PokerStars Hand #221908327615: Tournament #3082648141, $0.98+$0.12 USD Hold'em No Limit - Level I (15/30) - 2020/12/27 20:08:47 EET [2020/12/27 13:08:47 ET]
Table '3082648141 1' 9-max Seat #9 is the button
Seat 1: observerNIM (4879 in chips) is sitting out
Seat 2: rac021 (5329 in chips) 
Seat 3: Finderra (4652 in chips) 
Seat 4: shoorra (5223 in chips) 
Seat 5: matvey2008 (5027 in chips) 
Seat 6: drigoricardo (4927 in chips) 
Seat 7: nibz30 (4200 in chips) 
Seat 8: jcarlos.vale (5000 in chips) 
Seat 9: atrocity95 (5257 in chips) 
observerNIM: posts the ante 4
rac021: posts the ante 4
Finderra: posts the ante 4
shoorra: posts the ante 4
matvey2008: posts the ante 4
drigoricardo: posts the ante 4
nibz30: posts the ante 4
jcarlos.vale: posts the ante 4
atrocity95: posts the ante 4
observerNIM: posts small blind 15
rac021: posts big blind 30
*** HOLE CARDS ***
Dealt to jcarlos.vale [Qs 8h]
Finderra: raises 35 to 65
shoorra: folds 
matvey2008: folds 
drigoricardo: folds 
nibz30: calls 65
jcarlos.vale said, ":P"
jcarlos.vale: folds 
atrocity95: folds 
observerNIM: folds 
rac021: raises 185 to 250
Finderra: calls 185
nibz30: calls 185
*** FLOP *** [3c As 5h]
rac021: bets 300
Finderra: folds 
nibz30: calls 300
*** TURN *** [3c As 5h] [Tc]
rac021: bets 934
nibz30: folds 
Uncalled bet (934) returned to rac021
rac021 collected 1401 from pot
rac021: doesn't show handDTO
*** SUMMARY ***
Total pot 1401 | Rake 0 
Board [3c As 5h Tc]
Seat 1: observerNIM (small blind) folded before Flop
Seat 2: rac021 (big blind) collected (1401)
Seat 3: Finderra folded on the Flop
Seat 4: shoorra folded before Flop (didn't bet)
Seat 5: matvey2008 folded before Flop (didn't bet)
Seat 6: drigoricardo folded before Flop (didn't bet)
Seat 7: nibz30 folded on the Turn
Seat 8: jcarlos.vale folded before Flop (didn't bet)
Seat 9: atrocity95 (button) folded before Flop (didn't bet)



PokerStars Hand #221908411094: Tournament #3082648141, $0.98+$0.12 USD Hold'em No Limit - Level II (20/40) - 2020/12/27 20:10:18 EET [2020/12/27 13:10:18 ET]
Table '3082648141 1' 9-max Seat #1 is the button
Seat 1: observerNIM (4860 in chips) is sitting out
Seat 2: rac021 (6176 in chips) 
Seat 3: Finderra (4398 in chips) 
Seat 4: shoorra (5219 in chips) 
Seat 5: matvey2008 (5023 in chips) 
Seat 6: drigoricardo (4923 in chips) 
Seat 7: nibz30 (3646 in chips) 
Seat 8: jcarlos.vale (4996 in chips) 
Seat 9: atrocity95 (5253 in chips) 
observerNIM: posts the ante 5
rac021: posts the ante 5
Finderra: posts the ante 5
shoorra: posts the ante 5
matvey2008: posts the ante 5
drigoricardo: posts the ante 5
nibz30: posts the ante 5
jcarlos.vale: posts the ante 5
atrocity95: posts the ante 5
rac021: posts small blind 20
Finderra: posts big blind 40
*** HOLE CARDS ***
Dealt to jcarlos.vale [Kd Qc]
shoorra: raises 40 to 80
matvey2008: folds 
drigoricardo: folds 
nibz30: calls 80
jcarlos.vale: folds 
atrocity95: folds 
observerNIM: folds 
rac021: folds 
Finderra: calls 40
*** FLOP *** [4d 6d 4h]
Finderra: checks 
shoorra: checks 
nibz30: checks 
*** TURN *** [4d 6d 4h] [3h]
Finderra: checks 
shoorra: checks 
nibz30: checks 
*** RIVER *** [4d 6d 4h 3h] [Tc]
Finderra: bets 480
shoorra: folds 
nibz30: folds 
Uncalled bet (480) returned to Finderra
Finderra collected 305 from pot
*** SUMMARY ***
Total pot 305 | Rake 0 
Board [4d 6d 4h 3h Tc]
Seat 1: observerNIM (button) folded before Flop (didn't bet)
Seat 2: rac021 (small blind) folded before Flop
Seat 3: Finderra (big blind) collected (305)
Seat 4: shoorra folded on the River
Seat 5: matvey2008 folded before Flop (didn't bet)
Seat 6: drigoricardo folded before Flop (didn't bet)
Seat 7: nibz30 folded on the River
Seat 8: jcarlos.vale folded before Flop (didn't bet)
Seat 9: atrocity95 folded before Flop (didn't bet)



PokerStars Hand #221908478214: Tournament #3082648141, $0.98+$0.12 USD Hold'em No Limit - Level II (20/40) - 2020/12/27 20:11:32 EET [2020/12/27 13:11:32 ET]
Table '3082648141 1' 9-max Seat #2 is the button
Seat 1: observerNIM (4855 in chips) is sitting out
Seat 2: rac021 (6151 in chips) 
Seat 3: Finderra (4618 in chips) 
Seat 4: shoorra (5134 in chips) 
Seat 5: matvey2008 (5018 in chips) 
Seat 6: drigoricardo (4918 in chips) 
Seat 7: nibz30 (3561 in chips) 
Seat 8: jcarlos.vale (4991 in chips) 
Seat 9: atrocity95 (5248 in chips) 
observerNIM: posts the ante 5
rac021: posts the ante 5
Finderra: posts the ante 5
shoorra: posts the ante 5
matvey2008: posts the ante 5
drigoricardo: posts the ante 5
nibz30: posts the ante 5
jcarlos.vale: posts the ante 5
atrocity95: posts the ante 5
Finderra: posts small blind 20
shoorra: posts big blind 40
*** HOLE CARDS ***
Dealt to jcarlos.vale [Kc 8s]
matvey2008: folds 
drigoricardo: raises 70 to 110
nibz30: calls 110
jcarlos.vale: folds 
atrocity95: calls 110
observerNIM: folds 
rac021: folds 
Finderra: folds 
shoorra: folds 
*** FLOP *** [Th 4d Jh]
drigoricardo: checks 
nibz30: checks 
atrocity95: checks 
*** TURN *** [Th 4d Jh] [5h]
drigoricardo: bets 148
nibz30: folds 
atrocity95: folds 
Uncalled bet (148) returned to drigoricardo
drigoricardo collected 435 from pot
drigoricardo: doesn't show handDTO
*** SUMMARY ***
Total pot 435 | Rake 0 
Board [Th 4d Jh 5h]
Seat 1: observerNIM folded before Flop (didn't bet)
Seat 2: rac021 (button) folded before Flop (didn't bet)
Seat 3: Finderra (small blind) folded before Flop
Seat 4: shoorra (big blind) folded before Flop
Seat 5: matvey2008 folded before Flop (didn't bet)
Seat 6: drigoricardo collected (435)
Seat 7: nibz30 folded on the Turn
Seat 8: jcarlos.vale folded before Flop (didn't bet)
Seat 9: atrocity95 folded on the Turn



PokerStars Hand #221908528557: Tournament #3082648141, $0.98+$0.12 USD Hold'em No Limit - Level II (20/40) - 2020/12/27 20:12:28 EET [2020/12/27 13:12:28 ET]
Table '3082648141 1' 9-max Seat #3 is the button
Seat 1: observerNIM (4850 in chips) is sitting out
Seat 2: rac021 (6146 in chips) 
Seat 3: Finderra (4593 in chips) 
Seat 4: shoorra (5089 in chips) 
Seat 5: matvey2008 (5013 in chips) 
Seat 6: drigoricardo (5238 in chips) 
Seat 7: nibz30 (3446 in chips) 
Seat 8: jcarlos.vale (4986 in chips) 
Seat 9: atrocity95 (5133 in chips) 
observerNIM: posts the ante 5
rac021: posts the ante 5
Finderra: posts the ante 5
shoorra: posts the ante 5
matvey2008: posts the ante 5
drigoricardo: posts the ante 5
nibz30: posts the ante 5
jcarlos.vale: posts the ante 5
atrocity95: posts the ante 5
shoorra: posts small blind 20
matvey2008: posts big blind 40
*** HOLE CARDS ***
Dealt to jcarlos.vale [9s 8d]
observerNIM has returned
drigoricardo: folds 
nibz30: folds 
jcarlos.vale: folds 
atrocity95: folds 
observerNIM: raises 40 to 80
rac021: folds 
Finderra: folds 
shoorra: calls 60
matvey2008: folds 
*** FLOP *** [5c Kc 4d]
shoorra: checks 
observerNIM: checks 
*** TURN *** [5c Kc 4d] [As]
shoorra: bets 123
observerNIM: folds 
Uncalled bet (123) returned to shoorra
shoorra collected 245 from pot
shoorra: doesn't show handDTO
*** SUMMARY ***
Total pot 245 | Rake 0 
Board [5c Kc 4d As]
Seat 1: observerNIM folded on the Turn
Seat 2: rac021 folded before Flop (didn't bet)
Seat 3: Finderra (button) folded before Flop (didn't bet)
Seat 4: shoorra (small blind) collected (245)
Seat 5: matvey2008 (big blind) folded before Flop
Seat 6: drigoricardo folded before Flop (didn't bet)
Seat 7: nibz30 folded before Flop (didn't bet)
Seat 8: jcarlos.vale folded before Flop (didn't bet)
Seat 9: atrocity95 folded before Flop (didn't bet)



PokerStars Hand #221908570473: Tournament #3082648141, $0.98+$0.12 USD Hold'em No Limit - Level II (20/40) - 2020/12/27 20:13:14 EET [2020/12/27 13:13:14 ET]
Table '3082648141 1' 9-max Seat #4 is the button
Seat 1: observerNIM (4765 in chips) 
Seat 2: rac021 (6141 in chips) 
Seat 3: Finderra (4588 in chips) 
Seat 4: shoorra (5249 in chips) 
Seat 5: matvey2008 (4968 in chips) 
Seat 6: drigoricardo (5233 in chips) 
Seat 7: nibz30 (3441 in chips) 
Seat 8: jcarlos.vale (4981 in chips) 
Seat 9: atrocity95 (5128 in chips) 
observerNIM: posts the ante 5
rac021: posts the ante 5
Finderra: posts the ante 5
shoorra: posts the ante 5
matvey2008: posts the ante 5
drigoricardo: posts the ante 5
nibz30: posts the ante 5
jcarlos.vale: posts the ante 5
atrocity95: posts the ante 5
matvey2008: posts small blind 20
drigoricardo: posts big blind 40
*** HOLE CARDS ***
Dealt to jcarlos.vale [2h 8d]
nibz30: raises 40 to 80
jcarlos.vale: folds 
atrocity95: folds 
observerNIM: folds 
rac021: calls 80
Finderra: raises 400 to 480
shoorra: calls 480
matvey2008: folds 
drigoricardo: folds 
nibz30: calls 400
rac021: calls 400
*** FLOP *** [Td 9s 5d]
nibz30: bets 1013
rac021: folds 
Finderra: folds 
shoorra: folds 
Uncalled bet (1013) returned to nibz30
nibz30 collected 2025 from pot
nibz30: doesn't show handDTO
*** SUMMARY ***
Total pot 2025 | Rake 0 
Board [Td 9s 5d]
Seat 1: observerNIM folded before Flop (didn't bet)
Seat 2: rac021 folded on the Flop
Seat 3: Finderra folded on the Flop
Seat 4: shoorra (button) folded on the Flop
Seat 5: matvey2008 (small blind) folded before Flop
Seat 6: drigoricardo (big blind) folded before Flop
Seat 7: nibz30 collected (2025)
Seat 8: jcarlos.vale folded before Flop (didn't bet)
Seat 9: atrocity95 folded before Flop (didn't bet)



PokerStars Hand #221908641881: Tournament #3082648141, $0.98+$0.12 USD Hold'em No Limit - Level II (20/40) - 2020/12/27 20:14:33 EET [2020/12/27 13:14:33 ET]
Table '3082648141 1' 9-max Seat #5 is the button
Seat 1: observerNIM (4760 in chips) 
Seat 2: rac021 (5656 in chips) 
Seat 3: Finderra (4103 in chips) 
Seat 4: shoorra (4764 in chips) 
Seat 5: matvey2008 (4943 in chips) 
Seat 6: drigoricardo (5188 in chips) 
Seat 7: nibz30 (4981 in chips) 
Seat 8: jcarlos.vale (4976 in chips) 
Seat 9: atrocity95 (5123 in chips) 
observerNIM: posts the ante 5
rac021: posts the ante 5
Finderra: posts the ante 5
shoorra: posts the ante 5
matvey2008: posts the ante 5
drigoricardo: posts the ante 5
nibz30: posts the ante 5
jcarlos.vale: posts the ante 5
atrocity95: posts the ante 5
drigoricardo: posts small blind 20
nibz30: posts big blind 40
*** HOLE CARDS ***
Dealt to jcarlos.vale [4s 8s]
jcarlos.vale: folds 
atrocity95: folds 
observerNIM: folds 
rac021: folds 
Finderra: folds 
shoorra: raises 40 to 80
matvey2008: folds 
drigoricardo: folds 
nibz30: calls 40
*** FLOP *** [8d Qc Jc]
nibz30: checks 
shoorra: bets 68
nibz30: folds 
Uncalled bet (68) returned to shoorra
shoorra collected 225 from pot
shoorra: doesn't show handDTO
*** SUMMARY ***
Total pot 225 | Rake 0 
Board [8d Qc Jc]
Seat 1: observerNIM folded before Flop (didn't bet)
Seat 2: rac021 folded before Flop (didn't bet)
Seat 3: Finderra folded before Flop (didn't bet)
Seat 4: shoorra collected (225)
Seat 5: matvey2008 (button) folded before Flop (didn't bet)
Seat 6: drigoricardo (small blind) folded before Flop
Seat 7: nibz30 (big blind) folded on the Flop
Seat 8: jcarlos.vale folded before Flop (didn't bet)
Seat 9: atrocity95 folded before Flop (didn't bet)



PokerStars Hand #221908685866: Tournament #3082648141, $0.98+$0.12 USD Hold'em No Limit - Level II (20/40) - 2020/12/27 20:15:21 EET [2020/12/27 13:15:21 ET]
Table '3082648141 1' 9-max Seat #6 is the button
Seat 1: observerNIM (4755 in chips) 
Seat 2: rac021 (5651 in chips) 
Seat 3: Finderra (4098 in chips) 
Seat 4: shoorra (4904 in chips) 
Seat 5: matvey2008 (4938 in chips) 
Seat 6: drigoricardo (5163 in chips) 
Seat 7: nibz30 (4896 in chips) 
Seat 8: jcarlos.vale (4971 in chips) 
Seat 9: atrocity95 (5118 in chips) 
observerNIM: posts the ante 5
rac021: posts the ante 5
Finderra: posts the ante 5
shoorra: posts the ante 5
matvey2008: posts the ante 5
drigoricardo: posts the ante 5
nibz30: posts the ante 5
jcarlos.vale: posts the ante 5
atrocity95: posts the ante 5
nibz30: posts small blind 20
jcarlos.vale: posts big blind 40
*** HOLE CARDS ***
Dealt to jcarlos.vale [6h Kh]
atrocity95: folds 
observerNIM: folds 
rac021: raises 80 to 120
Finderra: folds 
shoorra: calls 120
matvey2008: folds 
drigoricardo: folds 
nibz30: calls 100
jcarlos.vale: folds 
*** FLOP *** [Qc 6s 3c]
nibz30: checks 
rac021: checks 
shoorra: bets 267
nibz30: folds 
rac021: calls 267
*** TURN *** [Qc 6s 3c] [5s]
rac021: checks 
shoorra: bets 490
rac021: folds 
Uncalled bet (490) returned to shoorra
shoorra collected 979 from pot
shoorra: doesn't show handDTO
*** SUMMARY ***
Total pot 979 | Rake 0 
Board [Qc 6s 3c 5s]
Seat 1: observerNIM folded before Flop (didn't bet)
Seat 2: rac021 folded on the Turn
Seat 3: Finderra folded before Flop (didn't bet)
Seat 4: shoorra collected (979)
Seat 5: matvey2008 folded before Flop (didn't bet)
Seat 6: drigoricardo (button) folded before Flop (didn't bet)
Seat 7: nibz30 (small blind) folded on the Flop
Seat 8: jcarlos.vale (big blind) folded before Flop
Seat 9: atrocity95 folded before Flop (didn't bet)



PokerStars Hand #221908820316: Tournament #3082648141, $0.98+$0.12 USD Hold'em No Limit - Level II (20/40) - 2020/12/27 20:17:50 EET [2020/12/27 13:17:50 ET]
Table '3082648141 1' 9-max Seat #7 is the button
Seat 1: observerNIM (4750 in chips) 
Seat 2: rac021 (5259 in chips) 
Seat 3: Finderra (4093 in chips) 
Seat 4: shoorra (5491 in chips) 
Seat 5: matvey2008 (4933 in chips) 
Seat 6: drigoricardo (5158 in chips) 
Seat 7: nibz30 (4771 in chips) 
Seat 8: jcarlos.vale (4926 in chips) 
Seat 9: atrocity95 (5113 in chips) 
observerNIM: posts the ante 5
rac021: posts the ante 5
Finderra: posts the ante 5
shoorra: posts the ante 5
matvey2008: posts the ante 5
drigoricardo: posts the ante 5
nibz30: posts the ante 5
jcarlos.vale: posts the ante 5
atrocity95: posts the ante 5
jcarlos.vale: posts small blind 20
atrocity95: posts big blind 40
*** HOLE CARDS ***
Dealt to jcarlos.vale [5c Jh]
observerNIM: raises 44 to 84
rac021: raises 188 to 272
Finderra: folds 
shoorra: folds 
matvey2008: folds 
drigoricardo: folds 
nibz30: calls 272
jcarlos.vale: folds 
atrocity95: folds 
observerNIM: folds 
*** FLOP *** [Qc Ts 4c]
rac021: bets 242
nibz30: folds 
Uncalled bet (242) returned to rac021
rac021 collected 733 from pot
rac021: doesn't show handDTO
*** SUMMARY ***
Total pot 733 | Rake 0 
Board [Qc Ts 4c]
Seat 1: observerNIM folded before Flop
Seat 2: rac021 collected (733)
Seat 3: Finderra folded before Flop (didn't bet)
Seat 4: shoorra folded before Flop (didn't bet)
Seat 5: matvey2008 folded before Flop (didn't bet)
Seat 6: drigoricardo folded before Flop (didn't bet)
Seat 7: nibz30 (button) folded on the Flop
Seat 8: jcarlos.vale (small blind) folded before Flop
Seat 9: atrocity95 (big blind) folded before Flop



PokerStars Hand #221908898299: Tournament #3082648141, $0.98+$0.12 USD Hold'em No Limit - Level II (20/40) - 2020/12/27 20:19:16 EET [2020/12/27 13:19:16 ET]
Table '3082648141 1' 9-max Seat #8 is the button
Seat 1: observerNIM (4661 in chips) 
Seat 2: rac021 (5715 in chips) 
Seat 3: Finderra (4088 in chips) 
Seat 4: shoorra (5486 in chips) 
Seat 5: matvey2008 (4928 in chips) 
Seat 6: drigoricardo (5153 in chips) 
Seat 7: nibz30 (4494 in chips) 
Seat 8: jcarlos.vale (4901 in chips) 
Seat 9: atrocity95 (5068 in chips) 
observerNIM: posts the ante 5
rac021: posts the ante 5
Finderra: posts the ante 5
shoorra: posts the ante 5
matvey2008: posts the ante 5
drigoricardo: posts the ante 5
nibz30: posts the ante 5
jcarlos.vale: posts the ante 5
atrocity95: posts the ante 5
atrocity95: posts small blind 20
observerNIM: posts big blind 40
*** HOLE CARDS ***
Dealt to jcarlos.vale [3c 3h]
rac021: folds 
Finderra: folds 
shoorra: folds 
matvey2008: raises 48 to 88
drigoricardo: raises 152 to 240
nibz30: folds 
jcarlos.vale: folds 
atrocity95: raises 840 to 1080
observerNIM: folds 
matvey2008: folds 
drigoricardo: folds 
Uncalled bet (840) returned to atrocity95
atrocity95 collected 653 from pot
atrocity95: doesn't show handDTO
*** SUMMARY ***
Total pot 653 | Rake 0 
Seat 1: observerNIM (big blind) folded before Flop
Seat 2: rac021 folded before Flop (didn't bet)
Seat 3: Finderra folded before Flop (didn't bet)
Seat 4: shoorra folded before Flop (didn't bet)
Seat 5: matvey2008 folded before Flop
Seat 6: drigoricardo folded before Flop
Seat 7: nibz30 folded before Flop (didn't bet)
Seat 8: jcarlos.vale (button) folded before Flop (didn't bet)
Seat 9: atrocity95 (small blind) collected (653)



PokerStars Hand #221908954933: Tournament #3082648141, $0.98+$0.12 USD Hold'em No Limit - Level III (25/50) - 2020/12/27 20:20:19 EET [2020/12/27 13:20:19 ET]
Table '3082648141 1' 9-max Seat #9 is the button
Seat 1: observerNIM (4616 in chips) 
Seat 2: rac021 (5710 in chips) 
Seat 3: Finderra (4083 in chips) 
Seat 4: shoorra (5481 in chips) 
Seat 5: matvey2008 (4835 in chips) 
Seat 6: drigoricardo (4908 in chips) 
Seat 7: nibz30 (4489 in chips) 
Seat 8: jcarlos.vale (4896 in chips) 
Seat 9: atrocity95 (5476 in chips) 
observerNIM: posts the ante 6
rac021: posts the ante 6
Finderra: posts the ante 6
shoorra: posts the ante 6
matvey2008: posts the ante 6
drigoricardo: posts the ante 6
nibz30: posts the ante 6
jcarlos.vale: posts the ante 6
atrocity95: posts the ante 6
observerNIM: posts small blind 25
rac021: posts big blind 50
*** HOLE CARDS ***
Dealt to jcarlos.vale [5h 6h]
Finderra: folds 
shoorra: folds 
matvey2008: folds 
drigoricardo: folds 
nibz30: calls 50
jcarlos.vale: calls 50
atrocity95: calls 50
observerNIM: folds 
rac021: checks 
*** FLOP *** [4d 6d Kd]
rac021: checks 
nibz30: checks 
jcarlos.vale: bets 100
atrocity95: folds 
rac021: folds 
nibz30: folds 
Uncalled bet (100) returned to jcarlos.vale
jcarlos.vale collected 279 from pot
jcarlos.vale: doesn't show handDTO
*** SUMMARY ***
Total pot 279 | Rake 0 
Board [4d 6d Kd]
Seat 1: observerNIM (small blind) folded before Flop
Seat 2: rac021 (big blind) folded on the Flop
Seat 3: Finderra folded before Flop (didn't bet)
Seat 4: shoorra folded before Flop (didn't bet)
Seat 5: matvey2008 folded before Flop (didn't bet)
Seat 6: drigoricardo folded before Flop (didn't bet)
Seat 7: nibz30 folded on the Flop
Seat 8: jcarlos.vale collected (279)
Seat 9: atrocity95 (button) folded on the Flop



PokerStars Hand #221909024478: Tournament #3082648141, $0.98+$0.12 USD Hold'em No Limit - Level III (25/50) - 2020/12/27 20:21:36 EET [2020/12/27 13:21:36 ET]
Table '3082648141 1' 9-max Seat #1 is the button
Seat 1: observerNIM (4585 in chips) 
Seat 2: rac021 (5654 in chips) 
Seat 3: Finderra (4077 in chips) 
Seat 4: shoorra (5475 in chips) 
Seat 5: matvey2008 (4829 in chips) 
Seat 6: drigoricardo (4902 in chips) 
Seat 7: nibz30 (4433 in chips) 
Seat 8: jcarlos.vale (5119 in chips) 
Seat 9: atrocity95 (5420 in chips) 
observerNIM: posts the ante 6
rac021: posts the ante 6
Finderra: posts the ante 6
shoorra: posts the ante 6
matvey2008: posts the ante 6
drigoricardo: posts the ante 6
nibz30: posts the ante 6
jcarlos.vale: posts the ante 6
atrocity95: posts the ante 6
rac021: posts small blind 25
Finderra: posts big blind 50
*** HOLE CARDS ***
Dealt to jcarlos.vale [3s 6d]
shoorra: folds 
matvey2008: folds 
drigoricardo: raises 100 to 150
nibz30: calls 150
jcarlos.vale: folds 
atrocity95: folds 
observerNIM: folds 
rac021: calls 125
Finderra: calls 100
*** FLOP *** [Ts 9h 8c]
rac021: checks 
Finderra: checks 
drigoricardo: bets 340
nibz30: folds 
rac021: folds 
Finderra: folds 
Uncalled bet (340) returned to drigoricardo
drigoricardo collected 654 from pot
drigoricardo: doesn't show handDTO
*** SUMMARY ***
Total pot 654 | Rake 0 
Board [Ts 9h 8c]
Seat 1: observerNIM (button) folded before Flop (didn't bet)
Seat 2: rac021 (small blind) folded on the Flop
Seat 3: Finderra (big blind) folded on the Flop
Seat 4: shoorra folded before Flop (didn't bet)
Seat 5: matvey2008 folded before Flop (didn't bet)
Seat 6: drigoricardo collected (654)
Seat 7: nibz30 folded on the Flop
Seat 8: jcarlos.vale folded before Flop (didn't bet)
Seat 9: atrocity95 folded before Flop (didn't bet)



PokerStars Hand #221909086618: Tournament #3082648141, $0.98+$0.12 USD Hold'em No Limit - Level III (25/50) - 2020/12/27 20:22:43 EET [2020/12/27 13:22:43 ET]
Table '3082648141 1' 9-max Seat #2 is the button
Seat 1: observerNIM (4579 in chips) 
Seat 2: rac021 (5498 in chips) 
Seat 3: Finderra (3921 in chips) 
Seat 4: shoorra (5469 in chips) 
Seat 5: matvey2008 (4823 in chips) 
Seat 6: drigoricardo (5400 in chips) 
Seat 7: nibz30 (4277 in chips) 
Seat 8: jcarlos.vale (5113 in chips) 
Seat 9: atrocity95 (5414 in chips) 
observerNIM: posts the ante 6
rac021: posts the ante 6
Finderra: posts the ante 6
shoorra: posts the ante 6
matvey2008: posts the ante 6
drigoricardo: posts the ante 6
nibz30: posts the ante 6
jcarlos.vale: posts the ante 6
atrocity95: posts the ante 6
Finderra: posts small blind 25
shoorra: posts big blind 50
*** HOLE CARDS ***
Dealt to jcarlos.vale [8h 6c]
matvey2008: folds 
drigoricardo: raises 58 to 108
nibz30: calls 108
jcarlos.vale: folds 
atrocity95: folds 
observerNIM has timed out
observerNIM: folds 
observerNIM is sitting out
rac021: calls 108
Finderra: calls 83
shoorra: calls 58
*** FLOP *** [Ac 3c 2h]
Finderra: checks 
shoorra: checks 
drigoricardo: bets 202
nibz30: calls 202
rac021: folds 
Finderra: folds 
shoorra: calls 202
*** TURN *** [Ac 3c 2h] [2c]
shoorra: checks 
drigoricardo: checks 
nibz30: checks 
*** RIVER *** [Ac 3c 2h 2c] [As]
shoorra: bets 600
drigoricardo: raises 1248 to 1848
nibz30: folds 
shoorra: folds 
Uncalled bet (1248) returned to drigoricardo
drigoricardo collected 2400 from pot
drigoricardo: doesn't show handDTO
*** SUMMARY ***
Total pot 2400 | Rake 0 
Board [Ac 3c 2h 2c As]
Seat 1: observerNIM folded before Flop (didn't bet)
Seat 2: rac021 (button) folded on the Flop
Seat 3: Finderra (small blind) folded on the Flop
Seat 4: shoorra (big blind) folded on the River
Seat 5: matvey2008 folded before Flop (didn't bet)
Seat 6: drigoricardo collected (2400)
Seat 7: nibz30 folded on the River
Seat 8: jcarlos.vale folded before Flop (didn't bet)
Seat 9: atrocity95 folded before Flop (didn't bet)



PokerStars Hand #221909283515: Tournament #3082648141, $0.98+$0.12 USD Hold'em No Limit - Level III (25/50) - 2020/12/27 20:26:23 EET [2020/12/27 13:26:23 ET]
Table '3082648141 201' 9-max Seat #2 is the button
Seat 1: pitiuco (3959 in chips) 
Seat 2: daveyzz (10405 in chips) 
Seat 3: Kalkbrenn22 (4418 in chips) 
Seat 4: DantePiamontesi (4988 in chips) 
Seat 5: floridajosch (4994 in chips) 
Seat 6: Siepriemium (4360 in chips) 
Seat 7: thedpkid (4982 in chips) 
Seat 8: jcarlos.vale (5107 in chips) 
Seat 9: kungclau (5000 in chips) 
pitiuco: posts the ante 6
daveyzz: posts the ante 6
Kalkbrenn22: posts the ante 6
DantePiamontesi: posts the ante 6
floridajosch: posts the ante 6
Siepriemium: posts the ante 6
thedpkid: posts the ante 6
jcarlos.vale: posts the ante 6
kungclau: posts the ante 6
Kalkbrenn22: posts small blind 25
DantePiamontesi: posts big blind 50
*** HOLE CARDS ***
Dealt to jcarlos.vale [2c 4c]
floridajosch: folds 
Siepriemium: folds 
thedpkid: folds 
jcarlos.vale: folds 
kungclau: raises 50 to 100
pitiuco: folds 
daveyzz: folds 
Kalkbrenn22: folds 
DantePiamontesi: calls 50
*** FLOP *** [4s 5c 9h]
DantePiamontesi: checks 
kungclau: bets 100
DantePiamontesi: folds 
Uncalled bet (100) returned to kungclau
kungclau collected 279 from pot
kungclau: doesn't show handDTO
*** SUMMARY ***
Total pot 279 | Rake 0 
Board [4s 5c 9h]
Seat 1: pitiuco folded before Flop (didn't bet)
Seat 2: daveyzz (button) folded before Flop (didn't bet)
Seat 3: Kalkbrenn22 (small blind) folded before Flop
Seat 4: DantePiamontesi (big blind) folded on the Flop
Seat 5: floridajosch folded before Flop (didn't bet)
Seat 6: Siepriemium folded before Flop (didn't bet)
Seat 7: thedpkid folded before Flop (didn't bet)
Seat 8: jcarlos.vale folded before Flop (didn't bet)
Seat 9: kungclau collected (279)



PokerStars Hand #221909325348: Tournament #3082648141, $0.98+$0.12 USD Hold'em No Limit - Level III (25/50) - 2020/12/27 20:27:10 EET [2020/12/27 13:27:10 ET]
Table '3082648141 201' 9-max Seat #3 is the button
Seat 1: pitiuco (3953 in chips) 
Seat 2: daveyzz (10399 in chips) 
Seat 3: Kalkbrenn22 (4387 in chips) 
Seat 4: DantePiamontesi (4882 in chips) 
Seat 5: floridajosch (4988 in chips) 
Seat 6: Siepriemium (4354 in chips) 
Seat 7: thedpkid (4976 in chips) 
Seat 8: jcarlos.vale (5101 in chips) 
Seat 9: kungclau (5173 in chips) 
pitiuco: posts the ante 6
daveyzz: posts the ante 6
Kalkbrenn22: posts the ante 6
DantePiamontesi: posts the ante 6
floridajosch: posts the ante 6
Siepriemium: posts the ante 6
thedpkid: posts the ante 6
jcarlos.vale: posts the ante 6
kungclau: posts the ante 6
DantePiamontesi: posts small blind 25
floridajosch: posts big blind 50
*** HOLE CARDS ***
Dealt to jcarlos.vale [2h 8h]
Siepriemium: folds 
thedpkid: raises 60 to 110
jcarlos.vale: folds 
kungclau: folds 
pitiuco: folds 
daveyzz: calls 110
Kalkbrenn22: folds 
DantePiamontesi: raises 290 to 400
floridajosch: folds 
thedpkid: calls 290
daveyzz: calls 290
*** FLOP *** [Ts Js 8c]
DantePiamontesi: bets 900
thedpkid: calls 900
daveyzz: folds 
*** TURN *** [Ts Js 8c] [Jc]
kungclau is disconnected 
DantePiamontesi: bets 3576 and is all-in
thedpkid: calls 3576
*** RIVER *** [Ts Js 8c Jc] [9d]
*** SHOW DOWN ***
DantePiamontesi: shows [Ah Ac] (two pair, Aces and Jacks)
thedpkid: shows [Jd Qd] (a straight, Eight to Queen)
thedpkid collected 10256 from pot
DantePiamontesi finished the tournament
*** SUMMARY ***
Total pot 10256 | Rake 0 
Board [Ts Js 8c Jc 9d]
Seat 1: pitiuco folded before Flop (didn't bet)
Seat 2: daveyzz folded on the Flop
Seat 3: Kalkbrenn22 (button) folded before Flop (didn't bet)
Seat 4: DantePiamontesi (small blind) showed [Ah Ac] and lost with two pair, Aces and Jacks
Seat 5: floridajosch (big blind) folded before Flop
Seat 6: Siepriemium folded before Flop (didn't bet)
Seat 7: thedpkid showed [Jd Qd] and won (10256) with a straight, Eight to Queen
Seat 8: jcarlos.vale folded before Flop (didn't bet)
Seat 9: kungclau folded before Flop (didn't bet)



PokerStars Hand #221909435660: Tournament #3082648141, $0.98+$0.12 USD Hold'em No Limit - Level III (25/50) - 2020/12/27 20:29:02 EET [2020/12/27 13:29:02 ET]
Table '3082648141 201' 9-max Seat #5 is the button
Seat 1: pitiuco (3947 in chips) 
Seat 2: daveyzz (9993 in chips) 
Seat 3: Kalkbrenn22 (4381 in chips) 
Seat 4: Sparre38 (5000 in chips) 
Seat 5: floridajosch (4932 in chips) 
Seat 6: Siepriemium (4348 in chips) 
Seat 7: thedpkid (10350 in chips) 
Seat 8: jcarlos.vale (5095 in chips) 
Seat 9: kungclau (5167 in chips) 
pitiuco: posts the ante 6
daveyzz: posts the ante 6
Kalkbrenn22: posts the ante 6
Sparre38: posts the ante 6
floridajosch: posts the ante 6
Siepriemium: posts the ante 6
thedpkid: posts the ante 6
jcarlos.vale: posts the ante 6
kungclau: posts the ante 6
Siepriemium: posts small blind 25
thedpkid: posts big blind 50
*** HOLE CARDS ***
Dealt to jcarlos.vale [5h Jc]
jcarlos.vale: folds 
kungclau: raises 50 to 100
pitiuco: folds 
daveyzz: folds 
Kalkbrenn22: folds 
Sparre38: folds 
floridajosch: calls 100
Siepriemium: calls 75
thedpkid: calls 50
*** FLOP *** [Kc 7d 8h]
Siepriemium: checks 
thedpkid: checks 
kungclau: checks 
floridajosch: checks 
*** TURN *** [Kc 7d 8h] [Th]
Siepriemium: bets 200
thedpkid: folds 
kungclau: folds 
floridajosch: folds 
Uncalled bet (200) returned to Siepriemium
Siepriemium collected 454 from pot
Siepriemium: doesn't show handDTO
*** SUMMARY ***
Total pot 454 | Rake 0 
Board [Kc 7d 8h Th]
Seat 1: pitiuco folded before Flop (didn't bet)
Seat 2: daveyzz folded before Flop (didn't bet)
Seat 3: Kalkbrenn22 folded before Flop (didn't bet)
Seat 4: Sparre38 folded before Flop (didn't bet)
Seat 5: floridajosch (button) folded on the Turn
Seat 6: Siepriemium (small blind) collected (454)
Seat 7: thedpkid (big blind) folded on the Turn
Seat 8: jcarlos.vale folded before Flop (didn't bet)
Seat 9: kungclau folded on the Turn



PokerStars Hand #221909511544: Tournament #3082648141, $0.98+$0.12 USD Hold'em No Limit - Level IV (30/60) - 2020/12/27 20:30:26 EET [2020/12/27 13:30:26 ET]
Table '3082648141 201' 9-max Seat #6 is the button
Seat 1: pitiuco (3941 in chips) 
Seat 2: daveyzz (9987 in chips) 
Seat 3: Kalkbrenn22 (4375 in chips) 
Seat 4: Sparre38 (4994 in chips) 
Seat 5: floridajosch (4826 in chips) 
Seat 6: Siepriemium (4696 in chips) 
Seat 7: thedpkid (10244 in chips) 
Seat 8: jcarlos.vale (5089 in chips) 
Seat 9: kungclau (5061 in chips) 
pitiuco: posts the ante 8
daveyzz: posts the ante 8
Kalkbrenn22: posts the ante 8
Sparre38: posts the ante 8
floridajosch: posts the ante 8
Siepriemium: posts the ante 8
thedpkid: posts the ante 8
jcarlos.vale: posts the ante 8
kungclau: posts the ante 8
thedpkid: posts small blind 30
jcarlos.vale: posts big blind 60
*** HOLE CARDS ***
Dealt to jcarlos.vale [3h Jc]
kungclau: folds 
pitiuco: folds 
daveyzz: folds 
Kalkbrenn22: folds 
Sparre38: raises 60 to 120
floridajosch: folds 
Siepriemium: calls 120
thedpkid: raises 528 to 648
jcarlos.vale: folds 
Sparre38: raises 4338 to 4986 and is all-in
Siepriemium: folds 
thedpkid: calls 4338
*** FLOP *** [4d 2h 8h]
*** TURN *** [4d 2h 8h] [7c]
*** RIVER *** [4d 2h 8h 7c] [Jd]
*** SHOW DOWN ***
thedpkid: shows [As Kc] (high pairOfCards Ace)
Sparre38: shows [Qh Qd] (a pair of Queens)
Sparre38 collected 10224 from pot
*** SUMMARY ***
Total pot 10224 | Rake 0 
Board [4d 2h 8h 7c Jd]
Seat 1: pitiuco folded before Flop (didn't bet)
Seat 2: daveyzz folded before Flop (didn't bet)
Seat 3: Kalkbrenn22 folded before Flop (didn't bet)
Seat 4: Sparre38 showed [Qh Qd] and won (10224) with a pair of Queens
Seat 5: floridajosch folded before Flop (didn't bet)
Seat 6: Siepriemium (button) folded before Flop
Seat 7: thedpkid (small blind) showed [As Kc] and lost with high pairOfCards Ace
Seat 8: jcarlos.vale (big blind) folded before Flop
Seat 9: kungclau folded before Flop (didn't bet)



PokerStars Hand #221909575225: Tournament #3082648141, $0.98+$0.12 USD Hold'em No Limit - Level IV (30/60) - 2020/12/27 20:31:35 EET [2020/12/27 13:31:35 ET]
Table '3082648141 201' 9-max Seat #7 is the button
Seat 1: pitiuco (3933 in chips) 
Seat 2: daveyzz (9979 in chips) 
Seat 3: Kalkbrenn22 (4367 in chips) 
Seat 4: Sparre38 (10224 in chips) 
Seat 5: floridajosch (4818 in chips) 
Seat 6: Siepriemium (4568 in chips) 
Seat 7: thedpkid (5250 in chips) 
Seat 8: jcarlos.vale (5021 in chips) 
Seat 9: kungclau (5053 in chips) 
pitiuco: posts the ante 8
daveyzz: posts the ante 8
Kalkbrenn22: posts the ante 8
Sparre38: posts the ante 8
floridajosch: posts the ante 8
Siepriemium: posts the ante 8
thedpkid: posts the ante 8
jcarlos.vale: posts the ante 8
kungclau: posts the ante 8
jcarlos.vale: posts small blind 30
kungclau: posts big blind 60
*** HOLE CARDS ***
Dealt to jcarlos.vale [5h Ks]
pitiuco: folds 
daveyzz: folds 
Kalkbrenn22: folds 
Sparre38: folds 
floridajosch: calls 60
Siepriemium: folds 
thedpkid: folds 
jcarlos.vale: calls 30
kungclau: checks 
*** FLOP *** [Kh Jh Qh]
jcarlos.vale: bets 180
kungclau: folds 
floridajosch: folds 
Uncalled bet (180) returned to jcarlos.vale
jcarlos.vale collected 252 from pot
jcarlos.vale: doesn't show handDTO
*** SUMMARY ***
Total pot 252 | Rake 0 
Board [Kh Jh Qh]
Seat 1: pitiuco folded before Flop (didn't bet)
Seat 2: daveyzz folded before Flop (didn't bet)
Seat 3: Kalkbrenn22 folded before Flop (didn't bet)
Seat 4: Sparre38 folded before Flop (didn't bet)
Seat 5: floridajosch folded on the Flop
Seat 6: Siepriemium folded before Flop (didn't bet)
Seat 7: thedpkid (button) folded before Flop (didn't bet)
Seat 8: jcarlos.vale (small blind) collected (252)
Seat 9: kungclau (big blind) folded on the Flop



PokerStars Hand #221909619285: Tournament #3082648141, $0.98+$0.12 USD Hold'em No Limit - Level IV (30/60) - 2020/12/27 20:32:23 EET [2020/12/27 13:32:23 ET]
Table '3082648141 201' 9-max Seat #8 is the button
Seat 1: pitiuco (3925 in chips) 
Seat 2: daveyzz (9971 in chips) 
Seat 3: Kalkbrenn22 (4359 in chips) 
Seat 4: Sparre38 (10216 in chips) 
Seat 5: floridajosch (4750 in chips) 
Seat 6: Siepriemium (4560 in chips) 
Seat 7: thedpkid (5242 in chips) 
Seat 8: jcarlos.vale (5205 in chips) 
Seat 9: kungclau (4985 in chips) 
pitiuco: posts the ante 8
daveyzz: posts the ante 8
Kalkbrenn22: posts the ante 8
Sparre38: posts the ante 8
floridajosch: posts the ante 8
Siepriemium: posts the ante 8
thedpkid: posts the ante 8
jcarlos.vale: posts the ante 8
kungclau: posts the ante 8
kungclau: posts small blind 30
pitiuco: posts big blind 60
*** HOLE CARDS ***
Dealt to jcarlos.vale [3s 9s]
daveyzz: calls 60
Kalkbrenn22: folds 
Sparre38: raises 60 to 120
floridajosch: calls 120
Siepriemium: folds 
thedpkid: folds 
jcarlos.vale: folds 
kungclau: folds 
pitiuco: calls 60
daveyzz: calls 60
*** FLOP *** [5h 3h 7c]
pitiuco: bets 3797 and is all-in
daveyzz: folds 
Sparre38: folds 
floridajosch: folds 
Uncalled bet (3797) returned to pitiuco
pitiuco collected 582 from pot
pitiuco: doesn't show handDTO
*** SUMMARY ***
Total pot 582 | Rake 0 
Board [5h 3h 7c]
Seat 1: pitiuco (big blind) collected (582)
Seat 2: daveyzz folded on the Flop
Seat 3: Kalkbrenn22 folded before Flop (didn't bet)
Seat 4: Sparre38 folded on the Flop
Seat 5: floridajosch folded on the Flop
Seat 6: Siepriemium folded before Flop (didn't bet)
Seat 7: thedpkid folded before Flop (didn't bet)
Seat 8: jcarlos.vale (button) folded before Flop (didn't bet)
Seat 9: kungclau (small blind) folded before Flop



PokerStars Hand #221909700823: Tournament #3082648141, $0.98+$0.12 USD Hold'em No Limit - Level IV (30/60) - 2020/12/27 20:33:52 EET [2020/12/27 13:33:52 ET]
Table '3082648141 201' 9-max Seat #9 is the button
Seat 1: pitiuco (4379 in chips) 
Seat 2: daveyzz (9843 in chips) 
Seat 3: Kalkbrenn22 (4351 in chips) 
Seat 4: Sparre38 (10088 in chips) 
Seat 5: floridajosch (4622 in chips) 
Seat 6: Siepriemium (4552 in chips) 
Seat 7: thedpkid (5234 in chips) 
Seat 8: jcarlos.vale (5197 in chips) 
Seat 9: kungclau (4947 in chips) 
pitiuco: posts the ante 8
daveyzz: posts the ante 8
Kalkbrenn22: posts the ante 8
Sparre38: posts the ante 8
floridajosch: posts the ante 8
Siepriemium: posts the ante 8
thedpkid: posts the ante 8
jcarlos.vale: posts the ante 8
kungclau: posts the ante 8
pitiuco: posts small blind 30
daveyzz: posts big blind 60
*** HOLE CARDS ***
Dealt to jcarlos.vale [5s 6c]
Kalkbrenn22: folds 
Sparre38: raises 60 to 120
floridajosch: calls 120
Siepriemium: folds 
thedpkid: folds 
jcarlos.vale: folds 
kungclau: folds 
pitiuco: calls 90
daveyzz: folds 
*** FLOP *** [8s 3h Ac]
pitiuco: checks 
Sparre38: bets 246
floridajosch: folds 
pitiuco: folds 
Uncalled bet (246) returned to Sparre38
Sparre38 collected 492 from pot
Sparre38: doesn't show handDTO
*** SUMMARY ***
Total pot 492 | Rake 0 
Board [8s 3h Ac]
Seat 1: pitiuco (small blind) folded on the Flop
Seat 2: daveyzz (big blind) folded before Flop
Seat 3: Kalkbrenn22 folded before Flop (didn't bet)
Seat 4: Sparre38 collected (492)
Seat 5: floridajosch folded on the Flop
Seat 6: Siepriemium folded before Flop (didn't bet)
Seat 7: thedpkid folded before Flop (didn't bet)
Seat 8: jcarlos.vale folded before Flop (didn't bet)
Seat 9: kungclau (button) folded before Flop (didn't bet)



PokerStars Hand #221909761956: Tournament #3082648141, $0.98+$0.12 USD Hold'em No Limit - Level IV (30/60) - 2020/12/27 20:34:58 EET [2020/12/27 13:34:58 ET]
Table '3082648141 201' 9-max Seat #1 is the button
Seat 1: pitiuco (4251 in chips) 
Seat 2: daveyzz (9775 in chips) 
Seat 3: Kalkbrenn22 (4343 in chips) 
Seat 4: Sparre38 (10452 in chips) 
Seat 5: floridajosch (4494 in chips) 
Seat 6: Siepriemium (4544 in chips) 
Seat 7: thedpkid (5226 in chips) 
Seat 8: jcarlos.vale (5189 in chips) 
Seat 9: kungclau (4939 in chips) 
pitiuco: posts the ante 8
daveyzz: posts the ante 8
Kalkbrenn22: posts the ante 8
Sparre38: posts the ante 8
floridajosch: posts the ante 8
Siepriemium: posts the ante 8
thedpkid: posts the ante 8
jcarlos.vale: posts the ante 8
kungclau: posts the ante 8
daveyzz: posts small blind 30
Kalkbrenn22: posts big blind 60
*** HOLE CARDS ***
Dealt to jcarlos.vale [9c 5h]
Sparre38: folds 
floridajosch: folds 
Siepriemium: folds 
thedpkid: folds 
jcarlos.vale: folds 
kungclau: raises 60 to 120
pitiuco: raises 402 to 522
daveyzz: folds 
Kalkbrenn22: folds 
kungclau: folds 
Uncalled bet (402) returned to pitiuco
pitiuco collected 402 from pot
pitiuco: doesn't show handDTO
*** SUMMARY ***
Total pot 402 | Rake 0 
Seat 1: pitiuco (button) collected (402)
Seat 2: daveyzz (small blind) folded before Flop
Seat 3: Kalkbrenn22 (big blind) folded before Flop
Seat 4: Sparre38 folded before Flop (didn't bet)
Seat 5: floridajosch folded before Flop (didn't bet)
Seat 6: Siepriemium folded before Flop (didn't bet)
Seat 7: thedpkid folded before Flop (didn't bet)
Seat 8: jcarlos.vale folded before Flop (didn't bet)
Seat 9: kungclau folded before Flop



PokerStars Hand #221909812108: Tournament #3082648141, $0.98+$0.12 USD Hold'em No Limit - Level IV (30/60) - 2020/12/27 20:35:53 EET [2020/12/27 13:35:53 ET]
Table '3082648141 201' 9-max Seat #2 is the button
Seat 1: pitiuco (4525 in chips) 
Seat 2: daveyzz (9737 in chips) 
Seat 3: Kalkbrenn22 (4275 in chips) 
Seat 4: Sparre38 (10444 in chips) 
Seat 5: floridajosch (4486 in chips) 
Seat 6: Siepriemium (4536 in chips) 
Seat 7: thedpkid (5218 in chips) 
Seat 8: jcarlos.vale (5181 in chips) 
Seat 9: kungclau (4811 in chips) 
pitiuco: posts the ante 8
daveyzz: posts the ante 8
Kalkbrenn22: posts the ante 8
Sparre38: posts the ante 8
floridajosch: posts the ante 8
Siepriemium: posts the ante 8
thedpkid: posts the ante 8
jcarlos.vale: posts the ante 8
kungclau: posts the ante 8
Kalkbrenn22: posts small blind 30
Sparre38: posts big blind 60
*** HOLE CARDS ***
Dealt to jcarlos.vale [Jc 3d]
floridajosch: calls 60
Siepriemium: folds 
thedpkid: folds 
jcarlos.vale: folds 
kungclau: calls 60
pitiuco: calls 60
daveyzz: folds 
Kalkbrenn22: folds 
Sparre38: checks 
*** FLOP *** [6s 5s 4s]
Sparre38: bets 171
floridajosch: calls 171
kungclau: calls 171
pitiuco: folds 
*** TURN *** [6s 5s 4s] [7s]
Sparre38: checks 
floridajosch: checks 
kungclau: bets 420
Sparre38: calls 420
floridajosch: calls 420
*** RIVER *** [6s 5s 4s 7s] [8d]
Sparre38: checks 
floridajosch: checks 
kungclau: bets 1440
Sparre38: folds 
floridajosch: folds [9s]
Uncalled bet (1440) returned to kungclau
kungclau collected 2115 from pot
*** SUMMARY ***
Total pot 2115 | Rake 0 
Board [6s 5s 4s 7s 8d]
Seat 1: pitiuco folded on the Flop
Seat 2: daveyzz (button) folded before Flop (didn't bet)
Seat 3: Kalkbrenn22 (small blind) folded before Flop
Seat 4: Sparre38 (big blind) folded on the River
Seat 5: floridajosch folded on the River
Seat 6: Siepriemium folded before Flop (didn't bet)
Seat 7: thedpkid folded before Flop (didn't bet)
Seat 8: jcarlos.vale folded before Flop (didn't bet)
Seat 9: kungclau collected (2115)



PokerStars Hand #221909930544: Tournament #3082648141, $0.98+$0.12 USD Hold'em No Limit - Level IV (30/60) - 2020/12/27 20:38:03 EET [2020/12/27 13:38:03 ET]
Table '3082648141 201' 9-max Seat #3 is the button
Seat 1: pitiuco (4457 in chips) 
Seat 2: daveyzz (9729 in chips) 
Seat 3: Kalkbrenn22 (4237 in chips) 
Seat 4: Sparre38 (9785 in chips) 
Seat 5: floridajosch (3827 in chips) 
Seat 6: Siepriemium (4528 in chips) 
Seat 7: thedpkid (5210 in chips) 
Seat 8: jcarlos.vale (5173 in chips) 
Seat 9: kungclau (6267 in chips) 
pitiuco: posts the ante 8
daveyzz: posts the ante 8
Kalkbrenn22: posts the ante 8
Sparre38: posts the ante 8
floridajosch: posts the ante 8
Siepriemium: posts the ante 8
thedpkid: posts the ante 8
jcarlos.vale: posts the ante 8
kungclau: posts the ante 8
Sparre38: posts small blind 30
floridajosch: posts big blind 60
*** HOLE CARDS ***
Dealt to jcarlos.vale [Th 2s]
Siepriemium: folds 
thedpkid: folds 
jcarlos.vale: folds 
kungclau: raises 60 to 120
pitiuco: folds 
daveyzz: calls 120
Kalkbrenn22: folds 
Sparre38: folds 
floridajosch: folds 
*** FLOP *** [3h Js Td]
kungclau: checks 
daveyzz: checks 
*** TURN *** [3h Js Td] [5s]
kungclau: checks 
daveyzz: checks 
*** RIVER *** [3h Js Td 5s] [Kh]
kungclau: checks 
daveyzz: checks 
*** SHOW DOWN ***
kungclau: shows [Ad 8d] (high pairOfCards Ace)
daveyzz: mucks handDTO
kungclau collected 402 from pot
*** SUMMARY ***
Total pot 402 | Rake 0 
Board [3h Js Td 5s Kh]
Seat 1: pitiuco folded before Flop (didn't bet)
Seat 2: daveyzz mucked [9h 8h]
Seat 3: Kalkbrenn22 (button) folded before Flop (didn't bet)
Seat 4: Sparre38 (small blind) folded before Flop
Seat 5: floridajosch (big blind) folded before Flop
Seat 6: Siepriemium folded before Flop (didn't bet)
Seat 7: thedpkid folded before Flop (didn't bet)
Seat 8: jcarlos.vale folded before Flop (didn't bet)
Seat 9: kungclau showed [Ad 8d] and won (402) with high pairOfCards Ace



PokerStars Hand #221909998399: Tournament #3082648141, $0.98+$0.12 USD Hold'em No Limit - Level IV (30/60) - 2020/12/27 20:39:17 EET [2020/12/27 13:39:17 ET]
Table '3082648141 201' 9-max Seat #4 is the button
Seat 1: pitiuco (4449 in chips) 
Seat 2: daveyzz (9601 in chips) 
Seat 3: Kalkbrenn22 (4229 in chips) 
Seat 4: Sparre38 (9747 in chips) 
Seat 5: floridajosch (3759 in chips) 
Seat 6: Siepriemium (4520 in chips) 
Seat 7: thedpkid (5202 in chips) 
Seat 8: jcarlos.vale (5165 in chips) 
Seat 9: kungclau (6541 in chips) 
pitiuco: posts the ante 8
daveyzz: posts the ante 8
Kalkbrenn22: posts the ante 8
Sparre38: posts the ante 8
floridajosch: posts the ante 8
Siepriemium: posts the ante 8
thedpkid: posts the ante 8
jcarlos.vale: posts the ante 8
kungclau: posts the ante 8
floridajosch: posts small blind 30
Siepriemium: posts big blind 60
*** HOLE CARDS ***
Dealt to jcarlos.vale [7d Td]
thedpkid: raises 66 to 126
jcarlos.vale: folds 
kungclau: folds 
pitiuco: folds 
daveyzz: calls 126
Kalkbrenn22: folds 
Sparre38: folds 
floridajosch: folds 
Siepriemium: folds 
*** FLOP *** [2c 8d 7c]
thedpkid: checks 
daveyzz: checks 
*** TURN *** [2c 8d 7c] [Jh]
thedpkid: bets 162
daveyzz: calls 162
*** RIVER *** [2c 8d 7c Jh] [Jc]
thedpkid: bets 487
daveyzz: raises 533 to 1020
thedpkid: calls 533
*** SHOW DOWN ***
daveyzz: shows [Ac 3c] (a flush, Ace high)
thedpkid: mucks handDTO
daveyzz collected 2778 from pot
*** SUMMARY ***
Total pot 2778 | Rake 0 
Board [2c 8d 7c Jh Jc]
Seat 1: pitiuco folded before Flop (didn't bet)
Seat 2: daveyzz showed [Ac 3c] and won (2778) with a flush, Ace high
Seat 3: Kalkbrenn22 folded before Flop (didn't bet)
Seat 4: Sparre38 (button) folded before Flop (didn't bet)
Seat 5: floridajosch (small blind) folded before Flop
Seat 6: Siepriemium (big blind) folded before Flop
Seat 7: thedpkid mucked [8c 9c]
Seat 8: jcarlos.vale folded before Flop (didn't bet)
Seat 9: kungclau folded before Flop (didn't bet)



PokerStars Hand #221910074390: Tournament #3082648141, $0.98+$0.12 USD Hold'em No Limit - Level V (40/80) - 2020/12/27 20:40:40 EET [2020/12/27 13:40:40 ET]
Table '3082648141 201' 9-max Seat #5 is the button
Seat 1: pitiuco (4441 in chips) 
Seat 2: daveyzz (11063 in chips) 
Seat 3: Kalkbrenn22 (4221 in chips) 
Seat 4: Sparre38 (9739 in chips) 
Seat 5: floridajosch (3721 in chips) 
Seat 6: Siepriemium (4452 in chips) 
Seat 7: thedpkid (3886 in chips) 
Seat 8: jcarlos.vale (5157 in chips) 
Seat 9: kungclau (6533 in chips) 
pitiuco: posts the ante 9
daveyzz: posts the ante 9
Kalkbrenn22: posts the ante 9
Sparre38: posts the ante 9
floridajosch: posts the ante 9
Siepriemium: posts the ante 9
thedpkid: posts the ante 9
jcarlos.vale: posts the ante 9
kungclau: posts the ante 9
Siepriemium: posts small blind 40
thedpkid: posts big blind 80
*** HOLE CARDS ***
Dealt to jcarlos.vale [2c Th]
jcarlos.vale: folds 
kungclau: folds 
pitiuco: folds 
daveyzz: folds 
Kalkbrenn22: folds 
Sparre38: folds 
floridajosch: folds 
Siepriemium: calls 40
thedpkid: checks 
*** FLOP *** [9s As 5s]
Siepriemium: bets 160
thedpkid: folds 
Uncalled bet (160) returned to Siepriemium
Siepriemium collected 241 from pot
Siepriemium: doesn't show handDTO
*** SUMMARY ***
Total pot 241 | Rake 0 
Board [9s As 5s]
Seat 1: pitiuco folded before Flop (didn't bet)
Seat 2: daveyzz folded before Flop (didn't bet)
Seat 3: Kalkbrenn22 folded before Flop (didn't bet)
Seat 4: Sparre38 folded before Flop (didn't bet)
Seat 5: floridajosch (button) folded before Flop (didn't bet)
Seat 6: Siepriemium (small blind) collected (241)
Seat 7: thedpkid (big blind) folded on the Flop
Seat 8: jcarlos.vale folded before Flop (didn't bet)
Seat 9: kungclau folded before Flop (didn't bet)



PokerStars Hand #221910113755: Tournament #3082648141, $0.98+$0.12 USD Hold'em No Limit - Level V (40/80) - 2020/12/27 20:41:23 EET [2020/12/27 13:41:23 ET]
Table '3082648141 201' 9-max Seat #6 is the button
Seat 1: pitiuco (4432 in chips) 
Seat 2: daveyzz (11054 in chips) 
Seat 3: Kalkbrenn22 (4212 in chips) 
Seat 4: Sparre38 (9730 in chips) 
Seat 5: floridajosch (3712 in chips) 
Seat 6: Siepriemium (4604 in chips) 
Seat 7: thedpkid (3797 in chips) 
Seat 8: jcarlos.vale (5148 in chips) 
Seat 9: kungclau (6524 in chips) 
pitiuco: posts the ante 9
daveyzz: posts the ante 9
Kalkbrenn22: posts the ante 9
Sparre38: posts the ante 9
floridajosch: posts the ante 9
Siepriemium: posts the ante 9
thedpkid: posts the ante 9
jcarlos.vale: posts the ante 9
kungclau: posts the ante 9
thedpkid: posts small blind 40
jcarlos.vale: posts big blind 80
*** HOLE CARDS ***
Dealt to jcarlos.vale [Qs Ks]
kungclau: folds 
pitiuco: folds 
daveyzz: folds 
Kalkbrenn22: calls 80
Sparre38: calls 80
floridajosch: folds 
Siepriemium: folds 
thedpkid: calls 40
jcarlos.vale: checks 
*** FLOP *** [5d 6d 8s]
thedpkid: bets 160
jcarlos.vale: folds 
Kalkbrenn22: folds 
Sparre38: calls 160
*** TURN *** [5d 6d 8s] [3h]
thedpkid: bets 397
Sparre38: calls 397
*** RIVER *** [5d 6d 8s 3h] [6c]
thedpkid: checks 
Sparre38: bets 758
thedpkid: calls 758
*** SHOW DOWN ***
Sparre38: shows [7c 8c] (two pair, Eights and Sixes)
thedpkid: shows [Th 8h] (two pair, Eights and Sixes - Ten kicker)
thedpkid collected 3031 from pot
*** SUMMARY ***
Total pot 3031 | Rake 0 
Board [5d 6d 8s 3h 6c]
Seat 1: pitiuco folded before Flop (didn't bet)
Seat 2: daveyzz folded before Flop (didn't bet)
Seat 3: Kalkbrenn22 folded on the Flop
Seat 4: Sparre38 showed [7c 8c] and lost with two pair, Eights and Sixes
Seat 5: floridajosch folded before Flop (didn't bet)
Seat 6: Siepriemium (button) folded before Flop (didn't bet)
Seat 7: thedpkid (small blind) showed [Th 8h] and won (3031) with two pair, Eights and Sixes
Seat 8: jcarlos.vale (big blind) folded on the Flop
Seat 9: kungclau folded before Flop (didn't bet)



PokerStars Hand #221910200884: Tournament #3082648141, $0.98+$0.12 USD Hold'em No Limit - Level V (40/80) - 2020/12/27 20:42:58 EET [2020/12/27 13:42:58 ET]
Table '3082648141 201' 9-max Seat #7 is the button
Seat 1: pitiuco (4423 in chips) 
Seat 2: daveyzz (11045 in chips) 
Seat 3: Kalkbrenn22 (4123 in chips) 
Seat 4: Sparre38 (8326 in chips) 
Seat 5: floridajosch (3703 in chips) 
Seat 6: Siepriemium (4595 in chips) 
Seat 7: thedpkid (5424 in chips) 
Seat 8: jcarlos.vale (5059 in chips) 
Seat 9: kungclau (6515 in chips) 
pitiuco: posts the ante 9
daveyzz: posts the ante 9
Kalkbrenn22: posts the ante 9
Sparre38: posts the ante 9
floridajosch: posts the ante 9
Siepriemium: posts the ante 9
thedpkid: posts the ante 9
jcarlos.vale: posts the ante 9
kungclau: posts the ante 9
jcarlos.vale: posts small blind 40
kungclau: posts big blind 80
*** HOLE CARDS ***
Dealt to jcarlos.vale [Ah 8c]
pitiuco: folds 
daveyzz: calls 80
Kalkbrenn22: folds 
Sparre38: folds 
floridajosch: calls 80
Siepriemium: folds 
thedpkid: folds 
jcarlos.vale: calls 40
kungclau: checks 
*** FLOP *** [Js 8s 6h]
jcarlos.vale: bets 160
kungclau: folds 
daveyzz: calls 160
floridajosch: folds 
*** TURN *** [Js 8s 6h] [4s]
jcarlos.vale: bets 160
daveyzz: calls 160
*** RIVER *** [Js 8s 6h 4s] [5d]
jcarlos.vale: checks 
daveyzz: bets 560
jcarlos.vale: folds 
Uncalled bet (560) returned to daveyzz
daveyzz collected 1041 from pot
*** SUMMARY ***
Total pot 1041 | Rake 0 
Board [Js 8s 6h 4s 5d]
Seat 1: pitiuco folded before Flop (didn't bet)
Seat 2: daveyzz collected (1041)
Seat 3: Kalkbrenn22 folded before Flop (didn't bet)
Seat 4: Sparre38 folded before Flop (didn't bet)
Seat 5: floridajosch folded on the Flop
Seat 6: Siepriemium folded before Flop (didn't bet)
Seat 7: thedpkid (button) folded before Flop (didn't bet)
Seat 8: jcarlos.vale (small blind) folded on the River
Seat 9: kungclau (big blind) folded on the Flop



PokerStars Hand #221910268972: Tournament #3082648141, $0.98+$0.12 USD Hold'em No Limit - Level V (40/80) - 2020/12/27 20:44:05 EET [2020/12/27 13:44:05 ET]
Table '3082648141 201' 9-max Seat #8 is the button
Seat 1: pitiuco (4414 in chips) 
Seat 2: daveyzz (11677 in chips) 
Seat 3: Kalkbrenn22 (4114 in chips) 
Seat 4: Sparre38 (8317 in chips) 
Seat 5: floridajosch (3614 in chips) 
Seat 6: Siepriemium (4586 in chips) 
Seat 7: thedpkid (5415 in chips) 
Seat 8: jcarlos.vale (4650 in chips) 
Seat 9: kungclau (6426 in chips) 
pitiuco: posts the ante 9
daveyzz: posts the ante 9
Kalkbrenn22: posts the ante 9
Sparre38: posts the ante 9
floridajosch: posts the ante 9
Siepriemium: posts the ante 9
thedpkid: posts the ante 9
jcarlos.vale: posts the ante 9
kungclau: posts the ante 9
kungclau: posts small blind 40
pitiuco: posts big blind 80
*** HOLE CARDS ***
Dealt to jcarlos.vale [Kh 7d]
daveyzz: folds 
Kalkbrenn22: calls 80
Sparre38: folds 
floridajosch: folds 
Siepriemium: calls 80
thedpkid: folds 
jcarlos.vale: folds 
kungclau: raises 320 to 400
pitiuco: folds 
Kalkbrenn22: folds 
Siepriemium: calls 320
*** FLOP *** [Ts 4d 3h]
kungclau: bets 320
Siepriemium: folds 
Uncalled bet (320) returned to kungclau
kungclau collected 1041 from pot
kungclau: doesn't show handDTO
*** SUMMARY ***
Total pot 1041 | Rake 0 
Board [Ts 4d 3h]
Seat 1: pitiuco (big blind) folded before Flop
Seat 2: daveyzz folded before Flop (didn't bet)
Seat 3: Kalkbrenn22 folded before Flop
Seat 4: Sparre38 folded before Flop (didn't bet)
Seat 5: floridajosch folded before Flop (didn't bet)
Seat 6: Siepriemium folded on the Flop
Seat 7: thedpkid folded before Flop (didn't bet)
Seat 8: jcarlos.vale (button) folded before Flop (didn't bet)
Seat 9: kungclau (small blind) collected (1041)



PokerStars Hand #221910305125: Tournament #3082648141, $0.98+$0.12 USD Hold'em No Limit - Level V (40/80) - 2020/12/27 20:44:45 EET [2020/12/27 13:44:45 ET]
Table '3082648141 201' 9-max Seat #9 is the button
Seat 1: pitiuco (4325 in chips) 
Seat 2: daveyzz (11668 in chips) 
Seat 3: Kalkbrenn22 (4025 in chips) 
Seat 4: Sparre38 (8308 in chips) 
Seat 5: floridajosch (3605 in chips) 
Seat 6: Siepriemium (4177 in chips) 
Seat 7: thedpkid (5406 in chips) 
Seat 8: jcarlos.vale (4641 in chips) 
Seat 9: kungclau (7058 in chips) 
pitiuco: posts the ante 9
daveyzz: posts the ante 9
Kalkbrenn22: posts the ante 9
Sparre38: posts the ante 9
floridajosch: posts the ante 9
Siepriemium: posts the ante 9
thedpkid: posts the ante 9
jcarlos.vale: posts the ante 9
kungclau: posts the ante 9
pitiuco: posts small blind 40
daveyzz: posts big blind 80
*** HOLE CARDS ***
Dealt to jcarlos.vale [5h 8d]
Kalkbrenn22: calls 80
Sparre38: folds 
floridajosch: folds 
Siepriemium: folds 
thedpkid: folds 
jcarlos.vale: folds 
kungclau: folds 
pitiuco: calls 40
daveyzz: checks 
*** FLOP *** [4d Jh Ts]
pitiuco: bets 80
daveyzz: folds 
Kalkbrenn22: calls 80
*** TURN *** [4d Jh Ts] [Jc]
pitiuco: checks 
Kalkbrenn22: bets 241
pitiuco: folds 
Uncalled bet (241) returned to Kalkbrenn22
Kalkbrenn22 collected 481 from pot
Kalkbrenn22: doesn't show handDTO
*** SUMMARY ***
Total pot 481 | Rake 0 
Board [4d Jh Ts Jc]
Seat 1: pitiuco (small blind) folded on the Turn
Seat 2: daveyzz (big blind) folded on the Flop
Seat 3: Kalkbrenn22 collected (481)
Seat 4: Sparre38 folded before Flop (didn't bet)
Seat 5: floridajosch folded before Flop (didn't bet)
Seat 6: Siepriemium folded before Flop (didn't bet)
Seat 7: thedpkid folded before Flop (didn't bet)
Seat 8: jcarlos.vale folded before Flop (didn't bet)
Seat 9: kungclau (button) folded before Flop (didn't bet)



PokerStars Hand #221910375306: Tournament #3082648141, $0.98+$0.12 USD Hold'em No Limit - Level V (40/80) - 2020/12/27 20:46:03 EET [2020/12/27 13:46:03 ET]
Table '3082648141 201' 9-max Seat #1 is the button
Seat 1: pitiuco (4156 in chips) 
Seat 2: daveyzz (11579 in chips) 
Seat 3: Kalkbrenn22 (4337 in chips) 
Seat 4: Sparre38 (8299 in chips) 
Seat 5: floridajosch (3596 in chips) 
Seat 6: Siepriemium (4168 in chips) 
Seat 7: thedpkid (5397 in chips) 
Seat 8: jcarlos.vale (4632 in chips) 
Seat 9: kungclau (7049 in chips) 
pitiuco: posts the ante 9
daveyzz: posts the ante 9
Kalkbrenn22: posts the ante 9
Sparre38: posts the ante 9
floridajosch: posts the ante 9
Siepriemium: posts the ante 9
thedpkid: posts the ante 9
jcarlos.vale: posts the ante 9
kungclau: posts the ante 9
daveyzz: posts small blind 40
Kalkbrenn22: posts big blind 80
*** HOLE CARDS ***
Dealt to jcarlos.vale [Ac 5d]
Sparre38: folds 
floridajosch: folds 
Siepriemium: raises 160 to 240
thedpkid: folds 
jcarlos.vale: folds 
kungclau: folds 
pitiuco: folds 
daveyzz: folds 
Kalkbrenn22: folds 
Uncalled bet (160) returned to Siepriemium
Siepriemium collected 281 from pot
Siepriemium: doesn't show handDTO
*** SUMMARY ***
Total pot 281 | Rake 0 
Seat 1: pitiuco (button) folded before Flop (didn't bet)
Seat 2: daveyzz (small blind) folded before Flop
Seat 3: Kalkbrenn22 (big blind) folded before Flop
Seat 4: Sparre38 folded before Flop (didn't bet)
Seat 5: floridajosch folded before Flop (didn't bet)
Seat 6: Siepriemium collected (281)
Seat 7: thedpkid folded before Flop (didn't bet)
Seat 8: jcarlos.vale folded before Flop (didn't bet)
Seat 9: kungclau folded before Flop (didn't bet)



PokerStars Hand #221910400206: Tournament #3082648141, $0.98+$0.12 USD Hold'em No Limit - Level V (40/80) - 2020/12/27 20:46:31 EET [2020/12/27 13:46:31 ET]
Table '3082648141 201' 9-max Seat #2 is the button
Seat 1: pitiuco (4147 in chips) 
Seat 2: daveyzz (11530 in chips) 
Seat 3: Kalkbrenn22 (4248 in chips) 
Seat 4: Sparre38 (8290 in chips) 
Seat 5: floridajosch (3587 in chips) 
Seat 6: Siepriemium (4360 in chips) 
Seat 7: thedpkid (5388 in chips) 
Seat 8: jcarlos.vale (4623 in chips) 
Seat 9: kungclau (7040 in chips) 
pitiuco: posts the ante 9
daveyzz: posts the ante 9
Kalkbrenn22: posts the ante 9
Sparre38: posts the ante 9
floridajosch: posts the ante 9
Siepriemium: posts the ante 9
thedpkid: posts the ante 9
jcarlos.vale: posts the ante 9
kungclau: posts the ante 9
Kalkbrenn22: posts small blind 40
Sparre38: posts big blind 80
*** HOLE CARDS ***
Dealt to jcarlos.vale [Qh 9h]
floridajosch: folds 
Siepriemium: folds 
thedpkid: raises 88 to 168
jcarlos.vale: folds 
kungclau: folds 
pitiuco: folds 
daveyzz: folds 
Kalkbrenn22: folds 
Sparre38: folds 
Uncalled bet (88) returned to thedpkid
thedpkid collected 281 from pot
thedpkid: doesn't show handDTO
*** SUMMARY ***
Total pot 281 | Rake 0 
Seat 1: pitiuco folded before Flop (didn't bet)
Seat 2: daveyzz (button) folded before Flop (didn't bet)
Seat 3: Kalkbrenn22 (small blind) folded before Flop
Seat 4: Sparre38 (big blind) folded before Flop
Seat 5: floridajosch folded before Flop (didn't bet)
Seat 6: Siepriemium folded before Flop (didn't bet)
Seat 7: thedpkid collected (281)
Seat 8: jcarlos.vale folded before Flop (didn't bet)
Seat 9: kungclau folded before Flop (didn't bet)



PokerStars Hand #221910438234: Tournament #3082648141, $0.98+$0.12 USD Hold'em No Limit - Level V (40/80) - 2020/12/27 20:47:13 EET [2020/12/27 13:47:13 ET]
Table '3082648141 201' 9-max Seat #3 is the button
Seat 1: pitiuco (4138 in chips) 
Seat 2: daveyzz (11521 in chips) 
Seat 3: Kalkbrenn22 (4199 in chips) 
Seat 4: Sparre38 (8201 in chips) 
Seat 5: floridajosch (3578 in chips) 
Seat 6: Siepriemium (4351 in chips) 
Seat 7: thedpkid (5580 in chips) 
Seat 8: jcarlos.vale (4614 in chips) 
Seat 9: kungclau (7031 in chips) 
pitiuco: posts the ante 9
daveyzz: posts the ante 9
Kalkbrenn22: posts the ante 9
Sparre38: posts the ante 9
floridajosch: posts the ante 9
Siepriemium: posts the ante 9
thedpkid: posts the ante 9
jcarlos.vale: posts the ante 9
kungclau: posts the ante 9
Sparre38: posts small blind 40
floridajosch: posts big blind 80
*** HOLE CARDS ***
Dealt to jcarlos.vale [9c Kc]
Siepriemium: folds 
thedpkid: folds 
jcarlos.vale: folds 
kungclau: folds 
pitiuco: calls 80
daveyzz: folds 
Kalkbrenn22: folds 
Sparre38: calls 40
floridajosch: checks 
*** FLOP *** [6h Ac 5c]
Sparre38: bets 161
floridajosch: folds 
pitiuco: folds 
Uncalled bet (161) returned to Sparre38
Sparre38 collected 321 from pot
Sparre38: doesn't show handDTO
*** SUMMARY ***
Total pot 321 | Rake 0 
Board [6h Ac 5c]
Seat 1: pitiuco folded on the Flop
Seat 2: daveyzz folded before Flop (didn't bet)
Seat 3: Kalkbrenn22 (button) folded before Flop (didn't bet)
Seat 4: Sparre38 (small blind) collected (321)
Seat 5: floridajosch (big blind) folded on the Flop
Seat 6: Siepriemium folded before Flop (didn't bet)
Seat 7: thedpkid folded before Flop (didn't bet)
Seat 8: jcarlos.vale folded before Flop (didn't bet)
Seat 9: kungclau folded before Flop (didn't bet)



PokerStars Hand #221910484868: Tournament #3082648141, $0.98+$0.12 USD Hold'em No Limit - Level V (40/80) - 2020/12/27 20:48:05 EET [2020/12/27 13:48:05 ET]
Table '3082648141 201' 9-max Seat #4 is the button
Seat 1: pitiuco (4049 in chips) 
Seat 2: daveyzz (11512 in chips) 
Seat 3: Kalkbrenn22 (4190 in chips) 
Seat 4: Sparre38 (8433 in chips) 
Seat 5: floridajosch (3489 in chips) 
Seat 6: Siepriemium (4342 in chips) 
Seat 7: thedpkid (5571 in chips) 
Seat 8: jcarlos.vale (4605 in chips) 
Seat 9: kungclau (7022 in chips) 
pitiuco: posts the ante 9
daveyzz: posts the ante 9
Kalkbrenn22: posts the ante 9
Sparre38: posts the ante 9
floridajosch: posts the ante 9
Siepriemium: posts the ante 9
thedpkid: posts the ante 9
jcarlos.vale: posts the ante 9
kungclau: posts the ante 9
floridajosch: posts small blind 40
Siepriemium: posts big blind 80
*** HOLE CARDS ***
Dealt to jcarlos.vale [9h 4d]
thedpkid: folds 
jcarlos.vale: folds 
kungclau: folds 
pitiuco: folds 
daveyzz: folds 
Kalkbrenn22: folds 
Sparre38: folds 
floridajosch: calls 40
Siepriemium: checks 
*** FLOP *** [8s 2c 7s]
floridajosch: checks 
Siepriemium: bets 160
floridajosch: folds 
Uncalled bet (160) returned to Siepriemium
Siepriemium collected 241 from pot
Siepriemium: doesn't show handDTO
*** SUMMARY ***
Total pot 241 | Rake 0 
Board [8s 2c 7s]
Seat 1: pitiuco folded before Flop (didn't bet)
Seat 2: daveyzz folded before Flop (didn't bet)
Seat 3: Kalkbrenn22 folded before Flop (didn't bet)
Seat 4: Sparre38 (button) folded before Flop (didn't bet)
Seat 5: floridajosch (small blind) folded on the Flop
Seat 6: Siepriemium (big blind) collected (241)
Seat 7: thedpkid folded before Flop (didn't bet)
Seat 8: jcarlos.vale folded before Flop (didn't bet)
Seat 9: kungclau folded before Flop (didn't bet)



PokerStars Hand #221910529190: Tournament #3082648141, $0.98+$0.12 USD Hold'em No Limit - Level V (40/80) - 2020/12/27 20:48:54 EET [2020/12/27 13:48:54 ET]
Table '3082648141 201' 9-max Seat #5 is the button
Seat 1: pitiuco (4040 in chips) 
Seat 2: daveyzz (11503 in chips) 
Seat 3: Kalkbrenn22 (4181 in chips) 
Seat 4: Sparre38 (8424 in chips) 
Seat 5: floridajosch (3400 in chips) 
Seat 6: Siepriemium (4494 in chips) 
Seat 7: thedpkid (5562 in chips) 
Seat 8: jcarlos.vale (4596 in chips) 
Seat 9: kungclau (7013 in chips) 
pitiuco: posts the ante 9
daveyzz: posts the ante 9
Kalkbrenn22: posts the ante 9
Sparre38: posts the ante 9
floridajosch: posts the ante 9
Siepriemium: posts the ante 9
thedpkid: posts the ante 9
jcarlos.vale: posts the ante 9
kungclau: posts the ante 9
Siepriemium: posts small blind 40
thedpkid: posts big blind 80
*** HOLE CARDS ***
Dealt to jcarlos.vale [Jd Qh]
jcarlos.vale: raises 128 to 208
kungclau: folds 
pitiuco: calls 208
daveyzz: calls 208
Kalkbrenn22: folds 
Sparre38: folds 
floridajosch: calls 208
Siepriemium: folds 
thedpkid: calls 128
*** FLOP *** [6c Th As]
thedpkid: checks 
jcarlos.vale: checks 
pitiuco: checks 
daveyzz: checks 
floridajosch: checks 
*** TURN *** [6c Th As] [6d]
thedpkid: checks 
jcarlos.vale: checks 
pitiuco: checks 
daveyzz: checks 
floridajosch: checks 
*** RIVER *** [6c Th As 6d] [9h]
thedpkid: checks 
jcarlos.vale: checks 
pitiuco: checks 
daveyzz: checks 
floridajosch: checks 
*** SHOW DOWN ***
thedpkid: shows [6h 4c] (three of a kind, Sixes)
jcarlos.vale: mucks handDTO
pitiuco: mucks handDTO
daveyzz: mucks handDTO
floridajosch: mucks handDTO
thedpkid collected 1161 from pot
*** SUMMARY ***
Total pot 1161 | Rake 0 
Board [6c Th As 6d 9h]
Seat 1: pitiuco mucked [4h 8h]
Seat 2: daveyzz mucked [5c 5d]
Seat 3: Kalkbrenn22 folded before Flop (didn't bet)
Seat 4: Sparre38 folded before Flop (didn't bet)
Seat 5: floridajosch (button) mucked [9d Qd]
Seat 6: Siepriemium (small blind) folded before Flop
Seat 7: thedpkid (big blind) showed [6h 4c] and won (1161) with three of a kind, Sixes
Seat 8: jcarlos.vale mucked [Jd Qh]
Seat 9: kungclau folded before Flop (didn't bet)



PokerStars Hand #221910613828: Tournament #3082648141, $0.98+$0.12 USD Hold'em No Limit - Level VI (50/100) - 2020/12/27 20:50:29 EET [2020/12/27 13:50:29 ET]
Table '3082648141 201' 9-max Seat #6 is the button
Seat 1: pitiuco (3823 in chips) 
Seat 2: daveyzz (11286 in chips) 
Seat 3: Kalkbrenn22 (4172 in chips) 
Seat 4: Sparre38 (8415 in chips) 
Seat 5: floridajosch (3183 in chips) 
Seat 6: Siepriemium (4445 in chips) 
Seat 7: thedpkid (6506 in chips) 
Seat 8: jcarlos.vale (4379 in chips) 
Seat 9: kungclau (7004 in chips) 
pitiuco: posts the ante 10
daveyzz: posts the ante 10
Kalkbrenn22: posts the ante 10
Sparre38: posts the ante 10
floridajosch: posts the ante 10
Siepriemium: posts the ante 10
thedpkid: posts the ante 10
jcarlos.vale: posts the ante 10
kungclau: posts the ante 10
thedpkid: posts small blind 50
jcarlos.vale: posts big blind 100
*** HOLE CARDS ***
Dealt to jcarlos.vale [Ad Ac]
kungclau: raises 100 to 200
pitiuco: folds 
daveyzz has timed out
daveyzz: folds 
daveyzz is sitting out
Kalkbrenn22: calls 200
Sparre38: folds 
floridajosch: calls 200
Siepriemium: folds 
thedpkid: folds 
jcarlos.vale: raises 400 to 600
daveyzz has returned
kungclau: calls 400
Kalkbrenn22: calls 400
floridajosch: calls 400
*** FLOP *** [Kh 5h Qd]
jcarlos.vale: bets 2100
kungclau: folds 
Kalkbrenn22: raises 1462 to 3562 and is all-in
floridajosch: folds 
jcarlos.vale: calls 1462
*** TURN *** [Kh 5h Qd] [7h]
*** RIVER *** [Kh 5h Qd 7h] [8h]
*** SHOW DOWN ***
jcarlos.vale: shows [Ad Ac] (a pair of Aces)
Kalkbrenn22: shows [Kc Qc] (two pair, Kings and Queens)
Kalkbrenn22 collected 9664 from pot
*** SUMMARY ***
Total pot 9664 | Rake 0 
Board [Kh 5h Qd 7h 8h]
Seat 1: pitiuco folded before Flop (didn't bet)
Seat 2: daveyzz folded before Flop (didn't bet)
Seat 3: Kalkbrenn22 showed [Kc Qc] and won (9664) with two pair, Kings and Queens
Seat 4: Sparre38 folded before Flop (didn't bet)
Seat 5: floridajosch folded on the Flop
Seat 6: Siepriemium (button) folded before Flop (didn't bet)
Seat 7: thedpkid (small blind) folded before Flop
Seat 8: jcarlos.vale (big blind) showed [Ad Ac] and lost with a pair of Aces
Seat 9: kungclau folded on the Flop



PokerStars Hand #221910723978: Tournament #3082648141, $0.98+$0.12 USD Hold'em No Limit - Level VI (50/100) - 2020/12/27 20:52:33 EET [2020/12/27 13:52:33 ET]
Table '3082648141 201' 9-max Seat #7 is the button
Seat 1: pitiuco (3813 in chips) 
Seat 2: daveyzz (11276 in chips) 
Seat 3: Kalkbrenn22 (9664 in chips) 
Seat 4: Sparre38 (8405 in chips) 
Seat 5: floridajosch (2573 in chips) 
Seat 6: Siepriemium (4435 in chips) 
Seat 7: thedpkid (6446 in chips) 
Seat 8: jcarlos.vale (207 in chips) 
Seat 9: kungclau (6394 in chips) 
pitiuco: posts the ante 10
daveyzz: posts the ante 10
Kalkbrenn22: posts the ante 10
Sparre38: posts the ante 10
floridajosch: posts the ante 10
Siepriemium: posts the ante 10
thedpkid: posts the ante 10
jcarlos.vale: posts the ante 10
kungclau: posts the ante 10
jcarlos.vale: posts small blind 50
kungclau: posts big blind 100
*** HOLE CARDS ***
Dealt to jcarlos.vale [4c 9d]
pitiuco: calls 100
daveyzz: folds 
Kalkbrenn22: folds 
Sparre38: raises 100 to 200
floridajosch: folds 
Siepriemium: folds 
thedpkid: folds 
jcarlos.vale: calls 147 and is all-in
kungclau: calls 100
pitiuco: calls 100
*** FLOP *** [Ad Ks Qs]
kungclau: checks 
pitiuco: checks 
Sparre38: bets 444
kungclau: folds 
pitiuco: folds 
Uncalled bet (444) returned to Sparre38
*** TURN *** [Ad Ks Qs] [8d]
*** RIVER *** [Ad Ks Qs 8d] [4h]
*** SHOW DOWN ***
Sparre38: shows [Ts Td] (a pair of Tens)
Sparre38 collected 9 from side pot
jcarlos.vale: shows [4c 9d] (a pair of Fours)
Sparre38 collected 878 from main pot
jcarlos.vale finished the tournament
*** SUMMARY ***
Total pot 887 Main pot 878. Side pot 9. | Rake 0 
Board [Ad Ks Qs 8d 4h]
Seat 1: pitiuco folded on the Flop
Seat 2: daveyzz folded before Flop (didn't bet)
Seat 3: Kalkbrenn22 folded before Flop (didn't bet)
Seat 4: Sparre38 showed [Ts Td] and won (887) with a pair of Tens
Seat 5: floridajosch folded before Flop (didn't bet)
Seat 6: Siepriemium folded before Flop (didn't bet)
Seat 7: thedpkid (button) folded before Flop (didn't bet)
Seat 8: jcarlos.vale (small blind) showed [4c 9d] and lost with a pair of Fours
Seat 9: kungclau (big blind) folded on the Flop



PokerStars Hand #221911195289: Tournament #3082648141, $0.98+$0.12 USD Hold'em No Limit - Level VI (50/100) - 2020/12/27 21:03:52 EET [2020/12/27 14:03:52 ET]
Table '3082648141 153' 9-max Seat #9 is the button
Seat 1: AAleKKsei Z (5834 in chips) 
Seat 2: stefogr (12021 in chips) 
Seat 3: mcollins01 (4794 in chips) 
Seat 4: andreas8866 (7117 in chips) 
Seat 5: SLAPSTICK_M3 (4703 in chips) 
Seat 6: 9Black3 (3228 in chips) 
Seat 7: jcarlos.vale (5000 in chips) 
Seat 8: GonzalezRock (8722 in chips) 
Seat 9: L@z@reva (11434 in chips) 
AAleKKsei Z: posts the ante 10
stefogr: posts the ante 10
mcollins01: posts the ante 10
andreas8866: posts the ante 10
SLAPSTICK_M3: posts the ante 10
9Black3: posts the ante 10
jcarlos.vale: posts the ante 10
GonzalezRock: posts the ante 10
L@z@reva: posts the ante 10
AAleKKsei Z: posts small blind 50
stefogr: posts big blind 100
*** HOLE CARDS ***
Dealt to jcarlos.vale [7c Td]
mcollins01: folds 
andreas8866: folds 
SLAPSTICK_M3: folds 
9Black3: folds 
jcarlos.vale: folds 
GonzalezRock has timed out
GonzalezRock: folds 
GonzalezRock is sitting out
GonzalezRock has returned
L@z@reva: calls 100
AAleKKsei Z: calls 50
stefogr: checks 
*** FLOP *** [Ad 9s 8h]
AAleKKsei Z: checks 
stefogr: bets 150
L@z@reva: folds 
AAleKKsei Z: calls 150
*** TURN *** [Ad 9s 8h] [6s]
AAleKKsei Z: checks 
stefogr: bets 300
AAleKKsei Z: folds 
Uncalled bet (300) returned to stefogr
stefogr collected 690 from pot
*** SUMMARY ***
Total pot 690 | Rake 0 
Board [Ad 9s 8h 6s]
Seat 1: AAleKKsei Z (small blind) folded on the Turn
Seat 2: stefogr (big blind) collected (690)
Seat 3: mcollins01 folded before Flop (didn't bet)
Seat 4: andreas8866 folded before Flop (didn't bet)
Seat 5: SLAPSTICK_M3 folded before Flop (didn't bet)
Seat 6: 9Black3 folded before Flop (didn't bet)
Seat 7: jcarlos.vale folded before Flop (didn't bet)
Seat 8: GonzalezRock folded before Flop (didn't bet)
Seat 9: L@z@reva (button) folded on the Flop



PokerStars Hand #221911261913: Tournament #3082648141, $0.98+$0.12 USD Hold'em No Limit - Level VI (50/100) - 2020/12/27 21:05:03 EET [2020/12/27 14:05:03 ET]
Table '3082648141 153' 9-max Seat #1 is the button
Seat 1: AAleKKsei Z (5574 in chips) 
Seat 2: stefogr (12451 in chips) 
Seat 3: mcollins01 (4784 in chips) 
Seat 4: andreas8866 (7107 in chips) 
Seat 5: SLAPSTICK_M3 (4693 in chips) 
Seat 6: 9Black3 (3218 in chips) 
Seat 7: jcarlos.vale (4990 in chips) 
Seat 8: GonzalezRock (8712 in chips) 
Seat 9: L@z@reva (11324 in chips) 
AAleKKsei Z: posts the ante 10
stefogr: posts the ante 10
mcollins01: posts the ante 10
andreas8866: posts the ante 10
SLAPSTICK_M3: posts the ante 10
9Black3: posts the ante 10
jcarlos.vale: posts the ante 10
GonzalezRock: posts the ante 10
L@z@reva: posts the ante 10
stefogr: posts small blind 50
mcollins01: posts big blind 100
*** HOLE CARDS ***
Dealt to jcarlos.vale [Ah Ts]
andreas8866: folds 
SLAPSTICK_M3: folds 
9Black3: folds 
jcarlos.vale: raises 160 to 260
GonzalezRock has timed out
GonzalezRock: folds 
GonzalezRock is sitting out
GonzalezRock has returned
L@z@reva: folds 
AAleKKsei Z: folds 
stefogr: calls 210
mcollins01: folds 
*** FLOP *** [Qc 9c 7d]
stefogr: checks 
jcarlos.vale: checks 
*** TURN *** [Qc 9c 7d] [Kh]
stefogr: checks 
jcarlos.vale: bets 200
stefogr: calls 200
*** RIVER *** [Qc 9c 7d Kh] [8s]
stefogr: checks 
jcarlos.vale: checks 
*** SHOW DOWN ***
stefogr: shows [5c 2c] (high pairOfCards King)
jcarlos.vale: shows [Ah Ts] (high pairOfCards Ace)
jcarlos.vale collected 1110 from pot
*** SUMMARY ***
Total pot 1110 | Rake 0 
Board [Qc 9c 7d Kh 8s]
Seat 1: AAleKKsei Z (button) folded before Flop (didn't bet)
Seat 2: stefogr (small blind) showed [5c 2c] and lost with high pairOfCards King
Seat 3: mcollins01 (big blind) folded before Flop
Seat 4: andreas8866 folded before Flop (didn't bet)
Seat 5: SLAPSTICK_M3 folded before Flop (didn't bet)
Seat 6: 9Black3 folded before Flop (didn't bet)
Seat 7: jcarlos.vale showed [Ah Ts] and won (1110) with high pairOfCards Ace
Seat 8: GonzalezRock folded before Flop (didn't bet)
Seat 9: L@z@reva folded before Flop (didn't bet)



PokerStars Hand #221911332114: Tournament #3082648141, $0.98+$0.12 USD Hold'em No Limit - Level VI (50/100) - 2020/12/27 21:06:14 EET [2020/12/27 14:06:14 ET]
Table '3082648141 153' 9-max Seat #2 is the button
Seat 1: AAleKKsei Z (5564 in chips) 
Seat 2: stefogr (11981 in chips) 
Seat 3: mcollins01 (4674 in chips) 
Seat 4: andreas8866 (7097 in chips) 
Seat 5: SLAPSTICK_M3 (4683 in chips) 
Seat 6: 9Black3 (3208 in chips) 
Seat 7: jcarlos.vale (5630 in chips) 
Seat 8: GonzalezRock (8702 in chips) 
Seat 9: L@z@reva (11314 in chips) 
AAleKKsei Z: posts the ante 10
stefogr: posts the ante 10
mcollins01: posts the ante 10
andreas8866: posts the ante 10
SLAPSTICK_M3: posts the ante 10
9Black3: posts the ante 10
jcarlos.vale: posts the ante 10
GonzalezRock: posts the ante 10
L@z@reva: posts the ante 10
mcollins01: posts small blind 50
andreas8866: posts big blind 100
*** HOLE CARDS ***
Dealt to jcarlos.vale [Jd 8h]
SLAPSTICK_M3: folds 
9Black3: folds 
jcarlos.vale: folds 
GonzalezRock has timed out
GonzalezRock: folds 
GonzalezRock is sitting out
L@z@reva: folds 
AAleKKsei Z: folds 
stefogr: folds 
mcollins01: calls 50
andreas8866: raises 300 to 400
mcollins01: folds 
Uncalled bet (300) returned to andreas8866
andreas8866 collected 290 from pot
andreas8866: doesn't show handDTO
*** SUMMARY ***
Total pot 290 | Rake 0 
Seat 1: AAleKKsei Z folded before Flop (didn't bet)
Seat 2: stefogr (button) folded before Flop (didn't bet)
Seat 3: mcollins01 (small blind) folded before Flop
Seat 4: andreas8866 (big blind) collected (290)
Seat 5: SLAPSTICK_M3 folded before Flop (didn't bet)
Seat 6: 9Black3 folded before Flop (didn't bet)
Seat 7: jcarlos.vale folded before Flop (didn't bet)
Seat 8: GonzalezRock folded before Flop (didn't bet)
Seat 9: L@z@reva folded before Flop (didn't bet)



PokerStars Hand #221911374896: Tournament #3082648141, $0.98+$0.12 USD Hold'em No Limit - Level VI (50/100) - 2020/12/27 21:07:00 EET [2020/12/27 14:07:00 ET]
Table '3082648141 153' 9-max Seat #3 is the button
Seat 1: AAleKKsei Z (5554 in chips) 
Seat 2: stefogr (11971 in chips) 
Seat 3: mcollins01 (4564 in chips) 
Seat 4: andreas8866 (7277 in chips) 
Seat 5: SLAPSTICK_M3 (4673 in chips) 
Seat 6: 9Black3 (3198 in chips) 
Seat 7: jcarlos.vale (5620 in chips) 
Seat 8: GonzalezRock (8692 in chips) is sitting out
Seat 9: L@z@reva (11304 in chips) 
AAleKKsei Z: posts the ante 10
stefogr: posts the ante 10
mcollins01: posts the ante 10
andreas8866: posts the ante 10
SLAPSTICK_M3: posts the ante 10
9Black3: posts the ante 10
jcarlos.vale: posts the ante 10
GonzalezRock: posts the ante 10
L@z@reva: posts the ante 10
andreas8866: posts small blind 50
SLAPSTICK_M3: posts big blind 100
*** HOLE CARDS ***
Dealt to jcarlos.vale [8s 9d]
9Black3: folds 
jcarlos.vale: folds 
GonzalezRock: folds 
L@z@reva: folds 
AAleKKsei Z: folds 
stefogr: raises 120 to 220
GonzalezRock has returned
mcollins01: raises 460 to 680
andreas8866: folds 
SLAPSTICK_M3: folds 
stefogr: calls 460
*** FLOP *** [2d 6s 4d]
stefogr: checks 
mcollins01: bets 550
stefogr: calls 550
*** TURN *** [2d 6s 4d] [4h]
stefogr: checks 
mcollins01: bets 1150
stefogr: folds 
Uncalled bet (1150) returned to mcollins01
mcollins01 collected 2700 from pot
mcollins01: shows [Jc 9c] (a pair of Fours)
*** SUMMARY ***
Total pot 2700 | Rake 0 
Board [2d 6s 4d 4h]
Seat 1: AAleKKsei Z folded before Flop (didn't bet)
Seat 2: stefogr folded on the Turn
Seat 3: mcollins01 (button) collected (2700)
Seat 4: andreas8866 (small blind) folded before Flop
Seat 5: SLAPSTICK_M3 (big blind) folded before Flop
Seat 6: 9Black3 folded before Flop (didn't bet)
Seat 7: jcarlos.vale folded before Flop (didn't bet)
Seat 8: GonzalezRock folded before Flop (didn't bet)
Seat 9: L@z@reva folded before Flop (didn't bet)



PokerStars Hand #221911430558: Tournament #3082648141, $0.98+$0.12 USD Hold'em No Limit - Level VI (50/100) - 2020/12/27 21:08:00 EET [2020/12/27 14:08:00 ET]
Table '3082648141 153' 9-max Seat #4 is the button
Seat 1: AAleKKsei Z (5544 in chips) 
Seat 2: stefogr (10731 in chips) 
Seat 3: mcollins01 (6024 in chips) 
Seat 4: andreas8866 (7217 in chips) 
Seat 5: SLAPSTICK_M3 (4563 in chips) 
Seat 6: 9Black3 (3188 in chips) 
Seat 7: jcarlos.vale (5610 in chips) 
Seat 8: GonzalezRock (8682 in chips) 
Seat 9: L@z@reva (11294 in chips) 
AAleKKsei Z: posts the ante 10
stefogr: posts the ante 10
mcollins01: posts the ante 10
andreas8866: posts the ante 10
SLAPSTICK_M3: posts the ante 10
9Black3: posts the ante 10
jcarlos.vale: posts the ante 10
GonzalezRock: posts the ante 10
L@z@reva: posts the ante 10
SLAPSTICK_M3: posts small blind 50
9Black3: posts big blind 100
*** HOLE CARDS ***
Dealt to jcarlos.vale [Kd 2h]
jcarlos.vale: folds 
GonzalezRock: folds 
stefogr said, "Bravo"
L@z@reva: folds 
stefogr said, "well played"
AAleKKsei Z: folds 
stefogr: folds 
mcollins01: raises 120 to 220
andreas8866: calls 220
SLAPSTICK_M3: calls 170
9Black3: folds 
*** FLOP *** [Qd 7s 4c]
mcollins01 said, "Easy game"
SLAPSTICK_M3: checks 
mcollins01: checks 
andreas8866: checks 
*** TURN *** [Qd 7s 4c] [7c]
SLAPSTICK_M3: checks 
mcollins01: bets 681
andreas8866: calls 681
SLAPSTICK_M3: folds 
*** RIVER *** [Qd 7s 4c 7c] [Ac]
mcollins01: checks 
andreas8866: checks 
*** SHOW DOWN ***
mcollins01: shows [3c Kc] (a flush, Ace high)
andreas8866: mucks handDTO
mcollins01 collected 2212 from pot
*** SUMMARY ***
Total pot 2212 | Rake 0 
Board [Qd 7s 4c 7c Ac]
Seat 1: AAleKKsei Z folded before Flop (didn't bet)
Seat 2: stefogr folded before Flop (didn't bet)
Seat 3: mcollins01 showed [3c Kc] and won (2212) with a flush, Ace high
Seat 4: andreas8866 (button) mucked [8s 8d]
Seat 5: SLAPSTICK_M3 (small blind) folded on the Turn
Seat 6: 9Black3 (big blind) folded before Flop
Seat 7: jcarlos.vale folded before Flop (didn't bet)
Seat 8: GonzalezRock folded before Flop (didn't bet)
Seat 9: L@z@reva folded before Flop (didn't bet)



PokerStars Hand #221911501282: Tournament #3082648141, $0.98+$0.12 USD Hold'em No Limit - Level VII (60/120) - 2020/12/27 21:09:16 EET [2020/12/27 14:09:16 ET]
Table '3082648141 153' 9-max Seat #5 is the button
Seat 1: AAleKKsei Z (5534 in chips) 
Seat 2: stefogr (10721 in chips) 
Seat 3: mcollins01 (7325 in chips) 
Seat 4: andreas8866 (6306 in chips) 
Seat 5: SLAPSTICK_M3 (4333 in chips) 
Seat 6: 9Black3 (3078 in chips) 
Seat 7: jcarlos.vale (5600 in chips) 
Seat 8: GonzalezRock (8672 in chips) 
Seat 9: L@z@reva (11284 in chips) 
AAleKKsei Z: posts the ante 12
stefogr: posts the ante 12
mcollins01: posts the ante 12
andreas8866: posts the ante 12
SLAPSTICK_M3: posts the ante 12
9Black3: posts the ante 12
jcarlos.vale: posts the ante 12
GonzalezRock: posts the ante 12
L@z@reva: posts the ante 12
9Black3: posts small blind 60
jcarlos.vale: posts big blind 120
*** HOLE CARDS ***
Dealt to jcarlos.vale [2s 4c]
GonzalezRock: folds 
L@z@reva: folds 
AAleKKsei Z: folds 
stefogr: folds 
mcollins01: folds 
andreas8866: folds 
SLAPSTICK_M3: raises 144 to 264
9Black3: folds 
jcarlos.vale: folds 
Uncalled bet (144) returned to SLAPSTICK_M3
SLAPSTICK_M3 collected 408 from pot
SLAPSTICK_M3: doesn't show handDTO
*** SUMMARY ***
Total pot 408 | Rake 0 
Seat 1: AAleKKsei Z folded before Flop (didn't bet)
Seat 2: stefogr folded before Flop (didn't bet)
Seat 3: mcollins01 folded before Flop (didn't bet)
Seat 4: andreas8866 folded before Flop (didn't bet)
Seat 5: SLAPSTICK_M3 (button) collected (408)
Seat 6: 9Black3 (small blind) folded before Flop
Seat 7: jcarlos.vale (big blind) folded before Flop
Seat 8: GonzalezRock folded before Flop (didn't bet)
Seat 9: L@z@reva folded before Flop (didn't bet)



PokerStars Hand #221911542160: Tournament #3082648141, $0.98+$0.12 USD Hold'em No Limit - Level VII (60/120) - 2020/12/27 21:10:00 EET [2020/12/27 14:10:00 ET]
Table '3082648141 153' 9-max Seat #6 is the button
Seat 1: AAleKKsei Z (5522 in chips) 
Seat 2: stefogr (10709 in chips) 
Seat 3: mcollins01 (7313 in chips) 
Seat 4: andreas8866 (6294 in chips) 
Seat 5: SLAPSTICK_M3 (4609 in chips) 
Seat 6: 9Black3 (3006 in chips) 
Seat 7: jcarlos.vale (5468 in chips) 
Seat 8: GonzalezRock (8660 in chips) 
Seat 9: L@z@reva (11272 in chips) 
AAleKKsei Z: posts the ante 12
stefogr: posts the ante 12
mcollins01: posts the ante 12
andreas8866: posts the ante 12
SLAPSTICK_M3: posts the ante 12
9Black3: posts the ante 12
jcarlos.vale: posts the ante 12
GonzalezRock: posts the ante 12
L@z@reva: posts the ante 12
jcarlos.vale: posts small blind 60
GonzalezRock: posts big blind 120
*** HOLE CARDS ***
Dealt to jcarlos.vale [Tc 9h]
L@z@reva: raises 120 to 240
AAleKKsei Z: folds 
stefogr: folds 
mcollins01: raises 540 to 780
andreas8866: folds 
SLAPSTICK_M3: folds 
9Black3: folds 
jcarlos.vale: folds 
GonzalezRock: folds 
L@z@reva: folds 
Uncalled bet (540) returned to mcollins01
mcollins01 collected 768 from pot
*** SUMMARY ***
Total pot 768 | Rake 0 
Seat 1: AAleKKsei Z folded before Flop (didn't bet)
Seat 2: stefogr folded before Flop (didn't bet)
Seat 3: mcollins01 collected (768)
Seat 4: andreas8866 folded before Flop (didn't bet)
Seat 5: SLAPSTICK_M3 folded before Flop (didn't bet)
Seat 6: 9Black3 (button) folded before Flop (didn't bet)
Seat 7: jcarlos.vale (small blind) folded before Flop
Seat 8: GonzalezRock (big blind) folded before Flop
Seat 9: L@z@reva folded before Flop



PokerStars Hand #221911589714: Tournament #3082648141, $0.98+$0.12 USD Hold'em No Limit - Level VII (60/120) - 2020/12/27 21:10:52 EET [2020/12/27 14:10:52 ET]
Table '3082648141 153' 9-max Seat #7 is the button
Seat 1: AAleKKsei Z (5510 in chips) 
Seat 2: stefogr (10697 in chips) 
Seat 3: mcollins01 (7829 in chips) 
Seat 4: andreas8866 (6282 in chips) 
Seat 5: SLAPSTICK_M3 (4597 in chips) 
Seat 6: 9Black3 (2994 in chips) 
Seat 7: jcarlos.vale (5396 in chips) 
Seat 8: GonzalezRock (8528 in chips) 
Seat 9: L@z@reva (11020 in chips) 
AAleKKsei Z: posts the ante 12
stefogr: posts the ante 12
mcollins01: posts the ante 12
andreas8866: posts the ante 12
SLAPSTICK_M3: posts the ante 12
9Black3: posts the ante 12
jcarlos.vale: posts the ante 12
GonzalezRock: posts the ante 12
L@z@reva: posts the ante 12
GonzalezRock: posts small blind 60
L@z@reva: posts big blind 120
*** HOLE CARDS ***
Dealt to jcarlos.vale [3h Ad]
AAleKKsei Z: folds 
stefogr: folds 
mcollins01: folds 
andreas8866: folds 
SLAPSTICK_M3: folds 
9Black3: folds 
jcarlos.vale: folds 
GonzalezRock has timed out
GonzalezRock: folds 
GonzalezRock is sitting out
Uncalled bet (60) returned to L@z@reva
L@z@reva collected 228 from pot
L@z@reva: doesn't show handDTO
*** SUMMARY ***
Total pot 228 | Rake 0 
Seat 1: AAleKKsei Z folded before Flop (didn't bet)
Seat 2: stefogr folded before Flop (didn't bet)
Seat 3: mcollins01 folded before Flop (didn't bet)
Seat 4: andreas8866 folded before Flop (didn't bet)
Seat 5: SLAPSTICK_M3 folded before Flop (didn't bet)
Seat 6: 9Black3 folded before Flop (didn't bet)
Seat 7: jcarlos.vale (button) folded before Flop (didn't bet)
Seat 8: GonzalezRock (small blind) folded before Flop
Seat 9: L@z@reva (big blind) collected (228)



PokerStars Hand #221911617580: Tournament #3082648141, $0.98+$0.12 USD Hold'em No Limit - Level VII (60/120) - 2020/12/27 21:11:22 EET [2020/12/27 14:11:22 ET]
Table '3082648141 153' 9-max Seat #8 is the button
Seat 1: AAleKKsei Z (5498 in chips) 
Seat 2: stefogr (10685 in chips) 
Seat 3: mcollins01 (7817 in chips) 
Seat 4: andreas8866 (6270 in chips) 
Seat 5: SLAPSTICK_M3 (4585 in chips) 
Seat 6: 9Black3 (2982 in chips) 
Seat 7: jcarlos.vale (5384 in chips) 
Seat 8: GonzalezRock (8456 in chips) is sitting out
Seat 9: L@z@reva (11176 in chips) 
AAleKKsei Z: posts the ante 12
stefogr: posts the ante 12
mcollins01: posts the ante 12
andreas8866: posts the ante 12
SLAPSTICK_M3: posts the ante 12
9Black3: posts the ante 12
jcarlos.vale: posts the ante 12
GonzalezRock: posts the ante 12
L@z@reva: posts the ante 12
L@z@reva: posts small blind 60
AAleKKsei Z: posts big blind 120
*** HOLE CARDS ***
Dealt to jcarlos.vale [6c 9c]
GonzalezRock has returned
stefogr: folds 
mcollins01: raises 150 to 270
andreas8866: folds 
SLAPSTICK_M3: folds 
9Black3: folds 
jcarlos.vale: folds 
GonzalezRock has timed out
GonzalezRock: folds 
GonzalezRock is sitting out
GonzalezRock has returned
L@z@reva: folds 
AAleKKsei Z: folds 
Uncalled bet (150) returned to mcollins01
mcollins01 collected 408 from pot
mcollins01: doesn't show handDTO
*** SUMMARY ***
Total pot 408 | Rake 0 
Seat 1: AAleKKsei Z (big blind) folded before Flop
Seat 2: stefogr folded before Flop (didn't bet)
Seat 3: mcollins01 collected (408)
Seat 4: andreas8866 folded before Flop (didn't bet)
Seat 5: SLAPSTICK_M3 folded before Flop (didn't bet)
Seat 6: 9Black3 folded before Flop (didn't bet)
Seat 7: jcarlos.vale folded before Flop (didn't bet)
Seat 8: GonzalezRock (button) folded before Flop (didn't bet)
Seat 9: L@z@reva (small blind) folded before Flop



PokerStars Hand #221911647866: Tournament #3082648141, $0.98+$0.12 USD Hold'em No Limit - Level VII (60/120) - 2020/12/27 21:11:54 EET [2020/12/27 14:11:54 ET]
Table '3082648141 153' 9-max Seat #9 is the button
Seat 1: AAleKKsei Z (5366 in chips) 
Seat 2: stefogr (10673 in chips) 
Seat 3: mcollins01 (8093 in chips) 
Seat 4: andreas8866 (6258 in chips) 
Seat 5: SLAPSTICK_M3 (4573 in chips) 
Seat 6: 9Black3 (2970 in chips) 
Seat 7: jcarlos.vale (5372 in chips) 
Seat 8: GonzalezRock (8444 in chips) 
Seat 9: L@z@reva (11104 in chips) 
AAleKKsei Z: posts the ante 12
stefogr: posts the ante 12
mcollins01: posts the ante 12
andreas8866: posts the ante 12
SLAPSTICK_M3: posts the ante 12
9Black3: posts the ante 12
jcarlos.vale: posts the ante 12
GonzalezRock: posts the ante 12
L@z@reva: posts the ante 12
AAleKKsei Z: posts small blind 60
stefogr: posts big blind 120
*** HOLE CARDS ***
Dealt to jcarlos.vale [Kh 9d]
mcollins01: folds 
andreas8866: folds 
SLAPSTICK_M3: folds 
9Black3: folds 
jcarlos.vale: folds 
GonzalezRock has timed out
GonzalezRock: folds 
GonzalezRock is sitting out
GonzalezRock has returned
L@z@reva: raises 408 to 528
AAleKKsei Z: folds 
stefogr: folds 
Uncalled bet (408) returned to L@z@reva
L@z@reva collected 408 from pot
L@z@reva: doesn't show handDTO
*** SUMMARY ***
Total pot 408 | Rake 0 
Seat 1: AAleKKsei Z (small blind) folded before Flop
Seat 2: stefogr (big blind) folded before Flop
Seat 3: mcollins01 folded before Flop (didn't bet)
Seat 4: andreas8866 folded before Flop (didn't bet)
Seat 5: SLAPSTICK_M3 folded before Flop (didn't bet)
Seat 6: 9Black3 folded before Flop (didn't bet)
Seat 7: jcarlos.vale folded before Flop (didn't bet)
Seat 8: GonzalezRock folded before Flop (didn't bet)
Seat 9: L@z@reva (button) collected (408)



PokerStars Hand #221911695615: Tournament #3082648141, $0.98+$0.12 USD Hold'em No Limit - Level VII (60/120) - 2020/12/27 21:12:46 EET [2020/12/27 14:12:46 ET]
Table '3082648141 153' 9-max Seat #1 is the button
Seat 1: AAleKKsei Z (5294 in chips) 
Seat 2: stefogr (10541 in chips) 
Seat 3: mcollins01 (8081 in chips) 
Seat 4: andreas8866 (6246 in chips) 
Seat 5: SLAPSTICK_M3 (4561 in chips) 
Seat 6: 9Black3 (2958 in chips) 
Seat 7: jcarlos.vale (5360 in chips) 
Seat 8: GonzalezRock (8432 in chips) 
Seat 9: L@z@reva (11380 in chips) 
AAleKKsei Z: posts the ante 12
stefogr: posts the ante 12
mcollins01: posts the ante 12
andreas8866: posts the ante 12
SLAPSTICK_M3: posts the ante 12
9Black3: posts the ante 12
jcarlos.vale: posts the ante 12
GonzalezRock: posts the ante 12
L@z@reva: posts the ante 12
stefogr: posts small blind 60
mcollins01: posts big blind 120
*** HOLE CARDS ***
Dealt to jcarlos.vale [4s 9h]
andreas8866: folds 
SLAPSTICK_M3: folds 
9Black3: folds 
jcarlos.vale: folds 
GonzalezRock: folds 
L@z@reva: folds 
AAleKKsei Z: folds 
stefogr: raises 144 to 264
mcollins01: calls 144
*** FLOP *** [Qc Qh 6d]
stefogr: checks 
mcollins01: checks 
*** TURN *** [Qc Qh 6d] [Ts]
stefogr: bets 300
mcollins01: folds 
Uncalled bet (300) returned to stefogr
stefogr collected 636 from pot
*** SUMMARY ***
Total pot 636 | Rake 0 
Board [Qc Qh 6d Ts]
Seat 1: AAleKKsei Z (button) folded before Flop (didn't bet)
Seat 2: stefogr (small blind) collected (636)
Seat 3: mcollins01 (big blind) folded on the Turn
Seat 4: andreas8866 folded before Flop (didn't bet)
Seat 5: SLAPSTICK_M3 folded before Flop (didn't bet)
Seat 6: 9Black3 folded before Flop (didn't bet)
Seat 7: jcarlos.vale folded before Flop (didn't bet)
Seat 8: GonzalezRock folded before Flop (didn't bet)
Seat 9: L@z@reva folded before Flop (didn't bet)



PokerStars Hand #221911756426: Tournament #3082648141, $0.98+$0.12 USD Hold'em No Limit - Level VII (60/120) - 2020/12/27 21:13:52 EET [2020/12/27 14:13:52 ET]
Table '3082648141 153' 9-max Seat #2 is the button
Seat 1: AAleKKsei Z (5282 in chips) 
Seat 2: stefogr (10901 in chips) 
Seat 3: mcollins01 (7805 in chips) 
Seat 4: andreas8866 (6234 in chips) 
Seat 5: SLAPSTICK_M3 (4549 in chips) 
Seat 6: 9Black3 (2946 in chips) 
Seat 7: jcarlos.vale (5348 in chips) 
Seat 8: GonzalezRock (8420 in chips) 
Seat 9: L@z@reva (11368 in chips) 
AAleKKsei Z: posts the ante 12
stefogr: posts the ante 12
mcollins01: posts the ante 12
andreas8866: posts the ante 12
SLAPSTICK_M3: posts the ante 12
9Black3: posts the ante 12
jcarlos.vale: posts the ante 12
GonzalezRock: posts the ante 12
L@z@reva: posts the ante 12
mcollins01: posts small blind 60
andreas8866: posts big blind 120
*** HOLE CARDS ***
Dealt to jcarlos.vale [6d 9d]
SLAPSTICK_M3: raises 144 to 264
9Black3: folds 
jcarlos.vale: folds 
GonzalezRock has timed out
GonzalezRock: folds 
GonzalezRock is sitting out
GonzalezRock has returned
L@z@reva: folds 
AAleKKsei Z: folds 
stefogr: folds 
mcollins01: folds 
andreas8866: calls 144
*** FLOP *** [3c 6s Qs]
andreas8866: checks 
SLAPSTICK_M3: bets 348
andreas8866: calls 348
*** TURN *** [3c 6s Qs] [4d]
andreas8866: checks 
SLAPSTICK_M3: bets 480
andreas8866: calls 480
*** RIVER *** [3c 6s Qs 4d] [Td]
andreas8866: checks 
SLAPSTICK_M3: bets 720
andreas8866: calls 720
*** SHOW DOWN ***
SLAPSTICK_M3: shows [Qd As] (a pair of Queens)
andreas8866: mucks handDTO
SLAPSTICK_M3 collected 3792 from pot
*** SUMMARY ***
Total pot 3792 | Rake 0 
Board [3c 6s Qs 4d Td]
Seat 1: AAleKKsei Z folded before Flop (didn't bet)
Seat 2: stefogr (button) folded before Flop (didn't bet)
Seat 3: mcollins01 (small blind) folded before Flop
Seat 4: andreas8866 (big blind) mucked [7s 7d]
Seat 5: SLAPSTICK_M3 showed [Qd As] and won (3792) with a pair of Queens
Seat 6: 9Black3 folded before Flop (didn't bet)
Seat 7: jcarlos.vale folded before Flop (didn't bet)
Seat 8: GonzalezRock folded before Flop (didn't bet)
Seat 9: L@z@reva folded before Flop (didn't bet)



PokerStars Hand #221911825289: Tournament #3082648141, $0.98+$0.12 USD Hold'em No Limit - Level VII (60/120) - 2020/12/27 21:15:07 EET [2020/12/27 14:15:07 ET]
Table '3082648141 153' 9-max Seat #3 is the button
Seat 1: AAleKKsei Z (5270 in chips) 
Seat 2: stefogr (10889 in chips) 
Seat 3: mcollins01 (7733 in chips) 
Seat 4: andreas8866 (4410 in chips) 
Seat 5: SLAPSTICK_M3 (6517 in chips) 
Seat 6: 9Black3 (2934 in chips) 
Seat 7: jcarlos.vale (5336 in chips) 
Seat 8: GonzalezRock (8408 in chips) 
Seat 9: L@z@reva (11356 in chips) 
AAleKKsei Z: posts the ante 12
stefogr: posts the ante 12
mcollins01: posts the ante 12
andreas8866: posts the ante 12
SLAPSTICK_M3: posts the ante 12
9Black3: posts the ante 12
jcarlos.vale: posts the ante 12
GonzalezRock: posts the ante 12
L@z@reva: posts the ante 12
andreas8866: posts small blind 60
SLAPSTICK_M3: posts big blind 120
*** HOLE CARDS ***
Dealt to jcarlos.vale [3d Qs]
9Black3: folds 
jcarlos.vale: folds 
GonzalezRock: raises 120 to 240
L@z@reva: folds 
AAleKKsei Z: folds 
stefogr: folds 
mcollins01: folds 
andreas8866: calls 180
SLAPSTICK_M3: calls 120
*** FLOP *** [8s 2c Ks]
andreas8866: checks 
SLAPSTICK_M3: bets 360
GonzalezRock: calls 360
andreas8866: calls 360
*** TURN *** [8s 2c Ks] [Kd]
andreas8866: checks 
SLAPSTICK_M3: checks 
GonzalezRock: checks 
*** RIVER *** [8s 2c Ks Kd] [5d]
andreas8866: checks 
SLAPSTICK_M3: bets 1080
GonzalezRock: folds 
andreas8866: folds 
Uncalled bet (1080) returned to SLAPSTICK_M3
SLAPSTICK_M3 collected 1908 from pot
SLAPSTICK_M3: doesn't show handDTO
*** SUMMARY ***
Total pot 1908 | Rake 0 
Board [8s 2c Ks Kd 5d]
Seat 1: AAleKKsei Z folded before Flop (didn't bet)
Seat 2: stefogr folded before Flop (didn't bet)
Seat 3: mcollins01 (button) folded before Flop (didn't bet)
Seat 4: andreas8866 (small blind) folded on the River
Seat 5: SLAPSTICK_M3 (big blind) collected (1908)
Seat 6: 9Black3 folded before Flop (didn't bet)
Seat 7: jcarlos.vale folded before Flop (didn't bet)
Seat 8: GonzalezRock folded on the River
Seat 9: L@z@reva folded before Flop (didn't bet)



PokerStars Hand #221911913804: Tournament #3082648141, $0.98+$0.12 USD Hold'em No Limit - Level VII (60/120) - 2020/12/27 21:16:43 EET [2020/12/27 14:16:43 ET]
Table '3082648141 153' 9-max Seat #4 is the button
Seat 1: AAleKKsei Z (5258 in chips) 
Seat 2: stefogr (10877 in chips) 
Seat 3: mcollins01 (7721 in chips) 
Seat 4: andreas8866 (3798 in chips) 
Seat 5: SLAPSTICK_M3 (7813 in chips) 
Seat 6: 9Black3 (2922 in chips) 
Seat 7: jcarlos.vale (5324 in chips) 
Seat 8: GonzalezRock (7796 in chips) 
Seat 9: L@z@reva (11344 in chips) 
AAleKKsei Z: posts the ante 12
stefogr: posts the ante 12
mcollins01: posts the ante 12
andreas8866: posts the ante 12
SLAPSTICK_M3: posts the ante 12
9Black3: posts the ante 12
jcarlos.vale: posts the ante 12
GonzalezRock: posts the ante 12
L@z@reva: posts the ante 12
SLAPSTICK_M3: posts small blind 60
9Black3: posts big blind 120
*** HOLE CARDS ***
Dealt to jcarlos.vale [2c Ac]
jcarlos.vale: folds 
GonzalezRock: folds 
L@z@reva: folds 
AAleKKsei Z: folds 
stefogr: raises 144 to 264
mcollins01: folds 
andreas8866: folds 
SLAPSTICK_M3: folds 
9Black3: calls 144
*** FLOP *** [Ts 4h Ad]
9Black3: checks 
stefogr: bets 264
9Black3: folds 
Uncalled bet (264) returned to stefogr
stefogr collected 696 from pot
*** SUMMARY ***
Total pot 696 | Rake 0 
Board [Ts 4h Ad]
Seat 1: AAleKKsei Z folded before Flop (didn't bet)
Seat 2: stefogr collected (696)
Seat 3: mcollins01 folded before Flop (didn't bet)
Seat 4: andreas8866 (button) folded before Flop (didn't bet)
Seat 5: SLAPSTICK_M3 (small blind) folded before Flop
Seat 6: 9Black3 (big blind) folded on the Flop
Seat 7: jcarlos.vale folded before Flop (didn't bet)
Seat 8: GonzalezRock folded before Flop (didn't bet)
Seat 9: L@z@reva folded before Flop (didn't bet)



PokerStars Hand #221911951768: Tournament #3082648141, $0.98+$0.12 USD Hold'em No Limit - Level VII (60/120) - 2020/12/27 21:17:18 EET [2020/12/27 14:17:18 ET]
Table '3082648141 153' 9-max Seat #5 is the button
Seat 1: AAleKKsei Z (5246 in chips) 
Seat 2: stefogr (11297 in chips) 
Seat 3: mcollins01 (7709 in chips) 
Seat 4: andreas8866 (3786 in chips) 
Seat 5: SLAPSTICK_M3 (7741 in chips) 
Seat 6: 9Black3 (2646 in chips) 
Seat 7: jcarlos.vale (5312 in chips) 
Seat 8: GonzalezRock (7784 in chips) 
Seat 9: L@z@reva (11332 in chips) 
AAleKKsei Z: posts the ante 12
stefogr: posts the ante 12
mcollins01: posts the ante 12
andreas8866: posts the ante 12
SLAPSTICK_M3: posts the ante 12
9Black3: posts the ante 12
jcarlos.vale: posts the ante 12
GonzalezRock: posts the ante 12
L@z@reva: posts the ante 12
9Black3: posts small blind 60
jcarlos.vale: posts big blind 120
*** HOLE CARDS ***
Dealt to jcarlos.vale [2s 3h]
GonzalezRock: folds 
L@z@reva: folds 
AAleKKsei Z: folds 
stefogr: folds 
mcollins01: folds 
andreas8866: folds 
SLAPSTICK_M3: folds 
9Black3: folds 
Uncalled bet (60) returned to jcarlos.vale
jcarlos.vale collected 228 from pot
jcarlos.vale: doesn't show handDTO
*** SUMMARY ***
Total pot 228 | Rake 0 
Seat 1: AAleKKsei Z folded before Flop (didn't bet)
Seat 2: stefogr folded before Flop (didn't bet)
Seat 3: mcollins01 folded before Flop (didn't bet)
Seat 4: andreas8866 folded before Flop (didn't bet)
Seat 5: SLAPSTICK_M3 (button) folded before Flop (didn't bet)
Seat 6: 9Black3 (small blind) folded before Flop
Seat 7: jcarlos.vale (big blind) collected (228)
Seat 8: GonzalezRock folded before Flop (didn't bet)
Seat 9: L@z@reva folded before Flop (didn't bet)



PokerStars Hand #221911986965: Tournament #3082648141, $0.98+$0.12 USD Hold'em No Limit - Level VII (60/120) - 2020/12/27 21:17:57 EET [2020/12/27 14:17:57 ET]
Table '3082648141 153' 9-max Seat #6 is the button
Seat 1: AAleKKsei Z (5234 in chips) 
Seat 2: stefogr (11285 in chips) 
Seat 3: mcollins01 (7697 in chips) 
Seat 4: andreas8866 (3774 in chips) 
Seat 5: SLAPSTICK_M3 (7729 in chips) 
Seat 6: 9Black3 (2574 in chips) 
Seat 7: jcarlos.vale (5468 in chips) 
Seat 8: GonzalezRock (7772 in chips) 
Seat 9: L@z@reva (11320 in chips) 
AAleKKsei Z: posts the ante 12
stefogr: posts the ante 12
mcollins01: posts the ante 12
andreas8866: posts the ante 12
SLAPSTICK_M3: posts the ante 12
9Black3: posts the ante 12
jcarlos.vale: posts the ante 12
GonzalezRock: posts the ante 12
L@z@reva: posts the ante 12
jcarlos.vale: posts small blind 60
GonzalezRock: posts big blind 120
*** HOLE CARDS ***
Dealt to jcarlos.vale [Ah Ad]
L@z@reva: folds 
AAleKKsei Z: folds 
stefogr: folds 
mcollins01: folds 
andreas8866: folds 
SLAPSTICK_M3: raises 144 to 264
9Black3: folds 
jcarlos.vale: raises 216 to 480
GonzalezRock: folds 
SLAPSTICK_M3: calls 216
*** FLOP *** [Jc 8d 2s]
jcarlos.vale: bets 891
SLAPSTICK_M3: folds 
Uncalled bet (891) returned to jcarlos.vale
jcarlos.vale collected 1188 from pot
jcarlos.vale: doesn't show handDTO
*** SUMMARY ***
Total pot 1188 | Rake 0 
Board [Jc 8d 2s]
Seat 1: AAleKKsei Z folded before Flop (didn't bet)
Seat 2: stefogr folded before Flop (didn't bet)
Seat 3: mcollins01 folded before Flop (didn't bet)
Seat 4: andreas8866 folded before Flop (didn't bet)
Seat 5: SLAPSTICK_M3 folded on the Flop
Seat 6: 9Black3 (button) folded before Flop (didn't bet)
Seat 7: jcarlos.vale (small blind) collected (1188)
Seat 8: GonzalezRock (big blind) folded before Flop
Seat 9: L@z@reva folded before Flop (didn't bet)



PokerStars Hand #221912033108: Tournament #3082648141, $0.98+$0.12 USD Hold'em No Limit - Level VII (60/120) - 2020/12/27 21:18:47 EET [2020/12/27 14:18:47 ET]
Table '3082648141 153' 9-max Seat #7 is the button
Seat 1: AAleKKsei Z (5222 in chips) 
Seat 2: stefogr (11273 in chips) 
Seat 3: mcollins01 (7685 in chips) 
Seat 4: andreas8866 (3762 in chips) 
Seat 5: SLAPSTICK_M3 (7237 in chips) 
Seat 6: 9Black3 (2562 in chips) 
Seat 7: jcarlos.vale (6164 in chips) 
Seat 8: GonzalezRock (7640 in chips) 
Seat 9: L@z@reva (11308 in chips) 
AAleKKsei Z: posts the ante 12
stefogr: posts the ante 12
mcollins01: posts the ante 12
andreas8866: posts the ante 12
SLAPSTICK_M3: posts the ante 12
9Black3: posts the ante 12
jcarlos.vale: posts the ante 12
GonzalezRock: posts the ante 12
L@z@reva: posts the ante 12
GonzalezRock: posts small blind 60
L@z@reva: posts big blind 120
*** HOLE CARDS ***
Dealt to jcarlos.vale [Jd Qc]
AAleKKsei Z: folds 
stefogr: raises 144 to 264
mcollins01: folds 
andreas8866: folds 
SLAPSTICK_M3: folds 
9Black3: folds 
jcarlos.vale: folds 
GonzalezRock has timed out
GonzalezRock: folds 
GonzalezRock is sitting out
L@z@reva: folds 
Uncalled bet (144) returned to stefogr
stefogr collected 408 from pot
*** SUMMARY ***
Total pot 408 | Rake 0 
Seat 1: AAleKKsei Z folded before Flop (didn't bet)
Seat 2: stefogr collected (408)
Seat 3: mcollins01 folded before Flop (didn't bet)
Seat 4: andreas8866 folded before Flop (didn't bet)
Seat 5: SLAPSTICK_M3 folded before Flop (didn't bet)
Seat 6: 9Black3 folded before Flop (didn't bet)
Seat 7: jcarlos.vale (button) folded before Flop (didn't bet)
Seat 8: GonzalezRock (small blind) folded before Flop
Seat 9: L@z@reva (big blind) folded before Flop



PokerStars Hand #221912072411: Tournament #3082648141, $0.98+$0.12 USD Hold'em No Limit - Level VIII (75/150) - 2020/12/27 21:19:30 EET [2020/12/27 14:19:30 ET]
Table '3082648141 153' 9-max Seat #8 is the button
Seat 1: AAleKKsei Z (5210 in chips) 
Seat 2: stefogr (11549 in chips) 
Seat 3: mcollins01 (7673 in chips) 
Seat 4: andreas8866 (3750 in chips) 
Seat 5: SLAPSTICK_M3 (7225 in chips) 
Seat 6: 9Black3 (2550 in chips) 
Seat 7: jcarlos.vale (6152 in chips) 
Seat 8: GonzalezRock (7568 in chips) is sitting out
Seat 9: L@z@reva (11176 in chips) 
AAleKKsei Z: posts the ante 15
stefogr: posts the ante 15
mcollins01: posts the ante 15
andreas8866: posts the ante 15
SLAPSTICK_M3: posts the ante 15
9Black3: posts the ante 15
jcarlos.vale: posts the ante 15
GonzalezRock: posts the ante 15
L@z@reva: posts the ante 15
L@z@reva: posts small blind 75
AAleKKsei Z: posts big blind 150
*** HOLE CARDS ***
Dealt to jcarlos.vale [7c Js]
stefogr: raises 180 to 330
mcollins01: folds 
andreas8866: folds 
SLAPSTICK_M3: folds 
9Black3: folds 
jcarlos.vale: folds 
GonzalezRock: folds 
L@z@reva: calls 255
AAleKKsei Z: folds 
*** FLOP *** [Kc Kh 9h]
GonzalezRock has returned
L@z@reva: bets 472
stefogr: folds 
Uncalled bet (472) returned to L@z@reva
L@z@reva collected 945 from pot
L@z@reva: doesn't show handDTO
*** SUMMARY ***
Total pot 945 | Rake 0 
Board [Kc Kh 9h]
Seat 1: AAleKKsei Z (big blind) folded before Flop
Seat 2: stefogr folded on the Flop
Seat 3: mcollins01 folded before Flop (didn't bet)
Seat 4: andreas8866 folded before Flop (didn't bet)
Seat 5: SLAPSTICK_M3 folded before Flop (didn't bet)
Seat 6: 9Black3 folded before Flop (didn't bet)
Seat 7: jcarlos.vale folded before Flop (didn't bet)
Seat 8: GonzalezRock (button) folded before Flop (didn't bet)
Seat 9: L@z@reva (small blind) collected (945)



PokerStars Hand #221912104458: Tournament #3082648141, $0.98+$0.12 USD Hold'em No Limit - Level VIII (75/150) - 2020/12/27 21:20:05 EET [2020/12/27 14:20:05 ET]
Table '3082648141 153' 9-max Seat #9 is the button
Seat 1: AAleKKsei Z (5045 in chips) 
Seat 2: stefogr (11204 in chips) 
Seat 3: mcollins01 (7658 in chips) 
Seat 4: andreas8866 (3735 in chips) 
Seat 5: SLAPSTICK_M3 (7210 in chips) 
Seat 6: 9Black3 (2535 in chips) 
Seat 7: jcarlos.vale (6137 in chips) 
Seat 8: GonzalezRock (7553 in chips) 
Seat 9: L@z@reva (11776 in chips) 
AAleKKsei Z: posts the ante 15
stefogr: posts the ante 15
mcollins01: posts the ante 15
andreas8866: posts the ante 15
SLAPSTICK_M3: posts the ante 15
9Black3: posts the ante 15
jcarlos.vale: posts the ante 15
GonzalezRock: posts the ante 15
L@z@reva: posts the ante 15
AAleKKsei Z: posts small blind 75
stefogr: posts big blind 150
*** HOLE CARDS ***
Dealt to jcarlos.vale [6s 7s]
mcollins01: folds 
andreas8866: folds 
SLAPSTICK_M3: folds 
9Black3: folds 
jcarlos.vale: raises 240 to 390
GonzalezRock: folds 
L@z@reva: folds 
AAleKKsei Z: folds 
stefogr: calls 240
*** FLOP *** [Jh 8h 4h]
stefogr: checks 
jcarlos.vale: bets 300
stefogr: folds 
Uncalled bet (300) returned to jcarlos.vale
jcarlos.vale collected 990 from pot
jcarlos.vale: doesn't show handDTO
*** SUMMARY ***
Total pot 990 | Rake 0 
Board [Jh 8h 4h]
Seat 1: AAleKKsei Z (small blind) folded before Flop
Seat 2: stefogr (big blind) folded on the Flop
Seat 3: mcollins01 folded before Flop (didn't bet)
Seat 4: andreas8866 folded before Flop (didn't bet)
Seat 5: SLAPSTICK_M3 folded before Flop (didn't bet)
Seat 6: 9Black3 folded before Flop (didn't bet)
Seat 7: jcarlos.vale collected (990)
Seat 8: GonzalezRock folded before Flop (didn't bet)
Seat 9: L@z@reva (button) folded before Flop (didn't bet)



PokerStars Hand #221912139938: Tournament #3082648141, $0.98+$0.12 USD Hold'em No Limit - Level VIII (75/150) - 2020/12/27 21:20:43 EET [2020/12/27 14:20:43 ET]
Table '3082648141 153' 9-max Seat #1 is the button
Seat 1: AAleKKsei Z (4955 in chips) 
Seat 2: stefogr (10799 in chips) 
Seat 3: mcollins01 (7643 in chips) 
Seat 4: andreas8866 (3720 in chips) 
Seat 5: SLAPSTICK_M3 (7195 in chips) 
Seat 6: 9Black3 (2520 in chips) 
Seat 7: jcarlos.vale (6722 in chips) 
Seat 8: GonzalezRock (7538 in chips) 
Seat 9: L@z@reva (11761 in chips) 
AAleKKsei Z: posts the ante 15
stefogr: posts the ante 15
mcollins01: posts the ante 15
andreas8866: posts the ante 15
SLAPSTICK_M3: posts the ante 15
9Black3: posts the ante 15
jcarlos.vale: posts the ante 15
GonzalezRock: posts the ante 15
L@z@reva: posts the ante 15
stefogr: posts small blind 75
mcollins01: posts big blind 150
*** HOLE CARDS ***
Dealt to jcarlos.vale [3d 7h]
andreas8866: folds 
SLAPSTICK_M3: folds 
9Black3: folds 
jcarlos.vale: folds 
GonzalezRock: raises 150 to 300
L@z@reva: folds 
AAleKKsei Z: calls 300
stefogr: calls 225
mcollins01: raises 1350 to 1650
GonzalezRock: calls 1350
AAleKKsei Z: folds 
stefogr: folds 
*** FLOP *** [Qs 3h 9h]
mcollins01: checks 
GonzalezRock: bets 2689
mcollins01: raises 3289 to 5978 and is all-in
GonzalezRock: calls 3184 and is all-in
Uncalled bet (105) returned to mcollins01
*** TURN *** [Qs 3h 9h] [Td]
*** RIVER *** [Qs 3h 9h Td] [Qd]
*** SHOW DOWN ***
mcollins01: shows [6c 6h] (two pair, Queens and Sixes)
GonzalezRock: shows [Qh Ad] (three of a kind, Queens)
GonzalezRock collected 15781 from pot
*** SUMMARY ***
Total pot 15781 | Rake 0 
Board [Qs 3h 9h Td Qd]
Seat 1: AAleKKsei Z (button) folded before Flop
Seat 2: stefogr (small blind) folded before Flop
Seat 3: mcollins01 (big blind) showed [6c 6h] and lost with two pair, Queens and Sixes
Seat 4: andreas8866 folded before Flop (didn't bet)
Seat 5: SLAPSTICK_M3 folded before Flop (didn't bet)
Seat 6: 9Black3 folded before Flop (didn't bet)
Seat 7: jcarlos.vale folded before Flop (didn't bet)
Seat 8: GonzalezRock showed [Qh Ad] and won (15781) with three of a kind, Queens
Seat 9: L@z@reva folded before Flop (didn't bet)



PokerStars Hand #221912209461: Tournament #3082648141, $0.98+$0.12 USD Hold'em No Limit - Level VIII (75/150) - 2020/12/27 21:21:59 EET [2020/12/27 14:21:59 ET]
Table '3082648141 153' 9-max Seat #2 is the button
Seat 1: AAleKKsei Z (4640 in chips) 
Seat 2: stefogr (10484 in chips) 
Seat 3: mcollins01 (105 in chips) 
Seat 4: andreas8866 (3705 in chips) 
Seat 5: SLAPSTICK_M3 (7180 in chips) 
Seat 6: 9Black3 (2505 in chips) 
Seat 7: jcarlos.vale (6707 in chips) 
Seat 8: GonzalezRock (15781 in chips) 
Seat 9: L@z@reva (11746 in chips) 
AAleKKsei Z: posts the ante 15
stefogr: posts the ante 15
mcollins01: posts the ante 15
andreas8866: posts the ante 15
SLAPSTICK_M3: posts the ante 15
9Black3: posts the ante 15
jcarlos.vale: posts the ante 15
GonzalezRock: posts the ante 15
L@z@reva: posts the ante 15
mcollins01: posts small blind 75
andreas8866: posts big blind 150
*** HOLE CARDS ***
Dealt to jcarlos.vale [5d Jc]
SLAPSTICK_M3: folds 
9Black3: folds 
jcarlos.vale: folds 
GonzalezRock: raises 150 to 300
L@z@reva: folds 
AAleKKsei Z: folds 
stefogr: folds 
mcollins01: calls 15 and is all-in
andreas8866: folds 
Uncalled bet (150) returned to GonzalezRock
*** FLOP *** [4d 9c 9h]
*** TURN *** [4d 9c 9h] [2s]
*** RIVER *** [4d 9c 9h 2s] [4h]
*** SHOW DOWN ***
GonzalezRock: shows [Kd Td] (two pair, Nines and Fours)
GonzalezRock collected 120 from side pot
mcollins01: shows [7h 9s] (a full house, Nines full of Fours)
mcollins01 collected 405 from main pot
*** SUMMARY ***
Total pot 525 Main pot 405. Side pot 120. | Rake 0 
Board [4d 9c 9h 2s 4h]
Seat 1: AAleKKsei Z folded before Flop (didn't bet)
Seat 2: stefogr (button) folded before Flop (didn't bet)
Seat 3: mcollins01 (small blind) showed [7h 9s] and won (405) with a full house, Nines full of Fours
Seat 4: andreas8866 (big blind) folded before Flop
Seat 5: SLAPSTICK_M3 folded before Flop (didn't bet)
Seat 6: 9Black3 folded before Flop (didn't bet)
Seat 7: jcarlos.vale folded before Flop (didn't bet)
Seat 8: GonzalezRock showed [Kd Td] and won (120) with two pair, Nines and Fours
Seat 9: L@z@reva folded before Flop (didn't bet)



PokerStars Hand #221912246879: Tournament #3082648141, $0.98+$0.12 USD Hold'em No Limit - Level VIII (75/150) - 2020/12/27 21:22:40 EET [2020/12/27 14:22:40 ET]
Table '3082648141 153' 9-max Seat #3 is the button
Seat 1: AAleKKsei Z (4625 in chips) 
Seat 2: stefogr (10469 in chips) 
Seat 3: mcollins01 (405 in chips) 
Seat 4: andreas8866 (3540 in chips) 
Seat 5: SLAPSTICK_M3 (7165 in chips) 
Seat 6: 9Black3 (2490 in chips) 
Seat 7: jcarlos.vale (6692 in chips) 
Seat 8: GonzalezRock (15736 in chips) 
Seat 9: L@z@reva (11731 in chips) 
AAleKKsei Z: posts the ante 15
stefogr: posts the ante 15
mcollins01: posts the ante 15
andreas8866: posts the ante 15
SLAPSTICK_M3: posts the ante 15
9Black3: posts the ante 15
jcarlos.vale: posts the ante 15
GonzalezRock: posts the ante 15
L@z@reva: posts the ante 15
andreas8866: posts small blind 75
SLAPSTICK_M3: posts big blind 150
*** HOLE CARDS ***
Dealt to jcarlos.vale [9d Ks]
9Black3: folds 
jcarlos.vale: folds 
GonzalezRock: raises 150 to 300
L@z@reva: folds 
AAleKKsei Z: folds 
stefogr: folds 
mcollins01 said, "Nitting with AQ love to see i"
mcollins01 said, "t"
mcollins01: folds 
andreas8866: folds 
SLAPSTICK_M3: calls 150
*** FLOP *** [5h 2s Ah]
SLAPSTICK_M3: checks 
GonzalezRock: bets 540
SLAPSTICK_M3: calls 540
*** TURN *** [5h 2s Ah] [8s]
SLAPSTICK_M3: checks 
GonzalezRock: checks 
*** RIVER *** [5h 2s Ah 8s] [9h]
SLAPSTICK_M3: bets 1418
GonzalezRock: calls 1418
*** SHOW DOWN ***
SLAPSTICK_M3: shows [2c Ac] (two pair, Aces and Deuces)
GonzalezRock: mucks handDTO
SLAPSTICK_M3 collected 4726 from pot
*** SUMMARY ***
Total pot 4726 | Rake 0 
Board [5h 2s Ah 8s 9h]
Seat 1: AAleKKsei Z folded before Flop (didn't bet)
Seat 2: stefogr folded before Flop (didn't bet)
Seat 3: mcollins01 (button) folded before Flop (didn't bet)
Seat 4: andreas8866 (small blind) folded before Flop
Seat 5: SLAPSTICK_M3 (big blind) showed [2c Ac] and won (4726) with two pair, Aces and Deuces
Seat 6: 9Black3 folded before Flop (didn't bet)
Seat 7: jcarlos.vale folded before Flop (didn't bet)
Seat 8: GonzalezRock mucked [As Js]
Seat 9: L@z@reva folded before Flop (didn't bet)



PokerStars Hand #221912323345: Tournament #3082648141, $0.98+$0.12 USD Hold'em No Limit - Level VIII (75/150) - 2020/12/27 21:24:03 EET [2020/12/27 14:24:03 ET]
Table '3082648141 153' 9-max Seat #4 is the button
Seat 1: AAleKKsei Z (4610 in chips) 
Seat 2: stefogr (10454 in chips) 
Seat 3: mcollins01 (390 in chips) 
Seat 4: andreas8866 (3450 in chips) 
Seat 5: SLAPSTICK_M3 (9618 in chips) 
Seat 6: 9Black3 (2475 in chips) 
Seat 7: jcarlos.vale (6677 in chips) 
Seat 8: GonzalezRock (13463 in chips) 
Seat 9: L@z@reva (11716 in chips) 
AAleKKsei Z: posts the ante 15
stefogr: posts the ante 15
mcollins01: posts the ante 15
andreas8866: posts the ante 15
SLAPSTICK_M3: posts the ante 15
9Black3: posts the ante 15
jcarlos.vale: posts the ante 15
GonzalezRock: posts the ante 15
L@z@reva: posts the ante 15
SLAPSTICK_M3: posts small blind 75
9Black3: posts big blind 150
*** HOLE CARDS ***
Dealt to jcarlos.vale [2h Ts]
jcarlos.vale: folds 
GonzalezRock: folds 
L@z@reva: folds 
AAleKKsei Z: folds 
stefogr: folds 
mcollins01: raises 195 to 345
andreas8866: calls 345
SLAPSTICK_M3: calls 270
9Black3: raises 2115 to 2460 and is all-in
mcollins01: calls 30 and is all-in
andreas8866: folds 
SLAPSTICK_M3: calls 2115
*** FLOP *** [7c 7h 6h]
*** TURN *** [7c 7h 6h] [As]
*** RIVER *** [7c 7h 6h As] [8s]
*** SHOW DOWN ***
SLAPSTICK_M3: shows [8d 6d] (two pair, Eights and Sevens)
9Black3: shows [Ad Js] (two pair, Aces and Sevens)
9Black3 collected 4170 from side pot
mcollins01: shows [Ks 9h] (a pair of Sevens)
9Black3 collected 1605 from main pot
mcollins01 is sitting out
mcollins01 finished the tournament
*** SUMMARY ***
Total pot 5775 Main pot 1605. Side pot 4170. | Rake 0 
Board [7c 7h 6h As 8s]
Seat 1: AAleKKsei Z folded before Flop (didn't bet)
Seat 2: stefogr folded before Flop (didn't bet)
Seat 3: mcollins01 showed [Ks 9h] and lost with a pair of Sevens
Seat 4: andreas8866 (button) folded before Flop
Seat 5: SLAPSTICK_M3 (small blind) showed [8d 6d] and lost with two pair, Eights and Sevens
Seat 6: 9Black3 (big blind) showed [Ad Js] and won (5775) with two pair, Aces and Sevens
Seat 7: jcarlos.vale folded before Flop (didn't bet)
Seat 8: GonzalezRock folded before Flop (didn't bet)
Seat 9: L@z@reva folded before Flop (didn't bet)



PokerStars Hand #221912373033: Tournament #3082648141, $0.98+$0.12 USD Hold'em No Limit - Level VIII (75/150) - 2020/12/27 21:24:58 EET [2020/12/27 14:24:58 ET]
Table '3082648141 153' 9-max Seat #5 is the button
Seat 1: AAleKKsei Z (4595 in chips) 
Seat 2: stefogr (10439 in chips) 
Seat 4: andreas8866 (3090 in chips) 
Seat 5: SLAPSTICK_M3 (7143 in chips) 
Seat 6: 9Black3 (5775 in chips) 
Seat 7: jcarlos.vale (6662 in chips) 
Seat 8: GonzalezRock (13448 in chips) 
Seat 9: L@z@reva (11701 in chips) 
AAleKKsei Z: posts the ante 15
stefogr: posts the ante 15
andreas8866: posts the ante 15
SLAPSTICK_M3: posts the ante 15
9Black3: posts the ante 15
jcarlos.vale: posts the ante 15
GonzalezRock: posts the ante 15
L@z@reva: posts the ante 15
9Black3: posts small blind 75
jcarlos.vale: posts big blind 150
*** HOLE CARDS ***
Dealt to jcarlos.vale [Qs 8h]
GonzalezRock: folds 
L@z@reva: folds 
AAleKKsei Z: folds 
stefogr: folds 
andreas8866: raises 150 to 300
SLAPSTICK_M3: folds 
9Black3: folds 
jcarlos.vale: folds 
Uncalled bet (150) returned to andreas8866
andreas8866 collected 495 from pot
andreas8866: doesn't show handDTO
*** SUMMARY ***
Total pot 495 | Rake 0 
Seat 1: AAleKKsei Z folded before Flop (didn't bet)
Seat 2: stefogr folded before Flop (didn't bet)
Seat 4: andreas8866 collected (495)
Seat 5: SLAPSTICK_M3 (button) folded before Flop (didn't bet)
Seat 6: 9Black3 (small blind) folded before Flop
Seat 7: jcarlos.vale (big blind) folded before Flop
Seat 8: GonzalezRock folded before Flop (didn't bet)
Seat 9: L@z@reva folded before Flop (didn't bet)



PokerStars Hand #221912401926: Tournament #3082648141, $0.98+$0.12 USD Hold'em No Limit - Level VIII (75/150) - 2020/12/27 21:25:29 EET [2020/12/27 14:25:29 ET]
Table '3082648141 153' 9-max Seat #6 is the button
Seat 1: AAleKKsei Z (4580 in chips) 
Seat 2: stefogr (10424 in chips) 
Seat 3: Jova52078 (5000 in chips) 
Seat 4: andreas8866 (3420 in chips) 
Seat 5: SLAPSTICK_M3 (7128 in chips) 
Seat 6: 9Black3 (5685 in chips) 
Seat 7: jcarlos.vale (6497 in chips) 
Seat 8: GonzalezRock (13433 in chips) 
Seat 9: L@z@reva (11686 in chips) 
AAleKKsei Z: posts the ante 15
stefogr: posts the ante 15
Jova52078: posts the ante 15
andreas8866: posts the ante 15
SLAPSTICK_M3: posts the ante 15
9Black3: posts the ante 15
jcarlos.vale: posts the ante 15
GonzalezRock: posts the ante 15
L@z@reva: posts the ante 15
jcarlos.vale: posts small blind 75
GonzalezRock: posts big blind 150
*** HOLE CARDS ***
Dealt to jcarlos.vale [8d 8s]
L@z@reva: calls 150
AAleKKsei Z: raises 300 to 450
stefogr: folds 
Jova52078: folds 
andreas8866: folds 
SLAPSTICK_M3: folds 
9Black3: folds 
jcarlos.vale: folds 
GonzalezRock: folds 
L@z@reva: folds 
Uncalled bet (300) returned to AAleKKsei Z
AAleKKsei Z collected 660 from pot
AAleKKsei Z: doesn't show handDTO
*** SUMMARY ***
Total pot 660 | Rake 0 
Seat 1: AAleKKsei Z collected (660)
Seat 2: stefogr folded before Flop (didn't bet)
Seat 3: Jova52078 folded before Flop (didn't bet)
Seat 4: andreas8866 folded before Flop (didn't bet)
Seat 5: SLAPSTICK_M3 folded before Flop (didn't bet)
Seat 6: 9Black3 (button) folded before Flop (didn't bet)
Seat 7: jcarlos.vale (small blind) folded before Flop
Seat 8: GonzalezRock (big blind) folded before Flop
Seat 9: L@z@reva folded before Flop



PokerStars Hand #221912453896: Tournament #3082648141, $0.98+$0.12 USD Hold'em No Limit - Level VIII (75/150) - 2020/12/27 21:26:22 EET [2020/12/27 14:26:22 ET]
Table '3082648141 153' 9-max Seat #7 is the button
Seat 1: AAleKKsei Z (5075 in chips) 
Seat 2: stefogr (10409 in chips) 
Seat 3: Jova52078 (4985 in chips) 
Seat 4: andreas8866 (3405 in chips) 
Seat 5: SLAPSTICK_M3 (7113 in chips) 
Seat 6: 9Black3 (5670 in chips) 
Seat 7: jcarlos.vale (6407 in chips) 
Seat 8: GonzalezRock (13268 in chips) 
Seat 9: L@z@reva (11521 in chips) 
AAleKKsei Z: posts the ante 15
stefogr: posts the ante 15
Jova52078: posts the ante 15
andreas8866: posts the ante 15
SLAPSTICK_M3: posts the ante 15
9Black3: posts the ante 15
jcarlos.vale: posts the ante 15
GonzalezRock: posts the ante 15
L@z@reva: posts the ante 15
GonzalezRock: posts small blind 75
L@z@reva: posts big blind 150
*** HOLE CARDS ***
Dealt to jcarlos.vale [Jd Ks]
AAleKKsei Z: folds 
stefogr: folds 
Jova52078: calls 150
andreas8866: folds 
SLAPSTICK_M3: folds 
9Black3: folds 
jcarlos.vale: raises 240 to 390
GonzalezRock: folds 
L@z@reva: calls 240
Jova52078: raises 240 to 630
jcarlos.vale: folds 
L@z@reva: calls 240
*** FLOP *** [2h 4c 6h]
L@z@reva: checks 
Jova52078: bets 750
L@z@reva: calls 750
*** TURN *** [2h 4c 6h] [7c]
L@z@reva: checks 
Jova52078: bets 1050
L@z@reva: calls 1050
*** RIVER *** [2h 4c 6h 7c] [4s]
L@z@reva: bets 9076 and is all-in
Jova52078: folds 
Uncalled bet (9076) returned to L@z@reva
L@z@reva collected 5460 from pot
L@z@reva: doesn't show handDTO
*** SUMMARY ***
Total pot 5460 | Rake 0 
Board [2h 4c 6h 7c 4s]
Seat 1: AAleKKsei Z folded before Flop (didn't bet)
Seat 2: stefogr folded before Flop (didn't bet)
Seat 3: Jova52078 folded on the River
Seat 4: andreas8866 folded before Flop (didn't bet)
Seat 5: SLAPSTICK_M3 folded before Flop (didn't bet)
Seat 6: 9Black3 folded before Flop (didn't bet)
Seat 7: jcarlos.vale (button) folded before Flop
Seat 8: GonzalezRock (small blind) folded before Flop
Seat 9: L@z@reva (big blind) collected (5460)



PokerStars Hand #221912515663: Tournament #3082648141, $0.98+$0.12 USD Hold'em No Limit - Level VIII (75/150) - 2020/12/27 21:27:30 EET [2020/12/27 14:27:30 ET]
Table '3082648141 153' 9-max Seat #8 is the button
Seat 1: AAleKKsei Z (5060 in chips) 
Seat 2: stefogr (10394 in chips) 
Seat 3: Jova52078 (2540 in chips) 
Seat 4: andreas8866 (3390 in chips) 
Seat 5: SLAPSTICK_M3 (7098 in chips) 
Seat 6: 9Black3 (5655 in chips) 
Seat 7: jcarlos.vale (6002 in chips) 
Seat 8: GonzalezRock (13178 in chips) 
Seat 9: L@z@reva (14536 in chips) 
AAleKKsei Z: posts the ante 15
stefogr: posts the ante 15
Jova52078: posts the ante 15
andreas8866: posts the ante 15
SLAPSTICK_M3: posts the ante 15
9Black3: posts the ante 15
jcarlos.vale: posts the ante 15
GonzalezRock: posts the ante 15
L@z@reva: posts the ante 15
L@z@reva: posts small blind 75
AAleKKsei Z: posts big blind 150
*** HOLE CARDS ***
Dealt to jcarlos.vale [Ts 8s]
stefogr: raises 180 to 330
Jova52078: raises 180 to 510
andreas8866: folds 
SLAPSTICK_M3: folds 
9Black3: folds 
jcarlos.vale: folds 
GonzalezRock: folds 
L@z@reva: folds 
AAleKKsei Z: folds 
stefogr: raises 1380 to 1890
Jova52078: raises 635 to 2525 and is all-in
stefogr: calls 635
*** FLOP *** [8c 4h Qh]
*** TURN *** [8c 4h Qh] [9d]
*** RIVER *** [8c 4h Qh 9d] [Qc]
*** SHOW DOWN ***
stefogr: shows [Kh Kd] (two pair, Kings and Queens)
Jova52078: shows [Ah 9c] (two pair, Queens and Nines)
stefogr collected 5410 from pot
Jova52078 finished the tournament
*** SUMMARY ***
Total pot 5410 | Rake 0 
Board [8c 4h Qh 9d Qc]
Seat 1: AAleKKsei Z (big blind) folded before Flop
Seat 2: stefogr showed [Kh Kd] and won (5410) with two pair, Kings and Queens
Seat 3: Jova52078 showed [Ah 9c] and lost with two pair, Queens and Nines
Seat 4: andreas8866 folded before Flop (didn't bet)
Seat 5: SLAPSTICK_M3 folded before Flop (didn't bet)
Seat 6: 9Black3 folded before Flop (didn't bet)
Seat 7: jcarlos.vale folded before Flop (didn't bet)
Seat 8: GonzalezRock (button) folded before Flop (didn't bet)
Seat 9: L@z@reva (small blind) folded before Flop



PokerStars Hand #221912563606: Tournament #3082648141, $0.98+$0.12 USD Hold'em No Limit - Level VIII (75/150) - 2020/12/27 21:28:23 EET [2020/12/27 14:28:23 ET]
Table '3082648141 153' 9-max Seat #9 is the button
Seat 1: AAleKKsei Z (4895 in chips) 
Seat 2: stefogr (13264 in chips) 
Seat 4: andreas8866 (3375 in chips) 
Seat 5: SLAPSTICK_M3 (7083 in chips) 
Seat 6: 9Black3 (5640 in chips) 
Seat 7: jcarlos.vale (5987 in chips) 
Seat 8: GonzalezRock (13163 in chips) 
Seat 9: L@z@reva (14446 in chips) 
AAleKKsei Z: posts the ante 15
stefogr: posts the ante 15
andreas8866: posts the ante 15
SLAPSTICK_M3: posts the ante 15
9Black3: posts the ante 15
jcarlos.vale: posts the ante 15
GonzalezRock: posts the ante 15
L@z@reva: posts the ante 15
AAleKKsei Z: posts small blind 75
stefogr: posts big blind 150
*** HOLE CARDS ***
Dealt to jcarlos.vale [Jd 9s]
andreas8866: folds 
SLAPSTICK_M3: folds 
9Black3: folds 
jcarlos.vale: folds 
GonzalezRock: raises 150 to 300
L@z@reva: calls 300
AAleKKsei Z: calls 225
stefogr: calls 150
*** FLOP *** [3s 8s Tc]
AAleKKsei Z: bets 1320
stefogr: calls 1320
GonzalezRock: folds 
L@z@reva: calls 1320
*** TURN *** [3s 8s Tc] [4h]
AAleKKsei Z: bets 3260 and is all-in
stefogr: folds 
L@z@reva: calls 3260
*** RIVER *** [3s 8s Tc 4h] [Ks]
*** SHOW DOWN ***
AAleKKsei Z: shows [Qs Qc] (a pair of Queens)
L@z@reva: shows [2s As] (a flush, Ace high)
L@z@reva collected 11800 from pot
AAleKKsei Z finished the tournament
*** SUMMARY ***
Total pot 11800 | Rake 0 
Board [3s 8s Tc 4h Ks]
Seat 1: AAleKKsei Z (small blind) showed [Qs Qc] and lost with a pair of Queens
Seat 2: stefogr (big blind) folded on the Turn
Seat 4: andreas8866 folded before Flop (didn't bet)
Seat 5: SLAPSTICK_M3 folded before Flop (didn't bet)
Seat 6: 9Black3 folded before Flop (didn't bet)
Seat 7: jcarlos.vale folded before Flop (didn't bet)
Seat 8: GonzalezRock folded on the Flop
Seat 9: L@z@reva (button) showed [2s As] and won (11800) with a flush, Ace high



PokerStars Hand #221912651596: Tournament #3082648141, $0.98+$0.12 USD Hold'em No Limit - Level IX (100/200) - 2020/12/27 21:29:57 EET [2020/12/27 14:29:57 ET]
Table '3082648141 153' 9-max Seat #2 is the button
Seat 2: stefogr (11629 in chips) 
Seat 3: NikitaPtrv (5000 in chips) out of handDTO (moved from another table into small blind)
Seat 4: andreas8866 (3360 in chips) 
Seat 5: SLAPSTICK_M3 (7068 in chips) 
Seat 6: 9Black3 (5625 in chips) 
Seat 7: jcarlos.vale (5972 in chips) 
Seat 8: GonzalezRock (12848 in chips) 
Seat 9: L@z@reva (21351 in chips) 
NikitaPtrv will be allowed to play after the button
stefogr: posts the ante 18
andreas8866: posts the ante 18
SLAPSTICK_M3: posts the ante 18
9Black3: posts the ante 18
jcarlos.vale: posts the ante 18
GonzalezRock: posts the ante 18
L@z@reva: posts the ante 18
andreas8866: posts small blind 100
SLAPSTICK_M3: posts big blind 200
*** HOLE CARDS ***
Dealt to jcarlos.vale [5d Jc]
9Black3: folds 
jcarlos.vale: folds 
GonzalezRock: folds 
L@z@reva: folds 
stefogr: raises 240 to 440
andreas8866: folds 
SLAPSTICK_M3: raises 760 to 1200
stefogr: calls 760
*** FLOP *** [6d Tc Kc]
SLAPSTICK_M3: checks 
stefogr: bets 867
SLAPSTICK_M3: raises 867 to 1734
stefogr: calls 867
*** TURN *** [6d Tc Kc] [3c]
SLAPSTICK_M3: checks 
stefogr: checks 
*** RIVER *** [6d Tc Kc 3c] [Js]
SLAPSTICK_M3: bets 1800
stefogr: folds 
Uncalled bet (1800) returned to SLAPSTICK_M3
SLAPSTICK_M3 collected 6094 from pot
SLAPSTICK_M3: doesn't show handDTO
*** SUMMARY ***
Total pot 6094 | Rake 0 
Board [6d Tc Kc 3c Js]
Seat 2: stefogr (button) folded on the River
Seat 4: andreas8866 (small blind) folded before Flop
Seat 5: SLAPSTICK_M3 (big blind) collected (6094)
Seat 6: 9Black3 folded before Flop (didn't bet)
Seat 7: jcarlos.vale folded before Flop (didn't bet)
Seat 8: GonzalezRock folded before Flop (didn't bet)
Seat 9: L@z@reva folded before Flop (didn't bet)



PokerStars Hand #221912729579: Tournament #3082648141, $0.98+$0.12 USD Hold'em No Limit - Level IX (100/200) - 2020/12/27 21:31:20 EET [2020/12/27 14:31:20 ET]
Table '3082648141 153' 9-max Seat #4 is the button
Seat 1: Phyrrura m. (12270 in chips) 
Seat 2: stefogr (8677 in chips) 
Seat 3: NikitaPtrv (5000 in chips) 
Seat 4: andreas8866 (3242 in chips) 
Seat 5: SLAPSTICK_M3 (10210 in chips) 
Seat 6: 9Black3 (5607 in chips) 
Seat 7: jcarlos.vale (5954 in chips) 
Seat 8: GonzalezRock (12830 in chips) 
Seat 9: L@z@reva (21333 in chips) 
Phyrrura m.: posts the ante 18
stefogr: posts the ante 18
NikitaPtrv: posts the ante 18
andreas8866: posts the ante 18
SLAPSTICK_M3: posts the ante 18
9Black3: posts the ante 18
jcarlos.vale: posts the ante 18
GonzalezRock: posts the ante 18
L@z@reva: posts the ante 18
SLAPSTICK_M3: posts small blind 100
9Black3: posts big blind 200
*** HOLE CARDS ***
Dealt to jcarlos.vale [9h 3s]
jcarlos.vale: folds 
GonzalezRock: raises 200 to 400
L@z@reva: folds 
Phyrrura m.: folds 
stefogr: folds 
NikitaPtrv: folds 
andreas8866: folds 
SLAPSTICK_M3: folds 
9Black3: folds 
Uncalled bet (200) returned to GonzalezRock
GonzalezRock collected 662 from pot
GonzalezRock: doesn't show handDTO
*** SUMMARY ***
Total pot 662 | Rake 0 
Seat 1: Phyrrura m. folded before Flop (didn't bet)
Seat 2: stefogr folded before Flop (didn't bet)
Seat 3: NikitaPtrv folded before Flop (didn't bet)
Seat 4: andreas8866 (button) folded before Flop (didn't bet)
Seat 5: SLAPSTICK_M3 (small blind) folded before Flop
Seat 6: 9Black3 (big blind) folded before Flop
Seat 7: jcarlos.vale folded before Flop (didn't bet)
Seat 8: GonzalezRock collected (662)
Seat 9: L@z@reva folded before Flop (didn't bet)



PokerStars Hand #221912779643: Tournament #3082648141, $0.98+$0.12 USD Hold'em No Limit - Level IX (100/200) - 2020/12/27 21:32:13 EET [2020/12/27 14:32:13 ET]
Table '3082648141 153' 9-max Seat #5 is the button
Seat 1: Phyrrura m. (12252 in chips) 
Seat 2: stefogr (8659 in chips) 
Seat 3: NikitaPtrv (4982 in chips) 
Seat 4: andreas8866 (3224 in chips) 
Seat 5: SLAPSTICK_M3 (10092 in chips) 
Seat 6: 9Black3 (5389 in chips) 
Seat 7: jcarlos.vale (5936 in chips) 
Seat 8: GonzalezRock (13274 in chips) 
Seat 9: L@z@reva (21315 in chips) 
Phyrrura m.: posts the ante 18
stefogr: posts the ante 18
NikitaPtrv: posts the ante 18
andreas8866: posts the ante 18
SLAPSTICK_M3: posts the ante 18
9Black3: posts the ante 18
jcarlos.vale: posts the ante 18
GonzalezRock: posts the ante 18
L@z@reva: posts the ante 18
9Black3: posts small blind 100
jcarlos.vale: posts big blind 200
*** HOLE CARDS ***
Dealt to jcarlos.vale [Ac 8h]
GonzalezRock: folds 
L@z@reva: folds 
Phyrrura m.: folds 
stefogr: folds 
NikitaPtrv: folds 
andreas8866: folds 
SLAPSTICK_M3: folds 
9Black3: folds 
Uncalled bet (100) returned to jcarlos.vale
jcarlos.vale collected 362 from pot
jcarlos.vale: doesn't show handDTO
*** SUMMARY ***
Total pot 362 | Rake 0 
Seat 1: Phyrrura m. folded before Flop (didn't bet)
Seat 2: stefogr folded before Flop (didn't bet)
Seat 3: NikitaPtrv folded before Flop (didn't bet)
Seat 4: andreas8866 folded before Flop (didn't bet)
Seat 5: SLAPSTICK_M3 (button) folded before Flop (didn't bet)
Seat 6: 9Black3 (small blind) folded before Flop
Seat 7: jcarlos.vale (big blind) collected (362)
Seat 8: GonzalezRock folded before Flop (didn't bet)
Seat 9: L@z@reva folded before Flop (didn't bet)



PokerStars Hand #221912810829: Tournament #3082648141, $0.98+$0.12 USD Hold'em No Limit - Level IX (100/200) - 2020/12/27 21:32:46 EET [2020/12/27 14:32:46 ET]
Table '3082648141 153' 9-max Seat #6 is the button
Seat 1: Phyrrura m. (12234 in chips) 
Seat 2: stefogr (8641 in chips) 
Seat 3: NikitaPtrv (4964 in chips) 
Seat 4: andreas8866 (3206 in chips) 
Seat 5: SLAPSTICK_M3 (10074 in chips) 
Seat 6: 9Black3 (5271 in chips) 
Seat 7: jcarlos.vale (6180 in chips) 
Seat 8: GonzalezRock (13256 in chips) 
Seat 9: L@z@reva (21297 in chips) 
Phyrrura m.: posts the ante 18
stefogr: posts the ante 18
NikitaPtrv: posts the ante 18
andreas8866: posts the ante 18
SLAPSTICK_M3: posts the ante 18
9Black3: posts the ante 18
jcarlos.vale: posts the ante 18
GonzalezRock: posts the ante 18
L@z@reva: posts the ante 18
jcarlos.vale: posts small blind 100
GonzalezRock: posts big blind 200
*** HOLE CARDS ***
Dealt to jcarlos.vale [2c 8c]
L@z@reva: folds 
Phyrrura m.: raises 200 to 400
stefogr: folds 
NikitaPtrv: folds 
andreas8866: folds 
SLAPSTICK_M3: calls 400
9Black3: folds 
jcarlos.vale: folds 
GonzalezRock: calls 200
*** FLOP *** [4s Kh 9d]
GonzalezRock: checks 
Phyrrura m.: checks 
SLAPSTICK_M3: checks 
*** TURN *** [4s Kh 9d] [Kc]
GonzalezRock: bets 200
Phyrrura m.: calls 200
SLAPSTICK_M3: folds 
*** RIVER *** [4s Kh 9d Kc] [Ah]
GonzalezRock: checks 
Phyrrura m.: checks 
*** SHOW DOWN ***
GonzalezRock: shows [8s 7s] (a pair of Kings)
Phyrrura m.: shows [5c 5s] (two pair, Kings and Fives)
Phyrrura m. collected 1862 from pot
*** SUMMARY ***
Total pot 1862 | Rake 0 
Board [4s Kh 9d Kc Ah]
Seat 1: Phyrrura m. showed [5c 5s] and won (1862) with two pair, Kings and Fives
Seat 2: stefogr folded before Flop (didn't bet)
Seat 3: NikitaPtrv folded before Flop (didn't bet)
Seat 4: andreas8866 folded before Flop (didn't bet)
Seat 5: SLAPSTICK_M3 folded on the Turn
Seat 6: 9Black3 (button) folded before Flop (didn't bet)
Seat 7: jcarlos.vale (small blind) folded before Flop
Seat 8: GonzalezRock (big blind) showed [8s 7s] and lost with a pair of Kings
Seat 9: L@z@reva folded before Flop (didn't bet)



PokerStars Hand #221912903974: Tournament #3082648141, $0.98+$0.12 USD Hold'em No Limit - Level IX (100/200) - 2020/12/27 21:34:24 EET [2020/12/27 14:34:24 ET]
Table '3082648141 153' 9-max Seat #7 is the button
Seat 1: Phyrrura m. (13478 in chips) 
Seat 2: stefogr (8623 in chips) 
Seat 3: NikitaPtrv (4946 in chips) 
Seat 4: andreas8866 (3188 in chips) 
Seat 5: SLAPSTICK_M3 (9656 in chips) 
Seat 6: 9Black3 (5253 in chips) 
Seat 7: jcarlos.vale (6062 in chips) 
Seat 8: GonzalezRock (12638 in chips) 
Seat 9: L@z@reva (21279 in chips) 
Phyrrura m.: posts the ante 18
stefogr: posts the ante 18
NikitaPtrv: posts the ante 18
andreas8866: posts the ante 18
SLAPSTICK_M3: posts the ante 18
9Black3: posts the ante 18
jcarlos.vale: posts the ante 18
GonzalezRock: posts the ante 18
L@z@reva: posts the ante 18
GonzalezRock: posts small blind 100
L@z@reva: posts big blind 200
*** HOLE CARDS ***
Dealt to jcarlos.vale [Ac Qc]
Phyrrura m.: folds 
stefogr: raises 240 to 440
NikitaPtrv: folds 
andreas8866: folds 
SLAPSTICK_M3: folds 
9Black3: folds 
jcarlos.vale: calls 440
GonzalezRock: folds 
L@z@reva: folds 
*** FLOP *** [9h Ks 5c]
stefogr: checks 
jcarlos.vale: checks 
*** TURN *** [9h Ks 5c] [Tc]
stefogr: bets 738
jcarlos.vale: folds 
Uncalled bet (738) returned to stefogr
stefogr collected 1342 from pot
stefogr: doesn't show handDTO
*** SUMMARY ***
Total pot 1342 | Rake 0 
Board [9h Ks 5c Tc]
Seat 1: Phyrrura m. folded before Flop (didn't bet)
Seat 2: stefogr collected (1342)
Seat 3: NikitaPtrv folded before Flop (didn't bet)
Seat 4: andreas8866 folded before Flop (didn't bet)
Seat 5: SLAPSTICK_M3 folded before Flop (didn't bet)
Seat 6: 9Black3 folded before Flop (didn't bet)
Seat 7: jcarlos.vale (button) folded on the Turn
Seat 8: GonzalezRock (small blind) folded before Flop
Seat 9: L@z@reva (big blind) folded before Flop



PokerStars Hand #221912943210: Tournament #3082648141, $0.98+$0.12 USD Hold'em No Limit - Level IX (100/200) - 2020/12/27 21:35:06 EET [2020/12/27 14:35:06 ET]
Table '3082648141 153' 9-max Seat #8 is the button
Seat 1: Phyrrura m. (13460 in chips) 
Seat 2: stefogr (9507 in chips) 
Seat 3: NikitaPtrv (4928 in chips) 
Seat 4: andreas8866 (3170 in chips) 
Seat 5: SLAPSTICK_M3 (9638 in chips) 
Seat 6: 9Black3 (5235 in chips) 
Seat 7: jcarlos.vale (5604 in chips) 
Seat 8: GonzalezRock (12520 in chips) 
Seat 9: L@z@reva (21061 in chips) 
Phyrrura m.: posts the ante 18
stefogr: posts the ante 18
NikitaPtrv: posts the ante 18
andreas8866: posts the ante 18
SLAPSTICK_M3: posts the ante 18
9Black3: posts the ante 18
jcarlos.vale: posts the ante 18
GonzalezRock: posts the ante 18
L@z@reva: posts the ante 18
L@z@reva: posts small blind 100
Phyrrura m.: posts big blind 200
*** HOLE CARDS ***
Dealt to jcarlos.vale [6s Qs]
stefogr: folds 
NikitaPtrv: folds 
andreas8866: folds 
SLAPSTICK_M3: folds 
9Black3: folds 
jcarlos.vale: folds 
GonzalezRock has timed out
GonzalezRock: folds 
GonzalezRock is sitting out
L@z@reva: raises 200 to 400
Phyrrura m.: raises 600 to 1000
L@z@reva: raises 600 to 1600
GonzalezRock has returned
Phyrrura m.: calls 600
*** FLOP *** [Qc 5h 8d]
L@z@reva: bets 3362
Phyrrura m.: folds 
Uncalled bet (3362) returned to L@z@reva
L@z@reva collected 3362 from pot
L@z@reva: doesn't show handDTO
*** SUMMARY ***
Total pot 3362 | Rake 0 
Board [Qc 5h 8d]
Seat 1: Phyrrura m. (big blind) folded on the Flop
Seat 2: stefogr folded before Flop (didn't bet)
Seat 3: NikitaPtrv folded before Flop (didn't bet)
Seat 4: andreas8866 folded before Flop (didn't bet)
Seat 5: SLAPSTICK_M3 folded before Flop (didn't bet)
Seat 6: 9Black3 folded before Flop (didn't bet)
Seat 7: jcarlos.vale folded before Flop (didn't bet)
Seat 8: GonzalezRock (button) folded before Flop (didn't bet)
Seat 9: L@z@reva (small blind) collected (3362)



PokerStars Hand #221913009300: Tournament #3082648141, $0.98+$0.12 USD Hold'em No Limit - Level IX (100/200) - 2020/12/27 21:36:07 EET [2020/12/27 14:36:07 ET]
Table '3082648141 153' 9-max Seat #9 is the button
Seat 1: Phyrrura m. (11842 in chips) 
Seat 2: stefogr (9489 in chips) 
Seat 3: NikitaPtrv (4910 in chips) 
Seat 4: andreas8866 (3152 in chips) 
Seat 5: SLAPSTICK_M3 (9620 in chips) 
Seat 6: 9Black3 (5217 in chips) 
Seat 7: jcarlos.vale (5586 in chips) 
Seat 8: GonzalezRock (12502 in chips) 
Seat 9: L@z@reva (22805 in chips) 
Phyrrura m.: posts the ante 18
stefogr: posts the ante 18
NikitaPtrv: posts the ante 18
andreas8866: posts the ante 18
SLAPSTICK_M3: posts the ante 18
9Black3: posts the ante 18
jcarlos.vale: posts the ante 18
GonzalezRock: posts the ante 18
L@z@reva: posts the ante 18
Phyrrura m.: posts small blind 100
stefogr: posts big blind 200
*** HOLE CARDS ***
Dealt to jcarlos.vale [2h 4d]
NikitaPtrv: folds 
andreas8866: folds 
SLAPSTICK_M3: folds 
9Black3: folds 
jcarlos.vale: folds 
GonzalezRock has timed out
GonzalezRock: folds 
GonzalezRock is sitting out
L@z@reva: folds 
GonzalezRock has returned
Phyrrura m.: calls 100
stefogr: checks 
*** FLOP *** [Ad As 5c]
Phyrrura m.: checks 
stefogr: bets 200
Phyrrura m.: calls 200
*** TURN *** [Ad As 5c] [9c]
Phyrrura m.: checks 
stefogr: checks 
*** RIVER *** [Ad As 5c 9c] [8c]
Phyrrura m.: bets 641
stefogr: folds 
Uncalled bet (641) returned to Phyrrura m.
Phyrrura m. collected 962 from pot
*** SUMMARY ***
Total pot 962 | Rake 0 
Board [Ad As 5c 9c 8c]
Seat 1: Phyrrura m. (small blind) collected (962)
Seat 2: stefogr (big blind) folded on the River
Seat 3: NikitaPtrv folded before Flop (didn't bet)
Seat 4: andreas8866 folded before Flop (didn't bet)
Seat 5: SLAPSTICK_M3 folded before Flop (didn't bet)
Seat 6: 9Black3 folded before Flop (didn't bet)
Seat 7: jcarlos.vale folded before Flop (didn't bet)
Seat 8: GonzalezRock folded before Flop (didn't bet)
Seat 9: L@z@reva (button) folded before Flop (didn't bet)



PokerStars Hand #221913095427: Tournament #3082648141, $0.98+$0.12 USD Hold'em No Limit - Level IX (100/200) - 2020/12/27 21:37:38 EET [2020/12/27 14:37:38 ET]
Table '3082648141 153' 9-max Seat #1 is the button
Seat 1: Phyrrura m. (12386 in chips) 
Seat 2: stefogr (9071 in chips) 
Seat 3: NikitaPtrv (4892 in chips) 
Seat 4: andreas8866 (3134 in chips) 
Seat 5: SLAPSTICK_M3 (9602 in chips) 
Seat 6: 9Black3 (5199 in chips) 
Seat 7: jcarlos.vale (5568 in chips) 
Seat 8: GonzalezRock (12484 in chips) 
Seat 9: L@z@reva (22787 in chips) 
Phyrrura m.: posts the ante 18
stefogr: posts the ante 18
NikitaPtrv: posts the ante 18
andreas8866: posts the ante 18
SLAPSTICK_M3: posts the ante 18
9Black3: posts the ante 18
jcarlos.vale: posts the ante 18
GonzalezRock: posts the ante 18
L@z@reva: posts the ante 18
stefogr: posts small blind 100
NikitaPtrv: posts big blind 200
*** HOLE CARDS ***
Dealt to jcarlos.vale [2d Jd]
andreas8866: folds 
SLAPSTICK_M3: raises 240 to 440
9Black3: folds 
jcarlos.vale: folds 
GonzalezRock: folds 
L@z@reva: folds 
Phyrrura m.: calls 440
stefogr: folds 
NikitaPtrv: folds 
*** FLOP *** [9s 8c Qs]
SLAPSTICK_M3: bets 895
Phyrrura m.: calls 895
*** TURN *** [9s 8c Qs] [4s]
SLAPSTICK_M3: bets 2088
Phyrrura m.: folds 
Uncalled bet (2088) returned to SLAPSTICK_M3
SLAPSTICK_M3 collected 3132 from pot
SLAPSTICK_M3: doesn't show handDTO
*** SUMMARY ***
Total pot 3132 | Rake 0 
Board [9s 8c Qs 4s]
Seat 1: Phyrrura m. (button) folded on the Turn
Seat 2: stefogr (small blind) folded before Flop
Seat 3: NikitaPtrv (big blind) folded before Flop
Seat 4: andreas8866 folded before Flop (didn't bet)
Seat 5: SLAPSTICK_M3 collected (3132)
Seat 6: 9Black3 folded before Flop (didn't bet)
Seat 7: jcarlos.vale folded before Flop (didn't bet)
Seat 8: GonzalezRock folded before Flop (didn't bet)
Seat 9: L@z@reva folded before Flop (didn't bet)



PokerStars Hand #221913147343: Tournament #3082648141, $0.98+$0.12 USD Hold'em No Limit - Level IX (100/200) - 2020/12/27 21:38:34 EET [2020/12/27 14:38:34 ET]
Table '3082648141 153' 9-max Seat #2 is the button
Seat 1: Phyrrura m. (11033 in chips) 
Seat 2: stefogr (8953 in chips) 
Seat 3: NikitaPtrv (4674 in chips) 
Seat 4: andreas8866 (3116 in chips) 
Seat 5: SLAPSTICK_M3 (11381 in chips) 
Seat 6: 9Black3 (5181 in chips) 
Seat 7: jcarlos.vale (5550 in chips) 
Seat 8: GonzalezRock (12466 in chips) 
Seat 9: L@z@reva (22769 in chips) 
Phyrrura m.: posts the ante 18
stefogr: posts the ante 18
NikitaPtrv: posts the ante 18
andreas8866: posts the ante 18
SLAPSTICK_M3: posts the ante 18
9Black3: posts the ante 18
jcarlos.vale: posts the ante 18
GonzalezRock: posts the ante 18
L@z@reva: posts the ante 18
NikitaPtrv: posts small blind 100
andreas8866: posts big blind 200
*** HOLE CARDS ***
Dealt to jcarlos.vale [9c Ks]
SLAPSTICK_M3: folds 
9Black3: folds 
jcarlos.vale: folds 
GonzalezRock: raises 200 to 400
L@z@reva: folds 
Phyrrura m.: folds 
stefogr: folds 
NikitaPtrv: folds 
andreas8866: calls 200
*** FLOP *** [3c 7h 4d]
andreas8866: checks 
GonzalezRock: bets 800
andreas8866: folds 
Uncalled bet (800) returned to GonzalezRock
GonzalezRock collected 1062 from pot
GonzalezRock: doesn't show handDTO
*** SUMMARY ***
Total pot 1062 | Rake 0 
Board [3c 7h 4d]
Seat 1: Phyrrura m. folded before Flop (didn't bet)
Seat 2: stefogr (button) folded before Flop (didn't bet)
Seat 3: NikitaPtrv (small blind) folded before Flop
Seat 4: andreas8866 (big blind) folded on the Flop
Seat 5: SLAPSTICK_M3 folded before Flop (didn't bet)
Seat 6: 9Black3 folded before Flop (didn't bet)
Seat 7: jcarlos.vale folded before Flop (didn't bet)
Seat 8: GonzalezRock collected (1062)
Seat 9: L@z@reva folded before Flop (didn't bet)



PokerStars Hand #221913203118: Tournament #3082648141, $0.98+$0.12 USD Hold'em No Limit - Level X (125/250) - 2020/12/27 21:39:33 EET [2020/12/27 14:39:33 ET]
Table '3082648141 153' 9-max Seat #3 is the button
Seat 1: Phyrrura m. (11015 in chips) 
Seat 2: stefogr (8935 in chips) 
Seat 3: NikitaPtrv (4556 in chips) 
Seat 4: andreas8866 (2698 in chips) 
Seat 5: SLAPSTICK_M3 (11363 in chips) 
Seat 6: 9Black3 (5163 in chips) 
Seat 7: jcarlos.vale (5532 in chips) 
Seat 8: GonzalezRock (13110 in chips) 
Seat 9: L@z@reva (22751 in chips) 
Phyrrura m.: posts the ante 20
stefogr: posts the ante 20
NikitaPtrv: posts the ante 20
andreas8866: posts the ante 20
SLAPSTICK_M3: posts the ante 20
9Black3: posts the ante 20
jcarlos.vale: posts the ante 20
GonzalezRock: posts the ante 20
L@z@reva: posts the ante 20
andreas8866: posts small blind 125
SLAPSTICK_M3: posts big blind 250
*** HOLE CARDS ***
Dealt to jcarlos.vale [Ac 2h]
9Black3: folds 
jcarlos.vale: folds 
GonzalezRock: folds 
L@z@reva: folds 
Phyrrura m.: folds 
stefogr: folds 
NikitaPtrv: raises 275 to 525
andreas8866: folds 
SLAPSTICK_M3: folds 
Uncalled bet (275) returned to NikitaPtrv
NikitaPtrv collected 805 from pot
NikitaPtrv: doesn't show handDTO
*** SUMMARY ***
Total pot 805 | Rake 0 
Seat 1: Phyrrura m. folded before Flop (didn't bet)
Seat 2: stefogr folded before Flop (didn't bet)
Seat 3: NikitaPtrv (button) collected (805)
Seat 4: andreas8866 (small blind) folded before Flop
Seat 5: SLAPSTICK_M3 (big blind) folded before Flop
Seat 6: 9Black3 folded before Flop (didn't bet)
Seat 7: jcarlos.vale folded before Flop (didn't bet)
Seat 8: GonzalezRock folded before Flop (didn't bet)
Seat 9: L@z@reva folded before Flop (didn't bet)



PokerStars Hand #221913244319: Tournament #3082648141, $0.98+$0.12 USD Hold'em No Limit - Level X (125/250) - 2020/12/27 21:40:17 EET [2020/12/27 14:40:17 ET]
Table '3082648141 153' 9-max Seat #4 is the button
Seat 1: Phyrrura m. (10995 in chips) 
Seat 2: stefogr (8915 in chips) 
Seat 3: NikitaPtrv (5091 in chips) 
Seat 4: andreas8866 (2553 in chips) 
Seat 5: SLAPSTICK_M3 (11093 in chips) 
Seat 6: 9Black3 (5143 in chips) 
Seat 7: jcarlos.vale (5512 in chips) 
Seat 8: GonzalezRock (13090 in chips) 
Seat 9: L@z@reva (22731 in chips) 
Phyrrura m.: posts the ante 20
stefogr: posts the ante 20
NikitaPtrv: posts the ante 20
andreas8866: posts the ante 20
SLAPSTICK_M3: posts the ante 20
9Black3: posts the ante 20
jcarlos.vale: posts the ante 20
GonzalezRock: posts the ante 20
L@z@reva: posts the ante 20
SLAPSTICK_M3: posts small blind 125
9Black3: posts big blind 250
*** HOLE CARDS ***
Dealt to jcarlos.vale [9d Kd]
jcarlos.vale: folds 
GonzalezRock: folds 
L@z@reva: folds 
Phyrrura m.: folds 
stefogr: folds 
NikitaPtrv: raises 275 to 525
andreas8866: folds 
SLAPSTICK_M3: folds 
9Black3: folds 
Uncalled bet (275) returned to NikitaPtrv
NikitaPtrv collected 805 from pot
NikitaPtrv: doesn't show handDTO
*** SUMMARY ***
Total pot 805 | Rake 0 
Seat 1: Phyrrura m. folded before Flop (didn't bet)
Seat 2: stefogr folded before Flop (didn't bet)
Seat 3: NikitaPtrv collected (805)
Seat 4: andreas8866 (button) folded before Flop (didn't bet)
Seat 5: SLAPSTICK_M3 (small blind) folded before Flop
Seat 6: 9Black3 (big blind) folded before Flop
Seat 7: jcarlos.vale folded before Flop (didn't bet)
Seat 8: GonzalezRock folded before Flop (didn't bet)
Seat 9: L@z@reva folded before Flop (didn't bet)



PokerStars Hand #221913275111: Tournament #3082648141, $0.98+$0.12 USD Hold'em No Limit - Level X (125/250) - 2020/12/27 21:40:49 EET [2020/12/27 14:40:49 ET]
Table '3082648141 274' 9-max Seat #1 is the button
Seat 1: jcarlos.vale (5492 in chips) 
Seat 2: edineipoker (7395 in chips) 
Seat 3: vogelao (4980 in chips) 
Seat 4: Supergirl2204 (17030 in chips) 
Seat 5: 1922kondrat (3359 in chips) 
Seat 6: Elwis08 (29345 in chips) 
jcarlos.vale: posts the ante 20
edineipoker: posts the ante 20
vogelao: posts the ante 20
Supergirl2204: posts the ante 20
1922kondrat: posts the ante 20
Elwis08: posts the ante 20
edineipoker: posts small blind 125
vogelao: posts big blind 250
*** HOLE CARDS ***
Dealt to jcarlos.vale [Js 6c]
Supergirl2204 is connected 
Supergirl2204: folds 
1922kondrat: raises 3089 to 3339 and is all-in
Elwis08: folds 
jcarlos.vale: folds 
edineipoker: folds 
vogelao: folds 
Uncalled bet (3089) returned to 1922kondrat
1922kondrat collected 745 from pot
1922kondrat: doesn't show handDTO
*** SUMMARY ***
Total pot 745 | Rake 0 
Seat 1: jcarlos.vale (button) folded before Flop (didn't bet)
Seat 2: edineipoker (small blind) folded before Flop
Seat 3: vogelao (big blind) folded before Flop
Seat 4: Supergirl2204 folded before Flop (didn't bet)
Seat 5: 1922kondrat collected (745)
Seat 6: Elwis08 folded before Flop (didn't bet)



PokerStars Hand #221913296049: Tournament #3082648141, $0.98+$0.12 USD Hold'em No Limit - Level X (125/250) - 2020/12/27 21:41:12 EET [2020/12/27 14:41:12 ET]
Table '3082648141 274' 9-max Seat #2 is the button
Seat 1: jcarlos.vale (5472 in chips) 
Seat 2: edineipoker (7250 in chips) 
Seat 3: vogelao (4710 in chips) 
Seat 5: 1922kondrat (3834 in chips) 
Seat 6: Elwis08 (29325 in chips) 
Seat 7: dre905 (5000 in chips) 
Seat 8: mgrjf (9180 in chips) 
Seat 9: 69PUSHA96 (5000 in chips) 
jcarlos.vale: posts the ante 20
edineipoker: posts the ante 20
vogelao: posts the ante 20
1922kondrat: posts the ante 20
Elwis08: posts the ante 20
dre905: posts the ante 20
mgrjf: posts the ante 20
69PUSHA96: posts the ante 20
vogelao: posts small blind 125
1922kondrat: posts big blind 250
*** HOLE CARDS ***
Dealt to jcarlos.vale [7d 5s]
Elwis08: folds 
dre905: folds 
mgrjf: folds 
69PUSHA96: raises 785 to 1035
jcarlos.vale: folds 
edineipoker: folds 
vogelao: raises 3655 to 4690 and is all-in
1922kondrat: folds 
69PUSHA96: calls 3655
*** FLOP *** [2c 8h Jd]
*** TURN *** [2c 8h Jd] [Jh]
*** RIVER *** [2c 8h Jd Jh] [6s]
*** SHOW DOWN ***
vogelao: shows [9d 9h] (two pair, Jacks and Nines)
69PUSHA96: shows [Ac Qd] (a pair of Jacks)
vogelao collected 9790 from pot
*** SUMMARY ***
Total pot 9790 | Rake 0 
Board [2c 8h Jd Jh 6s]
Seat 1: jcarlos.vale folded before Flop (didn't bet)
Seat 2: edineipoker (button) folded before Flop (didn't bet)
Seat 3: vogelao (small blind) showed [9d 9h] and won (9790) with two pair, Jacks and Nines
Seat 5: 1922kondrat (big blind) folded before Flop
Seat 6: Elwis08 folded before Flop (didn't bet)
Seat 7: dre905 folded before Flop (didn't bet)
Seat 8: mgrjf folded before Flop (didn't bet)
Seat 9: 69PUSHA96 showed [Ac Qd] and lost with a pair of Jacks



PokerStars Hand #221913329330: Tournament #3082648141, $0.98+$0.12 USD Hold'em No Limit - Level X (125/250) - 2020/12/27 21:41:47 EET [2020/12/27 14:41:47 ET]
Table '3082648141 274' 9-max Seat #3 is the button
Seat 1: jcarlos.vale (5452 in chips) 
Seat 2: edineipoker (7230 in chips) 
Seat 3: vogelao (9790 in chips) 
Seat 4: jonnesen777 (5000 in chips) out of handDTO (moved from another table into small blind)
Seat 5: 1922kondrat (3564 in chips) 
Seat 6: Elwis08 (29305 in chips) 
Seat 7: dre905 (4980 in chips) 
Seat 8: mgrjf (9160 in chips) 
Seat 9: 69PUSHA96 (290 in chips) 
jonnesen777 will be allowed to play after the button
jcarlos.vale: posts the ante 20
edineipoker: posts the ante 20
vogelao: posts the ante 20
1922kondrat: posts the ante 20
Elwis08: posts the ante 20
dre905: posts the ante 20
mgrjf: posts the ante 20
69PUSHA96: posts the ante 20
1922kondrat: posts small blind 125
Elwis08: posts big blind 250
*** HOLE CARDS ***
Dealt to jcarlos.vale [4c 9h]
dre905: folds 
mgrjf: folds 
69PUSHA96: raises 20 to 270 and is all-in
jcarlos.vale: folds 
edineipoker: folds 
vogelao: calls 270
1922kondrat: folds 
Elwis08: folds 
*** FLOP *** [Ad 3h 4d]
*** TURN *** [Ad 3h 4d] [5s]
*** RIVER *** [Ad 3h 4d 5s] [Qd]
*** SHOW DOWN ***
69PUSHA96: shows [Ah 9c] (a pair of Aces)
vogelao: shows [Ks 8c] (high pairOfCards Ace)
69PUSHA96 collected 1075 from pot
*** SUMMARY ***
Total pot 1075 | Rake 0 
Board [Ad 3h 4d 5s Qd]
Seat 1: jcarlos.vale folded before Flop (didn't bet)
Seat 2: edineipoker folded before Flop (didn't bet)
Seat 3: vogelao (button) showed [Ks 8c] and lost with high pairOfCards Ace
Seat 5: 1922kondrat (small blind) folded before Flop
Seat 6: Elwis08 (big blind) folded before Flop
Seat 7: dre905 folded before Flop (didn't bet)
Seat 8: mgrjf folded before Flop (didn't bet)
Seat 9: 69PUSHA96 showed [Ah 9c] and won (1075) with a pair of Aces



PokerStars Hand #221913361628: Tournament #3082648141, $0.98+$0.12 USD Hold'em No Limit - Level X (125/250) - 2020/12/27 21:42:21 EET [2020/12/27 14:42:21 ET]
Table '3082648141 274' 9-max Seat #5 is the button
Seat 1: jcarlos.vale (5432 in chips) 
Seat 2: edineipoker (7210 in chips) 
Seat 3: vogelao (9500 in chips) 
Seat 4: jonnesen777 (5000 in chips) 
Seat 5: 1922kondrat (3419 in chips) 
Seat 6: Elwis08 (29035 in chips) 
Seat 7: dre905 (4960 in chips) 
Seat 8: mgrjf (9140 in chips) 
Seat 9: 69PUSHA96 (1075 in chips) 
jcarlos.vale: posts the ante 20
edineipoker: posts the ante 20
vogelao: posts the ante 20
jonnesen777: posts the ante 20
1922kondrat: posts the ante 20
Elwis08: posts the ante 20
dre905: posts the ante 20
mgrjf: posts the ante 20
69PUSHA96: posts the ante 20
Elwis08: posts small blind 125
dre905: posts big blind 250
*** HOLE CARDS ***
Dealt to jcarlos.vale [5s 7c]
mgrjf: folds 
69PUSHA96: folds 
jcarlos.vale: folds 
edineipoker: folds 
vogelao: calls 250
jonnesen777: raises 4730 to 4980 and is all-in
1922kondrat: folds 
Elwis08: folds 
dre905: folds 
vogelao: folds 
Uncalled bet (4730) returned to jonnesen777
jonnesen777 collected 1055 from pot
jonnesen777: doesn't show handDTO
*** SUMMARY ***
Total pot 1055 | Rake 0 
Seat 1: jcarlos.vale folded before Flop (didn't bet)
Seat 2: edineipoker folded before Flop (didn't bet)
Seat 3: vogelao folded before Flop
Seat 4: jonnesen777 collected (1055)
Seat 5: 1922kondrat (button) folded before Flop (didn't bet)
Seat 6: Elwis08 (small blind) folded before Flop
Seat 7: dre905 (big blind) folded before Flop
Seat 8: mgrjf folded before Flop (didn't bet)
Seat 9: 69PUSHA96 folded before Flop (didn't bet)



PokerStars Hand #221913410719: Tournament #3082648141, $0.98+$0.12 USD Hold'em No Limit - Level X (125/250) - 2020/12/27 21:43:13 EET [2020/12/27 14:43:13 ET]
Table '3082648141 274' 9-max Seat #6 is the button
Seat 1: jcarlos.vale (5412 in chips) 
Seat 2: edineipoker (7190 in chips) 
Seat 3: vogelao (9230 in chips) 
Seat 4: jonnesen777 (5785 in chips) 
Seat 5: 1922kondrat (3399 in chips) 
Seat 6: Elwis08 (28890 in chips) 
Seat 7: dre905 (4690 in chips) 
Seat 8: mgrjf (9120 in chips) 
Seat 9: 69PUSHA96 (1055 in chips) 
jcarlos.vale: posts the ante 20
edineipoker: posts the ante 20
vogelao: posts the ante 20
jonnesen777: posts the ante 20
1922kondrat: posts the ante 20
Elwis08: posts the ante 20
dre905: posts the ante 20
mgrjf: posts the ante 20
69PUSHA96: posts the ante 20
dre905: posts small blind 125
mgrjf: posts big blind 250
*** HOLE CARDS ***
Dealt to jcarlos.vale [6h 7s]
69PUSHA96: raises 785 to 1035 and is all-in
jcarlos.vale: folds 
edineipoker: folds 
vogelao: folds 
jonnesen777: folds 
1922kondrat: raises 2344 to 3379 and is all-in
Elwis08: folds 
dre905: folds 
mgrjf: folds 
Uncalled bet (2344) returned to 1922kondrat
*** FLOP *** [7d 3s Ad]
*** TURN *** [7d 3s Ad] [Ah]
*** RIVER *** [7d 3s Ad Ah] [5c]
*** SHOW DOWN ***
69PUSHA96: shows [2c 8s] (a pair of Aces)
1922kondrat: shows [Js Kh] (a pair of Aces - King kicker)
1922kondrat collected 2625 from pot
69PUSHA96 finished the tournament
*** SUMMARY ***
Total pot 2625 | Rake 0 
Board [7d 3s Ad Ah 5c]
Seat 1: jcarlos.vale folded before Flop (didn't bet)
Seat 2: edineipoker folded before Flop (didn't bet)
Seat 3: vogelao folded before Flop (didn't bet)
Seat 4: jonnesen777 folded before Flop (didn't bet)
Seat 5: 1922kondrat showed [Js Kh] and won (2625) with a pair of Aces
Seat 6: Elwis08 (button) folded before Flop (didn't bet)
Seat 7: dre905 (small blind) folded before Flop
Seat 8: mgrjf (big blind) folded before Flop
Seat 9: 69PUSHA96 showed [2c 8s] and lost with a pair of Aces



PokerStars Hand #221913444825: Tournament #3082648141, $0.98+$0.12 USD Hold'em No Limit - Level X (125/250) - 2020/12/27 21:43:49 EET [2020/12/27 14:43:49 ET]
Table '3082648141 274' 9-max Seat #7 is the button
Seat 1: jcarlos.vale (5392 in chips) 
Seat 2: edineipoker (7170 in chips) 
Seat 3: vogelao (9210 in chips) 
Seat 4: jonnesen777 (5765 in chips) 
Seat 5: 1922kondrat (4969 in chips) 
Seat 6: Elwis08 (28870 in chips) 
Seat 7: dre905 (4545 in chips) 
Seat 8: mgrjf (8850 in chips) 
jcarlos.vale: posts the ante 20
edineipoker: posts the ante 20
vogelao: posts the ante 20
jonnesen777: posts the ante 20
1922kondrat: posts the ante 20
Elwis08: posts the ante 20
dre905: posts the ante 20
mgrjf: posts the ante 20
mgrjf: posts small blind 125
jcarlos.vale: posts big blind 250
*** HOLE CARDS ***
Dealt to jcarlos.vale [Qc Qh]
edineipoker: folds 
vogelao: folds 
jonnesen777: calls 250
1922kondrat: folds 
Elwis08: folds 
dre905: folds 
mgrjf: folds 
jcarlos.vale: raises 500 to 750
jonnesen777: calls 500
*** FLOP *** [Jc Jh Ad]
jcarlos.vale: bets 750
jonnesen777: folds 
Uncalled bet (750) returned to jcarlos.vale
jcarlos.vale collected 1785 from pot
jcarlos.vale: doesn't show handDTO
*** SUMMARY ***
Total pot 1785 | Rake 0 
Board [Jc Jh Ad]
Seat 1: jcarlos.vale (big blind) collected (1785)
Seat 2: edineipoker folded before Flop (didn't bet)
Seat 3: vogelao folded before Flop (didn't bet)
Seat 4: jonnesen777 folded on the Flop
Seat 5: 1922kondrat folded before Flop (didn't bet)
Seat 6: Elwis08 folded before Flop (didn't bet)
Seat 7: dre905 (button) folded before Flop (didn't bet)
Seat 8: mgrjf (small blind) folded before Flop



PokerStars Hand #221913475617: Tournament #3082648141, $0.98+$0.12 USD Hold'em No Limit - Level X (125/250) - 2020/12/27 21:44:22 EET [2020/12/27 14:44:22 ET]
Table '3082648141 274' 9-max Seat #8 is the button
Seat 1: jcarlos.vale (6407 in chips) 
Seat 3: vogelao (9190 in chips) 
Seat 4: jonnesen777 (4995 in chips) 
Seat 5: 1922kondrat (4949 in chips) 
Seat 6: Elwis08 (28850 in chips) 
Seat 7: dre905 (4525 in chips) 
Seat 8: mgrjf (8705 in chips) 
Seat 9: 69PUSHA96 (5000 in chips) out of handDTO (moved from another table into small blind)
69PUSHA96 will be allowed to play after the button
jcarlos.vale: posts the ante 20
vogelao: posts the ante 20
jonnesen777: posts the ante 20
1922kondrat: posts the ante 20
Elwis08: posts the ante 20
dre905: posts the ante 20
mgrjf: posts the ante 20
jcarlos.vale: posts small blind 125
vogelao: posts big blind 250
*** HOLE CARDS ***
Dealt to jcarlos.vale [5c Ad]
jonnesen777: folds 
1922kondrat: folds 
Elwis08: folds 
dre905: folds 
mgrjf: folds 
jcarlos.vale: raises 400 to 650
vogelao: folds 
Uncalled bet (400) returned to jcarlos.vale
jcarlos.vale collected 640 from pot
jcarlos.vale: doesn't show handDTO
*** SUMMARY ***
Total pot 640 | Rake 0 
Seat 1: jcarlos.vale (small blind) collected (640)
Seat 3: vogelao (big blind) folded before Flop
Seat 4: jonnesen777 folded before Flop (didn't bet)
Seat 5: 1922kondrat folded before Flop (didn't bet)
Seat 6: Elwis08 folded before Flop (didn't bet)
Seat 7: dre905 folded before Flop (didn't bet)
Seat 8: mgrjf (button) folded before Flop (didn't bet)



PokerStars Hand #221913497410: Tournament #3082648141, $0.98+$0.12 USD Hold'em No Limit - Level X (125/250) - 2020/12/27 21:44:45 EET [2020/12/27 14:44:45 ET]
Table '3082648141 274' 9-max Seat #1 is the button
Seat 1: jcarlos.vale (6777 in chips) 
Seat 2: premium.antifa (5000 in chips) out of handDTO (moved from another table into small blind)
Seat 3: vogelao (8920 in chips) 
Seat 4: jonnesen777 (4975 in chips) 
Seat 5: 1922kondrat (4929 in chips) 
Seat 6: Elwis08 (28830 in chips) 
Seat 7: dre905 (4505 in chips) 
Seat 8: mgrjf (8685 in chips) 
Seat 9: 69PUSHA96 (5000 in chips) 
premium.antifa will be allowed to play after the button
jcarlos.vale: posts the ante 20
vogelao: posts the ante 20
jonnesen777: posts the ante 20
1922kondrat: posts the ante 20
Elwis08: posts the ante 20
dre905: posts the ante 20
mgrjf: posts the ante 20
69PUSHA96: posts the ante 20
vogelao: posts small blind 125
jonnesen777: posts big blind 250
*** HOLE CARDS ***
Dealt to jcarlos.vale [3d Kh]
1922kondrat: folds 
Elwis08: raises 250 to 500
dre905: folds 
mgrjf: folds 
69PUSHA96: calls 500
jcarlos.vale: folds 
vogelao: folds 
jonnesen777: folds 
*** FLOP *** [8s 9c Qs]
Elwis08: checks 
69PUSHA96: checks 
*** TURN *** [8s 9c Qs] [Th]
Elwis08: checks 
69PUSHA96: checks 
*** RIVER *** [8s 9c Qs Th] [7h]
Elwis08: checks 
69PUSHA96: checks 
*** SHOW DOWN ***
Elwis08: shows [7d 7s] (three of a kind, Sevens)
69PUSHA96: shows [8d 8c] (three of a kind, Eights)
69PUSHA96 collected 1535 from pot
*** SUMMARY ***
Total pot 1535 | Rake 0 
Board [8s 9c Qs Th 7h]
Seat 1: jcarlos.vale (button) folded before Flop (didn't bet)
Seat 3: vogelao (small blind) folded before Flop
Seat 4: jonnesen777 (big blind) folded before Flop
Seat 5: 1922kondrat folded before Flop (didn't bet)
Seat 6: Elwis08 showed [7d 7s] and lost with three of a kind, Sevens
Seat 7: dre905 folded before Flop (didn't bet)
Seat 8: mgrjf folded before Flop (didn't bet)
Seat 9: 69PUSHA96 showed [8d 8c] and won (1535) with three of a kind, Eights



PokerStars Hand #221913565881: Tournament #3082648141, $0.98+$0.12 USD Hold'em No Limit - Level X (125/250) - 2020/12/27 21:45:48 EET [2020/12/27 14:45:48 ET]
Table '3082648141 274' 9-max Seat #3 is the button
Seat 1: jcarlos.vale (6757 in chips) 
Seat 2: premium.antifa (5000 in chips) 
Seat 3: vogelao (8775 in chips) 
Seat 4: jonnesen777 (4705 in chips) 
Seat 5: 1922kondrat (4909 in chips) 
Seat 6: Elwis08 (28310 in chips) 
Seat 8: mgrjf (8665 in chips) 
Seat 9: 69PUSHA96 (6015 in chips) 
jcarlos.vale: posts the ante 20
premium.antifa: posts the ante 20
vogelao: posts the ante 20
jonnesen777: posts the ante 20
1922kondrat: posts the ante 20
Elwis08: posts the ante 20
mgrjf: posts the ante 20
69PUSHA96: posts the ante 20
jonnesen777: posts small blind 125
1922kondrat: posts big blind 250
*** HOLE CARDS ***
Dealt to jcarlos.vale [7s Qs]
Elwis08: raises 250 to 500
mgrjf: folds 
69PUSHA96: folds 
jcarlos.vale: folds 
premium.antifa: folds 
vogelao: folds 
jonnesen777: folds 
1922kondrat: folds 
Uncalled bet (250) returned to Elwis08
Elwis08 collected 785 from pot
Elwis08: doesn't show handDTO
*** SUMMARY ***
Total pot 785 | Rake 0 
Seat 1: jcarlos.vale folded before Flop (didn't bet)
Seat 2: premium.antifa folded before Flop (didn't bet)
Seat 3: vogelao (button) folded before Flop (didn't bet)
Seat 4: jonnesen777 (small blind) folded before Flop
Seat 5: 1922kondrat (big blind) folded before Flop
Seat 6: Elwis08 collected (785)
Seat 8: mgrjf folded before Flop (didn't bet)
Seat 9: 69PUSHA96 folded before Flop (didn't bet)



PokerStars Hand #221913590174: Tournament #3082648141, $0.98+$0.12 USD Hold'em No Limit - Level X (125/250) - 2020/12/27 21:46:14 EET [2020/12/27 14:46:14 ET]
Table '3082648141 274' 9-max Seat #4 is the button
Seat 1: jcarlos.vale (6737 in chips) 
Seat 2: premium.antifa (4980 in chips) 
Seat 3: vogelao (8755 in chips) 
Seat 4: jonnesen777 (4560 in chips) 
Seat 5: 1922kondrat (4639 in chips) 
Seat 6: Elwis08 (28825 in chips) 
Seat 7: IBMaN78 (5000 in chips) 
Seat 8: mgrjf (8645 in chips) 
Seat 9: 69PUSHA96 (5995 in chips) 
jcarlos.vale: posts the ante 20
premium.antifa: posts the ante 20
vogelao: posts the ante 20
jonnesen777: posts the ante 20
1922kondrat: posts the ante 20
Elwis08: posts the ante 20
IBMaN78: posts the ante 20
mgrjf: posts the ante 20
69PUSHA96: posts the ante 20
1922kondrat: posts small blind 125
Elwis08: posts big blind 250
*** HOLE CARDS ***
Dealt to jcarlos.vale [4c As]
IBMaN78: folds 
mgrjf: raises 270 to 520
69PUSHA96: calls 520
jcarlos.vale: folds 
premium.antifa: folds 
vogelao: folds 
jonnesen777: folds 
1922kondrat: folds 
Elwis08: calls 270
*** FLOP *** [Qc Th 8s]
Elwis08: checks 
mgrjf: bets 615
69PUSHA96: raises 615 to 1230
Elwis08: raises 2020 to 3250
mgrjf: folds 
69PUSHA96: raises 2205 to 5455 and is all-in
Elwis08: calls 2205
*** TURN *** [Qc Th 8s] [Js]
*** RIVER *** [Qc Th 8s Js] [4d]
*** SHOW DOWN ***
Elwis08: shows [Jc 9h] (a straight, Eight to Queen)
69PUSHA96: shows [Qd 8d] (two pair, Queens and Eights)
Elwis08 collected 13390 from pot
69PUSHA96 finished the tournament
*** SUMMARY ***
Total pot 13390 | Rake 0 
Board [Qc Th 8s Js 4d]
Seat 1: jcarlos.vale folded before Flop (didn't bet)
Seat 2: premium.antifa folded before Flop (didn't bet)
Seat 3: vogelao folded before Flop (didn't bet)
Seat 4: jonnesen777 (button) folded before Flop (didn't bet)
Seat 5: 1922kondrat (small blind) folded before Flop
Seat 6: Elwis08 (big blind) showed [Jc 9h] and won (13390) with a straight, Eight to Queen
Seat 7: IBMaN78 folded before Flop (didn't bet)
Seat 8: mgrjf folded on the Flop
Seat 9: 69PUSHA96 showed [Qd 8d] and lost with two pair, Queens and Eights



PokerStars Hand #221913665364: Tournament #3082648141, $0.98+$0.12 USD Hold'em No Limit - Level X (125/250) - 2020/12/27 21:47:33 EET [2020/12/27 14:47:33 ET]
Table '3082648141 274' 9-max Seat #5 is the button
Seat 1: jcarlos.vale (6717 in chips) 
Seat 2: premium.antifa (4960 in chips) 
Seat 3: vogelao (8735 in chips) 
Seat 4: jonnesen777 (4540 in chips) 
Seat 5: 1922kondrat (4494 in chips) 
Seat 6: Elwis08 (36220 in chips) 
Seat 7: IBMaN78 (4980 in chips) 
Seat 8: mgrjf (7490 in chips) 
jcarlos.vale: posts the ante 20
premium.antifa: posts the ante 20
vogelao: posts the ante 20
jonnesen777: posts the ante 20
1922kondrat: posts the ante 20
Elwis08: posts the ante 20
IBMaN78: posts the ante 20
mgrjf: posts the ante 20
Elwis08: posts small blind 125
IBMaN78: posts big blind 250
*** HOLE CARDS ***
Dealt to jcarlos.vale [7c Js]
mgrjf: folds 
jcarlos.vale: folds 
premium.antifa: folds 
vogelao: folds 
jonnesen777: calls 250
1922kondrat: raises 4224 to 4474 and is all-in
Elwis08: folds 
IBMaN78: folds 
jonnesen777: folds 
Uncalled bet (4224) returned to 1922kondrat
1922kondrat collected 1035 from pot
1922kondrat: doesn't show handDTO
*** SUMMARY ***
Total pot 1035 | Rake 0 
Seat 1: jcarlos.vale folded before Flop (didn't bet)
Seat 2: premium.antifa folded before Flop (didn't bet)
Seat 3: vogelao folded before Flop (didn't bet)
Seat 4: jonnesen777 folded before Flop
Seat 5: 1922kondrat (button) collected (1035)
Seat 6: Elwis08 (small blind) folded before Flop
Seat 7: IBMaN78 (big blind) folded before Flop
Seat 8: mgrjf folded before Flop (didn't bet)



PokerStars Hand #221913687508: Tournament #3082648141, $0.98+$0.12 USD Hold'em No Limit - Level X (125/250) - 2020/12/27 21:47:57 EET [2020/12/27 14:47:57 ET]
Table '3082648141 274' 9-max Seat #6 is the button
Seat 1: jcarlos.vale (6697 in chips) 
Seat 2: premium.antifa (4940 in chips) 
Seat 3: vogelao (8715 in chips) 
Seat 4: jonnesen777 (4270 in chips) 
Seat 5: 1922kondrat (5259 in chips) 
Seat 6: Elwis08 (36075 in chips) 
Seat 7: IBMaN78 (4710 in chips) 
Seat 8: mgrjf (7470 in chips) 
jcarlos.vale: posts the ante 20
premium.antifa: posts the ante 20
vogelao: posts the ante 20
jonnesen777: posts the ante 20
1922kondrat: posts the ante 20
Elwis08: posts the ante 20
IBMaN78: posts the ante 20
mgrjf: posts the ante 20
IBMaN78: posts small blind 125
mgrjf: posts big blind 250
*** HOLE CARDS ***
Dealt to jcarlos.vale [Jc 9h]
jcarlos.vale: folds 
premium.antifa: folds 
vogelao: folds 
jonnesen777: folds 
1922kondrat: folds 
Elwis08: raises 250 to 500
IBMaN78: calls 375
mgrjf: folds 
*** FLOP *** [8h Qc Qd]
IBMaN78: checks 
Elwis08: bets 465
IBMaN78: calls 465
*** TURN *** [8h Qc Qd] [8s]
IBMaN78: checks 
Elwis08: checks 
*** RIVER *** [8h Qc Qd 8s] [6h]
IBMaN78: bets 1170
Elwis08: folds 
Uncalled bet (1170) returned to IBMaN78
IBMaN78 collected 2340 from pot
IBMaN78: doesn't show handDTO
*** SUMMARY ***
Total pot 2340 | Rake 0 
Board [8h Qc Qd 8s 6h]
Seat 1: jcarlos.vale folded before Flop (didn't bet)
Seat 2: premium.antifa folded before Flop (didn't bet)
Seat 3: vogelao folded before Flop (didn't bet)
Seat 4: jonnesen777 folded before Flop (didn't bet)
Seat 5: 1922kondrat folded before Flop (didn't bet)
Seat 6: Elwis08 (button) folded on the River
Seat 7: IBMaN78 (small blind) collected (2340)
Seat 8: mgrjf (big blind) folded before Flop



PokerStars Hand #221913726495: Tournament #3082648141, $0.98+$0.12 USD Hold'em No Limit - Level X (125/250) - 2020/12/27 21:48:38 EET [2020/12/27 14:48:38 ET]
Table '3082648141 274' 9-max Seat #7 is the button
Seat 1: jcarlos.vale (6677 in chips) 
Seat 2: premium.antifa (4920 in chips) 
Seat 3: vogelao (8695 in chips) 
Seat 4: jonnesen777 (4250 in chips) 
Seat 5: 1922kondrat (5239 in chips) 
Seat 6: Elwis08 (35090 in chips) 
Seat 7: IBMaN78 (6065 in chips) 
Seat 8: mgrjf (7200 in chips) 
Seat 9: FabOliveira9 (11959 in chips) 
jcarlos.vale: posts the ante 20
premium.antifa: posts the ante 20
vogelao: posts the ante 20
jonnesen777: posts the ante 20
1922kondrat: posts the ante 20
Elwis08: posts the ante 20
IBMaN78: posts the ante 20
mgrjf: posts the ante 20
FabOliveira9: posts the ante 20
mgrjf: posts small blind 125
FabOliveira9: posts big blind 250
*** HOLE CARDS ***
Dealt to jcarlos.vale [4d 8d]
jcarlos.vale: folds 
premium.antifa: folds 
vogelao: raises 250 to 500
jonnesen777: folds 
1922kondrat: calls 500
Elwis08: folds 
IBMaN78: folds 
mgrjf: folds 
FabOliveira9: calls 250
*** FLOP *** [Kh 7c 8c]
FabOliveira9: checks 
vogelao: checks 
1922kondrat: checks 
*** TURN *** [Kh 7c 8c] [6c]
FabOliveira9: checks 
vogelao: checks 
1922kondrat: checks 
*** RIVER *** [Kh 7c 8c 6c] [8s]
FabOliveira9: checks 
vogelao: checks 
1922kondrat: checks 
*** SHOW DOWN ***
FabOliveira9: shows [Jh 4s] (a pair of Eights)
vogelao: shows [Ac Td] (a pair of Eights - Ace kicker)
1922kondrat: mucks handDTO
vogelao collected 1805 from pot
*** SUMMARY ***
Total pot 1805 | Rake 0 
Board [Kh 7c 8c 6c 8s]
Seat 1: jcarlos.vale folded before Flop (didn't bet)
Seat 2: premium.antifa folded before Flop (didn't bet)
Seat 3: vogelao showed [Ac Td] and won (1805) with a pair of Eights
Seat 4: jonnesen777 folded before Flop (didn't bet)
Seat 5: 1922kondrat mucked [Qs Js]
Seat 6: Elwis08 folded before Flop (didn't bet)
Seat 7: IBMaN78 (button) folded before Flop (didn't bet)
Seat 8: mgrjf (small blind) folded before Flop
Seat 9: FabOliveira9 (big blind) showed [Jh 4s] and lost with a pair of Eights



PokerStars Hand #221913781677: Tournament #3082648141, $0.98+$0.12 USD Hold'em No Limit - Level XI (150/300) - 2020/12/27 21:49:36 EET [2020/12/27 14:49:36 ET]
Table '3082648141 274' 9-max Seat #8 is the button
Seat 1: jcarlos.vale (6657 in chips) 
Seat 2: premium.antifa (4900 in chips) 
Seat 3: vogelao (9980 in chips) 
Seat 4: jonnesen777 (4230 in chips) 
Seat 5: 1922kondrat (4719 in chips) 
Seat 6: Elwis08 (35070 in chips) 
Seat 7: IBMaN78 (6045 in chips) 
Seat 8: mgrjf (7055 in chips) 
Seat 9: FabOliveira9 (11439 in chips) 
jcarlos.vale: posts the ante 22
premium.antifa: posts the ante 22
vogelao: posts the ante 22
jonnesen777: posts the ante 22
1922kondrat: posts the ante 22
Elwis08: posts the ante 22
IBMaN78: posts the ante 22
mgrjf: posts the ante 22
FabOliveira9: posts the ante 22
FabOliveira9: posts small blind 150
jcarlos.vale: posts big blind 300
*** HOLE CARDS ***
Dealt to jcarlos.vale [4d 9d]
premium.antifa: folds 
vogelao: folds 
jonnesen777: folds 
1922kondrat: folds 
Elwis08: folds 
IBMaN78: raises 600 to 900
mgrjf: folds 
FabOliveira9: folds 
jcarlos.vale: folds 
Uncalled bet (600) returned to IBMaN78
IBMaN78 collected 948 from pot
IBMaN78: doesn't show handDTO
*** SUMMARY ***
Total pot 948 | Rake 0 
Seat 1: jcarlos.vale (big blind) folded before Flop
Seat 2: premium.antifa folded before Flop (didn't bet)
Seat 3: vogelao folded before Flop (didn't bet)
Seat 4: jonnesen777 folded before Flop (didn't bet)
Seat 5: 1922kondrat folded before Flop (didn't bet)
Seat 6: Elwis08 folded before Flop (didn't bet)
Seat 7: IBMaN78 collected (948)
Seat 8: mgrjf (button) folded before Flop (didn't bet)
Seat 9: FabOliveira9 (small blind) folded before Flop



PokerStars Hand #221913805935: Tournament #3082648141, $0.98+$0.12 USD Hold'em No Limit - Level XI (150/300) - 2020/12/27 21:50:01 EET [2020/12/27 14:50:01 ET]
Table '3082648141 274' 9-max Seat #9 is the button
Seat 1: jcarlos.vale (6335 in chips) 
Seat 2: premium.antifa (4878 in chips) 
Seat 3: vogelao (9958 in chips) 
Seat 4: jonnesen777 (4208 in chips) 
Seat 5: 1922kondrat (4697 in chips) 
Seat 6: Elwis08 (35048 in chips) 
Seat 7: IBMaN78 (6671 in chips) 
Seat 8: mgrjf (7033 in chips) 
Seat 9: FabOliveira9 (11267 in chips) 
jcarlos.vale: posts the ante 22
premium.antifa: posts the ante 22
vogelao: posts the ante 22
jonnesen777: posts the ante 22
1922kondrat: posts the ante 22
Elwis08: posts the ante 22
IBMaN78: posts the ante 22
mgrjf: posts the ante 22
FabOliveira9: posts the ante 22
jcarlos.vale: posts small blind 150
premium.antifa: posts big blind 300
*** HOLE CARDS ***
Dealt to jcarlos.vale [Th 6s]
vogelao: raises 300 to 600
jonnesen777: raises 3586 to 4186 and is all-in
1922kondrat: folds 
Elwis08: folds 
IBMaN78: folds 
mgrjf: folds 
FabOliveira9: folds 
jcarlos.vale: folds 
premium.antifa: folds 
vogelao: folds [Qc Ah]
Uncalled bet (3586) returned to jonnesen777
jonnesen777 collected 1848 from pot
jonnesen777: doesn't show handDTO
*** SUMMARY ***
Total pot 1848 | Rake 0 
Seat 1: jcarlos.vale (small blind) folded before Flop
Seat 2: premium.antifa (big blind) folded before Flop
Seat 3: vogelao folded before Flop
Seat 4: jonnesen777 collected (1848)
Seat 5: 1922kondrat folded before Flop (didn't bet)
Seat 6: Elwis08 folded before Flop (didn't bet)
Seat 7: IBMaN78 folded before Flop (didn't bet)
Seat 8: mgrjf folded before Flop (didn't bet)
Seat 9: FabOliveira9 (button) folded before Flop (didn't bet)



PokerStars Hand #221913843622: Tournament #3082648141, $0.98+$0.12 USD Hold'em No Limit - Level XI (150/300) - 2020/12/27 21:50:41 EET [2020/12/27 14:50:41 ET]
Table '3082648141 274' 9-max Seat #1 is the button
Seat 1: jcarlos.vale (6163 in chips) 
Seat 2: premium.antifa (4556 in chips) 
Seat 3: vogelao (9336 in chips) 
Seat 4: jonnesen777 (5434 in chips) 
Seat 5: 1922kondrat (4675 in chips) 
Seat 6: Elwis08 (35026 in chips) 
Seat 7: IBMaN78 (6649 in chips) 
Seat 8: mgrjf (7011 in chips) 
Seat 9: FabOliveira9 (11245 in chips) 
jcarlos.vale: posts the ante 22
premium.antifa: posts the ante 22
vogelao: posts the ante 22
jonnesen777: posts the ante 22
1922kondrat: posts the ante 22
Elwis08: posts the ante 22
IBMaN78: posts the ante 22
mgrjf: posts the ante 22
FabOliveira9: posts the ante 22
premium.antifa: posts small blind 150
vogelao: posts big blind 300
*** HOLE CARDS ***
Dealt to jcarlos.vale [4c 3h]
jonnesen777: folds 
1922kondrat: folds 
Elwis08: raises 300 to 600
IBMaN78: folds 
mgrjf: folds 
FabOliveira9: folds 
jcarlos.vale: folds 
premium.antifa: folds 
vogelao: folds 
Uncalled bet (300) returned to Elwis08
Elwis08 collected 948 from pot
Elwis08: doesn't show handDTO
*** SUMMARY ***
Total pot 948 | Rake 0 
Seat 1: jcarlos.vale (button) folded before Flop (didn't bet)
Seat 2: premium.antifa (small blind) folded before Flop
Seat 3: vogelao (big blind) folded before Flop
Seat 4: jonnesen777 folded before Flop (didn't bet)
Seat 5: 1922kondrat folded before Flop (didn't bet)
Seat 6: Elwis08 collected (948)
Seat 7: IBMaN78 folded before Flop (didn't bet)
Seat 8: mgrjf folded before Flop (didn't bet)
Seat 9: FabOliveira9 folded before Flop (didn't bet)



PokerStars Hand #221913863983: Tournament #3082648141, $0.98+$0.12 USD Hold'em No Limit - Level XI (150/300) - 2020/12/27 21:51:03 EET [2020/12/27 14:51:03 ET]
Table '3082648141 274' 9-max Seat #2 is the button
Seat 1: jcarlos.vale (6141 in chips) 
Seat 2: premium.antifa (4384 in chips) 
Seat 3: vogelao (9014 in chips) 
Seat 4: jonnesen777 (5412 in chips) 
Seat 5: 1922kondrat (4653 in chips) 
Seat 6: Elwis08 (35652 in chips) 
Seat 7: IBMaN78 (6627 in chips) 
Seat 8: mgrjf (6989 in chips) 
Seat 9: FabOliveira9 (11223 in chips) 
jcarlos.vale: posts the ante 22
premium.antifa: posts the ante 22
vogelao: posts the ante 22
jonnesen777: posts the ante 22
1922kondrat: posts the ante 22
Elwis08: posts the ante 22
IBMaN78: posts the ante 22
mgrjf: posts the ante 22
FabOliveira9: posts the ante 22
vogelao: posts small blind 150
jonnesen777: posts big blind 300
*** HOLE CARDS ***
Dealt to jcarlos.vale [Qd Qc]
1922kondrat: folds 
Elwis08: folds 
IBMaN78: folds 
mgrjf: folds 
FabOliveira9: folds 
jcarlos.vale: raises 480 to 780
premium.antifa: folds 
vogelao: calls 630
jonnesen777: calls 480
*** FLOP *** [Jh 7h 5c]
vogelao: checks 
jonnesen777: checks 
jcarlos.vale: bets 1904
vogelao: folds 
jonnesen777: folds 
Uncalled bet (1904) returned to jcarlos.vale
jcarlos.vale collected 2538 from pot
jcarlos.vale: doesn't show handDTO
*** SUMMARY ***
Total pot 2538 | Rake 0 
Board [Jh 7h 5c]
Seat 1: jcarlos.vale collected (2538)
Seat 2: premium.antifa (button) folded before Flop (didn't bet)
Seat 3: vogelao (small blind) folded on the Flop
Seat 4: jonnesen777 (big blind) folded on the Flop
Seat 5: 1922kondrat folded before Flop (didn't bet)
Seat 6: Elwis08 folded before Flop (didn't bet)
Seat 7: IBMaN78 folded before Flop (didn't bet)
Seat 8: mgrjf folded before Flop (didn't bet)
Seat 9: FabOliveira9 folded before Flop (didn't bet)



PokerStars Hand #221913903504: Tournament #3082648141, $0.98+$0.12 USD Hold'em No Limit - Level XI (150/300) - 2020/12/27 21:51:45 EET [2020/12/27 14:51:45 ET]
Table '3082648141 274' 9-max Seat #3 is the button
Seat 1: jcarlos.vale (7877 in chips) 
Seat 2: premium.antifa (4362 in chips) 
Seat 3: vogelao (8212 in chips) 
Seat 4: jonnesen777 (4610 in chips) 
Seat 5: 1922kondrat (4631 in chips) 
Seat 6: Elwis08 (35630 in chips) 
Seat 7: IBMaN78 (6605 in chips) 
Seat 8: mgrjf (6967 in chips) 
Seat 9: FabOliveira9 (11201 in chips) 
jcarlos.vale: posts the ante 22
premium.antifa: posts the ante 22
vogelao: posts the ante 22
jonnesen777: posts the ante 22
1922kondrat: posts the ante 22
Elwis08: posts the ante 22
IBMaN78: posts the ante 22
mgrjf: posts the ante 22
FabOliveira9: posts the ante 22
jonnesen777: posts small blind 150
1922kondrat: posts big blind 300
*** HOLE CARDS ***
Dealt to jcarlos.vale [8h Qc]
Elwis08: folds 
IBMaN78: folds 
mgrjf: folds 
FabOliveira9: folds 
jcarlos.vale: folds 
premium.antifa: folds 
vogelao: raises 300 to 600
jonnesen777: folds 
1922kondrat: folds 
Uncalled bet (300) returned to vogelao
vogelao collected 948 from pot
vogelao: doesn't show handDTO
*** SUMMARY ***
Total pot 948 | Rake 0 
Seat 1: jcarlos.vale folded before Flop (didn't bet)
Seat 2: premium.antifa folded before Flop (didn't bet)
Seat 3: vogelao (button) collected (948)
Seat 4: jonnesen777 (small blind) folded before Flop
Seat 5: 1922kondrat (big blind) folded before Flop
Seat 6: Elwis08 folded before Flop (didn't bet)
Seat 7: IBMaN78 folded before Flop (didn't bet)
Seat 8: mgrjf folded before Flop (didn't bet)
Seat 9: FabOliveira9 folded before Flop (didn't bet)



PokerStars Hand #221913929319: Tournament #3082648141, $0.98+$0.12 USD Hold'em No Limit - Level XI (150/300) - 2020/12/27 21:52:12 EET [2020/12/27 14:52:12 ET]
Table '3082648141 274' 9-max Seat #4 is the button
Seat 1: jcarlos.vale (7855 in chips) 
Seat 2: premium.antifa (4340 in chips) 
Seat 3: vogelao (8838 in chips) 
Seat 4: jonnesen777 (4438 in chips) 
Seat 5: 1922kondrat (4309 in chips) 
Seat 6: Elwis08 (35608 in chips) 
Seat 7: IBMaN78 (6583 in chips) 
Seat 8: mgrjf (6945 in chips) 
Seat 9: FabOliveira9 (11179 in chips) 
jcarlos.vale: posts the ante 22
premium.antifa: posts the ante 22
vogelao: posts the ante 22
jonnesen777: posts the ante 22
1922kondrat: posts the ante 22
Elwis08: posts the ante 22
IBMaN78: posts the ante 22
mgrjf: posts the ante 22
FabOliveira9: posts the ante 22
1922kondrat: posts small blind 150
Elwis08: posts big blind 300
*** HOLE CARDS ***
Dealt to jcarlos.vale [Ks 3d]
IBMaN78: folds 
mgrjf: folds 
FabOliveira9: folds 
jcarlos.vale: folds 
premium.antifa: calls 300
vogelao: folds 
jonnesen777: folds 
1922kondrat: folds 
Elwis08: checks 
*** FLOP *** [Qs Kc 9c]
Elwis08: checks 
premium.antifa: checks 
*** TURN *** [Qs Kc 9c] [5c]
Elwis08: checks 
premium.antifa: checks 
*** RIVER *** [Qs Kc 9c 5c] [7d]
Elwis08: checks 
premium.antifa: checks 
*** SHOW DOWN ***
Elwis08: shows [7c 4s] (a pair of Sevens)
premium.antifa: shows [9h Jc] (a pair of Nines)
premium.antifa collected 948 from pot
*** SUMMARY ***
Total pot 948 | Rake 0 
Board [Qs Kc 9c 5c 7d]
Seat 1: jcarlos.vale folded before Flop (didn't bet)
Seat 2: premium.antifa showed [9h Jc] and won (948) with a pair of Nines
Seat 3: vogelao folded before Flop (didn't bet)
Seat 4: jonnesen777 (button) folded before Flop (didn't bet)
Seat 5: 1922kondrat (small blind) folded before Flop
Seat 6: Elwis08 (big blind) showed [7c 4s] and lost with a pair of Sevens
Seat 7: IBMaN78 folded before Flop (didn't bet)
Seat 8: mgrjf folded before Flop (didn't bet)
Seat 9: FabOliveira9 folded before Flop (didn't bet)



PokerStars Hand #221913966422: Tournament #3082648141, $0.98+$0.12 USD Hold'em No Limit - Level XI (150/300) - 2020/12/27 21:52:52 EET [2020/12/27 14:52:52 ET]
Table '3082648141 274' 9-max Seat #5 is the button
Seat 1: jcarlos.vale (7833 in chips) 
Seat 2: premium.antifa (4966 in chips) 
Seat 3: vogelao (8816 in chips) 
Seat 4: jonnesen777 (4416 in chips) 
Seat 5: 1922kondrat (4137 in chips) 
Seat 6: Elwis08 (35286 in chips) 
Seat 7: IBMaN78 (6561 in chips) 
Seat 8: mgrjf (6923 in chips) 
Seat 9: FabOliveira9 (11157 in chips) 
jcarlos.vale: posts the ante 22
premium.antifa: posts the ante 22
vogelao: posts the ante 22
jonnesen777: posts the ante 22
1922kondrat: posts the ante 22
Elwis08: posts the ante 22
IBMaN78: posts the ante 22
mgrjf: posts the ante 22
FabOliveira9: posts the ante 22
Elwis08: posts small blind 150
IBMaN78: posts big blind 300
*** HOLE CARDS ***
Dealt to jcarlos.vale [Th 4d]
mgrjf: folds 
FabOliveira9: folds 
jcarlos.vale: folds 
premium.antifa: folds 
vogelao: folds 
jonnesen777: folds 
1922kondrat: raises 3815 to 4115 and is all-in
Elwis08: folds 
IBMaN78: folds 
Uncalled bet (3815) returned to 1922kondrat
1922kondrat collected 948 from pot
1922kondrat: doesn't show handDTO
*** SUMMARY ***
Total pot 948 | Rake 0 
Seat 1: jcarlos.vale folded before Flop (didn't bet)
Seat 2: premium.antifa folded before Flop (didn't bet)
Seat 3: vogelao folded before Flop (didn't bet)
Seat 4: jonnesen777 folded before Flop (didn't bet)
Seat 5: 1922kondrat (button) collected (948)
Seat 6: Elwis08 (small blind) folded before Flop
Seat 7: IBMaN78 (big blind) folded before Flop
Seat 8: mgrjf folded before Flop (didn't bet)
Seat 9: FabOliveira9 folded before Flop (didn't bet)



PokerStars Hand #221914011570: Tournament #3082648141, $0.98+$0.12 USD Hold'em No Limit - Level XI (150/300) - 2020/12/27 21:53:32 EET [2020/12/27 14:53:32 ET]
Table '3082648141 274' 9-max Seat #6 is the button
Seat 1: jcarlos.vale (7811 in chips) 
Seat 2: premium.antifa (4944 in chips) 
Seat 3: vogelao (8794 in chips) 
Seat 4: jonnesen777 (4394 in chips) 
Seat 5: 1922kondrat (4763 in chips) 
Seat 6: Elwis08 (35114 in chips) 
Seat 7: IBMaN78 (6239 in chips) 
Seat 8: mgrjf (6901 in chips) 
Seat 9: FabOliveira9 (11135 in chips) 
jcarlos.vale: posts the ante 22
premium.antifa: posts the ante 22
vogelao: posts the ante 22
jonnesen777: posts the ante 22
1922kondrat: posts the ante 22
Elwis08: posts the ante 22
IBMaN78: posts the ante 22
mgrjf: posts the ante 22
FabOliveira9: posts the ante 22
IBMaN78: posts small blind 150
mgrjf: posts big blind 300
*** HOLE CARDS ***
Dealt to jcarlos.vale [As 9d]
FabOliveira9: raises 450 to 750
jcarlos.vale: folds 
premium.antifa: folds 
vogelao: folds 
jonnesen777: folds 
1922kondrat: folds 
Elwis08: calls 750
IBMaN78: folds 
mgrjf: folds 
*** FLOP *** [2d 8d 5c]
FabOliveira9: bets 900
Elwis08: folds 
Uncalled bet (900) returned to FabOliveira9
FabOliveira9 collected 2148 from pot
FabOliveira9: doesn't show handDTO
*** SUMMARY ***
Total pot 2148 | Rake 0 
Board [2d 8d 5c]
Seat 1: jcarlos.vale folded before Flop (didn't bet)
Seat 2: premium.antifa folded before Flop (didn't bet)
Seat 3: vogelao folded before Flop (didn't bet)
Seat 4: jonnesen777 folded before Flop (didn't bet)
Seat 5: 1922kondrat folded before Flop (didn't bet)
Seat 6: Elwis08 (button) folded on the Flop
Seat 7: IBMaN78 (small blind) folded before Flop
Seat 8: mgrjf (big blind) folded before Flop
Seat 9: FabOliveira9 collected (2148)



PokerStars Hand #221914046096: Tournament #3082648141, $0.98+$0.12 USD Hold'em No Limit - Level XI (150/300) - 2020/12/27 21:54:09 EET [2020/12/27 14:54:09 ET]
Table '3082648141 274' 9-max Seat #7 is the button
Seat 1: jcarlos.vale (7789 in chips) 
Seat 2: premium.antifa (4922 in chips) 
Seat 3: vogelao (8772 in chips) 
Seat 4: jonnesen777 (4372 in chips) 
Seat 5: 1922kondrat (4741 in chips) 
Seat 6: Elwis08 (34342 in chips) 
Seat 7: IBMaN78 (6067 in chips) 
Seat 8: mgrjf (6579 in chips) 
Seat 9: FabOliveira9 (12511 in chips) 
jcarlos.vale: posts the ante 22
premium.antifa: posts the ante 22
vogelao: posts the ante 22
jonnesen777: posts the ante 22
1922kondrat: posts the ante 22
Elwis08: posts the ante 22
IBMaN78: posts the ante 22
mgrjf: posts the ante 22
FabOliveira9: posts the ante 22
mgrjf: posts small blind 150
FabOliveira9: posts big blind 300
*** HOLE CARDS ***
Dealt to jcarlos.vale [9d Ts]
jcarlos.vale: folds 
premium.antifa: raises 4600 to 4900 and is all-in
vogelao: folds 
jonnesen777: folds 
1922kondrat: folds 
Elwis08: folds 
IBMaN78: folds 
mgrjf: folds 
FabOliveira9: folds 
Uncalled bet (4600) returned to premium.antifa
premium.antifa collected 948 from pot
premium.antifa: doesn't show handDTO
*** SUMMARY ***
Total pot 948 | Rake 0 
Seat 1: jcarlos.vale folded before Flop (didn't bet)
Seat 2: premium.antifa collected (948)
Seat 3: vogelao folded before Flop (didn't bet)
Seat 4: jonnesen777 folded before Flop (didn't bet)
Seat 5: 1922kondrat folded before Flop (didn't bet)
Seat 6: Elwis08 folded before Flop (didn't bet)
Seat 7: IBMaN78 (button) folded before Flop (didn't bet)
Seat 8: mgrjf (small blind) folded before Flop
Seat 9: FabOliveira9 (big blind) folded before Flop



PokerStars Hand #221914103562: Tournament #3082648141, $0.98+$0.12 USD Hold'em No Limit - Level XI (150/300) - 2020/12/27 21:55:10 EET [2020/12/27 14:55:10 ET]
Table '3082648141 274' 9-max Seat #8 is the button
Seat 1: jcarlos.vale (7767 in chips) 
Seat 2: premium.antifa (5548 in chips) 
Seat 3: vogelao (8750 in chips) 
Seat 4: jonnesen777 (4350 in chips) 
Seat 5: 1922kondrat (4719 in chips) 
Seat 6: Elwis08 (34320 in chips) 
Seat 7: IBMaN78 (6045 in chips) 
Seat 8: mgrjf (6407 in chips) 
Seat 9: FabOliveira9 (12189 in chips) 
jcarlos.vale: posts the ante 22
premium.antifa: posts the ante 22
vogelao: posts the ante 22
jonnesen777: posts the ante 22
1922kondrat: posts the ante 22
Elwis08: posts the ante 22
IBMaN78: posts the ante 22
mgrjf: posts the ante 22
FabOliveira9: posts the ante 22
FabOliveira9: posts small blind 150
jcarlos.vale: posts big blind 300
*** HOLE CARDS ***
Dealt to jcarlos.vale [6s Th]
premium.antifa: folds 
vogelao: folds 
jonnesen777: folds 
1922kondrat: folds 
Elwis08: folds 
IBMaN78: folds 
mgrjf: folds 
FabOliveira9: raises 600 to 900
jcarlos.vale: folds 
Uncalled bet (600) returned to FabOliveira9
FabOliveira9 collected 798 from pot
FabOliveira9: doesn't show handDTO
*** SUMMARY ***
Total pot 798 | Rake 0 
Seat 1: jcarlos.vale (big blind) folded before Flop
Seat 2: premium.antifa folded before Flop (didn't bet)
Seat 3: vogelao folded before Flop (didn't bet)
Seat 4: jonnesen777 folded before Flop (didn't bet)
Seat 5: 1922kondrat folded before Flop (didn't bet)
Seat 6: Elwis08 folded before Flop (didn't bet)
Seat 7: IBMaN78 folded before Flop (didn't bet)
Seat 8: mgrjf (button) folded before Flop (didn't bet)
Seat 9: FabOliveira9 (small blind) collected (798)



PokerStars Hand #221914352303: Tournament #3082648141, $0.98+$0.12 USD Hold'em No Limit - Level XI (150/300) - 2020/12/27 22:02:10 EET [2020/12/27 15:02:10 ET]
Table '3082648141 274' 9-max Seat #9 is the button
Seat 1: jcarlos.vale (7445 in chips) 
Seat 2: premium.antifa (5526 in chips) 
Seat 3: vogelao (8728 in chips) 
Seat 4: jonnesen777 (4328 in chips) 
Seat 5: 1922kondrat (4697 in chips) 
Seat 6: Elwis08 (34298 in chips) 
Seat 7: IBMaN78 (6023 in chips) 
Seat 8: mgrjf (6385 in chips) 
Seat 9: FabOliveira9 (12665 in chips) 
jcarlos.vale: posts the ante 22
premium.antifa: posts the ante 22
vogelao: posts the ante 22
jonnesen777: posts the ante 22
1922kondrat: posts the ante 22
Elwis08: posts the ante 22
IBMaN78: posts the ante 22
mgrjf: posts the ante 22
FabOliveira9: posts the ante 22
jcarlos.vale: posts small blind 150
premium.antifa: posts big blind 300
*** HOLE CARDS ***
Dealt to jcarlos.vale [3d Kh]
vogelao: folds 
jonnesen777: folds 
1922kondrat: folds 
Elwis08: folds 
IBMaN78: raises 600 to 900
mgrjf: folds 
FabOliveira9: calls 900
jcarlos.vale: folds 
premium.antifa: folds 
*** FLOP *** [2s 7s 2c]
IBMaN78: bets 1224
FabOliveira9: calls 1224
*** TURN *** [2s 7s 2c] [Ac]
IBMaN78: checks 
FabOliveira9: bets 10519 and is all-in
IBMaN78: folds 
Uncalled bet (10519) returned to FabOliveira9
FabOliveira9 collected 4896 from pot
FabOliveira9: doesn't show handDTO
*** SUMMARY ***
Total pot 4896 | Rake 0 
Board [2s 7s 2c Ac]
Seat 1: jcarlos.vale (small blind) folded before Flop
Seat 2: premium.antifa (big blind) folded before Flop
Seat 3: vogelao folded before Flop (didn't bet)
Seat 4: jonnesen777 folded before Flop (didn't bet)
Seat 5: 1922kondrat folded before Flop (didn't bet)
Seat 6: Elwis08 folded before Flop (didn't bet)
Seat 7: IBMaN78 folded on the Turn
Seat 8: mgrjf folded before Flop (didn't bet)
Seat 9: FabOliveira9 (button) collected (4896)



PokerStars Hand #221914408393: Tournament #3082648141, $0.98+$0.12 USD Hold'em No Limit - Level XI (150/300) - 2020/12/27 22:03:10 EET [2020/12/27 15:03:10 ET]
Table '3082648141 274' 9-max Seat #1 is the button
Seat 1: jcarlos.vale (7273 in chips) 
Seat 2: premium.antifa (5204 in chips) 
Seat 3: vogelao (8706 in chips) 
Seat 4: jonnesen777 (4306 in chips) 
Seat 5: 1922kondrat (4675 in chips) 
Seat 6: Elwis08 (34276 in chips) 
Seat 7: IBMaN78 (3877 in chips) 
Seat 8: mgrjf (6363 in chips) 
Seat 9: FabOliveira9 (15415 in chips) 
jcarlos.vale: posts the ante 22
premium.antifa: posts the ante 22
vogelao: posts the ante 22
jonnesen777: posts the ante 22
1922kondrat: posts the ante 22
Elwis08: posts the ante 22
IBMaN78: posts the ante 22
mgrjf: posts the ante 22
FabOliveira9: posts the ante 22
premium.antifa: posts small blind 150
vogelao: posts big blind 300
*** HOLE CARDS ***
Dealt to jcarlos.vale [3d 3h]
jonnesen777: folds 
1922kondrat: raises 4353 to 4653 and is all-in
Elwis08: calls 4653
IBMaN78: folds 
mgrjf: folds 
FabOliveira9: folds 
jcarlos.vale: folds 
premium.antifa: folds 
vogelao: folds 
*** FLOP *** [Ac 5h Ad]
*** TURN *** [Ac 5h Ad] [Kc]
*** RIVER *** [Ac 5h Ad Kc] [4s]
*** SHOW DOWN ***
1922kondrat: shows [Ah 8s] (three of a kind, Aces)
Elwis08: shows [Qh Jh] (a pair of Aces)
1922kondrat collected 9954 from pot
*** SUMMARY ***
Total pot 9954 | Rake 0 
Board [Ac 5h Ad Kc 4s]
Seat 1: jcarlos.vale (button) folded before Flop (didn't bet)
Seat 2: premium.antifa (small blind) folded before Flop
Seat 3: vogelao (big blind) folded before Flop
Seat 4: jonnesen777 folded before Flop (didn't bet)
Seat 5: 1922kondrat showed [Ah 8s] and won (9954) with three of a kind, Aces
Seat 6: Elwis08 showed [Qh Jh] and lost with a pair of Aces
Seat 7: IBMaN78 folded before Flop (didn't bet)
Seat 8: mgrjf folded before Flop (didn't bet)
Seat 9: FabOliveira9 folded before Flop (didn't bet)



PokerStars Hand #221914439627: Tournament #3082648141, $0.98+$0.12 USD Hold'em No Limit - Level XI (150/300) - 2020/12/27 22:03:45 EET [2020/12/27 15:03:45 ET]
Table '3082648141 274' 9-max Seat #2 is the button
Seat 1: jcarlos.vale (7251 in chips) 
Seat 2: premium.antifa (5032 in chips) 
Seat 3: vogelao (8384 in chips) 
Seat 4: jonnesen777 (4284 in chips) 
Seat 5: 1922kondrat (9954 in chips) 
Seat 6: Elwis08 (29601 in chips) 
Seat 7: IBMaN78 (3855 in chips) 
Seat 8: mgrjf (6341 in chips) 
Seat 9: FabOliveira9 (15393 in chips) 
jcarlos.vale: posts the ante 22
premium.antifa: posts the ante 22
vogelao: posts the ante 22
jonnesen777: posts the ante 22
1922kondrat: posts the ante 22
Elwis08: posts the ante 22
IBMaN78: posts the ante 22
mgrjf: posts the ante 22
FabOliveira9: posts the ante 22
vogelao: posts small blind 150
jonnesen777: posts big blind 300
*** HOLE CARDS ***
Dealt to jcarlos.vale [Th 9d]
1922kondrat: raises 300 to 600
Elwis08: folds 
IBMaN78: folds 
mgrjf: folds 
FabOliveira9: folds 
jcarlos.vale: folds 
premium.antifa: calls 600
vogelao: folds 
jonnesen777: folds 
*** FLOP *** [5c Ac 9h]
1922kondrat: bets 610
premium.antifa: raises 610 to 1220
1922kondrat: folds 
Uncalled bet (610) returned to premium.antifa
premium.antifa collected 3068 from pot
premium.antifa: doesn't show handDTO
*** SUMMARY ***
Total pot 3068 | Rake 0 
Board [5c Ac 9h]
Seat 1: jcarlos.vale folded before Flop (didn't bet)
Seat 2: premium.antifa (button) collected (3068)
Seat 3: vogelao (small blind) folded before Flop
Seat 4: jonnesen777 (big blind) folded before Flop
Seat 5: 1922kondrat folded on the Flop
Seat 6: Elwis08 folded before Flop (didn't bet)
Seat 7: IBMaN78 folded before Flop (didn't bet)
Seat 8: mgrjf folded before Flop (didn't bet)
Seat 9: FabOliveira9 folded before Flop (didn't bet)



PokerStars Hand #221914475804: Tournament #3082648141, $0.98+$0.12 USD Hold'em No Limit - Level XI (150/300) - 2020/12/27 22:04:24 EET [2020/12/27 15:04:24 ET]
Table '3082648141 274' 9-max Seat #3 is the button
Seat 1: jcarlos.vale (7229 in chips) 
Seat 2: premium.antifa (6868 in chips) 
Seat 3: vogelao (8212 in chips) 
Seat 4: jonnesen777 (3962 in chips) 
Seat 5: 1922kondrat (8722 in chips) 
Seat 6: Elwis08 (29579 in chips) 
Seat 7: IBMaN78 (3833 in chips) 
Seat 8: mgrjf (6319 in chips) 
Seat 9: FabOliveira9 (15371 in chips) 
jcarlos.vale: posts the ante 22
premium.antifa: posts the ante 22
vogelao: posts the ante 22
jonnesen777: posts the ante 22
1922kondrat: posts the ante 22
Elwis08: posts the ante 22
IBMaN78: posts the ante 22
mgrjf: posts the ante 22
FabOliveira9: posts the ante 22
jonnesen777: posts small blind 150
1922kondrat: posts big blind 300
*** HOLE CARDS ***
Dealt to jcarlos.vale [4c Jc]
Elwis08: folds 
IBMaN78: folds 
mgrjf: folds 
FabOliveira9: raises 300 to 600
jcarlos.vale: folds 
premium.antifa: folds 
vogelao: folds 
jonnesen777: folds 
1922kondrat: folds 
Uncalled bet (300) returned to FabOliveira9
FabOliveira9 collected 948 from pot
FabOliveira9: doesn't show handDTO
*** SUMMARY ***
Total pot 948 | Rake 0 
Seat 1: jcarlos.vale folded before Flop (didn't bet)
Seat 2: premium.antifa folded before Flop (didn't bet)
Seat 3: vogelao (button) folded before Flop (didn't bet)
Seat 4: jonnesen777 (small blind) folded before Flop
Seat 5: 1922kondrat (big blind) folded before Flop
Seat 6: Elwis08 folded before Flop (didn't bet)
Seat 7: IBMaN78 folded before Flop (didn't bet)
Seat 8: mgrjf folded before Flop (didn't bet)
Seat 9: FabOliveira9 collected (948)



PokerStars Hand #221914505288: Tournament #3082648141, $0.98+$0.12 USD Hold'em No Limit - Level XI (150/300) - 2020/12/27 22:04:55 EET [2020/12/27 15:04:55 ET]
Table '3082648141 274' 9-max Seat #4 is the button
Seat 1: jcarlos.vale (7207 in chips) 
Seat 2: premium.antifa (6846 in chips) 
Seat 3: vogelao (8190 in chips) 
Seat 4: jonnesen777 (3790 in chips) 
Seat 5: 1922kondrat (8400 in chips) 
Seat 6: Elwis08 (29557 in chips) 
Seat 7: IBMaN78 (3811 in chips) 
Seat 8: mgrjf (6297 in chips) 
Seat 9: FabOliveira9 (15997 in chips) 
jcarlos.vale: posts the ante 22
premium.antifa: posts the ante 22
vogelao: posts the ante 22
jonnesen777: posts the ante 22
1922kondrat: posts the ante 22
Elwis08: posts the ante 22
IBMaN78: posts the ante 22
mgrjf: posts the ante 22
FabOliveira9: posts the ante 22
1922kondrat: posts small blind 150
Elwis08: posts big blind 300
*** HOLE CARDS ***
Dealt to jcarlos.vale [Ks Ah]
IBMaN78: folds 
mgrjf: folds 
FabOliveira9: folds 
jcarlos.vale: raises 480 to 780
premium.antifa: folds 
vogelao: folds 
jonnesen777: folds 
1922kondrat: calls 630
Elwis08: calls 480
*** FLOP *** [9h Jd 4s]
1922kondrat: checks 
Elwis08: checks 
jcarlos.vale: checks 
*** TURN *** [9h Jd 4s] [Ac]
1922kondrat: checks 
Elwis08: checks 
jcarlos.vale: bets 1904
1922kondrat: folds 
Elwis08: folds 
Uncalled bet (1904) returned to jcarlos.vale
jcarlos.vale collected 2538 from pot
jcarlos.vale: doesn't show handDTO
*** SUMMARY ***
Total pot 2538 | Rake 0 
Board [9h Jd 4s Ac]
Seat 1: jcarlos.vale collected (2538)
Seat 2: premium.antifa folded before Flop (didn't bet)
Seat 3: vogelao folded before Flop (didn't bet)
Seat 4: jonnesen777 (button) folded before Flop (didn't bet)
Seat 5: 1922kondrat (small blind) folded on the Turn
Seat 6: Elwis08 (big blind) folded on the Turn
Seat 7: IBMaN78 folded before Flop (didn't bet)
Seat 8: mgrjf folded before Flop (didn't bet)
Seat 9: FabOliveira9 folded before Flop (didn't bet)



PokerStars Hand #221914584482: Tournament #3082648141, $0.98+$0.12 USD Hold'em No Limit - Level XII (200/400) - 2020/12/27 22:06:16 EET [2020/12/27 15:06:16 ET]
Table '3082648141 274' 9-max Seat #5 is the button
Seat 1: jcarlos.vale (8943 in chips) 
Seat 2: premium.antifa (6824 in chips) 
Seat 3: vogelao (8168 in chips) 
Seat 4: jonnesen777 (3768 in chips) 
Seat 5: 1922kondrat (7598 in chips) 
Seat 6: Elwis08 (28755 in chips) 
Seat 7: IBMaN78 (3789 in chips) 
Seat 8: mgrjf (6275 in chips) 
Seat 9: FabOliveira9 (15975 in chips) 
jcarlos.vale: posts the ante 25
premium.antifa: posts the ante 25
vogelao: posts the ante 25
jonnesen777: posts the ante 25
1922kondrat: posts the ante 25
Elwis08: posts the ante 25
IBMaN78: posts the ante 25
mgrjf: posts the ante 25
FabOliveira9: posts the ante 25
Elwis08: posts small blind 200
IBMaN78: posts big blind 400
*** HOLE CARDS ***
Dealt to jcarlos.vale [Qs Th]
mgrjf: folds 
FabOliveira9: folds 
jcarlos.vale: folds 
premium.antifa: calls 400
vogelao: folds 
jonnesen777: folds 
1922kondrat: folds 
Elwis08: raises 2800 to 3200
IBMaN78: folds 
premium.antifa: calls 2800
*** FLOP *** [3h 7c 8d]
Elwis08: bets 2318
premium.antifa: raises 1281 to 3599 and is all-in
Elwis08: calls 1281
*** TURN *** [3h 7c 8d] [Ts]
*** RIVER *** [3h 7c 8d Ts] [7h]
*** SHOW DOWN ***
Elwis08: shows [8s 9s] (two pair, Eights and Sevens)
premium.antifa: shows [5s 5d] (two pair, Sevens and Fives)
Elwis08 collected 14223 from pot
premium.antifa finished the tournament in 1721st place
*** SUMMARY ***
Total pot 14223 | Rake 0 
Board [3h 7c 8d Ts 7h]
Seat 1: jcarlos.vale folded before Flop (didn't bet)
Seat 2: premium.antifa showed [5s 5d] and lost with two pair, Sevens and Fives
Seat 3: vogelao folded before Flop (didn't bet)
Seat 4: jonnesen777 folded before Flop (didn't bet)
Seat 5: 1922kondrat (button) folded before Flop (didn't bet)
Seat 6: Elwis08 (small blind) showed [8s 9s] and won (14223) with two pair, Eights and Sevens
Seat 7: IBMaN78 (big blind) folded before Flop
Seat 8: mgrjf folded before Flop (didn't bet)
Seat 9: FabOliveira9 folded before Flop (didn't bet)



PokerStars Hand #221914642435: Tournament #3082648141, $0.98+$0.12 USD Hold'em No Limit - Level XII (200/400) - 2020/12/27 22:07:15 EET [2020/12/27 15:07:15 ET]
Table '3082648141 274' 9-max Seat #6 is the button
Seat 1: jcarlos.vale (8918 in chips) 
Seat 3: vogelao (8143 in chips) 
Seat 4: jonnesen777 (3743 in chips) 
Seat 5: 1922kondrat (7573 in chips) 
Seat 6: Elwis08 (36154 in chips) 
Seat 7: IBMaN78 (3364 in chips) 
Seat 8: mgrjf (6250 in chips) 
Seat 9: FabOliveira9 (15950 in chips) 
jcarlos.vale: posts the ante 25
vogelao: posts the ante 25
jonnesen777: posts the ante 25
1922kondrat: posts the ante 25
Elwis08: posts the ante 25
IBMaN78: posts the ante 25
mgrjf: posts the ante 25
FabOliveira9: posts the ante 25
IBMaN78: posts small blind 200
mgrjf: posts big blind 400
*** HOLE CARDS ***
Dealt to jcarlos.vale [Ah 2h]
FabOliveira9: folds 
jcarlos.vale: calls 400
vogelao: folds 
jonnesen777: folds 
1922kondrat: raises 600 to 1000
Elwis08: folds 
IBMaN78: folds 
mgrjf: folds 
jcarlos.vale: folds 
Uncalled bet (600) returned to 1922kondrat
1922kondrat collected 1600 from pot
1922kondrat: doesn't show handDTO
*** SUMMARY ***
Total pot 1600 | Rake 0 
Seat 1: jcarlos.vale folded before Flop
Seat 3: vogelao folded before Flop (didn't bet)
Seat 4: jonnesen777 folded before Flop (didn't bet)
Seat 5: 1922kondrat collected (1600)
Seat 6: Elwis08 (button) folded before Flop (didn't bet)
Seat 7: IBMaN78 (small blind) folded before Flop
Seat 8: mgrjf (big blind) folded before Flop
Seat 9: FabOliveira9 folded before Flop (didn't bet)



PokerStars Hand #221914666228: Tournament #3082648141, $0.98+$0.12 USD Hold'em No Limit - Level XII (200/400) - 2020/12/27 22:07:39 EET [2020/12/27 15:07:39 ET]
Table '3082648141 274' 9-max Seat #7 is the button
Seat 1: jcarlos.vale (8493 in chips) 
Seat 2: praskachev (39911 in chips) 
Seat 3: vogelao (8118 in chips) 
Seat 4: jonnesen777 (3718 in chips) 
Seat 5: 1922kondrat (8748 in chips) 
Seat 6: Elwis08 (36129 in chips) 
Seat 7: IBMaN78 (3139 in chips) 
Seat 8: mgrjf (5825 in chips) 
Seat 9: FabOliveira9 (15925 in chips) 
jcarlos.vale: posts the ante 25
praskachev: posts the ante 25
vogelao: posts the ante 25
jonnesen777: posts the ante 25
1922kondrat: posts the ante 25
Elwis08: posts the ante 25
IBMaN78: posts the ante 25
mgrjf: posts the ante 25
FabOliveira9: posts the ante 25
mgrjf: posts small blind 200
FabOliveira9: posts big blind 400
*** HOLE CARDS ***
Dealt to jcarlos.vale [4h Ks]
jcarlos.vale: folds 
praskachev: folds 
vogelao: folds 
jonnesen777: raises 3293 to 3693 and is all-in
1922kondrat: folds 
Elwis08: folds 
IBMaN78: folds 
mgrjf: folds 
FabOliveira9: calls 3293
*** FLOP *** [Qs Qc 9d]
*** TURN *** [Qs Qc 9d] [7s]
*** RIVER *** [Qs Qc 9d 7s] [6s]
*** SHOW DOWN ***
FabOliveira9: shows [8s 8h] (two pair, Queens and Eights)
jonnesen777: shows [Kh Ah] (a pair of Queens)
FabOliveira9 collected 7811 from pot
jonnesen777 finished the tournament in 1689th place
*** SUMMARY ***
Total pot 7811 | Rake 0 
Board [Qs Qc 9d 7s 6s]
Seat 1: jcarlos.vale folded before Flop (didn't bet)
Seat 2: praskachev folded before Flop (didn't bet)
Seat 3: vogelao folded before Flop (didn't bet)
Seat 4: jonnesen777 showed [Kh Ah] and lost with a pair of Queens
Seat 5: 1922kondrat folded before Flop (didn't bet)
Seat 6: Elwis08 folded before Flop (didn't bet)
Seat 7: IBMaN78 (button) folded before Flop (didn't bet)
Seat 8: mgrjf (small blind) folded before Flop
Seat 9: FabOliveira9 (big blind) showed [8s 8h] and won (7811) with two pair, Queens and Eights



PokerStars Hand #221914693162: Tournament #3082648141, $0.98+$0.12 USD Hold'em No Limit - Level XII (200/400) - 2020/12/27 22:08:07 EET [2020/12/27 15:08:07 ET]
Table '3082648141 274' 9-max Seat #8 is the button
Seat 1: jcarlos.vale (8468 in chips) 
Seat 2: praskachev (39886 in chips) 
Seat 3: vogelao (8093 in chips) 
Seat 5: 1922kondrat (8723 in chips) 
Seat 6: Elwis08 (36104 in chips) 
Seat 7: IBMaN78 (3114 in chips) 
Seat 8: mgrjf (5600 in chips) 
Seat 9: FabOliveira9 (20018 in chips) 
jcarlos.vale: posts the ante 25
praskachev: posts the ante 25
vogelao: posts the ante 25
1922kondrat: posts the ante 25
Elwis08: posts the ante 25
IBMaN78: posts the ante 25
mgrjf: posts the ante 25
FabOliveira9: posts the ante 25
FabOliveira9: posts small blind 200
jcarlos.vale: posts big blind 400
*** HOLE CARDS ***
Dealt to jcarlos.vale [Jd Tc]
praskachev: raises 400 to 800
vogelao: folds 
1922kondrat: folds 
Elwis08: raises 1600 to 2400
IBMaN78: folds 
mgrjf: folds 
FabOliveira9: folds 
jcarlos.vale: folds 
praskachev: calls 1600
*** FLOP *** [2s Qd 6c]
praskachev: checks 
Elwis08: bets 1848
praskachev: calls 1848
*** TURN *** [2s Qd 6c] [8s]
praskachev: checks 
Elwis08: bets 7437
praskachev: folds 
Uncalled bet (7437) returned to Elwis08
Elwis08 collected 9296 from pot
Elwis08: doesn't show handDTO
*** SUMMARY ***
Total pot 9296 | Rake 0 
Board [2s Qd 6c 8s]
Seat 1: jcarlos.vale (big blind) folded before Flop
Seat 2: praskachev folded on the Turn
Seat 3: vogelao folded before Flop (didn't bet)
Seat 5: 1922kondrat folded before Flop (didn't bet)
Seat 6: Elwis08 collected (9296)
Seat 7: IBMaN78 folded before Flop (didn't bet)
Seat 8: mgrjf (button) folded before Flop (didn't bet)
Seat 9: FabOliveira9 (small blind) folded before Flop



PokerStars Hand #221914742970: Tournament #3082648141, $0.98+$0.12 USD Hold'em No Limit - Level XII (200/400) - 2020/12/27 22:08:57 EET [2020/12/27 15:08:57 ET]
Table '3082648141 274' 9-max Seat #9 is the button
Seat 1: jcarlos.vale (8043 in chips) 
Seat 2: praskachev (35613 in chips) 
Seat 3: vogelao (8068 in chips) 
Seat 4: nabajastars (33930 in chips) 
Seat 5: 1922kondrat (8698 in chips) 
Seat 6: Elwis08 (41127 in chips) 
Seat 7: IBMaN78 (3089 in chips) 
Seat 8: mgrjf (5575 in chips) 
Seat 9: FabOliveira9 (19793 in chips) 
jcarlos.vale: posts the ante 25
praskachev: posts the ante 25
vogelao: posts the ante 25
nabajastars: posts the ante 25
1922kondrat: posts the ante 25
Elwis08: posts the ante 25
IBMaN78: posts the ante 25
mgrjf: posts the ante 25
FabOliveira9: posts the ante 25
jcarlos.vale: posts small blind 200
praskachev: posts big blind 400
*** HOLE CARDS ***
Dealt to jcarlos.vale [Ts Ks]
vogelao: folds 
nabajastars: folds 
1922kondrat: folds 
Elwis08: raises 400 to 800
IBMaN78: folds 
mgrjf: folds 
FabOliveira9: calls 800
jcarlos.vale: calls 600
praskachev: calls 400
*** FLOP *** [2d 6s 7s]
jcarlos.vale: bets 1713
praskachev: folds 
Elwis08: folds 
FabOliveira9: raises 5087 to 6800
jcarlos.vale: raises 418 to 7218 and is all-in
FabOliveira9: calls 418
*** TURN *** [2d 6s 7s] [8c]
*** RIVER *** [2d 6s 7s 8c] [As]
*** SHOW DOWN ***
jcarlos.vale: shows [Ts Ks] (a flush, Ace high)
FabOliveira9: shows [7h 7c] (three of a kind, Sevens)
jcarlos.vale collected 17861 from pot
*** SUMMARY ***
Total pot 17861 | Rake 0 
Board [2d 6s 7s 8c As]
Seat 1: jcarlos.vale (small blind) showed [Ts Ks] and won (17861) with a flush, Ace high
Seat 2: praskachev (big blind) folded on the Flop
Seat 3: vogelao folded before Flop (didn't bet)
Seat 4: nabajastars folded before Flop (didn't bet)
Seat 5: 1922kondrat folded before Flop (didn't bet)
Seat 6: Elwis08 folded on the Flop
Seat 7: IBMaN78 folded before Flop (didn't bet)
Seat 8: mgrjf folded before Flop (didn't bet)
Seat 9: FabOliveira9 (button) showed [7h 7c] and lost with three of a kind, Sevens



PokerStars Hand #221914787498: Tournament #3082648141, $0.98+$0.12 USD Hold'em No Limit - Level XII (200/400) - 2020/12/27 22:09:42 EET [2020/12/27 15:09:42 ET]
Table '3082648141 274' 9-max Seat #1 is the button
Seat 1: jcarlos.vale (17861 in chips) 
Seat 2: praskachev (34788 in chips) 
Seat 3: vogelao (8043 in chips) 
Seat 4: nabajastars (33905 in chips) 
Seat 5: 1922kondrat (8673 in chips) 
Seat 6: Elwis08 (40302 in chips) 
Seat 7: IBMaN78 (3064 in chips) 
Seat 8: mgrjf (5550 in chips) 
Seat 9: FabOliveira9 (11750 in chips) 
jcarlos.vale: posts the ante 25
praskachev: posts the ante 25
vogelao: posts the ante 25
nabajastars: posts the ante 25
1922kondrat: posts the ante 25
Elwis08: posts the ante 25
IBMaN78: posts the ante 25
mgrjf: posts the ante 25
FabOliveira9: posts the ante 25
praskachev: posts small blind 200
vogelao: posts big blind 400
*** HOLE CARDS ***
Dealt to jcarlos.vale [8d 8c]
nabajastars: folds 
1922kondrat: folds 
Elwis08: folds 
IBMaN78: folds 
mgrjf: folds 
FabOliveira9: folds 
jcarlos.vale: raises 640 to 1040
praskachev: calls 840
vogelao: folds 
*** FLOP *** [7c 6d 5h]
praskachev: checks 
jcarlos.vale: bets 2029
praskachev: folds 
Uncalled bet (2029) returned to jcarlos.vale
jcarlos.vale collected 2705 from pot
jcarlos.vale: doesn't show handDTO
*** SUMMARY ***
Total pot 2705 | Rake 0 
Board [7c 6d 5h]
Seat 1: jcarlos.vale (button) collected (2705)
Seat 2: praskachev (small blind) folded on the Flop
Seat 3: vogelao (big blind) folded before Flop
Seat 4: nabajastars folded before Flop (didn't bet)
Seat 5: 1922kondrat folded before Flop (didn't bet)
Seat 6: Elwis08 folded before Flop (didn't bet)
Seat 7: IBMaN78 folded before Flop (didn't bet)
Seat 8: mgrjf folded before Flop (didn't bet)
Seat 9: FabOliveira9 folded before Flop (didn't bet)



PokerStars Hand #221914822379: Tournament #3082648141, $0.98+$0.12 USD Hold'em No Limit - Level XII (200/400) - 2020/12/27 22:10:18 EET [2020/12/27 15:10:18 ET]
Table '3082648141 274' 9-max Seat #2 is the button
Seat 1: jcarlos.vale (19501 in chips) 
Seat 2: praskachev (33723 in chips) 
Seat 3: vogelao (7618 in chips) 
Seat 4: nabajastars (33880 in chips) 
Seat 5: 1922kondrat (8648 in chips) 
Seat 6: Elwis08 (40277 in chips) 
Seat 7: IBMaN78 (3039 in chips) 
Seat 8: mgrjf (5525 in chips) 
Seat 9: FabOliveira9 (11725 in chips) 
jcarlos.vale: posts the ante 25
praskachev: posts the ante 25
vogelao: posts the ante 25
nabajastars: posts the ante 25
1922kondrat: posts the ante 25
Elwis08: posts the ante 25
IBMaN78: posts the ante 25
mgrjf: posts the ante 25
FabOliveira9: posts the ante 25
vogelao: posts small blind 200
nabajastars: posts big blind 400
*** HOLE CARDS ***
Dealt to jcarlos.vale [8s 4d]
1922kondrat: folds 
Elwis08: folds 
IBMaN78: folds 
mgrjf: folds 
FabOliveira9: folds 
jcarlos.vale: folds 
praskachev: raises 400 to 800
vogelao: folds 
nabajastars: calls 400
*** FLOP *** [5c 9h 6c]
nabajastars: bets 1519
praskachev: folds 
Uncalled bet (1519) returned to nabajastars
nabajastars collected 2025 from pot
*** SUMMARY ***
Total pot 2025 | Rake 0 
Board [5c 9h 6c]
Seat 1: jcarlos.vale folded before Flop (didn't bet)
Seat 2: praskachev (button) folded on the Flop
Seat 3: vogelao (small blind) folded before Flop
Seat 4: nabajastars (big blind) collected (2025)
Seat 5: 1922kondrat folded before Flop (didn't bet)
Seat 6: Elwis08 folded before Flop (didn't bet)
Seat 7: IBMaN78 folded before Flop (didn't bet)
Seat 8: mgrjf folded before Flop (didn't bet)
Seat 9: FabOliveira9 folded before Flop (didn't bet)



PokerStars Hand #221914872569: Tournament #3082648141, $0.98+$0.12 USD Hold'em No Limit - Level XII (200/400) - 2020/12/27 22:11:08 EET [2020/12/27 15:11:08 ET]
Table '3082648141 274' 9-max Seat #3 is the button
Seat 1: jcarlos.vale (19476 in chips) 
Seat 2: praskachev (32898 in chips) 
Seat 3: vogelao (7393 in chips) 
Seat 4: nabajastars (35080 in chips) 
Seat 5: 1922kondrat (8623 in chips) 
Seat 6: Elwis08 (40252 in chips) 
Seat 7: IBMaN78 (3014 in chips) 
Seat 8: mgrjf (5500 in chips) 
Seat 9: FabOliveira9 (11700 in chips) 
jcarlos.vale: posts the ante 25
praskachev: posts the ante 25
vogelao: posts the ante 25
nabajastars: posts the ante 25
1922kondrat: posts the ante 25
Elwis08: posts the ante 25
IBMaN78: posts the ante 25
mgrjf: posts the ante 25
FabOliveira9: posts the ante 25
nabajastars: posts small blind 200
1922kondrat: posts big blind 400
*** HOLE CARDS ***
Dealt to jcarlos.vale [Jh 5h]
Elwis08: folds 
IBMaN78: folds 
mgrjf: folds 
FabOliveira9: folds 
jcarlos.vale: folds 
praskachev: raises 400 to 800
vogelao: folds 
nabajastars: calls 600
1922kondrat: calls 400
*** FLOP *** [8c Kh 7d]
nabajastars: checks 
1922kondrat: bets 866
praskachev: calls 866
nabajastars: calls 866
*** TURN *** [8c Kh 7d] [3d]
nabajastars: checks 
1922kondrat: bets 6932 and is all-in
praskachev: folds 
nabajastars: calls 6932
*** RIVER *** [8c Kh 7d 3d] [4c]
*** SHOW DOWN ***
nabajastars: shows [Ks Tc] (a pair of Kings)
1922kondrat: shows [Td 9d] (high pairOfCards King)
nabajastars collected 19087 from pot
1922kondrat finished the tournament in 1541st place
*** SUMMARY ***
Total pot 19087 | Rake 0 
Board [8c Kh 7d 3d 4c]
Seat 1: jcarlos.vale folded before Flop (didn't bet)
Seat 2: praskachev folded on the Turn
Seat 3: vogelao (button) folded before Flop (didn't bet)
Seat 4: nabajastars (small blind) showed [Ks Tc] and won (19087) with a pair of Kings
Seat 5: 1922kondrat (big blind) showed [Td 9d] and lost with high pairOfCards King
Seat 6: Elwis08 folded before Flop (didn't bet)
Seat 7: IBMaN78 folded before Flop (didn't bet)
Seat 8: mgrjf folded before Flop (didn't bet)
Seat 9: FabOliveira9 folded before Flop (didn't bet)



PokerStars Hand #221914952404: Tournament #3082648141, $0.98+$0.12 USD Hold'em No Limit - Level XII (200/400) - 2020/12/27 22:12:29 EET [2020/12/27 15:12:29 ET]
Table '3082648141 274' 9-max Seat #4 is the button
Seat 1: jcarlos.vale (19451 in chips) 
Seat 2: praskachev (31207 in chips) 
Seat 3: vogelao (7368 in chips) 
Seat 4: nabajastars (45544 in chips) 
Seat 6: Elwis08 (40227 in chips) 
Seat 7: IBMaN78 (2989 in chips) 
Seat 8: mgrjf (5475 in chips) 
Seat 9: FabOliveira9 (11675 in chips) 
jcarlos.vale: posts the ante 25
praskachev: posts the ante 25
vogelao: posts the ante 25
nabajastars: posts the ante 25
Elwis08: posts the ante 25
IBMaN78: posts the ante 25
mgrjf: posts the ante 25
FabOliveira9: posts the ante 25
Elwis08: posts small blind 200
IBMaN78: posts big blind 400
*** HOLE CARDS ***
Dealt to jcarlos.vale [5s 7h]
mgrjf: folds 
FabOliveira9: folds 
jcarlos.vale: folds 
praskachev: folds 
vogelao: folds 
nabajastars: raises 600 to 1000
Elwis08: folds 
IBMaN78: calls 600
*** FLOP *** [8h 3s Ac]
IBMaN78: checks 
nabajastars: bets 1800
IBMaN78: folds 
Uncalled bet (1800) returned to nabajastars
nabajastars collected 2400 from pot
*** SUMMARY ***
Total pot 2400 | Rake 0 
Board [8h 3s Ac]
Seat 1: jcarlos.vale folded before Flop (didn't bet)
Seat 2: praskachev folded before Flop (didn't bet)
Seat 3: vogelao folded before Flop (didn't bet)
Seat 4: nabajastars (button) collected (2400)
Seat 6: Elwis08 (small blind) folded before Flop
Seat 7: IBMaN78 (big blind) folded on the Flop
Seat 8: mgrjf folded before Flop (didn't bet)
Seat 9: FabOliveira9 folded before Flop (didn't bet)



PokerStars Hand #221914993769: Tournament #3082648141, $0.98+$0.12 USD Hold'em No Limit - Level XII (200/400) - 2020/12/27 22:13:03 EET [2020/12/27 15:13:03 ET]
Table '3082648141 274' 9-max Seat #6 is the button
Seat 1: jcarlos.vale (19426 in chips) 
Seat 2: praskachev (31182 in chips) 
Seat 3: vogelao (7343 in chips) 
Seat 4: nabajastars (46919 in chips) 
Seat 5: bliznec11 (55824 in chips) 
Seat 6: Elwis08 (40002 in chips) 
Seat 7: IBMaN78 (1964 in chips) 
Seat 8: mgrjf (5450 in chips) 
Seat 9: FabOliveira9 (11650 in chips) 
jcarlos.vale: posts the ante 25
praskachev: posts the ante 25
vogelao: posts the ante 25
nabajastars: posts the ante 25
bliznec11: posts the ante 25
Elwis08: posts the ante 25
IBMaN78: posts the ante 25
mgrjf: posts the ante 25
FabOliveira9: posts the ante 25
IBMaN78: posts small blind 200
mgrjf: posts big blind 400
*** HOLE CARDS ***
Dealt to jcarlos.vale [2h 6d]
FabOliveira9: folds 
jcarlos.vale: folds 
praskachev: folds 
vogelao: folds 
nabajastars: folds 
bliznec11: folds 
Elwis08: raises 400 to 800
IBMaN78: raises 1139 to 1939 and is all-in
mgrjf: folds 
Elwis08: calls 1139
*** FLOP *** [Kc 8h 8d]
*** TURN *** [Kc 8h 8d] [4s]
*** RIVER *** [Kc 8h 8d 4s] [Qc]
*** SHOW DOWN ***
IBMaN78: shows [4h As] (two pair, Eights and Fours)
Elwis08: shows [Th Jh] (a pair of Eights)
IBMaN78 collected 4503 from pot
*** SUMMARY ***
Total pot 4503 | Rake 0 
Board [Kc 8h 8d 4s Qc]
Seat 1: jcarlos.vale folded before Flop (didn't bet)
Seat 2: praskachev folded before Flop (didn't bet)
Seat 3: vogelao folded before Flop (didn't bet)
Seat 4: nabajastars folded before Flop (didn't bet)
Seat 5: bliznec11 folded before Flop (didn't bet)
Seat 6: Elwis08 (button) showed [Th Jh] and lost with a pair of Eights
Seat 7: IBMaN78 (small blind) showed [4h As] and won (4503) with two pair, Eights and Fours
Seat 8: mgrjf (big blind) folded before Flop
Seat 9: FabOliveira9 folded before Flop (didn't bet)



PokerStars Hand #221915038705: Tournament #3082648141, $0.98+$0.12 USD Hold'em No Limit - Level XII (200/400) - 2020/12/27 22:13:48 EET [2020/12/27 15:13:48 ET]
Table '3082648141 274' 9-max Seat #7 is the button
Seat 1: jcarlos.vale (19401 in chips) 
Seat 2: praskachev (31157 in chips) 
Seat 3: vogelao (7318 in chips) 
Seat 4: nabajastars (46894 in chips) 
Seat 5: bliznec11 (55799 in chips) 
Seat 6: Elwis08 (38038 in chips) 
Seat 7: IBMaN78 (4503 in chips) 
Seat 8: mgrjf (5025 in chips) 
Seat 9: FabOliveira9 (11625 in chips) 
jcarlos.vale: posts the ante 25
praskachev: posts the ante 25
vogelao: posts the ante 25
nabajastars: posts the ante 25
bliznec11: posts the ante 25
Elwis08: posts the ante 25
IBMaN78: posts the ante 25
mgrjf: posts the ante 25
FabOliveira9: posts the ante 25
mgrjf: posts small blind 200
FabOliveira9: posts big blind 400
*** HOLE CARDS ***
Dealt to jcarlos.vale [4s 3c]
jcarlos.vale: folds 
praskachev: folds 
vogelao: folds 
nabajastars: raises 600 to 1000
bliznec11: folds 
Elwis08: folds 
IBMaN78: folds 
mgrjf: folds 
FabOliveira9: folds 
Uncalled bet (600) returned to nabajastars
nabajastars collected 1225 from pot
*** SUMMARY ***
Total pot 1225 | Rake 0 
Seat 1: jcarlos.vale folded before Flop (didn't bet)
Seat 2: praskachev folded before Flop (didn't bet)
Seat 3: vogelao folded before Flop (didn't bet)
Seat 4: nabajastars collected (1225)
Seat 5: bliznec11 folded before Flop (didn't bet)
Seat 6: Elwis08 folded before Flop (didn't bet)
Seat 7: IBMaN78 (button) folded before Flop (didn't bet)
Seat 8: mgrjf (small blind) folded before Flop
Seat 9: FabOliveira9 (big blind) folded before Flop



PokerStars Hand #221915071243: Tournament #3082648141, $0.98+$0.12 USD Hold'em No Limit - Level XII (200/400) - 2020/12/27 22:14:21 EET [2020/12/27 15:14:21 ET]
Table '3082648141 274' 9-max Seat #8 is the button
Seat 1: jcarlos.vale (19376 in chips) 
Seat 2: praskachev (31132 in chips) 
Seat 3: vogelao (7293 in chips) 
Seat 4: nabajastars (47694 in chips) 
Seat 5: bliznec11 (55774 in chips) 
Seat 6: Elwis08 (38013 in chips) 
Seat 7: IBMaN78 (4478 in chips) 
Seat 8: mgrjf (4800 in chips) 
Seat 9: FabOliveira9 (11200 in chips) 
jcarlos.vale: posts the ante 25
praskachev: posts the ante 25
vogelao: posts the ante 25
nabajastars: posts the ante 25
bliznec11: posts the ante 25
Elwis08: posts the ante 25
IBMaN78: posts the ante 25
mgrjf: posts the ante 25
FabOliveira9: posts the ante 25
FabOliveira9: posts small blind 200
jcarlos.vale: posts big blind 400
*** HOLE CARDS ***
Dealt to jcarlos.vale [7s Js]
praskachev: folds 
vogelao: folds 
nabajastars: folds 
bliznec11: folds 
Elwis08: raises 400 to 800
IBMaN78: folds 
mgrjf: folds 
FabOliveira9: folds 
jcarlos.vale: calls 400
*** FLOP *** [3c 3s 2d]
jcarlos.vale: checks 
Elwis08: bets 668
jcarlos.vale: folds 
Uncalled bet (668) returned to Elwis08
Elwis08 collected 2025 from pot
Elwis08: doesn't show handDTO
*** SUMMARY ***
Total pot 2025 | Rake 0 
Board [3c 3s 2d]
Seat 1: jcarlos.vale (big blind) folded on the Flop
Seat 2: praskachev folded before Flop (didn't bet)
Seat 3: vogelao folded before Flop (didn't bet)
Seat 4: nabajastars folded before Flop (didn't bet)
Seat 5: bliznec11 folded before Flop (didn't bet)
Seat 6: Elwis08 collected (2025)
Seat 7: IBMaN78 folded before Flop (didn't bet)
Seat 8: mgrjf (button) folded before Flop (didn't bet)
Seat 9: FabOliveira9 (small blind) folded before Flop



PokerStars Hand #221915134509: Tournament #3082648141, $0.98+$0.12 USD Hold'em No Limit - Level XII (200/400) - 2020/12/27 22:15:24 EET [2020/12/27 15:15:24 ET]
Table '3082648141 274' 9-max Seat #9 is the button
Seat 1: jcarlos.vale (18551 in chips) 
Seat 2: praskachev (31107 in chips) 
Seat 3: vogelao (7268 in chips) 
Seat 4: nabajastars (47669 in chips) 
Seat 5: bliznec11 (55749 in chips) 
Seat 6: Elwis08 (39213 in chips) 
Seat 7: IBMaN78 (4453 in chips) 
Seat 8: mgrjf (4775 in chips) 
Seat 9: FabOliveira9 (10975 in chips) 
jcarlos.vale: posts the ante 25
praskachev: posts the ante 25
vogelao: posts the ante 25
nabajastars: posts the ante 25
bliznec11: posts the ante 25
Elwis08: posts the ante 25
IBMaN78: posts the ante 25
mgrjf: posts the ante 25
FabOliveira9: posts the ante 25
jcarlos.vale: posts small blind 200
praskachev: posts big blind 400
*** HOLE CARDS ***
Dealt to jcarlos.vale [2c 4s]
vogelao: folds 
nabajastars: folds 
bliznec11: folds 
Elwis08: folds 
IBMaN78: folds 
mgrjf: raises 4350 to 4750 and is all-in
FabOliveira9: folds 
jcarlos.vale: folds 
praskachev: folds 
Uncalled bet (4350) returned to mgrjf
mgrjf collected 1225 from pot
mgrjf: doesn't show handDTO
*** SUMMARY ***
Total pot 1225 | Rake 0 
Seat 1: jcarlos.vale (small blind) folded before Flop
Seat 2: praskachev (big blind) folded before Flop
Seat 3: vogelao folded before Flop (didn't bet)
Seat 4: nabajastars folded before Flop (didn't bet)
Seat 5: bliznec11 folded before Flop (didn't bet)
Seat 6: Elwis08 folded before Flop (didn't bet)
Seat 7: IBMaN78 folded before Flop (didn't bet)
Seat 8: mgrjf collected (1225)
Seat 9: FabOliveira9 (button) folded before Flop (didn't bet)



PokerStars Hand #221915166307: Tournament #3082648141, $0.98+$0.12 USD Hold'em No Limit - Level XIII (250/500) - 2020/12/27 22:15:57 EET [2020/12/27 15:15:57 ET]
Table '3082648141 274' 9-max Seat #1 is the button
Seat 1: jcarlos.vale (18326 in chips) 
Seat 2: praskachev (30682 in chips) 
Seat 3: vogelao (7243 in chips) 
Seat 4: nabajastars (47644 in chips) 
Seat 5: bliznec11 (55724 in chips) 
Seat 6: Elwis08 (39188 in chips) 
Seat 7: IBMaN78 (4428 in chips) 
Seat 8: mgrjf (5575 in chips) 
Seat 9: FabOliveira9 (10950 in chips) 
jcarlos.vale: posts the ante 30
praskachev: posts the ante 30
vogelao: posts the ante 30
nabajastars: posts the ante 30
bliznec11: posts the ante 30
Elwis08: posts the ante 30
IBMaN78: posts the ante 30
mgrjf: posts the ante 30
FabOliveira9: posts the ante 30
praskachev: posts small blind 250
vogelao: posts big blind 500
*** HOLE CARDS ***
Dealt to jcarlos.vale [5d 8h]
nabajastars: folds 
bliznec11: folds 
Elwis08: raises 500 to 1000
IBMaN78: calls 1000
mgrjf: folds 
FabOliveira9: folds 
jcarlos.vale: folds 
praskachev: folds 
vogelao: folds 
*** FLOP *** [Jh 9d Qh]
Elwis08: bets 997
IBMaN78: raises 2401 to 3398 and is all-in
Elwis08: calls 2401
*** TURN *** [Jh 9d Qh] [Jc]
*** RIVER *** [Jh 9d Qh Jc] [Kd]
*** SHOW DOWN ***
Elwis08: shows [As Ac] (two pair, Aces and Jacks)
IBMaN78: shows [Ah Js] (three of a kind, Jacks)
IBMaN78 collected 9816 from pot
*** SUMMARY ***
Total pot 9816 | Rake 0 
Board [Jh 9d Qh Jc Kd]
Seat 1: jcarlos.vale (button) folded before Flop (didn't bet)
Seat 2: praskachev (small blind) folded before Flop
Seat 3: vogelao (big blind) folded before Flop
Seat 4: nabajastars folded before Flop (didn't bet)
Seat 5: bliznec11 folded before Flop (didn't bet)
Seat 6: Elwis08 showed [As Ac] and lost with two pair, Aces and Jacks
Seat 7: IBMaN78 showed [Ah Js] and won (9816) with three of a kind, Jacks
Seat 8: mgrjf folded before Flop (didn't bet)
Seat 9: FabOliveira9 folded before Flop (didn't bet)



PokerStars Hand #221915242238: Tournament #3082648141, $0.98+$0.12 USD Hold'em No Limit - Level XIII (250/500) - 2020/12/27 22:17:13 EET [2020/12/27 15:17:13 ET]
Table '3082648141 274' 9-max Seat #2 is the button
Seat 1: jcarlos.vale (18296 in chips) 
Seat 2: praskachev (30402 in chips) 
Seat 3: vogelao (6713 in chips) 
Seat 4: nabajastars (47614 in chips) 
Seat 5: bliznec11 (55694 in chips) 
Seat 6: Elwis08 (34760 in chips) 
Seat 7: IBMaN78 (9816 in chips) 
Seat 8: mgrjf (5545 in chips) 
Seat 9: FabOliveira9 (10920 in chips) 
jcarlos.vale: posts the ante 30
praskachev: posts the ante 30
vogelao: posts the ante 30
nabajastars: posts the ante 30
bliznec11: posts the ante 30
Elwis08: posts the ante 30
IBMaN78: posts the ante 30
mgrjf: posts the ante 30
FabOliveira9: posts the ante 30
vogelao: posts small blind 250
nabajastars: posts big blind 500
*** HOLE CARDS ***
Dealt to jcarlos.vale [8c As]
bliznec11: folds 
IBMaN78 said, "sry"
Elwis08: raises 500 to 1000
IBMaN78: folds 
mgrjf: folds 
FabOliveira9: folds 
IBMaN78 said, "desculpe"
jcarlos.vale: folds 
praskachev: calls 1000
vogelao: folds 
nabajastars has timed out
nabajastars: folds 
nabajastars is sitting out
*** FLOP *** [Js Qh 6s]
Elwis08: checks 
praskachev: checks 
*** TURN *** [Js Qh 6s] [Jc]
Elwis08: bets 997
praskachev: raises 997 to 1994
nabajastars has returned
Elwis08: calls 997
*** RIVER *** [Js Qh 6s Jc] [4s]
Elwis08: checks 
praskachev: checks 
*** SHOW DOWN ***
Elwis08: shows [7h 7c] (two pair, Jacks and Sevens)
praskachev: mucks handDTO
Elwis08 collected 7008 from pot
*** SUMMARY ***
Total pot 7008 | Rake 0 
Board [Js Qh 6s Jc 4s]
Seat 1: jcarlos.vale folded before Flop (didn't bet)
Seat 2: praskachev (button) mucked [7d Ad]
Seat 3: vogelao (small blind) folded before Flop
Seat 4: nabajastars (big blind) folded before Flop
Seat 5: bliznec11 folded before Flop (didn't bet)
Seat 6: Elwis08 showed [7h 7c] and won (7008) with two pair, Jacks and Sevens
Seat 7: IBMaN78 folded before Flop (didn't bet)
Seat 8: mgrjf folded before Flop (didn't bet)
Seat 9: FabOliveira9 folded before Flop (didn't bet)



PokerStars Hand #221915320167: Tournament #3082648141, $0.98+$0.12 USD Hold'em No Limit - Level XIII (250/500) - 2020/12/27 22:18:32 EET [2020/12/27 15:18:32 ET]
Table '3082648141 274' 9-max Seat #3 is the button
Seat 1: jcarlos.vale (18266 in chips) 
Seat 2: praskachev (27378 in chips) 
Seat 3: vogelao (6433 in chips) 
Seat 4: nabajastars (47084 in chips) 
Seat 5: bliznec11 (55664 in chips) 
Seat 6: Elwis08 (38744 in chips) 
Seat 7: IBMaN78 (9786 in chips) 
Seat 8: mgrjf (5515 in chips) 
Seat 9: FabOliveira9 (10890 in chips) 
jcarlos.vale: posts the ante 30
praskachev: posts the ante 30
vogelao: posts the ante 30
nabajastars: posts the ante 30
bliznec11: posts the ante 30
Elwis08: posts the ante 30
IBMaN78: posts the ante 30
mgrjf: posts the ante 30
FabOliveira9: posts the ante 30
nabajastars: posts small blind 250
bliznec11: posts big blind 500
*** HOLE CARDS ***
Dealt to jcarlos.vale [As Qh]
Elwis08: folds 
IBMaN78: folds 
mgrjf: folds 
FabOliveira9: calls 500
jcarlos.vale: raises 800 to 1300
praskachev: folds 
vogelao: folds 
nabajastars: folds 
bliznec11: folds 
FabOliveira9: calls 800
*** FLOP *** [3s Qd Th]
FabOliveira9: checks 
jcarlos.vale: bets 2715
FabOliveira9: folds 
Uncalled bet (2715) returned to jcarlos.vale
jcarlos.vale collected 3620 from pot
jcarlos.vale: doesn't show handDTO
*** SUMMARY ***
Total pot 3620 | Rake 0 
Board [3s Qd Th]
Seat 1: jcarlos.vale collected (3620)
Seat 2: praskachev folded before Flop (didn't bet)
Seat 3: vogelao (button) folded before Flop (didn't bet)
Seat 4: nabajastars (small blind) folded before Flop
Seat 5: bliznec11 (big blind) folded before Flop
Seat 6: Elwis08 folded before Flop (didn't bet)
Seat 7: IBMaN78 folded before Flop (didn't bet)
Seat 8: mgrjf folded before Flop (didn't bet)
Seat 9: FabOliveira9 folded on the Flop



PokerStars Hand #221915375378: Tournament #3082648141, $0.98+$0.12 USD Hold'em No Limit - Level XIII (250/500) - 2020/12/27 22:19:28 EET [2020/12/27 15:19:28 ET]
Table '3082648141 274' 9-max Seat #4 is the button
Seat 1: jcarlos.vale (20556 in chips) 
Seat 2: praskachev (27348 in chips) 
Seat 3: vogelao (6403 in chips) 
Seat 4: nabajastars (46804 in chips) 
Seat 5: bliznec11 (55134 in chips) 
Seat 6: Elwis08 (38714 in chips) 
Seat 7: IBMaN78 (9756 in chips) 
Seat 8: mgrjf (5485 in chips) 
Seat 9: FabOliveira9 (9560 in chips) 
jcarlos.vale: posts the ante 30
praskachev: posts the ante 30
vogelao: posts the ante 30
nabajastars: posts the ante 30
bliznec11: posts the ante 30
Elwis08: posts the ante 30
IBMaN78: posts the ante 30
mgrjf: posts the ante 30
FabOliveira9: posts the ante 30
bliznec11: posts small blind 250
Elwis08: posts big blind 500
*** HOLE CARDS ***
Dealt to jcarlos.vale [2c 4d]
IBMaN78: folds 
mgrjf: folds 
FabOliveira9: folds 
jcarlos.vale: folds 
praskachev: raises 500 to 1000
vogelao: folds 
nabajastars: raises 2000 to 3000
bliznec11: folds 
Elwis08: folds 
praskachev: calls 2000
*** FLOP *** [5h 8s 6d]
praskachev: checks 
nabajastars: bets 7020
praskachev: folds 
Uncalled bet (7020) returned to nabajastars
nabajastars collected 7020 from pot
*** SUMMARY ***
Total pot 7020 | Rake 0 
Board [5h 8s 6d]
Seat 1: jcarlos.vale folded before Flop (didn't bet)
Seat 2: praskachev folded on the Flop
Seat 3: vogelao folded before Flop (didn't bet)
Seat 4: nabajastars (button) collected (7020)
Seat 5: bliznec11 (small blind) folded before Flop
Seat 6: Elwis08 (big blind) folded before Flop
Seat 7: IBMaN78 folded before Flop (didn't bet)
Seat 8: mgrjf folded before Flop (didn't bet)
Seat 9: FabOliveira9 folded before Flop (didn't bet)



PokerStars Hand #221915410290: Tournament #3082648141, $0.98+$0.12 USD Hold'em No Limit - Level XIII (250/500) - 2020/12/27 22:20:03 EET [2020/12/27 15:20:03 ET]
Table '3082648141 274' 9-max Seat #5 is the button
Seat 1: jcarlos.vale (20526 in chips) 
Seat 2: praskachev (24318 in chips) 
Seat 3: vogelao (6373 in chips) 
Seat 4: nabajastars (50794 in chips) 
Seat 5: bliznec11 (54854 in chips) 
Seat 6: Elwis08 (38184 in chips) 
Seat 7: IBMaN78 (9726 in chips) 
Seat 8: mgrjf (5455 in chips) 
Seat 9: FabOliveira9 (9530 in chips) 
jcarlos.vale: posts the ante 30
praskachev: posts the ante 30
vogelao: posts the ante 30
nabajastars: posts the ante 30
bliznec11: posts the ante 30
Elwis08: posts the ante 30
IBMaN78: posts the ante 30
mgrjf: posts the ante 30
FabOliveira9: posts the ante 30
Elwis08: posts small blind 250
IBMaN78: posts big blind 500
*** HOLE CARDS ***
Dealt to jcarlos.vale [Jc 6c]
mgrjf: folds 
FabOliveira9: folds 
jcarlos.vale: folds 
praskachev: folds 
vogelao: folds 
nabajastars has timed out
nabajastars: folds 
nabajastars is sitting out
bliznec11: raises 500 to 1000
Elwis08: folds 
IBMaN78: calls 500
*** FLOP *** [2c Js 9c]
IBMaN78: checks 
nabajastars has returned
bliznec11: bets 983
IBMaN78: folds 
Uncalled bet (983) returned to bliznec11
bliznec11 collected 2520 from pot
bliznec11: doesn't show handDTO
*** SUMMARY ***
Total pot 2520 | Rake 0 
Board [2c Js 9c]
Seat 1: jcarlos.vale folded before Flop (didn't bet)
Seat 2: praskachev folded before Flop (didn't bet)
Seat 3: vogelao folded before Flop (didn't bet)
Seat 4: nabajastars folded before Flop (didn't bet)
Seat 5: bliznec11 (button) collected (2520)
Seat 6: Elwis08 (small blind) folded before Flop
Seat 7: IBMaN78 (big blind) folded on the Flop
Seat 8: mgrjf folded before Flop (didn't bet)
Seat 9: FabOliveira9 folded before Flop (didn't bet)



PokerStars Hand #221915470294: Tournament #3082648141, $0.98+$0.12 USD Hold'em No Limit - Level XIII (250/500) - 2020/12/27 22:21:05 EET [2020/12/27 15:21:05 ET]
Table '3082648141 274' 9-max Seat #6 is the button
Seat 1: jcarlos.vale (20496 in chips) 
Seat 2: praskachev (24288 in chips) 
Seat 3: vogelao (6343 in chips) 
Seat 4: nabajastars (50764 in chips) 
Seat 5: bliznec11 (56344 in chips) 
Seat 6: Elwis08 (37904 in chips) 
Seat 7: IBMaN78 (8696 in chips) 
Seat 8: mgrjf (5425 in chips) 
Seat 9: FabOliveira9 (9500 in chips) 
jcarlos.vale: posts the ante 30
praskachev: posts the ante 30
vogelao: posts the ante 30
nabajastars: posts the ante 30
bliznec11: posts the ante 30
Elwis08: posts the ante 30
IBMaN78: posts the ante 30
mgrjf: posts the ante 30
FabOliveira9: posts the ante 30
IBMaN78: posts small blind 250
mgrjf: posts big blind 500
*** HOLE CARDS ***
Dealt to jcarlos.vale [7s Td]
FabOliveira9: folds 
jcarlos.vale: folds 
praskachev: folds 
vogelao: folds 
nabajastars: raises 500 to 1000
bliznec11: calls 1000
Elwis08: folds 
IBMaN78: folds 
mgrjf: raises 4395 to 5395 and is all-in
nabajastars: folds 
bliznec11: calls 4395
*** FLOP *** [5s Js As]
*** TURN *** [5s Js As] [5h]
*** RIVER *** [5s Js As 5h] [9d]
*** SHOW DOWN ***
mgrjf: shows [Qh Qs] (two pair, Queens and Fives)
bliznec11: shows [Jd Qd] (two pair, Jacks and Fives)
mgrjf collected 12310 from pot
*** SUMMARY ***
Total pot 12310 | Rake 0 
Board [5s Js As 5h 9d]
Seat 1: jcarlos.vale folded before Flop (didn't bet)
Seat 2: praskachev folded before Flop (didn't bet)
Seat 3: vogelao folded before Flop (didn't bet)
Seat 4: nabajastars folded before Flop
Seat 5: bliznec11 showed [Jd Qd] and lost with two pair, Jacks and Fives
Seat 6: Elwis08 (button) folded before Flop (didn't bet)
Seat 7: IBMaN78 (small blind) folded before Flop
Seat 8: mgrjf (big blind) showed [Qh Qs] and won (12310) with two pair, Queens and Fives
Seat 9: FabOliveira9 folded before Flop (didn't bet)



PokerStars Hand #221915522443: Tournament #3082648141, $0.98+$0.12 USD Hold'em No Limit - Level XIII (250/500) - 2020/12/27 22:21:58 EET [2020/12/27 15:21:58 ET]
Table '3082648141 274' 9-max Seat #7 is the button
Seat 1: jcarlos.vale (20466 in chips) 
Seat 2: praskachev (24258 in chips) 
Seat 3: vogelao (6313 in chips) 
Seat 4: nabajastars (49734 in chips) 
Seat 5: bliznec11 (50919 in chips) 
Seat 6: Elwis08 (37874 in chips) 
Seat 7: IBMaN78 (8416 in chips) 
Seat 8: mgrjf (12310 in chips) 
Seat 9: FabOliveira9 (9470 in chips) 
jcarlos.vale: posts the ante 30
praskachev: posts the ante 30
vogelao: posts the ante 30
nabajastars: posts the ante 30
bliznec11: posts the ante 30
Elwis08: posts the ante 30
IBMaN78: posts the ante 30
mgrjf: posts the ante 30
FabOliveira9: posts the ante 30
mgrjf: posts small blind 250
FabOliveira9: posts big blind 500
*** HOLE CARDS ***
Dealt to jcarlos.vale [7c 4d]
jcarlos.vale: folds 
praskachev: folds 
vogelao: folds 
nabajastars: raises 750 to 1250
bliznec11: folds 
Elwis08: folds 
IBMaN78: folds 
mgrjf: folds 
FabOliveira9: raises 8190 to 9440 and is all-in
nabajastars: calls 8190
*** FLOP *** [5d Qh 2d]
*** TURN *** [5d Qh 2d] [5h]
*** RIVER *** [5d Qh 2d 5h] [7s]
*** SHOW DOWN ***
FabOliveira9: shows [As 6c] (a pair of Fives)
nabajastars: shows [2h 2s] (a full house, Deuces full of Fives)
nabajastars collected 19400 from pot
FabOliveira9 finished the tournament in 1303rd place
*** SUMMARY ***
Total pot 19400 | Rake 0 
Board [5d Qh 2d 5h 7s]
Seat 1: jcarlos.vale folded before Flop (didn't bet)
Seat 2: praskachev folded before Flop (didn't bet)
Seat 3: vogelao folded before Flop (didn't bet)
Seat 4: nabajastars showed [2h 2s] and won (19400) with a full house, Deuces full of Fives
Seat 5: bliznec11 folded before Flop (didn't bet)
Seat 6: Elwis08 folded before Flop (didn't bet)
Seat 7: IBMaN78 (button) folded before Flop (didn't bet)
Seat 8: mgrjf (small blind) folded before Flop
Seat 9: FabOliveira9 (big blind) showed [As 6c] and lost with a pair of Fives



PokerStars Hand #221915570366: Tournament #3082648141, $0.98+$0.12 USD Hold'em No Limit - Level XIII (250/500) - 2020/12/27 22:22:46 EET [2020/12/27 15:22:46 ET]
Table '3082648141 274' 9-max Seat #8 is the button
Seat 1: jcarlos.vale (20436 in chips) 
Seat 2: praskachev (24228 in chips) 
Seat 3: vogelao (6283 in chips) 
Seat 4: nabajastars (59664 in chips) 
Seat 5: bliznec11 (50889 in chips) 
Seat 6: Elwis08 (37844 in chips) 
Seat 7: IBMaN78 (8386 in chips) 
Seat 8: mgrjf (12030 in chips) 
jcarlos.vale: posts the ante 30
praskachev: posts the ante 30
vogelao: posts the ante 30
nabajastars: posts the ante 30
bliznec11: posts the ante 30
Elwis08: posts the ante 30
IBMaN78: posts the ante 30
mgrjf: posts the ante 30
jcarlos.vale: posts small blind 250
praskachev: posts big blind 500
*** HOLE CARDS ***
Dealt to jcarlos.vale [Jc 9s]
vogelao: folds 
nabajastars: folds 
bliznec11: folds 
Elwis08: folds 
IBMaN78: raises 1000 to 1500
mgrjf: folds 
jcarlos.vale: folds 
praskachev: folds 
Uncalled bet (1000) returned to IBMaN78
IBMaN78 collected 1490 from pot
IBMaN78: doesn't show handDTO
*** SUMMARY ***
Total pot 1490 | Rake 0 
Seat 1: jcarlos.vale (small blind) folded before Flop
Seat 2: praskachev (big blind) folded before Flop
Seat 3: vogelao folded before Flop (didn't bet)
Seat 4: nabajastars folded before Flop (didn't bet)
Seat 5: bliznec11 folded before Flop (didn't bet)
Seat 6: Elwis08 folded before Flop (didn't bet)
Seat 7: IBMaN78 collected (1490)
Seat 8: mgrjf (button) folded before Flop (didn't bet)



PokerStars Hand #221915605521: Tournament #3082648141, $0.98+$0.12 USD Hold'em No Limit - Level XIII (250/500) - 2020/12/27 22:23:22 EET [2020/12/27 15:23:22 ET]
Table '3082648141 274' 9-max Seat #1 is the button
Seat 1: jcarlos.vale (20156 in chips) 
Seat 2: praskachev (23698 in chips) 
Seat 3: vogelao (6253 in chips) 
Seat 4: nabajastars (59634 in chips) 
Seat 5: bliznec11 (50859 in chips) 
Seat 6: Elwis08 (37814 in chips) 
Seat 7: IBMaN78 (9346 in chips) 
Seat 8: mgrjf (12000 in chips) 
Seat 9: 66demon99 (10709 in chips) 
jcarlos.vale: posts the ante 30
praskachev: posts the ante 30
vogelao: posts the ante 30
nabajastars: posts the ante 30
bliznec11: posts the ante 30
Elwis08: posts the ante 30
IBMaN78: posts the ante 30
mgrjf: posts the ante 30
66demon99: posts the ante 30
praskachev: posts small blind 250
vogelao: posts big blind 500
*** HOLE CARDS ***
Dealt to jcarlos.vale [Qc 8d]
nabajastars: folds 
bliznec11 has timed out
bliznec11: folds 
bliznec11 is sitting out
Elwis08: folds 
IBMaN78: folds 
mgrjf: folds 
66demon99: folds 
jcarlos.vale: folds 
praskachev: raises 23168 to 23668 and is all-in
vogelao: folds 
Uncalled bet (23168) returned to praskachev
praskachev collected 1270 from pot
praskachev: doesn't show handDTO
*** SUMMARY ***
Total pot 1270 | Rake 0 
Seat 1: jcarlos.vale (button) folded before Flop (didn't bet)
Seat 2: praskachev (small blind) collected (1270)
Seat 3: vogelao (big blind) folded before Flop
Seat 4: nabajastars folded before Flop (didn't bet)
Seat 5: bliznec11 folded before Flop (didn't bet)
Seat 6: Elwis08 folded before Flop (didn't bet)
Seat 7: IBMaN78 folded before Flop (didn't bet)
Seat 8: mgrjf folded before Flop (didn't bet)
Seat 9: 66demon99 folded before Flop (didn't bet)



PokerStars Hand #221915699969: Tournament #3082648141, $0.98+$0.12 USD Hold'em No Limit - Level XIII (250/500) - 2020/12/27 22:24:59 EET [2020/12/27 15:24:59 ET]
Table '3082648141 274' 9-max Seat #2 is the button
Seat 1: jcarlos.vale (20126 in chips) 
Seat 2: praskachev (24438 in chips) 
Seat 3: vogelao (5723 in chips) 
Seat 4: nabajastars (59604 in chips) 
Seat 5: bliznec11 (50829 in chips) is sitting out
Seat 6: Elwis08 (37784 in chips) 
Seat 7: IBMaN78 (9316 in chips) 
Seat 8: mgrjf (11970 in chips) 
Seat 9: 66demon99 (10679 in chips) 
jcarlos.vale: posts the ante 30
praskachev: posts the ante 30
vogelao: posts the ante 30
nabajastars: posts the ante 30
bliznec11: posts the ante 30
Elwis08: posts the ante 30
IBMaN78: posts the ante 30
mgrjf: posts the ante 30
66demon99: posts the ante 30
vogelao: posts small blind 250
nabajastars: posts big blind 500
*** HOLE CARDS ***
Dealt to jcarlos.vale [9s 7c]
bliznec11: folds 
Elwis08: folds 
IBMaN78: raises 1000 to 1500
mgrjf: folds 
66demon99: folds 
jcarlos.vale: folds 
praskachev: folds 
vogelao: folds 
nabajastars: calls 1000
*** FLOP *** [Jd 2h Th]
nabajastars: checks 
IBMaN78: bets 1760
nabajastars: folds 
Uncalled bet (1760) returned to IBMaN78
IBMaN78 collected 3520 from pot
IBMaN78: doesn't show handDTO
*** SUMMARY ***
Total pot 3520 | Rake 0 
Board [Jd 2h Th]
Seat 1: jcarlos.vale folded before Flop (didn't bet)
Seat 2: praskachev (button) folded before Flop (didn't bet)
Seat 3: vogelao (small blind) folded before Flop
Seat 4: nabajastars (big blind) folded on the Flop
Seat 5: bliznec11 folded before Flop (didn't bet)
Seat 6: Elwis08 folded before Flop (didn't bet)
Seat 7: IBMaN78 collected (3520)
Seat 8: mgrjf folded before Flop (didn't bet)
Seat 9: 66demon99 folded before Flop (didn't bet)



PokerStars Hand #221915755386: Tournament #3082648141, $0.98+$0.12 USD Hold'em No Limit - Level XIV (300/600) - 2020/12/27 22:25:57 EET [2020/12/27 15:25:57 ET]
Table '3082648141 274' 9-max Seat #3 is the button
Seat 1: jcarlos.vale (20096 in chips) 
Seat 2: praskachev (24408 in chips) 
Seat 3: vogelao (5443 in chips) 
Seat 4: nabajastars (58074 in chips) 
Seat 5: bliznec11 (50799 in chips) is sitting out
Seat 6: Elwis08 (37754 in chips) 
Seat 7: IBMaN78 (11306 in chips) 
Seat 8: mgrjf (11940 in chips) 
Seat 9: 66demon99 (10649 in chips) 
jcarlos.vale: posts the ante 40
praskachev: posts the ante 40
vogelao: posts the ante 40
nabajastars: posts the ante 40
bliznec11: posts the ante 40
Elwis08: posts the ante 40
IBMaN78: posts the ante 40
mgrjf: posts the ante 40
66demon99: posts the ante 40
nabajastars: posts small blind 300
bliznec11: posts big blind 600
*** HOLE CARDS ***
Dealt to jcarlos.vale [4h 8s]
Elwis08: folds 
IBMaN78: folds 
mgrjf: folds 
66demon99: raises 600 to 1200
jcarlos.vale: folds 
praskachev: folds 
vogelao: raises 4203 to 5403 and is all-in
nabajastars: folds 
bliznec11: folds 
66demon99: calls 4203
*** FLOP *** [5h Th 9h]
*** TURN *** [5h Th 9h] [3s]
*** RIVER *** [5h Th 9h 3s] [Jh]
*** SHOW DOWN ***
66demon99: shows [7h Ah] (a flush, Ace high)
vogelao: shows [Tc Ad] (a pair of Tens)
66demon99 collected 12066 from pot
vogelao finished the tournament in 1230th place
*** SUMMARY ***
Total pot 12066 | Rake 0 
Board [5h Th 9h 3s Jh]
Seat 1: jcarlos.vale folded before Flop (didn't bet)
Seat 2: praskachev folded before Flop (didn't bet)
Seat 3: vogelao (button) showed [Tc Ad] and lost with a pair of Tens
Seat 4: nabajastars (small blind) folded before Flop
Seat 5: bliznec11 (big blind) folded before Flop
Seat 6: Elwis08 folded before Flop (didn't bet)
Seat 7: IBMaN78 folded before Flop (didn't bet)
Seat 8: mgrjf folded before Flop (didn't bet)
Seat 9: 66demon99 showed [7h Ah] and won (12066) with a flush, Ace high



PokerStars Hand #221915786222: Tournament #3082648141, $0.98+$0.12 USD Hold'em No Limit - Level XIV (300/600) - 2020/12/27 22:26:29 EET [2020/12/27 15:26:29 ET]
Table '3082648141 274' 9-max Seat #4 is the button
Seat 1: jcarlos.vale (20056 in chips) 
Seat 2: praskachev (24368 in chips) 
Seat 4: nabajastars (57734 in chips) 
Seat 5: bliznec11 (50159 in chips) is sitting out
Seat 6: Elwis08 (37714 in chips) 
Seat 7: IBMaN78 (11266 in chips) 
Seat 8: mgrjf (11900 in chips) 
Seat 9: 66demon99 (17272 in chips) 
jcarlos.vale: posts the ante 40
praskachev: posts the ante 40
nabajastars: posts the ante 40
bliznec11: posts the ante 40
Elwis08: posts the ante 40
IBMaN78: posts the ante 40
mgrjf: posts the ante 40
66demon99: posts the ante 40
bliznec11: posts small blind 300
Elwis08: posts big blind 600
*** HOLE CARDS ***
Dealt to jcarlos.vale [6d Qh]
IBMaN78: calls 600
mgrjf: folds 
66demon99: folds 
jcarlos.vale: folds 
praskachev: folds 
nabajastars: raises 1200 to 1800
bliznec11: folds 
Elwis08: folds 
IBMaN78: raises 9426 to 11226 and is all-in
nabajastars: folds 
Uncalled bet (9426) returned to IBMaN78
IBMaN78 collected 4820 from pot
IBMaN78: doesn't show handDTO
*** SUMMARY ***
Total pot 4820 | Rake 0 
Seat 1: jcarlos.vale folded before Flop (didn't bet)
Seat 2: praskachev folded before Flop (didn't bet)
Seat 4: nabajastars (button) folded before Flop
Seat 5: bliznec11 (small blind) folded before Flop
Seat 6: Elwis08 (big blind) folded before Flop
Seat 7: IBMaN78 collected (4820)
Seat 8: mgrjf folded before Flop (didn't bet)
Seat 9: 66demon99 folded before Flop (didn't bet)



PokerStars Hand #221915824313: Tournament #3082648141, $0.98+$0.12 USD Hold'em No Limit - Level XIV (300/600) - 2020/12/27 22:27:08 EET [2020/12/27 15:27:08 ET]
Table '3082648141 274' 9-max Seat #5 is the button
Seat 1: jcarlos.vale (20016 in chips) 
Seat 2: praskachev (24328 in chips) 
Seat 3: ayala999 (10886 in chips) 
Seat 4: nabajastars (55894 in chips) 
Seat 5: bliznec11 (49819 in chips) is sitting out
Seat 6: Elwis08 (37074 in chips) 
Seat 7: IBMaN78 (14246 in chips) 
Seat 8: mgrjf (11860 in chips) 
Seat 9: 66demon99 (17232 in chips) 
jcarlos.vale: posts the ante 40
praskachev: posts the ante 40
ayala999: posts the ante 40
nabajastars: posts the ante 40
bliznec11: posts the ante 40
Elwis08: posts the ante 40
IBMaN78: posts the ante 40
mgrjf: posts the ante 40
66demon99: posts the ante 40
Elwis08: posts small blind 300
IBMaN78: posts big blind 600
*** HOLE CARDS ***
Dealt to jcarlos.vale [6c 9s]
mgrjf: folds 
66demon99: folds 
jcarlos.vale: folds 
praskachev: raises 600 to 1200
ayala999: folds 
nabajastars: folds 
bliznec11: folds 
Elwis08: folds 
IBMaN78: calls 600
*** FLOP *** [8c Kd 6h]
IBMaN78: checks 
praskachev: bets 1530
IBMaN78: folds 
Uncalled bet (1530) returned to praskachev
praskachev collected 3060 from pot
praskachev: doesn't show handDTO
*** SUMMARY ***
Total pot 3060 | Rake 0 
Board [8c Kd 6h]
Seat 1: jcarlos.vale folded before Flop (didn't bet)
Seat 2: praskachev collected (3060)
Seat 3: ayala999 folded before Flop (didn't bet)
Seat 4: nabajastars folded before Flop (didn't bet)
Seat 5: bliznec11 (button) folded before Flop (didn't bet)
Seat 6: Elwis08 (small blind) folded before Flop
Seat 7: IBMaN78 (big blind) folded on the Flop
Seat 8: mgrjf folded before Flop (didn't bet)
Seat 9: 66demon99 folded before Flop (didn't bet)



PokerStars Hand #221915863385: Tournament #3082648141, $0.98+$0.12 USD Hold'em No Limit - Level XIV (300/600) - 2020/12/27 22:27:48 EET [2020/12/27 15:27:48 ET]
Table '3082648141 274' 9-max Seat #6 is the button
Seat 1: jcarlos.vale (19976 in chips) 
Seat 2: praskachev (26148 in chips) 
Seat 3: ayala999 (10846 in chips) 
Seat 4: nabajastars (55854 in chips) 
Seat 5: bliznec11 (49779 in chips) is sitting out
Seat 6: Elwis08 (36734 in chips) 
Seat 7: IBMaN78 (13006 in chips) 
Seat 8: mgrjf (11820 in chips) 
Seat 9: 66demon99 (17192 in chips) 
jcarlos.vale: posts the ante 40
praskachev: posts the ante 40
ayala999: posts the ante 40
nabajastars: posts the ante 40
bliznec11: posts the ante 40
Elwis08: posts the ante 40
IBMaN78: posts the ante 40
mgrjf: posts the ante 40
66demon99: posts the ante 40
IBMaN78: posts small blind 300
mgrjf: posts big blind 600
*** HOLE CARDS ***
Dealt to jcarlos.vale [7d 3c]
66demon99: folds 
jcarlos.vale: folds 
praskachev: folds 
ayala999: folds 
nabajastars: raises 600 to 1200
bliznec11: folds 
Elwis08: folds 
IBMaN78: folds 
mgrjf: folds 
Uncalled bet (600) returned to nabajastars
nabajastars collected 1860 from pot
*** SUMMARY ***
Total pot 1860 | Rake 0 
Seat 1: jcarlos.vale folded before Flop (didn't bet)
Seat 2: praskachev folded before Flop (didn't bet)
Seat 3: ayala999 folded before Flop (didn't bet)
Seat 4: nabajastars collected (1860)
Seat 5: bliznec11 folded before Flop (didn't bet)
Seat 6: Elwis08 (button) folded before Flop (didn't bet)
Seat 7: IBMaN78 (small blind) folded before Flop
Seat 8: mgrjf (big blind) folded before Flop
Seat 9: 66demon99 folded before Flop (didn't bet)



PokerStars Hand #221915885054: Tournament #3082648141, $0.98+$0.12 USD Hold'em No Limit - Level XIV (300/600) - 2020/12/27 22:28:11 EET [2020/12/27 15:28:11 ET]
Table '3082648141 274' 9-max Seat #7 is the button
Seat 1: jcarlos.vale (19936 in chips) 
Seat 2: praskachev (26108 in chips) 
Seat 3: ayala999 (10806 in chips) 
Seat 4: nabajastars (57074 in chips) 
Seat 5: bliznec11 (49739 in chips) is sitting out
Seat 6: Elwis08 (36694 in chips) 
Seat 7: IBMaN78 (12666 in chips) 
Seat 8: mgrjf (11180 in chips) 
Seat 9: 66demon99 (17152 in chips) 
jcarlos.vale: posts the ante 40
praskachev: posts the ante 40
ayala999: posts the ante 40
nabajastars: posts the ante 40
bliznec11: posts the ante 40
Elwis08: posts the ante 40
IBMaN78: posts the ante 40
mgrjf: posts the ante 40
66demon99: posts the ante 40
mgrjf: posts small blind 300
66demon99: posts big blind 600
*** HOLE CARDS ***
Dealt to jcarlos.vale [Qd 4d]
bliznec11 is disconnected 
jcarlos.vale: folds 
praskachev: folds 
ayala999: folds 
nabajastars: raises 900 to 1500
bliznec11: folds 
Elwis08: folds 
IBMaN78: folds 
mgrjf: folds 
66demon99: folds 
Uncalled bet (900) returned to nabajastars
nabajastars collected 1860 from pot
*** SUMMARY ***
Total pot 1860 | Rake 0 
Seat 1: jcarlos.vale folded before Flop (didn't bet)
Seat 2: praskachev folded before Flop (didn't bet)
Seat 3: ayala999 folded before Flop (didn't bet)
Seat 4: nabajastars collected (1860)
Seat 5: bliznec11 folded before Flop (didn't bet)
Seat 6: Elwis08 folded before Flop (didn't bet)
Seat 7: IBMaN78 (button) folded before Flop (didn't bet)
Seat 8: mgrjf (small blind) folded before Flop
Seat 9: 66demon99 (big blind) folded before Flop



PokerStars Hand #221915908197: Tournament #3082648141, $0.98+$0.12 USD Hold'em No Limit - Level XIV (300/600) - 2020/12/27 22:28:34 EET [2020/12/27 15:28:34 ET]
Table '3082648141 274' 9-max Seat #8 is the button
Seat 1: jcarlos.vale (19896 in chips) 
Seat 2: praskachev (26068 in chips) 
Seat 3: ayala999 (10766 in chips) 
Seat 4: nabajastars (58294 in chips) 
Seat 5: bliznec11 (49699 in chips) is sitting out
Seat 6: Elwis08 (36654 in chips) 
Seat 7: IBMaN78 (12626 in chips) 
Seat 8: mgrjf (10840 in chips) 
Seat 9: 66demon99 (16512 in chips) 
jcarlos.vale: posts the ante 40
praskachev: posts the ante 40
ayala999: posts the ante 40
nabajastars: posts the ante 40
bliznec11: posts the ante 40
Elwis08: posts the ante 40
IBMaN78: posts the ante 40
mgrjf: posts the ante 40
66demon99: posts the ante 40
66demon99: posts small blind 300
jcarlos.vale: posts big blind 600
*** HOLE CARDS ***
Dealt to jcarlos.vale [9h 8c]
praskachev: folds 
ayala999: folds 
nabajastars: folds 
bliznec11: folds 
Elwis08: folds 
IBMaN78: folds 
mgrjf: folds 
66demon99: raises 1320 to 1920
jcarlos.vale: folds 
Uncalled bet (1320) returned to 66demon99
66demon99 collected 1560 from pot
66demon99: doesn't show handDTO
*** SUMMARY ***
Total pot 1560 | Rake 0 
Seat 1: jcarlos.vale (big blind) folded before Flop
Seat 2: praskachev folded before Flop (didn't bet)
Seat 3: ayala999 folded before Flop (didn't bet)
Seat 4: nabajastars folded before Flop (didn't bet)
Seat 5: bliznec11 folded before Flop (didn't bet)
Seat 6: Elwis08 folded before Flop (didn't bet)
Seat 7: IBMaN78 folded before Flop (didn't bet)
Seat 8: mgrjf (button) folded before Flop (didn't bet)
Seat 9: 66demon99 (small blind) collected (1560)



PokerStars Hand #221915938501: Tournament #3082648141, $0.98+$0.12 USD Hold'em No Limit - Level XIV (300/600) - 2020/12/27 22:29:05 EET [2020/12/27 15:29:05 ET]
Table '3082648141 274' 9-max Seat #9 is the button
Seat 1: jcarlos.vale (19256 in chips) 
Seat 2: praskachev (26028 in chips) 
Seat 3: ayala999 (10726 in chips) 
Seat 4: nabajastars (58254 in chips) 
Seat 5: bliznec11 (49659 in chips) is sitting out
Seat 6: Elwis08 (36614 in chips) 
Seat 7: IBMaN78 (12586 in chips) 
Seat 8: mgrjf (10800 in chips) 
Seat 9: 66demon99 (17432 in chips) 
jcarlos.vale: posts the ante 40
praskachev: posts the ante 40
ayala999: posts the ante 40
nabajastars: posts the ante 40
bliznec11: posts the ante 40
Elwis08: posts the ante 40
IBMaN78: posts the ante 40
mgrjf: posts the ante 40
66demon99: posts the ante 40
jcarlos.vale: posts small blind 300
praskachev: posts big blind 600
*** HOLE CARDS ***
Dealt to jcarlos.vale [Ad Qc]
ayala999: folds 
nabajastars: folds 
bliznec11: folds 
Elwis08: folds 
IBMaN78: folds 
mgrjf: folds 
66demon99: folds 
jcarlos.vale: raises 960 to 1560
praskachev: folds 
Uncalled bet (960) returned to jcarlos.vale
jcarlos.vale collected 1560 from pot
jcarlos.vale: doesn't show handDTO
*** SUMMARY ***
Total pot 1560 | Rake 0 
Seat 1: jcarlos.vale (small blind) collected (1560)
Seat 2: praskachev (big blind) folded before Flop
Seat 3: ayala999 folded before Flop (didn't bet)
Seat 4: nabajastars folded before Flop (didn't bet)
Seat 5: bliznec11 folded before Flop (didn't bet)
Seat 6: Elwis08 folded before Flop (didn't bet)
Seat 7: IBMaN78 folded before Flop (didn't bet)
Seat 8: mgrjf folded before Flop (didn't bet)
Seat 9: 66demon99 (button) folded before Flop (didn't bet)



PokerStars Hand #221915967111: Tournament #3082648141, $0.98+$0.12 USD Hold'em No Limit - Level XIV (300/600) - 2020/12/27 22:29:35 EET [2020/12/27 15:29:35 ET]
Table '3082648141 274' 9-max Seat #1 is the button
Seat 1: jcarlos.vale (20176 in chips) 
Seat 2: praskachev (25388 in chips) 
Seat 3: ayala999 (10686 in chips) 
Seat 4: nabajastars (58214 in chips) 
Seat 5: bliznec11 (49619 in chips) is sitting out
Seat 6: Elwis08 (36574 in chips) 
Seat 7: IBMaN78 (12546 in chips) 
Seat 8: mgrjf (10760 in chips) 
Seat 9: 66demon99 (17392 in chips) 
jcarlos.vale: posts the ante 40
praskachev: posts the ante 40
ayala999: posts the ante 40
nabajastars: posts the ante 40
bliznec11: posts the ante 40
Elwis08: posts the ante 40
IBMaN78: posts the ante 40
mgrjf: posts the ante 40
66demon99: posts the ante 40
praskachev: posts small blind 300
ayala999: posts big blind 600
*** HOLE CARDS ***
Dealt to jcarlos.vale [Kc 2c]
bliznec11 has returned
nabajastars: folds 
bliznec11: folds 
Elwis08: folds 
IBMaN78: folds 
mgrjf: folds 
66demon99: raises 600 to 1200
jcarlos.vale: folds 
praskachev: raises 1800 to 3000
ayala999: raises 7646 to 10646 and is all-in
66demon99: folds 
praskachev: folds 
Uncalled bet (7646) returned to ayala999
ayala999 collected 7560 from pot
ayala999: doesn't show handDTO
*** SUMMARY ***
Total pot 7560 | Rake 0 
Seat 1: jcarlos.vale (button) folded before Flop (didn't bet)
Seat 2: praskachev (small blind) folded before Flop
Seat 3: ayala999 (big blind) collected (7560)
Seat 4: nabajastars folded before Flop (didn't bet)
Seat 5: bliznec11 folded before Flop (didn't bet)
Seat 6: Elwis08 folded before Flop (didn't bet)
Seat 7: IBMaN78 folded before Flop (didn't bet)
Seat 8: mgrjf folded before Flop (didn't bet)
Seat 9: 66demon99 folded before Flop



PokerStars Hand #221916019291: Tournament #3082648141, $0.98+$0.12 USD Hold'em No Limit - Level XIV (300/600) - 2020/12/27 22:30:28 EET [2020/12/27 15:30:28 ET]
Table '3082648141 274' 9-max Seat #2 is the button
Seat 1: jcarlos.vale (20136 in chips) 
Seat 2: praskachev (22348 in chips) 
Seat 3: ayala999 (15206 in chips) 
Seat 4: nabajastars (58174 in chips) 
Seat 5: bliznec11 (49579 in chips) 
Seat 6: Elwis08 (36534 in chips) 
Seat 7: IBMaN78 (12506 in chips) 
Seat 8: mgrjf (10720 in chips) 
Seat 9: 66demon99 (16152 in chips) 
jcarlos.vale: posts the ante 40
praskachev: posts the ante 40
ayala999: posts the ante 40
nabajastars: posts the ante 40
bliznec11: posts the ante 40
Elwis08: posts the ante 40
IBMaN78: posts the ante 40
mgrjf: posts the ante 40
66demon99: posts the ante 40
ayala999: posts small blind 300
nabajastars: posts big blind 600
*** HOLE CARDS ***
Dealt to jcarlos.vale [3h Qd]
bliznec11: folds 
Elwis08: folds 
IBMaN78: folds 
mgrjf: raises 648 to 1248
66demon99: folds 
jcarlos.vale: folds 
praskachev: folds 
ayala999: folds 
nabajastars: calls 648
*** FLOP *** [9c 6c 5c]
nabajastars: checks 
mgrjf: checks 
*** TURN *** [9c 6c 5c] [2h]
nabajastars: bets 947
mgrjf: folds 
Uncalled bet (947) returned to nabajastars
nabajastars collected 3156 from pot
*** SUMMARY ***
Total pot 3156 | Rake 0 
Board [9c 6c 5c 2h]
Seat 1: jcarlos.vale folded before Flop (didn't bet)
Seat 2: praskachev (button) folded before Flop (didn't bet)
Seat 3: ayala999 (small blind) folded before Flop
Seat 4: nabajastars (big blind) collected (3156)
Seat 5: bliznec11 folded before Flop (didn't bet)
Seat 6: Elwis08 folded before Flop (didn't bet)
Seat 7: IBMaN78 folded before Flop (didn't bet)
Seat 8: mgrjf folded on the Turn
Seat 9: 66demon99 folded before Flop (didn't bet)



PokerStars Hand #221916056519: Tournament #3082648141, $0.98+$0.12 USD Hold'em No Limit - Level XIV (300/600) - 2020/12/27 22:31:06 EET [2020/12/27 15:31:06 ET]
Table '3082648141 274' 9-max Seat #3 is the button
Seat 1: jcarlos.vale (20096 in chips) 
Seat 2: praskachev (22308 in chips) 
Seat 3: ayala999 (14866 in chips) 
Seat 4: nabajastars (60042 in chips) 
Seat 5: bliznec11 (49539 in chips) 
Seat 6: Elwis08 (36494 in chips) 
Seat 7: IBMaN78 (12466 in chips) 
Seat 8: mgrjf (9432 in chips) 
Seat 9: 66demon99 (16112 in chips) 
jcarlos.vale: posts the ante 40
praskachev: posts the ante 40
ayala999: posts the ante 40
nabajastars: posts the ante 40
bliznec11: posts the ante 40
Elwis08: posts the ante 40
IBMaN78: posts the ante 40
mgrjf: posts the ante 40
66demon99: posts the ante 40
nabajastars: posts small blind 300
bliznec11: posts big blind 600
*** HOLE CARDS ***
Dealt to jcarlos.vale [2c Kh]
Elwis08: folds 
IBMaN78: folds 
mgrjf: folds 
66demon99: folds 
jcarlos.vale: folds 
praskachev: folds 
ayala999: raises 600 to 1200
nabajastars: raises 3000 to 4200
bliznec11: folds 
ayala999: raises 10626 to 14826 and is all-in
nabajastars: calls 10626
*** FLOP *** [6h 3c 4h]
*** TURN *** [6h 3c 4h] [9s]
*** RIVER *** [6h 3c 4h 9s] [Ad]
*** SHOW DOWN ***
nabajastars: shows [Jd Jh] (a pair of Jacks)
ayala999: shows [7d 7s] (a pair of Sevens)
nabajastars collected 30612 from pot
ayala999 finished the tournament in 1117th place
*** SUMMARY ***
Total pot 30612 | Rake 0 
Board [6h 3c 4h 9s Ad]
Seat 1: jcarlos.vale folded before Flop (didn't bet)
Seat 2: praskachev folded before Flop (didn't bet)
Seat 3: ayala999 (button) showed [7d 7s] and lost with a pair of Sevens
Seat 4: nabajastars (small blind) showed [Jd Jh] and won (30612) with a pair of Jacks
Seat 5: bliznec11 (big blind) folded before Flop
Seat 6: Elwis08 folded before Flop (didn't bet)
Seat 7: IBMaN78 folded before Flop (didn't bet)
Seat 8: mgrjf folded before Flop (didn't bet)
Seat 9: 66demon99 folded before Flop (didn't bet)



PokerStars Hand #221916130415: Tournament #3082648141, $0.98+$0.12 USD Hold'em No Limit - Level XIV (300/600) - 2020/12/27 22:32:22 EET [2020/12/27 15:32:22 ET]
Table '3082648141 85' 9-max Seat #5 is the button
Seat 1: jcarlos.vale (20056 in chips) 
Seat 2: woopah (55952 in chips) 
Seat 3: SleazyP84 (13966 in chips) 
Seat 4: onlyoneggg (15874 in chips) 
Seat 5: flushnutsAA (68181 in chips) 
Seat 6: lucas.globo (16620 in chips) 
Seat 7: 7Cassie7 (10592 in chips) 
Seat 8: komerus (22560 in chips) 
Seat 9: yannicho (25815 in chips) 
jcarlos.vale: posts the ante 40
woopah: posts the ante 40
SleazyP84: posts the ante 40
onlyoneggg: posts the ante 40
flushnutsAA: posts the ante 40
lucas.globo: posts the ante 40
7Cassie7: posts the ante 40
komerus: posts the ante 40
yannicho: posts the ante 40
lucas.globo: posts small blind 300
7Cassie7: posts big blind 600
*** HOLE CARDS ***
Dealt to jcarlos.vale [Qh 2c]
komerus: calls 600
yannicho: folds 
jcarlos.vale: folds 
woopah: folds 
SleazyP84: raises 2100 to 2700
onlyoneggg: folds 
flushnutsAA: folds 
lucas.globo: folds 
7Cassie7: folds 
komerus: calls 2100
*** FLOP *** [Qd 2h Ah]
komerus: bets 600
SleazyP84: raises 2400 to 3000
komerus: calls 2400
*** TURN *** [Qd 2h Ah] [5s]
komerus: bets 600
SleazyP84: calls 600
*** RIVER *** [Qd 2h Ah 5s] [3d]
komerus: bets 600
SleazyP84: calls 600
*** SHOW DOWN ***
komerus: shows [Js Ac] (a pair of Aces)
SleazyP84: mucks handDTO
komerus collected 15060 from pot
*** SUMMARY ***
Total pot 15060 | Rake 0 
Board [Qd 2h Ah 5s 3d]
Seat 1: jcarlos.vale folded before Flop (didn't bet)
Seat 2: woopah folded before Flop (didn't bet)
Seat 3: SleazyP84 mucked [9c 9d]
Seat 4: onlyoneggg folded before Flop (didn't bet)
Seat 5: flushnutsAA (button) folded before Flop (didn't bet)
Seat 6: lucas.globo (small blind) folded before Flop
Seat 7: 7Cassie7 (big blind) folded before Flop
Seat 8: komerus showed [Js Ac] and won (15060) with a pair of Aces
Seat 9: yannicho folded before Flop (didn't bet)



PokerStars Hand #221916170169: Tournament #3082648141, $0.98+$0.12 USD Hold'em No Limit - Level XIV (300/600) - 2020/12/27 22:33:03 EET [2020/12/27 15:33:03 ET]
Table '3082648141 85' 9-max Seat #6 is the button
Seat 1: jcarlos.vale (20016 in chips) 
Seat 2: woopah (55912 in chips) 
Seat 3: SleazyP84 (7026 in chips) 
Seat 4: onlyoneggg (15834 in chips) 
Seat 5: flushnutsAA (68141 in chips) 
Seat 6: lucas.globo (16280 in chips) 
Seat 7: 7Cassie7 (9952 in chips) 
Seat 8: komerus (30680 in chips) 
Seat 9: yannicho (25775 in chips) 
jcarlos.vale: posts the ante 40
woopah: posts the ante 40
SleazyP84: posts the ante 40
onlyoneggg: posts the ante 40
flushnutsAA: posts the ante 40
lucas.globo: posts the ante 40
7Cassie7: posts the ante 40
komerus: posts the ante 40
yannicho: posts the ante 40
7Cassie7: posts small blind 300
komerus: posts big blind 600
*** HOLE CARDS ***
Dealt to jcarlos.vale [Jc 5d]
yannicho: folds 
jcarlos.vale: folds 
woopah: folds 
SleazyP84: folds 
onlyoneggg: folds 
flushnutsAA: folds 
lucas.globo: raises 1200 to 1800
7Cassie7: folds 
komerus: calls 1200
*** FLOP *** [4d As Js]
komerus: checks 
lucas.globo: bets 2130
komerus: folds 
Uncalled bet (2130) returned to lucas.globo
lucas.globo collected 4260 from pot
lucas.globo: doesn't show handDTO
*** SUMMARY ***
Total pot 4260 | Rake 0 
Board [4d As Js]
Seat 1: jcarlos.vale folded before Flop (didn't bet)
Seat 2: woopah folded before Flop (didn't bet)
Seat 3: SleazyP84 folded before Flop (didn't bet)
Seat 4: onlyoneggg folded before Flop (didn't bet)
Seat 5: flushnutsAA folded before Flop (didn't bet)
Seat 6: lucas.globo (button) collected (4260)
Seat 7: 7Cassie7 (small blind) folded before Flop
Seat 8: komerus (big blind) folded on the Flop
Seat 9: yannicho folded before Flop (didn't bet)



PokerStars Hand #221916202890: Tournament #3082648141, $0.98+$0.12 USD Hold'em No Limit - Level XIV (300/600) - 2020/12/27 22:33:31 EET [2020/12/27 15:33:31 ET]
Table '3082648141 85' 9-max Seat #7 is the button
Seat 1: jcarlos.vale (19976 in chips) 
Seat 2: woopah (55872 in chips) 
Seat 3: SleazyP84 (6986 in chips) 
Seat 4: onlyoneggg (15794 in chips) 
Seat 5: flushnutsAA (68101 in chips) 
Seat 6: lucas.globo (18700 in chips) 
Seat 7: 7Cassie7 (9612 in chips) 
Seat 8: komerus (28840 in chips) 
Seat 9: yannicho (25735 in chips) 
jcarlos.vale: posts the ante 40
woopah: posts the ante 40
SleazyP84: posts the ante 40
onlyoneggg: posts the ante 40
flushnutsAA: posts the ante 40
lucas.globo: posts the ante 40
7Cassie7: posts the ante 40
komerus: posts the ante 40
yannicho: posts the ante 40
komerus: posts small blind 300
yannicho: posts big blind 600
*** HOLE CARDS ***
Dealt to jcarlos.vale [Jc Js]
jcarlos.vale: raises 960 to 1560
woopah: calls 1560
SleazyP84: folds 
onlyoneggg: folds 
flushnutsAA: folds 
lucas.globo: folds 
7Cassie7: folds 
komerus: calls 1260
yannicho: folds 
*** FLOP *** [5d 3c 9c]
komerus: checks 
jcarlos.vale: bets 4230
woopah: calls 4230
komerus: folds 
*** TURN *** [5d 3c 9c] [Qh]
jcarlos.vale: bets 10575
woopah: folds 
Uncalled bet (10575) returned to jcarlos.vale
jcarlos.vale collected 14100 from pot
jcarlos.vale: doesn't show handDTO
*** SUMMARY ***
Total pot 14100 | Rake 0 
Board [5d 3c 9c Qh]
Seat 1: jcarlos.vale collected (14100)
Seat 2: woopah folded on the Turn
Seat 3: SleazyP84 folded before Flop (didn't bet)
Seat 4: onlyoneggg folded before Flop (didn't bet)
Seat 5: flushnutsAA folded before Flop (didn't bet)
Seat 6: lucas.globo folded before Flop (didn't bet)
Seat 7: 7Cassie7 (button) folded before Flop (didn't bet)
Seat 8: komerus (small blind) folded on the Flop
Seat 9: yannicho (big blind) folded before Flop



PokerStars Hand #221916263676: Tournament #3082648141, $0.98+$0.12 USD Hold'em No Limit - Level XIV (300/600) - 2020/12/27 22:34:34 EET [2020/12/27 15:34:34 ET]
Table '3082648141 85' 9-max Seat #8 is the button
Seat 1: jcarlos.vale (28246 in chips) 
Seat 2: woopah (50042 in chips) 
Seat 3: SleazyP84 (6946 in chips) 
Seat 4: onlyoneggg (15754 in chips) 
Seat 5: flushnutsAA (68061 in chips) 
Seat 6: lucas.globo (18660 in chips) 
Seat 7: 7Cassie7 (9572 in chips) 
Seat 8: komerus (27240 in chips) 
Seat 9: yannicho (25095 in chips) 
jcarlos.vale: posts the ante 40
woopah: posts the ante 40
SleazyP84: posts the ante 40
onlyoneggg: posts the ante 40
flushnutsAA: posts the ante 40
lucas.globo: posts the ante 40
7Cassie7: posts the ante 40
komerus: posts the ante 40
yannicho: posts the ante 40
yannicho: posts small blind 300
jcarlos.vale: posts big blind 600
*** HOLE CARDS ***
Dealt to jcarlos.vale [4d Ts]
woopah: folds 
SleazyP84: folds 
onlyoneggg: folds 
flushnutsAA: folds 
lucas.globo: folds 
7Cassie7: folds 
komerus: calls 600
yannicho: folds 
jcarlos.vale: checks 
*** FLOP *** [Ah 3s 6h]
jcarlos.vale: checks 
komerus: checks 
*** TURN *** [Ah 3s 6h] [6d]
jcarlos.vale: checks 
komerus: checks 
*** RIVER *** [Ah 3s 6h 6d] [9h]
jcarlos.vale: checks 
komerus: checks 
*** SHOW DOWN ***
jcarlos.vale: shows [4d Ts] (a pair of Sixes)
komerus: shows [Qd 2c] (a pair of Sixes - Ace+Queen kicker)
komerus collected 1860 from pot
*** SUMMARY ***
Total pot 1860 | Rake 0 
Board [Ah 3s 6h 6d 9h]
Seat 1: jcarlos.vale (big blind) showed [4d Ts] and lost with a pair of Sixes
Seat 2: woopah folded before Flop (didn't bet)
Seat 3: SleazyP84 folded before Flop (didn't bet)
Seat 4: onlyoneggg folded before Flop (didn't bet)
Seat 5: flushnutsAA folded before Flop (didn't bet)
Seat 6: lucas.globo folded before Flop (didn't bet)
Seat 7: 7Cassie7 folded before Flop (didn't bet)
Seat 8: komerus (button) showed [Qd 2c] and won (1860) with a pair of Sixes
Seat 9: yannicho (small blind) folded before Flop



PokerStars Hand #221916316410: Tournament #3082648141, $0.98+$0.12 USD Hold'em No Limit - Level XIV (300/600) - 2020/12/27 22:35:29 EET [2020/12/27 15:35:29 ET]
Table '3082648141 85' 9-max Seat #9 is the button
Seat 1: jcarlos.vale (27606 in chips) 
Seat 2: woopah (50002 in chips) 
Seat 3: SleazyP84 (6906 in chips) 
Seat 4: onlyoneggg (15714 in chips) 
Seat 5: flushnutsAA (68021 in chips) 
Seat 6: lucas.globo (18620 in chips) 
Seat 7: 7Cassie7 (9532 in chips) 
Seat 8: komerus (28460 in chips) 
Seat 9: yannicho (24755 in chips) 
jcarlos.vale: posts the ante 40
woopah: posts the ante 40
SleazyP84: posts the ante 40
onlyoneggg: posts the ante 40
flushnutsAA: posts the ante 40
lucas.globo: posts the ante 40
7Cassie7: posts the ante 40
komerus: posts the ante 40
yannicho: posts the ante 40
jcarlos.vale: posts small blind 300
woopah: posts big blind 600
*** HOLE CARDS ***
Dealt to jcarlos.vale [Jd Kc]
SleazyP84: folds 
onlyoneggg: folds 
flushnutsAA: folds 
lucas.globo: calls 600
7Cassie7: calls 600
komerus: calls 600
yannicho: folds 
jcarlos.vale: calls 300
woopah: checks 
*** FLOP *** [9d 8s 2s]
jcarlos.vale: checks 
woopah: checks 
lucas.globo: bets 1680
7Cassie7: folds 
komerus: folds 
jcarlos.vale: folds 
woopah: folds 
Uncalled bet (1680) returned to lucas.globo
lucas.globo collected 3360 from pot
lucas.globo: doesn't show handDTO
*** SUMMARY ***
Total pot 3360 | Rake 0 
Board [9d 8s 2s]
Seat 1: jcarlos.vale (small blind) folded on the Flop
Seat 2: woopah (big blind) folded on the Flop
Seat 3: SleazyP84 folded before Flop (didn't bet)
Seat 4: onlyoneggg folded before Flop (didn't bet)
Seat 5: flushnutsAA folded before Flop (didn't bet)
Seat 6: lucas.globo collected (3360)
Seat 7: 7Cassie7 folded on the Flop
Seat 8: komerus folded on the Flop
Seat 9: yannicho (button) folded before Flop (didn't bet)



PokerStars Hand #221916416452: Tournament #3082648141, $0.98+$0.12 USD Hold'em No Limit - Level XV (350/700) - 2020/12/27 22:37:14 EET [2020/12/27 15:37:14 ET]
Table '3082648141 85' 9-max Seat #1 is the button
Seat 1: jcarlos.vale (26966 in chips) 
Seat 2: woopah (49362 in chips) 
Seat 3: SleazyP84 (6866 in chips) 
Seat 4: onlyoneggg (15674 in chips) 
Seat 5: flushnutsAA (67981 in chips) 
Seat 6: lucas.globo (21340 in chips) 
Seat 7: 7Cassie7 (8892 in chips) 
Seat 8: komerus (27820 in chips) 
Seat 9: yannicho (24715 in chips) 
jcarlos.vale: posts the ante 50
woopah: posts the ante 50
SleazyP84: posts the ante 50
onlyoneggg: posts the ante 50
flushnutsAA: posts the ante 50
lucas.globo: posts the ante 50
7Cassie7: posts the ante 50
komerus: posts the ante 50
yannicho: posts the ante 50
woopah: posts small blind 350
SleazyP84: posts big blind 700
*** HOLE CARDS ***
Dealt to jcarlos.vale [7d 9s]
onlyoneggg: folds 
flushnutsAA: folds 
lucas.globo: folds 
7Cassie7: folds 
komerus: calls 700
yannicho: folds 
jcarlos.vale: folds 
woopah: folds 
SleazyP84: checks 
*** FLOP *** [5d Js As]
SleazyP84: checks 
komerus: bets 700
SleazyP84: folds 
Uncalled bet (700) returned to komerus
komerus collected 2200 from pot
komerus: doesn't show handDTO
*** SUMMARY ***
Total pot 2200 | Rake 0 
Board [5d Js As]
Seat 1: jcarlos.vale (button) folded before Flop (didn't bet)
Seat 2: woopah (small blind) folded before Flop
Seat 3: SleazyP84 (big blind) folded on the Flop
Seat 4: onlyoneggg folded before Flop (didn't bet)
Seat 5: flushnutsAA folded before Flop (didn't bet)
Seat 6: lucas.globo folded before Flop (didn't bet)
Seat 7: 7Cassie7 folded before Flop (didn't bet)
Seat 8: komerus collected (2200)
Seat 9: yannicho folded before Flop (didn't bet)



PokerStars Hand #221916456540: Tournament #3082648141, $0.98+$0.12 USD Hold'em No Limit - Level XV (350/700) - 2020/12/27 22:37:56 EET [2020/12/27 15:37:56 ET]
Table '3082648141 85' 9-max Seat #2 is the button
Seat 1: jcarlos.vale (26916 in chips) 
Seat 2: woopah (48962 in chips) 
Seat 3: SleazyP84 (6116 in chips) 
Seat 4: onlyoneggg (15624 in chips) 
Seat 5: flushnutsAA (67931 in chips) 
Seat 6: lucas.globo (21290 in chips) 
Seat 7: 7Cassie7 (8842 in chips) 
Seat 8: komerus (29270 in chips) 
Seat 9: yannicho (24665 in chips) 
jcarlos.vale: posts the ante 50
woopah: posts the ante 50
SleazyP84: posts the ante 50
onlyoneggg: posts the ante 50
flushnutsAA: posts the ante 50
lucas.globo: posts the ante 50
7Cassie7: posts the ante 50
komerus: posts the ante 50
yannicho: posts the ante 50
SleazyP84: posts small blind 350
onlyoneggg: posts big blind 700
*** HOLE CARDS ***
Dealt to jcarlos.vale [Td Kc]
flushnutsAA: folds 
lucas.globo: folds 
7Cassie7: folds 
komerus: calls 700
yannicho: folds 
jcarlos.vale: folds 
woopah: raises 2800 to 3500
SleazyP84: folds 
onlyoneggg: raises 12074 to 15574 and is all-in
komerus: folds 
woopah: calls 12074
*** FLOP *** [5s As 4h]
*** TURN *** [5s As 4h] [2s]
*** RIVER *** [5s As 4h 2s] [6c]
*** SHOW DOWN ***
onlyoneggg: shows [Jh Jd] (a pair of Jacks)
woopah: shows [Ad Qd] (a pair of Aces)
woopah collected 32648 from pot
onlyoneggg finished the tournament in 996th place
*** SUMMARY ***
Total pot 32648 | Rake 0 
Board [5s As 4h 2s 6c]
Seat 1: jcarlos.vale folded before Flop (didn't bet)
Seat 2: woopah (button) showed [Ad Qd] and won (32648) with a pair of Aces
Seat 3: SleazyP84 (small blind) folded before Flop
Seat 4: onlyoneggg (big blind) showed [Jh Jd] and lost with a pair of Jacks
Seat 5: flushnutsAA folded before Flop (didn't bet)
Seat 6: lucas.globo folded before Flop (didn't bet)
Seat 7: 7Cassie7 folded before Flop (didn't bet)
Seat 8: komerus folded before Flop
Seat 9: yannicho folded before Flop (didn't bet)



PokerStars Hand #221916505083: Tournament #3082648141, $0.98+$0.12 USD Hold'em No Limit - Level XV (350/700) - 2020/12/27 22:38:47 EET [2020/12/27 15:38:47 ET]
Table '3082648141 85' 9-max Seat #3 is the button
Seat 1: jcarlos.vale (26866 in chips) 
Seat 2: woopah (65986 in chips) 
Seat 3: SleazyP84 (5716 in chips) 
Seat 5: flushnutsAA (67881 in chips) 
Seat 6: lucas.globo (21240 in chips) 
Seat 7: 7Cassie7 (8792 in chips) 
Seat 8: komerus (28520 in chips) 
Seat 9: yannicho (24615 in chips) 
jcarlos.vale: posts the ante 50
woopah: posts the ante 50
SleazyP84: posts the ante 50
flushnutsAA: posts the ante 50
lucas.globo: posts the ante 50
7Cassie7: posts the ante 50
komerus: posts the ante 50
yannicho: posts the ante 50
flushnutsAA: posts small blind 350
lucas.globo: posts big blind 700
*** HOLE CARDS ***
Dealt to jcarlos.vale [6h Jd]
7Cassie7: folds 
komerus: folds 
yannicho: folds 
jcarlos.vale: folds 
woopah: raises 854 to 1554
SleazyP84: folds 
flushnutsAA: calls 1204
lucas.globo: folds 
*** FLOP *** [5c Kc 9d]
flushnutsAA: checks 
woopah: bets 1389
flushnutsAA: calls 1389
*** TURN *** [5c Kc 9d] [2c]
flushnutsAA: checks 
woopah: checks 
*** RIVER *** [5c Kc 9d 2c] [2s]
flushnutsAA: bets 4333
woopah: folds 
Uncalled bet (4333) returned to flushnutsAA
flushnutsAA collected 6986 from pot
flushnutsAA: doesn't show handDTO
*** SUMMARY ***
Total pot 6986 | Rake 0 
Board [5c Kc 9d 2c 2s]
Seat 1: jcarlos.vale folded before Flop (didn't bet)
Seat 2: woopah folded on the River
Seat 3: SleazyP84 (button) folded before Flop (didn't bet)
Seat 5: flushnutsAA (small blind) collected (6986)
Seat 6: lucas.globo (big blind) folded before Flop
Seat 7: 7Cassie7 folded before Flop (didn't bet)
Seat 8: komerus folded before Flop (didn't bet)
Seat 9: yannicho folded before Flop (didn't bet)



PokerStars Hand #221916549940: Tournament #3082648141, $0.98+$0.12 USD Hold'em No Limit - Level XV (350/700) - 2020/12/27 22:39:34 EET [2020/12/27 15:39:34 ET]
Table '3082648141 85' 9-max Seat #5 is the button
Seat 1: jcarlos.vale (26816 in chips) 
Seat 2: woopah (62993 in chips) 
Seat 3: SleazyP84 (5666 in chips) 
Seat 4: luanabvale (13506 in chips) 
Seat 5: flushnutsAA (71874 in chips) 
Seat 6: lucas.globo (20490 in chips) 
Seat 7: 7Cassie7 (8742 in chips) 
Seat 8: komerus (28470 in chips) 
Seat 9: yannicho (24565 in chips) 
jcarlos.vale: posts the ante 50
woopah: posts the ante 50
SleazyP84: posts the ante 50
luanabvale: posts the ante 50
flushnutsAA: posts the ante 50
lucas.globo: posts the ante 50
7Cassie7: posts the ante 50
komerus: posts the ante 50
yannicho: posts the ante 50
lucas.globo: posts small blind 350
7Cassie7: posts big blind 700
*** HOLE CARDS ***
Dealt to jcarlos.vale [7s 2s]
komerus: calls 700
yannicho: folds 
jcarlos.vale: folds 
woopah: folds 
SleazyP84: folds 
luanabvale: folds 
flushnutsAA: folds 
lucas.globo: folds 
7Cassie7: checks 
*** FLOP *** [Jh Qs Th]
7Cassie7: checks 
komerus: checks 
*** TURN *** [Jh Qs Th] [Kh]
7Cassie7: bets 2200
komerus: calls 2200
*** RIVER *** [Jh Qs Th Kh] [3c]
7Cassie7: bets 5792 and is all-in
komerus: calls 5792
*** SHOW DOWN ***
7Cassie7: shows [2h 3h] (a flush, King high)
komerus: shows [Kc 4s] (a pair of Kings)
7Cassie7 collected 18184 from pot
*** SUMMARY ***
Total pot 18184 | Rake 0 
Board [Jh Qs Th Kh 3c]
Seat 1: jcarlos.vale folded before Flop (didn't bet)
Seat 2: woopah folded before Flop (didn't bet)
Seat 3: SleazyP84 folded before Flop (didn't bet)
Seat 4: luanabvale folded before Flop (didn't bet)
Seat 5: flushnutsAA (button) folded before Flop (didn't bet)
Seat 6: lucas.globo (small blind) folded before Flop
Seat 7: 7Cassie7 (big blind) showed [2h 3h] and won (18184) with a flush, King high
Seat 8: komerus showed [Kc 4s] and lost with a pair of Kings
Seat 9: yannicho folded before Flop (didn't bet)



PokerStars Hand #221916598598: Tournament #3082648141, $0.98+$0.12 USD Hold'em No Limit - Level XV (350/700) - 2020/12/27 22:40:25 EET [2020/12/27 15:40:25 ET]
Table '3082648141 85' 9-max Seat #6 is the button
Seat 1: jcarlos.vale (26766 in chips) 
Seat 2: woopah (62943 in chips) 
Seat 3: SleazyP84 (5616 in chips) 
Seat 4: luanabvale (13456 in chips) 
Seat 5: flushnutsAA (71824 in chips) 
Seat 6: lucas.globo (20090 in chips) 
Seat 7: 7Cassie7 (18184 in chips) 
Seat 8: komerus (19728 in chips) 
Seat 9: yannicho (24515 in chips) 
jcarlos.vale: posts the ante 50
woopah: posts the ante 50
SleazyP84: posts the ante 50
luanabvale: posts the ante 50
flushnutsAA: posts the ante 50
lucas.globo: posts the ante 50
7Cassie7: posts the ante 50
komerus: posts the ante 50
yannicho: posts the ante 50
7Cassie7: posts small blind 350
komerus: posts big blind 700
*** HOLE CARDS ***
Dealt to jcarlos.vale [3h 6c]
yannicho: folds 
jcarlos.vale: folds 
woopah: folds 
SleazyP84: folds 
luanabvale: folds 
flushnutsAA: folds 
lucas.globo: raises 1400 to 2100
7Cassie7: folds 
komerus: calls 1400
*** FLOP *** [Jd Qh 2s]
komerus: bets 700
lucas.globo: raises 3200 to 3900
komerus: raises 3800 to 7700
lucas.globo: raises 10240 to 17940 and is all-in
komerus: calls 9878 and is all-in
Uncalled bet (362) returned to lucas.globo
*** TURN *** [Jd Qh 2s] [5s]
*** RIVER *** [Jd Qh 2s 5s] [5d]
*** SHOW DOWN ***
komerus: shows [Qs 9s] (two pair, Queens and Fives)
lucas.globo: shows [Js Jh] (a full house, Jacks full of Fives)
lucas.globo collected 40156 from pot
komerus finished the tournament in 966th place
*** SUMMARY ***
Total pot 40156 | Rake 0 
Board [Jd Qh 2s 5s 5d]
Seat 1: jcarlos.vale folded before Flop (didn't bet)
Seat 2: woopah folded before Flop (didn't bet)
Seat 3: SleazyP84 folded before Flop (didn't bet)
Seat 4: luanabvale folded before Flop (didn't bet)
Seat 5: flushnutsAA folded before Flop (didn't bet)
Seat 6: lucas.globo (button) showed [Js Jh] and won (40156) with a full house, Jacks full of Fives
Seat 7: 7Cassie7 (small blind) folded before Flop
Seat 8: komerus (big blind) showed [Qs 9s] and lost with two pair, Queens and Fives
Seat 9: yannicho folded before Flop (didn't bet)



PokerStars Hand #221916642443: Tournament #3082648141, $0.98+$0.12 USD Hold'em No Limit - Level XV (350/700) - 2020/12/27 22:41:03 EET [2020/12/27 15:41:03 ET]
Table '3082648141 85' 9-max Seat #7 is the button
Seat 1: jcarlos.vale (26716 in chips) 
Seat 2: woopah (62893 in chips) 
Seat 3: SleazyP84 (5566 in chips) 
Seat 4: luanabvale (13406 in chips) 
Seat 5: flushnutsAA (71774 in chips) 
Seat 6: lucas.globo (40518 in chips) 
Seat 7: 7Cassie7 (17784 in chips) 
Seat 9: yannicho (24465 in chips) 
jcarlos.vale: posts the ante 50
woopah: posts the ante 50
SleazyP84: posts the ante 50
luanabvale: posts the ante 50
flushnutsAA: posts the ante 50
lucas.globo: posts the ante 50
7Cassie7: posts the ante 50
yannicho: posts the ante 50
yannicho: posts small blind 350
jcarlos.vale: posts big blind 700
*** HOLE CARDS ***
Dealt to jcarlos.vale [2c Js]
woopah: folds 
SleazyP84: folds 
luanabvale: folds 
flushnutsAA: raises 700 to 1400
lucas.globo: folds 
7Cassie7: folds 
yannicho: folds 
jcarlos.vale: folds 
Uncalled bet (700) returned to flushnutsAA
flushnutsAA collected 2150 from pot
flushnutsAA: doesn't show handDTO
*** SUMMARY ***
Total pot 2150 | Rake 0 
Seat 1: jcarlos.vale (big blind) folded before Flop
Seat 2: woopah folded before Flop (didn't bet)
Seat 3: SleazyP84 folded before Flop (didn't bet)
Seat 4: luanabvale folded before Flop (didn't bet)
Seat 5: flushnutsAA collected (2150)
Seat 6: lucas.globo folded before Flop (didn't bet)
Seat 7: 7Cassie7 (button) folded before Flop (didn't bet)
Seat 9: yannicho (small blind) folded before Flop



PokerStars Hand #221916658366: Tournament #3082648141, $0.98+$0.12 USD Hold'em No Limit - Level XV (350/700) - 2020/12/27 22:41:20 EET [2020/12/27 15:41:20 ET]
Table '3082648141 85' 9-max Seat #9 is the button
Seat 1: jcarlos.vale (25966 in chips) 
Seat 2: woopah (62843 in chips) 
Seat 3: SleazyP84 (5516 in chips) 
Seat 4: luanabvale (13356 in chips) 
Seat 5: flushnutsAA (73174 in chips) 
Seat 6: lucas.globo (40468 in chips) 
Seat 7: 7Cassie7 (17734 in chips) 
Seat 8: $ekelfreddy$ (25661 in chips) 
Seat 9: yannicho (24065 in chips) 
jcarlos.vale: posts the ante 50
woopah: posts the ante 50
SleazyP84: posts the ante 50
luanabvale: posts the ante 50
flushnutsAA: posts the ante 50
lucas.globo: posts the ante 50
7Cassie7: posts the ante 50
$ekelfreddy$: posts the ante 50
yannicho: posts the ante 50
jcarlos.vale: posts small blind 350
woopah: posts big blind 700
*** HOLE CARDS ***
Dealt to jcarlos.vale [8h 9d]
SleazyP84: folds 
luanabvale: folds 
flushnutsAA: folds 
lucas.globo: folds 
7Cassie7: folds 
$ekelfreddy$: folds 
yannicho: raises 721 to 1421
jcarlos.vale: folds 
woopah: calls 721
*** FLOP *** [4h 4d Kd]
woopah: checks 
yannicho: bets 1202
woopah: folds 
Uncalled bet (1202) returned to yannicho
yannicho collected 3642 from pot
yannicho: doesn't show handDTO
*** SUMMARY ***
Total pot 3642 | Rake 0 
Board [4h 4d Kd]
Seat 1: jcarlos.vale (small blind) folded before Flop
Seat 2: woopah (big blind) folded on the Flop
Seat 3: SleazyP84 folded before Flop (didn't bet)
Seat 4: luanabvale folded before Flop (didn't bet)
Seat 5: flushnutsAA folded before Flop (didn't bet)
Seat 6: lucas.globo folded before Flop (didn't bet)
Seat 7: 7Cassie7 folded before Flop (didn't bet)
Seat 8: $ekelfreddy$ folded before Flop (didn't bet)
Seat 9: yannicho (button) collected (3642)



PokerStars Hand #221916690334: Tournament #3082648141, $0.98+$0.12 USD Hold'em No Limit - Level XV (350/700) - 2020/12/27 22:41:53 EET [2020/12/27 15:41:53 ET]
Table '3082648141 85' 9-max Seat #1 is the button
Seat 1: jcarlos.vale (25566 in chips) 
Seat 2: woopah (61372 in chips) 
Seat 3: SleazyP84 (5466 in chips) 
Seat 4: luanabvale (13306 in chips) 
Seat 5: flushnutsAA (73124 in chips) 
Seat 6: lucas.globo (40418 in chips) 
Seat 7: 7Cassie7 (17684 in chips) 
Seat 8: $ekelfreddy$ (25611 in chips) 
Seat 9: yannicho (26236 in chips) 
jcarlos.vale: posts the ante 50
woopah: posts the ante 50
SleazyP84: posts the ante 50
luanabvale: posts the ante 50
flushnutsAA: posts the ante 50
lucas.globo: posts the ante 50
7Cassie7: posts the ante 50
$ekelfreddy$: posts the ante 50
yannicho: posts the ante 50
woopah: posts small blind 350
SleazyP84: posts big blind 700
*** HOLE CARDS ***
Dealt to jcarlos.vale [Qs 9h]
luanabvale: raises 700 to 1400
flushnutsAA: folds 
lucas.globo: calls 1400
7Cassie7: folds 
$ekelfreddy$: folds 
yannicho: folds 
jcarlos.vale: folds 
woopah: folds 
SleazyP84: folds 
*** FLOP *** [4d 4s 9s]
luanabvale: checks 
lucas.globo: bets 2150
luanabvale: raises 9706 to 11856 and is all-in
lucas.globo: calls 9706
*** TURN *** [4d 4s 9s] [Ad]
*** RIVER *** [4d 4s 9s Ad] [Kd]
*** SHOW DOWN ***
luanabvale: shows [Td Ts] (two pair, Tens and Fours)
lucas.globo: shows [Js As] (two pair, Aces and Fours)
lucas.globo collected 28012 from pot
luanabvale finished the tournament in 938th place
*** SUMMARY ***
Total pot 28012 | Rake 0 
Board [4d 4s 9s Ad Kd]
Seat 1: jcarlos.vale (button) folded before Flop (didn't bet)
Seat 2: woopah (small blind) folded before Flop
Seat 3: SleazyP84 (big blind) folded before Flop
Seat 4: luanabvale showed [Td Ts] and lost with two pair, Tens and Fours
Seat 5: flushnutsAA folded before Flop (didn't bet)
Seat 6: lucas.globo showed [Js As] and won (28012) with two pair, Aces and Fours
Seat 7: 7Cassie7 folded before Flop (didn't bet)
Seat 8: $ekelfreddy$ folded before Flop (didn't bet)
Seat 9: yannicho folded before Flop (didn't bet)



PokerStars Hand #221916745372: Tournament #3082648141, $0.98+$0.12 USD Hold'em No Limit - Level XV (350/700) - 2020/12/27 22:42:51 EET [2020/12/27 15:42:51 ET]
Table '3082648141 85' 9-max Seat #2 is the button
Seat 1: jcarlos.vale (25516 in chips) 
Seat 2: woopah (60972 in chips) 
Seat 3: SleazyP84 (4716 in chips) 
Seat 4: mitrea1989 (20765 in chips) 
Seat 5: flushnutsAA (73074 in chips) 
Seat 6: lucas.globo (55124 in chips) 
Seat 7: 7Cassie7 (17634 in chips) 
Seat 8: $ekelfreddy$ (25561 in chips) 
Seat 9: yannicho (26186 in chips) 
jcarlos.vale: posts the ante 50
woopah: posts the ante 50
SleazyP84: posts the ante 50
mitrea1989: posts the ante 50
flushnutsAA: posts the ante 50
lucas.globo: posts the ante 50
7Cassie7: posts the ante 50
$ekelfreddy$: posts the ante 50
yannicho: posts the ante 50
SleazyP84: posts small blind 350
mitrea1989: posts big blind 700
*** HOLE CARDS ***
Dealt to jcarlos.vale [5d Ac]
flushnutsAA: folds 
lucas.globo: folds 
7Cassie7: calls 700
$ekelfreddy$: folds 
yannicho: folds 
jcarlos.vale: folds 
woopah: calls 700
SleazyP84: calls 350
mitrea1989: checks 
*** FLOP *** [6c Kd Ah]
SleazyP84: checks 
mitrea1989: checks 
7Cassie7: bets 700
woopah: folds 
SleazyP84: folds 
mitrea1989: folds 
Uncalled bet (700) returned to 7Cassie7
7Cassie7 collected 3250 from pot
*** SUMMARY ***
Total pot 3250 | Rake 0 
Board [6c Kd Ah]
Seat 1: jcarlos.vale folded before Flop (didn't bet)
Seat 2: woopah (button) folded on the Flop
Seat 3: SleazyP84 (small blind) folded on the Flop
Seat 4: mitrea1989 (big blind) folded on the Flop
Seat 5: flushnutsAA folded before Flop (didn't bet)
Seat 6: lucas.globo folded before Flop (didn't bet)
Seat 7: 7Cassie7 collected (3250)
Seat 8: $ekelfreddy$ folded before Flop (didn't bet)
Seat 9: yannicho folded before Flop (didn't bet)



PokerStars Hand #221916799135: Tournament #3082648141, $0.98+$0.12 USD Hold'em No Limit - Level XV (350/700) - 2020/12/27 22:43:47 EET [2020/12/27 15:43:47 ET]
Table '3082648141 85' 9-max Seat #3 is the button
Seat 1: jcarlos.vale (25466 in chips) 
Seat 2: woopah (60222 in chips) 
Seat 3: SleazyP84 (3966 in chips) 
Seat 4: mitrea1989 (20015 in chips) 
Seat 5: flushnutsAA (73024 in chips) 
Seat 6: lucas.globo (55074 in chips) 
Seat 7: 7Cassie7 (20134 in chips) 
Seat 8: $ekelfreddy$ (25511 in chips) 
Seat 9: yannicho (26136 in chips) 
jcarlos.vale: posts the ante 50
woopah: posts the ante 50
SleazyP84: posts the ante 50
mitrea1989: posts the ante 50
flushnutsAA: posts the ante 50
lucas.globo: posts the ante 50
7Cassie7: posts the ante 50
$ekelfreddy$: posts the ante 50
yannicho: posts the ante 50
mitrea1989: posts small blind 350
flushnutsAA: posts big blind 700
*** HOLE CARDS ***
Dealt to jcarlos.vale [7h 3s]
lucas.globo has timed out
lucas.globo: folds 
lucas.globo is sitting out
7Cassie7: raises 1400 to 2100
$ekelfreddy$: folds 
yannicho: folds 
jcarlos.vale: folds 
woopah: folds 
SleazyP84: folds 
mitrea1989: folds 
lucas.globo has returned
flushnutsAA: folds 
Uncalled bet (1400) returned to 7Cassie7
7Cassie7 collected 2200 from pot
*** SUMMARY ***
Total pot 2200 | Rake 0 
Seat 1: jcarlos.vale folded before Flop (didn't bet)
Seat 2: woopah folded before Flop (didn't bet)
Seat 3: SleazyP84 (button) folded before Flop (didn't bet)
Seat 4: mitrea1989 (small blind) folded before Flop
Seat 5: flushnutsAA (big blind) folded before Flop
Seat 6: lucas.globo folded before Flop (didn't bet)
Seat 7: 7Cassie7 collected (2200)
Seat 8: $ekelfreddy$ folded before Flop (didn't bet)
Seat 9: yannicho folded before Flop (didn't bet)



PokerStars Hand #221916837898: Tournament #3082648141, $0.98+$0.12 USD Hold'em No Limit - Level XV (350/700) - 2020/12/27 22:44:28 EET [2020/12/27 15:44:28 ET]
Table '3082648141 85' 9-max Seat #4 is the button
Seat 1: jcarlos.vale (25416 in chips) 
Seat 2: woopah (60172 in chips) 
Seat 3: SleazyP84 (3916 in chips) 
Seat 4: mitrea1989 (19615 in chips) 
Seat 5: flushnutsAA (72274 in chips) 
Seat 6: lucas.globo (55024 in chips) 
Seat 7: 7Cassie7 (21584 in chips) 
Seat 8: $ekelfreddy$ (25461 in chips) 
Seat 9: yannicho (26086 in chips) 
jcarlos.vale: posts the ante 50
woopah: posts the ante 50
SleazyP84: posts the ante 50
mitrea1989: posts the ante 50
flushnutsAA: posts the ante 50
lucas.globo: posts the ante 50
7Cassie7: posts the ante 50
$ekelfreddy$: posts the ante 50
yannicho: posts the ante 50
flushnutsAA: posts small blind 350
lucas.globo: posts big blind 700
*** HOLE CARDS ***
Dealt to jcarlos.vale [3h 2s]
7Cassie7: folds 
$ekelfreddy$: raises 1400 to 2100
yannicho: calls 2100
jcarlos.vale: folds 
woopah: folds 
SleazyP84: folds 
mitrea1989: folds 
flushnutsAA: folds 
lucas.globo: folds 
*** FLOP *** [Qc 9h 5d]
$ekelfreddy$: checks 
yannicho: checks 
*** TURN *** [Qc 9h 5d] [7s]
$ekelfreddy$: checks 
yannicho: bets 2508
$ekelfreddy$: calls 2508
*** RIVER *** [Qc 9h 5d 7s] [3s]
$ekelfreddy$: bets 5358
yannicho: calls 5358
*** SHOW DOWN ***
$ekelfreddy$: shows [7d 7c] (three of a kind, Sevens)
yannicho: mucks handDTO
$ekelfreddy$ collected 21432 from pot
*** SUMMARY ***
Total pot 21432 | Rake 0 
Board [Qc 9h 5d 7s 3s]
Seat 1: jcarlos.vale folded before Flop (didn't bet)
Seat 2: woopah folded before Flop (didn't bet)
Seat 3: SleazyP84 folded before Flop (didn't bet)
Seat 4: mitrea1989 (button) folded before Flop (didn't bet)
Seat 5: flushnutsAA (small blind) folded before Flop
Seat 6: lucas.globo (big blind) folded before Flop
Seat 7: 7Cassie7 folded before Flop (didn't bet)
Seat 8: $ekelfreddy$ showed [7d 7c] and won (21432) with three of a kind, Sevens
Seat 9: yannicho mucked [Kd Qd]



PokerStars Hand #221916878395: Tournament #3082648141, $0.98+$0.12 USD Hold'em No Limit - Level XV (350/700) - 2020/12/27 22:45:11 EET [2020/12/27 15:45:11 ET]
Table '3082648141 85' 9-max Seat #5 is the button
Seat 1: jcarlos.vale (25366 in chips) 
Seat 2: woopah (60122 in chips) 
Seat 3: SleazyP84 (3866 in chips) 
Seat 4: mitrea1989 (19565 in chips) 
Seat 5: flushnutsAA (71874 in chips) 
Seat 6: lucas.globo (54274 in chips) 
Seat 7: 7Cassie7 (21534 in chips) 
Seat 8: $ekelfreddy$ (36877 in chips) 
Seat 9: yannicho (16070 in chips) 
jcarlos.vale: posts the ante 50
woopah: posts the ante 50
SleazyP84: posts the ante 50
mitrea1989: posts the ante 50
flushnutsAA: posts the ante 50
lucas.globo: posts the ante 50
7Cassie7: posts the ante 50
$ekelfreddy$: posts the ante 50
yannicho: posts the ante 50
lucas.globo: posts small blind 350
7Cassie7: posts big blind 700
*** HOLE CARDS ***
Dealt to jcarlos.vale [8d Jc]
$ekelfreddy$: folds 
yannicho: folds 
jcarlos.vale: folds 
woopah: folds 
SleazyP84: folds 
mitrea1989: raises 700 to 1400
flushnutsAA: folds 
lucas.globo: calls 1050
7Cassie7: calls 700
*** FLOP *** [5s 7h 3d]
lucas.globo: checks 
7Cassie7: checks 
mitrea1989: checks 
*** TURN *** [5s 7h 3d] [9c]
lucas.globo: bets 2325
7Cassie7: calls 2325
mitrea1989: folds 
*** RIVER *** [5s 7h 3d 9c] [Ac]
lucas.globo: checks 
7Cassie7: checks 
*** SHOW DOWN ***
lucas.globo: shows [6c 5c] (a pair of Fives)
7Cassie7: shows [Kd 9h] (a pair of Nines)
7Cassie7 collected 9300 from pot
*** SUMMARY ***
Total pot 9300 | Rake 0 
Board [5s 7h 3d 9c Ac]
Seat 1: jcarlos.vale folded before Flop (didn't bet)
Seat 2: woopah folded before Flop (didn't bet)
Seat 3: SleazyP84 folded before Flop (didn't bet)
Seat 4: mitrea1989 folded on the Turn
Seat 5: flushnutsAA (button) folded before Flop (didn't bet)
Seat 6: lucas.globo (small blind) showed [6c 5c] and lost with a pair of Fives
Seat 7: 7Cassie7 (big blind) showed [Kd 9h] and won (9300) with a pair of Nines
Seat 8: $ekelfreddy$ folded before Flop (didn't bet)
Seat 9: yannicho folded before Flop (didn't bet)



PokerStars Hand #221916940201: Tournament #3082648141, $0.98+$0.12 USD Hold'em No Limit - Level XVI (400/800) - 2020/12/27 22:46:17 EET [2020/12/27 15:46:17 ET]
Table '3082648141 85' 9-max Seat #6 is the button
Seat 1: jcarlos.vale (25316 in chips) 
Seat 2: woopah (60072 in chips) 
Seat 3: SleazyP84 (3816 in chips) 
Seat 4: mitrea1989 (18115 in chips) 
Seat 5: flushnutsAA (71824 in chips) 
Seat 6: lucas.globo (50499 in chips) 
Seat 7: 7Cassie7 (27059 in chips) 
Seat 8: $ekelfreddy$ (36827 in chips) 
Seat 9: yannicho (16020 in chips) 
jcarlos.vale: posts the ante 65
woopah: posts the ante 65
SleazyP84: posts the ante 65
mitrea1989: posts the ante 65
flushnutsAA: posts the ante 65
lucas.globo: posts the ante 65
7Cassie7: posts the ante 65
$ekelfreddy$: posts the ante 65
yannicho: posts the ante 65
7Cassie7: posts small blind 400
$ekelfreddy$: posts big blind 800
*** HOLE CARDS ***
Dealt to jcarlos.vale [6c 3c]
yannicho: folds 
jcarlos.vale: folds 
woopah: folds 
SleazyP84: raises 2951 to 3751 and is all-in
mitrea1989: folds 
flushnutsAA: folds 
lucas.globo: folds 
7Cassie7: folds 
$ekelfreddy$: calls 2951
*** FLOP *** [Qh 6s 8c]
*** TURN *** [Qh 6s 8c] [3d]
*** RIVER *** [Qh 6s 8c 3d] [9c]
*** SHOW DOWN ***
$ekelfreddy$: shows [Th Qd] (a pair of Queens)
SleazyP84: shows [Ks Kd] (a pair of Kings)
SleazyP84 collected 8487 from pot
*** SUMMARY ***
Total pot 8487 | Rake 0 
Board [Qh 6s 8c 3d 9c]
Seat 1: jcarlos.vale folded before Flop (didn't bet)
Seat 2: woopah folded before Flop (didn't bet)
Seat 3: SleazyP84 showed [Ks Kd] and won (8487) with a pair of Kings
Seat 4: mitrea1989 folded before Flop (didn't bet)
Seat 5: flushnutsAA folded before Flop (didn't bet)
Seat 6: lucas.globo (button) folded before Flop (didn't bet)
Seat 7: 7Cassie7 (small blind) folded before Flop
Seat 8: $ekelfreddy$ (big blind) showed [Th Qd] and lost with a pair of Queens
Seat 9: yannicho folded before Flop (didn't bet)



PokerStars Hand #221916976057: Tournament #3082648141, $0.98+$0.12 USD Hold'em No Limit - Level XVI (400/800) - 2020/12/27 22:46:47 EET [2020/12/27 15:46:47 ET]
Table '3082648141 85' 9-max Seat #7 is the button
Seat 1: jcarlos.vale (25251 in chips) 
Seat 2: woopah (60007 in chips) 
Seat 3: SleazyP84 (8487 in chips) 
Seat 4: mitrea1989 (18050 in chips) 
Seat 5: flushnutsAA (71759 in chips) 
Seat 6: lucas.globo (50434 in chips) 
Seat 7: 7Cassie7 (26594 in chips) 
Seat 8: $ekelfreddy$ (33011 in chips) 
Seat 9: yannicho (15955 in chips) 
jcarlos.vale: posts the ante 65
woopah: posts the ante 65
SleazyP84: posts the ante 65
mitrea1989: posts the ante 65
flushnutsAA: posts the ante 65
lucas.globo: posts the ante 65
7Cassie7: posts the ante 65
$ekelfreddy$: posts the ante 65
yannicho: posts the ante 65
$ekelfreddy$: posts small blind 400
yannicho: posts big blind 800
*** HOLE CARDS ***
Dealt to jcarlos.vale [Js Td]
jcarlos.vale: folds 
woopah: folds 
SleazyP84: folds 
mitrea1989: folds 
flushnutsAA: folds 
lucas.globo: folds 
7Cassie7: folds 
$ekelfreddy$: calls 400
yannicho: raises 15090 to 15890 and is all-in
$ekelfreddy$: folds 
Uncalled bet (15090) returned to yannicho
yannicho collected 2185 from pot
yannicho: doesn't show handDTO
*** SUMMARY ***
Total pot 2185 | Rake 0 
Seat 1: jcarlos.vale folded before Flop (didn't bet)
Seat 2: woopah folded before Flop (didn't bet)
Seat 3: SleazyP84 folded before Flop (didn't bet)
Seat 4: mitrea1989 folded before Flop (didn't bet)
Seat 5: flushnutsAA folded before Flop (didn't bet)
Seat 6: lucas.globo folded before Flop (didn't bet)
Seat 7: 7Cassie7 (button) folded before Flop (didn't bet)
Seat 8: $ekelfreddy$ (small blind) folded before Flop
Seat 9: yannicho (big blind) collected (2185)



PokerStars Hand #221917006254: Tournament #3082648141, $0.98+$0.12 USD Hold'em No Limit - Level XVI (400/800) - 2020/12/27 22:47:19 EET [2020/12/27 15:47:19 ET]
Table '3082648141 85' 9-max Seat #8 is the button
Seat 1: jcarlos.vale (25186 in chips) 
Seat 2: woopah (59942 in chips) 
Seat 3: SleazyP84 (8422 in chips) 
Seat 4: mitrea1989 (17985 in chips) 
Seat 5: flushnutsAA (71694 in chips) 
Seat 6: lucas.globo (50369 in chips) 
Seat 7: 7Cassie7 (26529 in chips) 
Seat 8: $ekelfreddy$ (32146 in chips) 
Seat 9: yannicho (17275 in chips) 
jcarlos.vale: posts the ante 65
woopah: posts the ante 65
SleazyP84: posts the ante 65
mitrea1989: posts the ante 65
flushnutsAA: posts the ante 65
lucas.globo: posts the ante 65
7Cassie7: posts the ante 65
$ekelfreddy$: posts the ante 65
yannicho: posts the ante 65
yannicho: posts small blind 400
jcarlos.vale: posts big blind 800
*** HOLE CARDS ***
Dealt to jcarlos.vale [Ks 8c]
woopah: folds 
SleazyP84: folds 
mitrea1989: folds 
flushnutsAA: folds 
lucas.globo: folds 
7Cassie7: folds 
$ekelfreddy$: folds 
yannicho: calls 400
jcarlos.vale: checks 
*** FLOP *** [4d Kc 9c]
yannicho: bets 800
jcarlos.vale: raises 1600 to 2400
yannicho: calls 1600
*** TURN *** [4d Kc 9c] [Th]
yannicho: checks 
jcarlos.vale: bets 2400
yannicho: calls 2400
*** RIVER *** [4d Kc 9c Th] [7c]
yannicho: bets 11610 and is all-in
jcarlos.vale: folds 
Uncalled bet (11610) returned to yannicho
yannicho collected 11785 from pot
yannicho: doesn't show handDTO
*** SUMMARY ***
Total pot 11785 | Rake 0 
Board [4d Kc 9c Th 7c]
Seat 1: jcarlos.vale (big blind) folded on the River
Seat 2: woopah folded before Flop (didn't bet)
Seat 3: SleazyP84 folded before Flop (didn't bet)
Seat 4: mitrea1989 folded before Flop (didn't bet)
Seat 5: flushnutsAA folded before Flop (didn't bet)
Seat 6: lucas.globo folded before Flop (didn't bet)
Seat 7: 7Cassie7 folded before Flop (didn't bet)
Seat 8: $ekelfreddy$ (button) folded before Flop (didn't bet)
Seat 9: yannicho (small blind) collected (11785)



PokerStars Hand #221917049436: Tournament #3082648141, $0.98+$0.12 USD Hold'em No Limit - Level XVI (400/800) - 2020/12/27 22:48:05 EET [2020/12/27 15:48:05 ET]
Table '3082648141 85' 9-max Seat #9 is the button
Seat 1: jcarlos.vale (19521 in chips) 
Seat 2: woopah (59877 in chips) 
Seat 3: SleazyP84 (8357 in chips) 
Seat 4: mitrea1989 (17920 in chips) 
Seat 5: flushnutsAA (71629 in chips) 
Seat 6: lucas.globo (50304 in chips) 
Seat 7: 7Cassie7 (26464 in chips) 
Seat 8: $ekelfreddy$ (32081 in chips) 
Seat 9: yannicho (23395 in chips) 
jcarlos.vale: posts the ante 65
woopah: posts the ante 65
SleazyP84: posts the ante 65
mitrea1989: posts the ante 65
flushnutsAA: posts the ante 65
lucas.globo: posts the ante 65
7Cassie7: posts the ante 65
$ekelfreddy$: posts the ante 65
yannicho: posts the ante 65
jcarlos.vale: posts small blind 400
woopah: posts big blind 800
*** HOLE CARDS ***
Dealt to jcarlos.vale [7d 5s]
SleazyP84: folds 
mitrea1989: folds 
flushnutsAA: folds 
lucas.globo: raises 800 to 1600
7Cassie7: calls 1600
$ekelfreddy$: calls 1600
yannicho: folds 
jcarlos.vale: folds 
woopah: folds 
*** FLOP *** [9d 8h 9s]
lucas.globo: bets 800
7Cassie7: calls 800
$ekelfreddy$: folds 
*** TURN *** [9d 8h 9s] [3d]
lucas.globo: bets 2400
7Cassie7: calls 2400
*** RIVER *** [9d 8h 9s 3d] [Jd]
lucas.globo: checks 
7Cassie7: checks 
*** SHOW DOWN ***
lucas.globo: shows [Ah Ks] (a pair of Nines)
7Cassie7: shows [5c 5d] (two pair, Nines and Fives)
7Cassie7 collected 12985 from pot
*** SUMMARY ***
Total pot 12985 | Rake 0 
Board [9d 8h 9s 3d Jd]
Seat 1: jcarlos.vale (small blind) folded before Flop
Seat 2: woopah (big blind) folded before Flop
Seat 3: SleazyP84 folded before Flop (didn't bet)
Seat 4: mitrea1989 folded before Flop (didn't bet)
Seat 5: flushnutsAA folded before Flop (didn't bet)
Seat 6: lucas.globo showed [Ah Ks] and lost with a pair of Nines
Seat 7: 7Cassie7 showed [5c 5d] and won (12985) with two pair, Nines and Fives
Seat 8: $ekelfreddy$ folded on the Flop
Seat 9: yannicho (button) folded before Flop (didn't bet)



PokerStars Hand #221917108370: Tournament #3082648141, $0.98+$0.12 USD Hold'em No Limit - Level XVI (400/800) - 2020/12/27 22:49:07 EET [2020/12/27 15:49:07 ET]
Table '3082648141 85' 9-max Seat #1 is the button
Seat 1: jcarlos.vale (19056 in chips) 
Seat 2: woopah (59012 in chips) 
Seat 3: SleazyP84 (8292 in chips) 
Seat 4: mitrea1989 (17855 in chips) 
Seat 5: flushnutsAA (71564 in chips) 
Seat 6: lucas.globo (45439 in chips) 
Seat 7: 7Cassie7 (34584 in chips) 
Seat 8: $ekelfreddy$ (30416 in chips) 
Seat 9: yannicho (23330 in chips) 
jcarlos.vale: posts the ante 65
woopah: posts the ante 65
SleazyP84: posts the ante 65
mitrea1989: posts the ante 65
flushnutsAA: posts the ante 65
lucas.globo: posts the ante 65
7Cassie7: posts the ante 65
$ekelfreddy$: posts the ante 65
yannicho: posts the ante 65
woopah: posts small blind 400
SleazyP84: posts big blind 800
*** HOLE CARDS ***
Dealt to jcarlos.vale [4d 9s]
mitrea1989: folds 
flushnutsAA: folds 
lucas.globo: raises 1600 to 2400
7Cassie7: folds 
$ekelfreddy$: folds 
yannicho: folds 
jcarlos.vale: folds 
woopah: calls 2000
SleazyP84: folds 
*** FLOP *** [6d Ts 5s]
woopah: checks 
lucas.globo: bets 1600
woopah: calls 1600
*** TURN *** [6d Ts 5s] [Kd]
woopah: checks 
lucas.globo: checks 
*** RIVER *** [6d Ts 5s Kd] [2c]
woopah: bets 4505
lucas.globo: calls 4505
*** SHOW DOWN ***
woopah: shows [Ks Js] (a pair of Kings)
lucas.globo: mucks handDTO
woopah collected 18395 from pot
*** SUMMARY ***
Total pot 18395 | Rake 0 
Board [6d Ts 5s Kd 2c]
Seat 1: jcarlos.vale (button) folded before Flop (didn't bet)
Seat 2: woopah (small blind) showed [Ks Js] and won (18395) with a pair of Kings
Seat 3: SleazyP84 (big blind) folded before Flop
Seat 4: mitrea1989 folded before Flop (didn't bet)
Seat 5: flushnutsAA folded before Flop (didn't bet)
Seat 6: lucas.globo mucked [9h 9c]
Seat 7: 7Cassie7 folded before Flop (didn't bet)
Seat 8: $ekelfreddy$ folded before Flop (didn't bet)
Seat 9: yannicho folded before Flop (didn't bet)



PokerStars Hand #221917146174: Tournament #3082648141, $0.98+$0.12 USD Hold'em No Limit - Level XVI (400/800) - 2020/12/27 22:49:47 EET [2020/12/27 15:49:47 ET]
Table '3082648141 85' 9-max Seat #2 is the button
Seat 1: jcarlos.vale (18991 in chips) 
Seat 2: woopah (68837 in chips) 
Seat 3: SleazyP84 (7427 in chips) 
Seat 4: mitrea1989 (17790 in chips) 
Seat 5: flushnutsAA (71499 in chips) 
Seat 6: lucas.globo (36869 in chips) 
Seat 7: 7Cassie7 (34519 in chips) 
Seat 8: $ekelfreddy$ (30351 in chips) 
Seat 9: yannicho (23265 in chips) 
jcarlos.vale: posts the ante 65
woopah: posts the ante 65
SleazyP84: posts the ante 65
mitrea1989: posts the ante 65
flushnutsAA: posts the ante 65
lucas.globo: posts the ante 65
7Cassie7: posts the ante 65
$ekelfreddy$: posts the ante 65
yannicho: posts the ante 65
SleazyP84: posts small blind 400
mitrea1989: posts big blind 800
*** HOLE CARDS ***
Dealt to jcarlos.vale [Tc 8h]
flushnutsAA: folds 
lucas.globo: folds 
7Cassie7: folds 
$ekelfreddy$: folds 
yannicho: raises 824 to 1624
jcarlos.vale: folds 
woopah: calls 1624
SleazyP84: folds 
mitrea1989: calls 824
*** FLOP *** [Qs Jh Th]
mitrea1989: checks 
yannicho: checks 
woopah: checks 
*** TURN *** [Qs Jh Th] [Js]
mitrea1989: checks 
yannicho: checks 
woopah: checks 
*** RIVER *** [Qs Jh Th Js] [Jc]
mitrea1989: bets 2400
yannicho: calls 2400
woopah: folds 
*** SHOW DOWN ***
mitrea1989: shows [7c Qd] (a full house, Jacks full of Queens)
yannicho: mucks handDTO
mitrea1989 collected 10657 from pot
*** SUMMARY ***
Total pot 10657 | Rake 0 
Board [Qs Jh Th Js Jc]
Seat 1: jcarlos.vale folded before Flop (didn't bet)
Seat 2: woopah (button) folded on the River
Seat 3: SleazyP84 (small blind) folded before Flop
Seat 4: mitrea1989 (big blind) showed [7c Qd] and won (10657) with a full house, Jacks full of Queens
Seat 5: flushnutsAA folded before Flop (didn't bet)
Seat 6: lucas.globo folded before Flop (didn't bet)
Seat 7: 7Cassie7 folded before Flop (didn't bet)
Seat 8: $ekelfreddy$ folded before Flop (didn't bet)
Seat 9: yannicho mucked [8d 8c]



PokerStars Hand #221917210046: Tournament #3082648141, $0.98+$0.12 USD Hold'em No Limit - Level XVI (400/800) - 2020/12/27 22:50:55 EET [2020/12/27 15:50:55 ET]
Table '3082648141 85' 9-max Seat #3 is the button
Seat 1: jcarlos.vale (18926 in chips) 
Seat 2: woopah (67148 in chips) 
Seat 3: SleazyP84 (6962 in chips) 
Seat 4: mitrea1989 (24358 in chips) 
Seat 5: flushnutsAA (71434 in chips) 
Seat 6: lucas.globo (36804 in chips) 
Seat 7: 7Cassie7 (34454 in chips) 
Seat 8: $ekelfreddy$ (30286 in chips) 
Seat 9: yannicho (19176 in chips) 
jcarlos.vale: posts the ante 65
woopah: posts the ante 65
SleazyP84: posts the ante 65
mitrea1989: posts the ante 65
flushnutsAA: posts the ante 65
lucas.globo: posts the ante 65
7Cassie7: posts the ante 65
$ekelfreddy$: posts the ante 65
yannicho: posts the ante 65
mitrea1989: posts small blind 400
flushnutsAA: posts big blind 800
*** HOLE CARDS ***
Dealt to jcarlos.vale [7s 6s]
lucas.globo: calls 800
7Cassie7: folds 
$ekelfreddy$: folds 
yannicho: folds 
jcarlos.vale: calls 800
woopah: folds 
SleazyP84: folds 
mitrea1989: folds 
flushnutsAA: checks 
*** FLOP *** [8s 3d Jd]
flushnutsAA: checks 
lucas.globo: checks 
jcarlos.vale: checks 
*** TURN *** [8s 3d Jd] [Ac]
flushnutsAA: checks 
lucas.globo: bets 1693
jcarlos.vale: folds 
flushnutsAA: folds 
Uncalled bet (1693) returned to lucas.globo
lucas.globo collected 3385 from pot
lucas.globo: doesn't show handDTO
*** SUMMARY ***
Total pot 3385 | Rake 0 
Board [8s 3d Jd Ac]
Seat 1: jcarlos.vale folded on the Turn
Seat 2: woopah folded before Flop (didn't bet)
Seat 3: SleazyP84 (button) folded before Flop (didn't bet)
Seat 4: mitrea1989 (small blind) folded before Flop
Seat 5: flushnutsAA (big blind) folded on the Turn
Seat 6: lucas.globo collected (3385)
Seat 7: 7Cassie7 folded before Flop (didn't bet)
Seat 8: $ekelfreddy$ folded before Flop (didn't bet)
Seat 9: yannicho folded before Flop (didn't bet)



PokerStars Hand #221917266245: Tournament #3082648141, $0.98+$0.12 USD Hold'em No Limit - Level XVI (400/800) - 2020/12/27 22:51:55 EET [2020/12/27 15:51:55 ET]
Table '3082648141 85' 9-max Seat #4 is the button
Seat 1: jcarlos.vale (18061 in chips) 
Seat 2: woopah (67083 in chips) 
Seat 3: SleazyP84 (6897 in chips) 
Seat 4: mitrea1989 (23893 in chips) 
Seat 5: flushnutsAA (70569 in chips) 
Seat 6: lucas.globo (39324 in chips) 
Seat 7: 7Cassie7 (34389 in chips) 
Seat 8: $ekelfreddy$ (30221 in chips) 
Seat 9: yannicho (19111 in chips) 
jcarlos.vale: posts the ante 65
woopah: posts the ante 65
SleazyP84: posts the ante 65
mitrea1989: posts the ante 65
flushnutsAA: posts the ante 65
lucas.globo: posts the ante 65
7Cassie7: posts the ante 65
$ekelfreddy$: posts the ante 65
yannicho: posts the ante 65
flushnutsAA: posts small blind 400
lucas.globo: posts big blind 800
*** HOLE CARDS ***
Dealt to jcarlos.vale [5s Ts]
7Cassie7: folds 
$ekelfreddy$: folds 
yannicho: raises 824 to 1624
jcarlos.vale: folds 
woopah: folds 
SleazyP84: folds 
mitrea1989: folds 
flushnutsAA: folds 
lucas.globo: folds 
Uncalled bet (824) returned to yannicho
yannicho collected 2585 from pot
yannicho: doesn't show handDTO
*** SUMMARY ***
Total pot 2585 | Rake 0 
Seat 1: jcarlos.vale folded before Flop (didn't bet)
Seat 2: woopah folded before Flop (didn't bet)
Seat 3: SleazyP84 folded before Flop (didn't bet)
Seat 4: mitrea1989 (button) folded before Flop (didn't bet)
Seat 5: flushnutsAA (small blind) folded before Flop
Seat 6: lucas.globo (big blind) folded before Flop
Seat 7: 7Cassie7 folded before Flop (didn't bet)
Seat 8: $ekelfreddy$ folded before Flop (didn't bet)
Seat 9: yannicho collected (2585)



PokerStars Hand #221917295037: Tournament #3082648141, $0.98+$0.12 USD Hold'em No Limit - Level XVI (400/800) - 2020/12/27 22:52:26 EET [2020/12/27 15:52:26 ET]
Table '3082648141 85' 9-max Seat #5 is the button
Seat 1: jcarlos.vale (17996 in chips) 
Seat 2: woopah (67018 in chips) 
Seat 3: SleazyP84 (6832 in chips) 
Seat 4: mitrea1989 (23828 in chips) 
Seat 5: flushnutsAA (70104 in chips) 
Seat 6: lucas.globo (38459 in chips) 
Seat 7: 7Cassie7 (34324 in chips) 
Seat 8: $ekelfreddy$ (30156 in chips) 
Seat 9: yannicho (20831 in chips) 
jcarlos.vale: posts the ante 65
woopah: posts the ante 65
SleazyP84: posts the ante 65
mitrea1989: posts the ante 65
flushnutsAA: posts the ante 65
lucas.globo: posts the ante 65
7Cassie7: posts the ante 65
$ekelfreddy$: posts the ante 65
yannicho: posts the ante 65
lucas.globo: posts small blind 400
7Cassie7: posts big blind 800
*** HOLE CARDS ***
Dealt to jcarlos.vale [7d 3d]
$ekelfreddy$: folds 
yannicho: folds 
jcarlos.vale: folds 
woopah: raises 976 to 1776
SleazyP84: folds 
mitrea1989: folds 
flushnutsAA: folds 
lucas.globo: raises 1424 to 3200
7Cassie7: folds 
woopah: calls 1424
*** FLOP *** [Ad Tc As]
lucas.globo: bets 1600
woopah: calls 1600
*** TURN *** [Ad Tc As] [Kh]
lucas.globo: checks 
woopah: bets 2400
lucas.globo: folds 
Uncalled bet (2400) returned to woopah
woopah collected 10985 from pot
*** SUMMARY ***
Total pot 10985 | Rake 0 
Board [Ad Tc As Kh]
Seat 1: jcarlos.vale folded before Flop (didn't bet)
Seat 2: woopah collected (10985)
Seat 3: SleazyP84 folded before Flop (didn't bet)
Seat 4: mitrea1989 folded before Flop (didn't bet)
Seat 5: flushnutsAA (button) folded before Flop (didn't bet)
Seat 6: lucas.globo (small blind) folded on the Turn
Seat 7: 7Cassie7 (big blind) folded before Flop
Seat 8: $ekelfreddy$ folded before Flop (didn't bet)
Seat 9: yannicho folded before Flop (didn't bet)



PokerStars Hand #221917337604: Tournament #3082648141, $0.98+$0.12 USD Hold'em No Limit - Level XVI (400/800) - 2020/12/27 22:53:12 EET [2020/12/27 15:53:12 ET]
Table '3082648141 85' 9-max Seat #6 is the button
Seat 1: jcarlos.vale (17931 in chips) 
Seat 2: woopah (73138 in chips) 
Seat 3: SleazyP84 (6767 in chips) 
Seat 4: mitrea1989 (23763 in chips) 
Seat 5: flushnutsAA (70039 in chips) 
Seat 6: lucas.globo (33594 in chips) 
Seat 7: 7Cassie7 (33459 in chips) 
Seat 8: $ekelfreddy$ (30091 in chips) 
Seat 9: yannicho (20766 in chips) 
jcarlos.vale: posts the ante 65
woopah: posts the ante 65
SleazyP84: posts the ante 65
mitrea1989: posts the ante 65
flushnutsAA: posts the ante 65
lucas.globo: posts the ante 65
7Cassie7: posts the ante 65
$ekelfreddy$: posts the ante 65
yannicho: posts the ante 65
7Cassie7: posts small blind 400
$ekelfreddy$: posts big blind 800
*** HOLE CARDS ***
Dealt to jcarlos.vale [2s 8s]
yannicho: folds 
jcarlos.vale: folds 
woopah: folds 
SleazyP84: folds 
mitrea1989: folds 
flushnutsAA: raises 800 to 1600
lucas.globo: folds 
7Cassie7: folds 
$ekelfreddy$: calls 800
*** FLOP *** [3h 7d As]
$ekelfreddy$: checks 
flushnutsAA: bets 1507
$ekelfreddy$: calls 1507
*** TURN *** [3h 7d As] [Qd]
$ekelfreddy$: checks 
flushnutsAA: bets 4536
$ekelfreddy$: raises 16271 to 20807
flushnutsAA: folds 
Uncalled bet (16271) returned to $ekelfreddy$
$ekelfreddy$ collected 16271 from pot
$ekelfreddy$: doesn't show handDTO
*** SUMMARY ***
Total pot 16271 | Rake 0 
Board [3h 7d As Qd]
Seat 1: jcarlos.vale folded before Flop (didn't bet)
Seat 2: woopah folded before Flop (didn't bet)
Seat 3: SleazyP84 folded before Flop (didn't bet)
Seat 4: mitrea1989 folded before Flop (didn't bet)
Seat 5: flushnutsAA folded on the Turn
Seat 6: lucas.globo (button) folded before Flop (didn't bet)
Seat 7: 7Cassie7 (small blind) folded before Flop
Seat 8: $ekelfreddy$ (big blind) collected (16271)
Seat 9: yannicho folded before Flop (didn't bet)



PokerStars Hand #221917395226: Tournament #3082648141, $0.98+$0.12 USD Hold'em No Limit - Level XVI (400/800) - 2020/12/27 22:54:14 EET [2020/12/27 15:54:14 ET]
Table '3082648141 85' 9-max Seat #7 is the button
Seat 1: jcarlos.vale (17866 in chips) 
Seat 2: woopah (73073 in chips) 
Seat 3: SleazyP84 (6702 in chips) 
Seat 4: mitrea1989 (23698 in chips) 
Seat 5: flushnutsAA (62331 in chips) 
Seat 6: lucas.globo (33529 in chips) 
Seat 7: 7Cassie7 (32994 in chips) 
Seat 8: $ekelfreddy$ (38654 in chips) 
Seat 9: yannicho (20701 in chips) 
jcarlos.vale: posts the ante 65
woopah: posts the ante 65
SleazyP84: posts the ante 65
mitrea1989: posts the ante 65
flushnutsAA: posts the ante 65
lucas.globo: posts the ante 65
7Cassie7: posts the ante 65
$ekelfreddy$: posts the ante 65
yannicho: posts the ante 65
$ekelfreddy$: posts small blind 400
yannicho: posts big blind 800
*** HOLE CARDS ***
Dealt to jcarlos.vale [5c Jh]
jcarlos.vale: folds 
woopah: folds 
SleazyP84: raises 5837 to 6637 and is all-in
mitrea1989: folds 
flushnutsAA: folds 
lucas.globo: folds 
7Cassie7: folds 
$ekelfreddy$: folds 
yannicho: folds 
Uncalled bet (5837) returned to SleazyP84
SleazyP84 collected 2585 from pot
SleazyP84: doesn't show handDTO
*** SUMMARY ***
Total pot 2585 | Rake 0 
Seat 1: jcarlos.vale folded before Flop (didn't bet)
Seat 2: woopah folded before Flop (didn't bet)
Seat 3: SleazyP84 collected (2585)
Seat 4: mitrea1989 folded before Flop (didn't bet)
Seat 5: flushnutsAA folded before Flop (didn't bet)
Seat 6: lucas.globo folded before Flop (didn't bet)
Seat 7: 7Cassie7 (button) folded before Flop (didn't bet)
Seat 8: $ekelfreddy$ (small blind) folded before Flop
Seat 9: yannicho (big blind) folded before Flop



PokerStars Hand #221917420774: Tournament #3082648141, $0.98+$0.12 USD Hold'em No Limit - Level XVI (400/800) - 2020/12/27 22:54:41 EET [2020/12/27 15:54:41 ET]
Table '3082648141 85' 9-max Seat #8 is the button
Seat 1: jcarlos.vale (17801 in chips) 
Seat 2: woopah (73008 in chips) 
Seat 3: SleazyP84 (8422 in chips) 
Seat 4: mitrea1989 (23633 in chips) 
Seat 5: flushnutsAA (62266 in chips) 
Seat 6: lucas.globo (33464 in chips) 
Seat 7: 7Cassie7 (32929 in chips) 
Seat 8: $ekelfreddy$ (38189 in chips) 
Seat 9: yannicho (19836 in chips) 
jcarlos.vale: posts the ante 65
woopah: posts the ante 65
SleazyP84: posts the ante 65
mitrea1989: posts the ante 65
flushnutsAA: posts the ante 65
lucas.globo: posts the ante 65
7Cassie7: posts the ante 65
$ekelfreddy$: posts the ante 65
yannicho: posts the ante 65
yannicho: posts small blind 400
jcarlos.vale: posts big blind 800
*** HOLE CARDS ***
Dealt to jcarlos.vale [Ad Ah]
woopah: folds 
SleazyP84: folds 
mitrea1989: folds 
flushnutsAA: folds 
lucas.globo has timed out
lucas.globo: folds 
lucas.globo is sitting out
7Cassie7: calls 800
$ekelfreddy$: folds 
yannicho: calls 400
jcarlos.vale: raises 2400 to 3200
lucas.globo has returned
7Cassie7: calls 2400
yannicho: folds 
*** FLOP *** [Td Qc Ac]
jcarlos.vale: bets 5839
7Cassie7: calls 5839
*** TURN *** [Td Qc Ac] [3s]
jcarlos.vale: bets 8697 and is all-in
7Cassie7: calls 8697
*** RIVER *** [Td Qc Ac 3s] [4s]
*** SHOW DOWN ***
jcarlos.vale: shows [Ad Ah] (three of a kind, Aces)
7Cassie7: shows [4d As] (two pair, Aces and Fours)
jcarlos.vale collected 36857 from pot
*** SUMMARY ***
Total pot 36857 | Rake 0 
Board [Td Qc Ac 3s 4s]
Seat 1: jcarlos.vale (big blind) showed [Ad Ah] and won (36857) with three of a kind, Aces
Seat 2: woopah folded before Flop (didn't bet)
Seat 3: SleazyP84 folded before Flop (didn't bet)
Seat 4: mitrea1989 folded before Flop (didn't bet)
Seat 5: flushnutsAA folded before Flop (didn't bet)
Seat 6: lucas.globo folded before Flop (didn't bet)
Seat 7: 7Cassie7 showed [4d As] and lost with two pair, Aces and Fours
Seat 8: $ekelfreddy$ (button) folded before Flop (didn't bet)
Seat 9: yannicho (small blind) folded before Flop



PokerStars Hand #221917669820: Tournament #3082648141, $0.98+$0.12 USD Hold'em No Limit - Level XVI (400/800) - 2020/12/27 23:01:34 EET [2020/12/27 16:01:34 ET]
Table '3082648141 85' 9-max Seat #9 is the button
Seat 1: jcarlos.vale (36857 in chips) 
Seat 2: woopah (72943 in chips) 
Seat 3: SleazyP84 (8357 in chips) 
Seat 4: mitrea1989 (23568 in chips) 
Seat 5: flushnutsAA (62201 in chips) 
Seat 6: lucas.globo (33399 in chips) 
Seat 7: 7Cassie7 (15128 in chips) 
Seat 8: $ekelfreddy$ (38124 in chips) 
Seat 9: yannicho (18971 in chips) 
jcarlos.vale: posts the ante 65
woopah: posts the ante 65
SleazyP84: posts the ante 65
mitrea1989: posts the ante 65
flushnutsAA: posts the ante 65
lucas.globo: posts the ante 65
7Cassie7: posts the ante 65
$ekelfreddy$: posts the ante 65
yannicho: posts the ante 65
jcarlos.vale: posts small blind 400
woopah: posts big blind 800
*** HOLE CARDS ***
Dealt to jcarlos.vale [3d 5c]
SleazyP84: folds 
mitrea1989: calls 800
flushnutsAA: calls 800
lucas.globo: calls 800
7Cassie7: calls 800
$ekelfreddy$: folds 
yannicho: folds 
jcarlos.vale: calls 400
woopah: checks 
*** FLOP *** [Kc Qc 9c]
jcarlos.vale: checks 
woopah: checks 
mitrea1989: bets 1777
flushnutsAA: folds 
lucas.globo: folds 
7Cassie7: folds 
jcarlos.vale: folds 
woopah: folds 
Uncalled bet (1777) returned to mitrea1989
mitrea1989 collected 5385 from pot
mitrea1989: doesn't show handDTO
*** SUMMARY ***
Total pot 5385 | Rake 0 
Board [Kc Qc 9c]
Seat 1: jcarlos.vale (small blind) folded on the Flop
Seat 2: woopah (big blind) folded on the Flop
Seat 3: SleazyP84 folded before Flop (didn't bet)
Seat 4: mitrea1989 collected (5385)
Seat 5: flushnutsAA folded on the Flop
Seat 6: lucas.globo folded on the Flop
Seat 7: 7Cassie7 folded on the Flop
Seat 8: $ekelfreddy$ folded before Flop (didn't bet)
Seat 9: yannicho (button) folded before Flop (didn't bet)



PokerStars Hand #221917728857: Tournament #3082648141, $0.98+$0.12 USD Hold'em No Limit - Level XVII (500/1000) - 2020/12/27 23:02:50 EET [2020/12/27 16:02:50 ET]
Table '3082648141 85' 9-max Seat #1 is the button
Seat 1: jcarlos.vale (35992 in chips) 
Seat 2: woopah (72078 in chips) 
Seat 3: SleazyP84 (8292 in chips) 
Seat 4: mitrea1989 (28088 in chips) 
Seat 5: flushnutsAA (61336 in chips) 
Seat 6: lucas.globo (32534 in chips) 
Seat 7: 7Cassie7 (14263 in chips) 
Seat 8: $ekelfreddy$ (38059 in chips) 
Seat 9: yannicho (18906 in chips) 
jcarlos.vale: posts the ante 75
woopah: posts the ante 75
SleazyP84: posts the ante 75
mitrea1989: posts the ante 75
flushnutsAA: posts the ante 75
lucas.globo: posts the ante 75
7Cassie7: posts the ante 75
$ekelfreddy$: posts the ante 75
yannicho: posts the ante 75
woopah: posts small blind 500
SleazyP84: posts big blind 1000
*** HOLE CARDS ***
Dealt to jcarlos.vale [Ah 5s]
mitrea1989: folds 
flushnutsAA: folds 
lucas.globo: folds 
7Cassie7: folds 
$ekelfreddy$: folds 
yannicho: folds 
jcarlos.vale: raises 1600 to 2600
woopah: raises 4400 to 7000
SleazyP84: folds 
jcarlos.vale: folds 
Uncalled bet (4400) returned to woopah
woopah collected 6875 from pot
*** SUMMARY ***
Total pot 6875 | Rake 0 
Seat 1: jcarlos.vale (button) folded before Flop
Seat 2: woopah (small blind) collected (6875)
Seat 3: SleazyP84 (big blind) folded before Flop
Seat 4: mitrea1989 folded before Flop (didn't bet)
Seat 5: flushnutsAA folded before Flop (didn't bet)
Seat 6: lucas.globo folded before Flop (didn't bet)
Seat 7: 7Cassie7 folded before Flop (didn't bet)
Seat 8: $ekelfreddy$ folded before Flop (didn't bet)
Seat 9: yannicho folded before Flop (didn't bet)



PokerStars Hand #221917824067: Tournament #3082648141, $0.98+$0.12 USD Hold'em No Limit - Level XVII (500/1000) - 2020/12/27 23:04:35 EET [2020/12/27 16:04:35 ET]
Table '3082648141 85' 9-max Seat #2 is the button
Seat 1: jcarlos.vale (33317 in chips) 
Seat 2: woopah (76278 in chips) 
Seat 3: SleazyP84 (7217 in chips) 
Seat 4: mitrea1989 (28013 in chips) 
Seat 5: flushnutsAA (61261 in chips) 
Seat 6: lucas.globo (32459 in chips) 
Seat 7: 7Cassie7 (14188 in chips) 
Seat 8: $ekelfreddy$ (37984 in chips) 
Seat 9: yannicho (18831 in chips) 
jcarlos.vale: posts the ante 75
woopah: posts the ante 75
SleazyP84: posts the ante 75
mitrea1989: posts the ante 75
flushnutsAA: posts the ante 75
lucas.globo: posts the ante 75
7Cassie7: posts the ante 75
$ekelfreddy$: posts the ante 75
yannicho: posts the ante 75
SleazyP84: posts small blind 500
mitrea1989: posts big blind 1000
*** HOLE CARDS ***
Dealt to jcarlos.vale [4d 9d]
flushnutsAA: folds 
lucas.globo: folds 
7Cassie7: folds 
$ekelfreddy$: folds 
yannicho: folds 
jcarlos.vale: folds 
woopah: folds 
SleazyP84: raises 6142 to 7142 and is all-in
mitrea1989: folds 
Uncalled bet (6142) returned to SleazyP84
SleazyP84 collected 2675 from pot
SleazyP84: doesn't show handDTO
*** SUMMARY ***
Total pot 2675 | Rake 0 
Seat 1: jcarlos.vale folded before Flop (didn't bet)
Seat 2: woopah (button) folded before Flop (didn't bet)
Seat 3: SleazyP84 (small blind) collected (2675)
Seat 4: mitrea1989 (big blind) folded before Flop
Seat 5: flushnutsAA folded before Flop (didn't bet)
Seat 6: lucas.globo folded before Flop (didn't bet)
Seat 7: 7Cassie7 folded before Flop (didn't bet)
Seat 8: $ekelfreddy$ folded before Flop (didn't bet)
Seat 9: yannicho folded before Flop (didn't bet)



PokerStars Hand #221917863034: Tournament #3082648141, $0.98+$0.12 USD Hold'em No Limit - Level XVII (500/1000) - 2020/12/27 23:05:17 EET [2020/12/27 16:05:17 ET]
Table '3082648141 85' 9-max Seat #3 is the button
Seat 1: jcarlos.vale (33242 in chips) 
Seat 2: woopah (76203 in chips) 
Seat 3: SleazyP84 (8817 in chips) 
Seat 4: mitrea1989 (26938 in chips) 
Seat 5: flushnutsAA (61186 in chips) 
Seat 6: lucas.globo (32384 in chips) 
Seat 7: 7Cassie7 (14113 in chips) 
Seat 8: $ekelfreddy$ (37909 in chips) 
Seat 9: yannicho (18756 in chips) 
jcarlos.vale: posts the ante 75
woopah: posts the ante 75
SleazyP84: posts the ante 75
mitrea1989: posts the ante 75
flushnutsAA: posts the ante 75
lucas.globo: posts the ante 75
7Cassie7: posts the ante 75
$ekelfreddy$: posts the ante 75
yannicho: posts the ante 75
mitrea1989: posts small blind 500
flushnutsAA: posts big blind 1000
*** HOLE CARDS ***
Dealt to jcarlos.vale [8d 7h]
lucas.globo: folds 
7Cassie7: calls 1000
$ekelfreddy$: folds 
yannicho: folds 
jcarlos.vale: folds 
woopah: folds 
SleazyP84: folds 
mitrea1989: calls 500
flushnutsAA: checks 
*** FLOP *** [6s 9s 7c]
mitrea1989: checks 
flushnutsAA: checks 
7Cassie7: bets 3000
mitrea1989: folds 
flushnutsAA: raises 57111 to 60111 and is all-in
7Cassie7: calls 10038 and is all-in
Uncalled bet (47073) returned to flushnutsAA
*** TURN *** [6s 9s 7c] [5h]
*** RIVER *** [6s 9s 7c 5h] [Qh]
*** SHOW DOWN ***
flushnutsAA: shows [Ks 3s] (high pairOfCards King)
7Cassie7: shows [9c As] (a pair of Nines)
7Cassie7 collected 29751 from pot
*** SUMMARY ***
Total pot 29751 | Rake 0 
Board [6s 9s 7c 5h Qh]
Seat 1: jcarlos.vale folded before Flop (didn't bet)
Seat 2: woopah folded before Flop (didn't bet)
Seat 3: SleazyP84 (button) folded before Flop (didn't bet)
Seat 4: mitrea1989 (small blind) folded on the Flop
Seat 5: flushnutsAA (big blind) showed [Ks 3s] and lost with high pairOfCards King
Seat 6: lucas.globo folded before Flop (didn't bet)
Seat 7: 7Cassie7 showed [9c As] and won (29751) with a pair of Nines
Seat 8: $ekelfreddy$ folded before Flop (didn't bet)
Seat 9: yannicho folded before Flop (didn't bet)



PokerStars Hand #221917940123: Tournament #3082648141, $0.98+$0.12 USD Hold'em No Limit - Level XVII (500/1000) - 2020/12/27 23:06:41 EET [2020/12/27 16:06:41 ET]
Table '3082648141 85' 9-max Seat #4 is the button
Seat 1: jcarlos.vale (33167 in chips) 
Seat 2: woopah (76128 in chips) 
Seat 4: mitrea1989 (25863 in chips) 
Seat 5: flushnutsAA (47073 in chips) 
Seat 6: lucas.globo (32309 in chips) 
Seat 7: 7Cassie7 (29751 in chips) 
Seat 8: $ekelfreddy$ (37834 in chips) 
Seat 9: yannicho (18681 in chips) 
jcarlos.vale: posts the ante 75
woopah: posts the ante 75
mitrea1989: posts the ante 75
flushnutsAA: posts the ante 75
lucas.globo: posts the ante 75
7Cassie7: posts the ante 75
$ekelfreddy$: posts the ante 75
yannicho: posts the ante 75
flushnutsAA: posts small blind 500
lucas.globo: posts big blind 1000
*** HOLE CARDS ***
Dealt to jcarlos.vale [7d As]
7Cassie7: folds 
$ekelfreddy$: folds 
yannicho: folds 
jcarlos.vale: raises 1600 to 2600
woopah: folds 
mitrea1989: folds 
flushnutsAA: folds 
lucas.globo: calls 1600
*** FLOP *** [6c 4c 5s]
lucas.globo: checks 
jcarlos.vale: checks 
*** TURN *** [6c 4c 5s] [Jc]
lucas.globo: checks 
jcarlos.vale: checks 
*** RIVER *** [6c 4c 5s Jc] [5h]
lucas.globo: bets 3150
jcarlos.vale: folds 
Uncalled bet (3150) returned to lucas.globo
lucas.globo collected 6300 from pot
lucas.globo: doesn't show handDTO
*** SUMMARY ***
Total pot 6300 | Rake 0 
Board [6c 4c 5s Jc 5h]
Seat 1: jcarlos.vale folded on the River
Seat 2: woopah folded before Flop (didn't bet)
Seat 4: mitrea1989 (button) folded before Flop (didn't bet)
Seat 5: flushnutsAA (small blind) folded before Flop
Seat 6: lucas.globo (big blind) collected (6300)
Seat 7: 7Cassie7 folded before Flop (didn't bet)
Seat 8: $ekelfreddy$ folded before Flop (didn't bet)
Seat 9: yannicho folded before Flop (didn't bet)



PokerStars Hand #221917995234: Tournament #3082648141, $0.98+$0.12 USD Hold'em No Limit - Level XVII (500/1000) - 2020/12/27 23:07:39 EET [2020/12/27 16:07:39 ET]
Table '3082648141 85' 9-max Seat #5 is the button
Seat 1: jcarlos.vale (30492 in chips) 
Seat 2: woopah (76053 in chips) 
Seat 3: WASP-104b (17803 in chips) 
Seat 4: mitrea1989 (25788 in chips) 
Seat 5: flushnutsAA (46498 in chips) 
Seat 6: lucas.globo (35934 in chips) 
Seat 7: 7Cassie7 (29676 in chips) 
Seat 8: $ekelfreddy$ (37759 in chips) 
Seat 9: yannicho (18606 in chips) 
jcarlos.vale: posts the ante 75
woopah: posts the ante 75
WASP-104b: posts the ante 75
mitrea1989: posts the ante 75
flushnutsAA: posts the ante 75
lucas.globo: posts the ante 75
7Cassie7: posts the ante 75
$ekelfreddy$: posts the ante 75
yannicho: posts the ante 75
lucas.globo: posts small blind 500
7Cassie7: posts big blind 1000
*** HOLE CARDS ***
Dealt to jcarlos.vale [6h 6c]
$ekelfreddy$: folds 
yannicho: folds 
jcarlos.vale: raises 1600 to 2600
woopah: folds 
WASP-104b: folds 
mitrea1989: folds 
flushnutsAA: folds 
lucas.globo: folds 
7Cassie7: folds 
Uncalled bet (1600) returned to jcarlos.vale
jcarlos.vale collected 3175 from pot
jcarlos.vale: doesn't show handDTO
*** SUMMARY ***
Total pot 3175 | Rake 0 
Seat 1: jcarlos.vale collected (3175)
Seat 2: woopah folded before Flop (didn't bet)
Seat 3: WASP-104b folded before Flop (didn't bet)
Seat 4: mitrea1989 folded before Flop (didn't bet)
Seat 5: flushnutsAA (button) folded before Flop (didn't bet)
Seat 6: lucas.globo (small blind) folded before Flop
Seat 7: 7Cassie7 (big blind) folded before Flop
Seat 8: $ekelfreddy$ folded before Flop (didn't bet)
Seat 9: yannicho folded before Flop (didn't bet)



PokerStars Hand #221918022933: Tournament #3082648141, $0.98+$0.12 USD Hold'em No Limit - Level XVII (500/1000) - 2020/12/27 23:08:09 EET [2020/12/27 16:08:09 ET]
Table '3082648141 85' 9-max Seat #6 is the button
Seat 1: jcarlos.vale (32592 in chips) 
Seat 2: woopah (75978 in chips) 
Seat 3: WASP-104b (17728 in chips) 
Seat 4: mitrea1989 (25713 in chips) 
Seat 5: flushnutsAA (46423 in chips) 
Seat 6: lucas.globo (35359 in chips) 
Seat 7: 7Cassie7 (28601 in chips) 
Seat 8: $ekelfreddy$ (37684 in chips) 
Seat 9: yannicho (18531 in chips) 
jcarlos.vale: posts the ante 75
woopah: posts the ante 75
WASP-104b: posts the ante 75
mitrea1989: posts the ante 75
flushnutsAA: posts the ante 75
lucas.globo: posts the ante 75
7Cassie7: posts the ante 75
$ekelfreddy$: posts the ante 75
yannicho: posts the ante 75
7Cassie7: posts small blind 500
$ekelfreddy$: posts big blind 1000
*** HOLE CARDS ***
Dealt to jcarlos.vale [Jh Ts]
yannicho: raises 1030 to 2030
jcarlos.vale: folds 
woopah: folds 
WASP-104b: folds 
mitrea1989: folds 
flushnutsAA: calls 2030
lucas.globo: calls 2030
7Cassie7: folds 
$ekelfreddy$: calls 1030
*** FLOP *** [7c 9s Qc]
$ekelfreddy$: checks 
yannicho: checks 
flushnutsAA: bets 4833
lucas.globo: folds 
$ekelfreddy$: folds 
yannicho: folds 
Uncalled bet (4833) returned to flushnutsAA
flushnutsAA collected 9295 from pot
flushnutsAA: doesn't show handDTO
*** SUMMARY ***
Total pot 9295 | Rake 0 
Board [7c 9s Qc]
Seat 1: jcarlos.vale folded before Flop (didn't bet)
Seat 2: woopah folded before Flop (didn't bet)
Seat 3: WASP-104b folded before Flop (didn't bet)
Seat 4: mitrea1989 folded before Flop (didn't bet)
Seat 5: flushnutsAA collected (9295)
Seat 6: lucas.globo (button) folded on the Flop
Seat 7: 7Cassie7 (small blind) folded before Flop
Seat 8: $ekelfreddy$ (big blind) folded on the Flop
Seat 9: yannicho folded on the Flop



PokerStars Hand #221918071885: Tournament #3082648141, $0.98+$0.12 USD Hold'em No Limit - Level XVII (500/1000) - 2020/12/27 23:09:01 EET [2020/12/27 16:09:01 ET]
Table '3082648141 85' 9-max Seat #7 is the button
Seat 1: jcarlos.vale (32517 in chips) 
Seat 2: woopah (75903 in chips) 
Seat 3: WASP-104b (17653 in chips) 
Seat 4: mitrea1989 (25638 in chips) 
Seat 5: flushnutsAA (53613 in chips) 
Seat 6: lucas.globo (33254 in chips) 
Seat 7: 7Cassie7 (28026 in chips) 
Seat 8: $ekelfreddy$ (35579 in chips) 
Seat 9: yannicho (16426 in chips) 
jcarlos.vale: posts the ante 75
woopah: posts the ante 75
WASP-104b: posts the ante 75
mitrea1989: posts the ante 75
flushnutsAA: posts the ante 75
lucas.globo: posts the ante 75
7Cassie7: posts the ante 75
$ekelfreddy$: posts the ante 75
yannicho: posts the ante 75
$ekelfreddy$: posts small blind 500
yannicho: posts big blind 1000
*** HOLE CARDS ***
Dealt to jcarlos.vale [5s 2c]
jcarlos.vale: folds 
woopah: raises 1550 to 2550
WASP-104b: folds 
mitrea1989: folds 
flushnutsAA: folds 
lucas.globo: folds 
7Cassie7: folds 
$ekelfreddy$: folds 
yannicho: calls 1550
*** FLOP *** [Qd Ad Th]
yannicho: checks 
woopah: bets 2071
yannicho: raises 11730 to 13801 and is all-in
woopah: folds 
Uncalled bet (11730) returned to yannicho
yannicho collected 10417 from pot
yannicho: doesn't show handDTO
*** SUMMARY ***
Total pot 10417 | Rake 0 
Board [Qd Ad Th]
Seat 1: jcarlos.vale folded before Flop (didn't bet)
Seat 2: woopah folded on the Flop
Seat 3: WASP-104b folded before Flop (didn't bet)
Seat 4: mitrea1989 folded before Flop (didn't bet)
Seat 5: flushnutsAA folded before Flop (didn't bet)
Seat 6: lucas.globo folded before Flop (didn't bet)
Seat 7: 7Cassie7 (button) folded before Flop (didn't bet)
Seat 8: $ekelfreddy$ (small blind) folded before Flop
Seat 9: yannicho (big blind) collected (10417)



PokerStars Hand #221918139857: Tournament #3082648141, $0.98+$0.12 USD Hold'em No Limit - Level XVII (500/1000) - 2020/12/27 23:10:15 EET [2020/12/27 16:10:15 ET]
Table '3082648141 85' 9-max Seat #8 is the button
Seat 1: jcarlos.vale (32442 in chips) 
Seat 2: woopah (71207 in chips) 
Seat 3: WASP-104b (17578 in chips) 
Seat 4: mitrea1989 (25563 in chips) 
Seat 5: flushnutsAA (53538 in chips) 
Seat 6: lucas.globo (33179 in chips) 
Seat 7: 7Cassie7 (27951 in chips) 
Seat 8: $ekelfreddy$ (35004 in chips) 
Seat 9: yannicho (22147 in chips) 
jcarlos.vale: posts the ante 75
woopah: posts the ante 75
WASP-104b: posts the ante 75
mitrea1989: posts the ante 75
flushnutsAA: posts the ante 75
lucas.globo: posts the ante 75
7Cassie7: posts the ante 75
$ekelfreddy$: posts the ante 75
yannicho: posts the ante 75
yannicho: posts small blind 500
jcarlos.vale: posts big blind 1000
*** HOLE CARDS ***
Dealt to jcarlos.vale [Qs 2s]
woopah: raises 1220 to 2220
WASP-104b: folds 
mitrea1989: folds 
flushnutsAA: folds 
lucas.globo: folds 
7Cassie7: folds 
$ekelfreddy$: folds 
yannicho: calls 1720
jcarlos.vale: folds 
*** FLOP *** [Ts 8d 5h]
yannicho: checks 
woopah: bets 2018
yannicho: folds 
Uncalled bet (2018) returned to woopah
woopah collected 6115 from pot
*** SUMMARY ***
Total pot 6115 | Rake 0 
Board [Ts 8d 5h]
Seat 1: jcarlos.vale (big blind) folded before Flop
Seat 2: woopah collected (6115)
Seat 3: WASP-104b folded before Flop (didn't bet)
Seat 4: mitrea1989 folded before Flop (didn't bet)
Seat 5: flushnutsAA folded before Flop (didn't bet)
Seat 6: lucas.globo folded before Flop (didn't bet)
Seat 7: 7Cassie7 folded before Flop (didn't bet)
Seat 8: $ekelfreddy$ (button) folded before Flop (didn't bet)
Seat 9: yannicho (small blind) folded on the Flop



PokerStars Hand #221918166465: Tournament #3082648141, $0.98+$0.12 USD Hold'em No Limit - Level XVII (500/1000) - 2020/12/27 23:10:44 EET [2020/12/27 16:10:44 ET]
Table '3082648141 85' 9-max Seat #9 is the button
Seat 1: jcarlos.vale (31367 in chips) 
Seat 2: woopah (75027 in chips) 
Seat 3: WASP-104b (17503 in chips) 
Seat 4: mitrea1989 (25488 in chips) 
Seat 5: flushnutsAA (53463 in chips) 
Seat 6: lucas.globo (33104 in chips) 
Seat 7: 7Cassie7 (27876 in chips) 
Seat 8: $ekelfreddy$ (34929 in chips) 
Seat 9: yannicho (19852 in chips) 
jcarlos.vale: posts the ante 75
woopah: posts the ante 75
WASP-104b: posts the ante 75
mitrea1989: posts the ante 75
flushnutsAA: posts the ante 75
lucas.globo: posts the ante 75
7Cassie7: posts the ante 75
$ekelfreddy$: posts the ante 75
yannicho: posts the ante 75
jcarlos.vale: posts small blind 500
woopah: posts big blind 1000
*** HOLE CARDS ***
Dealt to jcarlos.vale [5d Td]
WASP-104b: folds 
mitrea1989: folds 
flushnutsAA: folds 
lucas.globo: raises 2000 to 3000
7Cassie7: folds 
$ekelfreddy$: folds 
yannicho: folds 
jcarlos.vale: folds 
woopah: folds 
Uncalled bet (2000) returned to lucas.globo
lucas.globo collected 3175 from pot
lucas.globo: doesn't show handDTO
*** SUMMARY ***
Total pot 3175 | Rake 0 
Seat 1: jcarlos.vale (small blind) folded before Flop
Seat 2: woopah (big blind) folded before Flop
Seat 3: WASP-104b folded before Flop (didn't bet)
Seat 4: mitrea1989 folded before Flop (didn't bet)
Seat 5: flushnutsAA folded before Flop (didn't bet)
Seat 6: lucas.globo collected (3175)
Seat 7: 7Cassie7 folded before Flop (didn't bet)
Seat 8: $ekelfreddy$ folded before Flop (didn't bet)
Seat 9: yannicho (button) folded before Flop (didn't bet)



PokerStars Hand #221918189646: Tournament #3082648141, $0.98+$0.12 USD Hold'em No Limit - Level XVII (500/1000) - 2020/12/27 23:11:08 EET [2020/12/27 16:11:08 ET]
Table '3082648141 85' 9-max Seat #1 is the button
Seat 1: jcarlos.vale (30792 in chips) 
Seat 2: woopah (73952 in chips) 
Seat 3: WASP-104b (17428 in chips) 
Seat 4: mitrea1989 (25413 in chips) 
Seat 5: flushnutsAA (53388 in chips) 
Seat 6: lucas.globo (35204 in chips) 
Seat 7: 7Cassie7 (27801 in chips) 
Seat 8: $ekelfreddy$ (34854 in chips) 
Seat 9: yannicho (19777 in chips) 
jcarlos.vale: posts the ante 75
woopah: posts the ante 75
WASP-104b: posts the ante 75
mitrea1989: posts the ante 75
flushnutsAA: posts the ante 75
lucas.globo: posts the ante 75
7Cassie7: posts the ante 75
$ekelfreddy$: posts the ante 75
yannicho: posts the ante 75
woopah: posts small blind 500
WASP-104b: posts big blind 1000
*** HOLE CARDS ***
Dealt to jcarlos.vale [8c 7s]
mitrea1989: folds 
flushnutsAA: folds 
lucas.globo: folds 
7Cassie7: folds 
$ekelfreddy$: folds 
yannicho: folds 
jcarlos.vale: folds 
woopah: folds 
Uncalled bet (500) returned to WASP-104b
WASP-104b collected 1675 from pot
WASP-104b: doesn't show handDTO
*** SUMMARY ***
Total pot 1675 | Rake 0 
Seat 1: jcarlos.vale (button) folded before Flop (didn't bet)
Seat 2: woopah (small blind) folded before Flop
Seat 3: WASP-104b (big blind) collected (1675)
Seat 4: mitrea1989 folded before Flop (didn't bet)
Seat 5: flushnutsAA folded before Flop (didn't bet)
Seat 6: lucas.globo folded before Flop (didn't bet)
Seat 7: 7Cassie7 folded before Flop (didn't bet)
Seat 8: $ekelfreddy$ folded before Flop (didn't bet)
Seat 9: yannicho folded before Flop (didn't bet)



PokerStars Hand #221918211771: Tournament #3082648141, $0.98+$0.12 USD Hold'em No Limit - Level XVII (500/1000) - 2020/12/27 23:11:25 EET [2020/12/27 16:11:25 ET]
Table '3082648141 85' 9-max Seat #2 is the button
Seat 1: jcarlos.vale (30717 in chips) 
Seat 2: woopah (73377 in chips) 
Seat 3: WASP-104b (18528 in chips) 
Seat 4: mitrea1989 (25338 in chips) 
Seat 5: flushnutsAA (53313 in chips) 
Seat 6: lucas.globo (35129 in chips) 
Seat 7: 7Cassie7 (27726 in chips) 
Seat 8: $ekelfreddy$ (34779 in chips) 
Seat 9: yannicho (19702 in chips) 
jcarlos.vale: posts the ante 75
woopah: posts the ante 75
WASP-104b: posts the ante 75
mitrea1989: posts the ante 75
flushnutsAA: posts the ante 75
lucas.globo: posts the ante 75
7Cassie7: posts the ante 75
$ekelfreddy$: posts the ante 75
yannicho: posts the ante 75
WASP-104b: posts small blind 500
mitrea1989: posts big blind 1000
*** HOLE CARDS ***
Dealt to jcarlos.vale [Kd 3h]
flushnutsAA: folds 
lucas.globo: folds 
7Cassie7: folds 
$ekelfreddy$: folds 
yannicho: folds 
jcarlos.vale: folds 
woopah: raises 1220 to 2220
WASP-104b: folds 
mitrea1989: raises 23043 to 25263 and is all-in
woopah: folds 
Uncalled bet (23043) returned to mitrea1989
mitrea1989 collected 5615 from pot
*** SUMMARY ***
Total pot 5615 | Rake 0 
Seat 1: jcarlos.vale folded before Flop (didn't bet)
Seat 2: woopah (button) folded before Flop
Seat 3: WASP-104b (small blind) folded before Flop
Seat 4: mitrea1989 (big blind) collected (5615)
Seat 5: flushnutsAA folded before Flop (didn't bet)
Seat 6: lucas.globo folded before Flop (didn't bet)
Seat 7: 7Cassie7 folded before Flop (didn't bet)
Seat 8: $ekelfreddy$ folded before Flop (didn't bet)
Seat 9: yannicho folded before Flop (didn't bet)



PokerStars Hand #221918269026: Tournament #3082648141, $0.98+$0.12 USD Hold'em No Limit - Level XVIII (600/1200) - 2020/12/27 23:12:27 EET [2020/12/27 16:12:27 ET]
Table '3082648141 85' 9-max Seat #3 is the button
Seat 1: jcarlos.vale (30642 in chips) 
Seat 2: woopah (71082 in chips) 
Seat 3: WASP-104b (17953 in chips) 
Seat 4: mitrea1989 (28658 in chips) 
Seat 5: flushnutsAA (53238 in chips) 
Seat 6: lucas.globo (35054 in chips) 
Seat 7: 7Cassie7 (27651 in chips) 
Seat 8: $ekelfreddy$ (34704 in chips) 
Seat 9: yannicho (19627 in chips) 
jcarlos.vale: posts the ante 90
woopah: posts the ante 90
WASP-104b: posts the ante 90
mitrea1989: posts the ante 90
flushnutsAA: posts the ante 90
lucas.globo: posts the ante 90
7Cassie7: posts the ante 90
$ekelfreddy$: posts the ante 90
yannicho: posts the ante 90
mitrea1989: posts small blind 600
flushnutsAA: posts big blind 1200
*** HOLE CARDS ***
Dealt to jcarlos.vale [9d Ac]
lucas.globo: folds 
7Cassie7: folds 
$ekelfreddy$: folds 
yannicho: folds 
jcarlos.vale: raises 1920 to 3120
woopah: folds 
WASP-104b: folds 
mitrea1989: folds 
flushnutsAA: folds 
Uncalled bet (1920) returned to jcarlos.vale
jcarlos.vale collected 3810 from pot
jcarlos.vale: doesn't show handDTO
*** SUMMARY ***
Total pot 3810 | Rake 0 
Seat 1: jcarlos.vale collected (3810)
Seat 2: woopah folded before Flop (didn't bet)
Seat 3: WASP-104b (button) folded before Flop (didn't bet)
Seat 4: mitrea1989 (small blind) folded before Flop
Seat 5: flushnutsAA (big blind) folded before Flop
Seat 6: lucas.globo folded before Flop (didn't bet)
Seat 7: 7Cassie7 folded before Flop (didn't bet)
Seat 8: $ekelfreddy$ folded before Flop (didn't bet)
Seat 9: yannicho folded before Flop (didn't bet)



PokerStars Hand #221918294402: Tournament #3082648141, $0.98+$0.12 USD Hold'em No Limit - Level XVIII (600/1200) - 2020/12/27 23:12:55 EET [2020/12/27 16:12:55 ET]
Table '3082648141 85' 9-max Seat #4 is the button
Seat 1: jcarlos.vale (33162 in chips) 
Seat 2: woopah (70992 in chips) 
Seat 3: WASP-104b (17863 in chips) 
Seat 4: mitrea1989 (27968 in chips) 
Seat 5: flushnutsAA (51948 in chips) 
Seat 6: lucas.globo (34964 in chips) 
Seat 7: 7Cassie7 (27561 in chips) 
Seat 8: $ekelfreddy$ (34614 in chips) 
Seat 9: yannicho (19537 in chips) 
jcarlos.vale: posts the ante 90
woopah: posts the ante 90
WASP-104b: posts the ante 90
mitrea1989: posts the ante 90
flushnutsAA: posts the ante 90
lucas.globo: posts the ante 90
7Cassie7: posts the ante 90
$ekelfreddy$: posts the ante 90
yannicho: posts the ante 90
flushnutsAA: posts small blind 600
lucas.globo: posts big blind 1200
*** HOLE CARDS ***
Dealt to jcarlos.vale [Qd Ac]
7Cassie7: folds 
$ekelfreddy$: raises 2400 to 3600
yannicho: folds 
jcarlos.vale: folds 
woopah: calls 3600
WASP-104b: folds 
mitrea1989: folds 
flushnutsAA: raises 7200 to 10800
lucas.globo: folds 
$ekelfreddy$: folds 
woopah: folds 
Uncalled bet (7200) returned to flushnutsAA
flushnutsAA collected 12810 from pot
flushnutsAA: doesn't show handDTO
*** SUMMARY ***
Total pot 12810 | Rake 0 
Seat 1: jcarlos.vale folded before Flop (didn't bet)
Seat 2: woopah folded before Flop
Seat 3: WASP-104b folded before Flop (didn't bet)
Seat 4: mitrea1989 (button) folded before Flop (didn't bet)
Seat 5: flushnutsAA (small blind) collected (12810)
Seat 6: lucas.globo (big blind) folded before Flop
Seat 7: 7Cassie7 folded before Flop (didn't bet)
Seat 8: $ekelfreddy$ folded before Flop
Seat 9: yannicho folded before Flop (didn't bet)



PokerStars Hand #221918338318: Tournament #3082648141, $0.98+$0.12 USD Hold'em No Limit - Level XVIII (600/1200) - 2020/12/27 23:13:42 EET [2020/12/27 16:13:42 ET]
Table '3082648141 85' 9-max Seat #5 is the button
Seat 1: jcarlos.vale (33072 in chips) 
Seat 2: woopah (67302 in chips) 
Seat 3: WASP-104b (17773 in chips) 
Seat 4: mitrea1989 (27878 in chips) 
Seat 5: flushnutsAA (61068 in chips) 
Seat 6: lucas.globo (33674 in chips) 
Seat 7: 7Cassie7 (27471 in chips) 
Seat 8: $ekelfreddy$ (30924 in chips) 
Seat 9: yannicho (19447 in chips) 
jcarlos.vale: posts the ante 90
woopah: posts the ante 90
WASP-104b: posts the ante 90
mitrea1989: posts the ante 90
flushnutsAA: posts the ante 90
lucas.globo: posts the ante 90
7Cassie7: posts the ante 90
$ekelfreddy$: posts the ante 90
yannicho: posts the ante 90
lucas.globo: posts small blind 600
7Cassie7: posts big blind 1200
*** HOLE CARDS ***
Dealt to jcarlos.vale [7h 4s]
$ekelfreddy$: folds 
yannicho: folds 
jcarlos.vale: folds 
woopah: folds 
WASP-104b: folds 
mitrea1989: folds 
flushnutsAA: raises 1200 to 2400
lucas.globo: folds 
7Cassie7: folds 
Uncalled bet (1200) returned to flushnutsAA
flushnutsAA collected 3810 from pot
flushnutsAA: doesn't show handDTO
*** SUMMARY ***
Total pot 3810 | Rake 0 
Seat 1: jcarlos.vale folded before Flop (didn't bet)
Seat 2: woopah folded before Flop (didn't bet)
Seat 3: WASP-104b folded before Flop (didn't bet)
Seat 4: mitrea1989 folded before Flop (didn't bet)
Seat 5: flushnutsAA (button) collected (3810)
Seat 6: lucas.globo (small blind) folded before Flop
Seat 7: 7Cassie7 (big blind) folded before Flop
Seat 8: $ekelfreddy$ folded before Flop (didn't bet)
Seat 9: yannicho folded before Flop (didn't bet)



PokerStars Hand #221918377881: Tournament #3082648141, $0.98+$0.12 USD Hold'em No Limit - Level XVIII (600/1200) - 2020/12/27 23:14:26 EET [2020/12/27 16:14:26 ET]
Table '3082648141 85' 9-max Seat #6 is the button
Seat 1: jcarlos.vale (32982 in chips) 
Seat 2: woopah (67212 in chips) 
Seat 3: WASP-104b (17683 in chips) 
Seat 4: mitrea1989 (27788 in chips) 
Seat 5: flushnutsAA (63588 in chips) 
Seat 6: lucas.globo (32984 in chips) 
Seat 7: 7Cassie7 (26181 in chips) 
Seat 8: $ekelfreddy$ (30834 in chips) 
Seat 9: yannicho (19357 in chips) 
jcarlos.vale: posts the ante 90
woopah: posts the ante 90
WASP-104b: posts the ante 90
mitrea1989: posts the ante 90
flushnutsAA: posts the ante 90
lucas.globo: posts the ante 90
7Cassie7: posts the ante 90
$ekelfreddy$: posts the ante 90
yannicho: posts the ante 90
7Cassie7: posts small blind 600
$ekelfreddy$: posts big blind 1200
*** HOLE CARDS ***
Dealt to jcarlos.vale [2d 7d]
yannicho: folds 
jcarlos.vale: folds 
woopah: folds 
WASP-104b: folds 
mitrea1989: folds 
flushnutsAA: folds 
lucas.globo: raises 1200 to 2400
7Cassie7: folds 
$ekelfreddy$: calls 1200
*** FLOP *** [Ks Kd Tc]
$ekelfreddy$: checks 
lucas.globo: bets 3105
$ekelfreddy$: folds 
Uncalled bet (3105) returned to lucas.globo
lucas.globo collected 6210 from pot
lucas.globo: doesn't show handDTO
*** SUMMARY ***
Total pot 6210 | Rake 0 
Board [Ks Kd Tc]
Seat 1: jcarlos.vale folded before Flop (didn't bet)
Seat 2: woopah folded before Flop (didn't bet)
Seat 3: WASP-104b folded before Flop (didn't bet)
Seat 4: mitrea1989 folded before Flop (didn't bet)
Seat 5: flushnutsAA folded before Flop (didn't bet)
Seat 6: lucas.globo (button) collected (6210)
Seat 7: 7Cassie7 (small blind) folded before Flop
Seat 8: $ekelfreddy$ (big blind) folded on the Flop
Seat 9: yannicho folded before Flop (didn't bet)



PokerStars Hand #221918417007: Tournament #3082648141, $0.98+$0.12 USD Hold'em No Limit - Level XVIII (600/1200) - 2020/12/27 23:15:08 EET [2020/12/27 16:15:08 ET]
Table '3082648141 85' 9-max Seat #7 is the button
Seat 1: jcarlos.vale (32892 in chips) 
Seat 2: woopah (67122 in chips) 
Seat 3: WASP-104b (17593 in chips) 
Seat 4: mitrea1989 (27698 in chips) 
Seat 5: flushnutsAA (63498 in chips) 
Seat 6: lucas.globo (36704 in chips) 
Seat 7: 7Cassie7 (25491 in chips) 
Seat 8: $ekelfreddy$ (28344 in chips) 
Seat 9: yannicho (19267 in chips) 
jcarlos.vale: posts the ante 90
woopah: posts the ante 90
WASP-104b: posts the ante 90
mitrea1989: posts the ante 90
flushnutsAA: posts the ante 90
lucas.globo: posts the ante 90
7Cassie7: posts the ante 90
$ekelfreddy$: posts the ante 90
yannicho: posts the ante 90
$ekelfreddy$: posts small blind 600
yannicho: posts big blind 1200
*** HOLE CARDS ***
Dealt to jcarlos.vale [7s 7d]
jcarlos.vale: raises 1920 to 3120
woopah: folds 
WASP-104b: folds 
mitrea1989: folds 
flushnutsAA: folds 
lucas.globo: folds 
7Cassie7: calls 3120
$ekelfreddy$: folds 
yannicho: folds 
*** FLOP *** [2d 5d 3c]
jcarlos.vale: bets 6638
7Cassie7: calls 6638
*** TURN *** [2d 5d 3c] [Ad]
jcarlos.vale: bets 2400
7Cassie7: calls 2400
*** RIVER *** [2d 5d 3c Ad] [4s]
jcarlos.vale: bets 2400
7Cassie7: calls 2400
*** SHOW DOWN ***
jcarlos.vale: shows [7s 7d] (a straight, Ace to Five)
7Cassie7: shows [Jd Jc] (a straight, Ace to Five)
jcarlos.vale collected 15863 from pot
7Cassie7 collected 15863 from pot
*** SUMMARY ***
Total pot 31726 | Rake 0 
Board [2d 5d 3c Ad 4s]
Seat 1: jcarlos.vale showed [7s 7d] and won (15863) with a straight, Ace to Five
Seat 2: woopah folded before Flop (didn't bet)
Seat 3: WASP-104b folded before Flop (didn't bet)
Seat 4: mitrea1989 folded before Flop (didn't bet)
Seat 5: flushnutsAA folded before Flop (didn't bet)
Seat 6: lucas.globo folded before Flop (didn't bet)
Seat 7: 7Cassie7 (button) showed [Jd Jc] and won (15863) with a straight, Ace to Five
Seat 8: $ekelfreddy$ (small blind) folded before Flop
Seat 9: yannicho (big blind) folded before Flop



PokerStars Hand #221918459036: Tournament #3082648141, $0.98+$0.12 USD Hold'em No Limit - Level XVIII (600/1200) - 2020/12/27 23:15:52 EET [2020/12/27 16:15:52 ET]
Table '3082648141 85' 9-max Seat #8 is the button
Seat 1: jcarlos.vale (34107 in chips) 
Seat 2: woopah (67032 in chips) 
Seat 3: WASP-104b (17503 in chips) 
Seat 4: mitrea1989 (27608 in chips) 
Seat 5: flushnutsAA (63408 in chips) 
Seat 6: lucas.globo (36614 in chips) 
Seat 7: 7Cassie7 (26706 in chips) 
Seat 8: $ekelfreddy$ (27654 in chips) 
Seat 9: yannicho (17977 in chips) 
jcarlos.vale: posts the ante 90
woopah: posts the ante 90
WASP-104b: posts the ante 90
mitrea1989: posts the ante 90
flushnutsAA: posts the ante 90
lucas.globo: posts the ante 90
7Cassie7: posts the ante 90
$ekelfreddy$: posts the ante 90
yannicho: posts the ante 90
yannicho: posts small blind 600
jcarlos.vale: posts big blind 1200
*** HOLE CARDS ***
Dealt to jcarlos.vale [8c 7d]
woopah: folds 
WASP-104b: folds 
mitrea1989: folds 
flushnutsAA: folds 
lucas.globo: raises 2400 to 3600
7Cassie7: folds 
$ekelfreddy$: folds 
yannicho: folds 
jcarlos.vale: folds 
Uncalled bet (2400) returned to lucas.globo
lucas.globo collected 3810 from pot
lucas.globo: doesn't show handDTO
*** SUMMARY ***
Total pot 3810 | Rake 0 
Seat 1: jcarlos.vale (big blind) folded before Flop
Seat 2: woopah folded before Flop (didn't bet)
Seat 3: WASP-104b folded before Flop (didn't bet)
Seat 4: mitrea1989 folded before Flop (didn't bet)
Seat 5: flushnutsAA folded before Flop (didn't bet)
Seat 6: lucas.globo collected (3810)
Seat 7: 7Cassie7 folded before Flop (didn't bet)
Seat 8: $ekelfreddy$ (button) folded before Flop (didn't bet)
Seat 9: yannicho (small blind) folded before Flop



PokerStars Hand #221918475288: Tournament #3082648141, $0.98+$0.12 USD Hold'em No Limit - Level XVIII (600/1200) - 2020/12/27 23:16:10 EET [2020/12/27 16:16:10 ET]
Table '3082648141 85' 9-max Seat #9 is the button
Seat 1: jcarlos.vale (32817 in chips) 
Seat 2: woopah (66942 in chips) 
Seat 3: WASP-104b (17413 in chips) 
Seat 4: mitrea1989 (27518 in chips) 
Seat 5: flushnutsAA (63318 in chips) 
Seat 6: lucas.globo (39134 in chips) 
Seat 7: 7Cassie7 (26616 in chips) 
Seat 8: $ekelfreddy$ (27564 in chips) 
Seat 9: yannicho (17287 in chips) 
jcarlos.vale: posts the ante 90
woopah: posts the ante 90
WASP-104b: posts the ante 90
mitrea1989: posts the ante 90
flushnutsAA: posts the ante 90
lucas.globo: posts the ante 90
7Cassie7: posts the ante 90
$ekelfreddy$: posts the ante 90
yannicho: posts the ante 90
jcarlos.vale: posts small blind 600
woopah: posts big blind 1200
*** HOLE CARDS ***
Dealt to jcarlos.vale [8h 2s]
WASP-104b: raises 1320 to 2520
mitrea1989: folds 
flushnutsAA: folds 
lucas.globo: folds 
7Cassie7: folds 
$ekelfreddy$: raises 4680 to 7200
yannicho: folds 
jcarlos.vale: folds 
woopah: folds 
WASP-104b: raises 10123 to 17323 and is all-in
$ekelfreddy$: calls 10123
*** FLOP *** [2d 5h 7h]
*** TURN *** [2d 5h 7h] [Ah]
*** RIVER *** [2d 5h 7h Ah] [Ts]
*** SHOW DOWN ***
WASP-104b: shows [Kd Kc] (a pair of Kings)
$ekelfreddy$: shows [Th Td] (three of a kind, Tens)
$ekelfreddy$ collected 37256 from pot
WASP-104b finished the tournament in 613th place and received $1.78.
*** SUMMARY ***
Total pot 37256 | Rake 0 
Board [2d 5h 7h Ah Ts]
Seat 1: jcarlos.vale (small blind) folded before Flop
Seat 2: woopah (big blind) folded before Flop
Seat 3: WASP-104b showed [Kd Kc] and lost with a pair of Kings
Seat 4: mitrea1989 folded before Flop (didn't bet)
Seat 5: flushnutsAA folded before Flop (didn't bet)
Seat 6: lucas.globo folded before Flop (didn't bet)
Seat 7: 7Cassie7 folded before Flop (didn't bet)
Seat 8: $ekelfreddy$ showed [Th Td] and won (37256) with three of a kind, Tens
Seat 9: yannicho (button) folded before Flop (didn't bet)



PokerStars Hand #221918528373: Tournament #3082648141, $0.98+$0.12 USD Hold'em No Limit - Level XVIII (600/1200) - 2020/12/27 23:17:06 EET [2020/12/27 16:17:06 ET]
Table '3082648141 47' 9-max Seat #5 is the button
Seat 1: peio123 (64149 in chips) 
Seat 2: Dgo Sytrik (40736 in chips) 
Seat 3: jcarlos.vale (32127 in chips) 
Seat 4: angyal40 (13772 in chips) 
Seat 5: engel395 (70016 in chips) 
Seat 6: Baron Pulpo (41128 in chips) 
Seat 7: kukbik (62049 in chips) 
Seat 8: houlajk (69672 in chips) 
Seat 9: dracko307 (60198 in chips) 
peio123: posts the ante 90
Dgo Sytrik: posts the ante 90
jcarlos.vale: posts the ante 90
angyal40: posts the ante 90
engel395: posts the ante 90
Baron Pulpo: posts the ante 90
kukbik: posts the ante 90
houlajk: posts the ante 90
dracko307: posts the ante 90
Baron Pulpo: posts small blind 600
kukbik: posts big blind 1200
*** HOLE CARDS ***
Dealt to jcarlos.vale [2h Ah]
houlajk: folds 
dracko307: folds 
peio123: folds 
Dgo Sytrik: folds 
jcarlos.vale: raises 1200 to 2400
angyal40: folds 
engel395: folds 
Baron Pulpo: folds 
kukbik: folds 
Uncalled bet (1200) returned to jcarlos.vale
jcarlos.vale collected 3810 from pot
jcarlos.vale: doesn't show handDTO
*** SUMMARY ***
Total pot 3810 | Rake 0 
Seat 1: peio123 folded before Flop (didn't bet)
Seat 2: Dgo Sytrik folded before Flop (didn't bet)
Seat 3: jcarlos.vale collected (3810)
Seat 4: angyal40 folded before Flop (didn't bet)
Seat 5: engel395 (button) folded before Flop (didn't bet)
Seat 6: Baron Pulpo (small blind) folded before Flop
Seat 7: kukbik (big blind) folded before Flop
Seat 8: houlajk folded before Flop (didn't bet)
Seat 9: dracko307 folded before Flop (didn't bet)



PokerStars Hand #221918552307: Tournament #3082648141, $0.98+$0.12 USD Hold'em No Limit - Level XVIII (600/1200) - 2020/12/27 23:17:31 EET [2020/12/27 16:17:31 ET]
Table '3082648141 47' 9-max Seat #6 is the button
Seat 1: peio123 (64059 in chips) 
Seat 2: Dgo Sytrik (40646 in chips) 
Seat 3: jcarlos.vale (34647 in chips) 
Seat 4: angyal40 (13682 in chips) 
Seat 5: engel395 (69926 in chips) 
Seat 6: Baron Pulpo (40438 in chips) 
Seat 7: kukbik (60759 in chips) 
Seat 8: houlajk (69582 in chips) 
Seat 9: dracko307 (60108 in chips) 
peio123: posts the ante 90
Dgo Sytrik: posts the ante 90
jcarlos.vale: posts the ante 90
angyal40: posts the ante 90
engel395: posts the ante 90
Baron Pulpo: posts the ante 90
kukbik: posts the ante 90
houlajk: posts the ante 90
dracko307: posts the ante 90
kukbik: posts small blind 600
houlajk: posts big blind 1200
*** HOLE CARDS ***
Dealt to jcarlos.vale [9c 5c]
dracko307: raises 1380 to 2580
peio123: folds 
Dgo Sytrik: folds 
jcarlos.vale: folds 
angyal40: folds 
engel395: folds 
Baron Pulpo: folds 
kukbik: folds 
houlajk: folds 
Uncalled bet (1380) returned to dracko307
dracko307 collected 3810 from pot
dracko307: doesn't show handDTO
*** SUMMARY ***
Total pot 3810 | Rake 0 
Seat 1: peio123 folded before Flop (didn't bet)
Seat 2: Dgo Sytrik folded before Flop (didn't bet)
Seat 3: jcarlos.vale folded before Flop (didn't bet)
Seat 4: angyal40 folded before Flop (didn't bet)
Seat 5: engel395 folded before Flop (didn't bet)
Seat 6: Baron Pulpo (button) folded before Flop (didn't bet)
Seat 7: kukbik (small blind) folded before Flop
Seat 8: houlajk (big blind) folded before Flop
Seat 9: dracko307 collected (3810)



PokerStars Hand #221918570167: Tournament #3082648141, $0.98+$0.12 USD Hold'em No Limit - Level XVIII (600/1200) - 2020/12/27 23:17:50 EET [2020/12/27 16:17:50 ET]
Table '3082648141 47' 9-max Seat #7 is the button
Seat 1: peio123 (63969 in chips) 
Seat 2: Dgo Sytrik (40556 in chips) 
Seat 3: jcarlos.vale (34557 in chips) 
Seat 4: angyal40 (13592 in chips) 
Seat 5: engel395 (69836 in chips) 
Seat 6: Baron Pulpo (40348 in chips) 
Seat 7: kukbik (60069 in chips) 
Seat 8: houlajk (68292 in chips) 
Seat 9: dracko307 (62628 in chips) 
peio123: posts the ante 90
Dgo Sytrik: posts the ante 90
jcarlos.vale: posts the ante 90
angyal40: posts the ante 90
engel395: posts the ante 90
Baron Pulpo: posts the ante 90
kukbik: posts the ante 90
houlajk: posts the ante 90
dracko307: posts the ante 90
houlajk: posts small blind 600
dracko307: posts big blind 1200
*** HOLE CARDS ***
Dealt to jcarlos.vale [Ad As]
peio123: folds 
Dgo Sytrik: folds 
jcarlos.vale: raises 1920 to 3120
angyal40: folds 
engel395: folds 
Baron Pulpo: calls 3120
kukbik: folds 
houlajk: folds 
dracko307: folds 
*** FLOP *** [Kc 7h Kd]
jcarlos.vale: bets 3600
Baron Pulpo: folds 
Uncalled bet (3600) returned to jcarlos.vale
jcarlos.vale collected 8850 from pot
jcarlos.vale: doesn't show handDTO
*** SUMMARY ***
Total pot 8850 | Rake 0 
Board [Kc 7h Kd]
Seat 1: peio123 folded before Flop (didn't bet)
Seat 2: Dgo Sytrik folded before Flop (didn't bet)
Seat 3: jcarlos.vale collected (8850)
Seat 4: angyal40 folded before Flop (didn't bet)
Seat 5: engel395 folded before Flop (didn't bet)
Seat 6: Baron Pulpo folded on the Flop
Seat 7: kukbik (button) folded before Flop (didn't bet)
Seat 8: houlajk (small blind) folded before Flop
Seat 9: dracko307 (big blind) folded before Flop



PokerStars Hand #221918616652: Tournament #3082648141, $0.98+$0.12 USD Hold'em No Limit - Level XVIII (600/1200) - 2020/12/27 23:18:39 EET [2020/12/27 16:18:39 ET]
Table '3082648141 47' 9-max Seat #8 is the button
Seat 1: peio123 (63879 in chips) 
Seat 2: Dgo Sytrik (40466 in chips) 
Seat 3: jcarlos.vale (40197 in chips) 
Seat 4: angyal40 (13502 in chips) 
Seat 5: engel395 (69746 in chips) 
Seat 6: Baron Pulpo (37138 in chips) 
Seat 7: kukbik (59979 in chips) 
Seat 8: houlajk (67602 in chips) 
Seat 9: dracko307 (61338 in chips) 
peio123: posts the ante 90
Dgo Sytrik: posts the ante 90
jcarlos.vale: posts the ante 90
angyal40: posts the ante 90
engel395: posts the ante 90
Baron Pulpo: posts the ante 90
kukbik: posts the ante 90
houlajk: posts the ante 90
dracko307: posts the ante 90
dracko307: posts small blind 600
peio123: posts big blind 1200
*** HOLE CARDS ***
Dealt to jcarlos.vale [Tc 9s]
Dgo Sytrik: folds 
jcarlos.vale: folds 
angyal40: folds 
engel395: folds 
Baron Pulpo: raises 1200 to 2400
kukbik: folds 
houlajk: folds 
dracko307: folds 
peio123: folds 
Uncalled bet (1200) returned to Baron Pulpo
Baron Pulpo collected 3810 from pot
*** SUMMARY ***
Total pot 3810 | Rake 0 
Seat 1: peio123 (big blind) folded before Flop
Seat 2: Dgo Sytrik folded before Flop (didn't bet)
Seat 3: jcarlos.vale folded before Flop (didn't bet)
Seat 4: angyal40 folded before Flop (didn't bet)
Seat 5: engel395 folded before Flop (didn't bet)
Seat 6: Baron Pulpo collected (3810)
Seat 7: kukbik folded before Flop (didn't bet)
Seat 8: houlajk (button) folded before Flop (didn't bet)
Seat 9: dracko307 (small blind) folded before Flop



PokerStars Hand #221918642459: Tournament #3082648141, $0.98+$0.12 USD Hold'em No Limit - Level XVIII (600/1200) - 2020/12/27 23:19:06 EET [2020/12/27 16:19:06 ET]
Table '3082648141 47' 9-max Seat #9 is the button
Seat 1: peio123 (62589 in chips) 
Seat 2: Dgo Sytrik (40376 in chips) 
Seat 3: jcarlos.vale (40107 in chips) 
Seat 4: angyal40 (13412 in chips) 
Seat 5: engel395 (69656 in chips) 
Seat 6: Baron Pulpo (39658 in chips) 
Seat 7: kukbik (59889 in chips) 
Seat 8: houlajk (67512 in chips) 
Seat 9: dracko307 (60648 in chips) 
peio123: posts the ante 90
Dgo Sytrik: posts the ante 90
jcarlos.vale: posts the ante 90
angyal40: posts the ante 90
engel395: posts the ante 90
Baron Pulpo: posts the ante 90
kukbik: posts the ante 90
houlajk: posts the ante 90
dracko307: posts the ante 90
peio123: posts small blind 600
Dgo Sytrik: posts big blind 1200
*** HOLE CARDS ***
Dealt to jcarlos.vale [Tc Kh]
jcarlos.vale: folds 
angyal40: folds 
engel395: folds 
Baron Pulpo: folds 
kukbik: folds 
houlajk: raises 1440 to 2640
dracko307: folds 
peio123: folds 
Dgo Sytrik: folds 
Uncalled bet (1440) returned to houlajk
houlajk collected 3810 from pot
houlajk: doesn't show handDTO
*** SUMMARY ***
Total pot 3810 | Rake 0 
Seat 1: peio123 (small blind) folded before Flop
Seat 2: Dgo Sytrik (big blind) folded before Flop
Seat 3: jcarlos.vale folded before Flop (didn't bet)
Seat 4: angyal40 folded before Flop (didn't bet)
Seat 5: engel395 folded before Flop (didn't bet)
Seat 6: Baron Pulpo folded before Flop (didn't bet)
Seat 7: kukbik folded before Flop (didn't bet)
Seat 8: houlajk collected (3810)
Seat 9: dracko307 (button) folded before Flop (didn't bet)



PokerStars Hand #221918661049: Tournament #3082648141, $0.98+$0.12 USD Hold'em No Limit - Level XVIII (600/1200) - 2020/12/27 23:19:26 EET [2020/12/27 16:19:26 ET]
Table '3082648141 47' 9-max Seat #1 is the button
Seat 1: peio123 (61899 in chips) 
Seat 2: Dgo Sytrik (39086 in chips) 
Seat 3: jcarlos.vale (40017 in chips) 
Seat 4: angyal40 (13322 in chips) 
Seat 5: engel395 (69566 in chips) 
Seat 6: Baron Pulpo (39568 in chips) 
Seat 7: kukbik (59799 in chips) 
Seat 8: houlajk (70032 in chips) 
Seat 9: dracko307 (60558 in chips) 
peio123: posts the ante 90
Dgo Sytrik: posts the ante 90
jcarlos.vale: posts the ante 90
angyal40: posts the ante 90
engel395: posts the ante 90
Baron Pulpo: posts the ante 90
kukbik: posts the ante 90
houlajk: posts the ante 90
dracko307: posts the ante 90
Dgo Sytrik: posts small blind 600
jcarlos.vale: posts big blind 1200
*** HOLE CARDS ***
Dealt to jcarlos.vale [4h 6c]
angyal40: folds 
engel395: folds 
Baron Pulpo: folds 
kukbik: folds 
houlajk: folds 
dracko307: folds 
peio123: raises 1200 to 2400
Dgo Sytrik: calls 1800
jcarlos.vale: folds 
*** FLOP *** [7d 6h 5c]
Dgo Sytrik: bets 3600
peio123: calls 3600
*** TURN *** [7d 6h 5c] [7h]
Dgo Sytrik: bets 7200
peio123: folds 
Uncalled bet (7200) returned to Dgo Sytrik
Dgo Sytrik collected 14010 from pot
Dgo Sytrik: doesn't show handDTO
*** SUMMARY ***
Total pot 14010 | Rake 0 
Board [7d 6h 5c 7h]
Seat 1: peio123 (button) folded on the Turn
Seat 2: Dgo Sytrik (small blind) collected (14010)
Seat 3: jcarlos.vale (big blind) folded before Flop
Seat 4: angyal40 folded before Flop (didn't bet)
Seat 5: engel395 folded before Flop (didn't bet)
Seat 6: Baron Pulpo folded before Flop (didn't bet)
Seat 7: kukbik folded before Flop (didn't bet)
Seat 8: houlajk folded before Flop (didn't bet)
Seat 9: dracko307 folded before Flop (didn't bet)



PokerStars Hand #221918701142: Tournament #3082648141, $0.98+$0.12 USD Hold'em No Limit - Level XVIII (600/1200) - 2020/12/27 23:20:08 EET [2020/12/27 16:20:08 ET]
Table '3082648141 47' 9-max Seat #2 is the button
Seat 1: peio123 (55809 in chips) 
Seat 2: Dgo Sytrik (47006 in chips) 
Seat 3: jcarlos.vale (38727 in chips) 
Seat 4: angyal40 (13232 in chips) 
Seat 5: engel395 (69476 in chips) 
Seat 6: Baron Pulpo (39478 in chips) 
Seat 7: kukbik (59709 in chips) 
Seat 8: houlajk (69942 in chips) 
Seat 9: dracko307 (60468 in chips) 
peio123: posts the ante 90
Dgo Sytrik: posts the ante 90
jcarlos.vale: posts the ante 90
angyal40: posts the ante 90
engel395: posts the ante 90
Baron Pulpo: posts the ante 90
kukbik: posts the ante 90
houlajk: posts the ante 90
dracko307: posts the ante 90
jcarlos.vale: posts small blind 600
angyal40: posts big blind 1200
*** HOLE CARDS ***
Dealt to jcarlos.vale [3c 8s]
engel395: folds 
Baron Pulpo: folds 
kukbik: folds 
houlajk: raises 1320 to 2520
dracko307: folds 
peio123: folds 
Dgo Sytrik: calls 2520
jcarlos.vale: folds 
angyal40: folds 
*** FLOP *** [Kc 5d Qd]
houlajk: checks 
Dgo Sytrik: bets 5400
houlajk: folds 
Uncalled bet (5400) returned to Dgo Sytrik
Dgo Sytrik collected 7650 from pot
Dgo Sytrik: doesn't show handDTO
*** SUMMARY ***
Total pot 7650 | Rake 0 
Board [Kc 5d Qd]
Seat 1: peio123 folded before Flop (didn't bet)
Seat 2: Dgo Sytrik (button) collected (7650)
Seat 3: jcarlos.vale (small blind) folded before Flop
Seat 4: angyal40 (big blind) folded before Flop
Seat 5: engel395 folded before Flop (didn't bet)
Seat 6: Baron Pulpo folded before Flop (didn't bet)
Seat 7: kukbik folded before Flop (didn't bet)
Seat 8: houlajk folded on the Flop
Seat 9: dracko307 folded before Flop (didn't bet)



PokerStars Hand #221918757761: Tournament #3082648141, $0.98+$0.12 USD Hold'em No Limit - Level XVIII (600/1200) - 2020/12/27 23:21:07 EET [2020/12/27 16:21:07 ET]
Table '3082648141 47' 9-max Seat #3 is the button
Seat 1: peio123 (55719 in chips) 
Seat 2: Dgo Sytrik (52046 in chips) 
Seat 3: jcarlos.vale (38037 in chips) 
Seat 4: angyal40 (11942 in chips) 
Seat 5: engel395 (69386 in chips) 
Seat 6: Baron Pulpo (39388 in chips) 
Seat 7: kukbik (59619 in chips) 
Seat 8: houlajk (67332 in chips) 
Seat 9: dracko307 (60378 in chips) 
peio123: posts the ante 90
Dgo Sytrik: posts the ante 90
jcarlos.vale: posts the ante 90
angyal40: posts the ante 90
engel395: posts the ante 90
Baron Pulpo: posts the ante 90
kukbik: posts the ante 90
houlajk: posts the ante 90
dracko307: posts the ante 90
angyal40: posts small blind 600
engel395: posts big blind 1200
*** HOLE CARDS ***
Dealt to jcarlos.vale [Ah 2c]
Baron Pulpo: folds 
kukbik: folds 
houlajk: raises 1320 to 2520
dracko307: folds 
peio123: folds 
Dgo Sytrik: folds 
jcarlos.vale: folds 
angyal40: folds 
engel395: calls 1320
*** FLOP *** [8h Ts 4c]
engel395: checks 
houlajk: bets 2129
engel395: folds 
Uncalled bet (2129) returned to houlajk
houlajk collected 6450 from pot
houlajk: doesn't show handDTO
*** SUMMARY ***
Total pot 6450 | Rake 0 
Board [8h Ts 4c]
Seat 1: peio123 folded before Flop (didn't bet)
Seat 2: Dgo Sytrik folded before Flop (didn't bet)
Seat 3: jcarlos.vale (button) folded before Flop (didn't bet)
Seat 4: angyal40 (small blind) folded before Flop
Seat 5: engel395 (big blind) folded on the Flop
Seat 6: Baron Pulpo folded before Flop (didn't bet)
Seat 7: kukbik folded before Flop (didn't bet)
Seat 8: houlajk collected (6450)
Seat 9: dracko307 folded before Flop (didn't bet)



PokerStars Hand #221918797950: Tournament #3082648141, $0.98+$0.12 USD Hold'em No Limit - Level XVIII (600/1200) - 2020/12/27 23:21:50 EET [2020/12/27 16:21:50 ET]
Table '3082648141 47' 9-max Seat #4 is the button
Seat 1: peio123 (55629 in chips) 
Seat 2: Dgo Sytrik (51956 in chips) 
Seat 3: jcarlos.vale (37947 in chips) 
Seat 4: angyal40 (11252 in chips) 
Seat 5: engel395 (66776 in chips) 
Seat 6: Baron Pulpo (39298 in chips) 
Seat 7: kukbik (59529 in chips) 
Seat 8: houlajk (71172 in chips) 
Seat 9: dracko307 (60288 in chips) 
peio123: posts the ante 90
Dgo Sytrik: posts the ante 90
jcarlos.vale: posts the ante 90
angyal40: posts the ante 90
engel395: posts the ante 90
Baron Pulpo: posts the ante 90
kukbik: posts the ante 90
houlajk: posts the ante 90
dracko307: posts the ante 90
engel395: posts small blind 600
Baron Pulpo: posts big blind 1200
*** HOLE CARDS ***
Dealt to jcarlos.vale [9c 2d]
kukbik: folds 
houlajk: raises 1320 to 2520
dracko307: folds 
peio123: folds 
Dgo Sytrik: folds 
jcarlos.vale: folds 
angyal40: folds 
engel395: folds 
Baron Pulpo: calls 1320
*** FLOP *** [Tc 2c Kd]
Baron Pulpo: checks 
houlajk: bets 2129
Baron Pulpo: calls 2129
*** TURN *** [Tc 2c Kd] [8c]
Baron Pulpo: checks 
houlajk: bets 8031
Baron Pulpo: folds 
Uncalled bet (8031) returned to houlajk
houlajk collected 10708 from pot
houlajk: doesn't show handDTO
*** SUMMARY ***
Total pot 10708 | Rake 0 
Board [Tc 2c Kd 8c]
Seat 1: peio123 folded before Flop (didn't bet)
Seat 2: Dgo Sytrik folded before Flop (didn't bet)
Seat 3: jcarlos.vale folded before Flop (didn't bet)
Seat 4: angyal40 (button) folded before Flop (didn't bet)
Seat 5: engel395 (small blind) folded before Flop
Seat 6: Baron Pulpo (big blind) folded on the Turn
Seat 7: kukbik folded before Flop (didn't bet)
Seat 8: houlajk collected (10708)
Seat 9: dracko307 folded before Flop (didn't bet)



PokerStars Hand #221918864471: Tournament #3082648141, $0.98+$0.12 USD Hold'em No Limit - Level XIX (700/1400) - 2020/12/27 23:23:00 EET [2020/12/27 16:23:00 ET]
Table '3082648141 47' 9-max Seat #5 is the button
Seat 1: peio123 (55539 in chips) 
Seat 2: Dgo Sytrik (51866 in chips) 
Seat 3: jcarlos.vale (37857 in chips) 
Seat 4: angyal40 (11162 in chips) 
Seat 5: engel395 (66086 in chips) 
Seat 6: Baron Pulpo (34559 in chips) 
Seat 7: kukbik (59439 in chips) 
Seat 8: houlajk (77141 in chips) 
Seat 9: dracko307 (60198 in chips) 
peio123: posts the ante 100
Dgo Sytrik: posts the ante 100
jcarlos.vale: posts the ante 100
angyal40: posts the ante 100
engel395: posts the ante 100
Baron Pulpo: posts the ante 100
kukbik: posts the ante 100
houlajk: posts the ante 100
dracko307: posts the ante 100
Baron Pulpo: posts small blind 700
kukbik: posts big blind 1400
*** HOLE CARDS ***
Dealt to jcarlos.vale [4s As]
houlajk: folds 
dracko307: folds 
peio123: folds 
Dgo Sytrik: raises 2100 to 3500
jcarlos.vale: folds 
angyal40: folds 
engel395: folds 
Baron Pulpo: raises 30959 to 34459 and is all-in
kukbik: folds 
Dgo Sytrik: folds 
Uncalled bet (30959) returned to Baron Pulpo
Baron Pulpo collected 9300 from pot
*** SUMMARY ***
Total pot 9300 | Rake 0 
Seat 1: peio123 folded before Flop (didn't bet)
Seat 2: Dgo Sytrik folded before Flop
Seat 3: jcarlos.vale folded before Flop (didn't bet)
Seat 4: angyal40 folded before Flop (didn't bet)
Seat 5: engel395 (button) folded before Flop (didn't bet)
Seat 6: Baron Pulpo (small blind) collected (9300)
Seat 7: kukbik (big blind) folded before Flop
Seat 8: houlajk folded before Flop (didn't bet)
Seat 9: dracko307 folded before Flop (didn't bet)



PokerStars Hand #221918891424: Tournament #3082648141, $0.98+$0.12 USD Hold'em No Limit - Level XIX (700/1400) - 2020/12/27 23:23:28 EET [2020/12/27 16:23:28 ET]
Table '3082648141 47' 9-max Seat #6 is the button
Seat 1: peio123 (55439 in chips) 
Seat 2: Dgo Sytrik (48266 in chips) 
Seat 3: jcarlos.vale (37757 in chips) 
Seat 4: angyal40 (11062 in chips) 
Seat 5: engel395 (65986 in chips) 
Seat 6: Baron Pulpo (40259 in chips) 
Seat 7: kukbik (57939 in chips) 
Seat 8: houlajk (77041 in chips) 
Seat 9: dracko307 (60098 in chips) 
peio123: posts the ante 100
Dgo Sytrik: posts the ante 100
jcarlos.vale: posts the ante 100
angyal40: posts the ante 100
engel395: posts the ante 100
Baron Pulpo: posts the ante 100
kukbik: posts the ante 100
houlajk: posts the ante 100
dracko307: posts the ante 100
kukbik: posts small blind 700
houlajk: posts big blind 1400
*** HOLE CARDS ***
Dealt to jcarlos.vale [Ac 6d]
dracko307: folds 
peio123: folds 
Dgo Sytrik: raises 1400 to 2800
jcarlos.vale: folds 
angyal40: folds 
engel395: folds 
Baron Pulpo: folds 
kukbik: folds 
houlajk: calls 1400
*** FLOP *** [7c Jh 4h]
houlajk: checks 
Dgo Sytrik: bets 3600
houlajk: calls 3600
*** TURN *** [7c Jh 4h] [As]
houlajk: checks 
Dgo Sytrik: checks 
*** RIVER *** [7c Jh 4h As] [Kd]
houlajk: bets 8400
Dgo Sytrik: folds 
Uncalled bet (8400) returned to houlajk
houlajk collected 14400 from pot
houlajk: doesn't show handDTO
*** SUMMARY ***
Total pot 14400 | Rake 0 
Board [7c Jh 4h As Kd]
Seat 1: peio123 folded before Flop (didn't bet)
Seat 2: Dgo Sytrik folded on the River
Seat 3: jcarlos.vale folded before Flop (didn't bet)
Seat 4: angyal40 folded before Flop (didn't bet)
Seat 5: engel395 folded before Flop (didn't bet)
Seat 6: Baron Pulpo (button) folded before Flop (didn't bet)
Seat 7: kukbik (small blind) folded before Flop
Seat 8: houlajk (big blind) collected (14400)
Seat 9: dracko307 folded before Flop (didn't bet)



PokerStars Hand #221918987377: Tournament #3082648141, $0.98+$0.12 USD Hold'em No Limit - Level XIX (700/1400) - 2020/12/27 23:25:10 EET [2020/12/27 16:25:10 ET]
Table '3082648141 47' 9-max Seat #7 is the button
Seat 1: peio123 (55339 in chips) 
Seat 2: Dgo Sytrik (41766 in chips) 
Seat 3: jcarlos.vale (37657 in chips) 
Seat 4: angyal40 (10962 in chips) 
Seat 5: engel395 (65886 in chips) 
Seat 6: Baron Pulpo (40159 in chips) 
Seat 7: kukbik (57139 in chips) 
Seat 8: houlajk (84941 in chips) 
Seat 9: dracko307 (59998 in chips) 
peio123: posts the ante 100
Dgo Sytrik: posts the ante 100
jcarlos.vale: posts the ante 100
angyal40: posts the ante 100
engel395: posts the ante 100
Baron Pulpo: posts the ante 100
kukbik: posts the ante 100
houlajk: posts the ante 100
dracko307: posts the ante 100
houlajk: posts small blind 700
dracko307: posts big blind 1400
*** HOLE CARDS ***
Dealt to jcarlos.vale [Th 8c]
peio123 has timed out
peio123: folds 
peio123 is sitting out
Dgo Sytrik: folds 
jcarlos.vale: folds 
angyal40: calls 1400
peio123 has returned
engel395: folds 
Baron Pulpo: calls 1400
kukbik: folds 
houlajk: calls 700
dracko307: checks 
*** FLOP *** [Ad Jh 9c]
houlajk: checks 
dracko307: checks 
angyal40: checks 
Baron Pulpo: checks 
*** TURN *** [Ad Jh 9c] [Jd]
houlajk: checks 
dracko307: checks 
angyal40: checks 
Baron Pulpo: checks 
*** RIVER *** [Ad Jh 9c Jd] [9s]
houlajk: checks 
dracko307: checks 
angyal40: checks 
Baron Pulpo: bets 2925
houlajk: folds 
dracko307: folds 
angyal40: folds 
Uncalled bet (2925) returned to Baron Pulpo
Baron Pulpo collected 6500 from pot
*** SUMMARY ***
Total pot 6500 | Rake 0 
Board [Ad Jh 9c Jd 9s]
Seat 1: peio123 folded before Flop (didn't bet)
Seat 2: Dgo Sytrik folded before Flop (didn't bet)
Seat 3: jcarlos.vale folded before Flop (didn't bet)
Seat 4: angyal40 folded on the River
Seat 5: engel395 folded before Flop (didn't bet)
Seat 6: Baron Pulpo collected (6500)
Seat 7: kukbik (button) folded before Flop (didn't bet)
Seat 8: houlajk (small blind) folded on the River
Seat 9: dracko307 (big blind) folded on the River



PokerStars Hand #221919083845: Tournament #3082648141, $0.98+$0.12 USD Hold'em No Limit - Level XIX (700/1400) - 2020/12/27 23:26:51 EET [2020/12/27 16:26:51 ET]
Table '3082648141 47' 9-max Seat #8 is the button
Seat 1: peio123 (55239 in chips) 
Seat 2: Dgo Sytrik (41666 in chips) 
Seat 3: jcarlos.vale (37557 in chips) 
Seat 4: angyal40 (9462 in chips) 
Seat 5: engel395 (65786 in chips) 
Seat 6: Baron Pulpo (45159 in chips) 
Seat 7: kukbik (57039 in chips) 
Seat 8: houlajk (83441 in chips) 
Seat 9: dracko307 (58498 in chips) 
peio123: posts the ante 100
Dgo Sytrik: posts the ante 100
jcarlos.vale: posts the ante 100
angyal40: posts the ante 100
engel395: posts the ante 100
Baron Pulpo: posts the ante 100
kukbik: posts the ante 100
houlajk: posts the ante 100
dracko307: posts the ante 100
dracko307: posts small blind 700
peio123: posts big blind 1400
*** HOLE CARDS ***
Dealt to jcarlos.vale [2h 8d]
Dgo Sytrik: folds 
jcarlos.vale: folds 
angyal40: folds 
engel395: folds 
Baron Pulpo: folds 
kukbik: folds 
houlajk: raises 1400 to 2800
dracko307: calls 2100
peio123: folds 
*** FLOP *** [8s Th Ac]
dracko307: checks 
houlajk: bets 2607
dracko307: calls 2607
*** TURN *** [8s Th Ac] [6s]
dracko307: checks 
houlajk: checks 
*** RIVER *** [8s Th Ac 6s] [7c]
dracko307: bets 7082
houlajk: folds 
Uncalled bet (7082) returned to dracko307
dracko307 collected 13114 from pot
dracko307: doesn't show handDTO
*** SUMMARY ***
Total pot 13114 | Rake 0 
Board [8s Th Ac 6s 7c]
Seat 1: peio123 (big blind) folded before Flop
Seat 2: Dgo Sytrik folded before Flop (didn't bet)
Seat 3: jcarlos.vale folded before Flop (didn't bet)
Seat 4: angyal40 folded before Flop (didn't bet)
Seat 5: engel395 folded before Flop (didn't bet)
Seat 6: Baron Pulpo folded before Flop (didn't bet)
Seat 7: kukbik folded before Flop (didn't bet)
Seat 8: houlajk (button) folded on the River
Seat 9: dracko307 (small blind) collected (13114)



PokerStars Hand #221919175292: Tournament #3082648141, $0.98+$0.12 USD Hold'em No Limit - Level XIX (700/1400) - 2020/12/27 23:28:28 EET [2020/12/27 16:28:28 ET]
Table '3082648141 47' 9-max Seat #9 is the button
Seat 1: peio123 (53739 in chips) 
Seat 2: Dgo Sytrik (41566 in chips) 
Seat 3: jcarlos.vale (37457 in chips) 
Seat 4: angyal40 (9362 in chips) 
Seat 5: engel395 (65686 in chips) 
Seat 6: Baron Pulpo (45059 in chips) 
Seat 7: kukbik (56939 in chips) 
Seat 8: houlajk (77934 in chips) 
Seat 9: dracko307 (66105 in chips) 
peio123: posts the ante 100
Dgo Sytrik: posts the ante 100
jcarlos.vale: posts the ante 100
angyal40: posts the ante 100
engel395: posts the ante 100
Baron Pulpo: posts the ante 100
kukbik: posts the ante 100
houlajk: posts the ante 100
dracko307: posts the ante 100
peio123: posts small blind 700
Dgo Sytrik: posts big blind 1400
*** HOLE CARDS ***
Dealt to jcarlos.vale [Ks 6d]
jcarlos.vale: folds 
angyal40: folds 
engel395: folds 
Baron Pulpo: folds 
kukbik: folds 
houlajk: folds 
dracko307: folds 
peio123: folds 
peio123 is sitting out
Uncalled bet (700) returned to Dgo Sytrik
Dgo Sytrik collected 2300 from pot
Dgo Sytrik: doesn't show handDTO
*** SUMMARY ***
Total pot 2300 | Rake 0 
Seat 1: peio123 (small blind) folded before Flop
Seat 2: Dgo Sytrik (big blind) collected (2300)
Seat 3: jcarlos.vale folded before Flop (didn't bet)
Seat 4: angyal40 folded before Flop (didn't bet)
Seat 5: engel395 folded before Flop (didn't bet)
Seat 6: Baron Pulpo folded before Flop (didn't bet)
Seat 7: kukbik folded before Flop (didn't bet)
Seat 8: houlajk folded before Flop (didn't bet)
Seat 9: dracko307 (button) folded before Flop (didn't bet)



PokerStars Hand #221919203677: Tournament #3082648141, $0.98+$0.12 USD Hold'em No Limit - Level XIX (700/1400) - 2020/12/27 23:28:58 EET [2020/12/27 16:28:58 ET]
Table '3082648141 47' 9-max Seat #1 is the button
Seat 1: peio123 (52939 in chips) is sitting out
Seat 2: Dgo Sytrik (43066 in chips) 
Seat 3: jcarlos.vale (37357 in chips) 
Seat 4: angyal40 (9262 in chips) 
Seat 5: engel395 (65586 in chips) 
Seat 6: Baron Pulpo (44959 in chips) 
Seat 7: kukbik (56839 in chips) 
Seat 8: houlajk (77834 in chips) 
Seat 9: dracko307 (66005 in chips) 
peio123: posts the ante 100
Dgo Sytrik: posts the ante 100
jcarlos.vale: posts the ante 100
angyal40: posts the ante 100
engel395: posts the ante 100
Baron Pulpo: posts the ante 100
kukbik: posts the ante 100
houlajk: posts the ante 100
dracko307: posts the ante 100
Dgo Sytrik: posts small blind 700
jcarlos.vale: posts big blind 1400
*** HOLE CARDS ***
Dealt to jcarlos.vale [Qs 7d]
angyal40: folds 
engel395: folds 
Baron Pulpo: folds 
kukbik: raises 1400 to 2800
houlajk: folds 
dracko307: folds 
peio123: folds 
Dgo Sytrik: folds 
jcarlos.vale: folds 
Uncalled bet (1400) returned to kukbik
kukbik collected 4400 from pot
kukbik: doesn't show handDTO
*** SUMMARY ***
Total pot 4400 | Rake 0 
Seat 1: peio123 (button) folded before Flop (didn't bet)
Seat 2: Dgo Sytrik (small blind) folded before Flop
Seat 3: jcarlos.vale (big blind) folded before Flop
Seat 4: angyal40 folded before Flop (didn't bet)
Seat 5: engel395 folded before Flop (didn't bet)
Seat 6: Baron Pulpo folded before Flop (didn't bet)
Seat 7: kukbik collected (4400)
Seat 8: houlajk folded before Flop (didn't bet)
Seat 9: dracko307 folded before Flop (didn't bet)



PokerStars Hand #221919220337: Tournament #3082648141, $0.98+$0.12 USD Hold'em No Limit - Level XIX (700/1400) - 2020/12/27 23:29:16 EET [2020/12/27 16:29:16 ET]
Table '3082648141 47' 9-max Seat #2 is the button
Seat 1: peio123 (52839 in chips) is sitting out
Seat 2: Dgo Sytrik (42266 in chips) 
Seat 3: jcarlos.vale (35857 in chips) 
Seat 4: angyal40 (9162 in chips) 
Seat 5: engel395 (65486 in chips) 
Seat 6: Baron Pulpo (44859 in chips) 
Seat 7: kukbik (59739 in chips) 
Seat 8: houlajk (77734 in chips) 
Seat 9: dracko307 (65905 in chips) 
peio123: posts the ante 100
Dgo Sytrik: posts the ante 100
jcarlos.vale: posts the ante 100
angyal40: posts the ante 100
engel395: posts the ante 100
Baron Pulpo: posts the ante 100
kukbik: posts the ante 100
houlajk: posts the ante 100
dracko307: posts the ante 100
jcarlos.vale: posts small blind 700
angyal40: posts big blind 1400
*** HOLE CARDS ***
Dealt to jcarlos.vale [6c 4d]
engel395: folds 
Baron Pulpo: folds 
kukbik: folds 
houlajk: folds 
dracko307: folds 
peio123: folds 
Dgo Sytrik: folds 
jcarlos.vale: raises 2240 to 3640
angyal40: folds 
Uncalled bet (2240) returned to jcarlos.vale
jcarlos.vale collected 3700 from pot
jcarlos.vale: doesn't show handDTO
*** SUMMARY ***
Total pot 3700 | Rake 0 
Seat 1: peio123 folded before Flop (didn't bet)
Seat 2: Dgo Sytrik (button) folded before Flop (didn't bet)
Seat 3: jcarlos.vale (small blind) collected (3700)
Seat 4: angyal40 (big blind) folded before Flop
Seat 5: engel395 folded before Flop (didn't bet)
Seat 6: Baron Pulpo folded before Flop (didn't bet)
Seat 7: kukbik folded before Flop (didn't bet)
Seat 8: houlajk folded before Flop (didn't bet)
Seat 9: dracko307 folded before Flop (didn't bet)



PokerStars Hand #221919242170: Tournament #3082648141, $0.98+$0.12 USD Hold'em No Limit - Level XIX (700/1400) - 2020/12/27 23:29:39 EET [2020/12/27 16:29:39 ET]
Table '3082648141 47' 9-max Seat #3 is the button
Seat 1: peio123 (52739 in chips) is sitting out
Seat 2: Dgo Sytrik (42166 in chips) 
Seat 3: jcarlos.vale (38057 in chips) 
Seat 4: angyal40 (7662 in chips) 
Seat 5: engel395 (65386 in chips) 
Seat 6: Baron Pulpo (44759 in chips) 
Seat 7: kukbik (59639 in chips) 
Seat 8: houlajk (77634 in chips) 
Seat 9: dracko307 (65805 in chips) 
peio123: posts the ante 100
Dgo Sytrik: posts the ante 100
jcarlos.vale: posts the ante 100
angyal40: posts the ante 100
engel395: posts the ante 100
Baron Pulpo: posts the ante 100
kukbik: posts the ante 100
houlajk: posts the ante 100
dracko307: posts the ante 100
angyal40: posts small blind 700
engel395: posts big blind 1400
*** HOLE CARDS ***
Dealt to jcarlos.vale [5d As]
Baron Pulpo: folds 
kukbik: folds 
houlajk: raises 1540 to 2940
dracko307: folds 
peio123: folds 
Dgo Sytrik: folds 
jcarlos.vale: folds 
angyal40: folds 
engel395: folds 
Uncalled bet (1540) returned to houlajk
houlajk collected 4400 from pot
houlajk: doesn't show handDTO
*** SUMMARY ***
Total pot 4400 | Rake 0 
Seat 1: peio123 folded before Flop (didn't bet)
Seat 2: Dgo Sytrik folded before Flop (didn't bet)
Seat 3: jcarlos.vale (button) folded before Flop (didn't bet)
Seat 4: angyal40 (small blind) folded before Flop
Seat 5: engel395 (big blind) folded before Flop
Seat 6: Baron Pulpo folded before Flop (didn't bet)
Seat 7: kukbik folded before Flop (didn't bet)
Seat 8: houlajk collected (4400)
Seat 9: dracko307 folded before Flop (didn't bet)



PokerStars Hand #221919264889: Tournament #3082648141, $0.98+$0.12 USD Hold'em No Limit - Level XIX (700/1400) - 2020/12/27 23:30:03 EET [2020/12/27 16:30:03 ET]
Table '3082648141 47' 9-max Seat #4 is the button
Seat 1: peio123 (52639 in chips) is sitting out
Seat 2: Dgo Sytrik (42066 in chips) 
Seat 3: jcarlos.vale (37957 in chips) 
Seat 4: angyal40 (6862 in chips) 
Seat 5: engel395 (63886 in chips) 
Seat 6: Baron Pulpo (44659 in chips) 
Seat 7: kukbik (59539 in chips) 
Seat 8: houlajk (80534 in chips) 
Seat 9: dracko307 (65705 in chips) 
peio123: posts the ante 100
Dgo Sytrik: posts the ante 100
jcarlos.vale: posts the ante 100
angyal40: posts the ante 100
engel395: posts the ante 100
Baron Pulpo: posts the ante 100
kukbik: posts the ante 100
houlajk: posts the ante 100
dracko307: posts the ante 100
engel395: posts small blind 700
Baron Pulpo: posts big blind 1400
*** HOLE CARDS ***
Dealt to jcarlos.vale [9h Kh]
kukbik: folds 
houlajk: raises 1540 to 2940
dracko307: folds 
peio123: folds 
Dgo Sytrik: folds 
jcarlos.vale: folds 
angyal40: folds 
engel395: folds 
Baron Pulpo: calls 1540
*** FLOP *** [7d 4s 6h]
Baron Pulpo: checks 
houlajk: bets 3740
Baron Pulpo: raises 4937 to 8677
houlajk: calls 4937
*** TURN *** [7d 4s 6h] [9s]
Baron Pulpo: bets 11175
houlajk: calls 11175
*** RIVER *** [7d 4s 6h 9s] [Td]
Baron Pulpo: bets 21767 and is all-in
houlajk: folds 
Uncalled bet (21767) returned to Baron Pulpo
Baron Pulpo collected 47184 from pot
*** SUMMARY ***
Total pot 47184 | Rake 0 
Board [7d 4s 6h 9s Td]
Seat 1: peio123 folded before Flop (didn't bet)
Seat 2: Dgo Sytrik folded before Flop (didn't bet)
Seat 3: jcarlos.vale folded before Flop (didn't bet)
Seat 4: angyal40 (button) folded before Flop (didn't bet)
Seat 5: engel395 (small blind) folded before Flop
Seat 6: Baron Pulpo (big blind) collected (47184)
Seat 7: kukbik folded before Flop (didn't bet)
Seat 8: houlajk folded on the River
Seat 9: dracko307 folded before Flop (didn't bet)



PokerStars Hand #221919376683: Tournament #3082648141, $0.98+$0.12 USD Hold'em No Limit - Level XIX (700/1400) - 2020/12/27 23:31:54 EET [2020/12/27 16:31:54 ET]
Table '3082648141 47' 9-max Seat #5 is the button
Seat 1: peio123 (52539 in chips) is sitting out
Seat 2: Dgo Sytrik (41966 in chips) 
Seat 3: jcarlos.vale (37857 in chips) 
Seat 4: angyal40 (6762 in chips) 
Seat 5: engel395 (63086 in chips) 
Seat 6: Baron Pulpo (68951 in chips) 
Seat 7: kukbik (59439 in chips) 
Seat 8: houlajk (57642 in chips) 
Seat 9: dracko307 (65605 in chips) 
peio123: posts the ante 100
Dgo Sytrik: posts the ante 100
jcarlos.vale: posts the ante 100
angyal40: posts the ante 100
engel395: posts the ante 100
Baron Pulpo: posts the ante 100
kukbik: posts the ante 100
houlajk: posts the ante 100
dracko307: posts the ante 100
Baron Pulpo: posts small blind 700
kukbik: posts big blind 1400
*** HOLE CARDS ***
Dealt to jcarlos.vale [Ts 3s]
houlajk: folds 
dracko307: folds 
peio123: folds 
Dgo Sytrik: folds 
jcarlos.vale: folds 
angyal40: folds 
engel395: folds 
Baron Pulpo: folds 
Uncalled bet (700) returned to kukbik
kukbik collected 2300 from pot
kukbik: doesn't show handDTO
*** SUMMARY ***
Total pot 2300 | Rake 0 
Seat 1: peio123 folded before Flop (didn't bet)
Seat 2: Dgo Sytrik folded before Flop (didn't bet)
Seat 3: jcarlos.vale folded before Flop (didn't bet)
Seat 4: angyal40 folded before Flop (didn't bet)
Seat 5: engel395 (button) folded before Flop (didn't bet)
Seat 6: Baron Pulpo (small blind) folded before Flop
Seat 7: kukbik (big blind) collected (2300)
Seat 8: houlajk folded before Flop (didn't bet)
Seat 9: dracko307 folded before Flop (didn't bet)



PokerStars Hand #221919398190: Tournament #3082648141, $0.98+$0.12 USD Hold'em No Limit - Level XX (800/1600) - 2020/12/27 23:32:17 EET [2020/12/27 16:32:17 ET]
Table '3082648141 47' 9-max Seat #6 is the button
Seat 1: peio123 (52439 in chips) is sitting out
Seat 2: Dgo Sytrik (41866 in chips) 
Seat 3: jcarlos.vale (37757 in chips) 
Seat 4: angyal40 (6662 in chips) 
Seat 5: engel395 (62986 in chips) 
Seat 6: Baron Pulpo (68151 in chips) 
Seat 7: kukbik (60939 in chips) 
Seat 8: houlajk (57542 in chips) 
Seat 9: dracko307 (65505 in chips) 
peio123: posts the ante 125
Dgo Sytrik: posts the ante 125
jcarlos.vale: posts the ante 125
angyal40: posts the ante 125
engel395: posts the ante 125
Baron Pulpo: posts the ante 125
kukbik: posts the ante 125
houlajk: posts the ante 125
dracko307: posts the ante 125
kukbik: posts small blind 800
houlajk: posts big blind 1600
*** HOLE CARDS ***
Dealt to jcarlos.vale [Jh Tc]
dracko307: folds 
peio123: folds 
Dgo Sytrik: raises 3200 to 4800
jcarlos.vale: folds 
angyal40: folds 
engel395: folds 
Baron Pulpo: folds 
kukbik: folds 
houlajk: calls 3200
*** FLOP *** [9h 2s 2h]
houlajk: checks 
peio123 has returned
Dgo Sytrik: bets 6400
houlajk: folds 
Uncalled bet (6400) returned to Dgo Sytrik
Dgo Sytrik collected 11525 from pot
*** SUMMARY ***
Total pot 11525 | Rake 0 
Board [9h 2s 2h]
Seat 1: peio123 folded before Flop (didn't bet)
Seat 2: Dgo Sytrik collected (11525)
Seat 3: jcarlos.vale folded before Flop (didn't bet)
Seat 4: angyal40 folded before Flop (didn't bet)
Seat 5: engel395 folded before Flop (didn't bet)
Seat 6: Baron Pulpo (button) folded before Flop (didn't bet)
Seat 7: kukbik (small blind) folded before Flop
Seat 8: houlajk (big blind) folded on the Flop
Seat 9: dracko307 folded before Flop (didn't bet)



PokerStars Hand #221919455965: Tournament #3082648141, $0.98+$0.12 USD Hold'em No Limit - Level XX (800/1600) - 2020/12/27 23:33:18 EET [2020/12/27 16:33:18 ET]
Table '3082648141 47' 9-max Seat #7 is the button
Seat 1: peio123 (52314 in chips) 
Seat 2: Dgo Sytrik (48466 in chips) 
Seat 3: jcarlos.vale (37632 in chips) 
Seat 4: angyal40 (6537 in chips) 
Seat 5: engel395 (62861 in chips) 
Seat 6: Baron Pulpo (68026 in chips) 
Seat 7: kukbik (60014 in chips) 
Seat 8: houlajk (52617 in chips) 
Seat 9: dracko307 (65380 in chips) 
peio123: posts the ante 125
Dgo Sytrik: posts the ante 125
jcarlos.vale: posts the ante 125
angyal40: posts the ante 125
engel395: posts the ante 125
Baron Pulpo: posts the ante 125
kukbik: posts the ante 125
houlajk: posts the ante 125
dracko307: posts the ante 125
houlajk: posts small blind 800
dracko307: posts big blind 1600
*** HOLE CARDS ***
Dealt to jcarlos.vale [5d Jc]
peio123: folds 
Dgo Sytrik: folds 
jcarlos.vale: folds 
angyal40: folds 
engel395: folds 
Baron Pulpo: raises 1760 to 3360
kukbik: folds 
houlajk: folds 
dracko307: calls 1760
*** FLOP *** [7c 4h Qc]
dracko307: checks 
Baron Pulpo: bets 2853
dracko307: folds 
Uncalled bet (2853) returned to Baron Pulpo
Baron Pulpo collected 8645 from pot
*** SUMMARY ***
Total pot 8645 | Rake 0 
Board [7c 4h Qc]
Seat 1: peio123 folded before Flop (didn't bet)
Seat 2: Dgo Sytrik folded before Flop (didn't bet)
Seat 3: jcarlos.vale folded before Flop (didn't bet)
Seat 4: angyal40 folded before Flop (didn't bet)
Seat 5: engel395 folded before Flop (didn't bet)
Seat 6: Baron Pulpo collected (8645)
Seat 7: kukbik (button) folded before Flop (didn't bet)
Seat 8: houlajk (small blind) folded before Flop
Seat 9: dracko307 (big blind) folded on the Flop



PokerStars Hand #221919499278: Tournament #3082648141, $0.98+$0.12 USD Hold'em No Limit - Level XX (800/1600) - 2020/12/27 23:34:04 EET [2020/12/27 16:34:04 ET]
Table '3082648141 47' 9-max Seat #8 is the button
Seat 1: peio123 (52189 in chips) 
Seat 2: Dgo Sytrik (48341 in chips) 
Seat 3: jcarlos.vale (37507 in chips) 
Seat 4: angyal40 (6412 in chips) 
Seat 5: engel395 (62736 in chips) 
Seat 6: Baron Pulpo (73186 in chips) 
Seat 7: kukbik (59889 in chips) 
Seat 8: houlajk (51692 in chips) 
Seat 9: dracko307 (61895 in chips) 
peio123: posts the ante 125
Dgo Sytrik: posts the ante 125
jcarlos.vale: posts the ante 125
angyal40: posts the ante 125
engel395: posts the ante 125
Baron Pulpo: posts the ante 125
kukbik: posts the ante 125
houlajk: posts the ante 125
dracko307: posts the ante 125
dracko307: posts small blind 800
peio123: posts big blind 1600
*** HOLE CARDS ***
Dealt to jcarlos.vale [Kc 3h]
Dgo Sytrik: folds 
jcarlos.vale: folds 
angyal40: folds 
engel395: folds 
Baron Pulpo: folds 
kukbik: folds 
houlajk: folds 
dracko307: calls 800
peio123: checks 
*** FLOP *** [9s 3s Jc]
dracko307: bets 1600
peio123: folds 
Uncalled bet (1600) returned to dracko307
dracko307 collected 4325 from pot
dracko307: doesn't show handDTO
*** SUMMARY ***
Total pot 4325 | Rake 0 
Board [9s 3s Jc]
Seat 1: peio123 (big blind) folded on the Flop
Seat 2: Dgo Sytrik folded before Flop (didn't bet)
Seat 3: jcarlos.vale folded before Flop (didn't bet)
Seat 4: angyal40 folded before Flop (didn't bet)
Seat 5: engel395 folded before Flop (didn't bet)
Seat 6: Baron Pulpo folded before Flop (didn't bet)
Seat 7: kukbik folded before Flop (didn't bet)
Seat 8: houlajk (button) folded before Flop (didn't bet)
Seat 9: dracko307 (small blind) collected (4325)



PokerStars Hand #221919529528: Tournament #3082648141, $0.98+$0.12 USD Hold'em No Limit - Level XX (800/1600) - 2020/12/27 23:34:36 EET [2020/12/27 16:34:36 ET]
Table '3082648141 47' 9-max Seat #9 is the button
Seat 1: peio123 (50464 in chips) 
Seat 2: Dgo Sytrik (48216 in chips) 
Seat 3: jcarlos.vale (37382 in chips) 
Seat 4: angyal40 (6287 in chips) 
Seat 5: engel395 (62611 in chips) 
Seat 6: Baron Pulpo (73061 in chips) 
Seat 7: kukbik (59764 in chips) 
Seat 8: houlajk (51567 in chips) 
Seat 9: dracko307 (64495 in chips) 
peio123: posts the ante 125
Dgo Sytrik: posts the ante 125
jcarlos.vale: posts the ante 125
angyal40: posts the ante 125
engel395: posts the ante 125
Baron Pulpo: posts the ante 125
kukbik: posts the ante 125
houlajk: posts the ante 125
dracko307: posts the ante 125
peio123: posts small blind 800
Dgo Sytrik: posts big blind 1600
*** HOLE CARDS ***
Dealt to jcarlos.vale [6h 5d]
jcarlos.vale: folds 
angyal40: folds 
engel395: folds 
Baron Pulpo: folds 
kukbik: folds 
houlajk: folds 
dracko307: calls 1600
peio123: calls 800
Dgo Sytrik: checks 
*** FLOP *** [9h 8d Kh]
peio123: checks 
Dgo Sytrik: bets 2400
dracko307: calls 2400
peio123: calls 2400
*** TURN *** [9h 8d Kh] [2h]
peio123: checks 
Dgo Sytrik: checks 
dracko307: checks 
*** RIVER *** [9h 8d Kh 2h] [Qh]
peio123: checks 
Dgo Sytrik: checks 
dracko307: checks 
*** SHOW DOWN ***
peio123: shows [Kc Jc] (a pair of Kings)
Dgo Sytrik: shows [7h Ks] (a flush, King high)
dracko307: mucks handDTO
Dgo Sytrik collected 13125 from pot
*** SUMMARY ***
Total pot 13125 | Rake 0 
Board [9h 8d Kh 2h Qh]
Seat 1: peio123 (small blind) showed [Kc Jc] and lost with a pair of Kings
Seat 2: Dgo Sytrik (big blind) showed [7h Ks] and won (13125) with a flush, King high
Seat 3: jcarlos.vale folded before Flop (didn't bet)
Seat 4: angyal40 folded before Flop (didn't bet)
Seat 5: engel395 folded before Flop (didn't bet)
Seat 6: Baron Pulpo folded before Flop (didn't bet)
Seat 7: kukbik folded before Flop (didn't bet)
Seat 8: houlajk folded before Flop (didn't bet)
Seat 9: dracko307 (button) mucked [8s Td]



PokerStars Hand #221919612623: Tournament #3082648141, $0.98+$0.12 USD Hold'em No Limit - Level XX (800/1600) - 2020/12/27 23:35:55 EET [2020/12/27 16:35:55 ET]
Table '3082648141 47' 9-max Seat #1 is the button
Seat 1: peio123 (46339 in chips) 
Seat 2: Dgo Sytrik (57216 in chips) 
Seat 3: jcarlos.vale (37257 in chips) 
Seat 4: angyal40 (6162 in chips) 
Seat 5: engel395 (62486 in chips) 
Seat 6: Baron Pulpo (72936 in chips) 
Seat 7: kukbik (59639 in chips) 
Seat 8: houlajk (51442 in chips) 
Seat 9: dracko307 (60370 in chips) 
peio123: posts the ante 125
Dgo Sytrik: posts the ante 125
jcarlos.vale: posts the ante 125
angyal40: posts the ante 125
engel395: posts the ante 125
Baron Pulpo: posts the ante 125
kukbik: posts the ante 125
houlajk: posts the ante 125
dracko307: posts the ante 125
Dgo Sytrik: posts small blind 800
jcarlos.vale: posts big blind 1600
*** HOLE CARDS ***
Dealt to jcarlos.vale [8c 7s]
angyal40: folds 
engel395: folds 
Baron Pulpo: folds 
kukbik: raises 1600 to 3200
houlajk: folds 
dracko307: folds 
peio123: folds 
Dgo Sytrik: folds 
jcarlos.vale: folds 
Uncalled bet (1600) returned to kukbik
kukbik collected 5125 from pot
kukbik: doesn't show handDTO
*** SUMMARY ***
Total pot 5125 | Rake 0 
Seat 1: peio123 (button) folded before Flop (didn't bet)
Seat 2: Dgo Sytrik (small blind) folded before Flop
Seat 3: jcarlos.vale (big blind) folded before Flop
Seat 4: angyal40 folded before Flop (didn't bet)
Seat 5: engel395 folded before Flop (didn't bet)
Seat 6: Baron Pulpo folded before Flop (didn't bet)
Seat 7: kukbik collected (5125)
Seat 8: houlajk folded before Flop (didn't bet)
Seat 9: dracko307 folded before Flop (didn't bet)



PokerStars Hand #221919633978: Tournament #3082648141, $0.98+$0.12 USD Hold'em No Limit - Level XX (800/1600) - 2020/12/27 23:36:18 EET [2020/12/27 16:36:18 ET]
Table '3082648141 47' 9-max Seat #2 is the button
Seat 1: peio123 (46214 in chips) 
Seat 2: Dgo Sytrik (56291 in chips) 
Seat 3: jcarlos.vale (35532 in chips) 
Seat 4: angyal40 (6037 in chips) 
Seat 5: engel395 (62361 in chips) 
Seat 6: Baron Pulpo (72811 in chips) 
Seat 7: kukbik (63039 in chips) 
Seat 8: houlajk (51317 in chips) 
Seat 9: dracko307 (60245 in chips) 
peio123: posts the ante 125
Dgo Sytrik: posts the ante 125
jcarlos.vale: posts the ante 125
angyal40: posts the ante 125
engel395: posts the ante 125
Baron Pulpo: posts the ante 125
kukbik: posts the ante 125
houlajk: posts the ante 125
dracko307: posts the ante 125
jcarlos.vale: posts small blind 800
angyal40: posts big blind 1600
*** HOLE CARDS ***
Dealt to jcarlos.vale [8h Jc]
engel395: folds 
Baron Pulpo: folds 
kukbik: folds 
houlajk: folds 
dracko307: raises 1840 to 3440
peio123: calls 3440
Dgo Sytrik: raises 4560 to 8000
jcarlos.vale: folds 
angyal40: folds 
dracko307: calls 4560
peio123: calls 4560
*** FLOP *** [3d 7s Kh]
dracko307: checks 
peio123: bets 38089 and is all-in
Dgo Sytrik: folds 
dracko307: folds 
Uncalled bet (38089) returned to peio123
peio123 collected 27525 from pot
*** SUMMARY ***
Total pot 27525 | Rake 0 
Board [3d 7s Kh]
Seat 1: peio123 collected (27525)
Seat 2: Dgo Sytrik (button) folded on the Flop
Seat 3: jcarlos.vale (small blind) folded before Flop
Seat 4: angyal40 (big blind) folded before Flop
Seat 5: engel395 folded before Flop (didn't bet)
Seat 6: Baron Pulpo folded before Flop (didn't bet)
Seat 7: kukbik folded before Flop (didn't bet)
Seat 8: houlajk folded before Flop (didn't bet)
Seat 9: dracko307 folded on the Flop



PokerStars Hand #221919677417: Tournament #3082648141, $0.98+$0.12 USD Hold'em No Limit - Level XX (800/1600) - 2020/12/27 23:37:05 EET [2020/12/27 16:37:05 ET]
Table '3082648141 47' 9-max Seat #3 is the button
Seat 1: peio123 (65614 in chips) 
Seat 2: Dgo Sytrik (48166 in chips) 
Seat 3: jcarlos.vale (34607 in chips) 
Seat 4: angyal40 (4312 in chips) 
Seat 5: engel395 (62236 in chips) 
Seat 6: Baron Pulpo (72686 in chips) 
Seat 7: kukbik (62914 in chips) 
Seat 8: houlajk (51192 in chips) 
Seat 9: dracko307 (52120 in chips) 
peio123: posts the ante 125
Dgo Sytrik: posts the ante 125
jcarlos.vale: posts the ante 125
angyal40: posts the ante 125
engel395: posts the ante 125
Baron Pulpo: posts the ante 125
kukbik: posts the ante 125
houlajk: posts the ante 125
dracko307: posts the ante 125
angyal40: posts small blind 800
engel395: posts big blind 1600
*** HOLE CARDS ***
Dealt to jcarlos.vale [5s Qc]
Baron Pulpo: folds 
kukbik: raises 1600 to 3200
houlajk: raises 6400 to 9600
dracko307: folds 
peio123: folds 
Dgo Sytrik: folds 
jcarlos.vale: folds 
angyal40: folds 
engel395: folds 
kukbik: calls 6400
*** FLOP *** [Qd Jd 9d]
kukbik: checks 
houlajk: checks 
*** TURN *** [Qd Jd 9d] [Js]
kukbik: checks 
houlajk: checks 
*** RIVER *** [Qd Jd 9d Js] [8s]
kukbik: checks 
houlajk: checks 
*** SHOW DOWN ***
kukbik: shows [Ks Ah] (a pair of Jacks)
houlajk: shows [Kc As] (a pair of Jacks)
kukbik collected 11363 from pot
houlajk collected 11362 from pot
*** SUMMARY ***
Total pot 22725 | Rake 0 
Board [Qd Jd 9d Js 8s]
Seat 1: peio123 folded before Flop (didn't bet)
Seat 2: Dgo Sytrik folded before Flop (didn't bet)
Seat 3: jcarlos.vale (button) folded before Flop (didn't bet)
Seat 4: angyal40 (small blind) folded before Flop
Seat 5: engel395 (big blind) folded before Flop
Seat 6: Baron Pulpo folded before Flop (didn't bet)
Seat 7: kukbik showed [Ks Ah] and won (11363) with a pair of Jacks
Seat 8: houlajk showed [Kc As] and won (11362) with a pair of Jacks
Seat 9: dracko307 folded before Flop (didn't bet)



PokerStars Hand #221919747084: Tournament #3082648141, $0.98+$0.12 USD Hold'em No Limit - Level XX (800/1600) - 2020/12/27 23:38:20 EET [2020/12/27 16:38:20 ET]
Table '3082648141 47' 9-max Seat #4 is the button
Seat 1: peio123 (65489 in chips) 
Seat 2: Dgo Sytrik (48041 in chips) 
Seat 3: jcarlos.vale (34482 in chips) 
Seat 4: angyal40 (3387 in chips) 
Seat 5: engel395 (60511 in chips) 
Seat 6: Baron Pulpo (72561 in chips) 
Seat 7: kukbik (64552 in chips) 
Seat 8: houlajk (52829 in chips) 
Seat 9: dracko307 (51995 in chips) 
peio123: posts the ante 125
Dgo Sytrik: posts the ante 125
jcarlos.vale: posts the ante 125
angyal40: posts the ante 125
engel395: posts the ante 125
Baron Pulpo: posts the ante 125
kukbik: posts the ante 125
houlajk: posts the ante 125
dracko307: posts the ante 125
engel395: posts small blind 800
Baron Pulpo: posts big blind 1600
*** HOLE CARDS ***
Dealt to jcarlos.vale [3h 2c]
kukbik: folds 
houlajk: folds 
dracko307: folds 
peio123: folds 
Dgo Sytrik: folds 
jcarlos.vale: folds 
angyal40: raises 1662 to 3262 and is all-in
engel395: folds 
Baron Pulpo: calls 1662
*** FLOP *** [7h As Jh]
*** TURN *** [7h As Jh] [Qc]
*** RIVER *** [7h As Jh Qc] [2d]
*** SHOW DOWN ***
Baron Pulpo: shows [Ah 5c] (a pair of Aces)
angyal40: shows [Th Ac] (a pair of Aces - Queen+Jack+Ten kicker)
angyal40 collected 8449 from pot
*** SUMMARY ***
Total pot 8449 | Rake 0 
Board [7h As Jh Qc 2d]
Seat 1: peio123 folded before Flop (didn't bet)
Seat 2: Dgo Sytrik folded before Flop (didn't bet)
Seat 3: jcarlos.vale folded before Flop (didn't bet)
Seat 4: angyal40 (button) showed [Th Ac] and won (8449) with a pair of Aces
Seat 5: engel395 (small blind) folded before Flop
Seat 6: Baron Pulpo (big blind) showed [Ah 5c] and lost with a pair of Aces
Seat 7: kukbik folded before Flop (didn't bet)
Seat 8: houlajk folded before Flop (didn't bet)
Seat 9: dracko307 folded before Flop (didn't bet)



PokerStars Hand #221919772061: Tournament #3082648141, $0.98+$0.12 USD Hold'em No Limit - Level XX (800/1600) - 2020/12/27 23:38:47 EET [2020/12/27 16:38:47 ET]
Table '3082648141 47' 9-max Seat #5 is the button
Seat 1: peio123 (65364 in chips) 
Seat 2: Dgo Sytrik (47916 in chips) 
Seat 3: jcarlos.vale (34357 in chips) 
Seat 4: angyal40 (8449 in chips) 
Seat 5: engel395 (59586 in chips) 
Seat 6: Baron Pulpo (69174 in chips) 
Seat 7: kukbik (64427 in chips) 
Seat 8: houlajk (52704 in chips) 
Seat 9: dracko307 (51870 in chips) 
peio123: posts the ante 125
Dgo Sytrik: posts the ante 125
jcarlos.vale: posts the ante 125
angyal40: posts the ante 125
engel395: posts the ante 125
Baron Pulpo: posts the ante 125
kukbik: posts the ante 125
houlajk: posts the ante 125
dracko307: posts the ante 125
Baron Pulpo: posts small blind 800
kukbik: posts big blind 1600
*** HOLE CARDS ***
Dealt to jcarlos.vale [4d 7d]
houlajk: folds 
dracko307: folds 
peio123: folds 
Dgo Sytrik: folds 
jcarlos.vale: raises 2560 to 4160
angyal40: folds 
engel395: folds 
Baron Pulpo: folds 
kukbik: calls 2560
*** FLOP *** [Jc 2d Qh]
kukbik: checks 
jcarlos.vale: bets 3200
kukbik: calls 3200
*** TURN *** [Jc 2d Qh] [Tc]
kukbik: checks 
jcarlos.vale: checks 
*** RIVER *** [Jc 2d Qh Tc] [6h]
kukbik: checks 
jcarlos.vale: checks 
*** SHOW DOWN ***
kukbik: shows [Jh Ad] (a pair of Jacks)
jcarlos.vale: mucks handDTO
kukbik collected 16645 from pot
*** SUMMARY ***
Total pot 16645 | Rake 0 
Board [Jc 2d Qh Tc 6h]
Seat 1: peio123 folded before Flop (didn't bet)
Seat 2: Dgo Sytrik folded before Flop (didn't bet)
Seat 3: jcarlos.vale mucked [4d 7d]
Seat 4: angyal40 folded before Flop (didn't bet)
Seat 5: engel395 (button) folded before Flop (didn't bet)
Seat 6: Baron Pulpo (small blind) folded before Flop
Seat 7: kukbik (big blind) showed [Jh Ad] and won (16645) with a pair of Jacks
Seat 8: houlajk folded before Flop (didn't bet)
Seat 9: dracko307 folded before Flop (didn't bet)



PokerStars Hand #221919815240: Tournament #3082648141, $0.98+$0.12 USD Hold'em No Limit - Level XX (800/1600) - 2020/12/27 23:39:34 EET [2020/12/27 16:39:34 ET]
Table '3082648141 47' 9-max Seat #6 is the button
Seat 1: peio123 (65239 in chips) 
Seat 2: Dgo Sytrik (47791 in chips) 
Seat 3: jcarlos.vale (26872 in chips) 
Seat 4: angyal40 (8324 in chips) 
Seat 5: engel395 (59461 in chips) 
Seat 6: Baron Pulpo (68249 in chips) 
Seat 7: kukbik (73587 in chips) 
Seat 8: houlajk (52579 in chips) 
Seat 9: dracko307 (51745 in chips) 
peio123: posts the ante 125
Dgo Sytrik: posts the ante 125
jcarlos.vale: posts the ante 125
angyal40: posts the ante 125
engel395: posts the ante 125
Baron Pulpo: posts the ante 125
kukbik: posts the ante 125
houlajk: posts the ante 125
dracko307: posts the ante 125
kukbik: posts small blind 800
houlajk: posts big blind 1600
*** HOLE CARDS ***
Dealt to jcarlos.vale [9d 8c]
dracko307: folds 
peio123: folds 
Dgo Sytrik: folds 
jcarlos.vale: folds 
angyal40: folds 
engel395: folds 
Baron Pulpo: folds 
kukbik: calls 800
houlajk: raises 4000 to 5600
kukbik: folds 
Uncalled bet (4000) returned to houlajk
houlajk collected 4325 from pot
houlajk: doesn't show handDTO
*** SUMMARY ***
Total pot 4325 | Rake 0 
Seat 1: peio123 folded before Flop (didn't bet)
Seat 2: Dgo Sytrik folded before Flop (didn't bet)
Seat 3: jcarlos.vale folded before Flop (didn't bet)
Seat 4: angyal40 folded before Flop (didn't bet)
Seat 5: engel395 folded before Flop (didn't bet)
Seat 6: Baron Pulpo (button) folded before Flop (didn't bet)
Seat 7: kukbik (small blind) folded before Flop
Seat 8: houlajk (big blind) collected (4325)
Seat 9: dracko307 folded before Flop (didn't bet)



PokerStars Hand #221919847705: Tournament #3082648141, $0.98+$0.12 USD Hold'em No Limit - Level XX (800/1600) - 2020/12/27 23:40:09 EET [2020/12/27 16:40:09 ET]
Table '3082648141 47' 9-max Seat #7 is the button
Seat 1: peio123 (65114 in chips) 
Seat 2: Dgo Sytrik (47666 in chips) 
Seat 3: jcarlos.vale (26747 in chips) 
Seat 4: angyal40 (8199 in chips) 
Seat 5: engel395 (59336 in chips) 
Seat 6: Baron Pulpo (68124 in chips) 
Seat 7: kukbik (71862 in chips) 
Seat 8: houlajk (55179 in chips) 
Seat 9: dracko307 (51620 in chips) 
peio123: posts the ante 125
Dgo Sytrik: posts the ante 125
jcarlos.vale: posts the ante 125
angyal40: posts the ante 125
engel395: posts the ante 125
Baron Pulpo: posts the ante 125
kukbik: posts the ante 125
houlajk: posts the ante 125
dracko307: posts the ante 125
houlajk: posts small blind 800
dracko307: posts big blind 1600
*** HOLE CARDS ***
Dealt to jcarlos.vale [3s 4c]
peio123: raises 1600 to 3200
Dgo Sytrik: folds 
jcarlos.vale: folds 
angyal40: folds 
engel395: folds 
Baron Pulpo: folds 
kukbik: folds 
houlajk: folds 
dracko307: calls 1600
*** FLOP *** [Tc 3d 2s]
dracko307: checks 
peio123: checks 
*** TURN *** [Tc 3d 2s] [4d]
dracko307: bets 2581
peio123: calls 2581
*** RIVER *** [Tc 3d 2s 4d] [Jh]
dracko307: bets 7200
peio123: calls 7200
*** SHOW DOWN ***
dracko307: shows [9s 8h] (high pairOfCards Jack)
peio123: shows [Jc Ad] (a pair of Jacks)
peio123 collected 27887 from pot
*** SUMMARY ***
Total pot 27887 | Rake 0 
Board [Tc 3d 2s 4d Jh]
Seat 1: peio123 showed [Jc Ad] and won (27887) with a pair of Jacks
Seat 2: Dgo Sytrik folded before Flop (didn't bet)
Seat 3: jcarlos.vale folded before Flop (didn't bet)
Seat 4: angyal40 folded before Flop (didn't bet)
Seat 5: engel395 folded before Flop (didn't bet)
Seat 6: Baron Pulpo folded before Flop (didn't bet)
Seat 7: kukbik (button) folded before Flop (didn't bet)
Seat 8: houlajk (small blind) folded before Flop
Seat 9: dracko307 (big blind) showed [9s 8h] and lost with high pairOfCards Jack



PokerStars Hand #221919900077: Tournament #3082648141, $0.98+$0.12 USD Hold'em No Limit - Level XX (800/1600) - 2020/12/27 23:41:06 EET [2020/12/27 16:41:06 ET]
Table '3082648141 47' 9-max Seat #8 is the button
Seat 1: peio123 (79895 in chips) 
Seat 2: Dgo Sytrik (47541 in chips) 
Seat 3: jcarlos.vale (26622 in chips) 
Seat 4: angyal40 (8074 in chips) 
Seat 5: engel395 (59211 in chips) 
Seat 6: Baron Pulpo (67999 in chips) 
Seat 7: kukbik (71737 in chips) 
Seat 8: houlajk (54254 in chips) 
Seat 9: dracko307 (38514 in chips) 
peio123: posts the ante 125
Dgo Sytrik: posts the ante 125
jcarlos.vale: posts the ante 125
angyal40: posts the ante 125
engel395: posts the ante 125
Baron Pulpo: posts the ante 125
kukbik: posts the ante 125
houlajk: posts the ante 125
dracko307: posts the ante 125
dracko307: posts small blind 800
peio123: posts big blind 1600
*** HOLE CARDS ***
Dealt to jcarlos.vale [2c 3d]
Dgo Sytrik: folds 
jcarlos.vale: folds 
angyal40: folds 
engel395: folds 
Baron Pulpo: folds 
kukbik: folds 
houlajk: folds 
dracko307: folds 
Uncalled bet (800) returned to peio123
peio123 collected 2725 from pot
*** SUMMARY ***
Total pot 2725 | Rake 0 
Seat 1: peio123 (big blind) collected (2725)
Seat 2: Dgo Sytrik folded before Flop (didn't bet)
Seat 3: jcarlos.vale folded before Flop (didn't bet)
Seat 4: angyal40 folded before Flop (didn't bet)
Seat 5: engel395 folded before Flop (didn't bet)
Seat 6: Baron Pulpo folded before Flop (didn't bet)
Seat 7: kukbik folded before Flop (didn't bet)
Seat 8: houlajk (button) folded before Flop (didn't bet)
Seat 9: dracko307 (small blind) folded before Flop



PokerStars Hand #221919920595: Tournament #3082648141, $0.98+$0.12 USD Hold'em No Limit - Level XX (800/1600) - 2020/12/27 23:41:29 EET [2020/12/27 16:41:29 ET]
Table '3082648141 47' 9-max Seat #9 is the button
Seat 1: peio123 (81695 in chips) 
Seat 2: Dgo Sytrik (47416 in chips) 
Seat 3: jcarlos.vale (26497 in chips) 
Seat 4: angyal40 (7949 in chips) 
Seat 5: engel395 (59086 in chips) 
Seat 6: Baron Pulpo (67874 in chips) 
Seat 7: kukbik (71612 in chips) 
Seat 8: houlajk (54129 in chips) 
Seat 9: dracko307 (37589 in chips) 
peio123: posts the ante 125
Dgo Sytrik: posts the ante 125
jcarlos.vale: posts the ante 125
angyal40: posts the ante 125
engel395: posts the ante 125
Baron Pulpo: posts the ante 125
kukbik: posts the ante 125
houlajk: posts the ante 125
dracko307: posts the ante 125
peio123: posts small blind 800
Dgo Sytrik: posts big blind 1600
*** HOLE CARDS ***
Dealt to jcarlos.vale [Jh 5s]
jcarlos.vale: folds 
angyal40: folds 
engel395: folds 
Baron Pulpo: folds 
kukbik: folds 
houlajk: folds 
dracko307: folds 
peio123: raises 3200 to 4800
Dgo Sytrik: folds 
Uncalled bet (3200) returned to peio123
peio123 collected 4325 from pot
*** SUMMARY ***
Total pot 4325 | Rake 0 
Seat 1: peio123 (small blind) collected (4325)
Seat 2: Dgo Sytrik (big blind) folded before Flop
Seat 3: jcarlos.vale folded before Flop (didn't bet)
Seat 4: angyal40 folded before Flop (didn't bet)
Seat 5: engel395 folded before Flop (didn't bet)
Seat 6: Baron Pulpo folded before Flop (didn't bet)
Seat 7: kukbik folded before Flop (didn't bet)
Seat 8: houlajk folded before Flop (didn't bet)
Seat 9: dracko307 (button) folded before Flop (didn't bet)



PokerStars Hand #221919951922: Tournament #3082648141, $0.98+$0.12 USD Hold'em No Limit - Level XX (800/1600) - 2020/12/27 23:42:02 EET [2020/12/27 16:42:02 ET]
Table '3082648141 47' 9-max Seat #1 is the button
Seat 1: peio123 (84295 in chips) 
Seat 2: Dgo Sytrik (45691 in chips) 
Seat 3: jcarlos.vale (26372 in chips) 
Seat 4: angyal40 (7824 in chips) 
Seat 5: engel395 (58961 in chips) 
Seat 6: Baron Pulpo (67749 in chips) 
Seat 7: kukbik (71487 in chips) 
Seat 8: houlajk (54004 in chips) 
Seat 9: dracko307 (37464 in chips) 
peio123: posts the ante 125
Dgo Sytrik: posts the ante 125
jcarlos.vale: posts the ante 125
angyal40: posts the ante 125
engel395: posts the ante 125
Baron Pulpo: posts the ante 125
kukbik: posts the ante 125
houlajk: posts the ante 125
dracko307: posts the ante 125
Dgo Sytrik: posts small blind 800
jcarlos.vale: posts big blind 1600
*** HOLE CARDS ***
Dealt to jcarlos.vale [3c Ad]
angyal40: folds 
engel395: folds 
Baron Pulpo: raises 1760 to 3360
kukbik: folds 
houlajk: folds 
dracko307: folds 
peio123: folds 
Dgo Sytrik: folds 
jcarlos.vale: folds 
Uncalled bet (1760) returned to Baron Pulpo
Baron Pulpo collected 5125 from pot
*** SUMMARY ***
Total pot 5125 | Rake 0 
Seat 1: peio123 (button) folded before Flop (didn't bet)
Seat 2: Dgo Sytrik (small blind) folded before Flop
Seat 3: jcarlos.vale (big blind) folded before Flop
Seat 4: angyal40 folded before Flop (didn't bet)
Seat 5: engel395 folded before Flop (didn't bet)
Seat 6: Baron Pulpo collected (5125)
Seat 7: kukbik folded before Flop (didn't bet)
Seat 8: houlajk folded before Flop (didn't bet)
Seat 9: dracko307 folded before Flop (didn't bet)



PokerStars Hand #221919984911: Tournament #3082648141, $0.98+$0.12 USD Hold'em No Limit - Level XXI (900/1800) - 2020/12/27 23:42:38 EET [2020/12/27 16:42:38 ET]
Table '3082648141 47' 9-max Seat #2 is the button
Seat 1: peio123 (84170 in chips) 
Seat 2: Dgo Sytrik (44766 in chips) 
Seat 3: jcarlos.vale (24647 in chips) 
Seat 4: angyal40 (7699 in chips) 
Seat 5: engel395 (58836 in chips) 
Seat 6: Baron Pulpo (71149 in chips) 
Seat 7: kukbik (71362 in chips) 
Seat 8: houlajk (53879 in chips) 
Seat 9: dracko307 (37339 in chips) 
peio123: posts the ante 150
Dgo Sytrik: posts the ante 150
jcarlos.vale: posts the ante 150
angyal40: posts the ante 150
engel395: posts the ante 150
Baron Pulpo: posts the ante 150
kukbik: posts the ante 150
houlajk: posts the ante 150
dracko307: posts the ante 150
jcarlos.vale: posts small blind 900
angyal40: posts big blind 1800
*** HOLE CARDS ***
Dealt to jcarlos.vale [3c 9d]
engel395: folds 
Baron Pulpo: folds 
kukbik: folds 
houlajk: raises 2160 to 3960
dracko307: folds 
peio123: folds 
Dgo Sytrik: folds 
jcarlos.vale: folds 
angyal40: folds 
Uncalled bet (2160) returned to houlajk
houlajk collected 5850 from pot
houlajk: doesn't show handDTO
*** SUMMARY ***
Total pot 5850 | Rake 0 
Seat 1: peio123 folded before Flop (didn't bet)
Seat 2: Dgo Sytrik (button) folded before Flop (didn't bet)
Seat 3: jcarlos.vale (small blind) folded before Flop
Seat 4: angyal40 (big blind) folded before Flop
Seat 5: engel395 folded before Flop (didn't bet)
Seat 6: Baron Pulpo folded before Flop (didn't bet)
Seat 7: kukbik folded before Flop (didn't bet)
Seat 8: houlajk collected (5850)
Seat 9: dracko307 folded before Flop (didn't bet)



PokerStars Hand #221920013982: Tournament #3082648141, $0.98+$0.12 USD Hold'em No Limit - Level XXI (900/1800) - 2020/12/27 23:43:10 EET [2020/12/27 16:43:10 ET]
Table '3082648141 47' 9-max Seat #3 is the button
Seat 1: peio123 (84020 in chips) 
Seat 2: Dgo Sytrik (44616 in chips) 
Seat 3: jcarlos.vale (23597 in chips) 
Seat 4: angyal40 (5749 in chips) 
Seat 5: engel395 (58686 in chips) 
Seat 6: Baron Pulpo (70999 in chips) 
Seat 7: kukbik (71212 in chips) 
Seat 8: houlajk (57779 in chips) 
Seat 9: dracko307 (37189 in chips) 
peio123: posts the ante 150
Dgo Sytrik: posts the ante 150
jcarlos.vale: posts the ante 150
angyal40: posts the ante 150
engel395: posts the ante 150
Baron Pulpo: posts the ante 150
kukbik: posts the ante 150
houlajk: posts the ante 150
dracko307: posts the ante 150
angyal40: posts small blind 900
engel395: posts big blind 1800
*** HOLE CARDS ***
Dealt to jcarlos.vale [9c 3h]
Baron Pulpo: folds 
kukbik: folds 
houlajk: folds 
dracko307: raises 2070 to 3870
peio123: folds 
Dgo Sytrik: folds 
jcarlos.vale: folds 
angyal40: folds 
engel395: folds 
Uncalled bet (2070) returned to dracko307
dracko307 collected 5850 from pot
dracko307: doesn't show handDTO
*** SUMMARY ***
Total pot 5850 | Rake 0 
Seat 1: peio123 folded before Flop (didn't bet)
Seat 2: Dgo Sytrik folded before Flop (didn't bet)
Seat 3: jcarlos.vale (button) folded before Flop (didn't bet)
Seat 4: angyal40 (small blind) folded before Flop
Seat 5: engel395 (big blind) folded before Flop
Seat 6: Baron Pulpo folded before Flop (didn't bet)
Seat 7: kukbik folded before Flop (didn't bet)
Seat 8: houlajk folded before Flop (didn't bet)
Seat 9: dracko307 collected (5850)



PokerStars Hand #221920055725: Tournament #3082648141, $0.98+$0.12 USD Hold'em No Limit - Level XXI (900/1800) - 2020/12/27 23:43:56 EET [2020/12/27 16:43:56 ET]
Table '3082648141 47' 9-max Seat #4 is the button
Seat 1: peio123 (83870 in chips) 
Seat 2: Dgo Sytrik (44466 in chips) 
Seat 3: jcarlos.vale (23447 in chips) 
Seat 4: angyal40 (4699 in chips) 
Seat 5: engel395 (56736 in chips) 
Seat 6: Baron Pulpo (70849 in chips) 
Seat 7: kukbik (71062 in chips) 
Seat 8: houlajk (57629 in chips) 
Seat 9: dracko307 (41089 in chips) 
peio123: posts the ante 150
Dgo Sytrik: posts the ante 150
jcarlos.vale: posts the ante 150
angyal40: posts the ante 150
engel395: posts the ante 150
Baron Pulpo: posts the ante 150
kukbik: posts the ante 150
houlajk: posts the ante 150
dracko307: posts the ante 150
engel395: posts small blind 900
Baron Pulpo: posts big blind 1800
*** HOLE CARDS ***
Dealt to jcarlos.vale [7s Ks]
kukbik: folds 
houlajk: folds 
dracko307: raises 2070 to 3870
peio123: folds 
Dgo Sytrik: raises 3330 to 7200
jcarlos.vale: folds 
angyal40: folds 
engel395: folds 
Baron Pulpo: folds 
dracko307: calls 3330
*** FLOP *** [2h 3c 8h]
dracko307: checks 
Dgo Sytrik: bets 18000
dracko307: folds 
Uncalled bet (18000) returned to Dgo Sytrik
Dgo Sytrik collected 18450 from pot
Dgo Sytrik: doesn't show handDTO
*** SUMMARY ***
Total pot 18450 | Rake 0 
Board [2h 3c 8h]
Seat 1: peio123 folded before Flop (didn't bet)
Seat 2: Dgo Sytrik collected (18450)
Seat 3: jcarlos.vale folded before Flop (didn't bet)
Seat 4: angyal40 (button) folded before Flop (didn't bet)
Seat 5: engel395 (small blind) folded before Flop
Seat 6: Baron Pulpo (big blind) folded before Flop
Seat 7: kukbik folded before Flop (didn't bet)
Seat 8: houlajk folded before Flop (didn't bet)
Seat 9: dracko307 folded on the Flop



PokerStars Hand #221920095775: Tournament #3082648141, $0.98+$0.12 USD Hold'em No Limit - Level XXI (900/1800) - 2020/12/27 23:44:40 EET [2020/12/27 16:44:40 ET]
Table '3082648141 47' 9-max Seat #5 is the button
Seat 1: peio123 (83720 in chips) 
Seat 2: Dgo Sytrik (55566 in chips) 
Seat 3: jcarlos.vale (23297 in chips) 
Seat 4: angyal40 (4549 in chips) 
Seat 5: engel395 (55686 in chips) 
Seat 6: Baron Pulpo (68899 in chips) 
Seat 7: kukbik (70912 in chips) 
Seat 8: houlajk (57479 in chips) 
Seat 9: dracko307 (33739 in chips) 
peio123: posts the ante 150
Dgo Sytrik: posts the ante 150
jcarlos.vale: posts the ante 150
angyal40: posts the ante 150
engel395: posts the ante 150
Baron Pulpo: posts the ante 150
kukbik: posts the ante 150
houlajk: posts the ante 150
dracko307: posts the ante 150
Baron Pulpo: posts small blind 900
kukbik: posts big blind 1800
*** HOLE CARDS ***
Dealt to jcarlos.vale [4d 8s]
houlajk: folds 
dracko307: folds 
peio123: folds 
Dgo Sytrik: folds 
jcarlos.vale: folds 
angyal40: folds 
engel395: calls 1800
Baron Pulpo: folds 
kukbik: checks 
*** FLOP *** [7s Ac Ts]
kukbik: checks 
engel395: bets 53736 and is all-in
kukbik: folds 
Uncalled bet (53736) returned to engel395
engel395 collected 5850 from pot
engel395: doesn't show handDTO
*** SUMMARY ***
Total pot 5850 | Rake 0 
Board [7s Ac Ts]
Seat 1: peio123 folded before Flop (didn't bet)
Seat 2: Dgo Sytrik folded before Flop (didn't bet)
Seat 3: jcarlos.vale folded before Flop (didn't bet)
Seat 4: angyal40 folded before Flop (didn't bet)
Seat 5: engel395 (button) collected (5850)
Seat 6: Baron Pulpo (small blind) folded before Flop
Seat 7: kukbik (big blind) folded on the Flop
Seat 8: houlajk folded before Flop (didn't bet)
Seat 9: dracko307 folded before Flop (didn't bet)



PokerStars Hand #221920147872: Tournament #3082648141, $0.98+$0.12 USD Hold'em No Limit - Level XXI (900/1800) - 2020/12/27 23:45:37 EET [2020/12/27 16:45:37 ET]
Table '3082648141 47' 9-max Seat #6 is the button
Seat 1: peio123 (83570 in chips) 
Seat 2: Dgo Sytrik (55416 in chips) 
Seat 3: jcarlos.vale (23147 in chips) 
Seat 4: angyal40 (4399 in chips) 
Seat 5: engel395 (59586 in chips) 
Seat 6: Baron Pulpo (67849 in chips) 
Seat 7: kukbik (68962 in chips) 
Seat 8: houlajk (57329 in chips) 
Seat 9: dracko307 (33589 in chips) 
peio123: posts the ante 150
Dgo Sytrik: posts the ante 150
jcarlos.vale: posts the ante 150
angyal40: posts the ante 150
engel395: posts the ante 150
Baron Pulpo: posts the ante 150
kukbik: posts the ante 150
houlajk: posts the ante 150
dracko307: posts the ante 150
kukbik: posts small blind 900
houlajk: posts big blind 1800
*** HOLE CARDS ***
Dealt to jcarlos.vale [7c 4h]
dracko307: folds 
peio123: folds 
Dgo Sytrik: raises 3600 to 5400
jcarlos.vale: folds 
angyal40: calls 4249 and is all-in
engel395: folds 
Baron Pulpo: folds 
kukbik: folds 
houlajk: calls 3600
*** FLOP *** [8c Th 7h]
houlajk: checks 
Dgo Sytrik: bets 8100
houlajk: folds 
Uncalled bet (8100) returned to Dgo Sytrik
*** TURN *** [8c Th 7h] [Qs]
*** RIVER *** [8c Th 7h Qs] [Qh]
*** SHOW DOWN ***
Dgo Sytrik: shows [Ah Kh] (a flush, Ace high)
Dgo Sytrik collected 2302 from side pot
angyal40: shows [Jd Js] (two pair, Queens and Jacks)
Dgo Sytrik collected 14997 from main pot
angyal40 finished the tournament in 381st place and received $2.80.
*** SUMMARY ***
Total pot 17299 Main pot 14997. Side pot 2302. | Rake 0 
Board [8c Th 7h Qs Qh]
Seat 1: peio123 folded before Flop (didn't bet)
Seat 2: Dgo Sytrik showed [Ah Kh] and won (17299) with a flush, Ace high
Seat 3: jcarlos.vale folded before Flop (didn't bet)
Seat 4: angyal40 showed [Jd Js] and lost with two pair, Queens and Jacks
Seat 5: engel395 folded before Flop (didn't bet)
Seat 6: Baron Pulpo (button) folded before Flop (didn't bet)
Seat 7: kukbik (small blind) folded before Flop
Seat 8: houlajk (big blind) folded on the Flop
Seat 9: dracko307 folded before Flop (didn't bet)



PokerStars Hand #221920195287: Tournament #3082648141, $0.98+$0.12 USD Hold'em No Limit - Level XXI (900/1800) - 2020/12/27 23:46:28 EET [2020/12/27 16:46:28 ET]
Table '3082648141 47' 9-max Seat #7 is the button
Seat 1: peio123 (83420 in chips) 
Seat 2: Dgo Sytrik (67165 in chips) 
Seat 3: jcarlos.vale (22997 in chips) 
Seat 5: engel395 (59436 in chips) 
Seat 6: Baron Pulpo (67699 in chips) 
Seat 7: kukbik (67912 in chips) 
Seat 8: houlajk (51779 in chips) 
Seat 9: dracko307 (33439 in chips) 
peio123: posts the ante 150
Dgo Sytrik: posts the ante 150
jcarlos.vale: posts the ante 150
engel395: posts the ante 150
Baron Pulpo: posts the ante 150
kukbik: posts the ante 150
houlajk: posts the ante 150
dracko307: posts the ante 150
houlajk: posts small blind 900
dracko307: posts big blind 1800
*** HOLE CARDS ***
Dealt to jcarlos.vale [8d 3s]
peio123: raises 1800 to 3600
Dgo Sytrik: folds 
jcarlos.vale: folds 
engel395: folds 
Baron Pulpo: folds 
kukbik: folds 
houlajk: calls 2700
dracko307: calls 1800
*** FLOP *** [Js 4h 9h]
houlajk: checks 
dracko307: checks 
peio123: checks 
*** TURN *** [Js 4h 9h] [Jc]
houlajk: checks 
dracko307: checks 
peio123: checks 
*** RIVER *** [Js 4h 9h Jc] [2s]
houlajk: checks 
dracko307: checks 
peio123: checks 
*** SHOW DOWN ***
houlajk: shows [Ts As] (a pair of Jacks)
dracko307: mucks handDTO
peio123: mucks handDTO
houlajk collected 12000 from pot
*** SUMMARY ***
Total pot 12000 | Rake 0 
Board [Js 4h 9h Jc 2s]
Seat 1: peio123 mucked [Qh Kc]
Seat 2: Dgo Sytrik folded before Flop (didn't bet)
Seat 3: jcarlos.vale folded before Flop (didn't bet)
Seat 5: engel395 folded before Flop (didn't bet)
Seat 6: Baron Pulpo folded before Flop (didn't bet)
Seat 7: kukbik (button) folded before Flop (didn't bet)
Seat 8: houlajk (small blind) showed [Ts As] and won (12000) with a pair of Jacks
Seat 9: dracko307 (big blind) mucked [5d Kd]



PokerStars Hand #221920258595: Tournament #3082648141, $0.98+$0.12 USD Hold'em No Limit - Level XXI (900/1800) - 2020/12/27 23:47:37 EET [2020/12/27 16:47:37 ET]
Table '3082648141 47' 9-max Seat #8 is the button
Seat 1: peio123 (79670 in chips) 
Seat 2: Dgo Sytrik (67015 in chips) 
Seat 3: jcarlos.vale (22847 in chips) 
Seat 4: Let_me_please (6397 in chips) 
Seat 5: engel395 (59286 in chips) 
Seat 6: Baron Pulpo (67549 in chips) 
Seat 7: kukbik (67762 in chips) 
Seat 8: houlajk (60029 in chips) 
Seat 9: dracko307 (29689 in chips) 
peio123: posts the ante 150
Dgo Sytrik: posts the ante 150
jcarlos.vale: posts the ante 150
Let_me_please: posts the ante 150
engel395: posts the ante 150
Baron Pulpo: posts the ante 150
kukbik: posts the ante 150
houlajk: posts the ante 150
dracko307: posts the ante 150
dracko307: posts small blind 900
peio123: posts big blind 1800
*** HOLE CARDS ***
Dealt to jcarlos.vale [2c 5d]
Dgo Sytrik: folds 
jcarlos.vale: folds 
Let_me_please: folds 
engel395: folds 
Baron Pulpo: folds 
kukbik: folds 
houlajk: folds 
dracko307: folds 
Uncalled bet (900) returned to peio123
peio123 collected 3150 from pot
*** SUMMARY ***
Total pot 3150 | Rake 0 
Seat 1: peio123 (big blind) collected (3150)
Seat 2: Dgo Sytrik folded before Flop (didn't bet)
Seat 3: jcarlos.vale folded before Flop (didn't bet)
Seat 4: Let_me_please folded before Flop (didn't bet)
Seat 5: engel395 folded before Flop (didn't bet)
Seat 6: Baron Pulpo folded before Flop (didn't bet)
Seat 7: kukbik folded before Flop (didn't bet)
Seat 8: houlajk (button) folded before Flop (didn't bet)
Seat 9: dracko307 (small blind) folded before Flop



PokerStars Hand #221920276897: Tournament #3082648141, $0.98+$0.12 USD Hold'em No Limit - Level XXI (900/1800) - 2020/12/27 23:47:57 EET [2020/12/27 16:47:57 ET]
Table '3082648141 47' 9-max Seat #9 is the button
Seat 1: peio123 (81770 in chips) 
Seat 2: Dgo Sytrik (66865 in chips) 
Seat 3: jcarlos.vale (22697 in chips) 
Seat 4: Let_me_please (6247 in chips) 
Seat 5: engel395 (59136 in chips) 
Seat 6: Baron Pulpo (67399 in chips) 
Seat 7: kukbik (67612 in chips) 
Seat 8: houlajk (59879 in chips) 
Seat 9: dracko307 (28639 in chips) 
peio123: posts the ante 150
Dgo Sytrik: posts the ante 150
jcarlos.vale: posts the ante 150
Let_me_please: posts the ante 150
engel395: posts the ante 150
Baron Pulpo: posts the ante 150
kukbik: posts the ante 150
houlajk: posts the ante 150
dracko307: posts the ante 150
peio123: posts small blind 900
Dgo Sytrik: posts big blind 1800
*** HOLE CARDS ***
Dealt to jcarlos.vale [9s 8s]
jcarlos.vale: raises 20747 to 22547 and is all-in
Let_me_please: folds 
engel395: folds 
Baron Pulpo: folds 
kukbik: folds 
houlajk: folds 
dracko307: folds 
peio123: folds 
Dgo Sytrik: folds 
Uncalled bet (20747) returned to jcarlos.vale
jcarlos.vale collected 5850 from pot
jcarlos.vale: doesn't show handDTO
*** SUMMARY ***
Total pot 5850 | Rake 0 
Seat 1: peio123 (small blind) folded before Flop
Seat 2: Dgo Sytrik (big blind) folded before Flop
Seat 3: jcarlos.vale collected (5850)
Seat 4: Let_me_please folded before Flop (didn't bet)
Seat 5: engel395 folded before Flop (didn't bet)
Seat 6: Baron Pulpo folded before Flop (didn't bet)
Seat 7: kukbik folded before Flop (didn't bet)
Seat 8: houlajk folded before Flop (didn't bet)
Seat 9: dracko307 (button) folded before Flop (didn't bet)



PokerStars Hand #221920293376: Tournament #3082648141, $0.98+$0.12 USD Hold'em No Limit - Level XXI (900/1800) - 2020/12/27 23:48:15 EET [2020/12/27 16:48:15 ET]
Table '3082648141 47' 9-max Seat #1 is the button
Seat 1: peio123 (80720 in chips) 
Seat 2: Dgo Sytrik (64915 in chips) 
Seat 3: jcarlos.vale (26597 in chips) 
Seat 4: Let_me_please (6097 in chips) 
Seat 5: engel395 (58986 in chips) 
Seat 6: Baron Pulpo (67249 in chips) 
Seat 7: kukbik (67462 in chips) 
Seat 8: houlajk (59729 in chips) 
Seat 9: dracko307 (28489 in chips) 
peio123: posts the ante 150
Dgo Sytrik: posts the ante 150
jcarlos.vale: posts the ante 150
Let_me_please: posts the ante 150
engel395: posts the ante 150
Baron Pulpo: posts the ante 150
kukbik: posts the ante 150
houlajk: posts the ante 150
dracko307: posts the ante 150
Dgo Sytrik: posts small blind 900
jcarlos.vale: posts big blind 1800
*** HOLE CARDS ***
Dealt to jcarlos.vale [5h Kh]
Let_me_please: folds 
engel395: folds 
Baron Pulpo: raises 1980 to 3780
kukbik: folds 
houlajk: folds 
dracko307: folds 
peio123 has timed out
peio123: folds 
peio123 is sitting out
Dgo Sytrik: folds 
jcarlos.vale: folds 
Uncalled bet (1980) returned to Baron Pulpo
Baron Pulpo collected 5850 from pot
*** SUMMARY ***
Total pot 5850 | Rake 0 
Seat 1: peio123 (button) folded before Flop (didn't bet)
Seat 2: Dgo Sytrik (small blind) folded before Flop
Seat 3: jcarlos.vale (big blind) folded before Flop
Seat 4: Let_me_please folded before Flop (didn't bet)
Seat 5: engel395 folded before Flop (didn't bet)
Seat 6: Baron Pulpo collected (5850)
Seat 7: kukbik folded before Flop (didn't bet)
Seat 8: houlajk folded before Flop (didn't bet)
Seat 9: dracko307 folded before Flop (didn't bet)



PokerStars Hand #221920332744: Tournament #3082648141, $0.98+$0.12 USD Hold'em No Limit - Level XXI (900/1800) - 2020/12/27 23:48:58 EET [2020/12/27 16:48:58 ET]
Table '3082648141 47' 9-max Seat #2 is the button
Seat 1: peio123 (80570 in chips) is sitting out
Seat 2: Dgo Sytrik (63865 in chips) 
Seat 3: jcarlos.vale (24647 in chips) 
Seat 4: Let_me_please (5947 in chips) 
Seat 5: engel395 (58836 in chips) 
Seat 6: Baron Pulpo (71149 in chips) 
Seat 7: kukbik (67312 in chips) 
Seat 8: houlajk (59579 in chips) 
Seat 9: dracko307 (28339 in chips) 
peio123: posts the ante 150
Dgo Sytrik: posts the ante 150
jcarlos.vale: posts the ante 150
Let_me_please: posts the ante 150
engel395: posts the ante 150
Baron Pulpo: posts the ante 150
kukbik: posts the ante 150
houlajk: posts the ante 150
dracko307: posts the ante 150
jcarlos.vale: posts small blind 900
Let_me_please: posts big blind 1800
*** HOLE CARDS ***
Dealt to jcarlos.vale [7d 6d]
peio123 has returned
engel395: folds 
Baron Pulpo: raises 1980 to 3780
kukbik: folds 
houlajk: folds 
dracko307: folds 
peio123: folds 
Dgo Sytrik: folds 
jcarlos.vale: raises 20717 to 24497 and is all-in
Let_me_please: folds 
Baron Pulpo: folds 
Uncalled bet (20717) returned to jcarlos.vale
jcarlos.vale collected 10710 from pot
jcarlos.vale: doesn't show handDTO
*** SUMMARY ***
Total pot 10710 | Rake 0 
Seat 1: peio123 folded before Flop (didn't bet)
Seat 2: Dgo Sytrik (button) folded before Flop (didn't bet)
Seat 3: jcarlos.vale (small blind) collected (10710)
Seat 4: Let_me_please (big blind) folded before Flop
Seat 5: engel395 folded before Flop (didn't bet)
Seat 6: Baron Pulpo folded before Flop
Seat 7: kukbik folded before Flop (didn't bet)
Seat 8: houlajk folded before Flop (didn't bet)
Seat 9: dracko307 folded before Flop (didn't bet)



PokerStars Hand #221920374474: Tournament #3082648141, $0.98+$0.12 USD Hold'em No Limit - Level XXI (900/1800) - 2020/12/27 23:49:43 EET [2020/12/27 16:49:43 ET]
Table '3082648141 47' 9-max Seat #3 is the button
Seat 1: peio123 (80420 in chips) 
Seat 2: Dgo Sytrik (63715 in chips) 
Seat 3: jcarlos.vale (31427 in chips) 
Seat 4: Let_me_please (3997 in chips) 
Seat 5: engel395 (58686 in chips) 
Seat 6: Baron Pulpo (67219 in chips) 
Seat 7: kukbik (67162 in chips) 
Seat 8: houlajk (59429 in chips) 
Seat 9: dracko307 (28189 in chips) 
peio123: posts the ante 150
Dgo Sytrik: posts the ante 150
jcarlos.vale: posts the ante 150
Let_me_please: posts the ante 150
engel395: posts the ante 150
Baron Pulpo: posts the ante 150
kukbik: posts the ante 150
houlajk: posts the ante 150
dracko307: posts the ante 150
Let_me_please: posts small blind 900
engel395: posts big blind 1800
*** HOLE CARDS ***
Dealt to jcarlos.vale [2c 8s]
Baron Pulpo: folds 
kukbik: folds 
houlajk: folds 
dracko307: folds 
peio123: folds 
Dgo Sytrik: raises 3600 to 5400
jcarlos.vale: folds 
Let_me_please: calls 2947 and is all-in
engel395: folds 
Uncalled bet (1553) returned to Dgo Sytrik
*** FLOP *** [Tc 7c 4d]
*** TURN *** [Tc 7c 4d] [7h]
*** RIVER *** [Tc 7c 4d 7h] [5d]
*** SHOW DOWN ***
Let_me_please: shows [Qc Kc] (a pair of Sevens)
Dgo Sytrik: shows [Ad Jc] (a pair of Sevens - Ace kicker)
Dgo Sytrik collected 10844 from pot
Let_me_please finished the tournament in 355th place and received $3.44.
*** SUMMARY ***
Total pot 10844 | Rake 0 
Board [Tc 7c 4d 7h 5d]
Seat 1: peio123 folded before Flop (didn't bet)
Seat 2: Dgo Sytrik showed [Ad Jc] and won (10844) with a pair of Sevens
Seat 3: jcarlos.vale (button) folded before Flop (didn't bet)
Seat 4: Let_me_please (small blind) showed [Qc Kc] and lost with a pair of Sevens
Seat 5: engel395 (big blind) folded before Flop
Seat 6: Baron Pulpo folded before Flop (didn't bet)
Seat 7: kukbik folded before Flop (didn't bet)
Seat 8: houlajk folded before Flop (didn't bet)
Seat 9: dracko307 folded before Flop (didn't bet)



PokerStars Hand #221920398035: Tournament #3082648141, $0.98+$0.12 USD Hold'em No Limit - Level XXI (900/1800) - 2020/12/27 23:50:08 EET [2020/12/27 16:50:08 ET]
Table '3082648141 47' 9-max Seat #5 is the button
Seat 1: peio123 (80270 in chips) 
Seat 2: Dgo Sytrik (70562 in chips) 
Seat 3: jcarlos.vale (31277 in chips) 
Seat 5: engel395 (56736 in chips) 
Seat 6: Baron Pulpo (67069 in chips) 
Seat 7: kukbik (67012 in chips) 
Seat 8: houlajk (59279 in chips) 
Seat 9: dracko307 (28039 in chips) 
peio123: posts the ante 150
Dgo Sytrik: posts the ante 150
jcarlos.vale: posts the ante 150
engel395: posts the ante 150
Baron Pulpo: posts the ante 150
kukbik: posts the ante 150
houlajk: posts the ante 150
dracko307: posts the ante 150
Baron Pulpo: posts small blind 900
kukbik: posts big blind 1800
*** HOLE CARDS ***
Dealt to jcarlos.vale [3c 9c]
houlajk: folds 
dracko307: raises 2070 to 3870
peio123: folds 
Dgo Sytrik: folds 
jcarlos.vale: folds 
engel395: folds 
Baron Pulpo: folds 
kukbik: folds 
Uncalled bet (2070) returned to dracko307
dracko307 collected 5700 from pot
dracko307: doesn't show handDTO
*** SUMMARY ***
Total pot 5700 | Rake 0 
Seat 1: peio123 folded before Flop (didn't bet)
Seat 2: Dgo Sytrik folded before Flop (didn't bet)
Seat 3: jcarlos.vale folded before Flop (didn't bet)
Seat 5: engel395 (button) folded before Flop (didn't bet)
Seat 6: Baron Pulpo (small blind) folded before Flop
Seat 7: kukbik (big blind) folded before Flop
Seat 8: houlajk folded before Flop (didn't bet)
Seat 9: dracko307 collected (5700)



PokerStars Hand #221920421440: Tournament #3082648141, $0.98+$0.12 USD Hold'em No Limit - Level XXI (900/1800) - 2020/12/27 23:50:34 EET [2020/12/27 16:50:34 ET]
Table '3082648141 47' 9-max Seat #6 is the button
Seat 1: peio123 (80120 in chips) 
Seat 2: Dgo Sytrik (70412 in chips) 
Seat 3: jcarlos.vale (31127 in chips) 
Seat 4: Loserknight (41880 in chips) 
Seat 5: engel395 (56586 in chips) 
Seat 6: Baron Pulpo (66019 in chips) 
Seat 7: kukbik (65062 in chips) 
Seat 8: houlajk (59129 in chips) 
Seat 9: dracko307 (31789 in chips) 
peio123: posts the ante 150
Dgo Sytrik: posts the ante 150
jcarlos.vale: posts the ante 150
Loserknight: posts the ante 150
engel395: posts the ante 150
Baron Pulpo: posts the ante 150
kukbik: posts the ante 150
houlajk: posts the ante 150
dracko307: posts the ante 150
kukbik: posts small blind 900
houlajk: posts big blind 1800
*** HOLE CARDS ***
Dealt to jcarlos.vale [7c 8c]
dracko307: folds 
peio123: folds 
Dgo Sytrik: folds 
jcarlos.vale: raises 29177 to 30977 and is all-in
Loserknight: folds 
engel395: folds 
Baron Pulpo: folds 
kukbik: folds 
houlajk: folds 
Uncalled bet (29177) returned to jcarlos.vale
jcarlos.vale collected 5850 from pot
jcarlos.vale: doesn't show handDTO
*** SUMMARY ***
Total pot 5850 | Rake 0 
Seat 1: peio123 folded before Flop (didn't bet)
Seat 2: Dgo Sytrik folded before Flop (didn't bet)
Seat 3: jcarlos.vale collected (5850)
Seat 4: Loserknight folded before Flop (didn't bet)
Seat 5: engel395 folded before Flop (didn't bet)
Seat 6: Baron Pulpo (button) folded before Flop (didn't bet)
Seat 7: kukbik (small blind) folded before Flop
Seat 8: houlajk (big blind) folded before Flop
Seat 9: dracko307 folded before Flop (didn't bet)



PokerStars Hand #221920446352: Tournament #3082648141, $0.98+$0.12 USD Hold'em No Limit - Level XXI (900/1800) - 2020/12/27 23:51:01 EET [2020/12/27 16:51:01 ET]
Table '3082648141 47' 9-max Seat #7 is the button
Seat 1: peio123 (79970 in chips) 
Seat 2: Dgo Sytrik (70262 in chips) 
Seat 3: jcarlos.vale (35027 in chips) 
Seat 4: Loserknight (41730 in chips) 
Seat 5: engel395 (56436 in chips) 
Seat 6: Baron Pulpo (65869 in chips) 
Seat 7: kukbik (64012 in chips) 
Seat 8: houlajk (57179 in chips) 
Seat 9: dracko307 (31639 in chips) 
peio123: posts the ante 150
Dgo Sytrik: posts the ante 150
jcarlos.vale: posts the ante 150
Loserknight: posts the ante 150
engel395: posts the ante 150
Baron Pulpo: posts the ante 150
kukbik: posts the ante 150
houlajk: posts the ante 150
dracko307: posts the ante 150
houlajk: posts small blind 900
dracko307: posts big blind 1800
*** HOLE CARDS ***
Dealt to jcarlos.vale [Qh As]
peio123: folds 
Dgo Sytrik: folds 
jcarlos.vale: raises 33077 to 34877 and is all-in
Loserknight: folds 
engel395: folds 
Baron Pulpo: folds 
kukbik: folds 
houlajk: folds 
dracko307: calls 29689 and is all-in
Uncalled bet (3388) returned to jcarlos.vale
*** FLOP *** [Kh Qd 9d]
*** TURN *** [Kh Qd 9d] [2c]
*** RIVER *** [Kh Qd 9d 2c] [Ah]
*** SHOW DOWN ***
dracko307: shows [Jd Js] (a pair of Jacks)
jcarlos.vale: shows [Qh As] (two pair, Aces and Queens)
jcarlos.vale collected 65228 from pot
dracko307 finished the tournament in 348th place and received $3.44.
*** SUMMARY ***
Total pot 65228 | Rake 0 
Board [Kh Qd 9d 2c Ah]
Seat 1: peio123 folded before Flop (didn't bet)
Seat 2: Dgo Sytrik folded before Flop (didn't bet)
Seat 3: jcarlos.vale showed [Qh As] and won (65228) with two pair, Aces and Queens
Seat 4: Loserknight folded before Flop (didn't bet)
Seat 5: engel395 folded before Flop (didn't bet)
Seat 6: Baron Pulpo folded before Flop (didn't bet)
Seat 7: kukbik (button) folded before Flop (didn't bet)
Seat 8: houlajk (small blind) folded before Flop
Seat 9: dracko307 (big blind) showed [Jd Js] and lost with a pair of Jacks



PokerStars Hand #221920472999: Tournament #3082648141, $0.98+$0.12 USD Hold'em No Limit - Level XXI (900/1800) - 2020/12/27 23:51:30 EET [2020/12/27 16:51:30 ET]
Table '3082648141 47' 9-max Seat #8 is the button
Seat 1: peio123 (79820 in chips) 
Seat 2: Dgo Sytrik (70112 in chips) 
Seat 3: jcarlos.vale (68616 in chips) 
Seat 4: Loserknight (41580 in chips) 
Seat 5: engel395 (56286 in chips) 
Seat 6: Baron Pulpo (65719 in chips) 
Seat 7: kukbik (63862 in chips) 
Seat 8: houlajk (56129 in chips) 
peio123: posts the ante 150
Dgo Sytrik: posts the ante 150
jcarlos.vale: posts the ante 150
Loserknight: posts the ante 150
engel395: posts the ante 150
Baron Pulpo: posts the ante 150
kukbik: posts the ante 150
houlajk: posts the ante 150
peio123: posts small blind 900
Dgo Sytrik: posts big blind 1800
*** HOLE CARDS ***
Dealt to jcarlos.vale [Kh 2c]
jcarlos.vale: folds 
Loserknight: folds 
engel395: folds 
Baron Pulpo: raises 1980 to 3780
kukbik: folds 
houlajk: folds 
peio123: folds 
Dgo Sytrik: raises 5220 to 9000
Baron Pulpo: calls 5220
*** FLOP *** [Tc 8s Jd]
Dgo Sytrik: bets 20100
Baron Pulpo: raises 36469 to 56569 and is all-in
Dgo Sytrik: calls 36469
*** TURN *** [Tc 8s Jd] [9h]
*** RIVER *** [Tc 8s Jd 9h] [8h]
*** SHOW DOWN ***
Dgo Sytrik: shows [Qd Qs] (a straight, Eight to Queen)
Baron Pulpo: shows [Kc Js] (two pair, Jacks and Eights)
Dgo Sytrik collected 133238 from pot
Baron Pulpo finished the tournament in 342nd place and received $3.44.
*** SUMMARY ***
Total pot 133238 | Rake 0 
Board [Tc 8s Jd 9h 8h]
Seat 1: peio123 (small blind) folded before Flop
Seat 2: Dgo Sytrik (big blind) showed [Qd Qs] and won (133238) with a straight, Eight to Queen
Seat 3: jcarlos.vale folded before Flop (didn't bet)
Seat 4: Loserknight folded before Flop (didn't bet)
Seat 5: engel395 folded before Flop (didn't bet)
Seat 6: Baron Pulpo showed [Kc Js] and lost with two pair, Jacks and Eights
Seat 7: kukbik folded before Flop (didn't bet)
Seat 8: houlajk (button) folded before Flop (didn't bet)



PokerStars Hand #221920532143: Tournament #3082648141, $0.98+$0.12 USD Hold'em No Limit - Level XXII (1000/2000) - 2020/12/27 23:52:35 EET [2020/12/27 16:52:35 ET]
Table '3082648141 47' 9-max Seat #1 is the button
Seat 1: peio123 (78770 in chips) 
Seat 2: Dgo Sytrik (137631 in chips) 
Seat 3: jcarlos.vale (68466 in chips) 
Seat 4: Loserknight (41430 in chips) 
Seat 5: engel395 (56136 in chips) 
Seat 7: kukbik (63712 in chips) 
Seat 8: houlajk (55979 in chips) 
Seat 9: atrocity95 (89375 in chips) 
peio123: posts the ante 175
Dgo Sytrik: posts the ante 175
jcarlos.vale: posts the ante 175
Loserknight: posts the ante 175
engel395: posts the ante 175
kukbik: posts the ante 175
houlajk: posts the ante 175
atrocity95: posts the ante 175
Dgo Sytrik: posts small blind 1000
jcarlos.vale: posts big blind 2000
*** HOLE CARDS ***
Dealt to jcarlos.vale [2s Jh]
Loserknight: folds 
engel395: folds 
kukbik: folds 
houlajk: raises 2400 to 4400
atrocity95: folds 
peio123: folds 
Dgo Sytrik: calls 3400
jcarlos.vale: folds 
*** FLOP *** [2d 6h 7c]
Dgo Sytrik: bets 6000
houlajk: calls 6000
*** TURN *** [2d 6h 7c] [2c]
Dgo Sytrik: checks 
houlajk: checks 
*** RIVER *** [2d 6h 7c 2c] [5s]
Dgo Sytrik: checks 
houlajk: checks 
*** SHOW DOWN ***
Dgo Sytrik: shows [Ac Jd] (a pair of Deuces)
houlajk: mucks handDTO
Dgo Sytrik collected 24200 from pot
*** SUMMARY ***
Total pot 24200 | Rake 0 
Board [2d 6h 7c 2c 5s]
Seat 1: peio123 (button) folded before Flop (didn't bet)
Seat 2: Dgo Sytrik (small blind) showed [Ac Jd] and won (24200) with a pair of Deuces
Seat 3: jcarlos.vale (big blind) folded before Flop
Seat 4: Loserknight folded before Flop (didn't bet)
Seat 5: engel395 folded before Flop (didn't bet)
Seat 7: kukbik folded before Flop (didn't bet)
Seat 8: houlajk mucked [As 9s]
Seat 9: atrocity95 folded before Flop (didn't bet)



PokerStars Hand #221920586141: Tournament #3082648141, $0.98+$0.12 USD Hold'em No Limit - Level XXII (1000/2000) - 2020/12/27 23:53:35 EET [2020/12/27 16:53:35 ET]
Table '3082648141 47' 9-max Seat #2 is the button
Seat 1: peio123 (78595 in chips) 
Seat 2: Dgo Sytrik (151256 in chips) 
Seat 3: jcarlos.vale (66291 in chips) 
Seat 4: Loserknight (41255 in chips) 
Seat 5: engel395 (55961 in chips) 
Seat 7: kukbik (63537 in chips) 
Seat 8: houlajk (45404 in chips) 
Seat 9: atrocity95 (89200 in chips) 
peio123: posts the ante 175
Dgo Sytrik: posts the ante 175
jcarlos.vale: posts the ante 175
Loserknight: posts the ante 175
engel395: posts the ante 175
kukbik: posts the ante 175
houlajk: posts the ante 175
atrocity95: posts the ante 175
jcarlos.vale: posts small blind 1000
Loserknight: posts big blind 2000
*** HOLE CARDS ***
Dealt to jcarlos.vale [8s Kh]
engel395: folds 
kukbik: folds 
houlajk: folds 
atrocity95: folds 
peio123: folds 
Dgo Sytrik: folds 
jcarlos.vale: folds 
Uncalled bet (1000) returned to Loserknight
Loserknight collected 3400 from pot
Loserknight: doesn't show handDTO
*** SUMMARY ***
Total pot 3400 | Rake 0 
Seat 1: peio123 folded before Flop (didn't bet)
Seat 2: Dgo Sytrik (button) folded before Flop (didn't bet)
Seat 3: jcarlos.vale (small blind) folded before Flop
Seat 4: Loserknight (big blind) collected (3400)
Seat 5: engel395 folded before Flop (didn't bet)
Seat 7: kukbik folded before Flop (didn't bet)
Seat 8: houlajk folded before Flop (didn't bet)
Seat 9: atrocity95 folded before Flop (didn't bet)



PokerStars Hand #221920605367: Tournament #3082648141, $0.98+$0.12 USD Hold'em No Limit - Level XXII (1000/2000) - 2020/12/27 23:53:57 EET [2020/12/27 16:53:57 ET]
Table '3082648141 47' 9-max Seat #3 is the button
Seat 1: peio123 (78420 in chips) 
Seat 2: Dgo Sytrik (151081 in chips) 
Seat 3: jcarlos.vale (65116 in chips) 
Seat 4: Loserknight (43480 in chips) 
Seat 5: engel395 (55786 in chips) 
Seat 7: kukbik (63362 in chips) 
Seat 8: houlajk (45229 in chips) 
Seat 9: atrocity95 (89025 in chips) 
peio123: posts the ante 175
Dgo Sytrik: posts the ante 175
jcarlos.vale: posts the ante 175
Loserknight: posts the ante 175
engel395: posts the ante 175
kukbik: posts the ante 175
houlajk: posts the ante 175
atrocity95: posts the ante 175
Loserknight: posts small blind 1000
engel395: posts big blind 2000
*** HOLE CARDS ***
Dealt to jcarlos.vale [5c 8c]
kukbik: folds 
houlajk: folds 
atrocity95: folds 
peio123: folds 
Dgo Sytrik is connected 
Dgo Sytrik: folds 
jcarlos.vale: folds 
Loserknight: folds 
Uncalled bet (1000) returned to engel395
engel395 collected 3400 from pot
*** SUMMARY ***
Total pot 3400 | Rake 0 
Seat 1: peio123 folded before Flop (didn't bet)
Seat 2: Dgo Sytrik folded before Flop (didn't bet)
Seat 3: jcarlos.vale (button) folded before Flop (didn't bet)
Seat 4: Loserknight (small blind) folded before Flop
Seat 5: engel395 (big blind) collected (3400)
Seat 7: kukbik folded before Flop (didn't bet)
Seat 8: houlajk folded before Flop (didn't bet)
Seat 9: atrocity95 folded before Flop (didn't bet)



PokerStars Hand #221920646089: Tournament #3082648141, $0.98+$0.12 USD Hold'em No Limit - Level XXII (1000/2000) - 2020/12/27 23:54:42 EET [2020/12/27 16:54:42 ET]
Table '3082648141 47' 9-max Seat #4 is the button
Seat 1: peio123 (78245 in chips) 
Seat 2: Dgo Sytrik (150906 in chips) 
Seat 3: jcarlos.vale (64941 in chips) 
Seat 4: Loserknight (42305 in chips) 
Seat 5: engel395 (58011 in chips) 
Seat 6: Element 179 (160608 in chips) 
Seat 7: kukbik (63187 in chips) 
Seat 8: houlajk (45054 in chips) 
Seat 9: atrocity95 (88850 in chips) 
peio123: posts the ante 175
Dgo Sytrik: posts the ante 175
jcarlos.vale: posts the ante 175
Loserknight: posts the ante 175
engel395: posts the ante 175
Element 179: posts the ante 175
kukbik: posts the ante 175
houlajk: posts the ante 175
atrocity95: posts the ante 175
engel395: posts small blind 1000
Element 179: posts big blind 2000
*** HOLE CARDS ***
Dealt to jcarlos.vale [Jc 9c]
kukbik: folds 
houlajk: folds 
atrocity95: folds 
peio123: folds 
Dgo Sytrik: folds 
jcarlos.vale: raises 3200 to 5200
Loserknight: folds 
engel395: folds 
Element 179: raises 12975 to 18175
jcarlos.vale: folds 
Uncalled bet (12975) returned to Element 179
Element 179 collected 12975 from pot
Element 179: doesn't show handDTO
*** SUMMARY ***
Total pot 12975 | Rake 0 
Seat 1: peio123 folded before Flop (didn't bet)
Seat 2: Dgo Sytrik folded before Flop (didn't bet)
Seat 3: jcarlos.vale folded before Flop
Seat 4: Loserknight (button) folded before Flop (didn't bet)
Seat 5: engel395 (small blind) folded before Flop
Seat 6: Element 179 (big blind) collected (12975)
Seat 7: kukbik folded before Flop (didn't bet)
Seat 8: houlajk folded before Flop (didn't bet)
Seat 9: atrocity95 folded before Flop (didn't bet)



PokerStars Hand #221920897385: Tournament #3082648141, $0.98+$0.12 USD Hold'em No Limit - Level XXII (1000/2000) - 2020/12/28 0:01:28 EET [2020/12/27 17:01:28 ET]
Table '3082648141 47' 9-max Seat #5 is the button
Seat 1: peio123 (78070 in chips) 
Seat 2: Dgo Sytrik (150731 in chips) 
Seat 3: jcarlos.vale (59566 in chips) 
Seat 4: Loserknight (42130 in chips) 
Seat 5: engel395 (56836 in chips) 
Seat 6: Element 179 (168208 in chips) 
Seat 7: kukbik (63012 in chips) 
Seat 8: houlajk (44879 in chips) 
Seat 9: atrocity95 (88675 in chips) 
peio123: posts the ante 175
Dgo Sytrik: posts the ante 175
jcarlos.vale: posts the ante 175
Loserknight: posts the ante 175
engel395: posts the ante 175
Element 179: posts the ante 175
kukbik: posts the ante 175
houlajk: posts the ante 175
atrocity95: posts the ante 175
Element 179: posts small blind 1000
kukbik: posts big blind 2000
*** HOLE CARDS ***
Dealt to jcarlos.vale [Jd 3c]
houlajk: folds 
atrocity95: folds 
peio123 has timed out
peio123: folds 
peio123 is sitting out
Dgo Sytrik: folds 
peio123 has returned
jcarlos.vale: folds 
Loserknight: folds 
engel395: folds 
Element 179: raises 4000 to 6000
kukbik: folds 
Uncalled bet (4000) returned to Element 179
Element 179 collected 5575 from pot
Element 179: doesn't show handDTO
*** SUMMARY ***
Total pot 5575 | Rake 0 
Seat 1: peio123 folded before Flop (didn't bet)
Seat 2: Dgo Sytrik folded before Flop (didn't bet)
Seat 3: jcarlos.vale folded before Flop (didn't bet)
Seat 4: Loserknight folded before Flop (didn't bet)
Seat 5: engel395 (button) folded before Flop (didn't bet)
Seat 6: Element 179 (small blind) collected (5575)
Seat 7: kukbik (big blind) folded before Flop
Seat 8: houlajk folded before Flop (didn't bet)
Seat 9: atrocity95 folded before Flop (didn't bet)



PokerStars Hand #221920938728: Tournament #3082648141, $0.98+$0.12 USD Hold'em No Limit - Level XXII (1000/2000) - 2020/12/28 0:02:21 EET [2020/12/27 17:02:21 ET]
Table '3082648141 47' 9-max Seat #6 is the button
Seat 1: peio123 (77895 in chips) 
Seat 2: Dgo Sytrik (150556 in chips) 
Seat 3: jcarlos.vale (59391 in chips) 
Seat 4: Loserknight (41955 in chips) 
Seat 5: engel395 (56661 in chips) 
Seat 6: Element 179 (171608 in chips) 
Seat 7: kukbik (60837 in chips) 
Seat 8: houlajk (44704 in chips) 
Seat 9: atrocity95 (88500 in chips) 
peio123: posts the ante 175
Dgo Sytrik: posts the ante 175
jcarlos.vale: posts the ante 175
Loserknight: posts the ante 175
engel395: posts the ante 175
Element 179: posts the ante 175
kukbik: posts the ante 175
houlajk: posts the ante 175
atrocity95: posts the ante 175
kukbik: posts small blind 1000
houlajk: posts big blind 2000
*** HOLE CARDS ***
Dealt to jcarlos.vale [Jc 3d]
atrocity95: folds 
peio123 has timed out
peio123: folds 
peio123 is sitting out
Dgo Sytrik: folds 
jcarlos.vale: folds 
peio123 has returned
Loserknight: raises 39780 to 41780 and is all-in
engel395: folds 
Element 179: folds 
kukbik: folds 
houlajk: folds 
Uncalled bet (39780) returned to Loserknight
Loserknight collected 6575 from pot
Loserknight: doesn't show handDTO
*** SUMMARY ***
Total pot 6575 | Rake 0 
Seat 1: peio123 folded before Flop (didn't bet)
Seat 2: Dgo Sytrik folded before Flop (didn't bet)
Seat 3: jcarlos.vale folded before Flop (didn't bet)
Seat 4: Loserknight collected (6575)
Seat 5: engel395 folded before Flop (didn't bet)
Seat 6: Element 179 (button) folded before Flop (didn't bet)
Seat 7: kukbik (small blind) folded before Flop
Seat 8: houlajk (big blind) folded before Flop
Seat 9: atrocity95 folded before Flop (didn't bet)



PokerStars Hand #221920968701: Tournament #3082648141, $0.98+$0.12 USD Hold'em No Limit - Level XXII (1000/2000) - 2020/12/28 0:02:56 EET [2020/12/27 17:02:56 ET]
Table '3082648141 47' 9-max Seat #7 is the button
Seat 1: peio123 (77720 in chips) 
Seat 2: Dgo Sytrik (150381 in chips) 
Seat 3: jcarlos.vale (59216 in chips) 
Seat 4: Loserknight (46355 in chips) 
Seat 5: engel395 (56486 in chips) 
Seat 6: Element 179 (171433 in chips) 
Seat 7: kukbik (59662 in chips) 
Seat 8: houlajk (42529 in chips) 
Seat 9: atrocity95 (88325 in chips) 
peio123: posts the ante 175
Dgo Sytrik: posts the ante 175
jcarlos.vale: posts the ante 175
Loserknight: posts the ante 175
engel395: posts the ante 175
Element 179: posts the ante 175
kukbik: posts the ante 175
houlajk: posts the ante 175
atrocity95: posts the ante 175
houlajk: posts small blind 1000
atrocity95: posts big blind 2000
*** HOLE CARDS ***
Dealt to jcarlos.vale [Ad Jh]
peio123: raises 2000 to 4000
Dgo Sytrik: folds 
jcarlos.vale: calls 4000
Loserknight: folds 
engel395: folds 
Element 179: folds 
kukbik: folds 
houlajk: folds 
atrocity95: folds 
*** FLOP *** [Js 3h Kd]
peio123: bets 6000
jcarlos.vale: folds 
Uncalled bet (6000) returned to peio123
peio123 collected 12575 from pot
*** SUMMARY ***
Total pot 12575 | Rake 0 
Board [Js 3h Kd]
Seat 1: peio123 collected (12575)
Seat 2: Dgo Sytrik folded before Flop (didn't bet)
Seat 3: jcarlos.vale folded on the Flop
Seat 4: Loserknight folded before Flop (didn't bet)
Seat 5: engel395 folded before Flop (didn't bet)
Seat 6: Element 179 folded before Flop (didn't bet)
Seat 7: kukbik (button) folded before Flop (didn't bet)
Seat 8: houlajk (small blind) folded before Flop
Seat 9: atrocity95 (big blind) folded before Flop



PokerStars Hand #221920994521: Tournament #3082648141, $0.98+$0.12 USD Hold'em No Limit - Level XXII (1000/2000) - 2020/12/28 0:03:26 EET [2020/12/27 17:03:26 ET]
Table '3082648141 47' 9-max Seat #8 is the button
Seat 1: peio123 (86120 in chips) 
Seat 2: Dgo Sytrik (150206 in chips) 
Seat 3: jcarlos.vale (55041 in chips) 
Seat 4: Loserknight (46180 in chips) 
Seat 5: engel395 (56311 in chips) 
Seat 6: Element 179 (171258 in chips) 
Seat 7: kukbik (59487 in chips) 
Seat 8: houlajk (41354 in chips) 
Seat 9: atrocity95 (86150 in chips) 
peio123: posts the ante 175
Dgo Sytrik: posts the ante 175
jcarlos.vale: posts the ante 175
Loserknight: posts the ante 175
engel395: posts the ante 175
Element 179: posts the ante 175
kukbik: posts the ante 175
houlajk: posts the ante 175
atrocity95: posts the ante 175
atrocity95: posts small blind 1000
peio123: posts big blind 2000
*** HOLE CARDS ***
Dealt to jcarlos.vale [8d 8s]
Dgo Sytrik: folds 
jcarlos.vale: raises 3200 to 5200
Loserknight: folds 
engel395: folds 
Element 179: folds 
kukbik: folds 
houlajk: folds 
atrocity95: folds 
peio123: folds 
Uncalled bet (3200) returned to jcarlos.vale
jcarlos.vale collected 6575 from pot
jcarlos.vale: doesn't show handDTO
*** SUMMARY ***
Total pot 6575 | Rake 0 
Seat 1: peio123 (big blind) folded before Flop
Seat 2: Dgo Sytrik folded before Flop (didn't bet)
Seat 3: jcarlos.vale collected (6575)
Seat 4: Loserknight folded before Flop (didn't bet)
Seat 5: engel395 folded before Flop (didn't bet)
Seat 6: Element 179 folded before Flop (didn't bet)
Seat 7: kukbik folded before Flop (didn't bet)
Seat 8: houlajk (button) folded before Flop (didn't bet)
Seat 9: atrocity95 (small blind) folded before Flop



PokerStars Hand #221921023282: Tournament #3082648141, $0.98+$0.12 USD Hold'em No Limit - Level XXII (1000/2000) - 2020/12/28 0:03:59 EET [2020/12/27 17:03:59 ET]
Table '3082648141 47' 9-max Seat #9 is the button
Seat 1: peio123 (83945 in chips) 
Seat 2: Dgo Sytrik (150031 in chips) 
Seat 3: jcarlos.vale (59441 in chips) 
Seat 4: Loserknight (46005 in chips) 
Seat 5: engel395 (56136 in chips) 
Seat 6: Element 179 (171083 in chips) 
Seat 7: kukbik (59312 in chips) 
Seat 8: houlajk (41179 in chips) 
Seat 9: atrocity95 (84975 in chips) 
peio123: posts the ante 175
Dgo Sytrik: posts the ante 175
jcarlos.vale: posts the ante 175
Loserknight: posts the ante 175
engel395: posts the ante 175
Element 179: posts the ante 175
kukbik: posts the ante 175
houlajk: posts the ante 175
atrocity95: posts the ante 175
peio123: posts small blind 1000
Dgo Sytrik: posts big blind 2000
*** HOLE CARDS ***
Dealt to jcarlos.vale [Qc Tc]
jcarlos.vale: folds 
Loserknight: folds 
engel395: folds 
Element 179: folds 
kukbik: raises 2000 to 4000
houlajk: folds 
atrocity95: folds 
peio123: folds 
Dgo Sytrik: folds 
Uncalled bet (2000) returned to kukbik
kukbik collected 6575 from pot
kukbik: doesn't show handDTO
*** SUMMARY ***
Total pot 6575 | Rake 0 
Seat 1: peio123 (small blind) folded before Flop
Seat 2: Dgo Sytrik (big blind) folded before Flop
Seat 3: jcarlos.vale folded before Flop (didn't bet)
Seat 4: Loserknight folded before Flop (didn't bet)
Seat 5: engel395 folded before Flop (didn't bet)
Seat 6: Element 179 folded before Flop (didn't bet)
Seat 7: kukbik collected (6575)
Seat 8: houlajk folded before Flop (didn't bet)
Seat 9: atrocity95 (button) folded before Flop (didn't bet)



PokerStars Hand #221921040828: Tournament #3082648141, $0.98+$0.12 USD Hold'em No Limit - Level XXII (1000/2000) - 2020/12/28 0:04:19 EET [2020/12/27 17:04:19 ET]
Table '3082648141 47' 9-max Seat #1 is the button
Seat 1: peio123 (82770 in chips) 
Seat 2: Dgo Sytrik (147856 in chips) 
Seat 3: jcarlos.vale (59266 in chips) 
Seat 4: Loserknight (45830 in chips) 
Seat 5: engel395 (55961 in chips) 
Seat 6: Element 179 (170908 in chips) 
Seat 7: kukbik (63712 in chips) 
Seat 8: houlajk (41004 in chips) 
Seat 9: atrocity95 (84800 in chips) 
peio123: posts the ante 175
Dgo Sytrik: posts the ante 175
jcarlos.vale: posts the ante 175
Loserknight: posts the ante 175
engel395: posts the ante 175
Element 179: posts the ante 175
kukbik: posts the ante 175
houlajk: posts the ante 175
atrocity95: posts the ante 175
Dgo Sytrik: posts small blind 1000
jcarlos.vale: posts big blind 2000
*** HOLE CARDS ***
Dealt to jcarlos.vale [Qd 6c]
Loserknight: folds 
engel395: folds 
Element 179: folds 
kukbik: folds 
houlajk: folds 
atrocity95: folds 
peio123 has timed out
peio123: folds 
peio123 is sitting out
Dgo Sytrik: raises 4000 to 6000
peio123 has returned
jcarlos.vale: folds 
Uncalled bet (4000) returned to Dgo Sytrik
Dgo Sytrik collected 5575 from pot
Dgo Sytrik: doesn't show handDTO
*** SUMMARY ***
Total pot 5575 | Rake 0 
Seat 1: peio123 (button) folded before Flop (didn't bet)
Seat 2: Dgo Sytrik (small blind) collected (5575)
Seat 3: jcarlos.vale (big blind) folded before Flop
Seat 4: Loserknight folded before Flop (didn't bet)
Seat 5: engel395 folded before Flop (didn't bet)
Seat 6: Element 179 folded before Flop (didn't bet)
Seat 7: kukbik folded before Flop (didn't bet)
Seat 8: houlajk folded before Flop (didn't bet)
Seat 9: atrocity95 folded before Flop (didn't bet)



PokerStars Hand #221921077687: Tournament #3082648141, $0.98+$0.12 USD Hold'em No Limit - Level XXII (1000/2000) - 2020/12/28 0:05:01 EET [2020/12/27 17:05:01 ET]
Table '3082648141 47' 9-max Seat #2 is the button
Seat 1: peio123 (82595 in chips) 
Seat 2: Dgo Sytrik (151256 in chips) 
Seat 3: jcarlos.vale (57091 in chips) 
Seat 4: Loserknight (45655 in chips) 
Seat 5: engel395 (55786 in chips) 
Seat 6: Element 179 (170733 in chips) 
Seat 7: kukbik (63537 in chips) 
Seat 8: houlajk (40829 in chips) 
Seat 9: atrocity95 (84625 in chips) 
peio123: posts the ante 175
Dgo Sytrik: posts the ante 175
jcarlos.vale: posts the ante 175
Loserknight: posts the ante 175
engel395: posts the ante 175
Element 179: posts the ante 175
kukbik: posts the ante 175
houlajk: posts the ante 175
atrocity95: posts the ante 175
jcarlos.vale: posts small blind 1000
Loserknight: posts big blind 2000
*** HOLE CARDS ***
Dealt to jcarlos.vale [6h Jd]
engel395: calls 2000
Element 179: folds 
kukbik: folds 
houlajk: folds 
atrocity95: folds 
peio123: folds 
Dgo Sytrik: folds 
jcarlos.vale: calls 1000
Loserknight: checks 
*** FLOP *** [9d Jc Ad]
jcarlos.vale: bets 4000
Loserknight: folds 
engel395: calls 4000
*** TURN *** [9d Jc Ad] [5d]
jcarlos.vale: bets 4000
engel395: calls 4000
*** RIVER *** [9d Jc Ad 5d] [8d]
jcarlos.vale: bets 4000
engel395: calls 4000
*** SHOW DOWN ***
jcarlos.vale: shows [6h Jd] (a flush, Ace high)
engel395: mucks handDTO
jcarlos.vale collected 31575 from pot
*** SUMMARY ***
Total pot 31575 | Rake 0 
Board [9d Jc Ad 5d 8d]
Seat 1: peio123 folded before Flop (didn't bet)
Seat 2: Dgo Sytrik (button) folded before Flop (didn't bet)
Seat 3: jcarlos.vale (small blind) showed [6h Jd] and won (31575) with a flush, Ace high
Seat 4: Loserknight (big blind) folded on the Flop
Seat 5: engel395 mucked [4s 4c]
Seat 6: Element 179 folded before Flop (didn't bet)
Seat 7: kukbik folded before Flop (didn't bet)
Seat 8: houlajk folded before Flop (didn't bet)
Seat 9: atrocity95 folded before Flop (didn't bet)



PokerStars Hand #221921128191: Tournament #3082648141, $0.98+$0.12 USD Hold'em No Limit - Level XXII (1000/2000) - 2020/12/28 0:05:55 EET [2020/12/27 17:05:55 ET]
Table '3082648141 47' 9-max Seat #3 is the button
Seat 1: peio123 (82420 in chips) 
Seat 2: Dgo Sytrik (151081 in chips) 
Seat 3: jcarlos.vale (74491 in chips) 
Seat 4: Loserknight (43480 in chips) 
Seat 5: engel395 (41611 in chips) 
Seat 6: Element 179 (170558 in chips) 
Seat 7: kukbik (63362 in chips) 
Seat 8: houlajk (40654 in chips) 
Seat 9: atrocity95 (84450 in chips) 
peio123: posts the ante 175
Dgo Sytrik: posts the ante 175
jcarlos.vale: posts the ante 175
Loserknight: posts the ante 175
engel395: posts the ante 175
Element 179: posts the ante 175
kukbik: posts the ante 175
houlajk: posts the ante 175
atrocity95: posts the ante 175
Loserknight: posts small blind 1000
engel395: posts big blind 2000
*** HOLE CARDS ***
Dealt to jcarlos.vale [Qh 7d]
Element 179: folds 
kukbik: folds 
houlajk: raises 2000 to 4000
atrocity95: folds 
peio123: folds 
Dgo Sytrik: folds 
jcarlos.vale: folds 
Loserknight: folds 
engel395: folds 
Uncalled bet (2000) returned to houlajk
houlajk collected 6575 from pot
houlajk: doesn't show handDTO
*** SUMMARY ***
Total pot 6575 | Rake 0 
Seat 1: peio123 folded before Flop (didn't bet)
Seat 2: Dgo Sytrik folded before Flop (didn't bet)
Seat 3: jcarlos.vale (button) folded before Flop (didn't bet)
Seat 4: Loserknight (small blind) folded before Flop
Seat 5: engel395 (big blind) folded before Flop
Seat 6: Element 179 folded before Flop (didn't bet)
Seat 7: kukbik folded before Flop (didn't bet)
Seat 8: houlajk collected (6575)
Seat 9: atrocity95 folded before Flop (didn't bet)



PokerStars Hand #221921152749: Tournament #3082648141, $0.98+$0.12 USD Hold'em No Limit - Level XXII (1000/2000) - 2020/12/28 0:06:22 EET [2020/12/27 17:06:22 ET]
Table '3082648141 47' 9-max Seat #4 is the button
Seat 1: peio123 (82245 in chips) 
Seat 2: Dgo Sytrik (150906 in chips) 
Seat 3: jcarlos.vale (74316 in chips) 
Seat 4: Loserknight (42305 in chips) 
Seat 5: engel395 (39436 in chips) 
Seat 6: Element 179 (170383 in chips) 
Seat 7: kukbik (63187 in chips) 
Seat 8: houlajk (45054 in chips) 
Seat 9: atrocity95 (84275 in chips) 
peio123: posts the ante 175
Dgo Sytrik: posts the ante 175
jcarlos.vale: posts the ante 175
Loserknight: posts the ante 175
engel395: posts the ante 175
Element 179: posts the ante 175
kukbik: posts the ante 175
houlajk: posts the ante 175
atrocity95: posts the ante 175
engel395: posts small blind 1000
Element 179: posts big blind 2000
*** HOLE CARDS ***
Dealt to jcarlos.vale [4c 8h]
kukbik: folds 
houlajk: folds 
atrocity95: folds 
peio123 has timed out
peio123: folds 
peio123 is sitting out
Dgo Sytrik: folds 
jcarlos.vale: folds 
Loserknight: folds 
engel395: folds 
Uncalled bet (1000) returned to Element 179
Element 179 collected 3575 from pot
Element 179: doesn't show handDTO
*** SUMMARY ***
Total pot 3575 | Rake 0 
Seat 1: peio123 folded before Flop (didn't bet)
Seat 2: Dgo Sytrik folded before Flop (didn't bet)
Seat 3: jcarlos.vale folded before Flop (didn't bet)
Seat 4: Loserknight (button) folded before Flop (didn't bet)
Seat 5: engel395 (small blind) folded before Flop
Seat 6: Element 179 (big blind) collected (3575)
Seat 7: kukbik folded before Flop (didn't bet)
Seat 8: houlajk folded before Flop (didn't bet)
Seat 9: atrocity95 folded before Flop (didn't bet)



PokerStars Hand #221921181344: Tournament #3082648141, $0.98+$0.12 USD Hold'em No Limit - Level XXII (1000/2000) - 2020/12/28 0:06:53 EET [2020/12/27 17:06:53 ET]
Table '3082648141 47' 9-max Seat #5 is the button
Seat 1: peio123 (82070 in chips) is sitting out
Seat 2: Dgo Sytrik (150731 in chips) 
Seat 3: jcarlos.vale (74141 in chips) 
Seat 4: Loserknight (42130 in chips) 
Seat 5: engel395 (38261 in chips) 
Seat 6: Element 179 (172783 in chips) 
Seat 7: kukbik (63012 in chips) 
Seat 8: houlajk (44879 in chips) 
Seat 9: atrocity95 (84100 in chips) 
peio123: posts the ante 175
Dgo Sytrik: posts the ante 175
jcarlos.vale: posts the ante 175
Loserknight: posts the ante 175
engel395: posts the ante 175
Element 179: posts the ante 175
kukbik: posts the ante 175
houlajk: posts the ante 175
atrocity95: posts the ante 175
Element 179: posts small blind 1000
kukbik: posts big blind 2000
*** HOLE CARDS ***
Dealt to jcarlos.vale [9c 7c]
houlajk: folds 
atrocity95: folds 
peio123: folds 
Dgo Sytrik: raises 4000 to 6000
jcarlos.vale: folds 
Loserknight: folds 
engel395: folds 
peio123 has returned
Element 179: folds 
kukbik: folds 
Uncalled bet (4000) returned to Dgo Sytrik
Dgo Sytrik collected 6575 from pot
Dgo Sytrik: doesn't show handDTO
*** SUMMARY ***
Total pot 6575 | Rake 0 
Seat 1: peio123 folded before Flop (didn't bet)
Seat 2: Dgo Sytrik collected (6575)
Seat 3: jcarlos.vale folded before Flop (didn't bet)
Seat 4: Loserknight folded before Flop (didn't bet)
Seat 5: engel395 (button) folded before Flop (didn't bet)
Seat 6: Element 179 (small blind) folded before Flop
Seat 7: kukbik (big blind) folded before Flop
Seat 8: houlajk folded before Flop (didn't bet)
Seat 9: atrocity95 folded before Flop (didn't bet)



PokerStars Hand #221921203888: Tournament #3082648141, $0.98+$0.12 USD Hold'em No Limit - Level XXII (1000/2000) - 2020/12/28 0:07:17 EET [2020/12/27 17:07:17 ET]
Table '3082648141 47' 9-max Seat #6 is the button
Seat 1: peio123 (81895 in chips) 
Seat 2: Dgo Sytrik (155131 in chips) 
Seat 3: jcarlos.vale (73966 in chips) 
Seat 4: Loserknight (41955 in chips) 
Seat 5: engel395 (38086 in chips) 
Seat 6: Element 179 (171608 in chips) 
Seat 7: kukbik (60837 in chips) 
Seat 8: houlajk (44704 in chips) 
Seat 9: atrocity95 (83925 in chips) 
peio123: posts the ante 175
Dgo Sytrik: posts the ante 175
jcarlos.vale: posts the ante 175
Loserknight: posts the ante 175
engel395: posts the ante 175
Element 179: posts the ante 175
kukbik: posts the ante 175
houlajk: posts the ante 175
atrocity95: posts the ante 175
kukbik: posts small blind 1000
houlajk: posts big blind 2000
*** HOLE CARDS ***
Dealt to jcarlos.vale [7s Jd]
atrocity95: folds 
peio123: folds 
Dgo Sytrik: folds 
jcarlos.vale: folds 
Loserknight: folds 
engel395: folds 
Element 179: raises 3000 to 5000
kukbik: folds 
houlajk: folds 
Uncalled bet (3000) returned to Element 179
Element 179 collected 6575 from pot
Element 179: doesn't show handDTO
*** SUMMARY ***
Total pot 6575 | Rake 0 
Seat 1: peio123 folded before Flop (didn't bet)
Seat 2: Dgo Sytrik folded before Flop (didn't bet)
Seat 3: jcarlos.vale folded before Flop (didn't bet)
Seat 4: Loserknight folded before Flop (didn't bet)
Seat 5: engel395 folded before Flop (didn't bet)
Seat 6: Element 179 (button) collected (6575)
Seat 7: kukbik (small blind) folded before Flop
Seat 8: houlajk (big blind) folded before Flop
Seat 9: atrocity95 folded before Flop (didn't bet)



PokerStars Hand #221921224381: Tournament #3082648141, $0.98+$0.12 USD Hold'em No Limit - Level XXII (1000/2000) - 2020/12/28 0:07:40 EET [2020/12/27 17:07:40 ET]
Table '3082648141 47' 9-max Seat #7 is the button
Seat 1: peio123 (81720 in chips) 
Seat 2: Dgo Sytrik (154956 in chips) 
Seat 3: jcarlos.vale (73791 in chips) 
Seat 4: Loserknight (41780 in chips) 
Seat 5: engel395 (37911 in chips) 
Seat 6: Element 179 (176008 in chips) 
Seat 7: kukbik (59662 in chips) 
Seat 8: houlajk (42529 in chips) 
Seat 9: atrocity95 (83750 in chips) 
peio123: posts the ante 175
Dgo Sytrik: posts the ante 175
jcarlos.vale: posts the ante 175
Loserknight: posts the ante 175
engel395: posts the ante 175
Element 179: posts the ante 175
kukbik: posts the ante 175
houlajk: posts the ante 175
atrocity95: posts the ante 175
houlajk: posts small blind 1000
atrocity95: posts big blind 2000
*** HOLE CARDS ***
Dealt to jcarlos.vale [Jh Td]
peio123: folds 
Dgo Sytrik: folds 
jcarlos.vale: folds 
Loserknight: folds 
engel395: folds 
Element 179: folds 
kukbik: folds 
houlajk: calls 1000
atrocity95: checks 
*** FLOP *** [2c 2h Ad]
houlajk: checks 
atrocity95: checks 
*** TURN *** [2c 2h Ad] [Tc]
houlajk: bets 4181
atrocity95: folds 
Uncalled bet (4181) returned to houlajk
houlajk collected 5575 from pot
houlajk: doesn't show handDTO
*** SUMMARY ***
Total pot 5575 | Rake 0 
Board [2c 2h Ad Tc]
Seat 1: peio123 folded before Flop (didn't bet)
Seat 2: Dgo Sytrik folded before Flop (didn't bet)
Seat 3: jcarlos.vale folded before Flop (didn't bet)
Seat 4: Loserknight folded before Flop (didn't bet)
Seat 5: engel395 folded before Flop (didn't bet)
Seat 6: Element 179 folded before Flop (didn't bet)
Seat 7: kukbik (button) folded before Flop (didn't bet)
Seat 8: houlajk (small blind) collected (5575)
Seat 9: atrocity95 (big blind) folded on the Turn



PokerStars Hand #221921302597: Tournament #3082648141, $0.98+$0.12 USD Hold'em No Limit - Level XXIII (1250/2500) - 2020/12/28 0:08:55 EET [2020/12/27 17:08:55 ET]
Table '3082648141 47' 9-max Seat #8 is the button
Seat 1: peio123 (81545 in chips) 
Seat 2: Dgo Sytrik (154781 in chips) 
Seat 3: jcarlos.vale (73616 in chips) 
Seat 4: Loserknight (41605 in chips) 
Seat 5: engel395 (37736 in chips) 
Seat 6: Element 179 (175833 in chips) 
Seat 7: kukbik (59487 in chips) 
Seat 8: houlajk (45929 in chips) 
Seat 9: atrocity95 (81575 in chips) 
peio123: posts the ante 200
Dgo Sytrik: posts the ante 200
jcarlos.vale: posts the ante 200
Loserknight: posts the ante 200
engel395: posts the ante 200
Element 179: posts the ante 200
kukbik: posts the ante 200
houlajk: posts the ante 200
atrocity95: posts the ante 200
atrocity95: posts small blind 1250
peio123: posts big blind 2500
*** HOLE CARDS ***
Dealt to jcarlos.vale [4d 5d]
Dgo Sytrik: folds 
jcarlos.vale: raises 4000 to 6500
Loserknight: folds 
engel395: folds 
Element 179: calls 6500
kukbik: folds 
houlajk: raises 39229 to 45729 and is all-in
atrocity95: folds 
peio123: folds 
jcarlos.vale: folds 
Element 179: folds 
Uncalled bet (39229) returned to houlajk
houlajk collected 25050 from pot
houlajk: doesn't show handDTO
*** SUMMARY ***
Total pot 25050 | Rake 0 
Seat 1: peio123 (big blind) folded before Flop
Seat 2: Dgo Sytrik folded before Flop (didn't bet)
Seat 3: jcarlos.vale folded before Flop
Seat 4: Loserknight folded before Flop (didn't bet)
Seat 5: engel395 folded before Flop (didn't bet)
Seat 6: Element 179 folded before Flop
Seat 7: kukbik folded before Flop (didn't bet)
Seat 8: houlajk (button) collected (25050)
Seat 9: atrocity95 (small blind) folded before Flop



PokerStars Hand #221921355303: Tournament #3082648141, $0.98+$0.12 USD Hold'em No Limit - Level XXIII (1250/2500) - 2020/12/28 0:09:46 EET [2020/12/27 17:09:46 ET]
Table '3082648141 47' 9-max Seat #9 is the button
Seat 1: peio123 (78845 in chips) 
Seat 2: Dgo Sytrik (154581 in chips) 
Seat 3: jcarlos.vale (66916 in chips) 
Seat 4: Loserknight (41405 in chips) 
Seat 5: engel395 (37536 in chips) 
Seat 6: Element 179 (169133 in chips) 
Seat 7: kukbik (59287 in chips) 
Seat 8: houlajk (64279 in chips) 
Seat 9: atrocity95 (80125 in chips) 
peio123: posts the ante 200
Dgo Sytrik: posts the ante 200
jcarlos.vale: posts the ante 200
Loserknight: posts the ante 200
engel395: posts the ante 200
Element 179: posts the ante 200
kukbik: posts the ante 200
houlajk: posts the ante 200
atrocity95: posts the ante 200
peio123: posts small blind 1250
Dgo Sytrik: posts big blind 2500
*** HOLE CARDS ***
Dealt to jcarlos.vale [Ad 4c]
jcarlos.vale: folds 
Loserknight: folds 
engel395: calls 2500
Element 179: raises 5500 to 8000
kukbik: folds 
houlajk: folds 
atrocity95: folds 
peio123: folds 
Dgo Sytrik: folds 
engel395: calls 5500
*** FLOP *** [6d 7c Tc]
engel395: bets 10000
Element 179: raises 20000 to 30000
engel395: calls 19336 and is all-in
Uncalled bet (664) returned to Element 179
*** TURN *** [6d 7c Tc] [Qd]
*** RIVER *** [6d 7c Tc Qd] [3h]
*** SHOW DOWN ***
engel395: shows [Ah Kd] (high pairOfCards Ace)
Element 179: shows [Qs Qh] (three of a kind, Queens)
Element 179 collected 80222 from pot
engel395 finished the tournament in 287th place and received $3.44.
*** SUMMARY ***
Total pot 80222 | Rake 0 
Board [6d 7c Tc Qd 3h]
Seat 1: peio123 (small blind) folded before Flop
Seat 2: Dgo Sytrik (big blind) folded before Flop
Seat 3: jcarlos.vale folded before Flop (didn't bet)
Seat 4: Loserknight folded before Flop (didn't bet)
Seat 5: engel395 showed [Ah Kd] and lost with high pairOfCards Ace
Seat 6: Element 179 showed [Qs Qh] and won (80222) with three of a kind, Queens
Seat 7: kukbik folded before Flop (didn't bet)
Seat 8: houlajk folded before Flop (didn't bet)
Seat 9: atrocity95 (button) folded before Flop (didn't bet)



PokerStars Hand #221921414316: Tournament #3082648141, $0.98+$0.12 USD Hold'em No Limit - Level XXIII (1250/2500) - 2020/12/28 0:10:51 EET [2020/12/27 17:10:51 ET]
Table '3082648141 47' 9-max Seat #1 is the button
Seat 1: peio123 (77395 in chips) 
Seat 2: Dgo Sytrik (151881 in chips) 
Seat 3: jcarlos.vale (66716 in chips) 
Seat 4: Loserknight (41205 in chips) 
Seat 6: Element 179 (211819 in chips) 
Seat 7: kukbik (59087 in chips) 
Seat 8: houlajk (64079 in chips) 
Seat 9: atrocity95 (79925 in chips) 
peio123: posts the ante 200
Dgo Sytrik: posts the ante 200
jcarlos.vale: posts the ante 200
Loserknight: posts the ante 200
Element 179: posts the ante 200
kukbik: posts the ante 200
houlajk: posts the ante 200
atrocity95: posts the ante 200
Dgo Sytrik: posts small blind 1250
jcarlos.vale: posts big blind 2500
*** HOLE CARDS ***
Dealt to jcarlos.vale [9c Kd]
Loserknight: folds 
Element 179: folds 
kukbik: folds 
houlajk: folds 
atrocity95: folds 
peio123: folds 
Dgo Sytrik: raises 2500 to 5000
jcarlos.vale: raises 61516 to 66516 and is all-in
Dgo Sytrik: folds 
Uncalled bet (61516) returned to jcarlos.vale
jcarlos.vale collected 11600 from pot
jcarlos.vale: doesn't show handDTO
*** SUMMARY ***
Total pot 11600 | Rake 0 
Seat 1: peio123 (button) folded before Flop (didn't bet)
Seat 2: Dgo Sytrik (small blind) folded before Flop
Seat 3: jcarlos.vale (big blind) collected (11600)
Seat 4: Loserknight folded before Flop (didn't bet)
Seat 6: Element 179 folded before Flop (didn't bet)
Seat 7: kukbik folded before Flop (didn't bet)
Seat 8: houlajk folded before Flop (didn't bet)
Seat 9: atrocity95 folded before Flop (didn't bet)



PokerStars Hand #221921446297: Tournament #3082648141, $0.98+$0.12 USD Hold'em No Limit - Level XXIII (1250/2500) - 2020/12/28 0:11:26 EET [2020/12/27 17:11:26 ET]
Table '3082648141 47' 9-max Seat #2 is the button
Seat 1: peio123 (77195 in chips) 
Seat 2: Dgo Sytrik (146681 in chips) 
Seat 3: jcarlos.vale (73116 in chips) 
Seat 4: Loserknight (41005 in chips) 
Seat 6: Element 179 (211619 in chips) 
Seat 7: kukbik (58887 in chips) 
Seat 8: houlajk (63879 in chips) 
Seat 9: atrocity95 (79725 in chips) 
peio123: posts the ante 200
Dgo Sytrik: posts the ante 200
jcarlos.vale: posts the ante 200
Loserknight: posts the ante 200
Element 179: posts the ante 200
kukbik: posts the ante 200
houlajk: posts the ante 200
atrocity95: posts the ante 200
jcarlos.vale: posts small blind 1250
Loserknight: posts big blind 2500
*** HOLE CARDS ***
Dealt to jcarlos.vale [5s Qs]
Element 179: raises 3710 to 6210
kukbik: folds 
houlajk: folds 
atrocity95: folds 
peio123: calls 6210
Dgo Sytrik: folds 
jcarlos.vale: folds 
Loserknight: folds 
*** FLOP *** [4c 9c Jc]
Element 179: checks 
peio123: bets 12500
Element 179: calls 12500
*** TURN *** [4c 9c Jc] [8c]
Element 179: checks 
peio123: checks 
*** RIVER *** [4c 9c Jc 8c] [Qd]
Element 179: checks 
peio123: checks 
*** SHOW DOWN ***
Element 179: shows [9h 9s] (three of a kind, Nines)
peio123: shows [Jd Td] (a straight, Eight to Queen)
peio123 collected 42770 from pot
*** SUMMARY ***
Total pot 42770 | Rake 0 
Board [4c 9c Jc 8c Qd]
Seat 1: peio123 showed [Jd Td] and won (42770) with a straight, Eight to Queen
Seat 2: Dgo Sytrik (button) folded before Flop (didn't bet)
Seat 3: jcarlos.vale (small blind) folded before Flop
Seat 4: Loserknight (big blind) folded before Flop
Seat 6: Element 179 showed [9h 9s] and lost with three of a kind, Nines
Seat 7: kukbik folded before Flop (didn't bet)
Seat 8: houlajk folded before Flop (didn't bet)
Seat 9: atrocity95 folded before Flop (didn't bet)



PokerStars Hand #221921502022: Tournament #3082648141, $0.98+$0.12 USD Hold'em No Limit - Level XXIII (1250/2500) - 2020/12/28 0:12:28 EET [2020/12/27 17:12:28 ET]
Table '3082648141 47' 9-max Seat #3 is the button
Seat 1: peio123 (101055 in chips) 
Seat 2: Dgo Sytrik (146481 in chips) 
Seat 3: jcarlos.vale (71666 in chips) 
Seat 4: Loserknight (38305 in chips) 
Seat 6: Element 179 (192709 in chips) 
Seat 7: kukbik (58687 in chips) 
Seat 8: houlajk (63679 in chips) 
Seat 9: atrocity95 (79525 in chips) 
peio123: posts the ante 200
Dgo Sytrik: posts the ante 200
jcarlos.vale: posts the ante 200
Loserknight: posts the ante 200
Element 179: posts the ante 200
kukbik: posts the ante 200
houlajk: posts the ante 200
atrocity95: posts the ante 200
Loserknight: posts small blind 1250
Element 179: posts big blind 2500
*** HOLE CARDS ***
Dealt to jcarlos.vale [9d 7d]
kukbik: folds 
houlajk: folds 
atrocity95: folds 
peio123: folds 
Dgo Sytrik: raises 5000 to 7500
jcarlos.vale: folds 
Loserknight: folds 
Element 179: calls 5000
*** FLOP *** [3h 8h 6h]
Element 179: checks 
Dgo Sytrik: bets 15000
Element 179: folds 
Uncalled bet (15000) returned to Dgo Sytrik
Dgo Sytrik collected 17850 from pot
Dgo Sytrik: doesn't show handDTO
*** SUMMARY ***
Total pot 17850 | Rake 0 
Board [3h 8h 6h]
Seat 1: peio123 folded before Flop (didn't bet)
Seat 2: Dgo Sytrik collected (17850)
Seat 3: jcarlos.vale (button) folded before Flop (didn't bet)
Seat 4: Loserknight (small blind) folded before Flop
Seat 6: Element 179 (big blind) folded on the Flop
Seat 7: kukbik folded before Flop (didn't bet)
Seat 8: houlajk folded before Flop (didn't bet)
Seat 9: atrocity95 folded before Flop (didn't bet)



PokerStars Hand #221921541280: Tournament #3082648141, $0.98+$0.12 USD Hold'em No Limit - Level XXIII (1250/2500) - 2020/12/28 0:13:11 EET [2020/12/27 17:13:11 ET]
Table '3082648141 47' 9-max Seat #4 is the button
Seat 1: peio123 (100855 in chips) 
Seat 2: Dgo Sytrik (156631 in chips) 
Seat 3: jcarlos.vale (71466 in chips) 
Seat 4: Loserknight (36855 in chips) 
Seat 5: calinob (65043 in chips) out of handDTO (moved from another table into small blind)
Seat 6: Element 179 (185009 in chips) 
Seat 7: kukbik (58487 in chips) 
Seat 8: houlajk (63479 in chips) 
Seat 9: atrocity95 (79325 in chips) 
calinob will be allowed to play after the button
peio123: posts the ante 200
Dgo Sytrik: posts the ante 200
jcarlos.vale: posts the ante 200
Loserknight: posts the ante 200
Element 179: posts the ante 200
kukbik: posts the ante 200
houlajk: posts the ante 200
atrocity95: posts the ante 200
Element 179: posts small blind 1250
kukbik: posts big blind 2500
*** HOLE CARDS ***
Dealt to jcarlos.vale [Qs Ac]
houlajk: folds 
atrocity95: folds 
peio123: folds 
Dgo Sytrik: folds 
jcarlos.vale: raises 4000 to 6500
Loserknight: folds 
Element 179: folds 
kukbik: folds 
Uncalled bet (4000) returned to jcarlos.vale
jcarlos.vale collected 7850 from pot
jcarlos.vale: doesn't show handDTO
*** SUMMARY ***
Total pot 7850 | Rake 0 
Seat 1: peio123 folded before Flop (didn't bet)
Seat 2: Dgo Sytrik folded before Flop (didn't bet)
Seat 3: jcarlos.vale collected (7850)
Seat 4: Loserknight (button) folded before Flop (didn't bet)
Seat 6: Element 179 (small blind) folded before Flop
Seat 7: kukbik (big blind) folded before Flop
Seat 8: houlajk folded before Flop (didn't bet)
Seat 9: atrocity95 folded before Flop (didn't bet)



PokerStars Hand #221921593327: Tournament #3082648141, $0.98+$0.12 USD Hold'em No Limit - Level XXIII (1250/2500) - 2020/12/28 0:14:09 EET [2020/12/27 17:14:09 ET]
Table '3082648141 47' 9-max Seat #6 is the button
Seat 1: peio123 (100655 in chips) 
Seat 2: Dgo Sytrik (156431 in chips) 
Seat 3: jcarlos.vale (76616 in chips) 
Seat 4: Loserknight (36655 in chips) 
Seat 5: calinob (65043 in chips) 
Seat 6: Element 179 (183559 in chips) 
Seat 7: kukbik (55787 in chips) 
Seat 8: houlajk (63279 in chips) 
Seat 9: atrocity95 (79125 in chips) 
peio123: posts the ante 200
Dgo Sytrik: posts the ante 200
jcarlos.vale: posts the ante 200
Loserknight: posts the ante 200
calinob: posts the ante 200
Element 179: posts the ante 200
kukbik: posts the ante 200
houlajk: posts the ante 200
atrocity95: posts the ante 200
kukbik: posts small blind 1250
houlajk: posts big blind 2500
*** HOLE CARDS ***
Dealt to jcarlos.vale [Ah Kc]
atrocity95: folds 
peio123: folds 
Dgo Sytrik: folds 
jcarlos.vale: raises 4000 to 6500
Loserknight: folds 
calinob: folds 
Element 179: folds 
kukbik: calls 5250
houlajk: calls 4000
*** FLOP *** [6d 8h 7c]
kukbik: checks 
houlajk: checks 
jcarlos.vale: checks 
*** TURN *** [6d 8h 7c] [Ac]
kukbik: checks 
houlajk: checks 
jcarlos.vale: bets 15975
kukbik: calls 15975
houlajk: folds 
*** RIVER *** [6d 8h 7c Ac] [Qs]
kukbik: bets 33112 and is all-in
jcarlos.vale: calls 33112
*** SHOW DOWN ***
kukbik: shows [Qc Ad] (two pair, Aces and Queens)
jcarlos.vale: shows [Ah Kc] (a pair of Aces)
kukbik collected 119474 from pot
*** SUMMARY ***
Total pot 119474 | Rake 0 
Board [6d 8h 7c Ac Qs]
Seat 1: peio123 folded before Flop (didn't bet)
Seat 2: Dgo Sytrik folded before Flop (didn't bet)
Seat 3: jcarlos.vale showed [Ah Kc] and lost with a pair of Aces
Seat 4: Loserknight folded before Flop (didn't bet)
Seat 5: calinob folded before Flop (didn't bet)
Seat 6: Element 179 (button) folded before Flop (didn't bet)
Seat 7: kukbik (small blind) showed [Qc Ad] and won (119474) with two pair, Aces and Queens
Seat 8: houlajk (big blind) folded on the Turn
Seat 9: atrocity95 folded before Flop (didn't bet)



PokerStars Hand #221921667414: Tournament #3082648141, $0.98+$0.12 USD Hold'em No Limit - Level XXIII (1250/2500) - 2020/12/28 0:15:31 EET [2020/12/27 17:15:31 ET]
Table '3082648141 47' 9-max Seat #7 is the button
Seat 1: peio123 (100455 in chips) 
Seat 2: Dgo Sytrik (156231 in chips) 
Seat 3: jcarlos.vale (20829 in chips) 
Seat 4: Loserknight (36455 in chips) 
Seat 5: calinob (64843 in chips) 
Seat 6: Element 179 (183359 in chips) 
Seat 7: kukbik (119474 in chips) 
Seat 8: houlajk (56579 in chips) 
Seat 9: atrocity95 (78925 in chips) 
peio123: posts the ante 200
Dgo Sytrik: posts the ante 200
jcarlos.vale: posts the ante 200
Loserknight: posts the ante 200
calinob: posts the ante 200
Element 179: posts the ante 200
kukbik: posts the ante 200
houlajk: posts the ante 200
atrocity95: posts the ante 200
houlajk: posts small blind 1250
atrocity95: posts big blind 2500
*** HOLE CARDS ***
Dealt to jcarlos.vale [Ks Js]
peio123: folds 
Dgo Sytrik: folds 
jcarlos.vale: raises 18129 to 20629 and is all-in
Loserknight: folds 
calinob: folds 
Element 179: folds 
kukbik: folds 
houlajk: folds 
atrocity95: calls 18129
*** FLOP *** [8h 4h Tc]
*** TURN *** [8h 4h Tc] [9s]
*** RIVER *** [8h 4h Tc 9s] [5d]
*** SHOW DOWN ***
atrocity95: shows [6h 6c] (a pair of Sixes)
jcarlos.vale: shows [Ks Js] (high pairOfCards King)
atrocity95 collected 44308 from pot
jcarlos.vale finished the tournament in 267th place and received $4.19.
*** SUMMARY ***
Total pot 44308 | Rake 0 
Board [8h 4h Tc 9s 5d]
Seat 1: peio123 folded before Flop (didn't bet)
Seat 2: Dgo Sytrik folded before Flop (didn't bet)
Seat 3: jcarlos.vale showed [Ks Js] and lost with high pairOfCards King
Seat 4: Loserknight folded before Flop (didn't bet)
Seat 5: calinob folded before Flop (didn't bet)
Seat 6: Element 179 folded before Flop (didn't bet)
Seat 7: kukbik (button) folded before Flop (didn't bet)
Seat 8: houlajk (small blind) folded before Flop
Seat 9: atrocity95 (big blind) showed [6h 6c] and won (44308) with a pair of Sixes



