PokerStars Hand #222144148471: Tournament #3086083919, $0.49+$0.06 USD Hold'em No Limit - Level I (15/30) - 2021/01/02 21:00:11 EET [2021/01/02 14:00:11 ET]
Table '3086083919 46' 9-max Seat #1 is the button
Seat 1: ramona691023 (5000 in chips) 
Seat 2: renanzin147 (5000 in chips) 
Seat 3: jcarlos.vale (5000 in chips) is sitting out
Seat 4: chekmpcc (5000 in chips) 
Seat 5: mariafirmina (5000 in chips) 
Seat 6: fakegodz (5000 in chips) 
Seat 7: ddurikkt (5000 in chips) 
Seat 8: Fischkop993 (5000 in chips) 
Seat 9: Trine2010 (5000 in chips) 
ramona691023: posts the ante 4
renanzin147: posts the ante 4
jcarlos.vale: posts the ante 4
chekmpcc: posts the ante 4
mariafirmina: posts the ante 4
fakegodz: posts the ante 4
ddurikkt: posts the ante 4
Fischkop993: posts the ante 4
Trine2010: posts the ante 4
renanzin147: posts small blind 15
jcarlos.vale: posts big blind 30
*** HOLE CARDS ***
Dealt to jcarlos.vale [6c 2h]
jcarlos.vale has returned
chekmpcc: folds 
mariafirmina: folds 
fakegodz: raises 120 to 150
ddurikkt: folds 
Fischkop993: folds 
Trine2010: folds 
ramona691023: calls 150
renanzin147: folds 
jcarlos.vale: folds 
*** FLOP *** [Kc Tc 6d]
fakegodz: bets 60
ramona691023: raises 60 to 120
fakegodz: calls 60
*** TURN *** [Kc Tc 6d] [5d]
fakegodz: bets 240
ramona691023: calls 240
*** RIVER *** [Kc Tc 6d 5d] [Ts]
fakegodz: bets 1101
ramona691023: folds 
Uncalled bet (1101) returned to fakegodz
fakegodz collected 1101 from pot
fakegodz: doesn't show handDTO
*** SUMMARY ***
Total pot 1101 | Rake 0 
Board [Kc Tc 6d 5d Ts]
Seat 1: ramona691023 (button) folded on the River
Seat 2: renanzin147 (small blind) folded before Flop
Seat 3: jcarlos.vale (big blind) folded before Flop
Seat 4: chekmpcc folded before Flop (didn't bet)
Seat 5: mariafirmina folded before Flop (didn't bet)
Seat 6: fakegodz collected (1101)
Seat 7: ddurikkt folded before Flop (didn't bet)
Seat 8: Fischkop993 folded before Flop (didn't bet)
Seat 9: Trine2010 folded before Flop (didn't bet)



PokerStars Hand #222144281857: Tournament #3086083919, $0.49+$0.06 USD Hold'em No Limit - Level I (15/30) - 2021/01/02 21:02:56 EET [2021/01/02 14:02:56 ET]
Table '3086083919 46' 9-max Seat #2 is the button
Seat 1: ramona691023 (4486 in chips) 
Seat 2: renanzin147 (4981 in chips) 
Seat 3: jcarlos.vale (4966 in chips) 
Seat 4: chekmpcc (4996 in chips) 
Seat 5: mariafirmina (4996 in chips) 
Seat 7: ddurikkt (4996 in chips) 
Seat 8: Fischkop993 (4996 in chips) 
Seat 9: Trine2010 (4996 in chips) 
ramona691023: posts the ante 4
renanzin147: posts the ante 4
jcarlos.vale: posts the ante 4
chekmpcc: posts the ante 4
mariafirmina: posts the ante 4
ddurikkt: posts the ante 4
Fischkop993: posts the ante 4
Trine2010: posts the ante 4
jcarlos.vale: posts small blind 15
chekmpcc: posts big blind 30
*** HOLE CARDS ***
Dealt to jcarlos.vale [5d 7s]
mariafirmina: folds 
ddurikkt: folds 
Fischkop993: folds 
Trine2010: folds 
ramona691023: calls 30
renanzin147: folds 
jcarlos.vale: calls 15
chekmpcc: raises 150 to 180
ramona691023: calls 150
jcarlos.vale: folds 
*** FLOP *** [5s 2s Td]
chekmpcc: bets 241
ramona691023: calls 241
*** TURN *** [5s 2s Td] [Js]
chekmpcc: checks 
ramona691023: bets 570
chekmpcc: folds 
Uncalled bet (570) returned to ramona691023
ramona691023 collected 904 from pot
ramona691023: doesn't show handDTO
*** SUMMARY ***
Total pot 904 | Rake 0 
Board [5s 2s Td Js]
Seat 1: ramona691023 collected (904)
Seat 2: renanzin147 (button) folded before Flop (didn't bet)
Seat 3: jcarlos.vale (small blind) folded before Flop
Seat 4: chekmpcc (big blind) folded on the Turn
Seat 5: mariafirmina folded before Flop (didn't bet)
Seat 7: ddurikkt folded before Flop (didn't bet)
Seat 8: Fischkop993 folded before Flop (didn't bet)
Seat 9: Trine2010 folded before Flop (didn't bet)



PokerStars Hand #222144347857: Tournament #3086083919, $0.49+$0.06 USD Hold'em No Limit - Level I (15/30) - 2021/01/02 21:04:09 EET [2021/01/02 14:04:09 ET]
Table '3086083919 46' 9-max Seat #3 is the button
Seat 1: ramona691023 (4965 in chips) 
Seat 2: renanzin147 (4977 in chips) 
Seat 3: jcarlos.vale (4932 in chips) 
Seat 4: chekmpcc (4571 in chips) 
Seat 5: mariafirmina (4992 in chips) 
Seat 6: Sobranie41 (5000 in chips) 
Seat 7: ddurikkt (4992 in chips) 
Seat 8: Fischkop993 (4992 in chips) 
Seat 9: Trine2010 (4992 in chips) 
ramona691023: posts the ante 4
renanzin147: posts the ante 4
jcarlos.vale: posts the ante 4
chekmpcc: posts the ante 4
mariafirmina: posts the ante 4
Sobranie41: posts the ante 4
ddurikkt: posts the ante 4
Fischkop993: posts the ante 4
Trine2010: posts the ante 4
chekmpcc: posts small blind 15
mariafirmina: posts big blind 30
*** HOLE CARDS ***
Dealt to jcarlos.vale [3s Ad]
Sobranie41: folds 
ddurikkt: raises 33 to 63
Fischkop993: folds 
Trine2010: folds 
ramona691023: calls 63
renanzin147: folds 
jcarlos.vale: folds 
chekmpcc: raises 183 to 246
mariafirmina: folds 
ddurikkt: raises 864 to 1110
ramona691023: calls 1047
chekmpcc: calls 864
*** FLOP *** [5h 5c 3h]
chekmpcc: checks 
ddurikkt: bets 3878 and is all-in
ramona691023: folds 
chekmpcc: folds 
Uncalled bet (3878) returned to ddurikkt
ddurikkt collected 3396 from pot
*** SUMMARY ***
Total pot 3396 | Rake 0 
Board [5h 5c 3h]
Seat 1: ramona691023 folded on the Flop
Seat 2: renanzin147 folded before Flop (didn't bet)
Seat 3: jcarlos.vale (button) folded before Flop (didn't bet)
Seat 4: chekmpcc (small blind) folded on the Flop
Seat 5: mariafirmina (big blind) folded before Flop
Seat 6: Sobranie41 folded before Flop (didn't bet)
Seat 7: ddurikkt collected (3396)
Seat 8: Fischkop993 folded before Flop (didn't bet)
Seat 9: Trine2010 folded before Flop (didn't bet)



PokerStars Hand #222144425971: Tournament #3086083919, $0.49+$0.06 USD Hold'em No Limit - Level I (15/30) - 2021/01/02 21:05:31 EET [2021/01/02 14:05:31 ET]
Table '3086083919 46' 9-max Seat #4 is the button
Seat 1: ramona691023 (3851 in chips) 
Seat 2: renanzin147 (4973 in chips) 
Seat 3: jcarlos.vale (4928 in chips) 
Seat 4: chekmpcc (3457 in chips) 
Seat 5: mariafirmina (4958 in chips) 
Seat 6: Sobranie41 (4996 in chips) 
Seat 7: ddurikkt (7274 in chips) 
Seat 8: Fischkop993 (4988 in chips) 
Seat 9: Trine2010 (4988 in chips) 
ramona691023: posts the ante 4
renanzin147: posts the ante 4
jcarlos.vale: posts the ante 4
chekmpcc: posts the ante 4
mariafirmina: posts the ante 4
Sobranie41: posts the ante 4
ddurikkt: posts the ante 4
Fischkop993: posts the ante 4
Trine2010: posts the ante 4
mariafirmina: posts small blind 15
Sobranie41: posts big blind 30
*** HOLE CARDS ***
Dealt to jcarlos.vale [5h Ad]
ddurikkt: raises 33 to 63
Fischkop993: folds 
Trine2010: calls 63
ramona691023: raises 627 to 690
renanzin147: folds 
jcarlos.vale: folds 
chekmpcc: folds 
mariafirmina: folds 
Sobranie41: folds 
ddurikkt: folds 
Trine2010: folds 
Uncalled bet (627) returned to ramona691023
ramona691023 collected 270 from pot
ramona691023: doesn't show handDTO
*** SUMMARY ***
Total pot 270 | Rake 0 
Seat 1: ramona691023 collected (270)
Seat 2: renanzin147 folded before Flop (didn't bet)
Seat 3: jcarlos.vale folded before Flop (didn't bet)
Seat 4: chekmpcc (button) folded before Flop (didn't bet)
Seat 5: mariafirmina (small blind) folded before Flop
Seat 6: Sobranie41 (big blind) folded before Flop
Seat 7: ddurikkt folded before Flop
Seat 8: Fischkop993 folded before Flop (didn't bet)
Seat 9: Trine2010 folded before Flop



PokerStars Hand #222144460208: Tournament #3086083919, $0.49+$0.06 USD Hold'em No Limit - Level I (15/30) - 2021/01/02 21:06:08 EET [2021/01/02 14:06:08 ET]
Table '3086083919 46' 9-max Seat #5 is the button
Seat 1: ramona691023 (4054 in chips) 
Seat 2: renanzin147 (4969 in chips) 
Seat 3: jcarlos.vale (4924 in chips) 
Seat 4: chekmpcc (3453 in chips) 
Seat 5: mariafirmina (4939 in chips) 
Seat 6: Sobranie41 (4962 in chips) 
Seat 7: ddurikkt (7207 in chips) 
Seat 8: Fischkop993 (4984 in chips) 
Seat 9: Trine2010 (4921 in chips) 
ramona691023: posts the ante 4
renanzin147: posts the ante 4
jcarlos.vale: posts the ante 4
chekmpcc: posts the ante 4
mariafirmina: posts the ante 4
Sobranie41: posts the ante 4
ddurikkt: posts the ante 4
Fischkop993: posts the ante 4
Trine2010: posts the ante 4
Sobranie41: posts small blind 15
ddurikkt: posts big blind 30
*** HOLE CARDS ***
Dealt to jcarlos.vale [5s Ks]
Fischkop993: raises 4950 to 4980 and is all-in
Trine2010: folds 
ramona691023: folds 
renanzin147: folds 
jcarlos.vale: folds 
chekmpcc: folds 
mariafirmina: folds 
Sobranie41: folds 
ddurikkt: folds 
Uncalled bet (4950) returned to Fischkop993
Fischkop993 collected 111 from pot
Fischkop993: doesn't show handDTO
*** SUMMARY ***
Total pot 111 | Rake 0 
Seat 1: ramona691023 folded before Flop (didn't bet)
Seat 2: renanzin147 folded before Flop (didn't bet)
Seat 3: jcarlos.vale folded before Flop (didn't bet)
Seat 4: chekmpcc folded before Flop (didn't bet)
Seat 5: mariafirmina (button) folded before Flop (didn't bet)
Seat 6: Sobranie41 (small blind) folded before Flop
Seat 7: ddurikkt (big blind) folded before Flop
Seat 8: Fischkop993 collected (111)
Seat 9: Trine2010 folded before Flop (didn't bet)



PokerStars Hand #222144510486: Tournament #3086083919, $0.49+$0.06 USD Hold'em No Limit - Level I (15/30) - 2021/01/02 21:07:01 EET [2021/01/02 14:07:01 ET]
Table '3086083919 46' 9-max Seat #6 is the button
Seat 1: ramona691023 (4050 in chips) 
Seat 2: renanzin147 (4965 in chips) 
Seat 3: jcarlos.vale (4920 in chips) 
Seat 4: chekmpcc (3449 in chips) 
Seat 5: mariafirmina (4935 in chips) 
Seat 6: Sobranie41 (4943 in chips) 
Seat 7: ddurikkt (7173 in chips) 
Seat 8: Fischkop993 (5061 in chips) 
Seat 9: Trine2010 (4917 in chips) 
ramona691023: posts the ante 4
renanzin147: posts the ante 4
jcarlos.vale: posts the ante 4
chekmpcc: posts the ante 4
mariafirmina: posts the ante 4
Sobranie41: posts the ante 4
ddurikkt: posts the ante 4
Fischkop993: posts the ante 4
Trine2010: posts the ante 4
ddurikkt: posts small blind 15
Fischkop993: posts big blind 30
*** HOLE CARDS ***
Dealt to jcarlos.vale [9h 2d]
Trine2010: calls 30
ramona691023: calls 30
renanzin147: folds 
jcarlos.vale: folds 
chekmpcc: raises 120 to 150
mariafirmina: folds 
Sobranie41: calls 150
ddurikkt: folds 
Fischkop993: calls 120
Trine2010: calls 120
ramona691023: calls 120
*** FLOP *** [5c 7s 2h]
Fischkop993: checks 
Trine2010: checks 
ramona691023: checks 
chekmpcc: bets 430
Sobranie41: calls 430
Fischkop993: calls 430
Trine2010: folds 
ramona691023: calls 430
*** TURN *** [5c 7s 2h] [5h]
Fischkop993: checks 
ramona691023: checks 
chekmpcc: checks 
Sobranie41: checks 
*** RIVER *** [5c 7s 2h 5h] [4h]
Fischkop993: bets 4477 and is all-in
ramona691023: folds 
chekmpcc: folds 
Sobranie41: folds 
Uncalled bet (4477) returned to Fischkop993
Fischkop993 collected 2521 from pot
Fischkop993: doesn't show handDTO
*** SUMMARY ***
Total pot 2521 | Rake 0 
Board [5c 7s 2h 5h 4h]
Seat 1: ramona691023 folded on the River
Seat 2: renanzin147 folded before Flop (didn't bet)
Seat 3: jcarlos.vale folded before Flop (didn't bet)
Seat 4: chekmpcc folded on the River
Seat 5: mariafirmina folded before Flop (didn't bet)
Seat 6: Sobranie41 (button) folded on the River
Seat 7: ddurikkt (small blind) folded before Flop
Seat 8: Fischkop993 (big blind) collected (2521)
Seat 9: Trine2010 folded on the Flop



PokerStars Hand #222144612038: Tournament #3086083919, $0.49+$0.06 USD Hold'em No Limit - Level I (15/30) - 2021/01/02 21:08:48 EET [2021/01/02 14:08:48 ET]
Table '3086083919 46' 9-max Seat #7 is the button
Seat 1: ramona691023 (3466 in chips) 
Seat 2: renanzin147 (4961 in chips) 
Seat 3: jcarlos.vale (4916 in chips) 
Seat 4: chekmpcc (2865 in chips) 
Seat 5: mariafirmina (4931 in chips) 
Seat 6: Sobranie41 (4359 in chips) 
Seat 7: ddurikkt (7154 in chips) 
Seat 8: Fischkop993 (6998 in chips) 
Seat 9: Trine2010 (4763 in chips) 
ramona691023: posts the ante 4
renanzin147: posts the ante 4
jcarlos.vale: posts the ante 4
chekmpcc: posts the ante 4
mariafirmina: posts the ante 4
Sobranie41: posts the ante 4
ddurikkt: posts the ante 4
Fischkop993: posts the ante 4
Trine2010: posts the ante 4
Fischkop993: posts small blind 15
Trine2010: posts big blind 30
*** HOLE CARDS ***
Dealt to jcarlos.vale [Ks 6s]
ramona691023: folds 
renanzin147: folds 
jcarlos.vale: folds 
chekmpcc: folds 
mariafirmina: folds 
Sobranie41: raises 4325 to 4355 and is all-in
ddurikkt: folds 
Fischkop993: folds 
Trine2010: folds 
Uncalled bet (4325) returned to Sobranie41
Sobranie41 collected 111 from pot
Sobranie41: doesn't show handDTO
*** SUMMARY ***
Total pot 111 | Rake 0 
Seat 1: ramona691023 folded before Flop (didn't bet)
Seat 2: renanzin147 folded before Flop (didn't bet)
Seat 3: jcarlos.vale folded before Flop (didn't bet)
Seat 4: chekmpcc folded before Flop (didn't bet)
Seat 5: mariafirmina folded before Flop (didn't bet)
Seat 6: Sobranie41 collected (111)
Seat 7: ddurikkt (button) folded before Flop (didn't bet)
Seat 8: Fischkop993 (small blind) folded before Flop
Seat 9: Trine2010 (big blind) folded before Flop



PokerStars Hand #222144643628: Tournament #3086083919, $0.49+$0.06 USD Hold'em No Limit - Level I (15/30) - 2021/01/02 21:09:21 EET [2021/01/02 14:09:21 ET]
Table '3086083919 46' 9-max Seat #8 is the button
Seat 1: ramona691023 (3462 in chips) 
Seat 2: renanzin147 (4957 in chips) 
Seat 3: jcarlos.vale (4912 in chips) 
Seat 4: chekmpcc (2861 in chips) 
Seat 5: mariafirmina (4927 in chips) 
Seat 6: Sobranie41 (4436 in chips) 
Seat 7: ddurikkt (7150 in chips) 
Seat 8: Fischkop993 (6979 in chips) 
Seat 9: Trine2010 (4729 in chips) 
ramona691023: posts the ante 4
renanzin147: posts the ante 4
jcarlos.vale: posts the ante 4
chekmpcc: posts the ante 4
mariafirmina: posts the ante 4
Sobranie41: posts the ante 4
ddurikkt: posts the ante 4
Fischkop993: posts the ante 4
Trine2010: posts the ante 4
Trine2010: posts small blind 15
ramona691023: posts big blind 30
*** HOLE CARDS ***
Dealt to jcarlos.vale [Jh 6s]
renanzin147: folds 
jcarlos.vale: folds 
chekmpcc: folds 
mariafirmina: folds 
Sobranie41: calls 30
ddurikkt: raises 33 to 63
Fischkop993: folds 
Trine2010: folds 
ramona691023: calls 33
Sobranie41: calls 33
*** FLOP *** [Tc 8s Kh]
ramona691023: checks 
Sobranie41: checks 
ddurikkt: bets 79
ramona691023: calls 79
Sobranie41: folds 
*** TURN *** [Tc 8s Kh] [7h]
ramona691023: checks 
ddurikkt: bets 306
ramona691023: raises 3010 to 3316 and is all-in
ddurikkt: calls 3010
*** RIVER *** [Tc 8s Kh 7h] [6c]
*** SHOW DOWN ***
ramona691023: shows [9c 6d] (a straight, Six to Ten)
ddurikkt: shows [Th Qh] (a pair of Tens)
ramona691023 collected 7030 from pot
*** SUMMARY ***
Total pot 7030 | Rake 0 
Board [Tc 8s Kh 7h 6c]
Seat 1: ramona691023 (big blind) showed [9c 6d] and won (7030) with a straight, Six to Ten
Seat 2: renanzin147 folded before Flop (didn't bet)
Seat 3: jcarlos.vale folded before Flop (didn't bet)
Seat 4: chekmpcc folded before Flop (didn't bet)
Seat 5: mariafirmina folded before Flop (didn't bet)
Seat 6: Sobranie41 folded on the Flop
Seat 7: ddurikkt showed [Th Qh] and lost with a pair of Tens
Seat 8: Fischkop993 (button) folded before Flop (didn't bet)
Seat 9: Trine2010 (small blind) folded before Flop



PokerStars Hand #222144731772: Tournament #3086083919, $0.49+$0.06 USD Hold'em No Limit - Level II (20/40) - 2021/01/02 21:10:49 EET [2021/01/02 14:10:49 ET]
Table '3086083919 46' 9-max Seat #9 is the button
Seat 1: ramona691023 (7030 in chips) 
Seat 2: renanzin147 (4953 in chips) 
Seat 3: jcarlos.vale (4908 in chips) 
Seat 4: chekmpcc (2857 in chips) 
Seat 5: mariafirmina (4923 in chips) 
Seat 6: Sobranie41 (4369 in chips) 
Seat 7: ddurikkt (3688 in chips) 
Seat 8: Fischkop993 (6975 in chips) 
Seat 9: Trine2010 (4710 in chips) 
ramona691023: posts the ante 5
renanzin147: posts the ante 5
jcarlos.vale: posts the ante 5
chekmpcc: posts the ante 5
mariafirmina: posts the ante 5
Sobranie41: posts the ante 5
ddurikkt: posts the ante 5
Fischkop993: posts the ante 5
Trine2010: posts the ante 5
ramona691023: posts small blind 20
renanzin147: posts big blind 40
*** HOLE CARDS ***
Dealt to jcarlos.vale [Kd 3s]
jcarlos.vale: folds 
chekmpcc: raises 80 to 120
mariafirmina: calls 120
Sobranie41: folds 
ddurikkt: raises 280 to 400
Fischkop993: folds 
Trine2010: folds 
ramona691023: folds 
renanzin147: folds 
chekmpcc: calls 280
mariafirmina: calls 280
*** FLOP *** [Tc Qs Ah]
chekmpcc: checks 
mariafirmina: checks 
ddurikkt: bets 431
chekmpcc: calls 431
mariafirmina: calls 431
*** TURN *** [Tc Qs Ah] [9s]
chekmpcc: checks 
mariafirmina: checks 
ddurikkt: bets 2000
chekmpcc: folds 
mariafirmina: folds 
Uncalled bet (2000) returned to ddurikkt
ddurikkt collected 2598 from pot
*** SUMMARY ***
Total pot 2598 | Rake 0 
Board [Tc Qs Ah 9s]
Seat 1: ramona691023 (small blind) folded before Flop
Seat 2: renanzin147 (big blind) folded before Flop
Seat 3: jcarlos.vale folded before Flop (didn't bet)
Seat 4: chekmpcc folded on the Turn
Seat 5: mariafirmina folded on the Turn
Seat 6: Sobranie41 folded before Flop (didn't bet)
Seat 7: ddurikkt collected (2598)
Seat 8: Fischkop993 folded before Flop (didn't bet)
Seat 9: Trine2010 (button) folded before Flop (didn't bet)



PokerStars Hand #222144840540: Tournament #3086083919, $0.49+$0.06 USD Hold'em No Limit - Level II (20/40) - 2021/01/02 21:12:43 EET [2021/01/02 14:12:43 ET]
Table '3086083919 46' 9-max Seat #1 is the button
Seat 1: ramona691023 (7005 in chips) 
Seat 2: renanzin147 (4908 in chips) 
Seat 3: jcarlos.vale (4903 in chips) 
Seat 4: chekmpcc (2021 in chips) 
Seat 5: mariafirmina (4087 in chips) 
Seat 6: Sobranie41 (4364 in chips) 
Seat 7: ddurikkt (5450 in chips) 
Seat 8: Fischkop993 (6970 in chips) 
Seat 9: Trine2010 (4705 in chips) 
ramona691023: posts the ante 5
renanzin147: posts the ante 5
jcarlos.vale: posts the ante 5
chekmpcc: posts the ante 5
mariafirmina: posts the ante 5
Sobranie41: posts the ante 5
ddurikkt: posts the ante 5
Fischkop993: posts the ante 5
Trine2010: posts the ante 5
renanzin147: posts small blind 20
jcarlos.vale: posts big blind 40
*** HOLE CARDS ***
Dealt to jcarlos.vale [9d 7d]
chekmpcc: raises 1976 to 2016 and is all-in
mariafirmina: folds 
Sobranie41: raises 2343 to 4359 and is all-in
ddurikkt: folds 
Fischkop993: folds 
Trine2010: folds 
ramona691023: folds 
renanzin147: folds 
jcarlos.vale: folds 
Uncalled bet (2343) returned to Sobranie41
*** FLOP *** [Jc Kh Kd]
*** TURN *** [Jc Kh Kd] [4h]
*** RIVER *** [Jc Kh Kd 4h] [2h]
*** SHOW DOWN ***
chekmpcc: shows [8s 8d] (two pair, Kings and Eights)
Sobranie41: shows [Ad 7c] (a pair of Kings)
chekmpcc collected 4137 from pot
*** SUMMARY ***
Total pot 4137 | Rake 0 
Board [Jc Kh Kd 4h 2h]
Seat 1: ramona691023 (button) folded before Flop (didn't bet)
Seat 2: renanzin147 (small blind) folded before Flop
Seat 3: jcarlos.vale (big blind) folded before Flop
Seat 4: chekmpcc showed [8s 8d] and won (4137) with two pair, Kings and Eights
Seat 5: mariafirmina folded before Flop (didn't bet)
Seat 6: Sobranie41 showed [Ad 7c] and lost with a pair of Kings
Seat 7: ddurikkt folded before Flop (didn't bet)
Seat 8: Fischkop993 folded before Flop (didn't bet)
Seat 9: Trine2010 folded before Flop (didn't bet)



PokerStars Hand #222144876640: Tournament #3086083919, $0.49+$0.06 USD Hold'em No Limit - Level II (20/40) - 2021/01/02 21:13:22 EET [2021/01/02 14:13:22 ET]
Table '3086083919 46' 9-max Seat #2 is the button
Seat 1: ramona691023 (7000 in chips) 
Seat 2: renanzin147 (4883 in chips) 
Seat 3: jcarlos.vale (4858 in chips) 
Seat 4: chekmpcc (4137 in chips) 
Seat 5: mariafirmina (4082 in chips) 
Seat 6: Sobranie41 (2343 in chips) 
Seat 7: ddurikkt (5445 in chips) 
Seat 8: Fischkop993 (6965 in chips) 
Seat 9: Trine2010 (4700 in chips) 
ramona691023: posts the ante 5
renanzin147: posts the ante 5
jcarlos.vale: posts the ante 5
chekmpcc: posts the ante 5
mariafirmina: posts the ante 5
Sobranie41: posts the ante 5
ddurikkt: posts the ante 5
Fischkop993: posts the ante 5
Trine2010: posts the ante 5
jcarlos.vale: posts small blind 20
chekmpcc: posts big blind 40
*** HOLE CARDS ***
Dealt to jcarlos.vale [Qh 3c]
mariafirmina: raises 40 to 80
Sobranie41: folds 
ddurikkt: raises 200 to 280
Fischkop993: folds 
Trine2010: calls 280
ramona691023: folds 
renanzin147: folds 
jcarlos.vale: folds 
chekmpcc: calls 240
mariafirmina: folds 
*** FLOP *** [3d 3s 6c]
chekmpcc: checks 
ddurikkt: checks 
Trine2010: checks 
*** TURN *** [3d 3s 6c] [Jc]
chekmpcc: checks 
ddurikkt: checks 
Trine2010: checks 
*** RIVER *** [3d 3s 6c Jc] [8d]
chekmpcc: checks 
ddurikkt: checks 
Trine2010: checks 
*** SHOW DOWN ***
chekmpcc: shows [9h Th] (a pair of Threes)
ddurikkt: shows [Ad Kd] (a pair of Threes - Ace kicker)
Trine2010: shows [Ac 8s] (two pair, Eights and Threes)
Trine2010 collected 985 from pot
*** SUMMARY ***
Total pot 985 | Rake 0 
Board [3d 3s 6c Jc 8d]
Seat 1: ramona691023 folded before Flop (didn't bet)
Seat 2: renanzin147 (button) folded before Flop (didn't bet)
Seat 3: jcarlos.vale (small blind) folded before Flop
Seat 4: chekmpcc (big blind) showed [9h Th] and lost with a pair of Threes
Seat 5: mariafirmina folded before Flop
Seat 6: Sobranie41 folded before Flop (didn't bet)
Seat 7: ddurikkt showed [Ad Kd] and lost with a pair of Threes
Seat 8: Fischkop993 folded before Flop (didn't bet)
Seat 9: Trine2010 showed [Ac 8s] and won (985) with two pair, Eights and Threes



PokerStars Hand #222144949966: Tournament #3086083919, $0.49+$0.06 USD Hold'em No Limit - Level II (20/40) - 2021/01/02 21:14:39 EET [2021/01/02 14:14:39 ET]
Table '3086083919 46' 9-max Seat #3 is the button
Seat 1: ramona691023 (6995 in chips) 
Seat 2: renanzin147 (4878 in chips) 
Seat 3: jcarlos.vale (4833 in chips) 
Seat 4: chekmpcc (3852 in chips) 
Seat 5: mariafirmina (3997 in chips) 
Seat 6: Sobranie41 (2338 in chips) 
Seat 7: ddurikkt (5160 in chips) 
Seat 8: Fischkop993 (6960 in chips) 
Seat 9: Trine2010 (5400 in chips) 
ramona691023: posts the ante 5
renanzin147: posts the ante 5
jcarlos.vale: posts the ante 5
chekmpcc: posts the ante 5
mariafirmina: posts the ante 5
Sobranie41: posts the ante 5
ddurikkt: posts the ante 5
Fischkop993: posts the ante 5
Trine2010: posts the ante 5
chekmpcc: posts small blind 20
mariafirmina: posts big blind 40
*** HOLE CARDS ***
Dealt to jcarlos.vale [5c Qh]
Sobranie41: raises 80 to 120
ddurikkt: folds 
Fischkop993: folds 
Trine2010: folds 
ramona691023: folds 
renanzin147: folds 
jcarlos.vale: folds 
chekmpcc: folds 
mariafirmina: folds 
Uncalled bet (80) returned to Sobranie41
Sobranie41 collected 145 from pot
Sobranie41: doesn't show handDTO
*** SUMMARY ***
Total pot 145 | Rake 0 
Seat 1: ramona691023 folded before Flop (didn't bet)
Seat 2: renanzin147 folded before Flop (didn't bet)
Seat 3: jcarlos.vale (button) folded before Flop (didn't bet)
Seat 4: chekmpcc (small blind) folded before Flop
Seat 5: mariafirmina (big blind) folded before Flop
Seat 6: Sobranie41 collected (145)
Seat 7: ddurikkt folded before Flop (didn't bet)
Seat 8: Fischkop993 folded before Flop (didn't bet)
Seat 9: Trine2010 folded before Flop (didn't bet)



PokerStars Hand #222144974965: Tournament #3086083919, $0.49+$0.06 USD Hold'em No Limit - Level II (20/40) - 2021/01/02 21:15:05 EET [2021/01/02 14:15:05 ET]
Table '3086083919 46' 9-max Seat #4 is the button
Seat 1: ramona691023 (6990 in chips) 
Seat 2: renanzin147 (4873 in chips) 
Seat 3: jcarlos.vale (4828 in chips) 
Seat 4: chekmpcc (3827 in chips) 
Seat 5: mariafirmina (3952 in chips) 
Seat 6: Sobranie41 (2438 in chips) 
Seat 7: ddurikkt (5155 in chips) 
Seat 8: Fischkop993 (6955 in chips) 
ramona691023: posts the ante 5
renanzin147: posts the ante 5
jcarlos.vale: posts the ante 5
chekmpcc: posts the ante 5
mariafirmina: posts the ante 5
Sobranie41: posts the ante 5
ddurikkt: posts the ante 5
Fischkop993: posts the ante 5
mariafirmina: posts small blind 20
Sobranie41: posts big blind 40
*** HOLE CARDS ***
Dealt to jcarlos.vale [9s Kh]
ddurikkt: folds 
Fischkop993: folds 
ramona691023: folds 
renanzin147: folds 
jcarlos.vale: folds 
chekmpcc: folds 
mariafirmina: folds 
Uncalled bet (20) returned to Sobranie41
Sobranie41 collected 80 from pot
Sobranie41: doesn't show handDTO
*** SUMMARY ***
Total pot 80 | Rake 0 
Seat 1: ramona691023 folded before Flop (didn't bet)
Seat 2: renanzin147 folded before Flop (didn't bet)
Seat 3: jcarlos.vale folded before Flop (didn't bet)
Seat 4: chekmpcc (button) folded before Flop (didn't bet)
Seat 5: mariafirmina (small blind) folded before Flop
Seat 6: Sobranie41 (big blind) collected (80)
Seat 7: ddurikkt folded before Flop (didn't bet)
Seat 8: Fischkop993 folded before Flop (didn't bet)



PokerStars Hand #222145001956: Tournament #3086083919, $0.49+$0.06 USD Hold'em No Limit - Level II (20/40) - 2021/01/02 21:15:33 EET [2021/01/02 14:15:33 ET]
Table '3086083919 46' 9-max Seat #5 is the button
Seat 1: ramona691023 (6985 in chips) 
Seat 2: renanzin147 (4868 in chips) 
Seat 3: jcarlos.vale (4823 in chips) 
Seat 4: chekmpcc (3822 in chips) 
Seat 5: mariafirmina (3927 in chips) 
Seat 6: Sobranie41 (2493 in chips) 
Seat 7: ddurikkt (5150 in chips) 
Seat 8: Fischkop993 (6950 in chips) 
Seat 9: JANAÍNA13 (5000 in chips) 
ramona691023: posts the ante 5
renanzin147: posts the ante 5
jcarlos.vale: posts the ante 5
chekmpcc: posts the ante 5
mariafirmina: posts the ante 5
Sobranie41: posts the ante 5
ddurikkt: posts the ante 5
Fischkop993: posts the ante 5
JANAÍNA13: posts the ante 5
Sobranie41: posts small blind 20
ddurikkt: posts big blind 40
*** HOLE CARDS ***
Dealt to jcarlos.vale [2h 5h]
Fischkop993: raises 40 to 80
JANAÍNA13: folds 
ramona691023: calls 80
renanzin147: folds 
jcarlos.vale: folds 
chekmpcc: raises 240 to 320
mariafirmina: folds 
Sobranie41: calls 300
ddurikkt: folds 
Fischkop993: calls 240
ramona691023: calls 240
*** FLOP *** [Th Qc 2d]
Sobranie41: checks 
Fischkop993: bets 6625 and is all-in
ramona691023: folds 
chekmpcc: calls 3497 and is all-in
Sobranie41: folds 
Uncalled bet (3128) returned to Fischkop993
*** TURN *** [Th Qc 2d] [4d]
*** RIVER *** [Th Qc 2d 4d] [3c]
*** SHOW DOWN ***
Fischkop993: shows [Td Ah] (a pair of Tens)
chekmpcc: shows [9c Qd] (a pair of Queens)
chekmpcc collected 8359 from pot
*** SUMMARY ***
Total pot 8359 | Rake 0 
Board [Th Qc 2d 4d 3c]
Seat 1: ramona691023 folded on the Flop
Seat 2: renanzin147 folded before Flop (didn't bet)
Seat 3: jcarlos.vale folded before Flop (didn't bet)
Seat 4: chekmpcc showed [9c Qd] and won (8359) with a pair of Queens
Seat 5: mariafirmina (button) folded before Flop (didn't bet)
Seat 6: Sobranie41 (small blind) folded on the Flop
Seat 7: ddurikkt (big blind) folded before Flop
Seat 8: Fischkop993 showed [Td Ah] and lost with a pair of Tens
Seat 9: JANAÍNA13 folded before Flop (didn't bet)



PokerStars Hand #222145107585: Tournament #3086083919, $0.49+$0.06 USD Hold'em No Limit - Level II (20/40) - 2021/01/02 21:17:25 EET [2021/01/02 14:17:25 ET]
Table '3086083919 46' 9-max Seat #6 is the button
Seat 1: ramona691023 (6660 in chips) 
Seat 2: renanzin147 (4863 in chips) 
Seat 3: jcarlos.vale (4818 in chips) 
Seat 4: chekmpcc (8359 in chips) 
Seat 5: mariafirmina (3922 in chips) 
Seat 6: Sobranie41 (2168 in chips) 
Seat 7: ddurikkt (5105 in chips) 
Seat 8: Fischkop993 (3128 in chips) 
Seat 9: JANAÍNA13 (4995 in chips) 
ramona691023: posts the ante 5
renanzin147: posts the ante 5
jcarlos.vale: posts the ante 5
chekmpcc: posts the ante 5
mariafirmina: posts the ante 5
Sobranie41: posts the ante 5
ddurikkt: posts the ante 5
Fischkop993: posts the ante 5
JANAÍNA13: posts the ante 5
ddurikkt: posts small blind 20
Fischkop993: posts big blind 40
*** HOLE CARDS ***
Dealt to jcarlos.vale [Jd 2d]
JANAÍNA13: folds 
ramona691023: folds 
renanzin147: folds 
jcarlos.vale: folds 
chekmpcc: folds 
mariafirmina: folds 
Sobranie41: folds 
ddurikkt: folds 
Uncalled bet (20) returned to Fischkop993
Fischkop993 collected 85 from pot
Fischkop993: doesn't show handDTO
*** SUMMARY ***
Total pot 85 | Rake 0 
Seat 1: ramona691023 folded before Flop (didn't bet)
Seat 2: renanzin147 folded before Flop (didn't bet)
Seat 3: jcarlos.vale folded before Flop (didn't bet)
Seat 4: chekmpcc folded before Flop (didn't bet)
Seat 5: mariafirmina folded before Flop (didn't bet)
Seat 6: Sobranie41 (button) folded before Flop (didn't bet)
Seat 7: ddurikkt (small blind) folded before Flop
Seat 8: Fischkop993 (big blind) collected (85)
Seat 9: JANAÍNA13 folded before Flop (didn't bet)



PokerStars Hand #222145127549: Tournament #3086083919, $0.49+$0.06 USD Hold'em No Limit - Level II (20/40) - 2021/01/02 21:17:46 EET [2021/01/02 14:17:46 ET]
Table '3086083919 46' 9-max Seat #7 is the button
Seat 1: ramona691023 (6655 in chips) 
Seat 2: renanzin147 (4858 in chips) 
Seat 3: jcarlos.vale (4813 in chips) 
Seat 4: chekmpcc (8354 in chips) 
Seat 5: mariafirmina (3917 in chips) 
Seat 6: Sobranie41 (2163 in chips) 
Seat 7: ddurikkt (5080 in chips) 
Seat 8: Fischkop993 (3188 in chips) 
Seat 9: JANAÍNA13 (4990 in chips) 
ramona691023: posts the ante 5
renanzin147: posts the ante 5
jcarlos.vale: posts the ante 5
chekmpcc: posts the ante 5
mariafirmina: posts the ante 5
Sobranie41: posts the ante 5
ddurikkt: posts the ante 5
Fischkop993: posts the ante 5
JANAÍNA13: posts the ante 5
Fischkop993: posts small blind 20
JANAÍNA13: posts big blind 40
*** HOLE CARDS ***
Dealt to jcarlos.vale [2d Kh]
ramona691023: folds 
renanzin147: folds 
jcarlos.vale: folds 
chekmpcc: folds 
mariafirmina: folds 
Sobranie41: calls 40
ddurikkt: folds 
Fischkop993: raises 3143 to 3183 and is all-in
JANAÍNA13: folds 
Sobranie41: folds 
Uncalled bet (3143) returned to Fischkop993
Fischkop993 collected 165 from pot
Fischkop993: doesn't show handDTO
*** SUMMARY ***
Total pot 165 | Rake 0 
Seat 1: ramona691023 folded before Flop (didn't bet)
Seat 2: renanzin147 folded before Flop (didn't bet)
Seat 3: jcarlos.vale folded before Flop (didn't bet)
Seat 4: chekmpcc folded before Flop (didn't bet)
Seat 5: mariafirmina folded before Flop (didn't bet)
Seat 6: Sobranie41 folded before Flop
Seat 7: ddurikkt (button) folded before Flop (didn't bet)
Seat 8: Fischkop993 (small blind) collected (165)
Seat 9: JANAÍNA13 (big blind) folded before Flop



PokerStars Hand #222145161110: Tournament #3086083919, $0.49+$0.06 USD Hold'em No Limit - Level II (20/40) - 2021/01/02 21:18:22 EET [2021/01/02 14:18:22 ET]
Table '3086083919 46' 9-max Seat #8 is the button
Seat 1: ramona691023 (6650 in chips) 
Seat 2: renanzin147 (4853 in chips) 
Seat 3: jcarlos.vale (4808 in chips) 
Seat 4: chekmpcc (8349 in chips) 
Seat 5: mariafirmina (3912 in chips) 
Seat 6: Sobranie41 (2118 in chips) 
Seat 7: ddurikkt (5075 in chips) 
Seat 8: Fischkop993 (3308 in chips) 
Seat 9: JANAÍNA13 (4945 in chips) 
ramona691023: posts the ante 5
renanzin147: posts the ante 5
jcarlos.vale: posts the ante 5
chekmpcc: posts the ante 5
mariafirmina: posts the ante 5
Sobranie41: posts the ante 5
ddurikkt: posts the ante 5
Fischkop993: posts the ante 5
JANAÍNA13: posts the ante 5
JANAÍNA13: posts small blind 20
ramona691023: posts big blind 40
*** HOLE CARDS ***
Dealt to jcarlos.vale [Ac 8c]
renanzin147: folds 
jcarlos.vale: raises 64 to 104
chekmpcc: folds 
mariafirmina: folds 
Sobranie41: folds 
ddurikkt: folds 
Fischkop993: folds 
JANAÍNA13: folds 
ramona691023: folds 
Uncalled bet (64) returned to jcarlos.vale
jcarlos.vale collected 145 from pot
jcarlos.vale: doesn't show handDTO
*** SUMMARY ***
Total pot 145 | Rake 0 
Seat 1: ramona691023 (big blind) folded before Flop
Seat 2: renanzin147 folded before Flop (didn't bet)
Seat 3: jcarlos.vale collected (145)
Seat 4: chekmpcc folded before Flop (didn't bet)
Seat 5: mariafirmina folded before Flop (didn't bet)
Seat 6: Sobranie41 folded before Flop (didn't bet)
Seat 7: ddurikkt folded before Flop (didn't bet)
Seat 8: Fischkop993 (button) folded before Flop (didn't bet)
Seat 9: JANAÍNA13 (small blind) folded before Flop



PokerStars Hand #222145187758: Tournament #3086083919, $0.49+$0.06 USD Hold'em No Limit - Level II (20/40) - 2021/01/02 21:18:50 EET [2021/01/02 14:18:50 ET]
Table '3086083919 46' 9-max Seat #9 is the button
Seat 1: ramona691023 (6605 in chips) 
Seat 2: renanzin147 (4848 in chips) 
Seat 3: jcarlos.vale (4908 in chips) 
Seat 4: chekmpcc (8344 in chips) 
Seat 5: mariafirmina (3907 in chips) 
Seat 6: Sobranie41 (2113 in chips) 
Seat 7: ddurikkt (5070 in chips) 
Seat 8: Fischkop993 (3303 in chips) 
Seat 9: JANAÍNA13 (4920 in chips) 
ramona691023: posts the ante 5
renanzin147: posts the ante 5
jcarlos.vale: posts the ante 5
chekmpcc: posts the ante 5
mariafirmina: posts the ante 5
Sobranie41: posts the ante 5
ddurikkt: posts the ante 5
Fischkop993: posts the ante 5
JANAÍNA13: posts the ante 5
ramona691023: posts small blind 20
renanzin147: posts big blind 40
*** HOLE CARDS ***
Dealt to jcarlos.vale [9d Ac]
jcarlos.vale: folds 
chekmpcc: folds 
mariafirmina: folds 
Sobranie41: folds 
ddurikkt: folds 
Fischkop993: folds 
JANAÍNA13: folds 
ramona691023: calls 20
renanzin147: raises 100 to 140
ramona691023: folds 
Uncalled bet (100) returned to renanzin147
renanzin147 collected 125 from pot
*** SUMMARY ***
Total pot 125 | Rake 0 
Seat 1: ramona691023 (small blind) folded before Flop
Seat 2: renanzin147 (big blind) collected (125)
Seat 3: jcarlos.vale folded before Flop (didn't bet)
Seat 4: chekmpcc folded before Flop (didn't bet)
Seat 5: mariafirmina folded before Flop (didn't bet)
Seat 6: Sobranie41 folded before Flop (didn't bet)
Seat 7: ddurikkt folded before Flop (didn't bet)
Seat 8: Fischkop993 folded before Flop (didn't bet)
Seat 9: JANAÍNA13 (button) folded before Flop (didn't bet)



PokerStars Hand #222145231791: Tournament #3086083919, $0.49+$0.06 USD Hold'em No Limit - Level II (20/40) - 2021/01/02 21:19:37 EET [2021/01/02 14:19:37 ET]
Table '3086083919 46' 9-max Seat #1 is the button
Seat 1: ramona691023 (6560 in chips) 
Seat 2: renanzin147 (4928 in chips) 
Seat 3: jcarlos.vale (4903 in chips) 
Seat 4: chekmpcc (8339 in chips) 
Seat 5: mariafirmina (3902 in chips) 
Seat 6: Sobranie41 (2108 in chips) 
Seat 7: ddurikkt (5065 in chips) 
Seat 8: Fischkop993 (3298 in chips) 
Seat 9: JANAÍNA13 (4915 in chips) 
ramona691023: posts the ante 5
renanzin147: posts the ante 5
jcarlos.vale: posts the ante 5
chekmpcc: posts the ante 5
mariafirmina: posts the ante 5
Sobranie41: posts the ante 5
ddurikkt: posts the ante 5
Fischkop993: posts the ante 5
JANAÍNA13: posts the ante 5
renanzin147: posts small blind 20
jcarlos.vale: posts big blind 40
*** HOLE CARDS ***
Dealt to jcarlos.vale [Ad 9h]
chekmpcc: folds 
mariafirmina: folds 
Sobranie41: folds 
ddurikkt: folds 
Fischkop993: folds 
JANAÍNA13: calls 40
ramona691023: folds 
renanzin147: raises 120 to 160
jcarlos.vale: folds 
JANAÍNA13: calls 120
*** FLOP *** [Th Kd 8s]
renanzin147: bets 134
JANAÍNA13: calls 134
*** TURN *** [Th Kd 8s] [5h]
renanzin147: checks 
JANAÍNA13: checks 
*** RIVER *** [Th Kd 8s 5h] [8d]
renanzin147: checks 
JANAÍNA13: checks 
*** SHOW DOWN ***
renanzin147: shows [3s As] (a pair of Eights)
JANAÍNA13: shows [Jh Kh] (two pair, Kings and Eights)
JANAÍNA13 collected 673 from pot
*** SUMMARY ***
Total pot 673 | Rake 0 
Board [Th Kd 8s 5h 8d]
Seat 1: ramona691023 (button) folded before Flop (didn't bet)
Seat 2: renanzin147 (small blind) showed [3s As] and lost with a pair of Eights
Seat 3: jcarlos.vale (big blind) folded before Flop
Seat 4: chekmpcc folded before Flop (didn't bet)
Seat 5: mariafirmina folded before Flop (didn't bet)
Seat 6: Sobranie41 folded before Flop (didn't bet)
Seat 7: ddurikkt folded before Flop (didn't bet)
Seat 8: Fischkop993 folded before Flop (didn't bet)
Seat 9: JANAÍNA13 showed [Jh Kh] and won (673) with two pair, Kings and Eights



PokerStars Hand #222145286748: Tournament #3086083919, $0.49+$0.06 USD Hold'em No Limit - Level III (25/50) - 2021/01/02 21:20:36 EET [2021/01/02 14:20:36 ET]
Table '3086083919 46' 9-max Seat #2 is the button
Seat 1: ramona691023 (6555 in chips) 
Seat 2: renanzin147 (4629 in chips) 
Seat 3: jcarlos.vale (4858 in chips) 
Seat 4: chekmpcc (8334 in chips) 
Seat 5: mariafirmina (3897 in chips) 
Seat 6: Sobranie41 (2103 in chips) 
Seat 7: ddurikkt (5060 in chips) 
Seat 8: Fischkop993 (3293 in chips) 
Seat 9: JANAÍNA13 (5289 in chips) 
ramona691023: posts the ante 6
renanzin147: posts the ante 6
jcarlos.vale: posts the ante 6
chekmpcc: posts the ante 6
mariafirmina: posts the ante 6
Sobranie41: posts the ante 6
ddurikkt: posts the ante 6
Fischkop993: posts the ante 6
JANAÍNA13: posts the ante 6
jcarlos.vale: posts small blind 25
chekmpcc: posts big blind 50
*** HOLE CARDS ***
Dealt to jcarlos.vale [4d 5s]
mariafirmina: folds 
Sobranie41: folds 
ddurikkt: raises 55 to 105
Fischkop993: folds 
JANAÍNA13: folds 
ramona691023: calls 105
renanzin147: folds 
jcarlos.vale: folds 
chekmpcc: folds 
*** FLOP *** [Qs 6c Kh]
ddurikkt: bets 112
ramona691023: calls 112
*** TURN *** [Qs 6c Kh] [Qd]
ddurikkt: bets 350
ramona691023: calls 350
*** RIVER *** [Qs 6c Kh Qd] [3d]
ddurikkt: checks 
ramona691023: checks 
*** SHOW DOWN ***
ddurikkt: shows [Jd Ad] (a pair of Queens)
ramona691023: shows [Kc 9c] (two pair, Kings and Queens)
ramona691023 collected 1263 from pot
*** SUMMARY ***
Total pot 1263 | Rake 0 
Board [Qs 6c Kh Qd 3d]
Seat 1: ramona691023 showed [Kc 9c] and won (1263) with two pair, Kings and Queens
Seat 2: renanzin147 (button) folded before Flop (didn't bet)
Seat 3: jcarlos.vale (small blind) folded before Flop
Seat 4: chekmpcc (big blind) folded before Flop
Seat 5: mariafirmina folded before Flop (didn't bet)
Seat 6: Sobranie41 folded before Flop (didn't bet)
Seat 7: ddurikkt showed [Jd Ad] and lost with a pair of Queens
Seat 8: Fischkop993 folded before Flop (didn't bet)
Seat 9: JANAÍNA13 folded before Flop (didn't bet)



PokerStars Hand #222145366477: Tournament #3086083919, $0.49+$0.06 USD Hold'em No Limit - Level III (25/50) - 2021/01/02 21:22:02 EET [2021/01/02 14:22:02 ET]
Table '3086083919 46' 9-max Seat #3 is the button
Seat 1: ramona691023 (7245 in chips) 
Seat 2: renanzin147 (4623 in chips) 
Seat 3: jcarlos.vale (4827 in chips) 
Seat 4: chekmpcc (8278 in chips) 
Seat 5: mariafirmina (3891 in chips) 
Seat 6: Sobranie41 (2097 in chips) 
Seat 7: ddurikkt (4487 in chips) 
Seat 8: Fischkop993 (3287 in chips) 
Seat 9: JANAÍNA13 (5283 in chips) 
ramona691023: posts the ante 6
renanzin147: posts the ante 6
jcarlos.vale: posts the ante 6
chekmpcc: posts the ante 6
mariafirmina: posts the ante 6
Sobranie41: posts the ante 6
ddurikkt: posts the ante 6
Fischkop993: posts the ante 6
JANAÍNA13: posts the ante 6
chekmpcc: posts small blind 25
mariafirmina: posts big blind 50
*** HOLE CARDS ***
Dealt to jcarlos.vale [As 4h]
Sobranie41: calls 50
ddurikkt: raises 55 to 105
Fischkop993: folds 
JANAÍNA13: folds 
ramona691023: folds 
renanzin147: folds 
jcarlos.vale: folds 
chekmpcc: folds 
mariafirmina: calls 55
Sobranie41: calls 55
*** FLOP *** [Qd 8d 8c]
mariafirmina: checks 
Sobranie41: checks 
ddurikkt: bets 130
mariafirmina: folds 
Sobranie41: folds 
Uncalled bet (130) returned to ddurikkt
ddurikkt collected 394 from pot
*** SUMMARY ***
Total pot 394 | Rake 0 
Board [Qd 8d 8c]
Seat 1: ramona691023 folded before Flop (didn't bet)
Seat 2: renanzin147 folded before Flop (didn't bet)
Seat 3: jcarlos.vale (button) folded before Flop (didn't bet)
Seat 4: chekmpcc (small blind) folded before Flop
Seat 5: mariafirmina (big blind) folded on the Flop
Seat 6: Sobranie41 folded on the Flop
Seat 7: ddurikkt collected (394)
Seat 8: Fischkop993 folded before Flop (didn't bet)
Seat 9: JANAÍNA13 folded before Flop (didn't bet)



PokerStars Hand #222145424360: Tournament #3086083919, $0.49+$0.06 USD Hold'em No Limit - Level III (25/50) - 2021/01/02 21:23:03 EET [2021/01/02 14:23:03 ET]
Table '3086083919 46' 9-max Seat #4 is the button
Seat 1: ramona691023 (7239 in chips) 
Seat 2: renanzin147 (4617 in chips) 
Seat 3: jcarlos.vale (4821 in chips) 
Seat 4: chekmpcc (8247 in chips) 
Seat 5: mariafirmina (3780 in chips) 
Seat 6: Sobranie41 (1986 in chips) 
Seat 7: ddurikkt (4770 in chips) 
Seat 8: Fischkop993 (3281 in chips) 
Seat 9: JANAÍNA13 (5277 in chips) 
ramona691023: posts the ante 6
renanzin147: posts the ante 6
jcarlos.vale: posts the ante 6
chekmpcc: posts the ante 6
mariafirmina: posts the ante 6
Sobranie41: posts the ante 6
ddurikkt: posts the ante 6
Fischkop993: posts the ante 6
JANAÍNA13: posts the ante 6
mariafirmina: posts small blind 25
Sobranie41: posts big blind 50
*** HOLE CARDS ***
Dealt to jcarlos.vale [2c Td]
ddurikkt: folds 
Fischkop993: raises 50 to 100
JANAÍNA13: folds 
ramona691023: folds 
renanzin147: calls 100
jcarlos.vale: folds 
chekmpcc: folds 
mariafirmina: folds 
Sobranie41: raises 1880 to 1980 and is all-in
Fischkop993: calls 1880
renanzin147: folds 
*** FLOP *** [2h 6c 4c]
*** TURN *** [2h 6c 4c] [As]
*** RIVER *** [2h 6c 4c As] [2d]
*** SHOW DOWN ***
Sobranie41: shows [Ad Kc] (two pair, Aces and Deuces)
Fischkop993: shows [Qd Ks] (a pair of Deuces)
Sobranie41 collected 4139 from pot
*** SUMMARY ***
Total pot 4139 | Rake 0 
Board [2h 6c 4c As 2d]
Seat 1: ramona691023 folded before Flop (didn't bet)
Seat 2: renanzin147 folded before Flop
Seat 3: jcarlos.vale folded before Flop (didn't bet)
Seat 4: chekmpcc (button) folded before Flop (didn't bet)
Seat 5: mariafirmina (small blind) folded before Flop
Seat 6: Sobranie41 (big blind) showed [Ad Kc] and won (4139) with two pair, Aces and Deuces
Seat 7: ddurikkt folded before Flop (didn't bet)
Seat 8: Fischkop993 showed [Qd Ks] and lost with a pair of Deuces
Seat 9: JANAÍNA13 folded before Flop (didn't bet)



PokerStars Hand #222145480433: Tournament #3086083919, $0.49+$0.06 USD Hold'em No Limit - Level III (25/50) - 2021/01/02 21:24:03 EET [2021/01/02 14:24:03 ET]
Table '3086083919 46' 9-max Seat #5 is the button
Seat 1: ramona691023 (7233 in chips) 
Seat 2: renanzin147 (4511 in chips) 
Seat 3: jcarlos.vale (4815 in chips) 
Seat 4: chekmpcc (8241 in chips) 
Seat 5: mariafirmina (3749 in chips) 
Seat 6: Sobranie41 (4139 in chips) 
Seat 7: ddurikkt (4764 in chips) 
Seat 8: Fischkop993 (1295 in chips) 
Seat 9: JANAÍNA13 (5271 in chips) 
ramona691023: posts the ante 6
renanzin147: posts the ante 6
jcarlos.vale: posts the ante 6
chekmpcc: posts the ante 6
mariafirmina: posts the ante 6
Sobranie41: posts the ante 6
ddurikkt: posts the ante 6
Fischkop993: posts the ante 6
JANAÍNA13: posts the ante 6
Sobranie41: posts small blind 25
ddurikkt: posts big blind 50
*** HOLE CARDS ***
Dealt to jcarlos.vale [Qs 2s]
Fischkop993: folds 
JANAÍNA13: calls 50
ramona691023: folds 
renanzin147: calls 50
jcarlos.vale: folds 
chekmpcc: raises 100 to 150
mariafirmina: folds 
Sobranie41: folds 
ddurikkt: folds 
JANAÍNA13: calls 100
renanzin147: calls 100
*** FLOP *** [7h Qd Jd]
JANAÍNA13: checks 
renanzin147: checks 
chekmpcc: bets 289
JANAÍNA13: folds 
renanzin147: folds 
Uncalled bet (289) returned to chekmpcc
chekmpcc collected 579 from pot
chekmpcc: doesn't show handDTO
*** SUMMARY ***
Total pot 579 | Rake 0 
Board [7h Qd Jd]
Seat 1: ramona691023 folded before Flop (didn't bet)
Seat 2: renanzin147 folded on the Flop
Seat 3: jcarlos.vale folded before Flop (didn't bet)
Seat 4: chekmpcc collected (579)
Seat 5: mariafirmina (button) folded before Flop (didn't bet)
Seat 6: Sobranie41 (small blind) folded before Flop
Seat 7: ddurikkt (big blind) folded before Flop
Seat 8: Fischkop993 folded before Flop (didn't bet)
Seat 9: JANAÍNA13 folded on the Flop



PokerStars Hand #222145547171: Tournament #3086083919, $0.49+$0.06 USD Hold'em No Limit - Level III (25/50) - 2021/01/02 21:25:15 EET [2021/01/02 14:25:15 ET]
Table '3086083919 46' 9-max Seat #6 is the button
Seat 1: ramona691023 (7227 in chips) 
Seat 2: renanzin147 (4355 in chips) 
Seat 3: jcarlos.vale (4809 in chips) 
Seat 4: chekmpcc (8664 in chips) 
Seat 5: mariafirmina (3743 in chips) 
Seat 6: Sobranie41 (4108 in chips) 
Seat 7: ddurikkt (4708 in chips) 
Seat 8: Fischkop993 (1289 in chips) 
Seat 9: JANAÍNA13 (5115 in chips) 
ramona691023: posts the ante 6
renanzin147: posts the ante 6
jcarlos.vale: posts the ante 6
chekmpcc: posts the ante 6
mariafirmina: posts the ante 6
Sobranie41: posts the ante 6
ddurikkt: posts the ante 6
Fischkop993: posts the ante 6
JANAÍNA13: posts the ante 6
ddurikkt: posts small blind 25
Fischkop993: posts big blind 50
*** HOLE CARDS ***
Dealt to jcarlos.vale [5c Tc]
JANAÍNA13: calls 50
ramona691023: folds 
renanzin147: folds 
jcarlos.vale: folds 
chekmpcc: folds 
mariafirmina: folds 
Sobranie41: folds 
ddurikkt: raises 85 to 135
Fischkop993: raises 1148 to 1283 and is all-in
JANAÍNA13: folds 
ddurikkt: folds 
Uncalled bet (1148) returned to Fischkop993
Fischkop993 collected 374 from pot
Fischkop993: doesn't show handDTO
*** SUMMARY ***
Total pot 374 | Rake 0 
Seat 1: ramona691023 folded before Flop (didn't bet)
Seat 2: renanzin147 folded before Flop (didn't bet)
Seat 3: jcarlos.vale folded before Flop (didn't bet)
Seat 4: chekmpcc folded before Flop (didn't bet)
Seat 5: mariafirmina folded before Flop (didn't bet)
Seat 6: Sobranie41 (button) folded before Flop (didn't bet)
Seat 7: ddurikkt (small blind) folded before Flop
Seat 8: Fischkop993 (big blind) collected (374)
Seat 9: JANAÍNA13 folded before Flop



PokerStars Hand #222145625478: Tournament #3086083919, $0.49+$0.06 USD Hold'em No Limit - Level III (25/50) - 2021/01/02 21:26:39 EET [2021/01/02 14:26:39 ET]
Table '3086083919 46' 9-max Seat #7 is the button
Seat 1: ramona691023 (7221 in chips) 
Seat 2: renanzin147 (4349 in chips) 
Seat 3: jcarlos.vale (4803 in chips) 
Seat 4: chekmpcc (8658 in chips) 
Seat 5: mariafirmina (3737 in chips) 
Seat 6: Sobranie41 (4102 in chips) 
Seat 7: ddurikkt (4567 in chips) 
Seat 8: Fischkop993 (1522 in chips) 
Seat 9: JANAÍNA13 (5059 in chips) 
ramona691023: posts the ante 6
renanzin147: posts the ante 6
jcarlos.vale: posts the ante 6
chekmpcc: posts the ante 6
mariafirmina: posts the ante 6
Sobranie41: posts the ante 6
ddurikkt: posts the ante 6
Fischkop993: posts the ante 6
JANAÍNA13: posts the ante 6
Fischkop993: posts small blind 25
JANAÍNA13: posts big blind 50
*** HOLE CARDS ***
Dealt to jcarlos.vale [Ts 6d]
ramona691023: calls 50
renanzin147: folds 
jcarlos.vale: folds 
chekmpcc: raises 100 to 150
mariafirmina: folds 
Sobranie41: raises 3946 to 4096 and is all-in
ddurikkt: folds 
Fischkop993: folds 
JANAÍNA13: folds 
ramona691023: folds 
chekmpcc: folds 
Uncalled bet (3946) returned to Sobranie41
Sobranie41 collected 479 from pot
Sobranie41: doesn't show handDTO
*** SUMMARY ***
Total pot 479 | Rake 0 
Seat 1: ramona691023 folded before Flop
Seat 2: renanzin147 folded before Flop (didn't bet)
Seat 3: jcarlos.vale folded before Flop (didn't bet)
Seat 4: chekmpcc folded before Flop
Seat 5: mariafirmina folded before Flop (didn't bet)
Seat 6: Sobranie41 collected (479)
Seat 7: ddurikkt (button) folded before Flop (didn't bet)
Seat 8: Fischkop993 (small blind) folded before Flop
Seat 9: JANAÍNA13 (big blind) folded before Flop



PokerStars Hand #222145667880: Tournament #3086083919, $0.49+$0.06 USD Hold'em No Limit - Level III (25/50) - 2021/01/02 21:27:24 EET [2021/01/02 14:27:24 ET]
Table '3086083919 46' 9-max Seat #8 is the button
Seat 1: ramona691023 (7165 in chips) 
Seat 2: renanzin147 (4343 in chips) 
Seat 3: jcarlos.vale (4797 in chips) 
Seat 4: chekmpcc (8502 in chips) 
Seat 5: mariafirmina (3731 in chips) 
Seat 6: Sobranie41 (4425 in chips) 
Seat 7: ddurikkt (4561 in chips) 
Seat 8: Fischkop993 (1491 in chips) 
Seat 9: JANAÍNA13 (5003 in chips) 
ramona691023: posts the ante 6
renanzin147: posts the ante 6
jcarlos.vale: posts the ante 6
chekmpcc: posts the ante 6
mariafirmina: posts the ante 6
Sobranie41: posts the ante 6
ddurikkt: posts the ante 6
Fischkop993: posts the ante 6
JANAÍNA13: posts the ante 6
JANAÍNA13: posts small blind 25
ramona691023: posts big blind 50
*** HOLE CARDS ***
Dealt to jcarlos.vale [Th Ah]
renanzin147: folds 
jcarlos.vale: raises 80 to 130
chekmpcc has timed out
chekmpcc: folds 
chekmpcc is sitting out
chekmpcc has returned
mariafirmina: folds 
Sobranie41: calls 130
ddurikkt: raises 370 to 500
Fischkop993: folds 
JANAÍNA13: folds 
ramona691023: folds 
jcarlos.vale: folds 
Sobranie41: calls 370
*** FLOP *** [3d 4c 7d]
Sobranie41: checks 
ddurikkt: checks 
*** TURN *** [3d 4c 7d] [Kh]
Sobranie41: checks 
ddurikkt: checks 
*** RIVER *** [3d 4c 7d Kh] [8d]
Sobranie41: bets 630
ddurikkt: folds 
Uncalled bet (630) returned to Sobranie41
Sobranie41 collected 1259 from pot
Sobranie41: doesn't show handDTO
*** SUMMARY ***
Total pot 1259 | Rake 0 
Board [3d 4c 7d Kh 8d]
Seat 1: ramona691023 (big blind) folded before Flop
Seat 2: renanzin147 folded before Flop (didn't bet)
Seat 3: jcarlos.vale folded before Flop
Seat 4: chekmpcc folded before Flop (didn't bet)
Seat 5: mariafirmina folded before Flop (didn't bet)
Seat 6: Sobranie41 collected (1259)
Seat 7: ddurikkt folded on the River
Seat 8: Fischkop993 (button) folded before Flop (didn't bet)
Seat 9: JANAÍNA13 (small blind) folded before Flop



PokerStars Hand #222145767524: Tournament #3086083919, $0.49+$0.06 USD Hold'em No Limit - Level III (25/50) - 2021/01/02 21:29:06 EET [2021/01/02 14:29:06 ET]
Table '3086083919 46' 9-max Seat #9 is the button
Seat 1: ramona691023 (7109 in chips) 
Seat 2: renanzin147 (4337 in chips) 
Seat 3: jcarlos.vale (4661 in chips) 
Seat 4: chekmpcc (8496 in chips) 
Seat 5: mariafirmina (3725 in chips) 
Seat 6: Sobranie41 (5178 in chips) 
Seat 7: ddurikkt (4055 in chips) 
Seat 8: Fischkop993 (1485 in chips) 
Seat 9: JANAÍNA13 (4972 in chips) 
ramona691023: posts the ante 6
renanzin147: posts the ante 6
jcarlos.vale: posts the ante 6
chekmpcc: posts the ante 6
mariafirmina: posts the ante 6
Sobranie41: posts the ante 6
ddurikkt: posts the ante 6
Fischkop993: posts the ante 6
JANAÍNA13: posts the ante 6
ramona691023: posts small blind 25
renanzin147: posts big blind 50
*** HOLE CARDS ***
Dealt to jcarlos.vale [Jd Qd]
jcarlos.vale: raises 80 to 130
chekmpcc has timed out
chekmpcc: folds 
chekmpcc is sitting out
mariafirmina: folds 
Sobranie41: calls 130
chekmpcc has returned
ddurikkt: raises 370 to 500
Fischkop993: folds 
JANAÍNA13: folds 
ramona691023: folds 
renanzin147: folds 
jcarlos.vale: folds 
Sobranie41: raises 4672 to 5172 and is all-in
ddurikkt: calls 3549 and is all-in
Uncalled bet (1123) returned to Sobranie41
*** FLOP *** [Td 3s Ac]
*** TURN *** [Td 3s Ac] [6s]
*** RIVER *** [Td 3s Ac 6s] [7c]
*** SHOW DOWN ***
Sobranie41: shows [Kd Kc] (a pair of Kings)
ddurikkt: shows [Qh Ad] (a pair of Aces)
ddurikkt collected 8357 from pot
*** SUMMARY ***
Total pot 8357 | Rake 0 
Board [Td 3s Ac 6s 7c]
Seat 1: ramona691023 (small blind) folded before Flop
Seat 2: renanzin147 (big blind) folded before Flop
Seat 3: jcarlos.vale folded before Flop
Seat 4: chekmpcc folded before Flop (didn't bet)
Seat 5: mariafirmina folded before Flop (didn't bet)
Seat 6: Sobranie41 showed [Kd Kc] and lost with a pair of Kings
Seat 7: ddurikkt showed [Qh Ad] and won (8357) with a pair of Aces
Seat 8: Fischkop993 folded before Flop (didn't bet)
Seat 9: JANAÍNA13 (button) folded before Flop (didn't bet)



PokerStars Hand #222145835345: Tournament #3086083919, $0.49+$0.06 USD Hold'em No Limit - Level IV (30/60) - 2021/01/02 21:30:18 EET [2021/01/02 14:30:18 ET]
Table '3086083919 46' 9-max Seat #1 is the button
Seat 1: ramona691023 (7078 in chips) 
Seat 2: renanzin147 (4281 in chips) 
Seat 3: jcarlos.vale (4525 in chips) 
Seat 4: chekmpcc (8490 in chips) 
Seat 5: mariafirmina (3719 in chips) 
Seat 6: Sobranie41 (1123 in chips) 
Seat 7: ddurikkt (8357 in chips) 
Seat 8: Fischkop993 (1479 in chips) 
Seat 9: JANAÍNA13 (4966 in chips) 
ramona691023: posts the ante 8
renanzin147: posts the ante 8
jcarlos.vale: posts the ante 8
chekmpcc: posts the ante 8
mariafirmina: posts the ante 8
Sobranie41: posts the ante 8
ddurikkt: posts the ante 8
Fischkop993: posts the ante 8
JANAÍNA13: posts the ante 8
renanzin147: posts small blind 30
jcarlos.vale: posts big blind 60
*** HOLE CARDS ***
Dealt to jcarlos.vale [8h Td]
chekmpcc: folds 
mariafirmina: folds 
Sobranie41: folds 
ddurikkt: raises 66 to 126
Fischkop993: calls 126
JANAÍNA13: folds 
ramona691023: folds 
renanzin147: folds 
jcarlos.vale: folds 
*** FLOP *** [3d 2h 2s]
ddurikkt: checks 
Fischkop993: checks 
*** TURN *** [3d 2h 2s] [Qs]
ddurikkt: checks 
Fischkop993: checks 
*** RIVER *** [3d 2h 2s Qs] [2d]
ddurikkt: checks 
Fischkop993: checks 
*** SHOW DOWN ***
ddurikkt: shows [7c Ts] (three of a kind, Deuces)
Fischkop993: shows [7h Kc] (three of a kind, Deuces - King kicker)
Fischkop993 collected 414 from pot
*** SUMMARY ***
Total pot 414 | Rake 0 
Board [3d 2h 2s Qs 2d]
Seat 1: ramona691023 (button) folded before Flop (didn't bet)
Seat 2: renanzin147 (small blind) folded before Flop
Seat 3: jcarlos.vale (big blind) folded before Flop
Seat 4: chekmpcc folded before Flop (didn't bet)
Seat 5: mariafirmina folded before Flop (didn't bet)
Seat 6: Sobranie41 folded before Flop (didn't bet)
Seat 7: ddurikkt showed [7c Ts] and lost with three of a kind, Deuces
Seat 8: Fischkop993 showed [7h Kc] and won (414) with three of a kind, Deuces
Seat 9: JANAÍNA13 folded before Flop (didn't bet)



PokerStars Hand #222145906761: Tournament #3086083919, $0.49+$0.06 USD Hold'em No Limit - Level IV (30/60) - 2021/01/02 21:31:35 EET [2021/01/02 14:31:35 ET]
Table '3086083919 46' 9-max Seat #2 is the button
Seat 1: ramona691023 (7070 in chips) 
Seat 2: renanzin147 (4243 in chips) 
Seat 3: jcarlos.vale (4457 in chips) 
Seat 4: chekmpcc (8482 in chips) 
Seat 5: mariafirmina (3711 in chips) 
Seat 6: Sobranie41 (1115 in chips) 
Seat 7: ddurikkt (8223 in chips) 
Seat 8: Fischkop993 (1759 in chips) 
Seat 9: JANAÍNA13 (4958 in chips) 
ramona691023: posts the ante 8
renanzin147: posts the ante 8
jcarlos.vale: posts the ante 8
chekmpcc: posts the ante 8
mariafirmina: posts the ante 8
Sobranie41: posts the ante 8
ddurikkt: posts the ante 8
Fischkop993: posts the ante 8
JANAÍNA13: posts the ante 8
jcarlos.vale: posts small blind 30
chekmpcc: posts big blind 60
*** HOLE CARDS ***
Dealt to jcarlos.vale [Td 6s]
mariafirmina: raises 60 to 120
Sobranie41: raises 987 to 1107 and is all-in
ddurikkt: folds 
Fischkop993: folds 
JANAÍNA13: folds 
ramona691023: folds 
renanzin147: folds 
jcarlos.vale: folds 
chekmpcc: folds 
mariafirmina: folds 
Uncalled bet (987) returned to Sobranie41
Sobranie41 collected 402 from pot
Sobranie41: doesn't show handDTO
*** SUMMARY ***
Total pot 402 | Rake 0 
Seat 1: ramona691023 folded before Flop (didn't bet)
Seat 2: renanzin147 (button) folded before Flop (didn't bet)
Seat 3: jcarlos.vale (small blind) folded before Flop
Seat 4: chekmpcc (big blind) folded before Flop
Seat 5: mariafirmina folded before Flop
Seat 6: Sobranie41 collected (402)
Seat 7: ddurikkt folded before Flop (didn't bet)
Seat 8: Fischkop993 folded before Flop (didn't bet)
Seat 9: JANAÍNA13 folded before Flop (didn't bet)



PokerStars Hand #222145929849: Tournament #3086083919, $0.49+$0.06 USD Hold'em No Limit - Level IV (30/60) - 2021/01/02 21:31:59 EET [2021/01/02 14:31:59 ET]
Table '3086083919 46' 9-max Seat #3 is the button
Seat 1: ramona691023 (7062 in chips) 
Seat 2: renanzin147 (4235 in chips) 
Seat 3: jcarlos.vale (4419 in chips) 
Seat 4: chekmpcc (8414 in chips) 
Seat 5: mariafirmina (3583 in chips) 
Seat 6: Sobranie41 (1389 in chips) 
Seat 7: ddurikkt (8215 in chips) 
Seat 8: Fischkop993 (1751 in chips) 
Seat 9: JANAÍNA13 (4950 in chips) 
ramona691023: posts the ante 8
renanzin147: posts the ante 8
jcarlos.vale: posts the ante 8
chekmpcc: posts the ante 8
mariafirmina: posts the ante 8
Sobranie41: posts the ante 8
ddurikkt: posts the ante 8
Fischkop993: posts the ante 8
JANAÍNA13: posts the ante 8
chekmpcc: posts small blind 30
mariafirmina: posts big blind 60
*** HOLE CARDS ***
Dealt to jcarlos.vale [Ad 8s]
Sobranie41: folds 
ddurikkt: folds 
Fischkop993: folds 
JANAÍNA13: folds 
ramona691023: calls 60
renanzin147: folds 
jcarlos.vale: folds 
chekmpcc: calls 30
mariafirmina: checks 
*** FLOP *** [5d Ah 4d]
chekmpcc: checks 
mariafirmina: checks 
chekmpcc is disconnected 
ramona691023: checks 
*** TURN *** [5d Ah 4d] [4s]
chekmpcc is connected 
chekmpcc: bets 174
mariafirmina: calls 174
ramona691023: folds 
*** RIVER *** [5d Ah 4d 4s] [Kh]
chekmpcc: bets 222
mariafirmina: calls 222
*** SHOW DOWN ***
chekmpcc: shows [9h 8c] (a pair of Fours)
mariafirmina: shows [2s Ac] (two pair, Aces and Fours)
mariafirmina collected 1044 from pot
*** SUMMARY ***
Total pot 1044 | Rake 0 
Board [5d Ah 4d 4s Kh]
Seat 1: ramona691023 folded on the Turn
Seat 2: renanzin147 folded before Flop (didn't bet)
Seat 3: jcarlos.vale (button) folded before Flop (didn't bet)
Seat 4: chekmpcc (small blind) showed [9h 8c] and lost with a pair of Fours
Seat 5: mariafirmina (big blind) showed [2s Ac] and won (1044) with two pair, Aces and Fours
Seat 6: Sobranie41 folded before Flop (didn't bet)
Seat 7: ddurikkt folded before Flop (didn't bet)
Seat 8: Fischkop993 folded before Flop (didn't bet)
Seat 9: JANAÍNA13 folded before Flop (didn't bet)



PokerStars Hand #222146021334: Tournament #3086083919, $0.49+$0.06 USD Hold'em No Limit - Level IV (30/60) - 2021/01/02 21:33:37 EET [2021/01/02 14:33:37 ET]
Table '3086083919 46' 9-max Seat #4 is the button
Seat 1: ramona691023 (6994 in chips) 
Seat 2: renanzin147 (4227 in chips) 
Seat 3: jcarlos.vale (4411 in chips) 
Seat 4: chekmpcc (7950 in chips) 
Seat 5: mariafirmina (4163 in chips) 
Seat 6: Sobranie41 (1381 in chips) 
Seat 7: ddurikkt (8207 in chips) 
Seat 8: Fischkop993 (1743 in chips) 
Seat 9: JANAÍNA13 (4942 in chips) 
ramona691023: posts the ante 8
renanzin147: posts the ante 8
jcarlos.vale: posts the ante 8
chekmpcc: posts the ante 8
mariafirmina: posts the ante 8
Sobranie41: posts the ante 8
ddurikkt: posts the ante 8
Fischkop993: posts the ante 8
JANAÍNA13: posts the ante 8
mariafirmina: posts small blind 30
Sobranie41: posts big blind 60
*** HOLE CARDS ***
Dealt to jcarlos.vale [4s 5c]
ddurikkt: raises 66 to 126
Fischkop993: folds 
JANAÍNA13: folds 
ramona691023: folds 
renanzin147: folds 
jcarlos.vale: folds 
chekmpcc: raises 192 to 318
mariafirmina: folds 
Sobranie41: folds 
ddurikkt: calls 192
*** FLOP *** [2h 4c 6d]
ddurikkt: checks 
chekmpcc: bets 300
ddurikkt: folds 
Uncalled bet (300) returned to chekmpcc
chekmpcc collected 798 from pot
*** SUMMARY ***
Total pot 798 | Rake 0 
Board [2h 4c 6d]
Seat 1: ramona691023 folded before Flop (didn't bet)
Seat 2: renanzin147 folded before Flop (didn't bet)
Seat 3: jcarlos.vale folded before Flop (didn't bet)
Seat 4: chekmpcc (button) collected (798)
Seat 5: mariafirmina (small blind) folded before Flop
Seat 6: Sobranie41 (big blind) folded before Flop
Seat 7: ddurikkt folded on the Flop
Seat 8: Fischkop993 folded before Flop (didn't bet)
Seat 9: JANAÍNA13 folded before Flop (didn't bet)



PokerStars Hand #222146073621: Tournament #3086083919, $0.49+$0.06 USD Hold'em No Limit - Level IV (30/60) - 2021/01/02 21:34:34 EET [2021/01/02 14:34:34 ET]
Table '3086083919 46' 9-max Seat #5 is the button
Seat 1: ramona691023 (6986 in chips) 
Seat 2: renanzin147 (4219 in chips) 
Seat 3: jcarlos.vale (4403 in chips) 
Seat 4: chekmpcc (8422 in chips) 
Seat 5: mariafirmina (4125 in chips) 
Seat 6: Sobranie41 (1313 in chips) 
Seat 7: ddurikkt (7881 in chips) 
Seat 8: Fischkop993 (1735 in chips) 
Seat 9: JANAÍNA13 (4934 in chips) 
ramona691023: posts the ante 8
renanzin147: posts the ante 8
jcarlos.vale: posts the ante 8
chekmpcc: posts the ante 8
mariafirmina: posts the ante 8
Sobranie41: posts the ante 8
ddurikkt: posts the ante 8
Fischkop993: posts the ante 8
JANAÍNA13: posts the ante 8
Sobranie41: posts small blind 30
ddurikkt: posts big blind 60
*** HOLE CARDS ***
Dealt to jcarlos.vale [Ad 3h]
Fischkop993: folds 
JANAÍNA13: folds 
ramona691023: folds 
renanzin147: raises 60 to 120
jcarlos.vale: folds 
chekmpcc: raises 240 to 360
mariafirmina: folds 
Sobranie41: folds 
ddurikkt: folds 
renanzin147: folds 
Uncalled bet (240) returned to chekmpcc
chekmpcc collected 402 from pot
*** SUMMARY ***
Total pot 402 | Rake 0 
Seat 1: ramona691023 folded before Flop (didn't bet)
Seat 2: renanzin147 folded before Flop
Seat 3: jcarlos.vale folded before Flop (didn't bet)
Seat 4: chekmpcc collected (402)
Seat 5: mariafirmina (button) folded before Flop (didn't bet)
Seat 6: Sobranie41 (small blind) folded before Flop
Seat 7: ddurikkt (big blind) folded before Flop
Seat 8: Fischkop993 folded before Flop (didn't bet)
Seat 9: JANAÍNA13 folded before Flop (didn't bet)



PokerStars Hand #222146141728: Tournament #3086083919, $0.49+$0.06 USD Hold'em No Limit - Level IV (30/60) - 2021/01/02 21:35:46 EET [2021/01/02 14:35:46 ET]
Table '3086083919 46' 9-max Seat #6 is the button
Seat 1: ramona691023 (6978 in chips) 
Seat 2: renanzin147 (4091 in chips) 
Seat 3: jcarlos.vale (4395 in chips) 
Seat 4: chekmpcc (8696 in chips) 
Seat 5: mariafirmina (4117 in chips) 
Seat 6: Sobranie41 (1275 in chips) 
Seat 7: ddurikkt (7813 in chips) 
Seat 8: Fischkop993 (1727 in chips) 
Seat 9: JANAÍNA13 (4926 in chips) 
ramona691023: posts the ante 8
renanzin147: posts the ante 8
jcarlos.vale: posts the ante 8
chekmpcc: posts the ante 8
mariafirmina: posts the ante 8
Sobranie41: posts the ante 8
ddurikkt: posts the ante 8
Fischkop993: posts the ante 8
JANAÍNA13: posts the ante 8
ddurikkt: posts small blind 30
Fischkop993: posts big blind 60
*** HOLE CARDS ***
Dealt to jcarlos.vale [8s As]
JANAÍNA13: raises 60 to 120
ramona691023: folds 
renanzin147: calls 120
jcarlos.vale: folds 
chekmpcc: folds 
mariafirmina: folds 
Sobranie41: raises 1147 to 1267 and is all-in
ddurikkt: folds 
Fischkop993: folds 
JANAÍNA13: folds 
renanzin147: folds 
Uncalled bet (1147) returned to Sobranie41
Sobranie41 collected 522 from pot
Sobranie41: doesn't show handDTO
*** SUMMARY ***
Total pot 522 | Rake 0 
Seat 1: ramona691023 folded before Flop (didn't bet)
Seat 2: renanzin147 folded before Flop
Seat 3: jcarlos.vale folded before Flop (didn't bet)
Seat 4: chekmpcc folded before Flop (didn't bet)
Seat 5: mariafirmina folded before Flop (didn't bet)
Seat 6: Sobranie41 (button) collected (522)
Seat 7: ddurikkt (small blind) folded before Flop
Seat 8: Fischkop993 (big blind) folded before Flop
Seat 9: JANAÍNA13 folded before Flop



PokerStars Hand #222146182442: Tournament #3086083919, $0.49+$0.06 USD Hold'em No Limit - Level IV (30/60) - 2021/01/02 21:36:29 EET [2021/01/02 14:36:29 ET]
Table '3086083919 46' 9-max Seat #7 is the button
Seat 1: ramona691023 (6970 in chips) 
Seat 2: renanzin147 (3963 in chips) 
Seat 3: jcarlos.vale (4387 in chips) 
Seat 4: chekmpcc (8688 in chips) 
Seat 5: mariafirmina (4109 in chips) 
Seat 6: Sobranie41 (1669 in chips) 
Seat 7: ddurikkt (7775 in chips) 
Seat 8: Fischkop993 (1659 in chips) 
Seat 9: JANAÍNA13 (4798 in chips) 
ramona691023: posts the ante 8
renanzin147: posts the ante 8
jcarlos.vale: posts the ante 8
chekmpcc: posts the ante 8
mariafirmina: posts the ante 8
Sobranie41: posts the ante 8
ddurikkt: posts the ante 8
Fischkop993: posts the ante 8
JANAÍNA13: posts the ante 8
Fischkop993: posts small blind 30
JANAÍNA13: posts big blind 60
*** HOLE CARDS ***
Dealt to jcarlos.vale [Ac Ah]
ramona691023: folds 
renanzin147: raises 60 to 120
jcarlos.vale: raises 180 to 300
chekmpcc: folds 
mariafirmina: folds 
Sobranie41: folds 
ddurikkt: folds 
Fischkop993: folds 
JANAÍNA13: folds 
renanzin147: calls 180
*** FLOP *** [5s Tc 8c]
renanzin147: checks 
jcarlos.vale: bets 660
renanzin147: folds 
Uncalled bet (660) returned to jcarlos.vale
jcarlos.vale collected 762 from pot
jcarlos.vale: doesn't show handDTO
*** SUMMARY ***
Total pot 762 | Rake 0 
Board [5s Tc 8c]
Seat 1: ramona691023 folded before Flop (didn't bet)
Seat 2: renanzin147 folded on the Flop
Seat 3: jcarlos.vale collected (762)
Seat 4: chekmpcc folded before Flop (didn't bet)
Seat 5: mariafirmina folded before Flop (didn't bet)
Seat 6: Sobranie41 folded before Flop (didn't bet)
Seat 7: ddurikkt (button) folded before Flop (didn't bet)
Seat 8: Fischkop993 (small blind) folded before Flop
Seat 9: JANAÍNA13 (big blind) folded before Flop



PokerStars Hand #222146224947: Tournament #3086083919, $0.49+$0.06 USD Hold'em No Limit - Level IV (30/60) - 2021/01/02 21:37:15 EET [2021/01/02 14:37:15 ET]
Table '3086083919 46' 9-max Seat #8 is the button
Seat 1: ramona691023 (6962 in chips) 
Seat 2: renanzin147 (3655 in chips) 
Seat 3: jcarlos.vale (4841 in chips) 
Seat 4: chekmpcc (8680 in chips) 
Seat 5: mariafirmina (4101 in chips) 
Seat 6: Sobranie41 (1661 in chips) 
Seat 7: ddurikkt (7767 in chips) 
Seat 8: Fischkop993 (1621 in chips) 
Seat 9: JANAÍNA13 (4730 in chips) 
ramona691023: posts the ante 8
renanzin147: posts the ante 8
jcarlos.vale: posts the ante 8
chekmpcc: posts the ante 8
mariafirmina: posts the ante 8
Sobranie41: posts the ante 8
ddurikkt: posts the ante 8
Fischkop993: posts the ante 8
JANAÍNA13: posts the ante 8
JANAÍNA13: posts small blind 30
ramona691023: posts big blind 60
*** HOLE CARDS ***
Dealt to jcarlos.vale [9h Tc]
renanzin147: folds 
jcarlos.vale: folds 
chekmpcc: folds 
mariafirmina: folds 
Sobranie41: folds 
ddurikkt: folds 
Fischkop993: folds 
JANAÍNA13: folds 
Uncalled bet (30) returned to ramona691023
ramona691023 collected 132 from pot
ramona691023: doesn't show handDTO
*** SUMMARY ***
Total pot 132 | Rake 0 
Seat 1: ramona691023 (big blind) collected (132)
Seat 2: renanzin147 folded before Flop (didn't bet)
Seat 3: jcarlos.vale folded before Flop (didn't bet)
Seat 4: chekmpcc folded before Flop (didn't bet)
Seat 5: mariafirmina folded before Flop (didn't bet)
Seat 6: Sobranie41 folded before Flop (didn't bet)
Seat 7: ddurikkt folded before Flop (didn't bet)
Seat 8: Fischkop993 (button) folded before Flop (didn't bet)
Seat 9: JANAÍNA13 (small blind) folded before Flop



PokerStars Hand #222146244623: Tournament #3086083919, $0.49+$0.06 USD Hold'em No Limit - Level IV (30/60) - 2021/01/02 21:37:36 EET [2021/01/02 14:37:36 ET]
Table '3086083919 46' 9-max Seat #9 is the button
Seat 1: ramona691023 (7056 in chips) 
Seat 2: renanzin147 (3647 in chips) 
Seat 3: jcarlos.vale (4833 in chips) 
Seat 4: chekmpcc (8672 in chips) 
Seat 5: mariafirmina (4093 in chips) 
Seat 6: Sobranie41 (1653 in chips) 
Seat 7: ddurikkt (7759 in chips) 
Seat 8: Fischkop993 (1613 in chips) 
Seat 9: JANAÍNA13 (4692 in chips) 
ramona691023: posts the ante 8
renanzin147: posts the ante 8
jcarlos.vale: posts the ante 8
chekmpcc: posts the ante 8
mariafirmina: posts the ante 8
Sobranie41: posts the ante 8
ddurikkt: posts the ante 8
Fischkop993: posts the ante 8
JANAÍNA13: posts the ante 8
ramona691023: posts small blind 30
renanzin147: posts big blind 60
*** HOLE CARDS ***
Dealt to jcarlos.vale [Tc Kc]
jcarlos.vale: calls 60
chekmpcc: raises 180 to 240
mariafirmina: folds 
Sobranie41: folds 
ddurikkt: folds 
Fischkop993: folds 
JANAÍNA13: calls 240
ramona691023: folds 
renanzin147: folds 
jcarlos.vale: folds 
*** FLOP *** [Js 3h Qc]
chekmpcc: checks 
JANAÍNA13: checks 
*** TURN *** [Js 3h Qc] [6h]
chekmpcc: bets 420
JANAÍNA13: calls 420
*** RIVER *** [Js 3h Qc 6h] [3c]
chekmpcc: checks 
JANAÍNA13: checks 
*** SHOW DOWN ***
chekmpcc: shows [8s 8c] (two pair, Eights and Threes)
JANAÍNA13: shows [Jh Kd] (two pair, Jacks and Threes)
JANAÍNA13 collected 1542 from pot
*** SUMMARY ***
Total pot 1542 | Rake 0 
Board [Js 3h Qc 6h 3c]
Seat 1: ramona691023 (small blind) folded before Flop
Seat 2: renanzin147 (big blind) folded before Flop
Seat 3: jcarlos.vale folded before Flop
Seat 4: chekmpcc showed [8s 8c] and lost with two pair, Eights and Threes
Seat 5: mariafirmina folded before Flop (didn't bet)
Seat 6: Sobranie41 folded before Flop (didn't bet)
Seat 7: ddurikkt folded before Flop (didn't bet)
Seat 8: Fischkop993 folded before Flop (didn't bet)
Seat 9: JANAÍNA13 (button) showed [Jh Kd] and won (1542) with two pair, Jacks and Threes



PokerStars Hand #222146345024: Tournament #3086083919, $0.49+$0.06 USD Hold'em No Limit - Level IV (30/60) - 2021/01/02 21:39:22 EET [2021/01/02 14:39:22 ET]
Table '3086083919 46' 9-max Seat #1 is the button
Seat 1: ramona691023 (7018 in chips) 
Seat 2: renanzin147 (3579 in chips) 
Seat 3: jcarlos.vale (4765 in chips) 
Seat 4: chekmpcc (8004 in chips) 
Seat 5: mariafirmina (4085 in chips) 
Seat 6: Sobranie41 (1645 in chips) 
Seat 7: ddurikkt (7751 in chips) 
Seat 8: Fischkop993 (1605 in chips) 
Seat 9: JANAÍNA13 (5566 in chips) 
ramona691023: posts the ante 8
renanzin147: posts the ante 8
jcarlos.vale: posts the ante 8
chekmpcc: posts the ante 8
mariafirmina: posts the ante 8
Sobranie41: posts the ante 8
ddurikkt: posts the ante 8
Fischkop993: posts the ante 8
JANAÍNA13: posts the ante 8
renanzin147: posts small blind 30
jcarlos.vale: posts big blind 60
*** HOLE CARDS ***
Dealt to jcarlos.vale [Qh 7c]
chekmpcc: folds 
mariafirmina: folds 
Sobranie41: folds 
ddurikkt: folds 
Fischkop993: folds 
JANAÍNA13: calls 60
ramona691023: folds 
renanzin147: folds 
jcarlos.vale: checks 
*** FLOP *** [5s 5h 8h]
jcarlos.vale: checks 
JANAÍNA13: checks 
*** TURN *** [5s 5h 8h] [5c]
jcarlos.vale: checks 
JANAÍNA13: checks 
*** RIVER *** [5s 5h 8h 5c] [Jc]
jcarlos.vale: checks 
JANAÍNA13: checks 
*** SHOW DOWN ***
jcarlos.vale: shows [Qh 7c] (three of a kind, Fives)
JANAÍNA13: shows [Kh Qc] (three of a kind, Fives - King kicker)
JANAÍNA13 collected 222 from pot
*** SUMMARY ***
Total pot 222 | Rake 0 
Board [5s 5h 8h 5c Jc]
Seat 1: ramona691023 (button) folded before Flop (didn't bet)
Seat 2: renanzin147 (small blind) folded before Flop
Seat 3: jcarlos.vale (big blind) showed [Qh 7c] and lost with three of a kind, Fives
Seat 4: chekmpcc folded before Flop (didn't bet)
Seat 5: mariafirmina folded before Flop (didn't bet)
Seat 6: Sobranie41 folded before Flop (didn't bet)
Seat 7: ddurikkt folded before Flop (didn't bet)
Seat 8: Fischkop993 folded before Flop (didn't bet)
Seat 9: JANAÍNA13 showed [Kh Qc] and won (222) with three of a kind, Fives



PokerStars Hand #222146396070: Tournament #3086083919, $0.49+$0.06 USD Hold'em No Limit - Level V (40/80) - 2021/01/02 21:40:16 EET [2021/01/02 14:40:16 ET]
Table '3086083919 46' 9-max Seat #2 is the button
Seat 1: ramona691023 (7010 in chips) 
Seat 2: renanzin147 (3541 in chips) 
Seat 3: jcarlos.vale (4697 in chips) 
Seat 4: chekmpcc (7996 in chips) 
Seat 5: mariafirmina (4077 in chips) 
Seat 6: Sobranie41 (1637 in chips) 
Seat 7: ddurikkt (7743 in chips) 
Seat 8: Fischkop993 (1597 in chips) 
Seat 9: JANAÍNA13 (5720 in chips) 
ramona691023: posts the ante 9
renanzin147: posts the ante 9
jcarlos.vale: posts the ante 9
chekmpcc: posts the ante 9
mariafirmina: posts the ante 9
Sobranie41: posts the ante 9
ddurikkt: posts the ante 9
Fischkop993: posts the ante 9
JANAÍNA13: posts the ante 9
jcarlos.vale: posts small blind 40
chekmpcc: posts big blind 80
*** HOLE CARDS ***
Dealt to jcarlos.vale [7d 4h]
mariafirmina: folds 
Sobranie41: folds 
ddurikkt: folds 
Fischkop993: calls 80
JANAÍNA13: folds 
ramona691023: raises 400 to 480
renanzin147: folds 
jcarlos.vale: folds 
chekmpcc: folds 
Fischkop993: calls 400
*** FLOP *** [6c Jc 9s]
Fischkop993: bets 1108 and is all-in
ramona691023: calls 1108
*** TURN *** [6c Jc 9s] [3c]
*** RIVER *** [6c Jc 9s 3c] [2d]
*** SHOW DOWN ***
Fischkop993: shows [9d 8d] (a pair of Nines)
ramona691023: shows [Qc Qd] (a pair of Queens)
ramona691023 collected 3377 from pot
Fischkop993 finished the tournament
*** SUMMARY ***
Total pot 3377 | Rake 0 
Board [6c Jc 9s 3c 2d]
Seat 1: ramona691023 showed [Qc Qd] and won (3377) with a pair of Queens
Seat 2: renanzin147 (button) folded before Flop (didn't bet)
Seat 3: jcarlos.vale (small blind) folded before Flop
Seat 4: chekmpcc (big blind) folded before Flop
Seat 5: mariafirmina folded before Flop (didn't bet)
Seat 6: Sobranie41 folded before Flop (didn't bet)
Seat 7: ddurikkt folded before Flop (didn't bet)
Seat 8: Fischkop993 showed [9d 8d] and lost with a pair of Nines
Seat 9: JANAÍNA13 folded before Flop (didn't bet)



PokerStars Hand #222146459595: Tournament #3086083919, $0.49+$0.06 USD Hold'em No Limit - Level V (40/80) - 2021/01/02 21:41:25 EET [2021/01/02 14:41:25 ET]
Table '3086083919 46' 9-max Seat #3 is the button
Seat 1: ramona691023 (8790 in chips) 
Seat 2: renanzin147 (3532 in chips) 
Seat 3: jcarlos.vale (4648 in chips) 
Seat 4: chekmpcc (7907 in chips) 
Seat 5: mariafirmina (4068 in chips) 
Seat 6: Sobranie41 (1628 in chips) 
Seat 7: ddurikkt (7734 in chips) 
Seat 9: JANAÍNA13 (5711 in chips) 
ramona691023: posts the ante 9
renanzin147: posts the ante 9
jcarlos.vale: posts the ante 9
chekmpcc: posts the ante 9
mariafirmina: posts the ante 9
Sobranie41: posts the ante 9
ddurikkt: posts the ante 9
JANAÍNA13: posts the ante 9
chekmpcc: posts small blind 40
mariafirmina: posts big blind 80
*** HOLE CARDS ***
Dealt to jcarlos.vale [Qc 6d]
Sobranie41: folds 
ddurikkt: folds 
JANAÍNA13: folds 
ramona691023: calls 80
renanzin147: folds 
jcarlos.vale: folds 
chekmpcc: raises 240 to 320
mariafirmina: folds 
ramona691023: folds 
Uncalled bet (240) returned to chekmpcc
chekmpcc collected 312 from pot
*** SUMMARY ***
Total pot 312 | Rake 0 
Seat 1: ramona691023 folded before Flop
Seat 2: renanzin147 folded before Flop (didn't bet)
Seat 3: jcarlos.vale (button) folded before Flop (didn't bet)
Seat 4: chekmpcc (small blind) collected (312)
Seat 5: mariafirmina (big blind) folded before Flop
Seat 6: Sobranie41 folded before Flop (didn't bet)
Seat 7: ddurikkt folded before Flop (didn't bet)
Seat 9: JANAÍNA13 folded before Flop (didn't bet)



PokerStars Hand #222146527252: Tournament #3086083919, $0.49+$0.06 USD Hold'em No Limit - Level V (40/80) - 2021/01/02 21:42:38 EET [2021/01/02 14:42:38 ET]
Table '3086083919 46' 9-max Seat #4 is the button
Seat 1: ramona691023 (8701 in chips) 
Seat 2: renanzin147 (3523 in chips) 
Seat 3: jcarlos.vale (4639 in chips) 
Seat 4: chekmpcc (8130 in chips) 
Seat 5: mariafirmina (3979 in chips) 
Seat 6: Sobranie41 (1619 in chips) 
Seat 7: ddurikkt (7725 in chips) 
Seat 8: diogennn (5000 in chips) 
Seat 9: JANAÍNA13 (5702 in chips) 
ramona691023: posts the ante 9
renanzin147: posts the ante 9
jcarlos.vale: posts the ante 9
chekmpcc: posts the ante 9
mariafirmina: posts the ante 9
Sobranie41: posts the ante 9
ddurikkt: posts the ante 9
diogennn: posts the ante 9
JANAÍNA13: posts the ante 9
mariafirmina: posts small blind 40
Sobranie41: posts big blind 80
*** HOLE CARDS ***
Dealt to jcarlos.vale [6s Qd]
ddurikkt: folds 
diogennn: folds 
JANAÍNA13: folds 
ramona691023: calls 80
renanzin147: folds 
jcarlos.vale: folds 
chekmpcc: raises 160 to 240
mariafirmina: folds 
Sobranie41: raises 1370 to 1610 and is all-in
ramona691023: folds 
chekmpcc: folds 
Uncalled bet (1370) returned to Sobranie41
Sobranie41 collected 681 from pot
Sobranie41: doesn't show handDTO
*** SUMMARY ***
Total pot 681 | Rake 0 
Seat 1: ramona691023 folded before Flop
Seat 2: renanzin147 folded before Flop (didn't bet)
Seat 3: jcarlos.vale folded before Flop (didn't bet)
Seat 4: chekmpcc (button) folded before Flop
Seat 5: mariafirmina (small blind) folded before Flop
Seat 6: Sobranie41 (big blind) collected (681)
Seat 7: ddurikkt folded before Flop (didn't bet)
Seat 8: diogennn folded before Flop (didn't bet)
Seat 9: JANAÍNA13 folded before Flop (didn't bet)



PokerStars Hand #222146564736: Tournament #3086083919, $0.49+$0.06 USD Hold'em No Limit - Level V (40/80) - 2021/01/02 21:43:18 EET [2021/01/02 14:43:18 ET]
Table '3086083919 46' 9-max Seat #5 is the button
Seat 1: ramona691023 (8612 in chips) 
Seat 2: renanzin147 (3514 in chips) 
Seat 3: jcarlos.vale (4630 in chips) 
Seat 4: chekmpcc (7881 in chips) 
Seat 5: mariafirmina (3930 in chips) 
Seat 6: Sobranie41 (2051 in chips) 
Seat 7: ddurikkt (7716 in chips) 
Seat 8: diogennn (4991 in chips) 
Seat 9: JANAÍNA13 (5693 in chips) 
ramona691023: posts the ante 9
renanzin147: posts the ante 9
jcarlos.vale: posts the ante 9
chekmpcc: posts the ante 9
mariafirmina: posts the ante 9
Sobranie41: posts the ante 9
ddurikkt: posts the ante 9
diogennn: posts the ante 9
JANAÍNA13: posts the ante 9
Sobranie41: posts small blind 40
ddurikkt: posts big blind 80
*** HOLE CARDS ***
Dealt to jcarlos.vale [Td 5h]
diogennn: folds 
JANAÍNA13: folds 
ramona691023: folds 
renanzin147: raises 80 to 160
jcarlos.vale: folds 
chekmpcc: folds 
mariafirmina: calls 160
Sobranie41: folds 
ddurikkt: calls 80
*** FLOP *** [9h 8c Kd]
ddurikkt: checks 
renanzin147: bets 397
mariafirmina: folds 
ddurikkt: folds 
Uncalled bet (397) returned to renanzin147
renanzin147 collected 601 from pot
*** SUMMARY ***
Total pot 601 | Rake 0 
Board [9h 8c Kd]
Seat 1: ramona691023 folded before Flop (didn't bet)
Seat 2: renanzin147 collected (601)
Seat 3: jcarlos.vale folded before Flop (didn't bet)
Seat 4: chekmpcc folded before Flop (didn't bet)
Seat 5: mariafirmina (button) folded on the Flop
Seat 6: Sobranie41 (small blind) folded before Flop
Seat 7: ddurikkt (big blind) folded on the Flop
Seat 8: diogennn folded before Flop (didn't bet)
Seat 9: JANAÍNA13 folded before Flop (didn't bet)



PokerStars Hand #222146602987: Tournament #3086083919, $0.49+$0.06 USD Hold'em No Limit - Level V (40/80) - 2021/01/02 21:44:00 EET [2021/01/02 14:44:00 ET]
Table '3086083919 46' 9-max Seat #6 is the button
Seat 1: ramona691023 (8603 in chips) 
Seat 2: renanzin147 (3946 in chips) 
Seat 3: jcarlos.vale (4621 in chips) 
Seat 4: chekmpcc (7872 in chips) 
Seat 5: mariafirmina (3761 in chips) 
Seat 6: Sobranie41 (2002 in chips) 
Seat 7: ddurikkt (7547 in chips) 
Seat 8: diogennn (4982 in chips) 
Seat 9: JANAÍNA13 (5684 in chips) 
ramona691023: posts the ante 9
renanzin147: posts the ante 9
jcarlos.vale: posts the ante 9
chekmpcc: posts the ante 9
mariafirmina: posts the ante 9
Sobranie41: posts the ante 9
ddurikkt: posts the ante 9
diogennn: posts the ante 9
JANAÍNA13: posts the ante 9
ddurikkt: posts small blind 40
diogennn: posts big blind 80
*** HOLE CARDS ***
Dealt to jcarlos.vale [Qc 6s]
JANAÍNA13: folds 
ramona691023: folds 
renanzin147: folds 
jcarlos.vale: folds 
chekmpcc: folds 
mariafirmina: folds 
Sobranie41: raises 1913 to 1993 and is all-in
ddurikkt: folds 
diogennn: folds 
Uncalled bet (1913) returned to Sobranie41
Sobranie41 collected 281 from pot
Sobranie41: doesn't show handDTO
*** SUMMARY ***
Total pot 281 | Rake 0 
Seat 1: ramona691023 folded before Flop (didn't bet)
Seat 2: renanzin147 folded before Flop (didn't bet)
Seat 3: jcarlos.vale folded before Flop (didn't bet)
Seat 4: chekmpcc folded before Flop (didn't bet)
Seat 5: mariafirmina folded before Flop (didn't bet)
Seat 6: Sobranie41 (button) collected (281)
Seat 7: ddurikkt (small blind) folded before Flop
Seat 8: diogennn (big blind) folded before Flop
Seat 9: JANAÍNA13 folded before Flop (didn't bet)



PokerStars Hand #222146636065: Tournament #3086083919, $0.49+$0.06 USD Hold'em No Limit - Level V (40/80) - 2021/01/02 21:44:35 EET [2021/01/02 14:44:35 ET]
Table '3086083919 46' 9-max Seat #7 is the button
Seat 1: ramona691023 (8594 in chips) 
Seat 2: renanzin147 (3937 in chips) 
Seat 3: jcarlos.vale (4612 in chips) 
Seat 4: chekmpcc (7863 in chips) 
Seat 5: mariafirmina (3752 in chips) 
Seat 6: Sobranie41 (2194 in chips) 
Seat 7: ddurikkt (7498 in chips) 
Seat 8: diogennn (4893 in chips) 
Seat 9: JANAÍNA13 (5675 in chips) 
ramona691023: posts the ante 9
renanzin147: posts the ante 9
jcarlos.vale: posts the ante 9
chekmpcc: posts the ante 9
mariafirmina: posts the ante 9
Sobranie41: posts the ante 9
ddurikkt: posts the ante 9
diogennn: posts the ante 9
JANAÍNA13: posts the ante 9
diogennn: posts small blind 40
JANAÍNA13: posts big blind 80
*** HOLE CARDS ***
Dealt to jcarlos.vale [Jh 7d]
ramona691023: folds 
ramona691023 is sitting out
renanzin147: folds 
jcarlos.vale: folds 
chekmpcc: raises 136 to 216
mariafirmina: folds 
Sobranie41: folds 
ddurikkt: folds 
diogennn: folds 
JANAÍNA13: folds 
Uncalled bet (136) returned to chekmpcc
chekmpcc collected 281 from pot
*** SUMMARY ***
Total pot 281 | Rake 0 
Seat 1: ramona691023 folded before Flop (didn't bet)
Seat 2: renanzin147 folded before Flop (didn't bet)
Seat 3: jcarlos.vale folded before Flop (didn't bet)
Seat 4: chekmpcc collected (281)
Seat 5: mariafirmina folded before Flop (didn't bet)
Seat 6: Sobranie41 folded before Flop (didn't bet)
Seat 7: ddurikkt (button) folded before Flop (didn't bet)
Seat 8: diogennn (small blind) folded before Flop
Seat 9: JANAÍNA13 (big blind) folded before Flop



PokerStars Hand #222146672087: Tournament #3086083919, $0.49+$0.06 USD Hold'em No Limit - Level V (40/80) - 2021/01/02 21:45:05 EET [2021/01/02 14:45:05 ET]
Table '3086083919 46' 9-max Seat #8 is the button
Seat 1: ramona691023 (8585 in chips) is sitting out
Seat 2: renanzin147 (3928 in chips) 
Seat 3: jcarlos.vale (4603 in chips) 
Seat 4: chekmpcc (8055 in chips) 
Seat 5: mariafirmina (3743 in chips) 
Seat 6: Sobranie41 (2185 in chips) 
Seat 7: ddurikkt (7489 in chips) 
Seat 8: diogennn (4844 in chips) 
Seat 9: JANAÍNA13 (5586 in chips) 
ramona691023: posts the ante 9
renanzin147: posts the ante 9
jcarlos.vale: posts the ante 9
chekmpcc: posts the ante 9
mariafirmina: posts the ante 9
Sobranie41: posts the ante 9
ddurikkt: posts the ante 9
diogennn: posts the ante 9
JANAÍNA13: posts the ante 9
JANAÍNA13: posts small blind 40
ramona691023: posts big blind 80
*** HOLE CARDS ***
Dealt to jcarlos.vale [Kc 3d]
ramona691023 has returned
renanzin147: folds 
jcarlos.vale: folds 
chekmpcc: raises 136 to 216
mariafirmina: folds 
Sobranie41: folds 
ddurikkt: folds 
diogennn: folds 
JANAÍNA13: calls 176
ramona691023: folds 
*** FLOP *** [Th 5h Ac]
JANAÍNA13: checks 
chekmpcc: bets 409
JANAÍNA13: folds 
Uncalled bet (409) returned to chekmpcc
chekmpcc collected 593 from pot
*** SUMMARY ***
Total pot 593 | Rake 0 
Board [Th 5h Ac]
Seat 1: ramona691023 (big blind) folded before Flop
Seat 2: renanzin147 folded before Flop (didn't bet)
Seat 3: jcarlos.vale folded before Flop (didn't bet)
Seat 4: chekmpcc collected (593)
Seat 5: mariafirmina folded before Flop (didn't bet)
Seat 6: Sobranie41 folded before Flop (didn't bet)
Seat 7: ddurikkt folded before Flop (didn't bet)
Seat 8: diogennn (button) folded before Flop (didn't bet)
Seat 9: JANAÍNA13 (small blind) folded on the Flop



PokerStars Hand #222146727626: Tournament #3086083919, $0.49+$0.06 USD Hold'em No Limit - Level V (40/80) - 2021/01/02 21:46:05 EET [2021/01/02 14:46:05 ET]
Table '3086083919 46' 9-max Seat #9 is the button
Seat 1: ramona691023 (8496 in chips) 
Seat 2: renanzin147 (3919 in chips) 
Seat 3: jcarlos.vale (4594 in chips) 
Seat 4: chekmpcc (8423 in chips) 
Seat 5: mariafirmina (3734 in chips) 
Seat 6: Sobranie41 (2176 in chips) 
Seat 7: ddurikkt (7480 in chips) 
Seat 8: diogennn (4835 in chips) 
Seat 9: JANAÍNA13 (5361 in chips) 
ramona691023: posts the ante 9
renanzin147: posts the ante 9
jcarlos.vale: posts the ante 9
chekmpcc: posts the ante 9
mariafirmina: posts the ante 9
Sobranie41: posts the ante 9
ddurikkt: posts the ante 9
diogennn: posts the ante 9
JANAÍNA13: posts the ante 9
ramona691023: posts small blind 40
renanzin147: posts big blind 80
*** HOLE CARDS ***
Dealt to jcarlos.vale [5c 4d]
jcarlos.vale: folds 
chekmpcc: folds 
mariafirmina: folds 
Sobranie41: folds 
ddurikkt: folds 
diogennn: calls 80
JANAÍNA13: folds 
ramona691023: calls 40
renanzin147: checks 
*** FLOP *** [Ah 7c 7h]
ramona691023: checks 
renanzin147: checks 
diogennn: bets 321
ramona691023: folds 
renanzin147: folds 
Uncalled bet (321) returned to diogennn
diogennn collected 321 from pot
diogennn: doesn't show handDTO
*** SUMMARY ***
Total pot 321 | Rake 0 
Board [Ah 7c 7h]
Seat 1: ramona691023 (small blind) folded on the Flop
Seat 2: renanzin147 (big blind) folded on the Flop
Seat 3: jcarlos.vale folded before Flop (didn't bet)
Seat 4: chekmpcc folded before Flop (didn't bet)
Seat 5: mariafirmina folded before Flop (didn't bet)
Seat 6: Sobranie41 folded before Flop (didn't bet)
Seat 7: ddurikkt folded before Flop (didn't bet)
Seat 8: diogennn collected (321)
Seat 9: JANAÍNA13 (button) folded before Flop (didn't bet)



PokerStars Hand #222146787721: Tournament #3086083919, $0.49+$0.06 USD Hold'em No Limit - Level V (40/80) - 2021/01/02 21:47:11 EET [2021/01/02 14:47:11 ET]
Table '3086083919 46' 9-max Seat #1 is the button
Seat 1: ramona691023 (8407 in chips) 
Seat 2: renanzin147 (3830 in chips) 
Seat 3: jcarlos.vale (4585 in chips) 
Seat 4: chekmpcc (8414 in chips) 
Seat 5: mariafirmina (3725 in chips) 
Seat 6: Sobranie41 (2167 in chips) 
Seat 7: ddurikkt (7471 in chips) 
Seat 8: diogennn (5067 in chips) 
Seat 9: JANAÍNA13 (5352 in chips) 
ramona691023: posts the ante 9
renanzin147: posts the ante 9
jcarlos.vale: posts the ante 9
chekmpcc: posts the ante 9
mariafirmina: posts the ante 9
Sobranie41: posts the ante 9
ddurikkt: posts the ante 9
diogennn: posts the ante 9
JANAÍNA13: posts the ante 9
renanzin147: posts small blind 40
jcarlos.vale: posts big blind 80
*** HOLE CARDS ***
Dealt to jcarlos.vale [9h 4h]
chekmpcc: folds 
mariafirmina: folds 
Sobranie41: calls 80
ddurikkt: raises 88 to 168
diogennn: calls 168
JANAÍNA13: calls 168
ramona691023: folds 
renanzin147: folds 
jcarlos.vale: folds 
Sobranie41: raises 1990 to 2158 and is all-in
ddurikkt: folds 
diogennn: folds 
JANAÍNA13: calls 1990
*** FLOP *** [6d 8c 5h]
*** TURN *** [6d 8c 5h] [7s]
*** RIVER *** [6d 8c 5h 7s] [5c]
*** SHOW DOWN ***
Sobranie41: shows [Tc Jc] (a pair of Fives)
JANAÍNA13: shows [9s 9c] (a straight, Five to Nine)
JANAÍNA13 collected 4853 from pot
Sobranie41 finished the tournament
*** SUMMARY ***
Total pot 4853 | Rake 0 
Board [6d 8c 5h 7s 5c]
Seat 1: ramona691023 (button) folded before Flop (didn't bet)
Seat 2: renanzin147 (small blind) folded before Flop
Seat 3: jcarlos.vale (big blind) folded before Flop
Seat 4: chekmpcc folded before Flop (didn't bet)
Seat 5: mariafirmina folded before Flop (didn't bet)
Seat 6: Sobranie41 showed [Tc Jc] and lost with a pair of Fives
Seat 7: ddurikkt folded before Flop
Seat 8: diogennn folded before Flop
Seat 9: JANAÍNA13 showed [9s 9c] and won (4853) with a straight, Five to Nine



PokerStars Hand #222146832885: Tournament #3086083919, $0.49+$0.06 USD Hold'em No Limit - Level V (40/80) - 2021/01/02 21:48:01 EET [2021/01/02 14:48:01 ET]
Table '3086083919 46' 9-max Seat #2 is the button
Seat 1: ramona691023 (8398 in chips) 
Seat 2: renanzin147 (3781 in chips) 
Seat 3: jcarlos.vale (4496 in chips) 
Seat 4: chekmpcc (8405 in chips) 
Seat 5: mariafirmina (3716 in chips) 
Seat 7: ddurikkt (7294 in chips) 
Seat 8: diogennn (4890 in chips) 
Seat 9: JANAÍNA13 (8038 in chips) 
ramona691023: posts the ante 9
renanzin147: posts the ante 9
jcarlos.vale: posts the ante 9
chekmpcc: posts the ante 9
mariafirmina: posts the ante 9
ddurikkt: posts the ante 9
diogennn: posts the ante 9
JANAÍNA13: posts the ante 9
jcarlos.vale: posts small blind 40
chekmpcc: posts big blind 80
*** HOLE CARDS ***
Dealt to jcarlos.vale [6c Th]
mariafirmina: folds 
ddurikkt: folds 
diogennn: calls 80
JANAÍNA13: folds 
ramona691023: folds 
renanzin147: calls 80
jcarlos.vale: calls 40
chekmpcc: raises 344 to 424
diogennn: folds 
renanzin147: folds 
jcarlos.vale: folds 
Uncalled bet (344) returned to chekmpcc
chekmpcc collected 392 from pot
*** SUMMARY ***
Total pot 392 | Rake 0 
Seat 1: ramona691023 folded before Flop (didn't bet)
Seat 2: renanzin147 (button) folded before Flop
Seat 3: jcarlos.vale (small blind) folded before Flop
Seat 4: chekmpcc (big blind) collected (392)
Seat 5: mariafirmina folded before Flop (didn't bet)
Seat 7: ddurikkt folded before Flop (didn't bet)
Seat 8: diogennn folded before Flop
Seat 9: JANAÍNA13 folded before Flop (didn't bet)



PokerStars Hand #222146867581: Tournament #3086083919, $0.49+$0.06 USD Hold'em No Limit - Level V (40/80) - 2021/01/02 21:48:39 EET [2021/01/02 14:48:39 ET]
Table '3086083919 46' 9-max Seat #3 is the button
Seat 1: ramona691023 (8389 in chips) 
Seat 2: renanzin147 (3692 in chips) 
Seat 3: jcarlos.vale (4407 in chips) 
Seat 4: chekmpcc (8708 in chips) 
Seat 5: mariafirmina (3707 in chips) 
Seat 6: FloripaOG (5000 in chips) 
Seat 7: ddurikkt (7285 in chips) 
Seat 8: diogennn (4801 in chips) 
Seat 9: JANAÍNA13 (8029 in chips) 
ramona691023: posts the ante 9
renanzin147: posts the ante 9
jcarlos.vale: posts the ante 9
chekmpcc: posts the ante 9
mariafirmina: posts the ante 9
FloripaOG: posts the ante 9
ddurikkt: posts the ante 9
diogennn: posts the ante 9
JANAÍNA13: posts the ante 9
chekmpcc: posts small blind 40
mariafirmina: posts big blind 80
*** HOLE CARDS ***
Dealt to jcarlos.vale [4s 9s]
FloripaOG: folds 
ddurikkt: folds 
diogennn: folds 
JANAÍNA13: folds 
ramona691023: calls 80
renanzin147: raises 200 to 280
jcarlos.vale: folds 
chekmpcc: folds 
mariafirmina: folds 
ramona691023: folds 
Uncalled bet (200) returned to renanzin147
renanzin147 collected 361 from pot
*** SUMMARY ***
Total pot 361 | Rake 0 
Seat 1: ramona691023 folded before Flop
Seat 2: renanzin147 collected (361)
Seat 3: jcarlos.vale (button) folded before Flop (didn't bet)
Seat 4: chekmpcc (small blind) folded before Flop
Seat 5: mariafirmina (big blind) folded before Flop
Seat 6: FloripaOG folded before Flop (didn't bet)
Seat 7: ddurikkt folded before Flop (didn't bet)
Seat 8: diogennn folded before Flop (didn't bet)
Seat 9: JANAÍNA13 folded before Flop (didn't bet)



PokerStars Hand #222146910046: Tournament #3086083919, $0.49+$0.06 USD Hold'em No Limit - Level V (40/80) - 2021/01/02 21:49:26 EET [2021/01/02 14:49:26 ET]
Table '3086083919 46' 9-max Seat #4 is the button
Seat 1: ramona691023 (8300 in chips) 
Seat 2: renanzin147 (3964 in chips) 
Seat 3: jcarlos.vale (4398 in chips) 
Seat 4: chekmpcc (8659 in chips) 
Seat 5: mariafirmina (3618 in chips) 
Seat 6: FloripaOG (4991 in chips) 
Seat 7: ddurikkt (7276 in chips) 
Seat 8: diogennn (4792 in chips) 
Seat 9: JANAÍNA13 (8020 in chips) 
ramona691023: posts the ante 9
renanzin147: posts the ante 9
jcarlos.vale: posts the ante 9
chekmpcc: posts the ante 9
mariafirmina: posts the ante 9
FloripaOG: posts the ante 9
ddurikkt: posts the ante 9
diogennn: posts the ante 9
JANAÍNA13: posts the ante 9
mariafirmina: posts small blind 40
FloripaOG: posts big blind 80
*** HOLE CARDS ***
Dealt to jcarlos.vale [8c Jc]
ddurikkt: folds 
diogennn: folds 
JANAÍNA13: folds 
ramona691023: folds 
renanzin147: folds 
jcarlos.vale: calls 80
chekmpcc: folds 
mariafirmina: folds 
FloripaOG: checks 
*** FLOP *** [Qs 5d Ts]
FloripaOG: bets 281
jcarlos.vale: folds 
Uncalled bet (281) returned to FloripaOG
FloripaOG collected 281 from pot
*** SUMMARY ***
Total pot 281 | Rake 0 
Board [Qs 5d Ts]
Seat 1: ramona691023 folded before Flop (didn't bet)
Seat 2: renanzin147 folded before Flop (didn't bet)
Seat 3: jcarlos.vale folded on the Flop
Seat 4: chekmpcc (button) folded before Flop (didn't bet)
Seat 5: mariafirmina (small blind) folded before Flop
Seat 6: FloripaOG (big blind) collected (281)
Seat 7: ddurikkt folded before Flop (didn't bet)
Seat 8: diogennn folded before Flop (didn't bet)
Seat 9: JANAÍNA13 folded before Flop (didn't bet)



PokerStars Hand #222146964296: Tournament #3086083919, $0.49+$0.06 USD Hold'em No Limit - Level VI (50/100) - 2021/01/02 21:50:25 EET [2021/01/02 14:50:25 ET]
Table '3086083919 46' 9-max Seat #5 is the button
Seat 1: ramona691023 (8291 in chips) 
Seat 2: renanzin147 (3955 in chips) 
Seat 3: jcarlos.vale (4309 in chips) 
Seat 4: chekmpcc (8650 in chips) 
Seat 5: mariafirmina (3569 in chips) 
Seat 6: FloripaOG (5183 in chips) 
Seat 7: ddurikkt (7267 in chips) 
Seat 8: diogennn (4783 in chips) 
Seat 9: JANAÍNA13 (8011 in chips) 
ramona691023: posts the ante 10
renanzin147: posts the ante 10
jcarlos.vale: posts the ante 10
chekmpcc: posts the ante 10
mariafirmina: posts the ante 10
FloripaOG: posts the ante 10
ddurikkt: posts the ante 10
diogennn: posts the ante 10
JANAÍNA13: posts the ante 10
FloripaOG: posts small blind 50
ddurikkt: posts big blind 100
*** HOLE CARDS ***
Dealt to jcarlos.vale [2c Tc]
diogennn: folds 
JANAÍNA13: calls 100
ramona691023: folds 
renanzin147: folds 
jcarlos.vale: folds 
chekmpcc: raises 200 to 300
mariafirmina: calls 300
FloripaOG: folds 
ddurikkt: folds 
JANAÍNA13: calls 200
*** FLOP *** [5s 2d 4d]
JANAÍNA13: checks 
chekmpcc: bets 787
mariafirmina: calls 787
JANAÍNA13: folds 
*** TURN *** [5s 2d 4d] [Qc]
chekmpcc: bets 1873
mariafirmina: folds 
Uncalled bet (1873) returned to chekmpcc
chekmpcc collected 2714 from pot
*** SUMMARY ***
Total pot 2714 | Rake 0 
Board [5s 2d 4d Qc]
Seat 1: ramona691023 folded before Flop (didn't bet)
Seat 2: renanzin147 folded before Flop (didn't bet)
Seat 3: jcarlos.vale folded before Flop (didn't bet)
Seat 4: chekmpcc collected (2714)
Seat 5: mariafirmina (button) folded on the Turn
Seat 6: FloripaOG (small blind) folded before Flop
Seat 7: ddurikkt (big blind) folded before Flop
Seat 8: diogennn folded before Flop (didn't bet)
Seat 9: JANAÍNA13 folded on the Flop



PokerStars Hand #222147026141: Tournament #3086083919, $0.49+$0.06 USD Hold'em No Limit - Level VI (50/100) - 2021/01/02 21:51:32 EET [2021/01/02 14:51:32 ET]
Table '3086083919 46' 9-max Seat #6 is the button
Seat 1: ramona691023 (8281 in chips) 
Seat 2: renanzin147 (3945 in chips) 
Seat 3: jcarlos.vale (4299 in chips) 
Seat 4: chekmpcc (10267 in chips) 
Seat 5: mariafirmina (2472 in chips) 
Seat 6: FloripaOG (5123 in chips) 
Seat 7: ddurikkt (7157 in chips) 
Seat 8: diogennn (4773 in chips) 
Seat 9: JANAÍNA13 (7701 in chips) 
ramona691023: posts the ante 10
renanzin147: posts the ante 10
jcarlos.vale: posts the ante 10
chekmpcc: posts the ante 10
mariafirmina: posts the ante 10
FloripaOG: posts the ante 10
ddurikkt: posts the ante 10
diogennn: posts the ante 10
JANAÍNA13: posts the ante 10
ddurikkt: posts small blind 50
diogennn: posts big blind 100
*** HOLE CARDS ***
Dealt to jcarlos.vale [Ad 6s]
JANAÍNA13: folds 
ramona691023: folds 
renanzin147: raises 100 to 200
jcarlos.vale: folds 
chekmpcc: raises 400 to 600
mariafirmina: folds 
FloripaOG: calls 600
ddurikkt: folds 
diogennn: folds 
renanzin147: folds 
*** FLOP *** [Tc Th 3d]
chekmpcc: bets 1132
FloripaOG: folds 
Uncalled bet (1132) returned to chekmpcc
chekmpcc collected 1640 from pot
*** SUMMARY ***
Total pot 1640 | Rake 0 
Board [Tc Th 3d]
Seat 1: ramona691023 folded before Flop (didn't bet)
Seat 2: renanzin147 folded before Flop
Seat 3: jcarlos.vale folded before Flop (didn't bet)
Seat 4: chekmpcc collected (1640)
Seat 5: mariafirmina folded before Flop (didn't bet)
Seat 6: FloripaOG (button) folded on the Flop
Seat 7: ddurikkt (small blind) folded before Flop
Seat 8: diogennn (big blind) folded before Flop
Seat 9: JANAÍNA13 folded before Flop (didn't bet)



PokerStars Hand #222147082427: Tournament #3086083919, $0.49+$0.06 USD Hold'em No Limit - Level VI (50/100) - 2021/01/02 21:52:33 EET [2021/01/02 14:52:33 ET]
Table '3086083919 46' 9-max Seat #7 is the button
Seat 1: ramona691023 (8271 in chips) 
Seat 2: renanzin147 (3735 in chips) 
Seat 3: jcarlos.vale (4289 in chips) 
Seat 4: chekmpcc (11297 in chips) 
Seat 5: mariafirmina (2462 in chips) 
Seat 6: FloripaOG (4513 in chips) 
Seat 7: ddurikkt (7097 in chips) 
Seat 8: diogennn (4663 in chips) 
Seat 9: JANAÍNA13 (7691 in chips) 
ramona691023: posts the ante 10
renanzin147: posts the ante 10
jcarlos.vale: posts the ante 10
chekmpcc: posts the ante 10
mariafirmina: posts the ante 10
FloripaOG: posts the ante 10
ddurikkt: posts the ante 10
diogennn: posts the ante 10
JANAÍNA13: posts the ante 10
diogennn: posts small blind 50
JANAÍNA13: posts big blind 100
*** HOLE CARDS ***
Dealt to jcarlos.vale [7c 5c]
ramona691023: folds 
ramona691023 is sitting out
renanzin147: raises 100 to 200
jcarlos.vale: folds 
chekmpcc: folds 
mariafirmina: folds 
FloripaOG: folds 
ddurikkt: raises 500 to 700
diogennn: folds 
JANAÍNA13: folds 
renanzin147: folds 
Uncalled bet (500) returned to ddurikkt
ddurikkt collected 640 from pot
ddurikkt: doesn't show handDTO
*** SUMMARY ***
Total pot 640 | Rake 0 
Seat 1: ramona691023 folded before Flop (didn't bet)
Seat 2: renanzin147 folded before Flop
Seat 3: jcarlos.vale folded before Flop (didn't bet)
Seat 4: chekmpcc folded before Flop (didn't bet)
Seat 5: mariafirmina folded before Flop (didn't bet)
Seat 6: FloripaOG folded before Flop (didn't bet)
Seat 7: ddurikkt (button) collected (640)
Seat 8: diogennn (small blind) folded before Flop
Seat 9: JANAÍNA13 (big blind) folded before Flop



PokerStars Hand #222147115129: Tournament #3086083919, $0.49+$0.06 USD Hold'em No Limit - Level VI (50/100) - 2021/01/02 21:53:08 EET [2021/01/02 14:53:08 ET]
Table '3086083919 46' 9-max Seat #8 is the button
Seat 1: ramona691023 (8261 in chips) is sitting out
Seat 2: renanzin147 (3525 in chips) 
Seat 3: jcarlos.vale (4279 in chips) 
Seat 4: chekmpcc (11287 in chips) 
Seat 5: mariafirmina (2452 in chips) 
Seat 6: FloripaOG (4503 in chips) 
Seat 7: ddurikkt (7527 in chips) 
Seat 8: diogennn (4603 in chips) 
Seat 9: JANAÍNA13 (7581 in chips) 
ramona691023: posts the ante 10
renanzin147: posts the ante 10
jcarlos.vale: posts the ante 10
chekmpcc: posts the ante 10
mariafirmina: posts the ante 10
FloripaOG: posts the ante 10
ddurikkt: posts the ante 10
diogennn: posts the ante 10
JANAÍNA13: posts the ante 10
JANAÍNA13: posts small blind 50
ramona691023: posts big blind 100
*** HOLE CARDS ***
Dealt to jcarlos.vale [7c Jh]
ramona691023 has returned
renanzin147: folds 
jcarlos.vale: folds 
chekmpcc: folds 
mariafirmina: folds 
FloripaOG: folds 
ddurikkt: folds 
diogennn: raises 340 to 440
JANAÍNA13: folds 
ramona691023: folds 
Uncalled bet (340) returned to diogennn
diogennn collected 340 from pot
diogennn: doesn't show handDTO
*** SUMMARY ***
Total pot 340 | Rake 0 
Seat 1: ramona691023 (big blind) folded before Flop
Seat 2: renanzin147 folded before Flop (didn't bet)
Seat 3: jcarlos.vale folded before Flop (didn't bet)
Seat 4: chekmpcc folded before Flop (didn't bet)
Seat 5: mariafirmina folded before Flop (didn't bet)
Seat 6: FloripaOG folded before Flop (didn't bet)
Seat 7: ddurikkt folded before Flop (didn't bet)
Seat 8: diogennn (button) collected (340)
Seat 9: JANAÍNA13 (small blind) folded before Flop



PokerStars Hand #222147142613: Tournament #3086083919, $0.49+$0.06 USD Hold'em No Limit - Level VI (50/100) - 2021/01/02 21:53:38 EET [2021/01/02 14:53:38 ET]
Table '3086083919 46' 9-max Seat #9 is the button
Seat 1: ramona691023 (8151 in chips) 
Seat 2: renanzin147 (3515 in chips) 
Seat 3: jcarlos.vale (4269 in chips) 
Seat 4: chekmpcc (11277 in chips) 
Seat 5: mariafirmina (2442 in chips) 
Seat 6: FloripaOG (4493 in chips) 
Seat 7: ddurikkt (7517 in chips) 
Seat 8: diogennn (4833 in chips) 
Seat 9: JANAÍNA13 (7521 in chips) 
ramona691023: posts the ante 10
renanzin147: posts the ante 10
jcarlos.vale: posts the ante 10
chekmpcc: posts the ante 10
mariafirmina: posts the ante 10
FloripaOG: posts the ante 10
ddurikkt: posts the ante 10
diogennn: posts the ante 10
JANAÍNA13: posts the ante 10
ramona691023: posts small blind 50
renanzin147: posts big blind 100
*** HOLE CARDS ***
Dealt to jcarlos.vale [4s Qh]
jcarlos.vale: folds 
chekmpcc: raises 110 to 210
mariafirmina: folds 
FloripaOG: folds 
ddurikkt: folds 
diogennn: folds 
JANAÍNA13: calls 210
ramona691023: folds 
renanzin147: calls 110
*** FLOP *** [3s 6h 3c]
renanzin147: checks 
chekmpcc: checks 
JANAÍNA13: checks 
*** TURN *** [3s 6h 3c] [Js]
renanzin147: checks 
chekmpcc: bets 500
JANAÍNA13: calls 500
renanzin147: folds 
*** RIVER *** [3s 6h 3c Js] [3h]
chekmpcc: checks 
JANAÍNA13: checks 
*** SHOW DOWN ***
chekmpcc: shows [5c 7c] (three of a kind, Threes)
JANAÍNA13: shows [Qs 9s] (three of a kind, Threes - Queen kicker)
JANAÍNA13 collected 1770 from pot
*** SUMMARY ***
Total pot 1770 | Rake 0 
Board [3s 6h 3c Js 3h]
Seat 1: ramona691023 (small blind) folded before Flop
Seat 2: renanzin147 (big blind) folded on the Turn
Seat 3: jcarlos.vale folded before Flop (didn't bet)
Seat 4: chekmpcc showed [5c 7c] and lost with three of a kind, Threes
Seat 5: mariafirmina folded before Flop (didn't bet)
Seat 6: FloripaOG folded before Flop (didn't bet)
Seat 7: ddurikkt folded before Flop (didn't bet)
Seat 8: diogennn folded before Flop (didn't bet)
Seat 9: JANAÍNA13 (button) showed [Qs 9s] and won (1770) with three of a kind, Threes



PokerStars Hand #222147228812: Tournament #3086083919, $0.49+$0.06 USD Hold'em No Limit - Level VI (50/100) - 2021/01/02 21:55:01 EET [2021/01/02 14:55:01 ET]
Table '3086083919 46' 9-max Seat #1 is the button
Seat 1: ramona691023 (8091 in chips) 
Seat 2: renanzin147 (3295 in chips) 
Seat 3: jcarlos.vale (4259 in chips) 
Seat 4: chekmpcc (10557 in chips) 
Seat 5: mariafirmina (2432 in chips) 
Seat 6: FloripaOG (4483 in chips) 
Seat 7: ddurikkt (7507 in chips) 
Seat 8: diogennn (4823 in chips) 
Seat 9: JANAÍNA13 (8571 in chips) 
ramona691023: posts the ante 10
renanzin147: posts the ante 10
jcarlos.vale: posts the ante 10
chekmpcc: posts the ante 10
mariafirmina: posts the ante 10
FloripaOG: posts the ante 10
ddurikkt: posts the ante 10
diogennn: posts the ante 10
JANAÍNA13: posts the ante 10
renanzin147: posts small blind 50
jcarlos.vale: posts big blind 100
*** HOLE CARDS ***
Dealt to jcarlos.vale [Th 6d]
chekmpcc: folds 
mariafirmina: folds 
FloripaOG: folds 
ddurikkt: folds 
diogennn: folds 
JANAÍNA13: folds 
ramona691023: calls 100
renanzin147: folds 
jcarlos.vale: checks 
*** FLOP *** [7c Tc 3s]
jcarlos.vale: bets 170
ramona691023: calls 170
*** TURN *** [7c Tc 3s] [Qh]
jcarlos.vale: bets 200
ramona691023: folds 
Uncalled bet (200) returned to jcarlos.vale
jcarlos.vale collected 680 from pot
jcarlos.vale: doesn't show handDTO
*** SUMMARY ***
Total pot 680 | Rake 0 
Board [7c Tc 3s Qh]
Seat 1: ramona691023 (button) folded on the Turn
Seat 2: renanzin147 (small blind) folded before Flop
Seat 3: jcarlos.vale (big blind) collected (680)
Seat 4: chekmpcc folded before Flop (didn't bet)
Seat 5: mariafirmina folded before Flop (didn't bet)
Seat 6: FloripaOG folded before Flop (didn't bet)
Seat 7: ddurikkt folded before Flop (didn't bet)
Seat 8: diogennn folded before Flop (didn't bet)
Seat 9: JANAÍNA13 folded before Flop (didn't bet)



PokerStars Hand #222147517057: Tournament #3086083919, $0.49+$0.06 USD Hold'em No Limit - Level VI (50/100) - 2021/01/02 22:02:33 EET [2021/01/02 15:02:33 ET]
Table '3086083919 46' 9-max Seat #2 is the button
Seat 1: ramona691023 (7811 in chips) 
Seat 2: renanzin147 (3235 in chips) 
Seat 3: jcarlos.vale (4659 in chips) 
Seat 4: chekmpcc (10547 in chips) 
Seat 5: mariafirmina (2422 in chips) 
Seat 6: FloripaOG (4473 in chips) 
Seat 7: ddurikkt (7497 in chips) 
Seat 8: diogennn (4813 in chips) 
Seat 9: JANAÍNA13 (8561 in chips) 
ramona691023: posts the ante 10
renanzin147: posts the ante 10
jcarlos.vale: posts the ante 10
chekmpcc: posts the ante 10
mariafirmina: posts the ante 10
FloripaOG: posts the ante 10
ddurikkt: posts the ante 10
diogennn: posts the ante 10
JANAÍNA13: posts the ante 10
jcarlos.vale: posts small blind 50
chekmpcc: posts big blind 100
*** HOLE CARDS ***
Dealt to jcarlos.vale [7s Jd]
mariafirmina: folds 
FloripaOG: folds 
ddurikkt: raises 110 to 210
diogennn: folds 
JANAÍNA13: folds 
ramona691023: folds 
renanzin147: folds 
jcarlos.vale: folds 
ramona691023 is sitting out
chekmpcc: folds 
Uncalled bet (110) returned to ddurikkt
ddurikkt collected 340 from pot
*** SUMMARY ***
Total pot 340 | Rake 0 
Seat 1: ramona691023 folded before Flop (didn't bet)
Seat 2: renanzin147 (button) folded before Flop (didn't bet)
Seat 3: jcarlos.vale (small blind) folded before Flop
Seat 4: chekmpcc (big blind) folded before Flop
Seat 5: mariafirmina folded before Flop (didn't bet)
Seat 6: FloripaOG folded before Flop (didn't bet)
Seat 7: ddurikkt collected (340)
Seat 8: diogennn folded before Flop (didn't bet)
Seat 9: JANAÍNA13 folded before Flop (didn't bet)



PokerStars Hand #222147556904: Tournament #3086083919, $0.49+$0.06 USD Hold'em No Limit - Level VI (50/100) - 2021/01/02 22:03:15 EET [2021/01/02 15:03:15 ET]
Table '3086083919 46' 9-max Seat #3 is the button
Seat 1: ramona691023 (7801 in chips) is sitting out
Seat 2: renanzin147 (3225 in chips) 
Seat 3: jcarlos.vale (4599 in chips) 
Seat 4: chekmpcc (10437 in chips) 
Seat 5: mariafirmina (2412 in chips) 
Seat 6: FloripaOG (4463 in chips) 
Seat 7: ddurikkt (7727 in chips) 
Seat 8: diogennn (4803 in chips) 
Seat 9: JANAÍNA13 (8551 in chips) 
ramona691023: posts the ante 10
renanzin147: posts the ante 10
jcarlos.vale: posts the ante 10
chekmpcc: posts the ante 10
mariafirmina: posts the ante 10
FloripaOG: posts the ante 10
ddurikkt: posts the ante 10
diogennn: posts the ante 10
JANAÍNA13: posts the ante 10
chekmpcc: posts small blind 50
mariafirmina: posts big blind 100
*** HOLE CARDS ***
Dealt to jcarlos.vale [Ks Th]
FloripaOG: calls 100
ddurikkt: folds 
diogennn: calls 100
ramona691023 has returned
JANAÍNA13: calls 100
ramona691023: folds 
renanzin147: calls 100
jcarlos.vale: folds 
chekmpcc: calls 50
mariafirmina: checks 
*** FLOP *** [9s 7c 8h]
chekmpcc: bets 807
mariafirmina: folds 
FloripaOG: calls 807
diogennn: folds 
JANAÍNA13: folds 
renanzin147: folds 
*** TURN *** [9s 7c 8h] [7h]
chekmpcc: checks 
FloripaOG: bets 3546 and is all-in
chekmpcc: folds 
Uncalled bet (3546) returned to FloripaOG
FloripaOG collected 2304 from pot
*** SUMMARY ***
Total pot 2304 | Rake 0 
Board [9s 7c 8h 7h]
Seat 1: ramona691023 folded before Flop (didn't bet)
Seat 2: renanzin147 folded on the Flop
Seat 3: jcarlos.vale (button) folded before Flop (didn't bet)
Seat 4: chekmpcc (small blind) folded on the Turn
Seat 5: mariafirmina (big blind) folded on the Flop
Seat 6: FloripaOG collected (2304)
Seat 7: ddurikkt folded before Flop (didn't bet)
Seat 8: diogennn folded on the Flop
Seat 9: JANAÍNA13 folded on the Flop



PokerStars Hand #222147615625: Tournament #3086083919, $0.49+$0.06 USD Hold'em No Limit - Level VI (50/100) - 2021/01/02 22:04:17 EET [2021/01/02 15:04:17 ET]
Table '3086083919 46' 9-max Seat #4 is the button
Seat 2: renanzin147 (3115 in chips) 
Seat 3: jcarlos.vale (4589 in chips) 
Seat 4: chekmpcc (9520 in chips) 
Seat 5: mariafirmina (2302 in chips) 
Seat 6: FloripaOG (5850 in chips) 
Seat 7: ddurikkt (7717 in chips) 
Seat 8: diogennn (4693 in chips) 
Seat 9: JANAÍNA13 (8441 in chips) 
renanzin147: posts the ante 10
jcarlos.vale: posts the ante 10
chekmpcc: posts the ante 10
mariafirmina: posts the ante 10
FloripaOG: posts the ante 10
ddurikkt: posts the ante 10
diogennn: posts the ante 10
JANAÍNA13: posts the ante 10
mariafirmina: posts small blind 50
FloripaOG: posts big blind 100
*** HOLE CARDS ***
Dealt to jcarlos.vale [9d Ac]
ddurikkt: folds 
diogennn: calls 100
JANAÍNA13: calls 100
renanzin147: folds 
jcarlos.vale: calls 100
chekmpcc: raises 400 to 500
mariafirmina: folds 
FloripaOG: folds 
diogennn: calls 400
JANAÍNA13: folds 
jcarlos.vale: folds 
*** FLOP *** [Ad Qh 6c]
diogennn: checks 
chekmpcc: checks 
*** TURN *** [Ad Qh 6c] [3d]
diogennn: checks 
chekmpcc: checks 
*** RIVER *** [Ad Qh 6c 3d] [As]
diogennn: checks 
chekmpcc: bets 358
diogennn: folds 
Uncalled bet (358) returned to chekmpcc
chekmpcc collected 1430 from pot
*** SUMMARY ***
Total pot 1430 | Rake 0 
Board [Ad Qh 6c 3d As]
Seat 2: renanzin147 folded before Flop (didn't bet)
Seat 3: jcarlos.vale folded before Flop
Seat 4: chekmpcc (button) collected (1430)
Seat 5: mariafirmina (small blind) folded before Flop
Seat 6: FloripaOG (big blind) folded before Flop
Seat 7: ddurikkt folded before Flop (didn't bet)
Seat 8: diogennn folded on the River
Seat 9: JANAÍNA13 folded before Flop



PokerStars Hand #222147702055: Tournament #3086083919, $0.49+$0.06 USD Hold'em No Limit - Level VI (50/100) - 2021/01/02 22:05:46 EET [2021/01/02 15:05:46 ET]
Table '3086083919 46' 9-max Seat #5 is the button
Seat 1: Roofes (5000 in chips) 
Seat 2: renanzin147 (3105 in chips) 
Seat 3: jcarlos.vale (4479 in chips) 
Seat 4: chekmpcc (10440 in chips) 
Seat 5: mariafirmina (2242 in chips) 
Seat 6: FloripaOG (5740 in chips) 
Seat 7: ddurikkt (7707 in chips) 
Seat 8: diogennn (4183 in chips) 
Seat 9: JANAÍNA13 (8331 in chips) 
Roofes: posts the ante 10
renanzin147: posts the ante 10
jcarlos.vale: posts the ante 10
chekmpcc: posts the ante 10
mariafirmina: posts the ante 10
FloripaOG: posts the ante 10
ddurikkt: posts the ante 10
diogennn: posts the ante 10
JANAÍNA13: posts the ante 10
FloripaOG: posts small blind 50
ddurikkt: posts big blind 100
*** HOLE CARDS ***
Dealt to jcarlos.vale [9h 6c]
diogennn: folds 
JANAÍNA13: calls 100
Roofes: calls 100
renanzin147: raises 400 to 500
jcarlos.vale: folds 
chekmpcc: folds 
mariafirmina: folds 
FloripaOG: folds 
ddurikkt: folds 
JANAÍNA13: folds 
Roofes: raises 4490 to 4990 and is all-in
renanzin147: folds 
Uncalled bet (4490) returned to Roofes
Roofes collected 1340 from pot
Roofes: doesn't show handDTO
*** SUMMARY ***
Total pot 1340 | Rake 0 
Seat 1: Roofes collected (1340)
Seat 2: renanzin147 folded before Flop
Seat 3: jcarlos.vale folded before Flop (didn't bet)
Seat 4: chekmpcc folded before Flop (didn't bet)
Seat 5: mariafirmina (button) folded before Flop (didn't bet)
Seat 6: FloripaOG (small blind) folded before Flop
Seat 7: ddurikkt (big blind) folded before Flop
Seat 8: diogennn folded before Flop (didn't bet)
Seat 9: JANAÍNA13 folded before Flop



PokerStars Hand #222147774358: Tournament #3086083919, $0.49+$0.06 USD Hold'em No Limit - Level VI (50/100) - 2021/01/02 22:06:59 EET [2021/01/02 15:06:59 ET]
Table '3086083919 46' 9-max Seat #6 is the button
Seat 1: Roofes (5830 in chips) 
Seat 2: renanzin147 (2595 in chips) 
Seat 3: jcarlos.vale (4469 in chips) 
Seat 4: chekmpcc (10430 in chips) 
Seat 5: mariafirmina (2232 in chips) 
Seat 6: FloripaOG (5680 in chips) 
Seat 7: ddurikkt (7597 in chips) 
Seat 8: diogennn (4173 in chips) 
Seat 9: JANAÍNA13 (8221 in chips) 
Roofes: posts the ante 10
renanzin147: posts the ante 10
jcarlos.vale: posts the ante 10
chekmpcc: posts the ante 10
mariafirmina: posts the ante 10
FloripaOG: posts the ante 10
ddurikkt: posts the ante 10
diogennn: posts the ante 10
JANAÍNA13: posts the ante 10
ddurikkt: posts small blind 50
diogennn: posts big blind 100
*** HOLE CARDS ***
Dealt to jcarlos.vale [Qs 3h]
JANAÍNA13: folds 
Roofes: folds 
renanzin147: folds 
jcarlos.vale: folds 
chekmpcc: raises 170 to 270
mariafirmina: calls 270
FloripaOG: calls 270
ddurikkt: folds 
diogennn: folds 
*** FLOP *** [Ts Td 6h]
chekmpcc: bets 389
mariafirmina: calls 389
FloripaOG: calls 389
*** TURN *** [Ts Td 6h] [8s]
chekmpcc: checks 
mariafirmina: checks 
FloripaOG: bets 2217
chekmpcc: folds 
mariafirmina: calls 1563 and is all-in
Uncalled bet (654) returned to FloripaOG
*** RIVER *** [Ts Td 6h 8s] [Kd]
*** SHOW DOWN ***
mariafirmina: shows [7h 9h] (a straight, Six to Ten)
FloripaOG: shows [Jh Qh] (a pair of Tens)
mariafirmina collected 5343 from pot
*** SUMMARY ***
Total pot 5343 | Rake 0 
Board [Ts Td 6h 8s Kd]
Seat 1: Roofes folded before Flop (didn't bet)
Seat 2: renanzin147 folded before Flop (didn't bet)
Seat 3: jcarlos.vale folded before Flop (didn't bet)
Seat 4: chekmpcc folded on the Turn
Seat 5: mariafirmina showed [7h 9h] and won (5343) with a straight, Six to Ten
Seat 6: FloripaOG (button) showed [Jh Qh] and lost with a pair of Tens
Seat 7: ddurikkt (small blind) folded before Flop
Seat 8: diogennn (big blind) folded before Flop
Seat 9: JANAÍNA13 folded before Flop (didn't bet)



PokerStars Hand #222147824257: Tournament #3086083919, $0.49+$0.06 USD Hold'em No Limit - Level VII (60/120) - 2021/01/02 22:07:49 EET [2021/01/02 15:07:49 ET]
Table '3086083919 46' 9-max Seat #7 is the button
Seat 1: Roofes (5820 in chips) 
Seat 2: renanzin147 (2585 in chips) 
Seat 3: jcarlos.vale (4459 in chips) 
Seat 4: chekmpcc (9761 in chips) 
Seat 5: mariafirmina (5343 in chips) 
Seat 6: FloripaOG (3448 in chips) 
Seat 7: ddurikkt (7537 in chips) 
Seat 8: diogennn (4063 in chips) 
Seat 9: JANAÍNA13 (8211 in chips) 
Roofes: posts the ante 12
renanzin147: posts the ante 12
jcarlos.vale: posts the ante 12
chekmpcc: posts the ante 12
mariafirmina: posts the ante 12
FloripaOG: posts the ante 12
ddurikkt: posts the ante 12
diogennn: posts the ante 12
JANAÍNA13: posts the ante 12
diogennn: posts small blind 60
JANAÍNA13: posts big blind 120
*** HOLE CARDS ***
Dealt to jcarlos.vale [3d 6d]
Roofes: folds 
renanzin147: folds 
jcarlos.vale: folds 
chekmpcc: folds 
mariafirmina: folds 
FloripaOG: calls 120
ddurikkt: calls 120
diogennn: folds 
JANAÍNA13: checks 
*** FLOP *** [9c 4h 2s]
JANAÍNA13: checks 
FloripaOG: checks 
ddurikkt: checks 
*** TURN *** [9c 4h 2s] [8c]
JANAÍNA13: checks 
FloripaOG: bets 528
ddurikkt: folds 
JANAÍNA13: folds 
Uncalled bet (528) returned to FloripaOG
FloripaOG collected 528 from pot
*** SUMMARY ***
Total pot 528 | Rake 0 
Board [9c 4h 2s 8c]
Seat 1: Roofes folded before Flop (didn't bet)
Seat 2: renanzin147 folded before Flop (didn't bet)
Seat 3: jcarlos.vale folded before Flop (didn't bet)
Seat 4: chekmpcc folded before Flop (didn't bet)
Seat 5: mariafirmina folded before Flop (didn't bet)
Seat 6: FloripaOG collected (528)
Seat 7: ddurikkt (button) folded on the Turn
Seat 8: diogennn (small blind) folded before Flop
Seat 9: JANAÍNA13 (big blind) folded on the Turn



PokerStars Hand #222147890813: Tournament #3086083919, $0.49+$0.06 USD Hold'em No Limit - Level VII (60/120) - 2021/01/02 22:08:48 EET [2021/01/02 15:08:48 ET]
Table '3086083919 46' 9-max Seat #8 is the button
Seat 1: Roofes (5808 in chips) 
Seat 2: renanzin147 (2573 in chips) 
Seat 3: jcarlos.vale (4447 in chips) 
Seat 4: chekmpcc (9749 in chips) 
Seat 5: mariafirmina (5331 in chips) 
Seat 6: FloripaOG (3844 in chips) 
Seat 7: ddurikkt (7405 in chips) 
Seat 8: diogennn (3991 in chips) 
Seat 9: JANAÍNA13 (8079 in chips) 
Roofes: posts the ante 12
renanzin147: posts the ante 12
jcarlos.vale: posts the ante 12
chekmpcc: posts the ante 12
mariafirmina: posts the ante 12
FloripaOG: posts the ante 12
ddurikkt: posts the ante 12
diogennn: posts the ante 12
JANAÍNA13: posts the ante 12
JANAÍNA13: posts small blind 60
Roofes: posts big blind 120
*** HOLE CARDS ***
Dealt to jcarlos.vale [7s Kd]
renanzin147: folds 
jcarlos.vale: folds 
chekmpcc: raises 204 to 324
mariafirmina: folds 
FloripaOG: folds 
ddurikkt: folds 
diogennn: calls 324
JANAÍNA13: folds 
Roofes: calls 204
*** FLOP *** [7d 5d 5h]
Roofes: bets 1140
chekmpcc: raises 8273 to 9413 and is all-in
diogennn: folds 
Roofes: calls 4332 and is all-in
Uncalled bet (3941) returned to chekmpcc
*** TURN *** [7d 5d 5h] [7c]
*** RIVER *** [7d 5d 5h 7c] [2d]
*** SHOW DOWN ***
Roofes: shows [Qd Th] (two pair, Sevens and Fives)
chekmpcc: shows [Ad 6d] (a flush, Ace high)
chekmpcc collected 12084 from pot
Roofes finished the tournament
*** SUMMARY ***
Total pot 12084 | Rake 0 
Board [7d 5d 5h 7c 2d]
Seat 1: Roofes (big blind) showed [Qd Th] and lost with two pair, Sevens and Fives
Seat 2: renanzin147 folded before Flop (didn't bet)
Seat 3: jcarlos.vale folded before Flop (didn't bet)
Seat 4: chekmpcc showed [Ad 6d] and won (12084) with a flush, Ace high
Seat 5: mariafirmina folded before Flop (didn't bet)
Seat 6: FloripaOG folded before Flop (didn't bet)
Seat 7: ddurikkt folded before Flop (didn't bet)
Seat 8: diogennn (button) folded on the Flop
Seat 9: JANAÍNA13 (small blind) folded before Flop



PokerStars Hand #222147931306: Tournament #3086083919, $0.49+$0.06 USD Hold'em No Limit - Level VII (60/120) - 2021/01/02 22:09:29 EET [2021/01/02 15:09:29 ET]
Table '3086083919 46' 9-max Seat #9 is the button
Seat 2: renanzin147 (2561 in chips) 
Seat 3: jcarlos.vale (4435 in chips) 
Seat 4: chekmpcc (16025 in chips) 
Seat 5: mariafirmina (5319 in chips) 
Seat 6: FloripaOG (3832 in chips) 
Seat 7: ddurikkt (7393 in chips) 
Seat 8: diogennn (3655 in chips) 
Seat 9: JANAÍNA13 (8007 in chips) 
renanzin147: posts the ante 12
jcarlos.vale: posts the ante 12
chekmpcc: posts the ante 12
mariafirmina: posts the ante 12
FloripaOG: posts the ante 12
ddurikkt: posts the ante 12
diogennn: posts the ante 12
JANAÍNA13: posts the ante 12
renanzin147: posts small blind 60
jcarlos.vale: posts big blind 120
*** HOLE CARDS ***
Dealt to jcarlos.vale [9h 2s]
chekmpcc: raises 204 to 324
mariafirmina: folds 
FloripaOG: folds 
ddurikkt: folds 
diogennn: calls 324
JANAÍNA13: folds 
renanzin147: folds 
jcarlos.vale: folds 
*** FLOP *** [Ks 5s 3d]
chekmpcc: bets 638
diogennn: calls 638
*** TURN *** [Ks 5s 3d] [Kh]
chekmpcc: checks 
diogennn: bets 2681 and is all-in
chekmpcc: folds 
Uncalled bet (2681) returned to diogennn
diogennn collected 2200 from pot
diogennn: doesn't show handDTO
*** SUMMARY ***
Total pot 2200 | Rake 0 
Board [Ks 5s 3d Kh]
Seat 2: renanzin147 (small blind) folded before Flop
Seat 3: jcarlos.vale (big blind) folded before Flop
Seat 4: chekmpcc folded on the Turn
Seat 5: mariafirmina folded before Flop (didn't bet)
Seat 6: FloripaOG folded before Flop (didn't bet)
Seat 7: ddurikkt folded before Flop (didn't bet)
Seat 8: diogennn collected (2200)
Seat 9: JANAÍNA13 (button) folded before Flop (didn't bet)



PokerStars Hand #222147966311: Tournament #3086083919, $0.49+$0.06 USD Hold'em No Limit - Level VII (60/120) - 2021/01/02 22:10:04 EET [2021/01/02 15:10:04 ET]
Table '3086083919 46' 9-max Seat #2 is the button
Seat 1: csabipapa1 (5000 in chips) 
Seat 2: renanzin147 (2489 in chips) 
Seat 3: jcarlos.vale (4303 in chips) 
Seat 4: chekmpcc (15051 in chips) 
Seat 5: mariafirmina (5307 in chips) 
Seat 6: FloripaOG (3820 in chips) 
Seat 7: ddurikkt (7381 in chips) 
Seat 8: diogennn (4881 in chips) 
Seat 9: JANAÍNA13 (7995 in chips) 
csabipapa1: posts the ante 12
renanzin147: posts the ante 12
jcarlos.vale: posts the ante 12
chekmpcc: posts the ante 12
mariafirmina: posts the ante 12
FloripaOG: posts the ante 12
ddurikkt: posts the ante 12
diogennn: posts the ante 12
JANAÍNA13: posts the ante 12
jcarlos.vale: posts small blind 60
chekmpcc: posts big blind 120
*** HOLE CARDS ***
Dealt to jcarlos.vale [4c 6d]
mariafirmina: folds 
FloripaOG: folds 
ddurikkt: raises 132 to 252
diogennn: folds 
JANAÍNA13: calls 252
csabipapa1: folds 
renanzin147: folds 
jcarlos.vale: folds 
chekmpcc: folds 
*** FLOP *** [6h 7h Jh]
ddurikkt: bets 261
JANAÍNA13: folds 
Uncalled bet (261) returned to ddurikkt
ddurikkt collected 792 from pot
*** SUMMARY ***
Total pot 792 | Rake 0 
Board [6h 7h Jh]
Seat 1: csabipapa1 folded before Flop (didn't bet)
Seat 2: renanzin147 (button) folded before Flop (didn't bet)
Seat 3: jcarlos.vale (small blind) folded before Flop
Seat 4: chekmpcc (big blind) folded before Flop
Seat 5: mariafirmina folded before Flop (didn't bet)
Seat 6: FloripaOG folded before Flop (didn't bet)
Seat 7: ddurikkt collected (792)
Seat 8: diogennn folded before Flop (didn't bet)
Seat 9: JANAÍNA13 folded on the Flop



PokerStars Hand #222148020142: Tournament #3086083919, $0.49+$0.06 USD Hold'em No Limit - Level VII (60/120) - 2021/01/02 22:10:59 EET [2021/01/02 15:10:59 ET]
Table '3086083919 46' 9-max Seat #3 is the button
Seat 1: csabipapa1 (4988 in chips) 
Seat 2: renanzin147 (2477 in chips) 
Seat 3: jcarlos.vale (4231 in chips) 
Seat 4: chekmpcc (14919 in chips) 
Seat 5: mariafirmina (5295 in chips) 
Seat 6: FloripaOG (3808 in chips) 
Seat 7: ddurikkt (7909 in chips) 
Seat 8: diogennn (4869 in chips) 
Seat 9: JANAÍNA13 (7731 in chips) 
csabipapa1: posts the ante 12
renanzin147: posts the ante 12
jcarlos.vale: posts the ante 12
chekmpcc: posts the ante 12
mariafirmina: posts the ante 12
FloripaOG: posts the ante 12
ddurikkt: posts the ante 12
diogennn: posts the ante 12
JANAÍNA13: posts the ante 12
chekmpcc: posts small blind 60
mariafirmina: posts big blind 120
*** HOLE CARDS ***
Dealt to jcarlos.vale [Jc 8s]
FloripaOG: raises 3676 to 3796 and is all-in
ddurikkt: folds 
diogennn: folds 
JANAÍNA13: folds 
csabipapa1: folds 
renanzin147: folds 
jcarlos.vale: folds 
chekmpcc: folds 
mariafirmina: folds 
Uncalled bet (3676) returned to FloripaOG
FloripaOG collected 408 from pot
*** SUMMARY ***
Total pot 408 | Rake 0 
Seat 1: csabipapa1 folded before Flop (didn't bet)
Seat 2: renanzin147 folded before Flop (didn't bet)
Seat 3: jcarlos.vale (button) folded before Flop (didn't bet)
Seat 4: chekmpcc (small blind) folded before Flop
Seat 5: mariafirmina (big blind) folded before Flop
Seat 6: FloripaOG collected (408)
Seat 7: ddurikkt folded before Flop (didn't bet)
Seat 8: diogennn folded before Flop (didn't bet)
Seat 9: JANAÍNA13 folded before Flop (didn't bet)



PokerStars Hand #222148059159: Tournament #3086083919, $0.49+$0.06 USD Hold'em No Limit - Level VII (60/120) - 2021/01/02 22:11:38 EET [2021/01/02 15:11:38 ET]
Table '3086083919 46' 9-max Seat #4 is the button
Seat 1: csabipapa1 (4976 in chips) 
Seat 2: renanzin147 (2465 in chips) 
Seat 3: jcarlos.vale (4219 in chips) 
Seat 4: chekmpcc (14847 in chips) 
Seat 5: mariafirmina (5163 in chips) 
Seat 6: FloripaOG (4084 in chips) 
Seat 7: ddurikkt (7897 in chips) 
Seat 8: diogennn (4857 in chips) 
Seat 9: JANAÍNA13 (7719 in chips) 
csabipapa1: posts the ante 12
renanzin147: posts the ante 12
jcarlos.vale: posts the ante 12
chekmpcc: posts the ante 12
mariafirmina: posts the ante 12
FloripaOG: posts the ante 12
ddurikkt: posts the ante 12
diogennn: posts the ante 12
JANAÍNA13: posts the ante 12
mariafirmina: posts small blind 60
FloripaOG: posts big blind 120
*** HOLE CARDS ***
Dealt to jcarlos.vale [4d 6s]
ddurikkt: folds 
diogennn: calls 120
JANAÍNA13: calls 120
csabipapa1: folds 
renanzin147: folds 
jcarlos.vale: folds 
chekmpcc: folds 
mariafirmina: calls 60
FloripaOG: checks 
*** FLOP *** [7s 5s 2d]
mariafirmina: checks 
FloripaOG: checks 
diogennn: checks 
JANAÍNA13: bets 294
mariafirmina: folds 
FloripaOG: calls 294
diogennn: calls 294
*** TURN *** [7s 5s 2d] [As]
FloripaOG: bets 3658 and is all-in
diogennn: folds 
JANAÍNA13: folds 
Uncalled bet (3658) returned to FloripaOG
FloripaOG collected 1470 from pot
*** SUMMARY ***
Total pot 1470 | Rake 0 
Board [7s 5s 2d As]
Seat 1: csabipapa1 folded before Flop (didn't bet)
Seat 2: renanzin147 folded before Flop (didn't bet)
Seat 3: jcarlos.vale folded before Flop (didn't bet)
Seat 4: chekmpcc (button) folded before Flop (didn't bet)
Seat 5: mariafirmina (small blind) folded on the Flop
Seat 6: FloripaOG (big blind) collected (1470)
Seat 7: ddurikkt folded before Flop (didn't bet)
Seat 8: diogennn folded on the Turn
Seat 9: JANAÍNA13 folded on the Turn



PokerStars Hand #222148109968: Tournament #3086083919, $0.49+$0.06 USD Hold'em No Limit - Level VII (60/120) - 2021/01/02 22:12:30 EET [2021/01/02 15:12:30 ET]
Table '3086083919 46' 9-max Seat #5 is the button
Seat 1: csabipapa1 (4964 in chips) 
Seat 2: renanzin147 (2453 in chips) 
Seat 3: jcarlos.vale (4207 in chips) 
Seat 4: chekmpcc (14835 in chips) 
Seat 5: mariafirmina (5031 in chips) 
Seat 6: FloripaOG (5128 in chips) 
Seat 7: ddurikkt (7885 in chips) 
Seat 8: diogennn (4431 in chips) 
Seat 9: JANAÍNA13 (7293 in chips) 
csabipapa1: posts the ante 12
renanzin147: posts the ante 12
jcarlos.vale: posts the ante 12
chekmpcc: posts the ante 12
mariafirmina: posts the ante 12
FloripaOG: posts the ante 12
ddurikkt: posts the ante 12
diogennn: posts the ante 12
JANAÍNA13: posts the ante 12
FloripaOG: posts small blind 60
ddurikkt: posts big blind 120
*** HOLE CARDS ***
Dealt to jcarlos.vale [6d 8c]
diogennn: folds 
JANAÍNA13: folds 
csabipapa1: folds 
renanzin147: raises 120 to 240
jcarlos.vale: folds 
chekmpcc: raises 480 to 720
mariafirmina: folds 
FloripaOG: folds 
ddurikkt: folds 
renanzin147: folds 
Uncalled bet (480) returned to chekmpcc
chekmpcc collected 768 from pot
*** SUMMARY ***
Total pot 768 | Rake 0 
Seat 1: csabipapa1 folded before Flop (didn't bet)
Seat 2: renanzin147 folded before Flop
Seat 3: jcarlos.vale folded before Flop (didn't bet)
Seat 4: chekmpcc collected (768)
Seat 5: mariafirmina (button) folded before Flop (didn't bet)
Seat 6: FloripaOG (small blind) folded before Flop
Seat 7: ddurikkt (big blind) folded before Flop
Seat 8: diogennn folded before Flop (didn't bet)
Seat 9: JANAÍNA13 folded before Flop (didn't bet)



PokerStars Hand #222148136311: Tournament #3086083919, $0.49+$0.06 USD Hold'em No Limit - Level VII (60/120) - 2021/01/02 22:12:56 EET [2021/01/02 15:12:56 ET]
Table '3086083919 46' 9-max Seat #6 is the button
Seat 1: csabipapa1 (4952 in chips) 
Seat 2: renanzin147 (2201 in chips) 
Seat 3: jcarlos.vale (4195 in chips) 
Seat 4: chekmpcc (15351 in chips) 
Seat 5: mariafirmina (5019 in chips) 
Seat 6: FloripaOG (5056 in chips) 
Seat 7: ddurikkt (7753 in chips) 
Seat 8: diogennn (4419 in chips) 
Seat 9: JANAÍNA13 (7281 in chips) 
csabipapa1: posts the ante 12
renanzin147: posts the ante 12
jcarlos.vale: posts the ante 12
chekmpcc: posts the ante 12
mariafirmina: posts the ante 12
FloripaOG: posts the ante 12
ddurikkt: posts the ante 12
diogennn: posts the ante 12
JANAÍNA13: posts the ante 12
ddurikkt: posts small blind 60
diogennn: posts big blind 120
*** HOLE CARDS ***
Dealt to jcarlos.vale [8d 6h]
JANAÍNA13: calls 120
csabipapa1: folds 
renanzin147: folds 
jcarlos.vale: folds 
chekmpcc: folds 
mariafirmina: folds 
FloripaOG: folds 
ddurikkt: raises 300 to 420
diogennn: folds 
JANAÍNA13: calls 300
*** FLOP *** [4d 3s 4h]
ddurikkt: checks 
JANAÍNA13: checks 
*** TURN *** [4d 3s 4h] [As]
ddurikkt: checks 
JANAÍNA13: checks 
*** RIVER *** [4d 3s 4h As] [Ks]
ddurikkt: checks 
JANAÍNA13: checks 
*** SHOW DOWN ***
ddurikkt: shows [Qc Th] (a pair of Fours)
JANAÍNA13: shows [Js Jd] (two pair, Jacks and Fours)
JANAÍNA13 collected 1068 from pot
*** SUMMARY ***
Total pot 1068 | Rake 0 
Board [4d 3s 4h As Ks]
Seat 1: csabipapa1 folded before Flop (didn't bet)
Seat 2: renanzin147 folded before Flop (didn't bet)
Seat 3: jcarlos.vale folded before Flop (didn't bet)
Seat 4: chekmpcc folded before Flop (didn't bet)
Seat 5: mariafirmina folded before Flop (didn't bet)
Seat 6: FloripaOG (button) folded before Flop (didn't bet)
Seat 7: ddurikkt (small blind) showed [Qc Th] and lost with a pair of Fours
Seat 8: diogennn (big blind) folded before Flop
Seat 9: JANAÍNA13 showed [Js Jd] and won (1068) with two pair, Jacks and Fours



PokerStars Hand #222148176817: Tournament #3086083919, $0.49+$0.06 USD Hold'em No Limit - Level VII (60/120) - 2021/01/02 22:13:37 EET [2021/01/02 15:13:37 ET]
Table '3086083919 46' 9-max Seat #7 is the button
Seat 1: csabipapa1 (4940 in chips) 
Seat 2: renanzin147 (2189 in chips) 
Seat 3: jcarlos.vale (4183 in chips) 
Seat 4: chekmpcc (15339 in chips) 
Seat 5: mariafirmina (5007 in chips) 
Seat 6: FloripaOG (5044 in chips) 
Seat 7: ddurikkt (7321 in chips) 
Seat 8: diogennn (4287 in chips) 
Seat 9: JANAÍNA13 (7917 in chips) 
csabipapa1: posts the ante 12
renanzin147: posts the ante 12
jcarlos.vale: posts the ante 12
chekmpcc: posts the ante 12
mariafirmina: posts the ante 12
FloripaOG: posts the ante 12
ddurikkt: posts the ante 12
diogennn: posts the ante 12
JANAÍNA13: posts the ante 12
diogennn: posts small blind 60
JANAÍNA13: posts big blind 120
*** HOLE CARDS ***
Dealt to jcarlos.vale [8s 7c]
csabipapa1: raises 240 to 360
renanzin147: folds 
jcarlos.vale: folds 
chekmpcc: folds 
mariafirmina: folds 
FloripaOG: folds 
ddurikkt: folds 
diogennn: folds 
JANAÍNA13: folds 
Uncalled bet (240) returned to csabipapa1
csabipapa1 collected 408 from pot
csabipapa1: doesn't show handDTO
*** SUMMARY ***
Total pot 408 | Rake 0 
Seat 1: csabipapa1 collected (408)
Seat 2: renanzin147 folded before Flop (didn't bet)
Seat 3: jcarlos.vale folded before Flop (didn't bet)
Seat 4: chekmpcc folded before Flop (didn't bet)
Seat 5: mariafirmina folded before Flop (didn't bet)
Seat 6: FloripaOG folded before Flop (didn't bet)
Seat 7: ddurikkt (button) folded before Flop (didn't bet)
Seat 8: diogennn (small blind) folded before Flop
Seat 9: JANAÍNA13 (big blind) folded before Flop



PokerStars Hand #222148209292: Tournament #3086083919, $0.49+$0.06 USD Hold'em No Limit - Level VII (60/120) - 2021/01/02 22:14:10 EET [2021/01/02 15:14:10 ET]
Table '3086083919 46' 9-max Seat #8 is the button
Seat 1: csabipapa1 (5216 in chips) 
Seat 2: renanzin147 (2177 in chips) 
Seat 3: jcarlos.vale (4171 in chips) 
Seat 4: chekmpcc (15327 in chips) 
Seat 5: mariafirmina (4995 in chips) 
Seat 6: FloripaOG (5032 in chips) 
Seat 7: ddurikkt (7309 in chips) 
Seat 8: diogennn (4215 in chips) 
Seat 9: JANAÍNA13 (7785 in chips) 
csabipapa1: posts the ante 12
renanzin147: posts the ante 12
jcarlos.vale: posts the ante 12
chekmpcc: posts the ante 12
mariafirmina: posts the ante 12
FloripaOG: posts the ante 12
ddurikkt: posts the ante 12
diogennn: posts the ante 12
JANAÍNA13: posts the ante 12
JANAÍNA13: posts small blind 60
csabipapa1: posts big blind 120
*** HOLE CARDS ***
Dealt to jcarlos.vale [4c 7d]
renanzin147: folds 
jcarlos.vale: folds 
chekmpcc: folds 
mariafirmina: folds 
FloripaOG: folds 
ddurikkt: raises 132 to 252
diogennn: folds 
JANAÍNA13: folds 
csabipapa1: folds 
Uncalled bet (132) returned to ddurikkt
ddurikkt collected 408 from pot
*** SUMMARY ***
Total pot 408 | Rake 0 
Seat 1: csabipapa1 (big blind) folded before Flop
Seat 2: renanzin147 folded before Flop (didn't bet)
Seat 3: jcarlos.vale folded before Flop (didn't bet)
Seat 4: chekmpcc folded before Flop (didn't bet)
Seat 5: mariafirmina folded before Flop (didn't bet)
Seat 6: FloripaOG folded before Flop (didn't bet)
Seat 7: ddurikkt collected (408)
Seat 8: diogennn (button) folded before Flop (didn't bet)
Seat 9: JANAÍNA13 (small blind) folded before Flop



PokerStars Hand #222148225976: Tournament #3086083919, $0.49+$0.06 USD Hold'em No Limit - Level VII (60/120) - 2021/01/02 22:14:27 EET [2021/01/02 15:14:27 ET]
Table '3086083919 46' 9-max Seat #9 is the button
Seat 1: csabipapa1 (5084 in chips) 
Seat 2: renanzin147 (2165 in chips) 
Seat 3: jcarlos.vale (4159 in chips) 
Seat 4: chekmpcc (15315 in chips) 
Seat 5: mariafirmina (4983 in chips) 
Seat 6: FloripaOG (5020 in chips) 
Seat 7: ddurikkt (7585 in chips) 
Seat 8: diogennn (4203 in chips) 
Seat 9: JANAÍNA13 (7713 in chips) 
csabipapa1: posts the ante 12
renanzin147: posts the ante 12
jcarlos.vale: posts the ante 12
chekmpcc: posts the ante 12
mariafirmina: posts the ante 12
FloripaOG: posts the ante 12
ddurikkt: posts the ante 12
diogennn: posts the ante 12
JANAÍNA13: posts the ante 12
csabipapa1: posts small blind 60
renanzin147: posts big blind 120
*** HOLE CARDS ***
Dealt to jcarlos.vale [Jh 7h]
jcarlos.vale: folds 
chekmpcc: folds 
mariafirmina: folds 
FloripaOG: calls 120
ddurikkt: folds 
diogennn: folds 
JANAÍNA13: folds 
csabipapa1: calls 60
renanzin147: raises 2033 to 2153 and is all-in
FloripaOG: folds 
csabipapa1: folds 
Uncalled bet (2033) returned to renanzin147
renanzin147 collected 468 from pot
*** SUMMARY ***
Total pot 468 | Rake 0 
Seat 1: csabipapa1 (small blind) folded before Flop
Seat 2: renanzin147 (big blind) collected (468)
Seat 3: jcarlos.vale folded before Flop (didn't bet)
Seat 4: chekmpcc folded before Flop (didn't bet)
Seat 5: mariafirmina folded before Flop (didn't bet)
Seat 6: FloripaOG folded before Flop
Seat 7: ddurikkt folded before Flop (didn't bet)
Seat 8: diogennn folded before Flop (didn't bet)
Seat 9: JANAÍNA13 (button) folded before Flop (didn't bet)



PokerStars Hand #222148266047: Tournament #3086083919, $0.49+$0.06 USD Hold'em No Limit - Level VII (60/120) - 2021/01/02 22:15:07 EET [2021/01/02 15:15:07 ET]
Table '3086083919 46' 9-max Seat #1 is the button
Seat 1: csabipapa1 (4952 in chips) 
Seat 2: renanzin147 (2501 in chips) 
Seat 3: jcarlos.vale (4147 in chips) 
Seat 4: chekmpcc (15303 in chips) 
Seat 5: mariafirmina (4971 in chips) 
Seat 6: FloripaOG (4888 in chips) 
Seat 7: ddurikkt (7573 in chips) 
Seat 8: diogennn (4191 in chips) 
Seat 9: JANAÍNA13 (7701 in chips) 
csabipapa1: posts the ante 12
renanzin147: posts the ante 12
jcarlos.vale: posts the ante 12
chekmpcc: posts the ante 12
mariafirmina: posts the ante 12
FloripaOG: posts the ante 12
ddurikkt: posts the ante 12
diogennn: posts the ante 12
JANAÍNA13: posts the ante 12
renanzin147: posts small blind 60
jcarlos.vale: posts big blind 120
*** HOLE CARDS ***
Dealt to jcarlos.vale [8h 7c]
chekmpcc: raises 204 to 324
mariafirmina: calls 324
FloripaOG: calls 324
ddurikkt: calls 324
diogennn: calls 324
JANAÍNA13: calls 324
csabipapa1: folds 
renanzin147: folds 
jcarlos.vale: folds 
*** FLOP *** [3c Kd 5h]
chekmpcc: checks 
mariafirmina: checks 
FloripaOG: checks 
ddurikkt: checks 
diogennn: checks 
JANAÍNA13: checks 
*** TURN *** [3c Kd 5h] [7s]
chekmpcc: checks 
mariafirmina: bets 1116
FloripaOG: folds 
ddurikkt: folds 
diogennn: folds 
JANAÍNA13: folds 
chekmpcc: folds 
Uncalled bet (1116) returned to mariafirmina
mariafirmina collected 2232 from pot
*** SUMMARY ***
Total pot 2232 | Rake 0 
Board [3c Kd 5h 7s]
Seat 1: csabipapa1 (button) folded before Flop (didn't bet)
Seat 2: renanzin147 (small blind) folded before Flop
Seat 3: jcarlos.vale (big blind) folded before Flop
Seat 4: chekmpcc folded on the Turn
Seat 5: mariafirmina collected (2232)
Seat 6: FloripaOG folded on the Turn
Seat 7: ddurikkt folded on the Turn
Seat 8: diogennn folded on the Turn
Seat 9: JANAÍNA13 folded on the Turn



PokerStars Hand #222148324644: Tournament #3086083919, $0.49+$0.06 USD Hold'em No Limit - Level VII (60/120) - 2021/01/02 22:16:05 EET [2021/01/02 15:16:05 ET]
Table '3086083919 46' 9-max Seat #2 is the button
Seat 1: csabipapa1 (4940 in chips) 
Seat 2: renanzin147 (2429 in chips) 
Seat 3: jcarlos.vale (4015 in chips) 
Seat 4: chekmpcc (14967 in chips) 
Seat 5: mariafirmina (6867 in chips) 
Seat 6: FloripaOG (4552 in chips) 
Seat 7: ddurikkt (7237 in chips) 
Seat 8: diogennn (3855 in chips) 
Seat 9: JANAÍNA13 (7365 in chips) 
csabipapa1: posts the ante 12
renanzin147: posts the ante 12
jcarlos.vale: posts the ante 12
chekmpcc: posts the ante 12
mariafirmina: posts the ante 12
FloripaOG: posts the ante 12
ddurikkt: posts the ante 12
diogennn: posts the ante 12
JANAÍNA13: posts the ante 12
jcarlos.vale: posts small blind 60
chekmpcc: posts big blind 120
*** HOLE CARDS ***
Dealt to jcarlos.vale [3h 6h]
mariafirmina: folds 
FloripaOG: folds 
ddurikkt: folds 
diogennn: folds 
JANAÍNA13: folds 
csabipapa1: raises 120 to 240
renanzin147: raises 2177 to 2417 and is all-in
jcarlos.vale: folds 
chekmpcc: folds 
csabipapa1: calls 2177
*** FLOP *** [Kd As 5h]
*** TURN *** [Kd As 5h] [8d]
*** RIVER *** [Kd As 5h 8d] [2s]
*** SHOW DOWN ***
csabipapa1: shows [5d Ad] (two pair, Aces and Fives)
renanzin147: shows [Qc Kh] (a pair of Kings)
csabipapa1 collected 5122 from pot
renanzin147 finished the tournament
*** SUMMARY ***
Total pot 5122 | Rake 0 
Board [Kd As 5h 8d 2s]
Seat 1: csabipapa1 showed [5d Ad] and won (5122) with two pair, Aces and Fives
Seat 2: renanzin147 (button) showed [Qc Kh] and lost with a pair of Kings
Seat 3: jcarlos.vale (small blind) folded before Flop
Seat 4: chekmpcc (big blind) folded before Flop
Seat 5: mariafirmina folded before Flop (didn't bet)
Seat 6: FloripaOG folded before Flop (didn't bet)
Seat 7: ddurikkt folded before Flop (didn't bet)
Seat 8: diogennn folded before Flop (didn't bet)
Seat 9: JANAÍNA13 folded before Flop (didn't bet)



PokerStars Hand #222148376292: Tournament #3086083919, $0.49+$0.06 USD Hold'em No Limit - Level VII (60/120) - 2021/01/02 22:16:57 EET [2021/01/02 15:16:57 ET]
Table '3086083919 46' 9-max Seat #3 is the button
Seat 1: csabipapa1 (7633 in chips) 
Seat 3: jcarlos.vale (3943 in chips) 
Seat 4: chekmpcc (14835 in chips) 
Seat 5: mariafirmina (6855 in chips) 
Seat 6: FloripaOG (4540 in chips) 
Seat 7: ddurikkt (7225 in chips) 
Seat 8: diogennn (3843 in chips) 
Seat 9: JANAÍNA13 (7353 in chips) 
csabipapa1: posts the ante 12
jcarlos.vale: posts the ante 12
chekmpcc: posts the ante 12
mariafirmina: posts the ante 12
FloripaOG: posts the ante 12
ddurikkt: posts the ante 12
diogennn: posts the ante 12
JANAÍNA13: posts the ante 12
chekmpcc: posts small blind 60
mariafirmina: posts big blind 120
*** HOLE CARDS ***
Dealt to jcarlos.vale [4h 7c]
FloripaOG: folds 
ddurikkt: raises 132 to 252
diogennn: raises 3579 to 3831 and is all-in
JANAÍNA13: folds 
csabipapa1: folds 
jcarlos.vale: folds 
chekmpcc: folds 
mariafirmina: folds 
ddurikkt: folds 
Uncalled bet (3579) returned to diogennn
diogennn collected 780 from pot
diogennn: doesn't show handDTO
*** SUMMARY ***
Total pot 780 | Rake 0 
Seat 1: csabipapa1 folded before Flop (didn't bet)
Seat 3: jcarlos.vale (button) folded before Flop (didn't bet)
Seat 4: chekmpcc (small blind) folded before Flop
Seat 5: mariafirmina (big blind) folded before Flop
Seat 6: FloripaOG folded before Flop (didn't bet)
Seat 7: ddurikkt folded before Flop
Seat 8: diogennn collected (780)
Seat 9: JANAÍNA13 folded before Flop (didn't bet)



PokerStars Hand #222148395130: Tournament #3086083919, $0.49+$0.06 USD Hold'em No Limit - Level VII (60/120) - 2021/01/02 22:17:16 EET [2021/01/02 15:17:16 ET]
Table '3086083919 46' 9-max Seat #4 is the button
Seat 1: csabipapa1 (7621 in chips) 
Seat 2: DEVIL8199 (5000 in chips) 
Seat 3: jcarlos.vale (3931 in chips) 
Seat 4: chekmpcc (14763 in chips) 
Seat 5: mariafirmina (6723 in chips) 
Seat 7: ddurikkt (6961 in chips) 
Seat 8: diogennn (4359 in chips) 
Seat 9: JANAÍNA13 (7341 in chips) 
csabipapa1: posts the ante 12
DEVIL8199: posts the ante 12
jcarlos.vale: posts the ante 12
chekmpcc: posts the ante 12
mariafirmina: posts the ante 12
ddurikkt: posts the ante 12
diogennn: posts the ante 12
JANAÍNA13: posts the ante 12
mariafirmina: posts small blind 60
ddurikkt: posts big blind 120
*** HOLE CARDS ***
Dealt to jcarlos.vale [6c Kd]
diogennn: folds 
JANAÍNA13: folds 
csabipapa1: folds 
DEVIL8199: folds 
jcarlos.vale: folds 
chekmpcc: raises 204 to 324
mariafirmina: folds 
ddurikkt: folds 
Uncalled bet (204) returned to chekmpcc
chekmpcc collected 396 from pot
*** SUMMARY ***
Total pot 396 | Rake 0 
Seat 1: csabipapa1 folded before Flop (didn't bet)
Seat 2: DEVIL8199 folded before Flop (didn't bet)
Seat 3: jcarlos.vale folded before Flop (didn't bet)
Seat 4: chekmpcc (button) collected (396)
Seat 5: mariafirmina (small blind) folded before Flop
Seat 7: ddurikkt (big blind) folded before Flop
Seat 8: diogennn folded before Flop (didn't bet)
Seat 9: JANAÍNA13 folded before Flop (didn't bet)



PokerStars Hand #222148427032: Tournament #3086083919, $0.49+$0.06 USD Hold'em No Limit - Level VIII (75/150) - 2021/01/02 22:17:48 EET [2021/01/02 15:17:48 ET]
Table '3086083919 46' 9-max Seat #5 is the button
Seat 1: csabipapa1 (7609 in chips) 
Seat 2: DEVIL8199 (4988 in chips) 
Seat 3: jcarlos.vale (3919 in chips) 
Seat 4: chekmpcc (15027 in chips) 
Seat 5: mariafirmina (6651 in chips) 
Seat 6: revolverpicn (5000 in chips) out of handDTO (moved from another table into small blind)
Seat 7: ddurikkt (6829 in chips) 
Seat 8: diogennn (4347 in chips) 
Seat 9: JANAÍNA13 (7329 in chips) 
revolverpicn will be allowed to play after the button
csabipapa1: posts the ante 15
DEVIL8199: posts the ante 15
jcarlos.vale: posts the ante 15
chekmpcc: posts the ante 15
mariafirmina: posts the ante 15
ddurikkt: posts the ante 15
diogennn: posts the ante 15
JANAÍNA13: posts the ante 15
ddurikkt: posts small blind 75
diogennn: posts big blind 150
*** HOLE CARDS ***
Dealt to jcarlos.vale [8h 5h]
JANAÍNA13: folds 
csabipapa1: folds 
DEVIL8199: raises 4823 to 4973 and is all-in
jcarlos.vale: folds 
chekmpcc: folds 
mariafirmina: raises 1663 to 6636 and is all-in
ddurikkt: folds 
diogennn: folds 
Uncalled bet (1663) returned to mariafirmina
*** FLOP *** [Jh 5s 6s]
*** TURN *** [Jh 5s 6s] [2c]
*** RIVER *** [Jh 5s 6s 2c] [Td]
*** SHOW DOWN ***
DEVIL8199: shows [8c 9c] (high pairOfCards Jack)
mariafirmina: shows [Kc Kh] (a pair of Kings)
mariafirmina collected 10291 from pot
DEVIL8199 finished the tournament
*** SUMMARY ***
Total pot 10291 | Rake 0 
Board [Jh 5s 6s 2c Td]
Seat 1: csabipapa1 folded before Flop (didn't bet)
Seat 2: DEVIL8199 showed [8c 9c] and lost with high pairOfCards Jack
Seat 3: jcarlos.vale folded before Flop (didn't bet)
Seat 4: chekmpcc folded before Flop (didn't bet)
Seat 5: mariafirmina (button) showed [Kc Kh] and won (10291) with a pair of Kings
Seat 7: ddurikkt (small blind) folded before Flop
Seat 8: diogennn (big blind) folded before Flop
Seat 9: JANAÍNA13 folded before Flop (didn't bet)



PokerStars Hand #222148452028: Tournament #3086083919, $0.49+$0.06 USD Hold'em No Limit - Level VIII (75/150) - 2021/01/02 22:18:13 EET [2021/01/02 15:18:13 ET]
Table '3086083919 46' 9-max Seat #7 is the button
Seat 1: csabipapa1 (7594 in chips) 
Seat 3: jcarlos.vale (3904 in chips) 
Seat 4: chekmpcc (15012 in chips) 
Seat 5: mariafirmina (11954 in chips) 
Seat 6: revolverpicn (5000 in chips) 
Seat 7: ddurikkt (6739 in chips) 
Seat 8: diogennn (4182 in chips) 
Seat 9: JANAÍNA13 (7314 in chips) 
csabipapa1: posts the ante 15
jcarlos.vale: posts the ante 15
chekmpcc: posts the ante 15
mariafirmina: posts the ante 15
revolverpicn: posts the ante 15
ddurikkt: posts the ante 15
diogennn: posts the ante 15
JANAÍNA13: posts the ante 15
diogennn: posts small blind 75
JANAÍNA13: posts big blind 150
*** HOLE CARDS ***
Dealt to jcarlos.vale [Qd 4c]
csabipapa1: folds 
jcarlos.vale: folds 
chekmpcc: raises 255 to 405
mariafirmina: folds 
revolverpicn: folds 
ddurikkt: folds 
diogennn: folds 
JANAÍNA13: folds 
Uncalled bet (255) returned to chekmpcc
chekmpcc collected 495 from pot
*** SUMMARY ***
Total pot 495 | Rake 0 
Seat 1: csabipapa1 folded before Flop (didn't bet)
Seat 3: jcarlos.vale folded before Flop (didn't bet)
Seat 4: chekmpcc collected (495)
Seat 5: mariafirmina folded before Flop (didn't bet)
Seat 6: revolverpicn folded before Flop (didn't bet)
Seat 7: ddurikkt (button) folded before Flop (didn't bet)
Seat 8: diogennn (small blind) folded before Flop
Seat 9: JANAÍNA13 (big blind) folded before Flop



PokerStars Hand #222148483840: Tournament #3086083919, $0.49+$0.06 USD Hold'em No Limit - Level VIII (75/150) - 2021/01/02 22:18:45 EET [2021/01/02 15:18:45 ET]
Table '3086083919 46' 9-max Seat #8 is the button
Seat 1: csabipapa1 (7579 in chips) 
Seat 2: 1993544 (5000 in chips) 
Seat 3: jcarlos.vale (3889 in chips) 
Seat 4: chekmpcc (15342 in chips) 
Seat 5: mariafirmina (11939 in chips) 
Seat 6: revolverpicn (4985 in chips) 
Seat 7: ddurikkt (6724 in chips) 
Seat 8: diogennn (4092 in chips) 
Seat 9: JANAÍNA13 (7149 in chips) 
csabipapa1: posts the ante 15
1993544: posts the ante 15
jcarlos.vale: posts the ante 15
chekmpcc: posts the ante 15
mariafirmina: posts the ante 15
revolverpicn: posts the ante 15
ddurikkt: posts the ante 15
diogennn: posts the ante 15
JANAÍNA13: posts the ante 15
JANAÍNA13: posts small blind 75
csabipapa1: posts big blind 150
*** HOLE CARDS ***
Dealt to jcarlos.vale [6c 5h]
1993544: folds 
jcarlos.vale: folds 
chekmpcc: folds 
mariafirmina: folds 
revolverpicn: folds 
ddurikkt: raises 165 to 315
diogennn: raises 3762 to 4077 and is all-in
JANAÍNA13: folds 
csabipapa1: folds 
ddurikkt: calls 3762
*** FLOP *** [Kh Jd Qd]
*** TURN *** [Kh Jd Qd] [Kc]
*** RIVER *** [Kh Jd Qd Kc] [4c]
*** SHOW DOWN ***
ddurikkt: shows [Kd Qs] (a full house, Kings full of Queens)
diogennn: shows [7s 7d] (two pair, Kings and Sevens)
ddurikkt collected 8514 from pot
diogennn finished the tournament
*** SUMMARY ***
Total pot 8514 | Rake 0 
Board [Kh Jd Qd Kc 4c]
Seat 1: csabipapa1 (big blind) folded before Flop
Seat 2: 1993544 folded before Flop (didn't bet)
Seat 3: jcarlos.vale folded before Flop (didn't bet)
Seat 4: chekmpcc folded before Flop (didn't bet)
Seat 5: mariafirmina folded before Flop (didn't bet)
Seat 6: revolverpicn folded before Flop (didn't bet)
Seat 7: ddurikkt showed [Kd Qs] and won (8514) with a full house, Kings full of Queens
Seat 8: diogennn (button) showed [7s 7d] and lost with two pair, Kings and Sevens
Seat 9: JANAÍNA13 (small blind) folded before Flop



PokerStars Hand #222148519694: Tournament #3086083919, $0.49+$0.06 USD Hold'em No Limit - Level VIII (75/150) - 2021/01/02 22:19:21 EET [2021/01/02 15:19:21 ET]
Table '3086083919 46' 9-max Seat #9 is the button
Seat 1: csabipapa1 (7414 in chips) 
Seat 2: 1993544 (4985 in chips) 
Seat 3: jcarlos.vale (3874 in chips) 
Seat 4: chekmpcc (15327 in chips) 
Seat 5: mariafirmina (11924 in chips) 
Seat 6: revolverpicn (4970 in chips) 
Seat 7: ddurikkt (11146 in chips) 
Seat 9: JANAÍNA13 (7059 in chips) 
csabipapa1: posts the ante 15
1993544: posts the ante 15
jcarlos.vale: posts the ante 15
chekmpcc: posts the ante 15
mariafirmina: posts the ante 15
revolverpicn: posts the ante 15
ddurikkt: posts the ante 15
JANAÍNA13: posts the ante 15
csabipapa1: posts small blind 75
1993544: posts big blind 150
*** HOLE CARDS ***
Dealt to jcarlos.vale [8s 5h]
jcarlos.vale: folds 
chekmpcc: folds 
mariafirmina: folds 
revolverpicn: folds 
ddurikkt: folds 
JANAÍNA13: folds 
csabipapa1: calls 75
1993544: checks 
*** FLOP *** [Qh 6c 5c]
csabipapa1: checks 
1993544: bets 210
csabipapa1: folds 
Uncalled bet (210) returned to 1993544
1993544 collected 420 from pot
1993544: doesn't show handDTO
*** SUMMARY ***
Total pot 420 | Rake 0 
Board [Qh 6c 5c]
Seat 1: csabipapa1 (small blind) folded on the Flop
Seat 2: 1993544 (big blind) collected (420)
Seat 3: jcarlos.vale folded before Flop (didn't bet)
Seat 4: chekmpcc folded before Flop (didn't bet)
Seat 5: mariafirmina folded before Flop (didn't bet)
Seat 6: revolverpicn folded before Flop (didn't bet)
Seat 7: ddurikkt folded before Flop (didn't bet)
Seat 9: JANAÍNA13 (button) folded before Flop (didn't bet)



PokerStars Hand #222148545221: Tournament #3086083919, $0.49+$0.06 USD Hold'em No Limit - Level VIII (75/150) - 2021/01/02 22:19:47 EET [2021/01/02 15:19:47 ET]
Table '3086083919 46' 9-max Seat #1 is the button
Seat 1: csabipapa1 (7249 in chips) 
Seat 2: 1993544 (5240 in chips) 
Seat 3: jcarlos.vale (3859 in chips) 
Seat 4: chekmpcc (15312 in chips) 
Seat 5: mariafirmina (11909 in chips) 
Seat 6: revolverpicn (4955 in chips) 
Seat 7: ddurikkt (11131 in chips) 
Seat 8: Elbobby2021 (5000 in chips) 
Seat 9: JANAÍNA13 (7044 in chips) 
csabipapa1: posts the ante 15
1993544: posts the ante 15
jcarlos.vale: posts the ante 15
chekmpcc: posts the ante 15
mariafirmina: posts the ante 15
revolverpicn: posts the ante 15
ddurikkt: posts the ante 15
Elbobby2021: posts the ante 15
JANAÍNA13: posts the ante 15
1993544: posts small blind 75
jcarlos.vale: posts big blind 150
*** HOLE CARDS ***
Dealt to jcarlos.vale [Qs 4s]
chekmpcc: folds 
mariafirmina: raises 150 to 300
revolverpicn: folds 
ddurikkt: raises 750 to 1050
Elbobby2021: folds 
JANAÍNA13: folds 
csabipapa1: folds 
1993544: folds 
jcarlos.vale: folds 
mariafirmina: calls 750
*** FLOP *** [4d Kc 2s]
mariafirmina: checks 
ddurikkt: bets 900
mariafirmina: folds 
Uncalled bet (900) returned to ddurikkt
ddurikkt collected 2460 from pot
*** SUMMARY ***
Total pot 2460 | Rake 0 
Board [4d Kc 2s]
Seat 1: csabipapa1 (button) folded before Flop (didn't bet)
Seat 2: 1993544 (small blind) folded before Flop
Seat 3: jcarlos.vale (big blind) folded before Flop
Seat 4: chekmpcc folded before Flop (didn't bet)
Seat 5: mariafirmina folded on the Flop
Seat 6: revolverpicn folded before Flop (didn't bet)
Seat 7: ddurikkt collected (2460)
Seat 8: Elbobby2021 folded before Flop (didn't bet)
Seat 9: JANAÍNA13 folded before Flop (didn't bet)



PokerStars Hand #222148635925: Tournament #3086083919, $0.49+$0.06 USD Hold'em No Limit - Level VIII (75/150) - 2021/01/02 22:21:17 EET [2021/01/02 15:21:17 ET]
Table '3086083919 46' 9-max Seat #2 is the button
Seat 1: csabipapa1 (7234 in chips) 
Seat 2: 1993544 (5150 in chips) 
Seat 3: jcarlos.vale (3694 in chips) 
Seat 4: chekmpcc (15297 in chips) 
Seat 5: mariafirmina (10844 in chips) 
Seat 6: revolverpicn (4940 in chips) 
Seat 7: ddurikkt (12526 in chips) 
Seat 8: Elbobby2021 (4985 in chips) 
Seat 9: JANAÍNA13 (7029 in chips) 
csabipapa1: posts the ante 15
1993544: posts the ante 15
jcarlos.vale: posts the ante 15
chekmpcc: posts the ante 15
mariafirmina: posts the ante 15
revolverpicn: posts the ante 15
ddurikkt: posts the ante 15
Elbobby2021: posts the ante 15
JANAÍNA13: posts the ante 15
jcarlos.vale: posts small blind 75
chekmpcc: posts big blind 150
*** HOLE CARDS ***
Dealt to jcarlos.vale [6s 4h]
mariafirmina: folds 
revolverpicn: folds 
ddurikkt: folds 
Elbobby2021: folds 
JANAÍNA13: folds 
csabipapa1: folds 
1993544: raises 300 to 450
jcarlos.vale: folds 
chekmpcc: folds 
Uncalled bet (300) returned to 1993544
1993544 collected 510 from pot
1993544: doesn't show handDTO
*** SUMMARY ***
Total pot 510 | Rake 0 
Seat 1: csabipapa1 folded before Flop (didn't bet)
Seat 2: 1993544 (button) collected (510)
Seat 3: jcarlos.vale (small blind) folded before Flop
Seat 4: chekmpcc (big blind) folded before Flop
Seat 5: mariafirmina folded before Flop (didn't bet)
Seat 6: revolverpicn folded before Flop (didn't bet)
Seat 7: ddurikkt folded before Flop (didn't bet)
Seat 8: Elbobby2021 folded before Flop (didn't bet)
Seat 9: JANAÍNA13 folded before Flop (didn't bet)



PokerStars Hand #222148664618: Tournament #3086083919, $0.49+$0.06 USD Hold'em No Limit - Level VIII (75/150) - 2021/01/02 22:21:46 EET [2021/01/02 15:21:46 ET]
Table '3086083919 46' 9-max Seat #3 is the button
Seat 1: csabipapa1 (7219 in chips) 
Seat 2: 1993544 (5495 in chips) 
Seat 3: jcarlos.vale (3604 in chips) 
Seat 4: chekmpcc (15132 in chips) 
Seat 5: mariafirmina (10829 in chips) 
Seat 6: revolverpicn (4925 in chips) 
Seat 7: ddurikkt (12511 in chips) 
Seat 8: Elbobby2021 (4970 in chips) 
Seat 9: JANAÍNA13 (7014 in chips) 
csabipapa1: posts the ante 15
1993544: posts the ante 15
jcarlos.vale: posts the ante 15
chekmpcc: posts the ante 15
mariafirmina: posts the ante 15
revolverpicn: posts the ante 15
ddurikkt: posts the ante 15
Elbobby2021: posts the ante 15
JANAÍNA13: posts the ante 15
chekmpcc: posts small blind 75
mariafirmina: posts big blind 150
*** HOLE CARDS ***
Dealt to jcarlos.vale [Qh Ks]
revolverpicn: folds 
ddurikkt: folds 
Elbobby2021: folds 
JANAÍNA13: folds 
csabipapa1: raises 300 to 450
1993544: folds 
jcarlos.vale: folds 
chekmpcc: folds 
mariafirmina: folds 
Uncalled bet (300) returned to csabipapa1
csabipapa1 collected 510 from pot
csabipapa1: doesn't show handDTO
*** SUMMARY ***
Total pot 510 | Rake 0 
Seat 1: csabipapa1 collected (510)
Seat 2: 1993544 folded before Flop (didn't bet)
Seat 3: jcarlos.vale (button) folded before Flop (didn't bet)
Seat 4: chekmpcc (small blind) folded before Flop
Seat 5: mariafirmina (big blind) folded before Flop
Seat 6: revolverpicn folded before Flop (didn't bet)
Seat 7: ddurikkt folded before Flop (didn't bet)
Seat 8: Elbobby2021 folded before Flop (didn't bet)
Seat 9: JANAÍNA13 folded before Flop (didn't bet)



PokerStars Hand #222148698130: Tournament #3086083919, $0.49+$0.06 USD Hold'em No Limit - Level VIII (75/150) - 2021/01/02 22:22:20 EET [2021/01/02 15:22:20 ET]
Table '3086083919 46' 9-max Seat #4 is the button
Seat 1: csabipapa1 (7564 in chips) 
Seat 2: 1993544 (5480 in chips) 
Seat 3: jcarlos.vale (3589 in chips) 
Seat 4: chekmpcc (15042 in chips) 
Seat 5: mariafirmina (10664 in chips) 
Seat 6: revolverpicn (4910 in chips) 
Seat 7: ddurikkt (12496 in chips) 
Seat 8: Elbobby2021 (4955 in chips) 
Seat 9: JANAÍNA13 (6999 in chips) 
csabipapa1: posts the ante 15
1993544: posts the ante 15
jcarlos.vale: posts the ante 15
chekmpcc: posts the ante 15
mariafirmina: posts the ante 15
revolverpicn: posts the ante 15
ddurikkt: posts the ante 15
Elbobby2021: posts the ante 15
JANAÍNA13: posts the ante 15
mariafirmina: posts small blind 75
revolverpicn: posts big blind 150
*** HOLE CARDS ***
Dealt to jcarlos.vale [4h 5h]
ddurikkt: folds 
Elbobby2021: folds 
JANAÍNA13: calls 150
csabipapa1: calls 150
1993544: folds 
jcarlos.vale: folds 
chekmpcc: raises 600 to 750
mariafirmina: folds 
revolverpicn: calls 600
JANAÍNA13: folds 
csabipapa1: folds 
*** FLOP *** [5d Js 8c]
revolverpicn: checks 
chekmpcc: checks 
*** TURN *** [5d Js 8c] [Kd]
revolverpicn: checks 
chekmpcc: bets 1387
revolverpicn: folds 
Uncalled bet (1387) returned to chekmpcc
chekmpcc collected 2010 from pot
*** SUMMARY ***
Total pot 2010 | Rake 0 
Board [5d Js 8c Kd]
Seat 1: csabipapa1 folded before Flop
Seat 2: 1993544 folded before Flop (didn't bet)
Seat 3: jcarlos.vale folded before Flop (didn't bet)
Seat 4: chekmpcc (button) collected (2010)
Seat 5: mariafirmina (small blind) folded before Flop
Seat 6: revolverpicn (big blind) folded on the Turn
Seat 7: ddurikkt folded before Flop (didn't bet)
Seat 8: Elbobby2021 folded before Flop (didn't bet)
Seat 9: JANAÍNA13 folded before Flop



PokerStars Hand #222148761525: Tournament #3086083919, $0.49+$0.06 USD Hold'em No Limit - Level VIII (75/150) - 2021/01/02 22:23:22 EET [2021/01/02 15:23:22 ET]
Table '3086083919 46' 9-max Seat #5 is the button
Seat 1: csabipapa1 (7399 in chips) 
Seat 2: 1993544 (5465 in chips) 
Seat 3: jcarlos.vale (3574 in chips) 
Seat 4: chekmpcc (16287 in chips) 
Seat 5: mariafirmina (10574 in chips) 
Seat 6: revolverpicn (4145 in chips) 
Seat 7: ddurikkt (12481 in chips) 
Seat 8: Elbobby2021 (4940 in chips) 
Seat 9: JANAÍNA13 (6834 in chips) 
csabipapa1: posts the ante 15
1993544: posts the ante 15
jcarlos.vale: posts the ante 15
chekmpcc: posts the ante 15
mariafirmina: posts the ante 15
revolverpicn: posts the ante 15
ddurikkt: posts the ante 15
Elbobby2021: posts the ante 15
JANAÍNA13: posts the ante 15
revolverpicn: posts small blind 75
ddurikkt: posts big blind 150
*** HOLE CARDS ***
Dealt to jcarlos.vale [5c Th]
Elbobby2021: raises 150 to 300
JANAÍNA13: folds 
csabipapa1: folds 
1993544: raises 5150 to 5450 and is all-in
jcarlos.vale: folds 
chekmpcc: folds 
mariafirmina: folds 
revolverpicn: folds 
ddurikkt: folds 
Elbobby2021: folds 
Uncalled bet (5150) returned to 1993544
1993544 collected 960 from pot
1993544: doesn't show handDTO
*** SUMMARY ***
Total pot 960 | Rake 0 
Seat 1: csabipapa1 folded before Flop (didn't bet)
Seat 2: 1993544 collected (960)
Seat 3: jcarlos.vale folded before Flop (didn't bet)
Seat 4: chekmpcc folded before Flop (didn't bet)
Seat 5: mariafirmina (button) folded before Flop (didn't bet)
Seat 6: revolverpicn (small blind) folded before Flop
Seat 7: ddurikkt (big blind) folded before Flop
Seat 8: Elbobby2021 folded before Flop
Seat 9: JANAÍNA13 folded before Flop (didn't bet)



PokerStars Hand #222148801091: Tournament #3086083919, $0.49+$0.06 USD Hold'em No Limit - Level VIII (75/150) - 2021/01/02 22:24:01 EET [2021/01/02 15:24:01 ET]
Table '3086083919 46' 9-max Seat #6 is the button
Seat 1: csabipapa1 (7384 in chips) 
Seat 2: 1993544 (6110 in chips) 
Seat 3: jcarlos.vale (3559 in chips) 
Seat 4: chekmpcc (16272 in chips) 
Seat 5: mariafirmina (10559 in chips) 
Seat 6: revolverpicn (4055 in chips) 
Seat 7: ddurikkt (12316 in chips) 
Seat 8: Elbobby2021 (4625 in chips) 
Seat 9: JANAÍNA13 (6819 in chips) 
csabipapa1: posts the ante 15
1993544: posts the ante 15
jcarlos.vale: posts the ante 15
chekmpcc: posts the ante 15
mariafirmina: posts the ante 15
revolverpicn: posts the ante 15
ddurikkt: posts the ante 15
Elbobby2021: posts the ante 15
JANAÍNA13: posts the ante 15
ddurikkt: posts small blind 75
Elbobby2021: posts big blind 150
*** HOLE CARDS ***
Dealt to jcarlos.vale [4d Th]
JANAÍNA13: folds 
csabipapa1: folds 
1993544: folds 
jcarlos.vale: folds 
chekmpcc: folds 
mariafirmina: folds 
revolverpicn: calls 150
ddurikkt: folds 
Elbobby2021: checks 
*** FLOP *** [Ah 5c 6h]
Elbobby2021: checks 
revolverpicn: checks 
*** TURN *** [Ah 5c 6h] [4c]
Elbobby2021: checks 
revolverpicn: checks 
*** RIVER *** [Ah 5c 6h 4c] [9c]
Elbobby2021: bets 510
revolverpicn: folds 
Uncalled bet (510) returned to Elbobby2021
Elbobby2021 collected 510 from pot
Elbobby2021: doesn't show handDTO
*** SUMMARY ***
Total pot 510 | Rake 0 
Board [Ah 5c 6h 4c 9c]
Seat 1: csabipapa1 folded before Flop (didn't bet)
Seat 2: 1993544 folded before Flop (didn't bet)
Seat 3: jcarlos.vale folded before Flop (didn't bet)
Seat 4: chekmpcc folded before Flop (didn't bet)
Seat 5: mariafirmina folded before Flop (didn't bet)
Seat 6: revolverpicn (button) folded on the River
Seat 7: ddurikkt (small blind) folded before Flop
Seat 8: Elbobby2021 (big blind) collected (510)
Seat 9: JANAÍNA13 folded before Flop (didn't bet)



PokerStars Hand #222148841143: Tournament #3086083919, $0.49+$0.06 USD Hold'em No Limit - Level VIII (75/150) - 2021/01/02 22:24:41 EET [2021/01/02 15:24:41 ET]
Table '3086083919 46' 9-max Seat #7 is the button
Seat 1: csabipapa1 (7369 in chips) 
Seat 2: 1993544 (6095 in chips) 
Seat 3: jcarlos.vale (3544 in chips) 
Seat 4: chekmpcc (16257 in chips) 
Seat 5: mariafirmina (10544 in chips) 
Seat 6: revolverpicn (3890 in chips) 
Seat 7: ddurikkt (12226 in chips) 
Seat 8: Elbobby2021 (4970 in chips) 
Seat 9: JANAÍNA13 (6804 in chips) 
csabipapa1: posts the ante 15
1993544: posts the ante 15
jcarlos.vale: posts the ante 15
chekmpcc: posts the ante 15
mariafirmina: posts the ante 15
revolverpicn: posts the ante 15
ddurikkt: posts the ante 15
Elbobby2021: posts the ante 15
JANAÍNA13: posts the ante 15
Elbobby2021: posts small blind 75
JANAÍNA13: posts big blind 150
*** HOLE CARDS ***
Dealt to jcarlos.vale [Kd Td]
csabipapa1: folds 
1993544: folds 
jcarlos.vale: raises 240 to 390
chekmpcc: folds 
mariafirmina: folds 
revolverpicn: folds 
ddurikkt: folds 
Elbobby2021: folds 
JANAÍNA13: calls 240
*** FLOP *** [9s 8s Kc]
JANAÍNA13: bets 495
jcarlos.vale: raises 2644 to 3139 and is all-in
JANAÍNA13: calls 2644
*** TURN *** [9s 8s Kc] [5d]
*** RIVER *** [9s 8s Kc 5d] [Th]
*** SHOW DOWN ***
JANAÍNA13: shows [8h Kh] (two pair, Kings and Eights)
jcarlos.vale: shows [Kd Td] (two pair, Kings and Tens)
jcarlos.vale collected 7268 from pot
*** SUMMARY ***
Total pot 7268 | Rake 0 
Board [9s 8s Kc 5d Th]
Seat 1: csabipapa1 folded before Flop (didn't bet)
Seat 2: 1993544 folded before Flop (didn't bet)
Seat 3: jcarlos.vale showed [Kd Td] and won (7268) with two pair, Kings and Tens
Seat 4: chekmpcc folded before Flop (didn't bet)
Seat 5: mariafirmina folded before Flop (didn't bet)
Seat 6: revolverpicn folded before Flop (didn't bet)
Seat 7: ddurikkt (button) folded before Flop (didn't bet)
Seat 8: Elbobby2021 (small blind) folded before Flop
Seat 9: JANAÍNA13 (big blind) showed [8h Kh] and lost with two pair, Kings and Eights



PokerStars Hand #222148890764: Tournament #3086083919, $0.49+$0.06 USD Hold'em No Limit - Level VIII (75/150) - 2021/01/02 22:25:30 EET [2021/01/02 15:25:30 ET]
Table '3086083919 46' 9-max Seat #8 is the button
Seat 1: csabipapa1 (7354 in chips) 
Seat 2: 1993544 (6080 in chips) 
Seat 3: jcarlos.vale (7268 in chips) 
Seat 4: chekmpcc (16242 in chips) 
Seat 5: mariafirmina (10529 in chips) 
Seat 6: revolverpicn (3875 in chips) 
Seat 7: ddurikkt (12211 in chips) 
Seat 8: Elbobby2021 (4880 in chips) 
Seat 9: JANAÍNA13 (3260 in chips) 
csabipapa1: posts the ante 15
1993544: posts the ante 15
jcarlos.vale: posts the ante 15
chekmpcc: posts the ante 15
mariafirmina: posts the ante 15
revolverpicn: posts the ante 15
ddurikkt: posts the ante 15
Elbobby2021: posts the ante 15
JANAÍNA13: posts the ante 15
JANAÍNA13: posts small blind 75
csabipapa1: posts big blind 150
*** HOLE CARDS ***
Dealt to jcarlos.vale [Td 6d]
1993544: raises 5915 to 6065 and is all-in
jcarlos.vale: folds 
chekmpcc: folds 
mariafirmina: folds 
revolverpicn: folds 
ddurikkt: folds 
Elbobby2021: folds 
JANAÍNA13: folds 
csabipapa1: folds 
Uncalled bet (5915) returned to 1993544
1993544 collected 510 from pot
1993544: doesn't show handDTO
*** SUMMARY ***
Total pot 510 | Rake 0 
Seat 1: csabipapa1 (big blind) folded before Flop
Seat 2: 1993544 collected (510)
Seat 3: jcarlos.vale folded before Flop (didn't bet)
Seat 4: chekmpcc folded before Flop (didn't bet)
Seat 5: mariafirmina folded before Flop (didn't bet)
Seat 6: revolverpicn folded before Flop (didn't bet)
Seat 7: ddurikkt folded before Flop (didn't bet)
Seat 8: Elbobby2021 (button) folded before Flop (didn't bet)
Seat 9: JANAÍNA13 (small blind) folded before Flop



PokerStars Hand #222148920677: Tournament #3086083919, $0.49+$0.06 USD Hold'em No Limit - Level VIII (75/150) - 2021/01/02 22:26:00 EET [2021/01/02 15:26:00 ET]
Table '3086083919 46' 9-max Seat #9 is the button
Seat 1: csabipapa1 (7189 in chips) 
Seat 2: 1993544 (6425 in chips) 
Seat 3: jcarlos.vale (7253 in chips) 
Seat 4: chekmpcc (16227 in chips) 
Seat 5: mariafirmina (10514 in chips) 
Seat 6: revolverpicn (3860 in chips) 
Seat 7: ddurikkt (12196 in chips) 
Seat 8: Elbobby2021 (4865 in chips) 
Seat 9: JANAÍNA13 (3170 in chips) 
csabipapa1: posts the ante 15
1993544: posts the ante 15
jcarlos.vale: posts the ante 15
chekmpcc: posts the ante 15
mariafirmina: posts the ante 15
revolverpicn: posts the ante 15
ddurikkt: posts the ante 15
Elbobby2021: posts the ante 15
JANAÍNA13: posts the ante 15
csabipapa1: posts small blind 75
1993544: posts big blind 150
*** HOLE CARDS ***
Dealt to jcarlos.vale [6c 2s]
jcarlos.vale: folds 
chekmpcc: folds 
mariafirmina: folds 
revolverpicn: folds 
ddurikkt: raises 165 to 315
Elbobby2021: calls 315
JANAÍNA13: folds 
csabipapa1: folds 
1993544: raises 6095 to 6410 and is all-in
ddurikkt: folds 
Elbobby2021: calls 4535 and is all-in
Uncalled bet (1560) returned to 1993544
*** FLOP *** [Jd Qh 7h]
*** TURN *** [Jd Qh 7h] [8s]
*** RIVER *** [Jd Qh 7h 8s] [6s]
*** SHOW DOWN ***
1993544: shows [As Jh] (a pair of Jacks)
Elbobby2021: shows [Ac Td] (high pairOfCards Ace)
1993544 collected 10225 from pot
Elbobby2021 finished the tournament
*** SUMMARY ***
Total pot 10225 | Rake 0 
Board [Jd Qh 7h 8s 6s]
Seat 1: csabipapa1 (small blind) folded before Flop
Seat 2: 1993544 (big blind) showed [As Jh] and won (10225) with a pair of Jacks
Seat 3: jcarlos.vale folded before Flop (didn't bet)
Seat 4: chekmpcc folded before Flop (didn't bet)
Seat 5: mariafirmina folded before Flop (didn't bet)
Seat 6: revolverpicn folded before Flop (didn't bet)
Seat 7: ddurikkt folded before Flop
Seat 8: Elbobby2021 showed [Ac Td] and lost with high pairOfCards Ace
Seat 9: JANAÍNA13 (button) folded before Flop (didn't bet)



PokerStars Hand #222148979563: Tournament #3086083919, $0.49+$0.06 USD Hold'em No Limit - Level VIII (75/150) - 2021/01/02 22:26:58 EET [2021/01/02 15:26:58 ET]
Table '3086083919 46' 9-max Seat #1 is the button
Seat 1: csabipapa1 (7099 in chips) 
Seat 2: 1993544 (11785 in chips) 
Seat 3: jcarlos.vale (7238 in chips) 
Seat 4: chekmpcc (16212 in chips) 
Seat 5: mariafirmina (10499 in chips) 
Seat 6: revolverpicn (3845 in chips) 
Seat 7: ddurikkt (11866 in chips) 
Seat 8: mrubilar (5000 in chips) 
Seat 9: JANAÍNA13 (3155 in chips) 
csabipapa1: posts the ante 15
1993544: posts the ante 15
jcarlos.vale: posts the ante 15
chekmpcc: posts the ante 15
mariafirmina: posts the ante 15
revolverpicn: posts the ante 15
ddurikkt: posts the ante 15
mrubilar: posts the ante 15
JANAÍNA13: posts the ante 15
1993544: posts small blind 75
jcarlos.vale: posts big blind 150
*** HOLE CARDS ***
Dealt to jcarlos.vale [Tc 2s]
chekmpcc: folds 
mariafirmina: folds 
revolverpicn: folds 
ddurikkt: raises 165 to 315
mrubilar: raises 4670 to 4985 and is all-in
JANAÍNA13: folds 
csabipapa1: folds 
1993544: raises 4670 to 9655
jcarlos.vale: folds 
ddurikkt: folds 
Uncalled bet (4670) returned to 1993544
*** FLOP *** [6s Jd 7c]
*** TURN *** [6s Jd 7c] [Ts]
*** RIVER *** [6s Jd 7c Ts] [Jc]
*** SHOW DOWN ***
1993544: shows [As Qc] (a pair of Jacks)
mrubilar: shows [Ad 9s] (a pair of Jacks - lower kicker)
1993544 collected 10570 from pot
mrubilar finished the tournament
*** SUMMARY ***
Total pot 10570 | Rake 0 
Board [6s Jd 7c Ts Jc]
Seat 1: csabipapa1 (button) folded before Flop (didn't bet)
Seat 2: 1993544 (small blind) showed [As Qc] and won (10570) with a pair of Jacks
Seat 3: jcarlos.vale (big blind) folded before Flop
Seat 4: chekmpcc folded before Flop (didn't bet)
Seat 5: mariafirmina folded before Flop (didn't bet)
Seat 6: revolverpicn folded before Flop (didn't bet)
Seat 7: ddurikkt folded before Flop
Seat 8: mrubilar showed [Ad 9s] and lost with a pair of Jacks
Seat 9: JANAÍNA13 folded before Flop (didn't bet)



PokerStars Hand #222149032837: Tournament #3086083919, $0.49+$0.06 USD Hold'em No Limit - Level IX (100/200) - 2021/01/02 22:27:52 EET [2021/01/02 15:27:52 ET]
Table '3086083919 46' 9-max Seat #2 is the button
Seat 1: csabipapa1 (7084 in chips) 
Seat 2: 1993544 (17355 in chips) 
Seat 3: jcarlos.vale (7073 in chips) 
Seat 4: chekmpcc (16197 in chips) 
Seat 5: mariafirmina (10484 in chips) 
Seat 6: revolverpicn (3830 in chips) 
Seat 7: ddurikkt (11536 in chips) 
Seat 8: dtl15 (5000 in chips) 
Seat 9: JANAÍNA13 (3140 in chips) 
csabipapa1: posts the ante 18
1993544: posts the ante 18
jcarlos.vale: posts the ante 18
chekmpcc: posts the ante 18
mariafirmina: posts the ante 18
revolverpicn: posts the ante 18
ddurikkt: posts the ante 18
dtl15: posts the ante 18
JANAÍNA13: posts the ante 18
jcarlos.vale: posts small blind 100
chekmpcc: posts big blind 200
*** HOLE CARDS ***
Dealt to jcarlos.vale [6d 2c]
mariafirmina: folds 
revolverpicn: raises 400 to 600
ddurikkt: folds 
dtl15: folds 
JANAÍNA13: folds 
csabipapa1: raises 6466 to 7066 and is all-in
1993544: raises 10271 to 17337 and is all-in
jcarlos.vale: folds 
chekmpcc: folds 
revolverpicn: calls 3212 and is all-in
Uncalled bet (10271) returned to 1993544
*** FLOP *** [Th Qc 8h]
*** TURN *** [Th Qc 8h] [7d]
*** RIVER *** [Th Qc 8h 7d] [Qs]
*** SHOW DOWN ***
csabipapa1: shows [Qd Ah] (three of a kind, Queens)
1993544: shows [4d 4s] (two pair, Queens and Fours)
csabipapa1 collected 6508 from side pot
revolverpicn: shows [Kd As] (a pair of Queens)
csabipapa1 collected 11898 from main pot
revolverpicn finished the tournament
*** SUMMARY ***
Total pot 18406 Main pot 11898. Side pot 6508. | Rake 0 
Board [Th Qc 8h 7d Qs]
Seat 1: csabipapa1 showed [Qd Ah] and won (18406) with three of a kind, Queens
Seat 2: 1993544 (button) showed [4d 4s] and lost with two pair, Queens and Fours
Seat 3: jcarlos.vale (small blind) folded before Flop
Seat 4: chekmpcc (big blind) folded before Flop
Seat 5: mariafirmina folded before Flop (didn't bet)
Seat 6: revolverpicn showed [Kd As] and lost with a pair of Queens
Seat 7: ddurikkt folded before Flop (didn't bet)
Seat 8: dtl15 folded before Flop (didn't bet)
Seat 9: JANAÍNA13 folded before Flop (didn't bet)



PokerStars Hand #222149065813: Tournament #3086083919, $0.49+$0.06 USD Hold'em No Limit - Level IX (100/200) - 2021/01/02 22:28:25 EET [2021/01/02 15:28:25 ET]
Table '3086083919 46' 9-max Seat #3 is the button
Seat 1: csabipapa1 (18406 in chips) 
Seat 2: 1993544 (10271 in chips) 
Seat 3: jcarlos.vale (6955 in chips) 
Seat 4: chekmpcc (15979 in chips) 
Seat 5: mariafirmina (10466 in chips) 
Seat 7: ddurikkt (11518 in chips) 
Seat 8: dtl15 (4982 in chips) 
Seat 9: JANAÍNA13 (3122 in chips) 
csabipapa1: posts the ante 18
1993544: posts the ante 18
jcarlos.vale: posts the ante 18
chekmpcc: posts the ante 18
mariafirmina: posts the ante 18
ddurikkt: posts the ante 18
dtl15: posts the ante 18
JANAÍNA13: posts the ante 18
chekmpcc: posts small blind 100
mariafirmina: posts big blind 200
*** HOLE CARDS ***
Dealt to jcarlos.vale [3s 4c]
ddurikkt: folds 
dtl15: folds 
JANAÍNA13: folds 
csabipapa1: calls 200
1993544: folds 
jcarlos.vale: folds 
chekmpcc: raises 600 to 800
mariafirmina: folds 
csabipapa1: calls 600
*** FLOP *** [8s 8c Ah]
chekmpcc: bets 800
csabipapa1: folds 
Uncalled bet (800) returned to chekmpcc
chekmpcc collected 1944 from pot
*** SUMMARY ***
Total pot 1944 | Rake 0 
Board [8s 8c Ah]
Seat 1: csabipapa1 folded on the Flop
Seat 2: 1993544 folded before Flop (didn't bet)
Seat 3: jcarlos.vale (button) folded before Flop (didn't bet)
Seat 4: chekmpcc (small blind) collected (1944)
Seat 5: mariafirmina (big blind) folded before Flop
Seat 7: ddurikkt folded before Flop (didn't bet)
Seat 8: dtl15 folded before Flop (didn't bet)
Seat 9: JANAÍNA13 folded before Flop (didn't bet)



PokerStars Hand #222149105804: Tournament #3086083919, $0.49+$0.06 USD Hold'em No Limit - Level IX (100/200) - 2021/01/02 22:29:05 EET [2021/01/02 15:29:05 ET]
Table '3086083919 46' 9-max Seat #4 is the button
Seat 1: csabipapa1 (17588 in chips) 
Seat 2: 1993544 (10253 in chips) 
Seat 3: jcarlos.vale (6937 in chips) 
Seat 4: chekmpcc (17105 in chips) 
Seat 5: mariafirmina (10248 in chips) 
Seat 7: ddurikkt (11500 in chips) 
Seat 8: dtl15 (4964 in chips) 
Seat 9: JANAÍNA13 (3104 in chips) 
csabipapa1: posts the ante 18
1993544: posts the ante 18
jcarlos.vale: posts the ante 18
chekmpcc: posts the ante 18
mariafirmina: posts the ante 18
ddurikkt: posts the ante 18
dtl15: posts the ante 18
JANAÍNA13: posts the ante 18
mariafirmina: posts small blind 100
ddurikkt: posts big blind 200
*** HOLE CARDS ***
Dealt to jcarlos.vale [Kh Ac]
dtl15: folds 
JANAÍNA13: folds 
csabipapa1: folds 
1993544: raises 400 to 600
jcarlos.vale: calls 600
chekmpcc: folds 
mariafirmina: calls 500
ddurikkt: calls 400
*** FLOP *** [Ts Jd 2c]
mariafirmina: checks 
ddurikkt: checks 
1993544: bets 1272
jcarlos.vale: raises 5047 to 6319 and is all-in
mariafirmina: folds 
ddurikkt: folds 
1993544: folds 
Uncalled bet (5047) returned to jcarlos.vale
jcarlos.vale collected 5088 from pot
jcarlos.vale: doesn't show handDTO
*** SUMMARY ***
Total pot 5088 | Rake 0 
Board [Ts Jd 2c]
Seat 1: csabipapa1 folded before Flop (didn't bet)
Seat 2: 1993544 folded on the Flop
Seat 3: jcarlos.vale collected (5088)
Seat 4: chekmpcc (button) folded before Flop (didn't bet)
Seat 5: mariafirmina (small blind) folded on the Flop
Seat 7: ddurikkt (big blind) folded on the Flop
Seat 8: dtl15 folded before Flop (didn't bet)
Seat 9: JANAÍNA13 folded before Flop (didn't bet)



PokerStars Hand #222149164056: Tournament #3086083919, $0.49+$0.06 USD Hold'em No Limit - Level IX (100/200) - 2021/01/02 22:30:04 EET [2021/01/02 15:30:04 ET]
Table '3086083919 46' 9-max Seat #5 is the button
Seat 1: csabipapa1 (17570 in chips) 
Seat 2: 1993544 (8363 in chips) 
Seat 3: jcarlos.vale (10135 in chips) 
Seat 4: chekmpcc (17087 in chips) 
Seat 5: mariafirmina (9630 in chips) 
Seat 6: acolini981 (5000 in chips) out of handDTO (moved from another table into small blind)
Seat 7: ddurikkt (10882 in chips) 
Seat 8: dtl15 (4946 in chips) 
Seat 9: JANAÍNA13 (3086 in chips) 
acolini981 will be allowed to play after the button
csabipapa1: posts the ante 18
1993544: posts the ante 18
jcarlos.vale: posts the ante 18
chekmpcc: posts the ante 18
mariafirmina: posts the ante 18
ddurikkt: posts the ante 18
dtl15: posts the ante 18
JANAÍNA13: posts the ante 18
ddurikkt: posts small blind 100
dtl15: posts big blind 200
*** HOLE CARDS ***
Dealt to jcarlos.vale [Ah 4h]
JANAÍNA13: folds 
csabipapa1: folds 
1993544: folds 
jcarlos.vale: folds 
chekmpcc: raises 340 to 540
mariafirmina: folds 
ddurikkt: calls 440
dtl15: folds 
*** FLOP *** [Qs 6d 4s]
ddurikkt: checks 
chekmpcc: bets 800
ddurikkt: folds 
Uncalled bet (800) returned to chekmpcc
chekmpcc collected 1424 from pot
*** SUMMARY ***
Total pot 1424 | Rake 0 
Board [Qs 6d 4s]
Seat 1: csabipapa1 folded before Flop (didn't bet)
Seat 2: 1993544 folded before Flop (didn't bet)
Seat 3: jcarlos.vale folded before Flop (didn't bet)
Seat 4: chekmpcc collected (1424)
Seat 5: mariafirmina (button) folded before Flop (didn't bet)
Seat 7: ddurikkt (small blind) folded on the Flop
Seat 8: dtl15 (big blind) folded before Flop
Seat 9: JANAÍNA13 folded before Flop (didn't bet)



PokerStars Hand #222149224108: Tournament #3086083919, $0.49+$0.06 USD Hold'em No Limit - Level IX (100/200) - 2021/01/02 22:30:54 EET [2021/01/02 15:30:54 ET]
Table '3086083919 46' 9-max Seat #7 is the button
Seat 1: csabipapa1 (17552 in chips) 
Seat 2: 1993544 (8345 in chips) 
Seat 3: jcarlos.vale (10117 in chips) 
Seat 4: chekmpcc (17953 in chips) 
Seat 5: mariafirmina (9612 in chips) 
Seat 6: acolini981 (5000 in chips) 
Seat 7: ddurikkt (10324 in chips) 
Seat 8: dtl15 (4728 in chips) 
Seat 9: JANAÍNA13 (3068 in chips) 
csabipapa1: posts the ante 18
1993544: posts the ante 18
jcarlos.vale: posts the ante 18
chekmpcc: posts the ante 18
mariafirmina: posts the ante 18
acolini981: posts the ante 18
ddurikkt: posts the ante 18
dtl15: posts the ante 18
JANAÍNA13: posts the ante 18
dtl15: posts small blind 100
JANAÍNA13: posts big blind 200
*** HOLE CARDS ***
Dealt to jcarlos.vale [Jc 7d]
csabipapa1: folds 
1993544: folds 
jcarlos.vale: folds 
chekmpcc: raises 220 to 420
mariafirmina: folds 
acolini981: calls 420
ddurikkt: calls 420
dtl15: folds 
JANAÍNA13: folds 
*** FLOP *** [As Kd 3c]
chekmpcc: checks 
acolini981: checks 
ddurikkt: checks 
*** TURN *** [As Kd 3c] [Ac]
chekmpcc: bets 431
acolini981: folds 
ddurikkt: folds 
Uncalled bet (431) returned to chekmpcc
chekmpcc collected 1722 from pot
*** SUMMARY ***
Total pot 1722 | Rake 0 
Board [As Kd 3c Ac]
Seat 1: csabipapa1 folded before Flop (didn't bet)
Seat 2: 1993544 folded before Flop (didn't bet)
Seat 3: jcarlos.vale folded before Flop (didn't bet)
Seat 4: chekmpcc collected (1722)
Seat 5: mariafirmina folded before Flop (didn't bet)
Seat 6: acolini981 folded on the Turn
Seat 7: ddurikkt (button) folded on the Turn
Seat 8: dtl15 (small blind) folded before Flop
Seat 9: JANAÍNA13 (big blind) folded before Flop



PokerStars Hand #222149282056: Tournament #3086083919, $0.49+$0.06 USD Hold'em No Limit - Level IX (100/200) - 2021/01/02 22:31:51 EET [2021/01/02 15:31:51 ET]
Table '3086083919 46' 9-max Seat #8 is the button
Seat 1: csabipapa1 (17534 in chips) 
Seat 2: 1993544 (8327 in chips) 
Seat 3: jcarlos.vale (10099 in chips) 
Seat 4: chekmpcc (19237 in chips) 
Seat 5: mariafirmina (9594 in chips) 
Seat 6: acolini981 (4562 in chips) 
Seat 7: ddurikkt (9886 in chips) 
Seat 8: dtl15 (4610 in chips) 
Seat 9: JANAÍNA13 (2850 in chips) 
csabipapa1: posts the ante 18
1993544: posts the ante 18
jcarlos.vale: posts the ante 18
chekmpcc: posts the ante 18
mariafirmina: posts the ante 18
acolini981: posts the ante 18
ddurikkt: posts the ante 18
dtl15: posts the ante 18
JANAÍNA13: posts the ante 18
JANAÍNA13: posts small blind 100
csabipapa1: posts big blind 200
*** HOLE CARDS ***
Dealt to jcarlos.vale [Jh Qc]
1993544: raises 400 to 600
jcarlos.vale: folds 
chekmpcc: folds 
mariafirmina: folds 
acolini981: calls 600
ddurikkt: folds 
dtl15: folds 
JANAÍNA13: folds 
csabipapa1: folds 
*** FLOP *** [2d 7c 6c]
1993544: checks 
acolini981: bets 831
1993544: raises 6878 to 7709 and is all-in
acolini981: calls 3113 and is all-in
Uncalled bet (3765) returned to 1993544
*** TURN *** [2d 7c 6c] [2c]
*** RIVER *** [2d 7c 6c 2c] [Qs]
*** SHOW DOWN ***
1993544: shows [Qh Ac] (two pair, Queens and Deuces)
acolini981: shows [5c 5h] (two pair, Fives and Deuces)
1993544 collected 9550 from pot
acolini981 finished the tournament
*** SUMMARY ***
Total pot 9550 | Rake 0 
Board [2d 7c 6c 2c Qs]
Seat 1: csabipapa1 (big blind) folded before Flop
Seat 2: 1993544 showed [Qh Ac] and won (9550) with two pair, Queens and Deuces
Seat 3: jcarlos.vale folded before Flop (didn't bet)
Seat 4: chekmpcc folded before Flop (didn't bet)
Seat 5: mariafirmina folded before Flop (didn't bet)
Seat 6: acolini981 showed [5c 5h] and lost with two pair, Fives and Deuces
Seat 7: ddurikkt folded before Flop (didn't bet)
Seat 8: dtl15 (button) folded before Flop (didn't bet)
Seat 9: JANAÍNA13 (small blind) folded before Flop



PokerStars Hand #222149330574: Tournament #3086083919, $0.49+$0.06 USD Hold'em No Limit - Level IX (100/200) - 2021/01/02 22:32:39 EET [2021/01/02 15:32:39 ET]
Table '3086083919 46' 9-max Seat #9 is the button
Seat 1: csabipapa1 (17316 in chips) 
Seat 2: 1993544 (13315 in chips) 
Seat 3: jcarlos.vale (10081 in chips) 
Seat 4: chekmpcc (19219 in chips) 
Seat 5: mariafirmina (9576 in chips) 
Seat 7: ddurikkt (9868 in chips) 
Seat 8: dtl15 (4592 in chips) 
Seat 9: JANAÍNA13 (2732 in chips) 
csabipapa1: posts the ante 18
1993544: posts the ante 18
jcarlos.vale: posts the ante 18
chekmpcc: posts the ante 18
mariafirmina: posts the ante 18
ddurikkt: posts the ante 18
dtl15: posts the ante 18
JANAÍNA13: posts the ante 18
csabipapa1: posts small blind 100
1993544: posts big blind 200
*** HOLE CARDS ***
Dealt to jcarlos.vale [6s 2c]
jcarlos.vale: folds 
chekmpcc: folds 
mariafirmina: raises 200 to 400
ddurikkt: folds 
dtl15: raises 800 to 1200
JANAÍNA13: folds 
csabipapa1: calls 1100
1993544: folds 
mariafirmina: calls 800
*** FLOP *** [5h 7c 5d]
csabipapa1: checks 
mariafirmina: checks 
dtl15: bets 600
csabipapa1: calls 600
mariafirmina: calls 600
*** TURN *** [5h 7c 5d] [Jh]
csabipapa1: checks 
mariafirmina: checks 
dtl15: bets 600
csabipapa1: folds 
mariafirmina: calls 600
*** RIVER *** [5h 7c 5d Jh] [9s]
mariafirmina: checks 
dtl15: bets 2174 and is all-in
mariafirmina: calls 2174
*** SHOW DOWN ***
dtl15: shows [7s 7d] (a full house, Sevens full of Fives)
mariafirmina: shows [Ts Td] (two pair, Tens and Fives)
dtl15 collected 11292 from pot
*** SUMMARY ***
Total pot 11292 | Rake 0 
Board [5h 7c 5d Jh 9s]
Seat 1: csabipapa1 (small blind) folded on the Turn
Seat 2: 1993544 (big blind) folded before Flop
Seat 3: jcarlos.vale folded before Flop (didn't bet)
Seat 4: chekmpcc folded before Flop (didn't bet)
Seat 5: mariafirmina showed [Ts Td] and lost with two pair, Tens and Fives
Seat 7: ddurikkt folded before Flop (didn't bet)
Seat 8: dtl15 showed [7s 7d] and won (11292) with a full house, Sevens full of Fives
Seat 9: JANAÍNA13 (button) folded before Flop (didn't bet)



PokerStars Hand #222149426719: Tournament #3086083919, $0.49+$0.06 USD Hold'em No Limit - Level IX (100/200) - 2021/01/02 22:34:15 EET [2021/01/02 15:34:15 ET]
Table '3086083919 46' 9-max Seat #1 is the button
Seat 1: csabipapa1 (15498 in chips) 
Seat 2: 1993544 (13097 in chips) 
Seat 3: jcarlos.vale (10063 in chips) 
Seat 4: chekmpcc (19201 in chips) 
Seat 5: mariafirmina (4984 in chips) 
Seat 6: arturei977 (5000 in chips) 
Seat 7: ddurikkt (9850 in chips) 
Seat 8: dtl15 (11292 in chips) 
Seat 9: JANAÍNA13 (2714 in chips) 
csabipapa1: posts the ante 18
1993544: posts the ante 18
jcarlos.vale: posts the ante 18
chekmpcc: posts the ante 18
mariafirmina: posts the ante 18
arturei977: posts the ante 18
ddurikkt: posts the ante 18
dtl15: posts the ante 18
JANAÍNA13: posts the ante 18
1993544: posts small blind 100
jcarlos.vale: posts big blind 200
*** HOLE CARDS ***
Dealt to jcarlos.vale [7h 8h]
chekmpcc: raises 220 to 420
mariafirmina: folds 
arturei977: raises 4562 to 4982 and is all-in
ddurikkt: raises 4850 to 9832 and is all-in
dtl15: folds 
JANAÍNA13: folds 
csabipapa1: folds 
1993544: folds 
jcarlos.vale: folds 
chekmpcc: folds 
Uncalled bet (4850) returned to ddurikkt
*** FLOP *** [8c Th Ad]
*** TURN *** [8c Th Ad] [9d]
*** RIVER *** [8c Th Ad 9d] [2c]
*** SHOW DOWN ***
arturei977: shows [Kh Ac] (a pair of Aces)
ddurikkt: shows [Tc Ts] (three of a kind, Tens)
ddurikkt collected 10846 from pot
arturei977 finished the tournament
*** SUMMARY ***
Total pot 10846 | Rake 0 
Board [8c Th Ad 9d 2c]
Seat 1: csabipapa1 (button) folded before Flop (didn't bet)
Seat 2: 1993544 (small blind) folded before Flop
Seat 3: jcarlos.vale (big blind) folded before Flop
Seat 4: chekmpcc folded before Flop
Seat 5: mariafirmina folded before Flop (didn't bet)
Seat 6: arturei977 showed [Kh Ac] and lost with a pair of Aces
Seat 7: ddurikkt showed [Tc Ts] and won (10846) with three of a kind, Tens
Seat 8: dtl15 folded before Flop (didn't bet)
Seat 9: JANAÍNA13 folded before Flop (didn't bet)



PokerStars Hand #222149461098: Tournament #3086083919, $0.49+$0.06 USD Hold'em No Limit - Level IX (100/200) - 2021/01/02 22:34:50 EET [2021/01/02 15:34:50 ET]
Table '3086083919 46' 9-max Seat #2 is the button
Seat 1: csabipapa1 (15480 in chips) 
Seat 2: 1993544 (12979 in chips) 
Seat 3: jcarlos.vale (9845 in chips) 
Seat 4: chekmpcc (18763 in chips) 
Seat 5: mariafirmina (4966 in chips) 
Seat 7: ddurikkt (15696 in chips) 
Seat 8: dtl15 (11274 in chips) 
Seat 9: JANAÍNA13 (2696 in chips) 
csabipapa1: posts the ante 18
1993544: posts the ante 18
jcarlos.vale: posts the ante 18
chekmpcc: posts the ante 18
mariafirmina: posts the ante 18
ddurikkt: posts the ante 18
dtl15: posts the ante 18
JANAÍNA13: posts the ante 18
jcarlos.vale: posts small blind 100
chekmpcc: posts big blind 200
*** HOLE CARDS ***
Dealt to jcarlos.vale [6s Ad]
mariafirmina: folds 
ddurikkt: raises 220 to 420
dtl15: folds 
JANAÍNA13: folds 
csabipapa1: folds 
1993544: folds 
jcarlos.vale: folds 
chekmpcc: folds 
Uncalled bet (220) returned to ddurikkt
ddurikkt collected 644 from pot
*** SUMMARY ***
Total pot 644 | Rake 0 
Seat 1: csabipapa1 folded before Flop (didn't bet)
Seat 2: 1993544 (button) folded before Flop (didn't bet)
Seat 3: jcarlos.vale (small blind) folded before Flop
Seat 4: chekmpcc (big blind) folded before Flop
Seat 5: mariafirmina folded before Flop (didn't bet)
Seat 7: ddurikkt collected (644)
Seat 8: dtl15 folded before Flop (didn't bet)
Seat 9: JANAÍNA13 folded before Flop (didn't bet)



PokerStars Hand #222149490756: Tournament #3086083919, $0.49+$0.06 USD Hold'em No Limit - Level IX (100/200) - 2021/01/02 22:35:20 EET [2021/01/02 15:35:20 ET]
Table '3086083919 46' 9-max Seat #3 is the button
Seat 1: csabipapa1 (15462 in chips) 
Seat 2: 1993544 (12961 in chips) 
Seat 3: jcarlos.vale (9727 in chips) 
Seat 4: chekmpcc (18545 in chips) 
Seat 5: mariafirmina (4948 in chips) 
Seat 6: ikfold2 (5000 in chips) 
Seat 7: ddurikkt (16122 in chips) 
Seat 8: dtl15 (11256 in chips) 
Seat 9: JANAÍNA13 (2678 in chips) 
csabipapa1: posts the ante 18
1993544: posts the ante 18
jcarlos.vale: posts the ante 18
chekmpcc: posts the ante 18
mariafirmina: posts the ante 18
ikfold2: posts the ante 18
ddurikkt: posts the ante 18
dtl15: posts the ante 18
JANAÍNA13: posts the ante 18
chekmpcc: posts small blind 100
mariafirmina: posts big blind 200
*** HOLE CARDS ***
Dealt to jcarlos.vale [2h Kh]
ikfold2: folds 
ddurikkt: folds 
dtl15: folds 
JANAÍNA13: raises 2460 to 2660 and is all-in
csabipapa1: folds 
1993544: folds 
jcarlos.vale: folds 
chekmpcc: folds 
mariafirmina: folds 
Uncalled bet (2460) returned to JANAÍNA13
JANAÍNA13 collected 662 from pot
JANAÍNA13: doesn't show handDTO
*** SUMMARY ***
Total pot 662 | Rake 0 
Seat 1: csabipapa1 folded before Flop (didn't bet)
Seat 2: 1993544 folded before Flop (didn't bet)
Seat 3: jcarlos.vale (button) folded before Flop (didn't bet)
Seat 4: chekmpcc (small blind) folded before Flop
Seat 5: mariafirmina (big blind) folded before Flop
Seat 6: ikfold2 folded before Flop (didn't bet)
Seat 7: ddurikkt folded before Flop (didn't bet)
Seat 8: dtl15 folded before Flop (didn't bet)
Seat 9: JANAÍNA13 collected (662)



PokerStars Hand #222149535047: Tournament #3086083919, $0.49+$0.06 USD Hold'em No Limit - Level IX (100/200) - 2021/01/02 22:36:04 EET [2021/01/02 15:36:04 ET]
Table '3086083919 46' 9-max Seat #4 is the button
Seat 1: csabipapa1 (15444 in chips) 
Seat 2: 1993544 (12943 in chips) 
Seat 3: jcarlos.vale (9709 in chips) 
Seat 4: chekmpcc (18427 in chips) 
Seat 5: mariafirmina (4730 in chips) 
Seat 6: ikfold2 (4982 in chips) 
Seat 7: ddurikkt (16104 in chips) 
Seat 8: dtl15 (11238 in chips) 
Seat 9: JANAÍNA13 (3122 in chips) 
csabipapa1: posts the ante 18
1993544: posts the ante 18
jcarlos.vale: posts the ante 18
chekmpcc: posts the ante 18
mariafirmina: posts the ante 18
ikfold2: posts the ante 18
ddurikkt: posts the ante 18
dtl15: posts the ante 18
JANAÍNA13: posts the ante 18
mariafirmina: posts small blind 100
ikfold2: posts big blind 200
*** HOLE CARDS ***
Dealt to jcarlos.vale [6h Qc]
ddurikkt: folds 
dtl15: folds 
JANAÍNA13: folds 
csabipapa1: raises 200 to 400
1993544: folds 
jcarlos.vale: folds 
chekmpcc: folds 
mariafirmina: folds 
ikfold2: calls 200
*** FLOP *** [Ac 4c 9h]
ikfold2: bets 531
csabipapa1: calls 531
*** TURN *** [Ac 4c 9h] [8h]
ikfold2: bets 200
csabipapa1: calls 200
*** RIVER *** [Ac 4c 9h 8h] [Jh]
ikfold2: bets 200
csabipapa1: calls 200
*** SHOW DOWN ***
ikfold2: shows [Tc Kh] (high pairOfCards Ace)
csabipapa1: shows [Th 9s] (a pair of Nines)
csabipapa1 collected 2924 from pot
*** SUMMARY ***
Total pot 2924 | Rake 0 
Board [Ac 4c 9h 8h Jh]
Seat 1: csabipapa1 showed [Th 9s] and won (2924) with a pair of Nines
Seat 2: 1993544 folded before Flop (didn't bet)
Seat 3: jcarlos.vale folded before Flop (didn't bet)
Seat 4: chekmpcc (button) folded before Flop (didn't bet)
Seat 5: mariafirmina (small blind) folded before Flop
Seat 6: ikfold2 (big blind) showed [Tc Kh] and lost with high pairOfCards Ace
Seat 7: ddurikkt folded before Flop (didn't bet)
Seat 8: dtl15 folded before Flop (didn't bet)
Seat 9: JANAÍNA13 folded before Flop (didn't bet)



PokerStars Hand #222149586435: Tournament #3086083919, $0.49+$0.06 USD Hold'em No Limit - Level IX (100/200) - 2021/01/02 22:36:56 EET [2021/01/02 15:36:56 ET]
Table '3086083919 46' 9-max Seat #5 is the button
Seat 1: csabipapa1 (17019 in chips) 
Seat 2: 1993544 (12925 in chips) 
Seat 3: jcarlos.vale (9691 in chips) 
Seat 4: chekmpcc (18409 in chips) 
Seat 5: mariafirmina (4612 in chips) 
Seat 6: ikfold2 (3633 in chips) 
Seat 7: ddurikkt (16086 in chips) 
Seat 8: dtl15 (11220 in chips) 
Seat 9: JANAÍNA13 (3104 in chips) 
csabipapa1: posts the ante 18
1993544: posts the ante 18
jcarlos.vale: posts the ante 18
chekmpcc: posts the ante 18
mariafirmina: posts the ante 18
ikfold2: posts the ante 18
ddurikkt: posts the ante 18
dtl15: posts the ante 18
JANAÍNA13: posts the ante 18
ikfold2: posts small blind 100
ddurikkt: posts big blind 200
*** HOLE CARDS ***
Dealt to jcarlos.vale [9c 4c]
dtl15: folds 
JANAÍNA13: folds 
csabipapa1: folds 
1993544: folds 
jcarlos.vale: folds 
chekmpcc: raises 340 to 540
mariafirmina: folds 
ikfold2: folds 
ddurikkt: raises 1060 to 1600
chekmpcc: calls 1060
*** FLOP *** [Qc 3s Th]
ddurikkt: bets 1142
chekmpcc: folds 
Uncalled bet (1142) returned to ddurikkt
ddurikkt collected 3462 from pot
*** SUMMARY ***
Total pot 3462 | Rake 0 
Board [Qc 3s Th]
Seat 1: csabipapa1 folded before Flop (didn't bet)
Seat 2: 1993544 folded before Flop (didn't bet)
Seat 3: jcarlos.vale folded before Flop (didn't bet)
Seat 4: chekmpcc folded on the Flop
Seat 5: mariafirmina (button) folded before Flop (didn't bet)
Seat 6: ikfold2 (small blind) folded before Flop
Seat 7: ddurikkt (big blind) collected (3462)
Seat 8: dtl15 folded before Flop (didn't bet)
Seat 9: JANAÍNA13 folded before Flop (didn't bet)



PokerStars Hand #222149644730: Tournament #3086083919, $0.49+$0.06 USD Hold'em No Limit - Level X (125/250) - 2021/01/02 22:37:55 EET [2021/01/02 15:37:55 ET]
Table '3086083919 46' 9-max Seat #6 is the button
Seat 1: csabipapa1 (17001 in chips) 
Seat 2: 1993544 (12907 in chips) 
Seat 3: jcarlos.vale (9673 in chips) 
Seat 4: chekmpcc (16791 in chips) 
Seat 5: mariafirmina (4594 in chips) 
Seat 6: ikfold2 (3515 in chips) 
Seat 7: ddurikkt (17930 in chips) 
Seat 8: dtl15 (11202 in chips) 
Seat 9: JANAÍNA13 (3086 in chips) 
csabipapa1: posts the ante 20
1993544: posts the ante 20
jcarlos.vale: posts the ante 20
chekmpcc: posts the ante 20
mariafirmina: posts the ante 20
ikfold2: posts the ante 20
ddurikkt: posts the ante 20
dtl15: posts the ante 20
JANAÍNA13: posts the ante 20
ddurikkt: posts small blind 125
dtl15: posts big blind 250
*** HOLE CARDS ***
Dealt to jcarlos.vale [Jd Ts]
JANAÍNA13: folds 
csabipapa1: folds 
1993544: folds 
jcarlos.vale: folds 
chekmpcc: folds 
mariafirmina: raises 250 to 500
ikfold2: calls 500
ddurikkt: folds 
dtl15: folds 
*** FLOP *** [6h 7d Th]
mariafirmina: checks 
ikfold2: bets 2995 and is all-in
mariafirmina: folds 
Uncalled bet (2995) returned to ikfold2
ikfold2 collected 1555 from pot
ikfold2: doesn't show handDTO
*** SUMMARY ***
Total pot 1555 | Rake 0 
Board [6h 7d Th]
Seat 1: csabipapa1 folded before Flop (didn't bet)
Seat 2: 1993544 folded before Flop (didn't bet)
Seat 3: jcarlos.vale folded before Flop (didn't bet)
Seat 4: chekmpcc folded before Flop (didn't bet)
Seat 5: mariafirmina folded on the Flop
Seat 6: ikfold2 (button) collected (1555)
Seat 7: ddurikkt (small blind) folded before Flop
Seat 8: dtl15 (big blind) folded before Flop
Seat 9: JANAÍNA13 folded before Flop (didn't bet)



PokerStars Hand #222149692293: Tournament #3086083919, $0.49+$0.06 USD Hold'em No Limit - Level X (125/250) - 2021/01/02 22:38:42 EET [2021/01/02 15:38:42 ET]
Table '3086083919 46' 9-max Seat #7 is the button
Seat 1: csabipapa1 (16981 in chips) 
Seat 2: 1993544 (12887 in chips) 
Seat 3: jcarlos.vale (9653 in chips) 
Seat 4: chekmpcc (16771 in chips) 
Seat 5: mariafirmina (4074 in chips) 
Seat 6: ikfold2 (4550 in chips) 
Seat 7: ddurikkt (17785 in chips) 
Seat 8: dtl15 (10932 in chips) 
Seat 9: JANAÍNA13 (3066 in chips) 
csabipapa1: posts the ante 20
1993544: posts the ante 20
jcarlos.vale: posts the ante 20
chekmpcc: posts the ante 20
mariafirmina: posts the ante 20
ikfold2: posts the ante 20
ddurikkt: posts the ante 20
dtl15: posts the ante 20
JANAÍNA13: posts the ante 20
dtl15: posts small blind 125
JANAÍNA13: posts big blind 250
*** HOLE CARDS ***
Dealt to jcarlos.vale [5c 9s]
csabipapa1: raises 500 to 750
1993544: folds 
jcarlos.vale: folds 
chekmpcc: raises 1500 to 2250
mariafirmina: folds 
ikfold2: folds 
ddurikkt: folds 
dtl15: folds 
JANAÍNA13: folds 
csabipapa1: folds 
Uncalled bet (1500) returned to chekmpcc
chekmpcc collected 2055 from pot
*** SUMMARY ***
Total pot 2055 | Rake 0 
Seat 1: csabipapa1 folded before Flop
Seat 2: 1993544 folded before Flop (didn't bet)
Seat 3: jcarlos.vale folded before Flop (didn't bet)
Seat 4: chekmpcc collected (2055)
Seat 5: mariafirmina folded before Flop (didn't bet)
Seat 6: ikfold2 folded before Flop (didn't bet)
Seat 7: ddurikkt (button) folded before Flop (didn't bet)
Seat 8: dtl15 (small blind) folded before Flop
Seat 9: JANAÍNA13 (big blind) folded before Flop



PokerStars Hand #222149713301: Tournament #3086083919, $0.49+$0.06 USD Hold'em No Limit - Level X (125/250) - 2021/01/02 22:39:03 EET [2021/01/02 15:39:03 ET]
Table '3086083919 46' 9-max Seat #8 is the button
Seat 1: csabipapa1 (16211 in chips) 
Seat 2: 1993544 (12867 in chips) 
Seat 3: jcarlos.vale (9633 in chips) 
Seat 4: chekmpcc (18056 in chips) 
Seat 5: mariafirmina (4054 in chips) 
Seat 6: ikfold2 (4530 in chips) 
Seat 7: ddurikkt (17765 in chips) 
Seat 8: dtl15 (10787 in chips) 
Seat 9: JANAÍNA13 (2796 in chips) 
csabipapa1: posts the ante 20
1993544: posts the ante 20
jcarlos.vale: posts the ante 20
chekmpcc: posts the ante 20
mariafirmina: posts the ante 20
ikfold2: posts the ante 20
ddurikkt: posts the ante 20
dtl15: posts the ante 20
JANAÍNA13: posts the ante 20
JANAÍNA13: posts small blind 125
csabipapa1: posts big blind 250
*** HOLE CARDS ***
Dealt to jcarlos.vale [6c 3d]
1993544: folds 
jcarlos.vale: folds 
chekmpcc: folds 
mariafirmina has timed out
mariafirmina: folds 
mariafirmina is sitting out
ikfold2: folds 
ddurikkt: folds 
dtl15: folds 
JANAÍNA13: folds 
Uncalled bet (125) returned to csabipapa1
csabipapa1 collected 430 from pot
csabipapa1: doesn't show handDTO
*** SUMMARY ***
Total pot 430 | Rake 0 
Seat 1: csabipapa1 (big blind) collected (430)
Seat 2: 1993544 folded before Flop (didn't bet)
Seat 3: jcarlos.vale folded before Flop (didn't bet)
Seat 4: chekmpcc folded before Flop (didn't bet)
Seat 5: mariafirmina folded before Flop (didn't bet)
Seat 6: ikfold2 folded before Flop (didn't bet)
Seat 7: ddurikkt folded before Flop (didn't bet)
Seat 8: dtl15 (button) folded before Flop (didn't bet)
Seat 9: JANAÍNA13 (small blind) folded before Flop



PokerStars Hand #222149762281: Tournament #3086083919, $0.49+$0.06 USD Hold'em No Limit - Level X (125/250) - 2021/01/02 22:39:52 EET [2021/01/02 15:39:52 ET]
Table '3086083919 46' 9-max Seat #9 is the button
Seat 1: csabipapa1 (16496 in chips) 
Seat 2: 1993544 (12847 in chips) 
Seat 3: jcarlos.vale (9613 in chips) 
Seat 4: chekmpcc (18036 in chips) 
Seat 5: mariafirmina (4034 in chips) is sitting out
Seat 6: ikfold2 (4510 in chips) 
Seat 7: ddurikkt (17745 in chips) 
Seat 8: dtl15 (10767 in chips) 
Seat 9: JANAÍNA13 (2651 in chips) 
csabipapa1: posts the ante 20
1993544: posts the ante 20
jcarlos.vale: posts the ante 20
chekmpcc: posts the ante 20
mariafirmina: posts the ante 20
ikfold2: posts the ante 20
ddurikkt: posts the ante 20
dtl15: posts the ante 20
JANAÍNA13: posts the ante 20
csabipapa1: posts small blind 125
1993544: posts big blind 250
*** HOLE CARDS ***
Dealt to jcarlos.vale [Kd 9c]
jcarlos.vale: folds 
chekmpcc: folds 
mariafirmina: folds 
ikfold2: calls 250
ddurikkt: folds 
dtl15: folds 
JANAÍNA13: folds 
mariafirmina has returned
csabipapa1: calls 125
1993544: raises 500 to 750
ikfold2: calls 500
csabipapa1: folds 
*** FLOP *** [2c 6d Qh]
1993544: bets 965
ikfold2: raises 2775 to 3740 and is all-in
1993544: calls 2775
*** TURN *** [2c 6d Qh] [3c]
*** RIVER *** [2c 6d Qh 3c] [9h]
*** SHOW DOWN ***
1993544: shows [7s 7c] (a pair of Sevens)
ikfold2: shows [Qs Kh] (a pair of Queens)
ikfold2 collected 9410 from pot
*** SUMMARY ***
Total pot 9410 | Rake 0 
Board [2c 6d Qh 3c 9h]
Seat 1: csabipapa1 (small blind) folded before Flop
Seat 2: 1993544 (big blind) showed [7s 7c] and lost with a pair of Sevens
Seat 3: jcarlos.vale folded before Flop (didn't bet)
Seat 4: chekmpcc folded before Flop (didn't bet)
Seat 5: mariafirmina folded before Flop (didn't bet)
Seat 6: ikfold2 showed [Qs Kh] and won (9410) with a pair of Queens
Seat 7: ddurikkt folded before Flop (didn't bet)
Seat 8: dtl15 folded before Flop (didn't bet)
Seat 9: JANAÍNA13 (button) folded before Flop (didn't bet)



PokerStars Hand #222149806727: Tournament #3086083919, $0.49+$0.06 USD Hold'em No Limit - Level X (125/250) - 2021/01/02 22:40:36 EET [2021/01/02 15:40:36 ET]
Table '3086083919 46' 9-max Seat #1 is the button
Seat 1: csabipapa1 (16226 in chips) 
Seat 2: 1993544 (8337 in chips) 
Seat 3: jcarlos.vale (9593 in chips) 
Seat 4: chekmpcc (18016 in chips) 
Seat 5: mariafirmina (4014 in chips) 
Seat 6: ikfold2 (9410 in chips) 
Seat 7: ddurikkt (17725 in chips) 
Seat 8: dtl15 (10747 in chips) 
Seat 9: JANAÍNA13 (2631 in chips) 
csabipapa1: posts the ante 20
1993544: posts the ante 20
jcarlos.vale: posts the ante 20
chekmpcc: posts the ante 20
mariafirmina: posts the ante 20
ikfold2: posts the ante 20
ddurikkt: posts the ante 20
dtl15: posts the ante 20
JANAÍNA13: posts the ante 20
1993544: posts small blind 125
jcarlos.vale: posts big blind 250
*** HOLE CARDS ***
Dealt to jcarlos.vale [4s 4h]
chekmpcc: folds 
mariafirmina: calls 250
ikfold2: folds 
ddurikkt: folds 
dtl15: folds 
JANAÍNA13: raises 2361 to 2611 and is all-in
csabipapa1: folds 
1993544: folds 
jcarlos.vale: folds 
mariafirmina: folds 
Uncalled bet (2361) returned to JANAÍNA13
JANAÍNA13 collected 1055 from pot
JANAÍNA13: doesn't show handDTO
*** SUMMARY ***
Total pot 1055 | Rake 0 
Seat 1: csabipapa1 (button) folded before Flop (didn't bet)
Seat 2: 1993544 (small blind) folded before Flop
Seat 3: jcarlos.vale (big blind) folded before Flop
Seat 4: chekmpcc folded before Flop (didn't bet)
Seat 5: mariafirmina folded before Flop
Seat 6: ikfold2 folded before Flop (didn't bet)
Seat 7: ddurikkt folded before Flop (didn't bet)
Seat 8: dtl15 folded before Flop (didn't bet)
Seat 9: JANAÍNA13 collected (1055)



PokerStars Hand #222149829982: Tournament #3086083919, $0.49+$0.06 USD Hold'em No Limit - Level X (125/250) - 2021/01/02 22:41:00 EET [2021/01/02 15:41:00 ET]
Table '3086083919 46' 9-max Seat #2 is the button
Seat 1: csabipapa1 (16206 in chips) 
Seat 2: 1993544 (8192 in chips) 
Seat 3: jcarlos.vale (9323 in chips) 
Seat 5: mariafirmina (3744 in chips) 
Seat 6: ikfold2 (9390 in chips) 
Seat 7: ddurikkt (17705 in chips) 
Seat 8: dtl15 (10727 in chips) 
Seat 9: JANAÍNA13 (3416 in chips) 
csabipapa1: posts the ante 20
1993544: posts the ante 20
jcarlos.vale: posts the ante 20
mariafirmina: posts the ante 20
ikfold2: posts the ante 20
ddurikkt: posts the ante 20
dtl15: posts the ante 20
JANAÍNA13: posts the ante 20
jcarlos.vale: posts small blind 125
mariafirmina: posts big blind 250
*** HOLE CARDS ***
Dealt to jcarlos.vale [5d 8s]
ikfold2: folds 
ddurikkt: raises 275 to 525
dtl15: calls 525
JANAÍNA13: folds 
csabipapa1: folds 
1993544: folds 
jcarlos.vale: folds 
mariafirmina: raises 275 to 800
ddurikkt: calls 275
dtl15: calls 275
*** FLOP *** [Qs 9s 4d]
mariafirmina: bets 1343
ddurikkt: folds 
dtl15: folds 
Uncalled bet (1343) returned to mariafirmina
mariafirmina collected 2685 from pot
*** SUMMARY ***
Total pot 2685 | Rake 0 
Board [Qs 9s 4d]
Seat 1: csabipapa1 folded before Flop (didn't bet)
Seat 2: 1993544 (button) folded before Flop (didn't bet)
Seat 3: jcarlos.vale (small blind) folded before Flop
Seat 5: mariafirmina (big blind) collected (2685)
Seat 6: ikfold2 folded before Flop (didn't bet)
Seat 7: ddurikkt folded on the Flop
Seat 8: dtl15 folded on the Flop
Seat 9: JANAÍNA13 folded before Flop (didn't bet)



PokerStars Hand #222149874130: Tournament #3086083919, $0.49+$0.06 USD Hold'em No Limit - Level X (125/250) - 2021/01/02 22:41:44 EET [2021/01/02 15:41:44 ET]
Table '3086083919 46' 9-max Seat #3 is the button
Seat 1: csabipapa1 (16186 in chips) 
Seat 2: 1993544 (8172 in chips) 
Seat 3: jcarlos.vale (9178 in chips) 
Seat 4: KennyTurc (5000 in chips) out of handDTO (moved from another table into small blind)
Seat 5: mariafirmina (5609 in chips) 
Seat 6: ikfold2 (9370 in chips) 
Seat 7: ddurikkt (16885 in chips) 
Seat 8: dtl15 (9907 in chips) 
Seat 9: JANAÍNA13 (3396 in chips) 
KennyTurc will be allowed to play after the button
csabipapa1: posts the ante 20
1993544: posts the ante 20
jcarlos.vale: posts the ante 20
mariafirmina: posts the ante 20
ikfold2: posts the ante 20
ddurikkt: posts the ante 20
dtl15: posts the ante 20
JANAÍNA13: posts the ante 20
mariafirmina: posts small blind 125
ikfold2: posts big blind 250
*** HOLE CARDS ***
Dealt to jcarlos.vale [Kc Ah]
ddurikkt: folds 
dtl15: folds 
JANAÍNA13: folds 
csabipapa1: folds 
1993544: folds 
jcarlos.vale: raises 400 to 650
mariafirmina: folds 
ikfold2: folds 
Uncalled bet (400) returned to jcarlos.vale
jcarlos.vale collected 785 from pot
jcarlos.vale: doesn't show handDTO
*** SUMMARY ***
Total pot 785 | Rake 0 
Seat 1: csabipapa1 folded before Flop (didn't bet)
Seat 2: 1993544 folded before Flop (didn't bet)
Seat 3: jcarlos.vale (button) collected (785)
Seat 5: mariafirmina (small blind) folded before Flop
Seat 6: ikfold2 (big blind) folded before Flop
Seat 7: ddurikkt folded before Flop (didn't bet)
Seat 8: dtl15 folded before Flop (didn't bet)
Seat 9: JANAÍNA13 folded before Flop (didn't bet)



PokerStars Hand #222149896624: Tournament #3086083919, $0.49+$0.06 USD Hold'em No Limit - Level X (125/250) - 2021/01/02 22:42:07 EET [2021/01/02 15:42:07 ET]
Table '3086083919 46' 9-max Seat #5 is the button
Seat 1: csabipapa1 (16166 in chips) 
Seat 2: 1993544 (8152 in chips) 
Seat 3: jcarlos.vale (9693 in chips) 
Seat 4: KennyTurc (5000 in chips) 
Seat 5: mariafirmina (5464 in chips) 
Seat 6: ikfold2 (9100 in chips) 
Seat 7: ddurikkt (16865 in chips) 
Seat 8: dtl15 (9887 in chips) 
Seat 9: JANAÍNA13 (3376 in chips) 
csabipapa1: posts the ante 20
1993544: posts the ante 20
jcarlos.vale: posts the ante 20
KennyTurc: posts the ante 20
mariafirmina: posts the ante 20
ikfold2: posts the ante 20
ddurikkt: posts the ante 20
dtl15: posts the ante 20
JANAÍNA13: posts the ante 20
ikfold2: posts small blind 125
ddurikkt: posts big blind 250
*** HOLE CARDS ***
Dealt to jcarlos.vale [4s 3h]
dtl15: folds 
JANAÍNA13: raises 3106 to 3356 and is all-in
csabipapa1: folds 
1993544: folds 
jcarlos.vale: folds 
KennyTurc: folds 
mariafirmina has timed out
mariafirmina: folds 
mariafirmina is sitting out
ikfold2: folds 
ddurikkt: folds 
Uncalled bet (3106) returned to JANAÍNA13
JANAÍNA13 collected 805 from pot
JANAÍNA13: doesn't show handDTO
*** SUMMARY ***
Total pot 805 | Rake 0 
Seat 1: csabipapa1 folded before Flop (didn't bet)
Seat 2: 1993544 folded before Flop (didn't bet)
Seat 3: jcarlos.vale folded before Flop (didn't bet)
Seat 4: KennyTurc folded before Flop (didn't bet)
Seat 5: mariafirmina (button) folded before Flop (didn't bet)
Seat 6: ikfold2 (small blind) folded before Flop
Seat 7: ddurikkt (big blind) folded before Flop
Seat 8: dtl15 folded before Flop (didn't bet)
Seat 9: JANAÍNA13 collected (805)



PokerStars Hand #222149933488: Tournament #3086083919, $0.49+$0.06 USD Hold'em No Limit - Level X (125/250) - 2021/01/02 22:42:44 EET [2021/01/02 15:42:44 ET]
Table '3086083919 46' 9-max Seat #6 is the button
Seat 1: csabipapa1 (16146 in chips) 
Seat 2: 1993544 (8132 in chips) 
Seat 3: jcarlos.vale (9673 in chips) 
Seat 4: KennyTurc (4980 in chips) 
Seat 5: mariafirmina (5444 in chips) is sitting out
Seat 6: ikfold2 (8955 in chips) 
Seat 7: ddurikkt (16595 in chips) 
Seat 8: dtl15 (9867 in chips) 
Seat 9: JANAÍNA13 (3911 in chips) 
csabipapa1: posts the ante 20
1993544: posts the ante 20
jcarlos.vale: posts the ante 20
KennyTurc: posts the ante 20
mariafirmina: posts the ante 20
ikfold2: posts the ante 20
ddurikkt: posts the ante 20
dtl15: posts the ante 20
JANAÍNA13: posts the ante 20
ddurikkt: posts small blind 125
dtl15: posts big blind 250
*** HOLE CARDS ***
Dealt to jcarlos.vale [3h 8d]
JANAÍNA13: folds 
csabipapa1: folds 
1993544: folds 
jcarlos.vale: folds 
KennyTurc: calls 250
mariafirmina: folds 
ikfold2: raises 500 to 750
ddurikkt: folds 
dtl15: calls 500
mariafirmina has returned
KennyTurc: calls 500
*** FLOP *** [Qd Qc Jc]
dtl15: checks 
KennyTurc: checks 
ikfold2: bets 1277
dtl15: calls 1277
KennyTurc: folds 
*** TURN *** [Qd Qc Jc] [7c]
dtl15: checks 
ikfold2: checks 
*** RIVER *** [Qd Qc Jc 7c] [7h]
dtl15: checks 
ikfold2: checks 
*** SHOW DOWN ***
dtl15: shows [6h 6s] (two pair, Queens and Sevens)
ikfold2: shows [Ks As] (two pair, Queens and Sevens - Ace kicker)
ikfold2 collected 5109 from pot
*** SUMMARY ***
Total pot 5109 | Rake 0 
Board [Qd Qc Jc 7c 7h]
Seat 1: csabipapa1 folded before Flop (didn't bet)
Seat 2: 1993544 folded before Flop (didn't bet)
Seat 3: jcarlos.vale folded before Flop (didn't bet)
Seat 4: KennyTurc folded on the Flop
Seat 5: mariafirmina folded before Flop (didn't bet)
Seat 6: ikfold2 (button) showed [Ks As] and won (5109) with two pair, Queens and Sevens
Seat 7: ddurikkt (small blind) folded before Flop
Seat 8: dtl15 (big blind) showed [6h 6s] and lost with two pair, Queens and Sevens
Seat 9: JANAÍNA13 folded before Flop (didn't bet)



PokerStars Hand #222149990013: Tournament #3086083919, $0.49+$0.06 USD Hold'em No Limit - Level X (125/250) - 2021/01/02 22:43:42 EET [2021/01/02 15:43:42 ET]
Table '3086083919 46' 9-max Seat #7 is the button
Seat 1: csabipapa1 (16126 in chips) 
Seat 2: 1993544 (8112 in chips) 
Seat 3: jcarlos.vale (9653 in chips) 
Seat 4: KennyTurc (4210 in chips) 
Seat 5: mariafirmina (5424 in chips) 
Seat 6: ikfold2 (12017 in chips) 
Seat 7: ddurikkt (16450 in chips) 
Seat 8: dtl15 (7820 in chips) 
csabipapa1: posts the ante 20
1993544: posts the ante 20
jcarlos.vale: posts the ante 20
KennyTurc: posts the ante 20
mariafirmina: posts the ante 20
ikfold2: posts the ante 20
ddurikkt: posts the ante 20
dtl15: posts the ante 20
dtl15: posts small blind 125
csabipapa1: posts big blind 250
*** HOLE CARDS ***
Dealt to jcarlos.vale [4c Ah]
1993544: raises 500 to 750
jcarlos.vale: folds 
KennyTurc: folds 
mariafirmina: folds 
ikfold2: folds 
ddurikkt: folds 
dtl15: folds 
csabipapa1: calls 500
*** FLOP *** [Jd 2c 4h]
csabipapa1: checks 
1993544: bets 893
csabipapa1: calls 893
*** TURN *** [Jd 2c 4h] [Jh]
csabipapa1: checks 
1993544: bets 1786
csabipapa1: calls 1786
*** RIVER *** [Jd 2c 4h Jh] [Ts]
csabipapa1: checks 
1993544: bets 4663 and is all-in
csabipapa1: folds 
Uncalled bet (4663) returned to 1993544
1993544 collected 7143 from pot
1993544: doesn't show handDTO
*** SUMMARY ***
Total pot 7143 | Rake 0 
Board [Jd 2c 4h Jh Ts]
Seat 1: csabipapa1 (big blind) folded on the River
Seat 2: 1993544 collected (7143)
Seat 3: jcarlos.vale folded before Flop (didn't bet)
Seat 4: KennyTurc folded before Flop (didn't bet)
Seat 5: mariafirmina folded before Flop (didn't bet)
Seat 6: ikfold2 folded before Flop (didn't bet)
Seat 7: ddurikkt (button) folded before Flop (didn't bet)
Seat 8: dtl15 (small blind) folded before Flop



PokerStars Hand #222150034619: Tournament #3086083919, $0.49+$0.06 USD Hold'em No Limit - Level X (125/250) - 2021/01/02 22:44:28 EET [2021/01/02 15:44:28 ET]
Table '3086083919 46' 9-max Seat #8 is the button
Seat 1: csabipapa1 (12677 in chips) 
Seat 2: 1993544 (11806 in chips) 
Seat 3: jcarlos.vale (9633 in chips) 
Seat 4: KennyTurc (4190 in chips) 
Seat 5: mariafirmina (5404 in chips) 
Seat 6: ikfold2 (11997 in chips) 
Seat 7: ddurikkt (16430 in chips) 
Seat 8: dtl15 (7675 in chips) 
Seat 9: GraniniOrange (5000 in chips) out of handDTO (moved from another table into small blind)
GraniniOrange will be allowed to play after the button
csabipapa1: posts the ante 20
1993544: posts the ante 20
jcarlos.vale: posts the ante 20
KennyTurc: posts the ante 20
mariafirmina: posts the ante 20
ikfold2: posts the ante 20
ddurikkt: posts the ante 20
dtl15: posts the ante 20
csabipapa1: posts small blind 125
1993544: posts big blind 250
*** HOLE CARDS ***
Dealt to jcarlos.vale [8d Ks]
jcarlos.vale: folds 
KennyTurc: folds 
mariafirmina has timed out
mariafirmina: folds 
mariafirmina is sitting out
ikfold2: folds 
ddurikkt: folds 
dtl15: folds 
csabipapa1: raises 660 to 910
1993544: folds 
Uncalled bet (660) returned to csabipapa1
csabipapa1 collected 660 from pot
csabipapa1: doesn't show handDTO
*** SUMMARY ***
Total pot 660 | Rake 0 
Seat 1: csabipapa1 (small blind) collected (660)
Seat 2: 1993544 (big blind) folded before Flop
Seat 3: jcarlos.vale folded before Flop (didn't bet)
Seat 4: KennyTurc folded before Flop (didn't bet)
Seat 5: mariafirmina folded before Flop (didn't bet)
Seat 6: ikfold2 folded before Flop (didn't bet)
Seat 7: ddurikkt folded before Flop (didn't bet)
Seat 8: dtl15 (button) folded before Flop (didn't bet)



PokerStars Hand #222150068114: Tournament #3086083919, $0.49+$0.06 USD Hold'em No Limit - Level X (125/250) - 2021/01/02 22:45:02 EET [2021/01/02 15:45:02 ET]
Table '3086083919 46' 9-max Seat #1 is the button
Seat 1: csabipapa1 (13067 in chips) 
Seat 2: 1993544 (11536 in chips) 
Seat 3: jcarlos.vale (9613 in chips) 
Seat 4: KennyTurc (4170 in chips) 
Seat 5: mariafirmina (5384 in chips) is sitting out
Seat 6: ikfold2 (11977 in chips) 
Seat 7: ddurikkt (16410 in chips) 
Seat 8: dtl15 (7655 in chips) 
Seat 9: GraniniOrange (5000 in chips) 
csabipapa1: posts the ante 20
1993544: posts the ante 20
jcarlos.vale: posts the ante 20
KennyTurc: posts the ante 20
mariafirmina: posts the ante 20
ikfold2: posts the ante 20
ddurikkt: posts the ante 20
dtl15: posts the ante 20
GraniniOrange: posts the ante 20
1993544: posts small blind 125
jcarlos.vale: posts big blind 250
*** HOLE CARDS ***
Dealt to jcarlos.vale [4h 6c]
KennyTurc: folds 
mariafirmina: folds 
ikfold2: folds 
ddurikkt: folds 
dtl15: folds 
GraniniOrange: calls 250
csabipapa1: calls 250
1993544: calls 125
jcarlos.vale: checks 
*** FLOP *** [Ts Ad As]
1993544: checks 
jcarlos.vale: checks 
GraniniOrange: checks 
mariafirmina has returned
csabipapa1: checks 
*** TURN *** [Ts Ad As] [Kh]
1993544: checks 
jcarlos.vale: checks 
GraniniOrange: bets 1500
csabipapa1: calls 1500
1993544: folds 
jcarlos.vale has timed out
jcarlos.vale: folds 
jcarlos.vale is sitting out
*** RIVER *** [Ts Ad As Kh] [3c]
GraniniOrange: bets 3230 and is all-in
csabipapa1: calls 3230
*** SHOW DOWN ***
GraniniOrange: shows [Kc 9d] (two pair, Aces and Kings)
csabipapa1: shows [Ah 4d] (three of a kind, Aces)
csabipapa1 collected 10640 from pot
GraniniOrange finished the tournament in 1557th place
*** SUMMARY ***
Total pot 10640 | Rake 0 
Board [Ts Ad As Kh 3c]
Seat 1: csabipapa1 (button) showed [Ah 4d] and won (10640) with three of a kind, Aces
Seat 2: 1993544 (small blind) folded on the Turn
Seat 3: jcarlos.vale (big blind) folded on the Turn
Seat 4: KennyTurc folded before Flop (didn't bet)
Seat 5: mariafirmina folded before Flop (didn't bet)
Seat 6: ikfold2 folded before Flop (didn't bet)
Seat 7: ddurikkt folded before Flop (didn't bet)
Seat 8: dtl15 folded before Flop (didn't bet)
Seat 9: GraniniOrange showed [Kc 9d] and lost with two pair, Aces and Kings



PokerStars Hand #222150174529: Tournament #3086083919, $0.49+$0.06 USD Hold'em No Limit - Level X (125/250) - 2021/01/02 22:46:51 EET [2021/01/02 15:46:51 ET]
Table '3086083919 46' 9-max Seat #2 is the button
Seat 1: csabipapa1 (18707 in chips) 
Seat 2: 1993544 (11266 in chips) 
Seat 3: jcarlos.vale (9343 in chips) is sitting out
Seat 4: KennyTurc (4150 in chips) 
Seat 5: mariafirmina (5364 in chips) 
Seat 6: ikfold2 (11957 in chips) 
Seat 7: ddurikkt (16390 in chips) 
Seat 8: dtl15 (7635 in chips) 
csabipapa1: posts the ante 20
1993544: posts the ante 20
jcarlos.vale: posts the ante 20
KennyTurc: posts the ante 20
mariafirmina: posts the ante 20
ikfold2: posts the ante 20
ddurikkt: posts the ante 20
dtl15: posts the ante 20
jcarlos.vale: posts small blind 125
KennyTurc: posts big blind 250
*** HOLE CARDS ***
Dealt to jcarlos.vale [As 4h]
mariafirmina: folds 
ikfold2: folds 
ddurikkt: raises 275 to 525
dtl15: folds 
csabipapa1: folds 
1993544: raises 275 to 800
jcarlos.vale: folds 
KennyTurc: calls 550
ddurikkt: calls 275
*** FLOP *** [6c 7h Ac]
jcarlos.vale has returned
KennyTurc: bets 2685
ddurikkt: folds 
1993544: folds 
Uncalled bet (2685) returned to KennyTurc
KennyTurc collected 2685 from pot
*** SUMMARY ***
Total pot 2685 | Rake 0 
Board [6c 7h Ac]
Seat 1: csabipapa1 folded before Flop (didn't bet)
Seat 2: 1993544 (button) folded on the Flop
Seat 3: jcarlos.vale (small blind) folded before Flop
Seat 4: KennyTurc (big blind) collected (2685)
Seat 5: mariafirmina folded before Flop (didn't bet)
Seat 6: ikfold2 folded before Flop (didn't bet)
Seat 7: ddurikkt folded on the Flop
Seat 8: dtl15 folded before Flop (didn't bet)



PokerStars Hand #222150219791: Tournament #3086083919, $0.49+$0.06 USD Hold'em No Limit - Level X (125/250) - 2021/01/02 22:47:37 EET [2021/01/02 15:47:37 ET]
Table '3086083919 46' 9-max Seat #3 is the button
Seat 1: csabipapa1 (18687 in chips) 
Seat 2: 1993544 (10446 in chips) 
Seat 3: jcarlos.vale (9198 in chips) 
Seat 4: KennyTurc (6015 in chips) 
Seat 5: mariafirmina (5344 in chips) 
Seat 6: ikfold2 (11937 in chips) 
Seat 7: ddurikkt (15570 in chips) 
Seat 8: dtl15 (7615 in chips) 
Seat 9: KKNA601 (20136 in chips) 
csabipapa1: posts the ante 20
1993544: posts the ante 20
jcarlos.vale: posts the ante 20
KennyTurc: posts the ante 20
mariafirmina: posts the ante 20
ikfold2: posts the ante 20
ddurikkt: posts the ante 20
dtl15: posts the ante 20
KKNA601: posts the ante 20
KennyTurc: posts small blind 125
mariafirmina: posts big blind 250
*** HOLE CARDS ***
Dealt to jcarlos.vale [Ac As]
ikfold2: folds 
ddurikkt: raises 275 to 525
dtl15: folds 
KKNA601: calls 525
csabipapa1: folds 
1993544: folds 
jcarlos.vale: raises 725 to 1250
KennyTurc: calls 1125
mariafirmina: folds 
ddurikkt: calls 725
KKNA601: calls 725
*** FLOP *** [4c 5h Ad]
KennyTurc: checks 
ddurikkt: bets 1792
KKNA601: folds 
jcarlos.vale: raises 1958 to 3750
KennyTurc: folds 
ddurikkt: raises 10550 to 14300 and is all-in
jcarlos.vale: calls 4178 and is all-in
Uncalled bet (6372) returned to ddurikkt
*** TURN *** [4c 5h Ad] [8d]
*** RIVER *** [4c 5h Ad 8d] [8s]
*** SHOW DOWN ***
ddurikkt: shows [Ts Ah] (two pair, Aces and Eights)
jcarlos.vale: shows [Ac As] (a full house, Aces full of Eights)
jcarlos.vale collected 21286 from pot
*** SUMMARY ***
Total pot 21286 | Rake 0 
Board [4c 5h Ad 8d 8s]
Seat 1: csabipapa1 folded before Flop (didn't bet)
Seat 2: 1993544 folded before Flop (didn't bet)
Seat 3: jcarlos.vale (button) showed [Ac As] and won (21286) with a full house, Aces full of Eights
Seat 4: KennyTurc (small blind) folded on the Flop
Seat 5: mariafirmina (big blind) folded before Flop
Seat 6: ikfold2 folded before Flop (didn't bet)
Seat 7: ddurikkt showed [Ts Ah] and lost with two pair, Aces and Eights
Seat 8: dtl15 folded before Flop (didn't bet)
Seat 9: KKNA601 folded on the Flop



PokerStars Hand #222150299595: Tournament #3086083919, $0.49+$0.06 USD Hold'em No Limit - Level XI (150/300) - 2021/01/02 22:49:00 EET [2021/01/02 15:49:00 ET]
Table '3086083919 46' 9-max Seat #4 is the button
Seat 1: csabipapa1 (18667 in chips) 
Seat 2: 1993544 (10426 in chips) 
Seat 3: jcarlos.vale (21286 in chips) 
Seat 4: KennyTurc (4745 in chips) 
Seat 5: mariafirmina (5074 in chips) 
Seat 6: ikfold2 (11917 in chips) 
Seat 7: ddurikkt (6372 in chips) 
Seat 8: dtl15 (7595 in chips) 
Seat 9: KKNA601 (18866 in chips) 
csabipapa1: posts the ante 22
1993544: posts the ante 22
jcarlos.vale: posts the ante 22
KennyTurc: posts the ante 22
mariafirmina: posts the ante 22
ikfold2: posts the ante 22
ddurikkt: posts the ante 22
dtl15: posts the ante 22
KKNA601: posts the ante 22
mariafirmina: posts small blind 150
ikfold2: posts big blind 300
*** HOLE CARDS ***
Dealt to jcarlos.vale [3h 6s]
ddurikkt: raises 330 to 630
dtl15: folds 
KKNA601: raises 1908 to 2538
csabipapa1: folds 
1993544: folds 
jcarlos.vale: folds 
KennyTurc: folds 
mariafirmina: folds 
ikfold2: folds 
ddurikkt: raises 3812 to 6350 and is all-in
KKNA601: calls 3812
*** FLOP *** [Ac 5d 3d]
*** TURN *** [Ac 5d 3d] [Kc]
*** RIVER *** [Ac 5d 3d Kc] [8h]
*** SHOW DOWN ***
ddurikkt: shows [Jd As] (a pair of Aces)
KKNA601: shows [Ad Qd] (a pair of Aces - King+Queen kicker)
KKNA601 collected 13348 from pot
ddurikkt finished the tournament in 1461st place
*** SUMMARY ***
Total pot 13348 | Rake 0 
Board [Ac 5d 3d Kc 8h]
Seat 1: csabipapa1 folded before Flop (didn't bet)
Seat 2: 1993544 folded before Flop (didn't bet)
Seat 3: jcarlos.vale folded before Flop (didn't bet)
Seat 4: KennyTurc (button) folded before Flop (didn't bet)
Seat 5: mariafirmina (small blind) folded before Flop
Seat 6: ikfold2 (big blind) folded before Flop
Seat 7: ddurikkt showed [Jd As] and lost with a pair of Aces
Seat 8: dtl15 folded before Flop (didn't bet)
Seat 9: KKNA601 showed [Ad Qd] and won (13348) with a pair of Aces



PokerStars Hand #222150332698: Tournament #3086083919, $0.49+$0.06 USD Hold'em No Limit - Level XI (150/300) - 2021/01/02 22:49:34 EET [2021/01/02 15:49:34 ET]
Table '3086083919 46' 9-max Seat #5 is the button
Seat 1: csabipapa1 (18645 in chips) 
Seat 2: 1993544 (10404 in chips) 
Seat 3: jcarlos.vale (21264 in chips) 
Seat 4: KennyTurc (4723 in chips) 
Seat 5: mariafirmina (4902 in chips) 
Seat 6: ikfold2 (11595 in chips) 
Seat 8: dtl15 (7573 in chips) 
Seat 9: KKNA601 (25842 in chips) 
csabipapa1: posts the ante 22
1993544: posts the ante 22
jcarlos.vale: posts the ante 22
KennyTurc: posts the ante 22
mariafirmina: posts the ante 22
ikfold2: posts the ante 22
dtl15: posts the ante 22
KKNA601: posts the ante 22
ikfold2: posts small blind 150
dtl15: posts big blind 300
*** HOLE CARDS ***
Dealt to jcarlos.vale [6d Kd]
KKNA601: folds 
csabipapa1: folds 
1993544: raises 600 to 900
jcarlos.vale: folds 
KennyTurc: calls 900
mariafirmina: calls 900
ikfold2: calls 750
dtl15: folds 
*** FLOP *** [5c 2d 4s]
ikfold2: checks 
1993544: checks 
KennyTurc: bets 3801 and is all-in
mariafirmina: folds 
ikfold2: folds 
1993544: calls 3801
*** TURN *** [5c 2d 4s] [8d]
*** RIVER *** [5c 2d 4s 8d] [6s]
*** SHOW DOWN ***
1993544: shows [As 9h] (high pairOfCards Ace)
KennyTurc: shows [4c Qc] (a pair of Fours)
KennyTurc collected 11678 from pot
*** SUMMARY ***
Total pot 11678 | Rake 0 
Board [5c 2d 4s 8d 6s]
Seat 1: csabipapa1 folded before Flop (didn't bet)
Seat 2: 1993544 showed [As 9h] and lost with high pairOfCards Ace
Seat 3: jcarlos.vale folded before Flop (didn't bet)
Seat 4: KennyTurc showed [4c Qc] and won (11678) with a pair of Fours
Seat 5: mariafirmina (button) folded on the Flop
Seat 6: ikfold2 (small blind) folded on the Flop
Seat 8: dtl15 (big blind) folded before Flop
Seat 9: KKNA601 folded before Flop (didn't bet)



PokerStars Hand #222150371185: Tournament #3086083919, $0.49+$0.06 USD Hold'em No Limit - Level XI (150/300) - 2021/01/02 22:50:14 EET [2021/01/02 15:50:14 ET]
Table '3086083919 46' 9-max Seat #6 is the button
Seat 1: csabipapa1 (18623 in chips) 
Seat 2: 1993544 (5681 in chips) 
Seat 3: jcarlos.vale (21242 in chips) 
Seat 4: KennyTurc (11678 in chips) 
Seat 6: ikfold2 (10673 in chips) 
Seat 7: BaronVonBong (7398 in chips) out of handDTO (moved from another table into small blind)
Seat 8: dtl15 (7251 in chips) 
Seat 9: KKNA601 (25820 in chips) 
BaronVonBong will be allowed to play after the button
csabipapa1: posts the ante 22
1993544: posts the ante 22
jcarlos.vale: posts the ante 22
KennyTurc: posts the ante 22
ikfold2: posts the ante 22
dtl15: posts the ante 22
KKNA601: posts the ante 22
dtl15: posts small blind 150
KKNA601: posts big blind 300
*** HOLE CARDS ***
Dealt to jcarlos.vale [Tc Js]
csabipapa1: folds 
1993544: folds 
jcarlos.vale: folds 
KennyTurc: folds 
ikfold2: folds 
dtl15: raises 600 to 900
KKNA601: calls 600
*** FLOP *** [9h 9c 2d]
dtl15: bets 1954
KKNA601: folds 
Uncalled bet (1954) returned to dtl15
dtl15 collected 1954 from pot
dtl15: doesn't show handDTO
*** SUMMARY ***
Total pot 1954 | Rake 0 
Board [9h 9c 2d]
Seat 1: csabipapa1 folded before Flop (didn't bet)
Seat 2: 1993544 folded before Flop (didn't bet)
Seat 3: jcarlos.vale folded before Flop (didn't bet)
Seat 4: KennyTurc folded before Flop (didn't bet)
Seat 6: ikfold2 (button) folded before Flop (didn't bet)
Seat 8: dtl15 (small blind) collected (1954)
Seat 9: KKNA601 (big blind) folded on the Flop



PokerStars Hand #222150399409: Tournament #3086083919, $0.49+$0.06 USD Hold'em No Limit - Level XI (150/300) - 2021/01/02 22:50:43 EET [2021/01/02 15:50:43 ET]
Table '3086083919 46' 9-max Seat #8 is the button
Seat 1: csabipapa1 (18601 in chips) 
Seat 2: 1993544 (5659 in chips) 
Seat 3: jcarlos.vale (21220 in chips) 
Seat 4: KennyTurc (11656 in chips) 
Seat 5: Luckypunch.tm (13475 in chips) 
Seat 6: ikfold2 (10651 in chips) 
Seat 7: BaronVonBong (7398 in chips) 
Seat 8: dtl15 (8283 in chips) 
Seat 9: KKNA601 (24898 in chips) 
csabipapa1: posts the ante 22
1993544: posts the ante 22
jcarlos.vale: posts the ante 22
KennyTurc: posts the ante 22
Luckypunch.tm: posts the ante 22
ikfold2: posts the ante 22
BaronVonBong: posts the ante 22
dtl15: posts the ante 22
KKNA601: posts the ante 22
KKNA601: posts small blind 150
csabipapa1: posts big blind 300
*** HOLE CARDS ***
Dealt to jcarlos.vale [5h Jc]
1993544: folds 
jcarlos.vale: folds 
KennyTurc: calls 300
Luckypunch.tm: folds 
ikfold2: folds 
BaronVonBong: folds 
dtl15: calls 300
KKNA601: calls 150
csabipapa1: checks 
*** FLOP *** [2h 2s 9s]
KKNA601: checks 
csabipapa1: checks 
KennyTurc: checks 
dtl15: checks 
*** TURN *** [2h 2s 9s] [3s]
KKNA601: bets 699
csabipapa1: folds 
KennyTurc: folds 
dtl15: folds 
Uncalled bet (699) returned to KKNA601
KKNA601 collected 1398 from pot
KKNA601: doesn't show handDTO
*** SUMMARY ***
Total pot 1398 | Rake 0 
Board [2h 2s 9s 3s]
Seat 1: csabipapa1 (big blind) folded on the Turn
Seat 2: 1993544 folded before Flop (didn't bet)
Seat 3: jcarlos.vale folded before Flop (didn't bet)
Seat 4: KennyTurc folded on the Turn
Seat 5: Luckypunch.tm folded before Flop (didn't bet)
Seat 6: ikfold2 folded before Flop (didn't bet)
Seat 7: BaronVonBong folded before Flop (didn't bet)
Seat 8: dtl15 (button) folded on the Turn
Seat 9: KKNA601 (small blind) collected (1398)



PokerStars Hand #222150440337: Tournament #3086083919, $0.49+$0.06 USD Hold'em No Limit - Level XI (150/300) - 2021/01/02 22:51:25 EET [2021/01/02 15:51:25 ET]
Table '3086083919 46' 9-max Seat #9 is the button
Seat 1: csabipapa1 (18279 in chips) 
Seat 2: 1993544 (5637 in chips) 
Seat 3: jcarlos.vale (21198 in chips) 
Seat 4: KennyTurc (11334 in chips) 
Seat 5: Luckypunch.tm (13453 in chips) 
Seat 6: ikfold2 (10629 in chips) 
Seat 7: BaronVonBong (7376 in chips) 
Seat 8: dtl15 (7961 in chips) 
Seat 9: KKNA601 (25974 in chips) 
csabipapa1: posts the ante 22
1993544: posts the ante 22
jcarlos.vale: posts the ante 22
KennyTurc: posts the ante 22
Luckypunch.tm: posts the ante 22
ikfold2: posts the ante 22
BaronVonBong: posts the ante 22
dtl15: posts the ante 22
KKNA601: posts the ante 22
csabipapa1: posts small blind 150
1993544: posts big blind 300
*** HOLE CARDS ***
Dealt to jcarlos.vale [Ah As]
jcarlos.vale has timed out
jcarlos.vale: folds 
jcarlos.vale is sitting out
jcarlos.vale has returned
KennyTurc: folds 
Luckypunch.tm: folds 
ikfold2: folds 
BaronVonBong: folds 
dtl15: folds 
KKNA601: calls 300
csabipapa1: raises 1098 to 1398
1993544: folds 
KKNA601: calls 1098
*** FLOP *** [2c 4s Qh]
csabipapa1: checks 
KKNA601: checks 
*** TURN *** [2c 4s Qh] [8s]
csabipapa1: checks 
KKNA601: checks 
*** RIVER *** [2c 4s Qh 8s] [2s]
csabipapa1: checks 
KKNA601: checks 
*** SHOW DOWN ***
csabipapa1: shows [Ac 6s] (a pair of Deuces)
KKNA601: shows [3d 3s] (two pair, Threes and Deuces)
KKNA601 collected 3294 from pot
*** SUMMARY ***
Total pot 3294 | Rake 0 
Board [2c 4s Qh 8s 2s]
Seat 1: csabipapa1 (small blind) showed [Ac 6s] and lost with a pair of Deuces
Seat 2: 1993544 (big blind) folded before Flop
Seat 3: jcarlos.vale folded before Flop (didn't bet)
Seat 4: KennyTurc folded before Flop (didn't bet)
Seat 5: Luckypunch.tm folded before Flop (didn't bet)
Seat 6: ikfold2 folded before Flop (didn't bet)
Seat 7: BaronVonBong folded before Flop (didn't bet)
Seat 8: dtl15 folded before Flop (didn't bet)
Seat 9: KKNA601 (button) showed [3d 3s] and won (3294) with two pair, Threes and Deuces



PokerStars Hand #222150479896: Tournament #3086083919, $0.49+$0.06 USD Hold'em No Limit - Level XI (150/300) - 2021/01/02 22:52:06 EET [2021/01/02 15:52:06 ET]
Table '3086083919 46' 9-max Seat #1 is the button
Seat 1: csabipapa1 (16859 in chips) 
Seat 2: 1993544 (5315 in chips) 
Seat 3: jcarlos.vale (21176 in chips) 
Seat 4: KennyTurc (11312 in chips) 
Seat 5: Luckypunch.tm (13431 in chips) 
Seat 6: ikfold2 (10607 in chips) 
Seat 7: BaronVonBong (7354 in chips) 
Seat 8: dtl15 (7939 in chips) 
Seat 9: KKNA601 (27848 in chips) 
csabipapa1: posts the ante 22
1993544: posts the ante 22
jcarlos.vale: posts the ante 22
KennyTurc: posts the ante 22
Luckypunch.tm: posts the ante 22
ikfold2: posts the ante 22
BaronVonBong: posts the ante 22
dtl15: posts the ante 22
KKNA601: posts the ante 22
1993544: posts small blind 150
jcarlos.vale: posts big blind 300
*** HOLE CARDS ***
Dealt to jcarlos.vale [Th Qd]
KennyTurc: folds 
Luckypunch.tm: folds 
ikfold2: folds 
BaronVonBong: folds 
dtl15: folds 
KKNA601: calls 300
csabipapa1: raises 900 to 1200
1993544: raises 4093 to 5293 and is all-in
jcarlos.vale: folds 
KKNA601: folds 
csabipapa1: calls 4093
*** FLOP *** [8c Ts Ac]
*** TURN *** [8c Ts Ac] [4h]
*** RIVER *** [8c Ts Ac 4h] [4s]
*** SHOW DOWN ***
1993544: shows [Jd Qc] (a pair of Fours)
csabipapa1: shows [9d Js] (a pair of Fours - lower kicker)
1993544 collected 11384 from pot
*** SUMMARY ***
Total pot 11384 | Rake 0 
Board [8c Ts Ac 4h 4s]
Seat 1: csabipapa1 (button) showed [9d Js] and lost with a pair of Fours
Seat 2: 1993544 (small blind) showed [Jd Qc] and won (11384) with a pair of Fours
Seat 3: jcarlos.vale (big blind) folded before Flop
Seat 4: KennyTurc folded before Flop (didn't bet)
Seat 5: Luckypunch.tm folded before Flop (didn't bet)
Seat 6: ikfold2 folded before Flop (didn't bet)
Seat 7: BaronVonBong folded before Flop (didn't bet)
Seat 8: dtl15 folded before Flop (didn't bet)
Seat 9: KKNA601 folded before Flop



PokerStars Hand #222150518710: Tournament #3086083919, $0.49+$0.06 USD Hold'em No Limit - Level XI (150/300) - 2021/01/02 22:52:46 EET [2021/01/02 15:52:46 ET]
Table '3086083919 46' 9-max Seat #2 is the button
Seat 1: csabipapa1 (11544 in chips) 
Seat 2: 1993544 (11384 in chips) 
Seat 3: jcarlos.vale (20854 in chips) 
Seat 4: KennyTurc (11290 in chips) 
Seat 5: Luckypunch.tm (13409 in chips) 
Seat 6: ikfold2 (10585 in chips) 
Seat 7: BaronVonBong (7332 in chips) 
Seat 8: dtl15 (7917 in chips) 
Seat 9: KKNA601 (27526 in chips) 
csabipapa1: posts the ante 22
1993544: posts the ante 22
jcarlos.vale: posts the ante 22
KennyTurc: posts the ante 22
Luckypunch.tm: posts the ante 22
ikfold2: posts the ante 22
BaronVonBong: posts the ante 22
dtl15: posts the ante 22
KKNA601: posts the ante 22
jcarlos.vale: posts small blind 150
KennyTurc: posts big blind 300
*** HOLE CARDS ***
Dealt to jcarlos.vale [Ks 6s]
Luckypunch.tm: folds 
ikfold2: folds 
BaronVonBong: folds 
dtl15: folds 
KKNA601: calls 300
csabipapa1: raises 11062 to 11362
1993544: folds 
jcarlos.vale: folds 
KennyTurc: calls 10968 and is all-in
KKNA601: folds 
Uncalled bet (94) returned to csabipapa1
*** FLOP *** [2c 8h Ad]
*** TURN *** [2c 8h Ad] [Tc]
*** RIVER *** [2c 8h Ad Tc] [Kd]
*** SHOW DOWN ***
KennyTurc: shows [7d 7h] (a pair of Sevens)
csabipapa1: shows [6h Ah] (a pair of Aces)
csabipapa1 collected 23184 from pot
KennyTurc finished the tournament in 1329th place
*** SUMMARY ***
Total pot 23184 | Rake 0 
Board [2c 8h Ad Tc Kd]
Seat 1: csabipapa1 showed [6h Ah] and won (23184) with a pair of Aces
Seat 2: 1993544 (button) folded before Flop (didn't bet)
Seat 3: jcarlos.vale (small blind) folded before Flop
Seat 4: KennyTurc (big blind) showed [7d 7h] and lost with a pair of Sevens
Seat 5: Luckypunch.tm folded before Flop (didn't bet)
Seat 6: ikfold2 folded before Flop (didn't bet)
Seat 7: BaronVonBong folded before Flop (didn't bet)
Seat 8: dtl15 folded before Flop (didn't bet)
Seat 9: KKNA601 folded before Flop



PokerStars Hand #222150564344: Tournament #3086083919, $0.49+$0.06 USD Hold'em No Limit - Level XI (150/300) - 2021/01/02 22:53:33 EET [2021/01/02 15:53:33 ET]
Table '3086083919 46' 9-max Seat #3 is the button
Seat 1: csabipapa1 (23438 in chips) 
Seat 2: 1993544 (11362 in chips) 
Seat 3: jcarlos.vale (20682 in chips) 
Seat 5: Luckypunch.tm (13387 in chips) 
Seat 6: ikfold2 (10563 in chips) 
Seat 7: BaronVonBong (7310 in chips) 
Seat 8: dtl15 (7895 in chips) 
Seat 9: KKNA601 (27204 in chips) 
csabipapa1: posts the ante 22
1993544: posts the ante 22
jcarlos.vale: posts the ante 22
Luckypunch.tm: posts the ante 22
ikfold2: posts the ante 22
BaronVonBong: posts the ante 22
dtl15: posts the ante 22
KKNA601: posts the ante 22
Luckypunch.tm: posts small blind 150
ikfold2: posts big blind 300
*** HOLE CARDS ***
Dealt to jcarlos.vale [6h 9d]
BaronVonBong: calls 300
dtl15: folds 
KKNA601: calls 300
csabipapa1: raises 11040 to 11340
1993544: folds 
jcarlos.vale: folds 
Luckypunch.tm: folds 
ikfold2: calls 10241 and is all-in
BaronVonBong: folds 
KKNA601: calls 11040
*** FLOP *** [4d Ac Jd]
KKNA601: checks 
csabipapa1: bets 12076 and is all-in
KKNA601: calls 12076
*** TURN *** [4d Ac Jd] [5d]
*** RIVER *** [4d Ac Jd 5d] [8h]
*** SHOW DOWN ***
KKNA601: shows [Js Ks] (a pair of Jacks)
csabipapa1: shows [As Jc] (two pair, Aces and Jacks)
csabipapa1 collected 25750 from side pot
ikfold2: shows [Td Ad] (a flush, Ace high)
ikfold2 collected 32249 from main pot
*** SUMMARY ***
Total pot 57999 Main pot 32249. Side pot 25750. | Rake 0 
Board [4d Ac Jd 5d 8h]
Seat 1: csabipapa1 showed [As Jc] and won (25750) with two pair, Aces and Jacks
Seat 2: 1993544 folded before Flop (didn't bet)
Seat 3: jcarlos.vale (button) folded before Flop (didn't bet)
Seat 5: Luckypunch.tm (small blind) folded before Flop
Seat 6: ikfold2 (big blind) showed [Td Ad] and won (32249) with a flush, Ace high
Seat 7: BaronVonBong folded before Flop
Seat 8: dtl15 folded before Flop (didn't bet)
Seat 9: KKNA601 showed [Js Ks] and lost with a pair of Jacks



PokerStars Hand #222150606147: Tournament #3086083919, $0.49+$0.06 USD Hold'em No Limit - Level XI (150/300) - 2021/01/02 22:54:15 EET [2021/01/02 15:54:15 ET]
Table '3086083919 46' 9-max Seat #5 is the button
Seat 1: csabipapa1 (25750 in chips) 
Seat 2: 1993544 (11340 in chips) 
Seat 3: jcarlos.vale (20660 in chips) 
Seat 4: jetboy1998 (26358 in chips) 
Seat 5: Luckypunch.tm (13215 in chips) 
Seat 6: ikfold2 (32249 in chips) 
Seat 7: BaronVonBong (6988 in chips) 
Seat 8: dtl15 (7873 in chips) 
Seat 9: KKNA601 (3766 in chips) 
csabipapa1: posts the ante 22
1993544: posts the ante 22
jcarlos.vale: posts the ante 22
jetboy1998: posts the ante 22
Luckypunch.tm: posts the ante 22
ikfold2: posts the ante 22
BaronVonBong: posts the ante 22
dtl15: posts the ante 22
KKNA601: posts the ante 22
ikfold2: posts small blind 150
BaronVonBong: posts big blind 300
*** HOLE CARDS ***
Dealt to jcarlos.vale [8d Qd]
dtl15: folds 
KKNA601: calls 300
csabipapa1: calls 300
1993544: raises 600 to 900
jcarlos.vale: folds 
jetboy1998: calls 900
Luckypunch.tm: folds 
ikfold2: folds 
BaronVonBong: folds 
KKNA601: calls 600
csabipapa1: calls 600
*** FLOP *** [8s Ks 6d]
KKNA601: checks 
csabipapa1: checks 
1993544: bets 2124
jetboy1998: calls 2124
KKNA601: raises 720 to 2844 and is all-in
csabipapa1: calls 2844
1993544: folds 
jetboy1998: calls 720
*** TURN *** [8s Ks 6d] [5d]
csabipapa1: checks 
jetboy1998: bets 1200
csabipapa1: calls 1200
*** RIVER *** [8s Ks 6d 5d] [Th]
csabipapa1: checks 
jetboy1998: checks 
*** SHOW DOWN ***
csabipapa1: shows [3d Kd] (a pair of Kings)
jetboy1998: mucks handDTO
csabipapa1 collected 2400 from side pot
KKNA601: mucks handDTO
csabipapa1 collected 14904 from main pot
KKNA601 finished the tournament in 1278th place
*** SUMMARY ***
Total pot 17304 Main pot 14904. Side pot 2400. | Rake 0 
Board [8s Ks 6d 5d Th]
Seat 1: csabipapa1 showed [3d Kd] and won (17304) with a pair of Kings
Seat 2: 1993544 folded on the Flop
Seat 3: jcarlos.vale folded before Flop (didn't bet)
Seat 4: jetboy1998 mucked [7c Js]
Seat 5: Luckypunch.tm (button) folded before Flop (didn't bet)
Seat 6: ikfold2 (small blind) folded before Flop
Seat 7: BaronVonBong (big blind) folded before Flop
Seat 8: dtl15 folded before Flop (didn't bet)
Seat 9: KKNA601 mucked [2s 5s]



PokerStars Hand #222150933283: Tournament #3086083919, $0.49+$0.06 USD Hold'em No Limit - Level XI (150/300) - 2021/01/02 23:01:52 EET [2021/01/02 16:01:52 ET]
Table '3086083919 46' 9-max Seat #6 is the button
Seat 1: csabipapa1 (38088 in chips) 
Seat 2: 1993544 (8294 in chips) 
Seat 3: jcarlos.vale (20638 in chips) 
Seat 4: jetboy1998 (21392 in chips) 
Seat 5: Luckypunch.tm (13193 in chips) 
Seat 6: ikfold2 (32077 in chips) 
Seat 7: BaronVonBong (6666 in chips) 
Seat 8: dtl15 (7851 in chips) 
Seat 9: danm98 (3917 in chips) 
csabipapa1: posts the ante 22
1993544: posts the ante 22
jcarlos.vale: posts the ante 22
jetboy1998: posts the ante 22
Luckypunch.tm: posts the ante 22
ikfold2: posts the ante 22
BaronVonBong: posts the ante 22
dtl15: posts the ante 22
danm98: posts the ante 22
BaronVonBong: posts small blind 150
dtl15: posts big blind 300
*** HOLE CARDS ***
Dealt to jcarlos.vale [Th 8h]
danm98: folds 
csabipapa1: folds 
1993544: folds 
jcarlos.vale: folds 
jetboy1998: calls 300
Luckypunch.tm: folds 
ikfold2: folds 
BaronVonBong: calls 150
dtl15: checks 
*** FLOP *** [Ad 5d Td]
BaronVonBong: checks 
dtl15: checks 
jetboy1998: bets 549
BaronVonBong: folds 
dtl15: folds 
Uncalled bet (549) returned to jetboy1998
jetboy1998 collected 1098 from pot
jetboy1998: doesn't show handDTO
*** SUMMARY ***
Total pot 1098 | Rake 0 
Board [Ad 5d Td]
Seat 1: csabipapa1 folded before Flop (didn't bet)
Seat 2: 1993544 folded before Flop (didn't bet)
Seat 3: jcarlos.vale folded before Flop (didn't bet)
Seat 4: jetboy1998 collected (1098)
Seat 5: Luckypunch.tm folded before Flop (didn't bet)
Seat 6: ikfold2 (button) folded before Flop (didn't bet)
Seat 7: BaronVonBong (small blind) folded on the Flop
Seat 8: dtl15 (big blind) folded on the Flop
Seat 9: danm98 folded before Flop (didn't bet)



PokerStars Hand #222151006134: Tournament #3086083919, $0.49+$0.06 USD Hold'em No Limit - Level XI (150/300) - 2021/01/02 23:03:14 EET [2021/01/02 16:03:14 ET]
Table '3086083919 46' 9-max Seat #7 is the button
Seat 1: csabipapa1 (38066 in chips) 
Seat 2: 1993544 (8272 in chips) 
Seat 3: jcarlos.vale (20616 in chips) 
Seat 4: jetboy1998 (22168 in chips) 
Seat 5: Luckypunch.tm (13171 in chips) 
Seat 6: ikfold2 (32055 in chips) 
Seat 7: BaronVonBong (6344 in chips) 
Seat 8: dtl15 (7529 in chips) 
Seat 9: danm98 (3895 in chips) 
csabipapa1: posts the ante 22
1993544: posts the ante 22
jcarlos.vale: posts the ante 22
jetboy1998: posts the ante 22
Luckypunch.tm: posts the ante 22
ikfold2: posts the ante 22
BaronVonBong: posts the ante 22
dtl15: posts the ante 22
danm98: posts the ante 22
dtl15: posts small blind 150
danm98: posts big blind 300
*** HOLE CARDS ***
Dealt to jcarlos.vale [9s As]
csabipapa1: raises 948 to 1248
1993544: folds 
jcarlos.vale: folds 
jetboy1998: folds 
Luckypunch.tm: folds 
ikfold2: calls 1248
BaronVonBong: folds 
dtl15: folds 
danm98: folds 
*** FLOP *** [Jd 5h 7h]
csabipapa1: checks 
ikfold2: bets 1572
csabipapa1: calls 1572
*** TURN *** [Jd 5h 7h] [2c]
csabipapa1: checks 
ikfold2: bets 3144
csabipapa1: calls 3144
*** RIVER *** [Jd 5h 7h 2c] [6s]
csabipapa1: checks 
ikfold2: checks 
*** SHOW DOWN ***
csabipapa1: shows [Ts Th] (a pair of Tens)
ikfold2: mucks handDTO
csabipapa1 collected 12576 from pot
*** SUMMARY ***
Total pot 12576 | Rake 0 
Board [Jd 5h 7h 2c 6s]
Seat 1: csabipapa1 showed [Ts Th] and won (12576) with a pair of Tens
Seat 2: 1993544 folded before Flop (didn't bet)
Seat 3: jcarlos.vale folded before Flop (didn't bet)
Seat 4: jetboy1998 folded before Flop (didn't bet)
Seat 5: Luckypunch.tm folded before Flop (didn't bet)
Seat 6: ikfold2 mucked [Ah 8h]
Seat 7: BaronVonBong (button) folded before Flop (didn't bet)
Seat 8: dtl15 (small blind) folded before Flop
Seat 9: danm98 (big blind) folded before Flop



PokerStars Hand #222151053444: Tournament #3086083919, $0.49+$0.06 USD Hold'em No Limit - Level XI (150/300) - 2021/01/02 23:04:03 EET [2021/01/02 16:04:03 ET]
Table '3086083919 46' 9-max Seat #8 is the button
Seat 1: csabipapa1 (44656 in chips) 
Seat 2: 1993544 (8250 in chips) 
Seat 3: jcarlos.vale (20594 in chips) 
Seat 4: jetboy1998 (22146 in chips) 
Seat 5: Luckypunch.tm (13149 in chips) 
Seat 6: ikfold2 (26069 in chips) 
Seat 7: BaronVonBong (6322 in chips) 
Seat 8: dtl15 (7357 in chips) 
Seat 9: danm98 (3573 in chips) 
csabipapa1: posts the ante 22
1993544: posts the ante 22
jcarlos.vale: posts the ante 22
jetboy1998: posts the ante 22
Luckypunch.tm: posts the ante 22
ikfold2: posts the ante 22
BaronVonBong: posts the ante 22
dtl15: posts the ante 22
danm98: posts the ante 22
danm98: posts small blind 150
csabipapa1: posts big blind 300
*** HOLE CARDS ***
Dealt to jcarlos.vale [Qh 6h]
1993544: raises 7928 to 8228 and is all-in
jcarlos.vale: folds 
jetboy1998 has timed out
jetboy1998: folds 
jetboy1998 is sitting out
Luckypunch.tm: folds 
jetboy1998 has returned
ikfold2: folds 
BaronVonBong: folds 
dtl15: folds 
danm98: folds 
csabipapa1: folds 
Uncalled bet (7928) returned to 1993544
1993544 collected 948 from pot
1993544: doesn't show handDTO
*** SUMMARY ***
Total pot 948 | Rake 0 
Seat 1: csabipapa1 (big blind) folded before Flop
Seat 2: 1993544 collected (948)
Seat 3: jcarlos.vale folded before Flop (didn't bet)
Seat 4: jetboy1998 folded before Flop (didn't bet)
Seat 5: Luckypunch.tm folded before Flop (didn't bet)
Seat 6: ikfold2 folded before Flop (didn't bet)
Seat 7: BaronVonBong folded before Flop (didn't bet)
Seat 8: dtl15 (button) folded before Flop (didn't bet)
Seat 9: danm98 (small blind) folded before Flop



PokerStars Hand #222151107087: Tournament #3086083919, $0.49+$0.06 USD Hold'em No Limit - Level XII (200/400) - 2021/01/02 23:04:59 EET [2021/01/02 16:04:59 ET]
Table '3086083919 46' 9-max Seat #9 is the button
Seat 1: csabipapa1 (44334 in chips) 
Seat 2: 1993544 (8876 in chips) 
Seat 3: jcarlos.vale (20572 in chips) 
Seat 4: jetboy1998 (22124 in chips) 
Seat 5: Luckypunch.tm (13127 in chips) 
Seat 6: ikfold2 (26047 in chips) 
Seat 7: BaronVonBong (6300 in chips) 
Seat 8: dtl15 (7335 in chips) 
Seat 9: danm98 (3401 in chips) 
csabipapa1: posts the ante 25
1993544: posts the ante 25
jcarlos.vale: posts the ante 25
jetboy1998: posts the ante 25
Luckypunch.tm: posts the ante 25
ikfold2: posts the ante 25
BaronVonBong: posts the ante 25
dtl15: posts the ante 25
danm98: posts the ante 25
csabipapa1: posts small blind 200
1993544: posts big blind 400
*** HOLE CARDS ***
Dealt to jcarlos.vale [7c 4s]
jcarlos.vale: folds 
jetboy1998: folds 
Luckypunch.tm: folds 
ikfold2: folds 
BaronVonBong: calls 400
dtl15: folds 
danm98: folds 
csabipapa1: calls 200
1993544: checks 
*** FLOP *** [Qs 8c Qc]
csabipapa1: checks 
csabipapa1 has returned
1993544: bets 713
BaronVonBong: folds 
csabipapa1: folds 
Uncalled bet (713) returned to 1993544
1993544 collected 1425 from pot
1993544: doesn't show handDTO
*** SUMMARY ***
Total pot 1425 | Rake 0 
Board [Qs 8c Qc]
Seat 1: csabipapa1 (small blind) folded on the Flop
Seat 2: 1993544 (big blind) collected (1425)
Seat 3: jcarlos.vale folded before Flop (didn't bet)
Seat 4: jetboy1998 folded before Flop (didn't bet)
Seat 5: Luckypunch.tm folded before Flop (didn't bet)
Seat 6: ikfold2 folded before Flop (didn't bet)
Seat 7: BaronVonBong folded on the Flop
Seat 8: dtl15 folded before Flop (didn't bet)
Seat 9: danm98 (button) folded before Flop (didn't bet)



PokerStars Hand #222151181983: Tournament #3086083919, $0.49+$0.06 USD Hold'em No Limit - Level XII (200/400) - 2021/01/02 23:06:16 EET [2021/01/02 16:06:16 ET]
Table '3086083919 46' 9-max Seat #1 is the button
Seat 1: csabipapa1 (43909 in chips) 
Seat 2: 1993544 (9876 in chips) 
Seat 3: jcarlos.vale (20547 in chips) 
Seat 4: jetboy1998 (22099 in chips) 
Seat 5: Luckypunch.tm (13102 in chips) 
Seat 6: ikfold2 (26022 in chips) 
Seat 7: BaronVonBong (5875 in chips) 
Seat 8: dtl15 (7310 in chips) 
Seat 9: danm98 (3376 in chips) 
csabipapa1: posts the ante 25
1993544: posts the ante 25
jcarlos.vale: posts the ante 25
jetboy1998: posts the ante 25
Luckypunch.tm: posts the ante 25
ikfold2: posts the ante 25
BaronVonBong: posts the ante 25
dtl15: posts the ante 25
danm98: posts the ante 25
1993544: posts small blind 200
jcarlos.vale: posts big blind 400
*** HOLE CARDS ***
Dealt to jcarlos.vale [2c Th]
jetboy1998: calls 400
Luckypunch.tm: folds 
ikfold2: calls 400
BaronVonBong: calls 400
dtl15: folds 
danm98: raises 800 to 1200
csabipapa1: folds 
1993544: folds 
jcarlos.vale: folds 
jetboy1998: calls 800
ikfold2: calls 800
BaronVonBong: calls 800
*** FLOP *** [4d 5c Jc]
jetboy1998: bets 400
ikfold2: folds 
BaronVonBong: calls 400
danm98: raises 1751 to 2151 and is all-in
jetboy1998: raises 1751 to 3902
BaronVonBong: raises 748 to 4650 and is all-in
jetboy1998: calls 748
*** TURN *** [4d 5c Jc] [6s]
*** RIVER *** [4d 5c Jc 6s] [7s]
*** SHOW DOWN ***
jetboy1998: shows [Td Jh] (a pair of Jacks)
BaronVonBong: shows [Jd Qs] (a pair of Jacks - Queen kicker)
BaronVonBong collected 4998 from side pot
danm98: shows [Kc Kh] (a pair of Kings)
danm98 collected 12078 from main pot
*** SUMMARY ***
Total pot 17076 Main pot 12078. Side pot 4998. | Rake 0 
Board [4d 5c Jc 6s 7s]
Seat 1: csabipapa1 (button) folded before Flop (didn't bet)
Seat 2: 1993544 (small blind) folded before Flop
Seat 3: jcarlos.vale (big blind) folded before Flop
Seat 4: jetboy1998 showed [Td Jh] and lost with a pair of Jacks
Seat 5: Luckypunch.tm folded before Flop (didn't bet)
Seat 6: ikfold2 folded on the Flop
Seat 7: BaronVonBong showed [Jd Qs] and won (4998) with a pair of Jacks
Seat 8: dtl15 folded before Flop (didn't bet)
Seat 9: danm98 showed [Kc Kh] and won (12078) with a pair of Kings



PokerStars Hand #222151283923: Tournament #3086083919, $0.49+$0.06 USD Hold'em No Limit - Level XII (200/400) - 2021/01/02 23:08:01 EET [2021/01/02 16:08:01 ET]
Table '3086083919 46' 9-max Seat #2 is the button
Seat 1: csabipapa1 (43884 in chips) 
Seat 2: 1993544 (9651 in chips) 
Seat 3: jcarlos.vale (20122 in chips) 
Seat 4: jetboy1998 (16224 in chips) 
Seat 5: Luckypunch.tm (13077 in chips) 
Seat 6: ikfold2 (24797 in chips) 
Seat 7: BaronVonBong (4998 in chips) 
Seat 8: dtl15 (7285 in chips) 
Seat 9: danm98 (12078 in chips) 
csabipapa1: posts the ante 25
1993544: posts the ante 25
jcarlos.vale: posts the ante 25
jetboy1998: posts the ante 25
Luckypunch.tm: posts the ante 25
ikfold2: posts the ante 25
BaronVonBong: posts the ante 25
dtl15: posts the ante 25
danm98: posts the ante 25
jcarlos.vale: posts small blind 200
jetboy1998: posts big blind 400
*** HOLE CARDS ***
Dealt to jcarlos.vale [5c Td]
Luckypunch.tm: raises 600 to 1000
ikfold2: calls 1000
BaronVonBong: folds 
dtl15: folds 
danm98: folds 
csabipapa1: folds 
1993544: raises 8626 to 9626 and is all-in
jcarlos.vale: folds 
jetboy1998: folds 
Luckypunch.tm: raises 3426 to 13052 and is all-in
ikfold2: calls 12052
*** FLOP *** [6c 3h 9s]
*** TURN *** [6c 3h 9s] [3c]
*** RIVER *** [6c 3h 9s 3c] [8h]
*** SHOW DOWN ***
Luckypunch.tm: shows [Js Jc] (two pair, Jacks and Threes)
ikfold2: shows [Ah Th] (a pair of Threes)
Luckypunch.tm collected 6852 from side pot
1993544: shows [Ad As] (two pair, Aces and Threes)
1993544 collected 29703 from main pot
*** SUMMARY ***
Total pot 36555 Main pot 29703. Side pot 6852. | Rake 0 
Board [6c 3h 9s 3c 8h]
Seat 1: csabipapa1 folded before Flop (didn't bet)
Seat 2: 1993544 (button) showed [Ad As] and won (29703) with two pair, Aces and Threes
Seat 3: jcarlos.vale (small blind) folded before Flop
Seat 4: jetboy1998 (big blind) folded before Flop
Seat 5: Luckypunch.tm showed [Js Jc] and won (6852) with two pair, Jacks and Threes
Seat 6: ikfold2 showed [Ah Th] and lost with a pair of Threes
Seat 7: BaronVonBong folded before Flop (didn't bet)
Seat 8: dtl15 folded before Flop (didn't bet)
Seat 9: danm98 folded before Flop (didn't bet)



PokerStars Hand #222151325194: Tournament #3086083919, $0.49+$0.06 USD Hold'em No Limit - Level XII (200/400) - 2021/01/02 23:08:43 EET [2021/01/02 16:08:43 ET]
Table '3086083919 46' 9-max Seat #3 is the button
Seat 1: csabipapa1 (43859 in chips) 
Seat 2: 1993544 (29703 in chips) 
Seat 3: jcarlos.vale (19897 in chips) 
Seat 4: jetboy1998 (15799 in chips) 
Seat 5: Luckypunch.tm (6852 in chips) 
Seat 6: ikfold2 (11720 in chips) 
Seat 7: BaronVonBong (4973 in chips) 
Seat 8: dtl15 (7260 in chips) 
Seat 9: danm98 (12053 in chips) 
csabipapa1: posts the ante 25
1993544: posts the ante 25
jcarlos.vale: posts the ante 25
jetboy1998: posts the ante 25
Luckypunch.tm: posts the ante 25
ikfold2: posts the ante 25
BaronVonBong: posts the ante 25
dtl15: posts the ante 25
danm98: posts the ante 25
jetboy1998: posts small blind 200
Luckypunch.tm: posts big blind 400
*** HOLE CARDS ***
Dealt to jcarlos.vale [8c 3s]
ikfold2: folds 
BaronVonBong: calls 400
dtl15: folds 
danm98: folds 
csabipapa1: folds 
1993544: raises 800 to 1200
jcarlos.vale: folds 
jetboy1998: calls 1000
Luckypunch.tm: folds 
BaronVonBong: folds 
*** FLOP *** [9c 7c 2c]
jetboy1998: bets 1712
1993544: folds 
Uncalled bet (1712) returned to jetboy1998
jetboy1998 collected 3425 from pot
jetboy1998: doesn't show handDTO
*** SUMMARY ***
Total pot 3425 | Rake 0 
Board [9c 7c 2c]
Seat 1: csabipapa1 folded before Flop (didn't bet)
Seat 2: 1993544 folded on the Flop
Seat 3: jcarlos.vale (button) folded before Flop (didn't bet)
Seat 4: jetboy1998 (small blind) collected (3425)
Seat 5: Luckypunch.tm (big blind) folded before Flop
Seat 6: ikfold2 folded before Flop (didn't bet)
Seat 7: BaronVonBong folded before Flop
Seat 8: dtl15 folded before Flop (didn't bet)
Seat 9: danm98 folded before Flop (didn't bet)



PokerStars Hand #222151379138: Tournament #3086083919, $0.49+$0.06 USD Hold'em No Limit - Level XII (200/400) - 2021/01/02 23:09:39 EET [2021/01/02 16:09:39 ET]
Table '3086083919 46' 9-max Seat #4 is the button
Seat 1: csabipapa1 (43834 in chips) 
Seat 2: 1993544 (28478 in chips) 
Seat 3: jcarlos.vale (19872 in chips) 
Seat 4: jetboy1998 (17999 in chips) 
Seat 5: Luckypunch.tm (6427 in chips) 
Seat 6: ikfold2 (11695 in chips) 
Seat 7: BaronVonBong (4548 in chips) 
Seat 8: dtl15 (7235 in chips) 
Seat 9: danm98 (12028 in chips) 
csabipapa1: posts the ante 25
1993544: posts the ante 25
jcarlos.vale: posts the ante 25
jetboy1998: posts the ante 25
Luckypunch.tm: posts the ante 25
ikfold2: posts the ante 25
BaronVonBong: posts the ante 25
dtl15: posts the ante 25
danm98: posts the ante 25
Luckypunch.tm: posts small blind 200
ikfold2: posts big blind 400
*** HOLE CARDS ***
Dealt to jcarlos.vale [4s 5d]
BaronVonBong: folds 
dtl15: folds 
danm98: folds 
csabipapa1: folds 
1993544: folds 
jcarlos.vale: folds 
jetboy1998: calls 400
Luckypunch.tm: folds 
ikfold2: checks 
*** FLOP *** [8h Ac Th]
ikfold2: bets 400
jetboy1998: raises 400 to 800
ikfold2: raises 10470 to 11270 and is all-in
jetboy1998: calls 10470
*** TURN *** [8h Ac Th] [9h]
*** RIVER *** [8h Ac Th 9h] [9d]
*** SHOW DOWN ***
ikfold2: shows [Ah 3s] (two pair, Aces and Nines)
jetboy1998: shows [Td As] (two pair, Aces and Tens)
jetboy1998 collected 23765 from pot
ikfold2 finished the tournament in 1108th place
*** SUMMARY ***
Total pot 23765 | Rake 0 
Board [8h Ac Th 9h 9d]
Seat 1: csabipapa1 folded before Flop (didn't bet)
Seat 2: 1993544 folded before Flop (didn't bet)
Seat 3: jcarlos.vale folded before Flop (didn't bet)
Seat 4: jetboy1998 (button) showed [Td As] and won (23765) with two pair, Aces and Tens
Seat 5: Luckypunch.tm (small blind) folded before Flop
Seat 6: ikfold2 (big blind) showed [Ah 3s] and lost with two pair, Aces and Nines
Seat 7: BaronVonBong folded before Flop (didn't bet)
Seat 8: dtl15 folded before Flop (didn't bet)
Seat 9: danm98 folded before Flop (didn't bet)



PokerStars Hand #222151459399: Tournament #3086083919, $0.49+$0.06 USD Hold'em No Limit - Level XII (200/400) - 2021/01/02 23:11:02 EET [2021/01/02 16:11:02 ET]
Table '3086083919 117' 9-max Seat #4 is the button
Seat 1: juegoimaginado (11170 in chips) 
Seat 2: jcarlos.vale (19847 in chips) 
Seat 3: Everloooong (4335 in chips) 
Seat 4: ikayuk (16597 in chips) 
Seat 5: ecolife (20530 in chips) 
Seat 6: rinomarley420 (10317 in chips) 
Seat 7: kulbaba195445 (25312 in chips) 
Seat 8: BaD_BeRt68 (2103 in chips) is sitting out
Seat 9: alexandru2111 (14512 in chips) 
juegoimaginado: posts the ante 25
jcarlos.vale: posts the ante 25
Everloooong: posts the ante 25
ikayuk: posts the ante 25
ecolife: posts the ante 25
rinomarley420: posts the ante 25
kulbaba195445: posts the ante 25
BaD_BeRt68: posts the ante 25
alexandru2111: posts the ante 25
ecolife: posts small blind 200
rinomarley420: posts big blind 400
*** HOLE CARDS ***
Dealt to jcarlos.vale [Js Ts]
kulbaba195445: folds 
BaD_BeRt68: folds 
alexandru2111: calls 400
juegoimaginado: folds 
jcarlos.vale: calls 400
Everloooong: folds 
ikayuk: calls 400
ecolife: calls 200
rinomarley420: checks 
*** FLOP *** [2c Qd 8s]
ecolife: checks 
rinomarley420: checks 
alexandru2111: checks 
jcarlos.vale: checks 
ikayuk: checks 
*** TURN *** [2c Qd 8s] [Qc]
ecolife: checks 
rinomarley420: bets 400
alexandru2111: calls 400
jcarlos.vale: folds 
ikayuk: folds 
ecolife: folds 
*** RIVER *** [2c Qd 8s Qc] [Jc]
rinomarley420: bets 400
alexandru2111: raises 13287 to 13687 and is all-in
rinomarley420: folds 
Uncalled bet (13287) returned to alexandru2111
alexandru2111 collected 3825 from pot
alexandru2111: doesn't show handDTO
*** SUMMARY ***
Total pot 3825 | Rake 0 
Board [2c Qd 8s Qc Jc]
Seat 1: juegoimaginado folded before Flop (didn't bet)
Seat 2: jcarlos.vale folded on the Turn
Seat 3: Everloooong folded before Flop (didn't bet)
Seat 4: ikayuk (button) folded on the Turn
Seat 5: ecolife (small blind) folded on the Turn
Seat 6: rinomarley420 (big blind) folded on the River
Seat 7: kulbaba195445 folded before Flop (didn't bet)
Seat 8: BaD_BeRt68 folded before Flop (didn't bet)
Seat 9: alexandru2111 collected (3825)



PokerStars Hand #222151542466: Tournament #3086083919, $0.49+$0.06 USD Hold'em No Limit - Level XII (200/400) - 2021/01/02 23:12:26 EET [2021/01/02 16:12:26 ET]
Table '3086083919 117' 9-max Seat #5 is the button
Seat 1: juegoimaginado (11145 in chips) 
Seat 2: jcarlos.vale (19422 in chips) 
Seat 3: Everloooong (4310 in chips) 
Seat 4: ikayuk (16172 in chips) 
Seat 5: ecolife (20105 in chips) 
Seat 6: rinomarley420 (9092 in chips) 
Seat 7: kulbaba195445 (25287 in chips) 
Seat 8: BaD_BeRt68 (2078 in chips) is sitting out
Seat 9: alexandru2111 (17112 in chips) 
juegoimaginado: posts the ante 25
jcarlos.vale: posts the ante 25
Everloooong: posts the ante 25
ikayuk: posts the ante 25
ecolife: posts the ante 25
rinomarley420: posts the ante 25
kulbaba195445: posts the ante 25
BaD_BeRt68: posts the ante 25
alexandru2111: posts the ante 25
rinomarley420: posts small blind 200
kulbaba195445: posts big blind 400
*** HOLE CARDS ***
Dealt to jcarlos.vale [8h Qd]
BaD_BeRt68: folds 
alexandru2111: folds 
juegoimaginado: folds 
jcarlos.vale: folds 
Everloooong: folds 
ikayuk: folds 
ecolife: raises 400 to 800
rinomarley420: folds 
kulbaba195445: raises 800 to 1600
ecolife: calls 800
*** FLOP *** [Kc 4h 7c]
kulbaba195445: checks 
ecolife: checks 
*** TURN *** [Kc 4h 7c] [7h]
kulbaba195445: checks 
ecolife: bets 800
kulbaba195445: calls 800
*** RIVER *** [Kc 4h 7c 7h] [8s]
kulbaba195445: checks 
ecolife: checks 
*** SHOW DOWN ***
kulbaba195445: shows [Th As] (a pair of Sevens)
ecolife: shows [8c Td] (two pair, Eights and Sevens)
ecolife collected 5225 from pot
*** SUMMARY ***
Total pot 5225 | Rake 0 
Board [Kc 4h 7c 7h 8s]
Seat 1: juegoimaginado folded before Flop (didn't bet)
Seat 2: jcarlos.vale folded before Flop (didn't bet)
Seat 3: Everloooong folded before Flop (didn't bet)
Seat 4: ikayuk folded before Flop (didn't bet)
Seat 5: ecolife (button) showed [8c Td] and won (5225) with two pair, Eights and Sevens
Seat 6: rinomarley420 (small blind) folded before Flop
Seat 7: kulbaba195445 (big blind) showed [Th As] and lost with a pair of Sevens
Seat 8: BaD_BeRt68 folded before Flop (didn't bet)
Seat 9: alexandru2111 folded before Flop (didn't bet)



PokerStars Hand #222151588521: Tournament #3086083919, $0.49+$0.06 USD Hold'em No Limit - Level XII (200/400) - 2021/01/02 23:13:13 EET [2021/01/02 16:13:13 ET]
Table '3086083919 117' 9-max Seat #6 is the button
Seat 1: juegoimaginado (11120 in chips) 
Seat 2: jcarlos.vale (19397 in chips) 
Seat 3: Everloooong (4285 in chips) 
Seat 4: ikayuk (16147 in chips) 
Seat 5: ecolife (22905 in chips) 
Seat 6: rinomarley420 (8867 in chips) 
Seat 7: kulbaba195445 (22862 in chips) 
Seat 8: BaD_BeRt68 (2053 in chips) is sitting out
Seat 9: alexandru2111 (17087 in chips) 
juegoimaginado: posts the ante 25
jcarlos.vale: posts the ante 25
Everloooong: posts the ante 25
ikayuk: posts the ante 25
ecolife: posts the ante 25
rinomarley420: posts the ante 25
kulbaba195445: posts the ante 25
BaD_BeRt68: posts the ante 25
alexandru2111: posts the ante 25
kulbaba195445: posts small blind 200
BaD_BeRt68: posts big blind 400
*** HOLE CARDS ***
Dealt to jcarlos.vale [Kc Td]
alexandru2111: raises 16662 to 17062 and is all-in
juegoimaginado: folds 
jcarlos.vale: folds 
Everloooong: folds 
ikayuk: folds 
ecolife: folds 
rinomarley420 has timed out
rinomarley420: folds 
rinomarley420 is sitting out
kulbaba195445: folds 
BaD_BeRt68: folds 
Uncalled bet (16662) returned to alexandru2111
alexandru2111 collected 1225 from pot
*** SUMMARY ***
Total pot 1225 | Rake 0 
Seat 1: juegoimaginado folded before Flop (didn't bet)
Seat 2: jcarlos.vale folded before Flop (didn't bet)
Seat 3: Everloooong folded before Flop (didn't bet)
Seat 4: ikayuk folded before Flop (didn't bet)
Seat 5: ecolife folded before Flop (didn't bet)
Seat 6: rinomarley420 (button) folded before Flop (didn't bet)
Seat 7: kulbaba195445 (small blind) folded before Flop
Seat 8: BaD_BeRt68 (big blind) folded before Flop
Seat 9: alexandru2111 collected (1225)



PokerStars Hand #222151655271: Tournament #3086083919, $0.49+$0.06 USD Hold'em No Limit - Level XII (200/400) - 2021/01/02 23:14:22 EET [2021/01/02 16:14:22 ET]
Table '3086083919 117' 9-max Seat #7 is the button
Seat 1: juegoimaginado (11095 in chips) 
Seat 2: jcarlos.vale (19372 in chips) 
Seat 3: Everloooong (4260 in chips) 
Seat 4: ikayuk (16122 in chips) 
Seat 5: ecolife (22880 in chips) 
Seat 6: rinomarley420 (8842 in chips) is sitting out
Seat 7: kulbaba195445 (22637 in chips) 
Seat 8: BaD_BeRt68 (1628 in chips) is sitting out
Seat 9: alexandru2111 (17887 in chips) 
juegoimaginado: posts the ante 25
jcarlos.vale: posts the ante 25
Everloooong: posts the ante 25
ikayuk: posts the ante 25
ecolife: posts the ante 25
rinomarley420: posts the ante 25
kulbaba195445: posts the ante 25
BaD_BeRt68: posts the ante 25
alexandru2111: posts the ante 25
BaD_BeRt68: posts small blind 200
alexandru2111: posts big blind 400
*** HOLE CARDS ***
Dealt to jcarlos.vale [Th As]
juegoimaginado: folds 
jcarlos.vale: raises 640 to 1040
Everloooong: folds 
ikayuk: folds 
ecolife: folds 
rinomarley420: folds 
kulbaba195445: folds 
BaD_BeRt68: folds 
alexandru2111: calls 640
*** FLOP *** [9s Jd 8d]
alexandru2111: bets 400
jcarlos.vale: calls 400
*** TURN *** [9s Jd 8d] [5c]
alexandru2111: bets 3305
jcarlos.vale: folds 
Uncalled bet (3305) returned to alexandru2111
alexandru2111 collected 3305 from pot
alexandru2111: doesn't show handDTO
*** SUMMARY ***
Total pot 3305 | Rake 0 
Board [9s Jd 8d 5c]
Seat 1: juegoimaginado folded before Flop (didn't bet)
Seat 2: jcarlos.vale folded on the Turn
Seat 3: Everloooong folded before Flop (didn't bet)
Seat 4: ikayuk folded before Flop (didn't bet)
Seat 5: ecolife folded before Flop (didn't bet)
Seat 6: rinomarley420 folded before Flop (didn't bet)
Seat 7: kulbaba195445 (button) folded before Flop (didn't bet)
Seat 8: BaD_BeRt68 (small blind) folded before Flop
Seat 9: alexandru2111 (big blind) collected (3305)



PokerStars Hand #222151697007: Tournament #3086083919, $0.49+$0.06 USD Hold'em No Limit - Level XIII (250/500) - 2021/01/02 23:15:05 EET [2021/01/02 16:15:05 ET]
Table '3086083919 117' 9-max Seat #8 is the button
Seat 1: juegoimaginado (11070 in chips) 
Seat 2: jcarlos.vale (17907 in chips) 
Seat 3: Everloooong (4235 in chips) 
Seat 4: ikayuk (16097 in chips) 
Seat 5: ecolife (22855 in chips) 
Seat 6: rinomarley420 (8817 in chips) is sitting out
Seat 7: kulbaba195445 (22612 in chips) 
Seat 8: BaD_BeRt68 (1403 in chips) is sitting out
Seat 9: alexandru2111 (19727 in chips) 
juegoimaginado: posts the ante 30
jcarlos.vale: posts the ante 30
Everloooong: posts the ante 30
ikayuk: posts the ante 30
ecolife: posts the ante 30
rinomarley420: posts the ante 30
kulbaba195445: posts the ante 30
BaD_BeRt68: posts the ante 30
alexandru2111: posts the ante 30
alexandru2111: posts small blind 250
juegoimaginado: posts big blind 500
*** HOLE CARDS ***
Dealt to jcarlos.vale [Tc 3h]
jcarlos.vale: folds 
Everloooong: folds 
ikayuk: folds 
ecolife: raises 500 to 1000
rinomarley420: folds 
kulbaba195445: folds 
BaD_BeRt68: folds 
alexandru2111: calls 750
juegoimaginado: calls 500
*** FLOP *** [Kh Jh Qc]
alexandru2111: checks 
juegoimaginado: checks 
ecolife: bets 1000
alexandru2111: calls 1000
juegoimaginado: folds 
*** TURN *** [Kh Jh Qc] [6h]
alexandru2111: bets 17697 and is all-in
ecolife: folds 
Uncalled bet (17697) returned to alexandru2111
alexandru2111 collected 5270 from pot
alexandru2111: doesn't show handDTO
*** SUMMARY ***
Total pot 5270 | Rake 0 
Board [Kh Jh Qc 6h]
Seat 1: juegoimaginado (big blind) folded on the Flop
Seat 2: jcarlos.vale folded before Flop (didn't bet)
Seat 3: Everloooong folded before Flop (didn't bet)
Seat 4: ikayuk folded before Flop (didn't bet)
Seat 5: ecolife folded on the Turn
Seat 6: rinomarley420 folded before Flop (didn't bet)
Seat 7: kulbaba195445 folded before Flop (didn't bet)
Seat 8: BaD_BeRt68 (button) folded before Flop (didn't bet)
Seat 9: alexandru2111 (small blind) collected (5270)



PokerStars Hand #222151741205: Tournament #3086083919, $0.49+$0.06 USD Hold'em No Limit - Level XIII (250/500) - 2021/01/02 23:15:49 EET [2021/01/02 16:15:49 ET]
Table '3086083919 117' 9-max Seat #9 is the button
Seat 1: juegoimaginado (10040 in chips) 
Seat 2: jcarlos.vale (17877 in chips) 
Seat 3: Everloooong (4205 in chips) 
Seat 4: ikayuk (16067 in chips) 
Seat 5: ecolife (20825 in chips) 
Seat 6: rinomarley420 (8787 in chips) is sitting out
Seat 7: kulbaba195445 (22582 in chips) 
Seat 8: BaD_BeRt68 (1373 in chips) is sitting out
Seat 9: alexandru2111 (22967 in chips) 
juegoimaginado: posts the ante 30
jcarlos.vale: posts the ante 30
Everloooong: posts the ante 30
ikayuk: posts the ante 30
ecolife: posts the ante 30
rinomarley420: posts the ante 30
kulbaba195445: posts the ante 30
BaD_BeRt68: posts the ante 30
alexandru2111: posts the ante 30
juegoimaginado: posts small blind 250
jcarlos.vale: posts big blind 500
*** HOLE CARDS ***
Dealt to jcarlos.vale [Ah 3h]
Everloooong: folds 
ikayuk: folds 
ecolife: folds 
rinomarley420: folds 
kulbaba195445: calls 500
BaD_BeRt68: folds 
alexandru2111: calls 500
juegoimaginado: raises 1000 to 1500
jcarlos.vale: folds 
kulbaba195445: calls 1000
alexandru2111: calls 1000
*** FLOP *** [2h 7s 3s]
juegoimaginado: bets 2135
kulbaba195445: folds 
alexandru2111: raises 19302 to 21437 and is all-in
juegoimaginado: calls 6375 and is all-in
Uncalled bet (12927) returned to alexandru2111
*** TURN *** [2h 7s 3s] [Ks]
*** RIVER *** [2h 7s 3s Ks] [Jd]
*** SHOW DOWN ***
juegoimaginado: shows [As Kh] (a pair of Kings)
alexandru2111: shows [8c Th] (high pairOfCards King)
juegoimaginado collected 22290 from pot
*** SUMMARY ***
Total pot 22290 | Rake 0 
Board [2h 7s 3s Ks Jd]
Seat 1: juegoimaginado (small blind) showed [As Kh] and won (22290) with a pair of Kings
Seat 2: jcarlos.vale (big blind) folded before Flop
Seat 3: Everloooong folded before Flop (didn't bet)
Seat 4: ikayuk folded before Flop (didn't bet)
Seat 5: ecolife folded before Flop (didn't bet)
Seat 6: rinomarley420 folded before Flop (didn't bet)
Seat 7: kulbaba195445 folded on the Flop
Seat 8: BaD_BeRt68 folded before Flop (didn't bet)
Seat 9: alexandru2111 (button) showed [8c Th] and lost with high pairOfCards King



PokerStars Hand #222151795377: Tournament #3086083919, $0.49+$0.06 USD Hold'em No Limit - Level XIII (250/500) - 2021/01/02 23:16:44 EET [2021/01/02 16:16:44 ET]
Table '3086083919 117' 9-max Seat #1 is the button
Seat 1: juegoimaginado (22290 in chips) 
Seat 2: jcarlos.vale (17347 in chips) 
Seat 3: Everloooong (4175 in chips) 
Seat 4: ikayuk (16037 in chips) 
Seat 5: ecolife (20795 in chips) 
Seat 6: rinomarley420 (8757 in chips) is sitting out
Seat 7: kulbaba195445 (21052 in chips) 
Seat 8: BaD_BeRt68 (1343 in chips) is sitting out
Seat 9: alexandru2111 (12927 in chips) 
juegoimaginado: posts the ante 30
jcarlos.vale: posts the ante 30
Everloooong: posts the ante 30
ikayuk: posts the ante 30
ecolife: posts the ante 30
rinomarley420: posts the ante 30
kulbaba195445: posts the ante 30
BaD_BeRt68: posts the ante 30
alexandru2111: posts the ante 30
jcarlos.vale: posts small blind 250
Everloooong: posts big blind 500
*** HOLE CARDS ***
Dealt to jcarlos.vale [3s 2d]
ikayuk: folds 
ecolife: folds 
rinomarley420: folds 
kulbaba195445: folds 
BaD_BeRt68: folds 
alexandru2111 said, "putaaaaaa  raise for nothing? **** you and your mother!!!"
alexandru2111 said, "you are verry uglly!!!"
alexandru2111: calls 500
juegoimaginado: raises 2020 to 2520
jcarlos.vale: folds 
Everloooong: folds 
alexandru2111: calls 2020
*** FLOP *** [3c Qc 2h]
alexandru2111: checks 
juegoimaginado: bets 2530
alexandru2111 said, "putaaaaaaaaaa"
alexandru2111 said, "you and your mother"
alexandru2111 said, "bigggg"
alexandru2111 said, "putaaaa"
alexandru2111: folds 
Uncalled bet (2530) returned to juegoimaginado
juegoimaginado collected 6060 from pot
jcarlos.vale said, "go fish"
juegoimaginado: doesn't show handDTO
*** SUMMARY ***
Total pot 6060 | Rake 0 
Board [3c Qc 2h]
Seat 1: juegoimaginado (button) collected (6060)
Seat 2: jcarlos.vale (small blind) folded before Flop
Seat 3: Everloooong (big blind) folded before Flop
Seat 4: ikayuk folded before Flop (didn't bet)
Seat 5: ecolife folded before Flop (didn't bet)
Seat 6: rinomarley420 folded before Flop (didn't bet)
Seat 7: kulbaba195445 folded before Flop (didn't bet)
Seat 8: BaD_BeRt68 folded before Flop (didn't bet)
Seat 9: alexandru2111 folded on the Flop



PokerStars Hand #222151862836: Tournament #3086083919, $0.49+$0.06 USD Hold'em No Limit - Level XIII (250/500) - 2021/01/02 23:17:51 EET [2021/01/02 16:17:51 ET]
Table '3086083919 117' 9-max Seat #2 is the button
Seat 1: juegoimaginado (25800 in chips) 
Seat 2: jcarlos.vale (17067 in chips) 
Seat 3: Everloooong (3645 in chips) 
Seat 4: ikayuk (16007 in chips) 
Seat 5: ecolife (20765 in chips) 
Seat 6: rinomarley420 (8727 in chips) is sitting out
Seat 7: kulbaba195445 (21022 in chips) 
Seat 8: BaD_BeRt68 (1313 in chips) is sitting out
Seat 9: alexandru2111 (10377 in chips) 
juegoimaginado: posts the ante 30
jcarlos.vale: posts the ante 30
Everloooong: posts the ante 30
ikayuk: posts the ante 30
ecolife: posts the ante 30
rinomarley420: posts the ante 30
kulbaba195445: posts the ante 30
BaD_BeRt68: posts the ante 30
alexandru2111: posts the ante 30
Everloooong: posts small blind 250
ikayuk: posts big blind 500
*** HOLE CARDS ***
Dealt to jcarlos.vale [6c 6h]
alexandru2111 said, "raise for nothing"
ecolife: folds 
rinomarley420: folds 
kulbaba195445: folds 
BaD_BeRt68: folds 
alexandru2111 said, "1!!!"
alexandru2111: folds 
juegoimaginado: calls 500
jcarlos.vale: raises 800 to 1300
alexandru2111 said, "man raise for nothing?"
Everloooong: raises 2315 to 3615 and is all-in
ikayuk: folds 
juegoimaginado: folds 
jcarlos.vale: calls 2315
*** FLOP *** [9d 5d Kc]
alexandru2111 said, "incredible!!!"
*** TURN *** [9d 5d Kc] [8s]
*** RIVER *** [9d 5d Kc 8s] [Js]
*** SHOW DOWN ***
Everloooong: shows [5h 5c] (three of a kind, Fives)
jcarlos.vale: shows [6c 6h] (a pair of Sixes)
Everloooong collected 8500 from pot
*** SUMMARY ***
Total pot 8500 | Rake 0 
Board [9d 5d Kc 8s Js]
Seat 1: juegoimaginado folded before Flop
Seat 2: jcarlos.vale (button) showed [6c 6h] and lost with a pair of Sixes
Seat 3: Everloooong (small blind) showed [5h 5c] and won (8500) with three of a kind, Fives
Seat 4: ikayuk (big blind) folded before Flop
Seat 5: ecolife folded before Flop (didn't bet)
Seat 6: rinomarley420 folded before Flop (didn't bet)
Seat 7: kulbaba195445 folded before Flop (didn't bet)
Seat 8: BaD_BeRt68 folded before Flop (didn't bet)
Seat 9: alexandru2111 folded before Flop (didn't bet)



PokerStars Hand #222151901321: Tournament #3086083919, $0.49+$0.06 USD Hold'em No Limit - Level XIII (250/500) - 2021/01/02 23:18:30 EET [2021/01/02 16:18:30 ET]
Table '3086083919 117' 9-max Seat #3 is the button
Seat 1: juegoimaginado (25270 in chips) 
Seat 2: jcarlos.vale (13422 in chips) 
Seat 3: Everloooong (8500 in chips) 
Seat 4: ikayuk (15477 in chips) 
Seat 5: ecolife (20735 in chips) 
Seat 6: rinomarley420 (8697 in chips) is sitting out
Seat 7: kulbaba195445 (20992 in chips) 
Seat 8: BaD_BeRt68 (1283 in chips) is sitting out
Seat 9: alexandru2111 (10347 in chips) 
juegoimaginado: posts the ante 30
jcarlos.vale: posts the ante 30
Everloooong: posts the ante 30
ikayuk: posts the ante 30
ecolife: posts the ante 30
rinomarley420: posts the ante 30
kulbaba195445: posts the ante 30
BaD_BeRt68: posts the ante 30
alexandru2111: posts the ante 30
ikayuk: posts small blind 250
ecolife: posts big blind 500
*** HOLE CARDS ***
Dealt to jcarlos.vale [2s 7c]
rinomarley420: folds 
kulbaba195445: folds 
BaD_BeRt68: folds 
alexandru2111: folds 
juegoimaginado: folds 
jcarlos.vale: folds 
Everloooong: folds 
ikayuk: folds 
Uncalled bet (250) returned to ecolife
ecolife collected 770 from pot
*** SUMMARY ***
Total pot 770 | Rake 0 
Seat 1: juegoimaginado folded before Flop (didn't bet)
Seat 2: jcarlos.vale folded before Flop (didn't bet)
Seat 3: Everloooong (button) folded before Flop (didn't bet)
Seat 4: ikayuk (small blind) folded before Flop
Seat 5: ecolife (big blind) collected (770)
Seat 6: rinomarley420 folded before Flop (didn't bet)
Seat 7: kulbaba195445 folded before Flop (didn't bet)
Seat 8: BaD_BeRt68 folded before Flop (didn't bet)
Seat 9: alexandru2111 folded before Flop (didn't bet)



PokerStars Hand #222151921267: Tournament #3086083919, $0.49+$0.06 USD Hold'em No Limit - Level XIII (250/500) - 2021/01/02 23:18:50 EET [2021/01/02 16:18:50 ET]
Table '3086083919 117' 9-max Seat #4 is the button
Seat 1: juegoimaginado (25240 in chips) 
Seat 2: jcarlos.vale (13392 in chips) 
Seat 3: Everloooong (8470 in chips) 
Seat 4: ikayuk (15197 in chips) 
Seat 5: ecolife (21225 in chips) 
Seat 6: rinomarley420 (8667 in chips) is sitting out
Seat 7: kulbaba195445 (20962 in chips) 
Seat 8: BaD_BeRt68 (1253 in chips) is sitting out
Seat 9: alexandru2111 (10317 in chips) 
juegoimaginado: posts the ante 30
jcarlos.vale: posts the ante 30
Everloooong: posts the ante 30
ikayuk: posts the ante 30
ecolife: posts the ante 30
rinomarley420: posts the ante 30
kulbaba195445: posts the ante 30
BaD_BeRt68: posts the ante 30
alexandru2111: posts the ante 30
ecolife: posts small blind 250
rinomarley420: posts big blind 500
*** HOLE CARDS ***
Dealt to jcarlos.vale [7s 4d]
kulbaba195445: folds 
BaD_BeRt68: folds 
alexandru2111: folds 
juegoimaginado: folds 
jcarlos.vale: folds 
jcarlos.vale said, "you will give the chis"
jcarlos.vale said, "chips"
Everloooong: raises 500 to 1000
ikayuk: folds 
ecolife: raises 20195 to 21195 and is all-in
rinomarley420: folds 
Everloooong: folds 
Uncalled bet (20195) returned to ecolife
ecolife collected 2770 from pot
*** SUMMARY ***
Total pot 2770 | Rake 0 
Seat 1: juegoimaginado folded before Flop (didn't bet)
Seat 2: jcarlos.vale folded before Flop (didn't bet)
Seat 3: Everloooong folded before Flop
Seat 4: ikayuk (button) folded before Flop (didn't bet)
Seat 5: ecolife (small blind) collected (2770)
Seat 6: rinomarley420 (big blind) folded before Flop
Seat 7: kulbaba195445 folded before Flop (didn't bet)
Seat 8: BaD_BeRt68 folded before Flop (didn't bet)
Seat 9: alexandru2111 folded before Flop (didn't bet)



PokerStars Hand #222151947826: Tournament #3086083919, $0.49+$0.06 USD Hold'em No Limit - Level XIII (250/500) - 2021/01/02 23:19:17 EET [2021/01/02 16:19:17 ET]
Table '3086083919 117' 9-max Seat #5 is the button
Seat 1: juegoimaginado (25210 in chips) 
Seat 2: jcarlos.vale (13362 in chips) 
Seat 3: Everloooong (7440 in chips) 
Seat 4: ikayuk (15167 in chips) 
Seat 5: ecolife (22965 in chips) 
Seat 6: rinomarley420 (8137 in chips) is sitting out
Seat 7: kulbaba195445 (20932 in chips) 
Seat 8: BaD_BeRt68 (1223 in chips) is sitting out
Seat 9: alexandru2111 (10287 in chips) 
juegoimaginado: posts the ante 30
jcarlos.vale: posts the ante 30
Everloooong: posts the ante 30
ikayuk: posts the ante 30
ecolife: posts the ante 30
rinomarley420: posts the ante 30
kulbaba195445: posts the ante 30
BaD_BeRt68: posts the ante 30
alexandru2111: posts the ante 30
rinomarley420: posts small blind 250
kulbaba195445: posts big blind 500
*** HOLE CARDS ***
Dealt to jcarlos.vale [7s 2h]
BaD_BeRt68: folds 
alexandru2111: calls 500
juegoimaginado: folds 
jcarlos.vale: folds 
Everloooong: folds 
ikayuk: folds 
ecolife: folds 
rinomarley420: folds 
kulbaba195445: checks 
*** FLOP *** [5c 9c 2d]
kulbaba195445: checks 
alexandru2111: bets 9757 and is all-in
kulbaba195445: folds 
Uncalled bet (9757) returned to alexandru2111
alexandru2111 collected 1520 from pot
alexandru2111: doesn't show handDTO
*** SUMMARY ***
Total pot 1520 | Rake 0 
Board [5c 9c 2d]
Seat 1: juegoimaginado folded before Flop (didn't bet)
Seat 2: jcarlos.vale folded before Flop (didn't bet)
Seat 3: Everloooong folded before Flop (didn't bet)
Seat 4: ikayuk folded before Flop (didn't bet)
Seat 5: ecolife (button) folded before Flop (didn't bet)
Seat 6: rinomarley420 (small blind) folded before Flop
Seat 7: kulbaba195445 (big blind) folded on the Flop
Seat 8: BaD_BeRt68 folded before Flop (didn't bet)
Seat 9: alexandru2111 collected (1520)



PokerStars Hand #222151974606: Tournament #3086083919, $0.49+$0.06 USD Hold'em No Limit - Level XIII (250/500) - 2021/01/02 23:19:44 EET [2021/01/02 16:19:44 ET]
Table '3086083919 117' 9-max Seat #6 is the button
Seat 1: juegoimaginado (25180 in chips) 
Seat 2: jcarlos.vale (13332 in chips) 
Seat 3: Everloooong (7410 in chips) 
Seat 4: ikayuk (15137 in chips) 
Seat 5: ecolife (22935 in chips) 
Seat 6: rinomarley420 (7857 in chips) is sitting out
Seat 7: kulbaba195445 (20402 in chips) 
Seat 8: BaD_BeRt68 (1193 in chips) is sitting out
Seat 9: alexandru2111 (11277 in chips) 
juegoimaginado: posts the ante 30
jcarlos.vale: posts the ante 30
Everloooong: posts the ante 30
ikayuk: posts the ante 30
ecolife: posts the ante 30
rinomarley420: posts the ante 30
kulbaba195445: posts the ante 30
BaD_BeRt68: posts the ante 30
alexandru2111: posts the ante 30
kulbaba195445: posts small blind 250
BaD_BeRt68: posts big blind 500
*** HOLE CARDS ***
Dealt to jcarlos.vale [Jd Kc]
rinomarley420 has returned
alexandru2111: calls 500
juegoimaginado: folds 
jcarlos.vale: raises 800 to 1300
Everloooong: folds 
ikayuk: folds 
ecolife: folds 
rinomarley420 has timed out
rinomarley420: folds 
rinomarley420 is sitting out
kulbaba195445: folds 
BaD_BeRt68: folds 
alexandru2111: calls 800
*** FLOP *** [Td Ah 2c]
alexandru2111: checks 
jcarlos.vale: checks 
*** TURN *** [Td Ah 2c] [3h]
alexandru2111: checks 
jcarlos.vale: checks 
*** RIVER *** [Td Ah 2c 3h] [8d]
alexandru2111: checks 
jcarlos.vale: checks 
*** SHOW DOWN ***
alexandru2111: shows [Kd 5c] (high pairOfCards Ace)
jcarlos.vale: shows [Jd Kc] (high pairOfCards Ace - King+Jack kicker)
jcarlos.vale collected 3620 from pot
*** SUMMARY ***
Total pot 3620 | Rake 0 
Board [Td Ah 2c 3h 8d]
Seat 1: juegoimaginado folded before Flop (didn't bet)
Seat 2: jcarlos.vale showed [Jd Kc] and won (3620) with high pairOfCards Ace
Seat 3: Everloooong folded before Flop (didn't bet)
Seat 4: ikayuk folded before Flop (didn't bet)
Seat 5: ecolife folded before Flop (didn't bet)
Seat 6: rinomarley420 (button) folded before Flop (didn't bet)
Seat 7: kulbaba195445 (small blind) folded before Flop
Seat 8: BaD_BeRt68 (big blind) folded before Flop
Seat 9: alexandru2111 showed [Kd 5c] and lost with high pairOfCards Ace



PokerStars Hand #222152020002: Tournament #3086083919, $0.49+$0.06 USD Hold'em No Limit - Level XIII (250/500) - 2021/01/02 23:20:30 EET [2021/01/02 16:20:30 ET]
Table '3086083919 117' 9-max Seat #7 is the button
Seat 1: juegoimaginado (25150 in chips) 
Seat 2: jcarlos.vale (15622 in chips) 
Seat 3: Everloooong (7380 in chips) 
Seat 4: ikayuk (15107 in chips) 
Seat 5: ecolife (22905 in chips) 
Seat 6: rinomarley420 (7827 in chips) is sitting out
Seat 7: kulbaba195445 (20122 in chips) 
Seat 8: BaD_BeRt68 (663 in chips) is sitting out
Seat 9: alexandru2111 (9947 in chips) 
juegoimaginado: posts the ante 30
jcarlos.vale: posts the ante 30
Everloooong: posts the ante 30
ikayuk: posts the ante 30
ecolife: posts the ante 30
rinomarley420: posts the ante 30
kulbaba195445: posts the ante 30
BaD_BeRt68: posts the ante 30
alexandru2111: posts the ante 30
BaD_BeRt68: posts small blind 250
alexandru2111: posts big blind 500
*** HOLE CARDS ***
Dealt to jcarlos.vale [5h 4s]
juegoimaginado: folds 
jcarlos.vale: folds 
Everloooong: folds 
ikayuk: folds 
ecolife: folds 
rinomarley420: folds 
kulbaba195445: calls 500
BaD_BeRt68: folds 
alexandru2111: checks 
*** FLOP *** [Qh Ad 9h]
rinomarley420 has returned
alexandru2111: checks 
kulbaba195445: checks 
*** TURN *** [Qh Ad 9h] [Kh]
alexandru2111: checks 
kulbaba195445: bets 500
alexandru2111: folds 
Uncalled bet (500) returned to kulbaba195445
kulbaba195445 collected 1520 from pot
*** SUMMARY ***
Total pot 1520 | Rake 0 
Board [Qh Ad 9h Kh]
Seat 1: juegoimaginado folded before Flop (didn't bet)
Seat 2: jcarlos.vale folded before Flop (didn't bet)
Seat 3: Everloooong folded before Flop (didn't bet)
Seat 4: ikayuk folded before Flop (didn't bet)
Seat 5: ecolife folded before Flop (didn't bet)
Seat 6: rinomarley420 folded before Flop (didn't bet)
Seat 7: kulbaba195445 (button) collected (1520)
Seat 8: BaD_BeRt68 (small blind) folded before Flop
Seat 9: alexandru2111 (big blind) folded on the Turn



PokerStars Hand #222152043161: Tournament #3086083919, $0.49+$0.06 USD Hold'em No Limit - Level XIII (250/500) - 2021/01/02 23:20:53 EET [2021/01/02 16:20:53 ET]
Table '3086083919 117' 9-max Seat #8 is the button
Seat 1: juegoimaginado (25120 in chips) 
Seat 2: jcarlos.vale (15592 in chips) 
Seat 3: Everloooong (7350 in chips) 
Seat 4: ikayuk (15077 in chips) 
Seat 5: ecolife (22875 in chips) 
Seat 6: rinomarley420 (7797 in chips) 
Seat 7: kulbaba195445 (21112 in chips) 
Seat 8: BaD_BeRt68 (383 in chips) is sitting out
Seat 9: alexandru2111 (9417 in chips) 
juegoimaginado: posts the ante 30
jcarlos.vale: posts the ante 30
Everloooong: posts the ante 30
ikayuk: posts the ante 30
ecolife: posts the ante 30
rinomarley420: posts the ante 30
kulbaba195445: posts the ante 30
BaD_BeRt68: posts the ante 30
alexandru2111: posts the ante 30
alexandru2111: posts small blind 250
juegoimaginado: posts big blind 500
*** HOLE CARDS ***
Dealt to jcarlos.vale [9s Ts]
jcarlos.vale: folds 
Everloooong: folds 
ikayuk: folds 
ecolife: raises 500 to 1000
rinomarley420 has timed out
rinomarley420: folds 
rinomarley420 is sitting out
kulbaba195445: folds 
BaD_BeRt68: folds 
alexandru2111: raises 8387 to 9387 and is all-in
juegoimaginado: folds 
ecolife: calls 8387
*** FLOP *** [4d 9h Th]
*** TURN *** [4d 9h Th] [4h]
*** RIVER *** [4d 9h Th 4h] [6h]
rinomarley420 has returned
*** SHOW DOWN ***
alexandru2111: shows [Ad 8h] (a flush, Ten high)
ecolife: shows [7h 7s] (a flush, Ten high - lower pairOfCards)
alexandru2111 collected 19544 from pot
*** SUMMARY ***
Total pot 19544 | Rake 0 
Board [4d 9h Th 4h 6h]
Seat 1: juegoimaginado (big blind) folded before Flop
Seat 2: jcarlos.vale folded before Flop (didn't bet)
Seat 3: Everloooong folded before Flop (didn't bet)
Seat 4: ikayuk folded before Flop (didn't bet)
Seat 5: ecolife showed [7h 7s] and lost with a flush, Ten high
Seat 6: rinomarley420 folded before Flop (didn't bet)
Seat 7: kulbaba195445 folded before Flop (didn't bet)
Seat 8: BaD_BeRt68 (button) folded before Flop (didn't bet)
Seat 9: alexandru2111 (small blind) showed [Ad 8h] and won (19544) with a flush, Ten high



PokerStars Hand #222152084808: Tournament #3086083919, $0.49+$0.06 USD Hold'em No Limit - Level XIII (250/500) - 2021/01/02 23:21:35 EET [2021/01/02 16:21:35 ET]
Table '3086083919 117' 9-max Seat #9 is the button
Seat 1: juegoimaginado (24590 in chips) 
Seat 2: jcarlos.vale (15562 in chips) 
Seat 3: Everloooong (7320 in chips) 
Seat 4: ikayuk (15047 in chips) 
Seat 5: ecolife (13458 in chips) 
Seat 6: rinomarley420 (7767 in chips) 
Seat 7: kulbaba195445 (21082 in chips) 
Seat 8: BaD_BeRt68 (353 in chips) is sitting out
Seat 9: alexandru2111 (19544 in chips) 
juegoimaginado: posts the ante 30
jcarlos.vale: posts the ante 30
Everloooong: posts the ante 30
ikayuk: posts the ante 30
ecolife: posts the ante 30
rinomarley420: posts the ante 30
kulbaba195445: posts the ante 30
BaD_BeRt68: posts the ante 30
alexandru2111: posts the ante 30
juegoimaginado: posts small blind 250
jcarlos.vale: posts big blind 500
*** HOLE CARDS ***
Dealt to jcarlos.vale [Ts 8s]
Everloooong: folds 
ikayuk: folds 
ecolife: raises 12928 to 13428 and is all-in
rinomarley420: folds 
kulbaba195445: folds 
BaD_BeRt68: folds 
alexandru2111: folds 
juegoimaginado: folds 
jcarlos.vale: folds 
Uncalled bet (12928) returned to ecolife
ecolife collected 1520 from pot
*** SUMMARY ***
Total pot 1520 | Rake 0 
Seat 1: juegoimaginado (small blind) folded before Flop
Seat 2: jcarlos.vale (big blind) folded before Flop
Seat 3: Everloooong folded before Flop (didn't bet)
Seat 4: ikayuk folded before Flop (didn't bet)
Seat 5: ecolife collected (1520)
Seat 6: rinomarley420 folded before Flop (didn't bet)
Seat 7: kulbaba195445 folded before Flop (didn't bet)
Seat 8: BaD_BeRt68 folded before Flop (didn't bet)
Seat 9: alexandru2111 (button) folded before Flop (didn't bet)



PokerStars Hand #222152112282: Tournament #3086083919, $0.49+$0.06 USD Hold'em No Limit - Level XIII (250/500) - 2021/01/02 23:21:57 EET [2021/01/02 16:21:57 ET]
Table '3086083919 117' 9-max Seat #1 is the button
Seat 1: juegoimaginado (24310 in chips) 
Seat 2: jcarlos.vale (15032 in chips) 
Seat 3: Everloooong (7290 in chips) 
Seat 4: ikayuk (15017 in chips) 
Seat 5: ecolife (14448 in chips) 
Seat 6: rinomarley420 (7737 in chips) 
Seat 7: kulbaba195445 (21052 in chips) 
Seat 8: BaD_BeRt68 (323 in chips) is sitting out
Seat 9: alexandru2111 (19514 in chips) 
juegoimaginado: posts the ante 30
jcarlos.vale: posts the ante 30
Everloooong: posts the ante 30
ikayuk: posts the ante 30
ecolife: posts the ante 30
rinomarley420: posts the ante 30
kulbaba195445: posts the ante 30
BaD_BeRt68: posts the ante 30
alexandru2111: posts the ante 30
jcarlos.vale: posts small blind 250
Everloooong: posts big blind 500
*** HOLE CARDS ***
Dealt to jcarlos.vale [Qh 3d]
ikayuk: folds 
ecolife: raises 500 to 1000
rinomarley420: folds 
kulbaba195445: folds 
BaD_BeRt68: folds 
alexandru2111: calls 1000
juegoimaginado: folds 
jcarlos.vale: folds 
Everloooong: folds 
*** FLOP *** [As 2h 9s]
ecolife: checks 
alexandru2111: checks 
*** TURN *** [As 2h 9s] [5h]
ecolife: bets 1510
alexandru2111: calls 1510
*** RIVER *** [As 2h 9s 5h] [6s]
ecolife: bets 1908
alexandru2111: raises 15066 to 16974 and is all-in
ecolife: calls 10000 and is all-in
Uncalled bet (5066) returned to alexandru2111
*** SHOW DOWN ***
alexandru2111: shows [7h 8d] (a straight, Five to Nine)
ecolife: shows [Kd Kh] (a pair of Kings)
alexandru2111 collected 29856 from pot
ecolife finished the tournament in 882nd place
*** SUMMARY ***
Total pot 29856 | Rake 0 
Board [As 2h 9s 5h 6s]
Seat 1: juegoimaginado (button) folded before Flop (didn't bet)
Seat 2: jcarlos.vale (small blind) folded before Flop
Seat 3: Everloooong (big blind) folded before Flop
Seat 4: ikayuk folded before Flop (didn't bet)
Seat 5: ecolife showed [Kd Kh] and lost with a pair of Kings
Seat 6: rinomarley420 folded before Flop (didn't bet)
Seat 7: kulbaba195445 folded before Flop (didn't bet)
Seat 8: BaD_BeRt68 folded before Flop (didn't bet)
Seat 9: alexandru2111 showed [7h 8d] and won (29856) with a straight, Five to Nine



PokerStars Hand #222152159954: Tournament #3086083919, $0.49+$0.06 USD Hold'em No Limit - Level XIII (250/500) - 2021/01/02 23:22:46 EET [2021/01/02 16:22:46 ET]
Table '3086083919 117' 9-max Seat #2 is the button
Seat 1: juegoimaginado (24280 in chips) 
Seat 2: jcarlos.vale (14752 in chips) 
Seat 3: Everloooong (6760 in chips) 
Seat 4: ikayuk (14987 in chips) 
Seat 6: rinomarley420 (7707 in chips) 
Seat 7: kulbaba195445 (21022 in chips) 
Seat 8: BaD_BeRt68 (293 in chips) is sitting out
Seat 9: alexandru2111 (34922 in chips) 
juegoimaginado: posts the ante 30
jcarlos.vale: posts the ante 30
Everloooong: posts the ante 30
ikayuk: posts the ante 30
rinomarley420: posts the ante 30
kulbaba195445: posts the ante 30
BaD_BeRt68: posts the ante 30
alexandru2111: posts the ante 30
Everloooong: posts small blind 250
ikayuk: posts big blind 500
*** HOLE CARDS ***
Dealt to jcarlos.vale [3h 3s]
rinomarley420: folds 
kulbaba195445: folds 
BaD_BeRt68: folds 
alexandru2111: calls 500
juegoimaginado: folds 
jcarlos.vale: calls 500
Everloooong: folds 
ikayuk: checks 
*** FLOP *** [Jc Qh Jh]
ikayuk: checks 
alexandru2111: checks 
jcarlos.vale: bets 1000
ikayuk: folds 
alexandru2111: folds 
Uncalled bet (1000) returned to jcarlos.vale
jcarlos.vale collected 1990 from pot
jcarlos.vale: doesn't show handDTO
*** SUMMARY ***
Total pot 1990 | Rake 0 
Board [Jc Qh Jh]
Seat 1: juegoimaginado folded before Flop (didn't bet)
Seat 2: jcarlos.vale (button) collected (1990)
Seat 3: Everloooong (small blind) folded before Flop
Seat 4: ikayuk (big blind) folded on the Flop
Seat 6: rinomarley420 folded before Flop (didn't bet)
Seat 7: kulbaba195445 folded before Flop (didn't bet)
Seat 8: BaD_BeRt68 folded before Flop (didn't bet)
Seat 9: alexandru2111 folded on the Flop



PokerStars Hand #222152196506: Tournament #3086083919, $0.49+$0.06 USD Hold'em No Limit - Level XIII (250/500) - 2021/01/02 23:23:23 EET [2021/01/02 16:23:23 ET]
Table '3086083919 117' 9-max Seat #3 is the button
Seat 1: juegoimaginado (24250 in chips) 
Seat 2: jcarlos.vale (16212 in chips) 
Seat 3: Everloooong (6480 in chips) 
Seat 4: ikayuk (14457 in chips) 
Seat 5: El Loco171717 (39797 in chips) 
Seat 6: rinomarley420 (7677 in chips) 
Seat 7: kulbaba195445 (20992 in chips) 
Seat 8: BaD_BeRt68 (263 in chips) is sitting out
Seat 9: alexandru2111 (34392 in chips) 
juegoimaginado: posts the ante 30
jcarlos.vale: posts the ante 30
Everloooong: posts the ante 30
ikayuk: posts the ante 30
El Loco171717: posts the ante 30
rinomarley420: posts the ante 30
kulbaba195445: posts the ante 30
BaD_BeRt68: posts the ante 30
alexandru2111: posts the ante 30
ikayuk: posts small blind 250
El Loco171717: posts big blind 500
*** HOLE CARDS ***
Dealt to jcarlos.vale [9d 3d]
rinomarley420: folds 
kulbaba195445: calls 500
BaD_BeRt68: folds 
alexandru2111: folds 
juegoimaginado: folds 
jcarlos.vale: folds 
Everloooong: folds 
ikayuk: folds 
El Loco171717: checks 
*** FLOP *** [Ah Jd 3s]
El Loco171717: checks 
kulbaba195445: bets 500
El Loco171717: folds 
Uncalled bet (500) returned to kulbaba195445
kulbaba195445 collected 1520 from pot
*** SUMMARY ***
Total pot 1520 | Rake 0 
Board [Ah Jd 3s]
Seat 1: juegoimaginado folded before Flop (didn't bet)
Seat 2: jcarlos.vale folded before Flop (didn't bet)
Seat 3: Everloooong (button) folded before Flop (didn't bet)
Seat 4: ikayuk (small blind) folded before Flop
Seat 5: El Loco171717 (big blind) folded on the Flop
Seat 6: rinomarley420 folded before Flop (didn't bet)
Seat 7: kulbaba195445 collected (1520)
Seat 8: BaD_BeRt68 folded before Flop (didn't bet)
Seat 9: alexandru2111 folded before Flop (didn't bet)



PokerStars Hand #222152228773: Tournament #3086083919, $0.49+$0.06 USD Hold'em No Limit - Level XIII (250/500) - 2021/01/02 23:23:56 EET [2021/01/02 16:23:56 ET]
Table '3086083919 117' 9-max Seat #4 is the button
Seat 1: juegoimaginado (24220 in chips) 
Seat 2: jcarlos.vale (16182 in chips) 
Seat 3: Everloooong (6450 in chips) 
Seat 4: ikayuk (14177 in chips) 
Seat 5: El Loco171717 (39267 in chips) 
Seat 6: rinomarley420 (7647 in chips) 
Seat 7: kulbaba195445 (21982 in chips) 
Seat 8: BaD_BeRt68 (233 in chips) is sitting out
Seat 9: alexandru2111 (34362 in chips) 
juegoimaginado: posts the ante 30
jcarlos.vale: posts the ante 30
Everloooong: posts the ante 30
ikayuk: posts the ante 30
El Loco171717: posts the ante 30
rinomarley420: posts the ante 30
kulbaba195445: posts the ante 30
BaD_BeRt68: posts the ante 30
alexandru2111: posts the ante 30
El Loco171717: posts small blind 250
rinomarley420: posts big blind 500
*** HOLE CARDS ***
Dealt to jcarlos.vale [2d 9c]
kulbaba195445: folds 
BaD_BeRt68: folds 
alexandru2111: folds 
juegoimaginado: folds 
jcarlos.vale: folds 
Everloooong: raises 5920 to 6420 and is all-in
ikayuk: folds 
El Loco171717: folds 
rinomarley420: folds 
Uncalled bet (5920) returned to Everloooong
Everloooong collected 1520 from pot
Everloooong: doesn't show handDTO
*** SUMMARY ***
Total pot 1520 | Rake 0 
Seat 1: juegoimaginado folded before Flop (didn't bet)
Seat 2: jcarlos.vale folded before Flop (didn't bet)
Seat 3: Everloooong collected (1520)
Seat 4: ikayuk (button) folded before Flop (didn't bet)
Seat 5: El Loco171717 (small blind) folded before Flop
Seat 6: rinomarley420 (big blind) folded before Flop
Seat 7: kulbaba195445 folded before Flop (didn't bet)
Seat 8: BaD_BeRt68 folded before Flop (didn't bet)
Seat 9: alexandru2111 folded before Flop (didn't bet)



PokerStars Hand #222152245210: Tournament #3086083919, $0.49+$0.06 USD Hold'em No Limit - Level XIII (250/500) - 2021/01/02 23:24:12 EET [2021/01/02 16:24:12 ET]
Table '3086083919 117' 9-max Seat #5 is the button
Seat 1: juegoimaginado (24190 in chips) 
Seat 2: jcarlos.vale (16152 in chips) 
Seat 3: Everloooong (7440 in chips) 
Seat 4: ikayuk (14147 in chips) 
Seat 5: El Loco171717 (38987 in chips) 
Seat 6: rinomarley420 (7117 in chips) 
Seat 7: kulbaba195445 (21952 in chips) 
Seat 8: BaD_BeRt68 (203 in chips) is sitting out
Seat 9: alexandru2111 (34332 in chips) 
juegoimaginado: posts the ante 30
jcarlos.vale: posts the ante 30
Everloooong: posts the ante 30
ikayuk: posts the ante 30
El Loco171717: posts the ante 30
rinomarley420: posts the ante 30
kulbaba195445: posts the ante 30
BaD_BeRt68: posts the ante 30
alexandru2111: posts the ante 30
rinomarley420: posts small blind 250
kulbaba195445: posts big blind 500
*** HOLE CARDS ***
Dealt to jcarlos.vale [9c 9d]
BaD_BeRt68: folds 
alexandru2111: calls 500
juegoimaginado: folds 
jcarlos.vale: raises 1500 to 2000
Everloooong: folds 
ikayuk: calls 2000
El Loco171717: folds 
rinomarley420: folds 
kulbaba195445: folds 
alexandru2111: folds 
*** FLOP *** [As Ks 7h]
jcarlos.vale: checks 
ikayuk: checks 
*** TURN *** [As Ks 7h] [6c]
BaD_BeRt68 has returned
jcarlos.vale: bets 1500
ikayuk: raises 1500 to 3000
jcarlos.vale: folds 
Uncalled bet (1500) returned to ikayuk
ikayuk collected 8520 from pot
ikayuk: doesn't show handDTO
*** SUMMARY ***
Total pot 8520 | Rake 0 
Board [As Ks 7h 6c]
Seat 1: juegoimaginado folded before Flop (didn't bet)
Seat 2: jcarlos.vale folded on the Turn
Seat 3: Everloooong folded before Flop (didn't bet)
Seat 4: ikayuk collected (8520)
Seat 5: El Loco171717 (button) folded before Flop (didn't bet)
Seat 6: rinomarley420 (small blind) folded before Flop
Seat 7: kulbaba195445 (big blind) folded before Flop
Seat 8: BaD_BeRt68 folded before Flop (didn't bet)
Seat 9: alexandru2111 folded before Flop



PokerStars Hand #222152282525: Tournament #3086083919, $0.49+$0.06 USD Hold'em No Limit - Level XIV (300/600) - 2021/01/02 23:24:50 EET [2021/01/02 16:24:50 ET]
Table '3086083919 117' 9-max Seat #6 is the button
Seat 1: juegoimaginado (24160 in chips) 
Seat 2: jcarlos.vale (12622 in chips) 
Seat 3: Everloooong (7410 in chips) 
Seat 4: ikayuk (19137 in chips) 
Seat 5: El Loco171717 (38957 in chips) 
Seat 6: rinomarley420 (6837 in chips) 
Seat 7: kulbaba195445 (21422 in chips) 
Seat 8: BaD_BeRt68 (173 in chips) 
Seat 9: alexandru2111 (33802 in chips) 
juegoimaginado: posts the ante 40
jcarlos.vale: posts the ante 40
Everloooong: posts the ante 40
ikayuk: posts the ante 40
El Loco171717: posts the ante 40
rinomarley420: posts the ante 40
kulbaba195445: posts the ante 40
BaD_BeRt68: posts the ante 40
alexandru2111: posts the ante 40
kulbaba195445: posts small blind 300
BaD_BeRt68: posts big blind 133 and is all-in
*** HOLE CARDS ***
Dealt to jcarlos.vale [9c Tc]
alexandru2111: calls 600
juegoimaginado: raises 600 to 1200
jcarlos.vale: folds 
Everloooong: folds 
ikayuk: folds 
El Loco171717: folds 
rinomarley420: folds 
kulbaba195445: folds 
alexandru2111: calls 600
*** FLOP *** [Ac 8h 6s]
alexandru2111: checks 
juegoimaginado: bets 1200
alexandru2111: folds [Qc Kd]
Uncalled bet (1200) returned to juegoimaginado
*** TURN *** [Ac 8h 6s] [2h]
*** RIVER *** [Ac 8h 6s 2h] [Jd]
*** SHOW DOWN ***
juegoimaginado: shows [9s 9h] (a pair of Nines)
juegoimaginado collected 2301 from side pot
BaD_BeRt68: shows [7h Jh] (a pair of Jacks)
BaD_BeRt68 collected 892 from main pot
*** SUMMARY ***
Total pot 3193 Main pot 892. Side pot 2301. | Rake 0 
Board [Ac 8h 6s 2h Jd]
Seat 1: juegoimaginado showed [9s 9h] and won (2301) with a pair of Nines
Seat 2: jcarlos.vale folded before Flop (didn't bet)
Seat 3: Everloooong folded before Flop (didn't bet)
Seat 4: ikayuk folded before Flop (didn't bet)
Seat 5: El Loco171717 folded before Flop (didn't bet)
Seat 6: rinomarley420 (button) folded before Flop (didn't bet)
Seat 7: kulbaba195445 (small blind) folded before Flop
Seat 8: BaD_BeRt68 (big blind) showed [7h Jh] and won (892) with a pair of Jacks
Seat 9: alexandru2111 folded on the Flop



PokerStars Hand #222152316273: Tournament #3086083919, $0.49+$0.06 USD Hold'em No Limit - Level XIV (300/600) - 2021/01/02 23:25:25 EET [2021/01/02 16:25:25 ET]
Table '3086083919 117' 9-max Seat #7 is the button
Seat 1: juegoimaginado (25221 in chips) 
Seat 2: jcarlos.vale (12582 in chips) 
Seat 3: Everloooong (7370 in chips) 
Seat 4: ikayuk (19097 in chips) 
Seat 5: El Loco171717 (38917 in chips) 
Seat 6: rinomarley420 (6797 in chips) 
Seat 7: kulbaba195445 (21082 in chips) 
Seat 8: BaD_BeRt68 (892 in chips) 
Seat 9: alexandru2111 (32562 in chips) 
juegoimaginado: posts the ante 40
jcarlos.vale: posts the ante 40
Everloooong: posts the ante 40
ikayuk: posts the ante 40
El Loco171717: posts the ante 40
rinomarley420: posts the ante 40
kulbaba195445: posts the ante 40
BaD_BeRt68: posts the ante 40
alexandru2111: posts the ante 40
BaD_BeRt68: posts small blind 300
alexandru2111: posts big blind 600
*** HOLE CARDS ***
Dealt to jcarlos.vale [As 3h]
juegoimaginado: folds 
jcarlos.vale: folds 
Everloooong: raises 600 to 1200
ikayuk: folds 
El Loco171717: calls 1200
rinomarley420: folds 
kulbaba195445: folds 
BaD_BeRt68: calls 552 and is all-in
alexandru2111: calls 600
*** FLOP *** [7s 7h 9c]
alexandru2111: checks 
Everloooong: bets 6130 and is all-in
El Loco171717: calls 6130
alexandru2111: folds 
*** TURN *** [7s 7h 9c] [6d]
*** RIVER *** [7s 7h 9c 6d] [8c]
*** SHOW DOWN ***
Everloooong: shows [9d Ad] (two pair, Nines and Sevens)
El Loco171717: shows [Qs Qh] (two pair, Queens and Sevens)
El Loco171717 collected 13304 from side pot
BaD_BeRt68: shows [Kc 6c] (two pair, Sevens and Sixes)
El Loco171717 collected 3768 from main pot
Everloooong finished the tournament in 838th place
BaD_BeRt68 finished the tournament in 839th place
*** SUMMARY ***
Total pot 17072 Main pot 3768. Side pot 13304. | Rake 0 
Board [7s 7h 9c 6d 8c]
Seat 1: juegoimaginado folded before Flop (didn't bet)
Seat 2: jcarlos.vale folded before Flop (didn't bet)
Seat 3: Everloooong showed [9d Ad] and lost with two pair, Nines and Sevens
Seat 4: ikayuk folded before Flop (didn't bet)
Seat 5: El Loco171717 showed [Qs Qh] and won (17072) with two pair, Queens and Sevens
Seat 6: rinomarley420 folded before Flop (didn't bet)
Seat 7: kulbaba195445 (button) folded before Flop (didn't bet)
Seat 8: BaD_BeRt68 (small blind) showed [Kc 6c] and lost with two pair, Sevens and Sixes
Seat 9: alexandru2111 (big blind) folded on the Flop



PokerStars Hand #222152377364: Tournament #3086083919, $0.49+$0.06 USD Hold'em No Limit - Level XIV (300/600) - 2021/01/02 23:26:26 EET [2021/01/02 16:26:26 ET]
Table '3086083919 96' 9-max Seat #9 is the button
Seat 1: vladlen101 (19426 in chips) 
Seat 2: jcarlos.vale (12542 in chips) 
Seat 3: MishaSleep (42640 in chips) 
Seat 4: mariafirmina (24130 in chips) 
Seat 5: felipeando (5805 in chips) 
Seat 6: jordan202025 (8175 in chips) 
Seat 7: YaR1qq (33085 in chips) 
Seat 8: Negrata (22865 in chips) 
Seat 9: rac12345 (35138 in chips) 
vladlen101: posts the ante 40
jcarlos.vale: posts the ante 40
MishaSleep: posts the ante 40
mariafirmina: posts the ante 40
felipeando: posts the ante 40
jordan202025: posts the ante 40
YaR1qq: posts the ante 40
Negrata: posts the ante 40
rac12345: posts the ante 40
vladlen101: posts small blind 300
jcarlos.vale: posts big blind 600
*** HOLE CARDS ***
Dealt to jcarlos.vale [Jd 6h]
MishaSleep: folds 
mariafirmina: raises 600 to 1200
felipeando: folds 
jordan202025: folds 
YaR1qq: folds 
Negrata: folds 
rac12345: folds 
vladlen101: folds 
jcarlos.vale: folds 
Uncalled bet (600) returned to mariafirmina
mariafirmina collected 1860 from pot
*** SUMMARY ***
Total pot 1860 | Rake 0 
Seat 1: vladlen101 (small blind) folded before Flop
Seat 2: jcarlos.vale (big blind) folded before Flop
Seat 3: MishaSleep folded before Flop (didn't bet)
Seat 4: mariafirmina collected (1860)
Seat 5: felipeando folded before Flop (didn't bet)
Seat 6: jordan202025 folded before Flop (didn't bet)
Seat 7: YaR1qq folded before Flop (didn't bet)
Seat 8: Negrata folded before Flop (didn't bet)
Seat 9: rac12345 (button) folded before Flop (didn't bet)



PokerStars Hand #222152424200: Tournament #3086083919, $0.49+$0.06 USD Hold'em No Limit - Level XIV (300/600) - 2021/01/02 23:27:13 EET [2021/01/02 16:27:13 ET]
Table '3086083919 96' 9-max Seat #1 is the button
Seat 1: vladlen101 (19086 in chips) 
Seat 2: jcarlos.vale (11902 in chips) 
Seat 3: MishaSleep (42600 in chips) 
Seat 4: mariafirmina (25350 in chips) 
Seat 5: felipeando (5765 in chips) 
Seat 6: jordan202025 (8135 in chips) 
Seat 7: YaR1qq (33045 in chips) 
Seat 8: Negrata (22825 in chips) 
Seat 9: rac12345 (35098 in chips) 
vladlen101: posts the ante 40
jcarlos.vale: posts the ante 40
MishaSleep: posts the ante 40
mariafirmina: posts the ante 40
felipeando: posts the ante 40
jordan202025: posts the ante 40
YaR1qq: posts the ante 40
Negrata: posts the ante 40
rac12345: posts the ante 40
jcarlos.vale: posts small blind 300
MishaSleep: posts big blind 600
*** HOLE CARDS ***
Dealt to jcarlos.vale [5s 3h]
mariafirmina: folds 
felipeando: folds 
jordan202025: folds 
YaR1qq: folds 
Negrata: folds 
rac12345: folds 
vladlen101: folds 
jcarlos.vale: folds 
Uncalled bet (300) returned to MishaSleep
MishaSleep collected 960 from pot
*** SUMMARY ***
Total pot 960 | Rake 0 
Seat 1: vladlen101 (button) folded before Flop (didn't bet)
Seat 2: jcarlos.vale (small blind) folded before Flop
Seat 3: MishaSleep (big blind) collected (960)
Seat 4: mariafirmina folded before Flop (didn't bet)
Seat 5: felipeando folded before Flop (didn't bet)
Seat 6: jordan202025 folded before Flop (didn't bet)
Seat 7: YaR1qq folded before Flop (didn't bet)
Seat 8: Negrata folded before Flop (didn't bet)
Seat 9: rac12345 folded before Flop (didn't bet)



PokerStars Hand #222152442054: Tournament #3086083919, $0.49+$0.06 USD Hold'em No Limit - Level XIV (300/600) - 2021/01/02 23:27:31 EET [2021/01/02 16:27:31 ET]
Table '3086083919 96' 9-max Seat #2 is the button
Seat 1: vladlen101 (19046 in chips) 
Seat 2: jcarlos.vale (11562 in chips) 
Seat 3: MishaSleep (43220 in chips) 
Seat 4: mariafirmina (25310 in chips) 
Seat 5: felipeando (5725 in chips) 
Seat 6: jordan202025 (8095 in chips) 
Seat 7: YaR1qq (33005 in chips) 
Seat 8: Negrata (22785 in chips) 
Seat 9: rac12345 (35058 in chips) 
vladlen101: posts the ante 40
jcarlos.vale: posts the ante 40
MishaSleep: posts the ante 40
mariafirmina: posts the ante 40
felipeando: posts the ante 40
jordan202025: posts the ante 40
YaR1qq: posts the ante 40
Negrata: posts the ante 40
rac12345: posts the ante 40
MishaSleep: posts small blind 300
mariafirmina: posts big blind 600
*** HOLE CARDS ***
Dealt to jcarlos.vale [6d 8h]
felipeando: folds 
jordan202025: folds 
YaR1qq: folds 
Negrata: folds 
rac12345: folds 
vladlen101: folds 
jcarlos.vale: folds 
MishaSleep: folds 
Uncalled bet (300) returned to mariafirmina
mariafirmina collected 960 from pot
*** SUMMARY ***
Total pot 960 | Rake 0 
Seat 1: vladlen101 folded before Flop (didn't bet)
Seat 2: jcarlos.vale (button) folded before Flop (didn't bet)
Seat 3: MishaSleep (small blind) folded before Flop
Seat 4: mariafirmina (big blind) collected (960)
Seat 5: felipeando folded before Flop (didn't bet)
Seat 6: jordan202025 folded before Flop (didn't bet)
Seat 7: YaR1qq folded before Flop (didn't bet)
Seat 8: Negrata folded before Flop (didn't bet)
Seat 9: rac12345 folded before Flop (didn't bet)



PokerStars Hand #222152461996: Tournament #3086083919, $0.49+$0.06 USD Hold'em No Limit - Level XIV (300/600) - 2021/01/02 23:27:51 EET [2021/01/02 16:27:51 ET]
Table '3086083919 96' 9-max Seat #3 is the button
Seat 1: vladlen101 (19006 in chips) 
Seat 2: jcarlos.vale (11522 in chips) 
Seat 3: MishaSleep (42880 in chips) 
Seat 4: mariafirmina (25930 in chips) 
Seat 5: felipeando (5685 in chips) 
Seat 6: jordan202025 (8055 in chips) 
Seat 7: YaR1qq (32965 in chips) 
Seat 8: Negrata (22745 in chips) 
Seat 9: rac12345 (35018 in chips) 
vladlen101: posts the ante 40
jcarlos.vale: posts the ante 40
MishaSleep: posts the ante 40
mariafirmina: posts the ante 40
felipeando: posts the ante 40
jordan202025: posts the ante 40
YaR1qq: posts the ante 40
Negrata: posts the ante 40
rac12345: posts the ante 40
mariafirmina: posts small blind 300
felipeando: posts big blind 600
*** HOLE CARDS ***
Dealt to jcarlos.vale [8c Kd]
jordan202025: folds 
YaR1qq: folds 
Negrata: folds 
rac12345: folds 
vladlen101: folds 
jcarlos.vale: folds 
MishaSleep: raises 900 to 1500
mariafirmina: folds 
felipeando: folds 
Uncalled bet (900) returned to MishaSleep
MishaSleep collected 1860 from pot
*** SUMMARY ***
Total pot 1860 | Rake 0 
Seat 1: vladlen101 folded before Flop (didn't bet)
Seat 2: jcarlos.vale folded before Flop (didn't bet)
Seat 3: MishaSleep (button) collected (1860)
Seat 4: mariafirmina (small blind) folded before Flop
Seat 5: felipeando (big blind) folded before Flop
Seat 6: jordan202025 folded before Flop (didn't bet)
Seat 7: YaR1qq folded before Flop (didn't bet)
Seat 8: Negrata folded before Flop (didn't bet)
Seat 9: rac12345 folded before Flop (didn't bet)



PokerStars Hand #222152485481: Tournament #3086083919, $0.49+$0.06 USD Hold'em No Limit - Level XIV (300/600) - 2021/01/02 23:28:15 EET [2021/01/02 16:28:15 ET]
Table '3086083919 96' 9-max Seat #4 is the button
Seat 1: vladlen101 (18966 in chips) 
Seat 2: jcarlos.vale (11482 in chips) 
Seat 3: MishaSleep (44100 in chips) 
Seat 4: mariafirmina (25590 in chips) 
Seat 5: felipeando (5045 in chips) 
Seat 6: jordan202025 (8015 in chips) 
Seat 7: YaR1qq (32925 in chips) 
Seat 8: Negrata (22705 in chips) 
Seat 9: rac12345 (34978 in chips) 
vladlen101: posts the ante 40
jcarlos.vale: posts the ante 40
MishaSleep: posts the ante 40
mariafirmina: posts the ante 40
felipeando: posts the ante 40
jordan202025: posts the ante 40
YaR1qq: posts the ante 40
Negrata: posts the ante 40
rac12345: posts the ante 40
felipeando: posts small blind 300
jordan202025: posts big blind 600
*** HOLE CARDS ***
Dealt to jcarlos.vale [Ks 6d]
YaR1qq: raises 600 to 1200
Negrata: folds 
rac12345: folds 
vladlen101: folds 
jcarlos.vale: folds 
MishaSleep: folds 
mariafirmina: folds 
felipeando: folds 
jordan202025: calls 600
*** FLOP *** [5h 4c Qc]
jordan202025: checks 
YaR1qq: bets 1200
jordan202025: folds 
Uncalled bet (1200) returned to YaR1qq
YaR1qq collected 3060 from pot
YaR1qq: doesn't show handDTO
*** SUMMARY ***
Total pot 3060 | Rake 0 
Board [5h 4c Qc]
Seat 1: vladlen101 folded before Flop (didn't bet)
Seat 2: jcarlos.vale folded before Flop (didn't bet)
Seat 3: MishaSleep folded before Flop (didn't bet)
Seat 4: mariafirmina (button) folded before Flop (didn't bet)
Seat 5: felipeando (small blind) folded before Flop
Seat 6: jordan202025 (big blind) folded on the Flop
Seat 7: YaR1qq collected (3060)
Seat 8: Negrata folded before Flop (didn't bet)
Seat 9: rac12345 folded before Flop (didn't bet)



PokerStars Hand #222152515101: Tournament #3086083919, $0.49+$0.06 USD Hold'em No Limit - Level XIV (300/600) - 2021/01/02 23:28:45 EET [2021/01/02 16:28:45 ET]
Table '3086083919 96' 9-max Seat #5 is the button
Seat 1: vladlen101 (18926 in chips) 
Seat 2: jcarlos.vale (11442 in chips) 
Seat 3: MishaSleep (44060 in chips) 
Seat 4: mariafirmina (25550 in chips) 
Seat 5: felipeando (4705 in chips) 
Seat 6: jordan202025 (6775 in chips) 
Seat 7: YaR1qq (34745 in chips) 
Seat 8: Negrata (22665 in chips) 
Seat 9: rac12345 (34938 in chips) 
vladlen101: posts the ante 40
jcarlos.vale: posts the ante 40
MishaSleep: posts the ante 40
mariafirmina: posts the ante 40
felipeando: posts the ante 40
jordan202025: posts the ante 40
YaR1qq: posts the ante 40
Negrata: posts the ante 40
rac12345: posts the ante 40
jordan202025: posts small blind 300
YaR1qq: posts big blind 600
*** HOLE CARDS ***
Dealt to jcarlos.vale [5h 5s]
Negrata: folds 
rac12345: calls 600
vladlen101: folds 
jcarlos.vale: raises 10802 to 11402 and is all-in
MishaSleep: folds 
mariafirmina: folds 
felipeando: folds 
jordan202025: folds 
YaR1qq: folds 
rac12345: folds 
Uncalled bet (10802) returned to jcarlos.vale
jcarlos.vale collected 2460 from pot
jcarlos.vale: doesn't show handDTO
*** SUMMARY ***
Total pot 2460 | Rake 0 
Seat 1: vladlen101 folded before Flop (didn't bet)
Seat 2: jcarlos.vale collected (2460)
Seat 3: MishaSleep folded before Flop (didn't bet)
Seat 4: mariafirmina folded before Flop (didn't bet)
Seat 5: felipeando (button) folded before Flop (didn't bet)
Seat 6: jordan202025 (small blind) folded before Flop
Seat 7: YaR1qq (big blind) folded before Flop
Seat 8: Negrata folded before Flop (didn't bet)
Seat 9: rac12345 folded before Flop



PokerStars Hand #222152553679: Tournament #3086083919, $0.49+$0.06 USD Hold'em No Limit - Level XIV (300/600) - 2021/01/02 23:29:24 EET [2021/01/02 16:29:24 ET]
Table '3086083919 96' 9-max Seat #6 is the button
Seat 1: vladlen101 (18886 in chips) 
Seat 2: jcarlos.vale (13262 in chips) 
Seat 3: MishaSleep (44020 in chips) 
Seat 4: mariafirmina (25510 in chips) 
Seat 5: felipeando (4665 in chips) 
Seat 6: jordan202025 (6435 in chips) 
Seat 7: YaR1qq (34105 in chips) 
Seat 8: Negrata (22625 in chips) 
Seat 9: rac12345 (34298 in chips) 
vladlen101: posts the ante 40
jcarlos.vale: posts the ante 40
MishaSleep: posts the ante 40
mariafirmina: posts the ante 40
felipeando: posts the ante 40
jordan202025: posts the ante 40
YaR1qq: posts the ante 40
Negrata: posts the ante 40
rac12345: posts the ante 40
YaR1qq: posts small blind 300
Negrata: posts big blind 600
*** HOLE CARDS ***
Dealt to jcarlos.vale [7d Ah]
rac12345: calls 600
vladlen101: folds 
jcarlos.vale: folds 
MishaSleep: folds 
mariafirmina: folds 
felipeando: folds 
jordan202025 has timed out
jordan202025: folds 
jordan202025 is sitting out
YaR1qq: folds 
Negrata: checks 
*** FLOP *** [2d Td 2c]
Negrata: checks 
jordan202025 has returned
rac12345: bets 600
Negrata: folds 
Uncalled bet (600) returned to rac12345
rac12345 collected 1860 from pot
rac12345: doesn't show handDTO
*** SUMMARY ***
Total pot 1860 | Rake 0 
Board [2d Td 2c]
Seat 1: vladlen101 folded before Flop (didn't bet)
Seat 2: jcarlos.vale folded before Flop (didn't bet)
Seat 3: MishaSleep folded before Flop (didn't bet)
Seat 4: mariafirmina folded before Flop (didn't bet)
Seat 5: felipeando folded before Flop (didn't bet)
Seat 6: jordan202025 (button) folded before Flop (didn't bet)
Seat 7: YaR1qq (small blind) folded before Flop
Seat 8: Negrata (big blind) folded on the Flop
Seat 9: rac12345 collected (1860)



PokerStars Hand #222152606318: Tournament #3086083919, $0.49+$0.06 USD Hold'em No Limit - Level XIV (300/600) - 2021/01/02 23:30:17 EET [2021/01/02 16:30:17 ET]
Table '3086083919 96' 9-max Seat #7 is the button
Seat 1: vladlen101 (18846 in chips) 
Seat 2: jcarlos.vale (13222 in chips) 
Seat 3: MishaSleep (43980 in chips) 
Seat 4: mariafirmina (25470 in chips) 
Seat 5: felipeando (4625 in chips) 
Seat 6: jordan202025 (6395 in chips) 
Seat 7: YaR1qq (33765 in chips) 
Seat 8: Negrata (21985 in chips) 
Seat 9: rac12345 (35518 in chips) 
vladlen101: posts the ante 40
jcarlos.vale: posts the ante 40
MishaSleep: posts the ante 40
mariafirmina: posts the ante 40
felipeando: posts the ante 40
jordan202025: posts the ante 40
YaR1qq: posts the ante 40
Negrata: posts the ante 40
rac12345: posts the ante 40
Negrata: posts small blind 300
rac12345: posts big blind 600
*** HOLE CARDS ***
Dealt to jcarlos.vale [7c Ac]
vladlen101: calls 600
jcarlos.vale: folds 
MishaSleep: folds 
mariafirmina: folds 
felipeando: folds 
jordan202025: folds 
YaR1qq: raises 600 to 1200
Negrata: calls 900
rac12345: raises 3600 to 4800
vladlen101: folds 
YaR1qq: calls 3600
Negrata: folds 
*** FLOP *** [5s Kh 8d]
rac12345: checks 
YaR1qq: checks 
*** TURN *** [5s Kh 8d] [2s]
rac12345: checks 
YaR1qq: bets 2400
rac12345: calls 2400
*** RIVER *** [5s Kh 8d 2s] [7d]
rac12345: checks 
YaR1qq: bets 4800
rac12345: calls 4800
*** SHOW DOWN ***
YaR1qq: shows [As Ts] (high pairOfCards Ace)
rac12345: shows [Qs Qc] (a pair of Queens)
rac12345 collected 26160 from pot
*** SUMMARY ***
Total pot 26160 | Rake 0 
Board [5s Kh 8d 2s 7d]
Seat 1: vladlen101 folded before Flop
Seat 2: jcarlos.vale folded before Flop (didn't bet)
Seat 3: MishaSleep folded before Flop (didn't bet)
Seat 4: mariafirmina folded before Flop (didn't bet)
Seat 5: felipeando folded before Flop (didn't bet)
Seat 6: jordan202025 folded before Flop (didn't bet)
Seat 7: YaR1qq (button) showed [As Ts] and lost with high pairOfCards Ace
Seat 8: Negrata (small blind) folded before Flop
Seat 9: rac12345 (big blind) showed [Qs Qc] and won (26160) with a pair of Queens



PokerStars Hand #222152699314: Tournament #3086083919, $0.49+$0.06 USD Hold'em No Limit - Level XIV (300/600) - 2021/01/02 23:31:52 EET [2021/01/02 16:31:52 ET]
Table '3086083919 96' 9-max Seat #8 is the button
Seat 1: vladlen101 (18206 in chips) 
Seat 2: jcarlos.vale (13182 in chips) 
Seat 3: MishaSleep (43940 in chips) 
Seat 4: mariafirmina (25430 in chips) 
Seat 5: felipeando (4585 in chips) 
Seat 6: jordan202025 (6355 in chips) 
Seat 7: YaR1qq (21725 in chips) 
Seat 8: Negrata (20745 in chips) 
Seat 9: rac12345 (49638 in chips) 
vladlen101: posts the ante 40
jcarlos.vale: posts the ante 40
MishaSleep: posts the ante 40
mariafirmina: posts the ante 40
felipeando: posts the ante 40
jordan202025: posts the ante 40
YaR1qq: posts the ante 40
Negrata: posts the ante 40
rac12345: posts the ante 40
rac12345: posts small blind 300
vladlen101: posts big blind 600
*** HOLE CARDS ***
Dealt to jcarlos.vale [Th Ac]
jcarlos.vale: folds 
MishaSleep: folds 
mariafirmina: raises 600 to 1200
felipeando: folds 
jordan202025: folds 
YaR1qq: folds 
Negrata: folds 
rac12345: folds 
vladlen101: folds 
Uncalled bet (600) returned to mariafirmina
mariafirmina collected 1860 from pot
*** SUMMARY ***
Total pot 1860 | Rake 0 
Seat 1: vladlen101 (big blind) folded before Flop
Seat 2: jcarlos.vale folded before Flop (didn't bet)
Seat 3: MishaSleep folded before Flop (didn't bet)
Seat 4: mariafirmina collected (1860)
Seat 5: felipeando folded before Flop (didn't bet)
Seat 6: jordan202025 folded before Flop (didn't bet)
Seat 7: YaR1qq folded before Flop (didn't bet)
Seat 8: Negrata (button) folded before Flop (didn't bet)
Seat 9: rac12345 (small blind) folded before Flop



PokerStars Hand #222152727238: Tournament #3086083919, $0.49+$0.06 USD Hold'em No Limit - Level XIV (300/600) - 2021/01/02 23:32:21 EET [2021/01/02 16:32:21 ET]
Table '3086083919 96' 9-max Seat #9 is the button
Seat 1: vladlen101 (17566 in chips) 
Seat 2: jcarlos.vale (13142 in chips) 
Seat 3: MishaSleep (43900 in chips) 
Seat 4: mariafirmina (26650 in chips) 
Seat 5: felipeando (4545 in chips) 
Seat 6: jordan202025 (6315 in chips) 
Seat 7: YaR1qq (21685 in chips) 
Seat 8: Negrata (20705 in chips) 
Seat 9: rac12345 (49298 in chips) 
vladlen101: posts the ante 40
jcarlos.vale: posts the ante 40
MishaSleep: posts the ante 40
mariafirmina: posts the ante 40
felipeando: posts the ante 40
jordan202025: posts the ante 40
YaR1qq: posts the ante 40
Negrata: posts the ante 40
rac12345: posts the ante 40
vladlen101: posts small blind 300
jcarlos.vale: posts big blind 600
*** HOLE CARDS ***
Dealt to jcarlos.vale [2h 7d]
MishaSleep: folds 
mariafirmina: folds 
felipeando: folds 
jordan202025 has timed out
jordan202025: folds 
jordan202025 is sitting out
YaR1qq: folds 
jordan202025 has returned
Negrata: folds 
rac12345: calls 600
vladlen101: raises 2160 to 2760
jcarlos.vale: folds 
rac12345: calls 2160
*** FLOP *** [Kh 2s 5s]
vladlen101: bets 3240
rac12345: raises 43258 to 46498 and is all-in
vladlen101: calls 11526 and is all-in
Uncalled bet (31732) returned to rac12345
*** TURN *** [Kh 2s 5s] [3h]
*** RIVER *** [Kh 2s 5s 3h] [4h]
*** SHOW DOWN ***
vladlen101: shows [Ks Ad] (a straight, Ace to Five)
rac12345: shows [Tc Kd] (a pair of Kings)
vladlen101 collected 36012 from pot
*** SUMMARY ***
Total pot 36012 | Rake 0 
Board [Kh 2s 5s 3h 4h]
Seat 1: vladlen101 (small blind) showed [Ks Ad] and won (36012) with a straight, Ace to Five
Seat 2: jcarlos.vale (big blind) folded before Flop
Seat 3: MishaSleep folded before Flop (didn't bet)
Seat 4: mariafirmina folded before Flop (didn't bet)
Seat 5: felipeando folded before Flop (didn't bet)
Seat 6: jordan202025 folded before Flop (didn't bet)
Seat 7: YaR1qq folded before Flop (didn't bet)
Seat 8: Negrata folded before Flop (didn't bet)
Seat 9: rac12345 (button) showed [Tc Kd] and lost with a pair of Kings



PokerStars Hand #222152792109: Tournament #3086083919, $0.49+$0.06 USD Hold'em No Limit - Level XIV (300/600) - 2021/01/02 23:33:27 EET [2021/01/02 16:33:27 ET]
Table '3086083919 96' 9-max Seat #1 is the button
Seat 1: vladlen101 (36012 in chips) 
Seat 2: jcarlos.vale (12502 in chips) 
Seat 3: MishaSleep (43860 in chips) 
Seat 4: mariafirmina (26610 in chips) 
Seat 5: felipeando (4505 in chips) 
Seat 6: jordan202025 (6275 in chips) 
Seat 7: YaR1qq (21645 in chips) 
Seat 8: Negrata (20665 in chips) 
Seat 9: rac12345 (31732 in chips) 
vladlen101: posts the ante 40
jcarlos.vale: posts the ante 40
MishaSleep: posts the ante 40
mariafirmina: posts the ante 40
felipeando: posts the ante 40
jordan202025: posts the ante 40
YaR1qq: posts the ante 40
Negrata: posts the ante 40
rac12345: posts the ante 40
jcarlos.vale: posts small blind 300
MishaSleep: posts big blind 600
*** HOLE CARDS ***
Dealt to jcarlos.vale [Kc 5d]
mariafirmina: folds 
felipeando: folds 
jordan202025: folds 
YaR1qq: folds 
Negrata: folds 
rac12345: folds 
vladlen101: folds 
jcarlos.vale: folds 
Uncalled bet (300) returned to MishaSleep
MishaSleep collected 960 from pot
*** SUMMARY ***
Total pot 960 | Rake 0 
Seat 1: vladlen101 (button) folded before Flop (didn't bet)
Seat 2: jcarlos.vale (small blind) folded before Flop
Seat 3: MishaSleep (big blind) collected (960)
Seat 4: mariafirmina folded before Flop (didn't bet)
Seat 5: felipeando folded before Flop (didn't bet)
Seat 6: jordan202025 folded before Flop (didn't bet)
Seat 7: YaR1qq folded before Flop (didn't bet)
Seat 8: Negrata folded before Flop (didn't bet)
Seat 9: rac12345 folded before Flop (didn't bet)



PokerStars Hand #222152816025: Tournament #3086083919, $0.49+$0.06 USD Hold'em No Limit - Level XIV (300/600) - 2021/01/02 23:33:51 EET [2021/01/02 16:33:51 ET]
Table '3086083919 96' 9-max Seat #2 is the button
Seat 1: vladlen101 (35972 in chips) 
Seat 2: jcarlos.vale (12162 in chips) 
Seat 3: MishaSleep (44480 in chips) 
Seat 4: mariafirmina (26570 in chips) 
Seat 5: felipeando (4465 in chips) 
Seat 6: jordan202025 (6235 in chips) 
Seat 7: YaR1qq (21605 in chips) 
Seat 8: Negrata (20625 in chips) 
Seat 9: rac12345 (31692 in chips) 
vladlen101: posts the ante 40
jcarlos.vale: posts the ante 40
MishaSleep: posts the ante 40
mariafirmina: posts the ante 40
felipeando: posts the ante 40
jordan202025: posts the ante 40
YaR1qq: posts the ante 40
Negrata: posts the ante 40
rac12345: posts the ante 40
MishaSleep: posts small blind 300
mariafirmina: posts big blind 600
*** HOLE CARDS ***
Dealt to jcarlos.vale [9s Ks]
felipeando: folds 
jordan202025: folds 
YaR1qq: folds 
Negrata: folds 
rac12345: raises 31052 to 31652 and is all-in
vladlen101: folds 
jcarlos.vale: folds 
MishaSleep: folds 
mariafirmina: folds 
Uncalled bet (31052) returned to rac12345
rac12345 collected 1860 from pot
rac12345: doesn't show handDTO
*** SUMMARY ***
Total pot 1860 | Rake 0 
Seat 1: vladlen101 folded before Flop (didn't bet)
Seat 2: jcarlos.vale (button) folded before Flop (didn't bet)
Seat 3: MishaSleep (small blind) folded before Flop
Seat 4: mariafirmina (big blind) folded before Flop
Seat 5: felipeando folded before Flop (didn't bet)
Seat 6: jordan202025 folded before Flop (didn't bet)
Seat 7: YaR1qq folded before Flop (didn't bet)
Seat 8: Negrata folded before Flop (didn't bet)
Seat 9: rac12345 collected (1860)



PokerStars Hand #222152837048: Tournament #3086083919, $0.49+$0.06 USD Hold'em No Limit - Level XIV (300/600) - 2021/01/02 23:34:13 EET [2021/01/02 16:34:13 ET]
Table '3086083919 96' 9-max Seat #3 is the button
Seat 1: vladlen101 (35932 in chips) 
Seat 2: jcarlos.vale (12122 in chips) 
Seat 3: MishaSleep (44140 in chips) 
Seat 4: mariafirmina (25930 in chips) 
Seat 5: felipeando (4425 in chips) 
Seat 6: jordan202025 (6195 in chips) 
Seat 7: YaR1qq (21565 in chips) 
Seat 8: Negrata (20585 in chips) 
Seat 9: rac12345 (32912 in chips) 
vladlen101: posts the ante 40
jcarlos.vale: posts the ante 40
MishaSleep: posts the ante 40
mariafirmina: posts the ante 40
felipeando: posts the ante 40
jordan202025: posts the ante 40
YaR1qq: posts the ante 40
Negrata: posts the ante 40
rac12345: posts the ante 40
mariafirmina: posts small blind 300
felipeando: posts big blind 600
*** HOLE CARDS ***
Dealt to jcarlos.vale [Ad 3d]
jordan202025: folds 
YaR1qq: folds 
Negrata: folds 
rac12345: calls 600
vladlen101: folds 
jcarlos.vale: folds 
MishaSleep: folds 
mariafirmina: folds 
felipeando: raises 3785 to 4385 and is all-in
rac12345: calls 3785
*** FLOP *** [Qd Td 5d]
*** TURN *** [Qd Td 5d] [2s]
*** RIVER *** [Qd Td 5d 2s] [Ac]
*** SHOW DOWN ***
felipeando: shows [As Qc] (two pair, Aces and Queens)
rac12345: shows [Kh 7s] (high pairOfCards Ace)
felipeando collected 9430 from pot
*** SUMMARY ***
Total pot 9430 | Rake 0 
Board [Qd Td 5d 2s Ac]
Seat 1: vladlen101 folded before Flop (didn't bet)
Seat 2: jcarlos.vale folded before Flop (didn't bet)
Seat 3: MishaSleep (button) folded before Flop (didn't bet)
Seat 4: mariafirmina (small blind) folded before Flop
Seat 5: felipeando (big blind) showed [As Qc] and won (9430) with two pair, Aces and Queens
Seat 6: jordan202025 folded before Flop (didn't bet)
Seat 7: YaR1qq folded before Flop (didn't bet)
Seat 8: Negrata folded before Flop (didn't bet)
Seat 9: rac12345 showed [Kh 7s] and lost with high pairOfCards Ace



PokerStars Hand #222152873921: Tournament #3086083919, $0.49+$0.06 USD Hold'em No Limit - Level XV (350/700) - 2021/01/02 23:34:51 EET [2021/01/02 16:34:51 ET]
Table '3086083919 96' 9-max Seat #4 is the button
Seat 1: vladlen101 (35892 in chips) 
Seat 2: jcarlos.vale (12082 in chips) 
Seat 3: MishaSleep (44100 in chips) 
Seat 4: mariafirmina (25590 in chips) 
Seat 5: felipeando (9430 in chips) 
Seat 6: jordan202025 (6155 in chips) 
Seat 7: YaR1qq (21525 in chips) 
Seat 8: Negrata (20545 in chips) 
Seat 9: rac12345 (28487 in chips) 
vladlen101: posts the ante 50
jcarlos.vale: posts the ante 50
MishaSleep: posts the ante 50
mariafirmina: posts the ante 50
felipeando: posts the ante 50
jordan202025: posts the ante 50
YaR1qq: posts the ante 50
Negrata: posts the ante 50
rac12345: posts the ante 50
felipeando: posts small blind 350
jordan202025: posts big blind 700
*** HOLE CARDS ***
Dealt to jcarlos.vale [2d 8d]
YaR1qq: folds 
Negrata: folds 
rac12345: raises 27737 to 28437 and is all-in
vladlen101: folds 
jcarlos.vale: folds 
MishaSleep: folds 
mariafirmina: folds 
felipeando: folds 
jordan202025: folds 
Uncalled bet (27737) returned to rac12345
rac12345 collected 2200 from pot
rac12345: doesn't show handDTO
*** SUMMARY ***
Total pot 2200 | Rake 0 
Seat 1: vladlen101 folded before Flop (didn't bet)
Seat 2: jcarlos.vale folded before Flop (didn't bet)
Seat 3: MishaSleep folded before Flop (didn't bet)
Seat 4: mariafirmina (button) folded before Flop (didn't bet)
Seat 5: felipeando (small blind) folded before Flop
Seat 6: jordan202025 (big blind) folded before Flop
Seat 7: YaR1qq folded before Flop (didn't bet)
Seat 8: Negrata folded before Flop (didn't bet)
Seat 9: rac12345 collected (2200)



PokerStars Hand #222152909663: Tournament #3086083919, $0.49+$0.06 USD Hold'em No Limit - Level XV (350/700) - 2021/01/02 23:35:28 EET [2021/01/02 16:35:28 ET]
Table '3086083919 96' 9-max Seat #5 is the button
Seat 1: vladlen101 (35842 in chips) 
Seat 2: jcarlos.vale (12032 in chips) 
Seat 3: MishaSleep (44050 in chips) 
Seat 4: mariafirmina (25540 in chips) 
Seat 5: felipeando (9030 in chips) 
Seat 6: jordan202025 (5405 in chips) 
Seat 7: YaR1qq (21475 in chips) 
Seat 8: Negrata (20495 in chips) 
Seat 9: rac12345 (29937 in chips) 
vladlen101: posts the ante 50
jcarlos.vale: posts the ante 50
MishaSleep: posts the ante 50
mariafirmina: posts the ante 50
felipeando: posts the ante 50
jordan202025: posts the ante 50
YaR1qq: posts the ante 50
Negrata: posts the ante 50
rac12345: posts the ante 50
jordan202025: posts small blind 350
YaR1qq: posts big blind 700
*** HOLE CARDS ***
Dealt to jcarlos.vale [3h Jc]
Negrata: folds 
rac12345: folds 
vladlen101: folds 
jcarlos.vale: folds 
MishaSleep: folds 
mariafirmina: folds 
felipeando: folds 
jordan202025: calls 350
YaR1qq: checks 
*** FLOP *** [6s Ad Td]
jordan202025: checks 
YaR1qq: checks 
*** TURN *** [6s Ad Td] [Ks]
jordan202025: checks 
YaR1qq: checks 
*** RIVER *** [6s Ad Td Ks] [5d]
jordan202025: checks 
YaR1qq: bets 1400
jordan202025: calls 1400
*** SHOW DOWN ***
YaR1qq: shows [7c 5h] (a pair of Fives)
jordan202025: shows [3d Jd] (a flush, Ace high)
jordan202025 collected 4650 from pot
*** SUMMARY ***
Total pot 4650 | Rake 0 
Board [6s Ad Td Ks 5d]
Seat 1: vladlen101 folded before Flop (didn't bet)
Seat 2: jcarlos.vale folded before Flop (didn't bet)
Seat 3: MishaSleep folded before Flop (didn't bet)
Seat 4: mariafirmina folded before Flop (didn't bet)
Seat 5: felipeando (button) folded before Flop (didn't bet)
Seat 6: jordan202025 (small blind) showed [3d Jd] and won (4650) with a flush, Ace high
Seat 7: YaR1qq (big blind) showed [7c 5h] and lost with a pair of Fives
Seat 8: Negrata folded before Flop (didn't bet)
Seat 9: rac12345 folded before Flop (didn't bet)



PokerStars Hand #222152967454: Tournament #3086083919, $0.49+$0.06 USD Hold'em No Limit - Level XV (350/700) - 2021/01/02 23:36:28 EET [2021/01/02 16:36:28 ET]
Table '3086083919 96' 9-max Seat #6 is the button
Seat 1: vladlen101 (35792 in chips) 
Seat 2: jcarlos.vale (11982 in chips) 
Seat 3: MishaSleep (44000 in chips) 
Seat 4: mariafirmina (25490 in chips) 
Seat 5: felipeando (8980 in chips) 
Seat 6: jordan202025 (7905 in chips) 
Seat 7: YaR1qq (19325 in chips) 
Seat 8: Negrata (20445 in chips) 
Seat 9: rac12345 (29887 in chips) 
vladlen101: posts the ante 50
jcarlos.vale: posts the ante 50
MishaSleep: posts the ante 50
mariafirmina: posts the ante 50
felipeando: posts the ante 50
jordan202025: posts the ante 50
YaR1qq: posts the ante 50
Negrata: posts the ante 50
rac12345: posts the ante 50
YaR1qq: posts small blind 350
Negrata: posts big blind 700
*** HOLE CARDS ***
Dealt to jcarlos.vale [Ks 4s]
rac12345: calls 700
vladlen101: folds 
jcarlos.vale: folds 
MishaSleep: folds 
mariafirmina: folds 
felipeando: folds 
jordan202025: folds 
YaR1qq: folds 
Negrata: checks 
*** FLOP *** [Ac 7c 5c]
Negrata: checks 
rac12345: bets 1100
Negrata: folds 
Uncalled bet (1100) returned to rac12345
rac12345 collected 2200 from pot
rac12345: doesn't show handDTO
*** SUMMARY ***
Total pot 2200 | Rake 0 
Board [Ac 7c 5c]
Seat 1: vladlen101 folded before Flop (didn't bet)
Seat 2: jcarlos.vale folded before Flop (didn't bet)
Seat 3: MishaSleep folded before Flop (didn't bet)
Seat 4: mariafirmina folded before Flop (didn't bet)
Seat 5: felipeando folded before Flop (didn't bet)
Seat 6: jordan202025 (button) folded before Flop (didn't bet)
Seat 7: YaR1qq (small blind) folded before Flop
Seat 8: Negrata (big blind) folded on the Flop
Seat 9: rac12345 collected (2200)



PokerStars Hand #222153002907: Tournament #3086083919, $0.49+$0.06 USD Hold'em No Limit - Level XV (350/700) - 2021/01/02 23:37:05 EET [2021/01/02 16:37:05 ET]
Table '3086083919 96' 9-max Seat #7 is the button
Seat 1: vladlen101 (35742 in chips) 
Seat 2: jcarlos.vale (11932 in chips) 
Seat 3: MishaSleep (43950 in chips) 
Seat 4: mariafirmina (25440 in chips) 
Seat 5: felipeando (8930 in chips) 
Seat 6: jordan202025 (7855 in chips) 
Seat 7: YaR1qq (18925 in chips) 
Seat 8: Negrata (19695 in chips) 
Seat 9: rac12345 (31337 in chips) 
vladlen101: posts the ante 50
jcarlos.vale: posts the ante 50
MishaSleep: posts the ante 50
mariafirmina: posts the ante 50
felipeando: posts the ante 50
jordan202025: posts the ante 50
YaR1qq: posts the ante 50
Negrata: posts the ante 50
rac12345: posts the ante 50
Negrata: posts small blind 350
rac12345: posts big blind 700
*** HOLE CARDS ***
Dealt to jcarlos.vale [Qh 9s]
vladlen101: folds 
jcarlos.vale: folds 
MishaSleep: folds 
mariafirmina: folds 
felipeando: folds 
jordan202025: folds 
YaR1qq: raises 700 to 1400
Negrata: folds 
rac12345: calls 700
*** FLOP *** [3d Ac Jd]
rac12345: checks 
YaR1qq: bets 1400
rac12345: folds 
Uncalled bet (1400) returned to YaR1qq
YaR1qq collected 3600 from pot
YaR1qq: doesn't show handDTO
*** SUMMARY ***
Total pot 3600 | Rake 0 
Board [3d Ac Jd]
Seat 1: vladlen101 folded before Flop (didn't bet)
Seat 2: jcarlos.vale folded before Flop (didn't bet)
Seat 3: MishaSleep folded before Flop (didn't bet)
Seat 4: mariafirmina folded before Flop (didn't bet)
Seat 5: felipeando folded before Flop (didn't bet)
Seat 6: jordan202025 folded before Flop (didn't bet)
Seat 7: YaR1qq (button) collected (3600)
Seat 8: Negrata (small blind) folded before Flop
Seat 9: rac12345 (big blind) folded on the Flop



PokerStars Hand #222153054438: Tournament #3086083919, $0.49+$0.06 USD Hold'em No Limit - Level XV (350/700) - 2021/01/02 23:37:50 EET [2021/01/02 16:37:50 ET]
Table '3086083919 96' 9-max Seat #8 is the button
Seat 1: vladlen101 (35692 in chips) 
Seat 2: jcarlos.vale (11882 in chips) 
Seat 3: MishaSleep (43900 in chips) 
Seat 4: mariafirmina (25390 in chips) 
Seat 5: felipeando (8880 in chips) 
Seat 6: jordan202025 (7805 in chips) 
Seat 7: YaR1qq (21075 in chips) 
Seat 8: Negrata (19295 in chips) 
Seat 9: rac12345 (29887 in chips) 
vladlen101: posts the ante 50
jcarlos.vale: posts the ante 50
MishaSleep: posts the ante 50
mariafirmina: posts the ante 50
felipeando: posts the ante 50
jordan202025: posts the ante 50
YaR1qq: posts the ante 50
Negrata: posts the ante 50
rac12345: posts the ante 50
rac12345: posts small blind 350
vladlen101: posts big blind 700
*** HOLE CARDS ***
Dealt to jcarlos.vale [8d Kc]
jcarlos.vale: folds 
MishaSleep: folds 
mariafirmina: folds 
felipeando: folds 
jordan202025 has timed out
jordan202025: folds 
jordan202025 is sitting out
YaR1qq: calls 700
jordan202025 has returned
Negrata: folds 
rac12345: raises 1400 to 2100
vladlen101: folds 
YaR1qq: folds 
Uncalled bet (1400) returned to rac12345
rac12345 collected 2550 from pot
rac12345: doesn't show handDTO
*** SUMMARY ***
Total pot 2550 | Rake 0 
Seat 1: vladlen101 (big blind) folded before Flop
Seat 2: jcarlos.vale folded before Flop (didn't bet)
Seat 3: MishaSleep folded before Flop (didn't bet)
Seat 4: mariafirmina folded before Flop (didn't bet)
Seat 5: felipeando folded before Flop (didn't bet)
Seat 6: jordan202025 folded before Flop (didn't bet)
Seat 7: YaR1qq folded before Flop
Seat 8: Negrata (button) folded before Flop (didn't bet)
Seat 9: rac12345 (small blind) collected (2550)



PokerStars Hand #222153102953: Tournament #3086083919, $0.49+$0.06 USD Hold'em No Limit - Level XV (350/700) - 2021/01/02 23:38:41 EET [2021/01/02 16:38:41 ET]
Table '3086083919 96' 9-max Seat #9 is the button
Seat 1: vladlen101 (34942 in chips) 
Seat 2: jcarlos.vale (11832 in chips) 
Seat 3: MishaSleep (43850 in chips) 
Seat 4: mariafirmina (25340 in chips) 
Seat 5: felipeando (8830 in chips) 
Seat 6: jordan202025 (7755 in chips) 
Seat 7: YaR1qq (20325 in chips) 
Seat 8: Negrata (19245 in chips) 
Seat 9: rac12345 (31687 in chips) 
vladlen101: posts the ante 50
jcarlos.vale: posts the ante 50
MishaSleep: posts the ante 50
mariafirmina: posts the ante 50
felipeando: posts the ante 50
jordan202025: posts the ante 50
YaR1qq: posts the ante 50
Negrata: posts the ante 50
rac12345: posts the ante 50
vladlen101: posts small blind 350
jcarlos.vale: posts big blind 700
*** HOLE CARDS ***
Dealt to jcarlos.vale [Qs 6s]
MishaSleep: folds 
mariafirmina: folds 
felipeando: raises 8080 to 8780 and is all-in
jordan202025: folds 
YaR1qq: folds 
Negrata: folds 
rac12345: folds 
vladlen101: folds 
jcarlos.vale: folds 
Uncalled bet (8080) returned to felipeando
felipeando collected 2200 from pot
felipeando: doesn't show handDTO
*** SUMMARY ***
Total pot 2200 | Rake 0 
Seat 1: vladlen101 (small blind) folded before Flop
Seat 2: jcarlos.vale (big blind) folded before Flop
Seat 3: MishaSleep folded before Flop (didn't bet)
Seat 4: mariafirmina folded before Flop (didn't bet)
Seat 5: felipeando collected (2200)
Seat 6: jordan202025 folded before Flop (didn't bet)
Seat 7: YaR1qq folded before Flop (didn't bet)
Seat 8: Negrata folded before Flop (didn't bet)
Seat 9: rac12345 (button) folded before Flop (didn't bet)



PokerStars Hand #222153132939: Tournament #3086083919, $0.49+$0.06 USD Hold'em No Limit - Level XV (350/700) - 2021/01/02 23:39:12 EET [2021/01/02 16:39:12 ET]
Table '3086083919 96' 9-max Seat #1 is the button
Seat 1: vladlen101 (34542 in chips) 
Seat 2: jcarlos.vale (11082 in chips) 
Seat 3: MishaSleep (43800 in chips) 
Seat 4: mariafirmina (25290 in chips) 
Seat 5: felipeando (10280 in chips) 
Seat 6: jordan202025 (7705 in chips) 
Seat 7: YaR1qq (20275 in chips) 
Seat 8: Negrata (19195 in chips) 
Seat 9: rac12345 (31637 in chips) 
vladlen101: posts the ante 50
jcarlos.vale: posts the ante 50
MishaSleep: posts the ante 50
mariafirmina: posts the ante 50
felipeando: posts the ante 50
jordan202025: posts the ante 50
YaR1qq: posts the ante 50
Negrata: posts the ante 50
rac12345: posts the ante 50
jcarlos.vale: posts small blind 350
MishaSleep: posts big blind 700
*** HOLE CARDS ***
Dealt to jcarlos.vale [Jh Qd]
mariafirmina: folds 
felipeando: folds 
jordan202025 has timed out
jordan202025: folds 
jordan202025 is sitting out
YaR1qq: folds 
Negrata: folds 
rac12345: folds 
vladlen101: folds 
jcarlos.vale: raises 10332 to 11032 and is all-in
MishaSleep: folds 
Uncalled bet (10332) returned to jcarlos.vale
jcarlos.vale collected 1850 from pot
jcarlos.vale: doesn't show handDTO
*** SUMMARY ***
Total pot 1850 | Rake 0 
Seat 1: vladlen101 (button) folded before Flop (didn't bet)
Seat 2: jcarlos.vale (small blind) collected (1850)
Seat 3: MishaSleep (big blind) folded before Flop
Seat 4: mariafirmina folded before Flop (didn't bet)
Seat 5: felipeando folded before Flop (didn't bet)
Seat 6: jordan202025 folded before Flop (didn't bet)
Seat 7: YaR1qq folded before Flop (didn't bet)
Seat 8: Negrata folded before Flop (didn't bet)
Seat 9: rac12345 folded before Flop (didn't bet)



PokerStars Hand #222153163611: Tournament #3086083919, $0.49+$0.06 USD Hold'em No Limit - Level XV (350/700) - 2021/01/02 23:39:44 EET [2021/01/02 16:39:44 ET]
Table '3086083919 96' 9-max Seat #2 is the button
Seat 1: vladlen101 (34492 in chips) 
Seat 2: jcarlos.vale (12182 in chips) 
Seat 3: MishaSleep (43050 in chips) 
Seat 4: mariafirmina (25240 in chips) 
Seat 5: felipeando (10230 in chips) 
Seat 6: jordan202025 (7655 in chips) is sitting out
Seat 7: YaR1qq (20225 in chips) 
Seat 8: Negrata (19145 in chips) 
Seat 9: rac12345 (31587 in chips) 
vladlen101: posts the ante 50
jcarlos.vale: posts the ante 50
MishaSleep: posts the ante 50
mariafirmina: posts the ante 50
felipeando: posts the ante 50
jordan202025: posts the ante 50
YaR1qq: posts the ante 50
Negrata: posts the ante 50
rac12345: posts the ante 50
MishaSleep: posts small blind 350
mariafirmina: posts big blind 700
*** HOLE CARDS ***
Dealt to jcarlos.vale [6d Jh]
felipeando: folds 
jordan202025: folds 
YaR1qq: calls 700
jordan202025 has returned
Negrata: folds 
rac12345: calls 700
vladlen101: folds 
jcarlos.vale: folds 
MishaSleep: calls 350
mariafirmina: checks 
*** FLOP *** [Kh Td 2s]
MishaSleep: checks 
mariafirmina: checks 
YaR1qq: checks 
rac12345: bets 1625
MishaSleep: folds 
mariafirmina: folds 
YaR1qq: calls 1625
*** TURN *** [Kh Td 2s] [3d]
YaR1qq: checks 
rac12345: bets 3250
YaR1qq: folds 
Uncalled bet (3250) returned to rac12345
rac12345 collected 6500 from pot
rac12345: doesn't show handDTO
*** SUMMARY ***
Total pot 6500 | Rake 0 
Board [Kh Td 2s 3d]
Seat 1: vladlen101 folded before Flop (didn't bet)
Seat 2: jcarlos.vale (button) folded before Flop (didn't bet)
Seat 3: MishaSleep (small blind) folded on the Flop
Seat 4: mariafirmina (big blind) folded on the Flop
Seat 5: felipeando folded before Flop (didn't bet)
Seat 6: jordan202025 folded before Flop (didn't bet)
Seat 7: YaR1qq folded on the Turn
Seat 8: Negrata folded before Flop (didn't bet)
Seat 9: rac12345 collected (6500)



PokerStars Hand #222153227727: Tournament #3086083919, $0.49+$0.06 USD Hold'em No Limit - Level XV (350/700) - 2021/01/02 23:40:51 EET [2021/01/02 16:40:51 ET]
Table '3086083919 96' 9-max Seat #3 is the button
Seat 1: vladlen101 (34442 in chips) 
Seat 2: jcarlos.vale (12132 in chips) 
Seat 3: MishaSleep (42300 in chips) 
Seat 4: mariafirmina (24490 in chips) 
Seat 5: felipeando (10180 in chips) 
Seat 6: jordan202025 (7605 in chips) 
Seat 7: YaR1qq (17850 in chips) 
Seat 8: Negrata (19095 in chips) 
Seat 9: rac12345 (35712 in chips) 
vladlen101: posts the ante 50
jcarlos.vale: posts the ante 50
MishaSleep: posts the ante 50
mariafirmina: posts the ante 50
felipeando: posts the ante 50
jordan202025: posts the ante 50
YaR1qq: posts the ante 50
Negrata: posts the ante 50
rac12345: posts the ante 50
mariafirmina: posts small blind 350
felipeando: posts big blind 700
*** HOLE CARDS ***
Dealt to jcarlos.vale [As 5d]
jordan202025: folds 
YaR1qq: folds 
Negrata: folds 
rac12345: folds 
vladlen101: folds 
jcarlos.vale: folds 
MishaSleep: folds 
mariafirmina: raises 700 to 1400
felipeando: folds 
Uncalled bet (700) returned to mariafirmina
mariafirmina collected 1850 from pot
*** SUMMARY ***
Total pot 1850 | Rake 0 
Seat 1: vladlen101 folded before Flop (didn't bet)
Seat 2: jcarlos.vale folded before Flop (didn't bet)
Seat 3: MishaSleep (button) folded before Flop (didn't bet)
Seat 4: mariafirmina (small blind) collected (1850)
Seat 5: felipeando (big blind) folded before Flop
Seat 6: jordan202025 folded before Flop (didn't bet)
Seat 7: YaR1qq folded before Flop (didn't bet)
Seat 8: Negrata folded before Flop (didn't bet)
Seat 9: rac12345 folded before Flop (didn't bet)



PokerStars Hand #222153247778: Tournament #3086083919, $0.49+$0.06 USD Hold'em No Limit - Level XV (350/700) - 2021/01/02 23:41:12 EET [2021/01/02 16:41:12 ET]
Table '3086083919 96' 9-max Seat #4 is the button
Seat 1: vladlen101 (34392 in chips) 
Seat 2: jcarlos.vale (12082 in chips) 
Seat 3: MishaSleep (42250 in chips) 
Seat 4: mariafirmina (25590 in chips) 
Seat 5: felipeando (9430 in chips) 
Seat 6: jordan202025 (7555 in chips) 
Seat 7: YaR1qq (17800 in chips) 
Seat 8: Negrata (19045 in chips) 
Seat 9: rac12345 (35662 in chips) 
vladlen101: posts the ante 50
jcarlos.vale: posts the ante 50
MishaSleep: posts the ante 50
mariafirmina: posts the ante 50
felipeando: posts the ante 50
jordan202025: posts the ante 50
YaR1qq: posts the ante 50
Negrata: posts the ante 50
rac12345: posts the ante 50
felipeando: posts small blind 350
jordan202025: posts big blind 700
*** HOLE CARDS ***
Dealt to jcarlos.vale [2s Qc]
YaR1qq: folds 
Negrata: folds 
rac12345: folds 
vladlen101: folds 
jcarlos.vale: folds 
MishaSleep: raises 1050 to 1750
mariafirmina: folds 
felipeando: raises 7630 to 9380 and is all-in
jordan202025: folds 
MishaSleep: folds 
Uncalled bet (7630) returned to felipeando
felipeando collected 4650 from pot
felipeando: doesn't show handDTO
*** SUMMARY ***
Total pot 4650 | Rake 0 
Seat 1: vladlen101 folded before Flop (didn't bet)
Seat 2: jcarlos.vale folded before Flop (didn't bet)
Seat 3: MishaSleep folded before Flop
Seat 4: mariafirmina (button) folded before Flop (didn't bet)
Seat 5: felipeando (small blind) collected (4650)
Seat 6: jordan202025 (big blind) folded before Flop
Seat 7: YaR1qq folded before Flop (didn't bet)
Seat 8: Negrata folded before Flop (didn't bet)
Seat 9: rac12345 folded before Flop (didn't bet)



PokerStars Hand #222153271346: Tournament #3086083919, $0.49+$0.06 USD Hold'em No Limit - Level XV (350/700) - 2021/01/02 23:41:37 EET [2021/01/02 16:41:37 ET]
Table '3086083919 96' 9-max Seat #5 is the button
Seat 1: vladlen101 (34342 in chips) 
Seat 2: jcarlos.vale (12032 in chips) 
Seat 3: MishaSleep (40450 in chips) 
Seat 4: mariafirmina (25540 in chips) 
Seat 5: felipeando (12280 in chips) 
Seat 6: jordan202025 (6805 in chips) 
Seat 7: YaR1qq (17750 in chips) 
Seat 8: Negrata (18995 in chips) 
Seat 9: rac12345 (35612 in chips) 
vladlen101: posts the ante 50
jcarlos.vale: posts the ante 50
MishaSleep: posts the ante 50
mariafirmina: posts the ante 50
felipeando: posts the ante 50
jordan202025: posts the ante 50
YaR1qq: posts the ante 50
Negrata: posts the ante 50
rac12345: posts the ante 50
jordan202025: posts small blind 350
YaR1qq: posts big blind 700
*** HOLE CARDS ***
Dealt to jcarlos.vale [Ks 5d]
Negrata: folds 
rac12345: folds 
vladlen101: folds 
jcarlos.vale: folds 
MishaSleep: folds 
mariafirmina: folds 
felipeando: raises 11530 to 12230 and is all-in
jordan202025: folds 
YaR1qq: folds 
Uncalled bet (11530) returned to felipeando
felipeando collected 2200 from pot
felipeando: doesn't show handDTO
*** SUMMARY ***
Total pot 2200 | Rake 0 
Seat 1: vladlen101 folded before Flop (didn't bet)
Seat 2: jcarlos.vale folded before Flop (didn't bet)
Seat 3: MishaSleep folded before Flop (didn't bet)
Seat 4: mariafirmina folded before Flop (didn't bet)
Seat 5: felipeando (button) collected (2200)
Seat 6: jordan202025 (small blind) folded before Flop
Seat 7: YaR1qq (big blind) folded before Flop
Seat 8: Negrata folded before Flop (didn't bet)
Seat 9: rac12345 folded before Flop (didn't bet)



PokerStars Hand #222153301972: Tournament #3086083919, $0.49+$0.06 USD Hold'em No Limit - Level XV (350/700) - 2021/01/02 23:42:10 EET [2021/01/02 16:42:10 ET]
Table '3086083919 96' 9-max Seat #6 is the button
Seat 1: vladlen101 (34292 in chips) 
Seat 2: jcarlos.vale (11982 in chips) 
Seat 3: MishaSleep (40400 in chips) 
Seat 4: mariafirmina (25490 in chips) 
Seat 5: felipeando (13730 in chips) 
Seat 6: jordan202025 (6405 in chips) 
Seat 7: YaR1qq (17000 in chips) 
Seat 8: Negrata (18945 in chips) 
Seat 9: rac12345 (35562 in chips) 
vladlen101: posts the ante 50
jcarlos.vale: posts the ante 50
MishaSleep: posts the ante 50
mariafirmina: posts the ante 50
felipeando: posts the ante 50
jordan202025: posts the ante 50
YaR1qq: posts the ante 50
Negrata: posts the ante 50
rac12345: posts the ante 50
YaR1qq: posts small blind 350
Negrata: posts big blind 700
*** HOLE CARDS ***
Dealt to jcarlos.vale [9c 2s]
rac12345: folds 
vladlen101: folds 
jcarlos.vale: folds 
MishaSleep: folds 
mariafirmina: folds 
felipeando: folds 
jordan202025: raises 5655 to 6355 and is all-in
YaR1qq: folds 
Negrata: folds 
Uncalled bet (5655) returned to jordan202025
jordan202025 collected 2200 from pot
*** SUMMARY ***
Total pot 2200 | Rake 0 
Seat 1: vladlen101 folded before Flop (didn't bet)
Seat 2: jcarlos.vale folded before Flop (didn't bet)
Seat 3: MishaSleep folded before Flop (didn't bet)
Seat 4: mariafirmina folded before Flop (didn't bet)
Seat 5: felipeando folded before Flop (didn't bet)
Seat 6: jordan202025 (button) collected (2200)
Seat 7: YaR1qq (small blind) folded before Flop
Seat 8: Negrata (big blind) folded before Flop
Seat 9: rac12345 folded before Flop (didn't bet)



PokerStars Hand #222153328765: Tournament #3086083919, $0.49+$0.06 USD Hold'em No Limit - Level XV (350/700) - 2021/01/02 23:42:38 EET [2021/01/02 16:42:38 ET]
Table '3086083919 96' 9-max Seat #7 is the button
Seat 1: vladlen101 (34242 in chips) 
Seat 2: jcarlos.vale (11932 in chips) 
Seat 3: MishaSleep (40350 in chips) 
Seat 4: mariafirmina (25440 in chips) 
Seat 5: felipeando (13680 in chips) 
Seat 6: jordan202025 (7855 in chips) 
Seat 7: YaR1qq (16600 in chips) 
Seat 8: Negrata (18195 in chips) 
Seat 9: rac12345 (35512 in chips) 
vladlen101: posts the ante 50
jcarlos.vale: posts the ante 50
MishaSleep: posts the ante 50
mariafirmina: posts the ante 50
felipeando: posts the ante 50
jordan202025: posts the ante 50
YaR1qq: posts the ante 50
Negrata: posts the ante 50
rac12345: posts the ante 50
Negrata: posts small blind 350
rac12345: posts big blind 700
*** HOLE CARDS ***
Dealt to jcarlos.vale [5s 6c]
vladlen101: folds 
jcarlos.vale: folds 
MishaSleep: folds 
mariafirmina: folds 
felipeando: folds 
jordan202025: folds 
YaR1qq: folds 
Negrata: calls 350
rac12345: checks 
*** FLOP *** [6s 7c Kh]
Negrata: checks 
rac12345: bets 700
Negrata: folds 
Uncalled bet (700) returned to rac12345
rac12345 collected 1850 from pot
rac12345: doesn't show handDTO
*** SUMMARY ***
Total pot 1850 | Rake 0 
Board [6s 7c Kh]
Seat 1: vladlen101 folded before Flop (didn't bet)
Seat 2: jcarlos.vale folded before Flop (didn't bet)
Seat 3: MishaSleep folded before Flop (didn't bet)
Seat 4: mariafirmina folded before Flop (didn't bet)
Seat 5: felipeando folded before Flop (didn't bet)
Seat 6: jordan202025 folded before Flop (didn't bet)
Seat 7: YaR1qq (button) folded before Flop (didn't bet)
Seat 8: Negrata (small blind) folded on the Flop
Seat 9: rac12345 (big blind) collected (1850)



PokerStars Hand #222153368403: Tournament #3086083919, $0.49+$0.06 USD Hold'em No Limit - Level XV (350/700) - 2021/01/02 23:43:20 EET [2021/01/02 16:43:20 ET]
Table '3086083919 96' 9-max Seat #8 is the button
Seat 1: vladlen101 (34192 in chips) 
Seat 2: jcarlos.vale (11882 in chips) 
Seat 3: MishaSleep (40300 in chips) 
Seat 4: mariafirmina (25390 in chips) 
Seat 5: felipeando (13630 in chips) 
Seat 6: jordan202025 (7805 in chips) 
Seat 7: YaR1qq (16550 in chips) 
Seat 8: Negrata (17445 in chips) 
Seat 9: rac12345 (36612 in chips) 
vladlen101: posts the ante 50
jcarlos.vale: posts the ante 50
MishaSleep: posts the ante 50
mariafirmina: posts the ante 50
felipeando: posts the ante 50
jordan202025: posts the ante 50
YaR1qq: posts the ante 50
Negrata: posts the ante 50
rac12345: posts the ante 50
rac12345: posts small blind 350
vladlen101: posts big blind 700
*** HOLE CARDS ***
Dealt to jcarlos.vale [3c 4d]
jcarlos.vale: folds 
MishaSleep: raises 1050 to 1750
mariafirmina has timed out
mariafirmina: folds 
mariafirmina is sitting out
felipeando: folds 
jordan202025: folds 
YaR1qq: folds 
Negrata: folds 
rac12345: folds 
vladlen101: folds 
Uncalled bet (1050) returned to MishaSleep
MishaSleep collected 2200 from pot
mariafirmina has returned
*** SUMMARY ***
Total pot 2200 | Rake 0 
Seat 1: vladlen101 (big blind) folded before Flop
Seat 2: jcarlos.vale folded before Flop (didn't bet)
Seat 3: MishaSleep collected (2200)
Seat 4: mariafirmina folded before Flop (didn't bet)
Seat 5: felipeando folded before Flop (didn't bet)
Seat 6: jordan202025 folded before Flop (didn't bet)
Seat 7: YaR1qq folded before Flop (didn't bet)
Seat 8: Negrata (button) folded before Flop (didn't bet)
Seat 9: rac12345 (small blind) folded before Flop



PokerStars Hand #222153401504: Tournament #3086083919, $0.49+$0.06 USD Hold'em No Limit - Level XV (350/700) - 2021/01/02 23:43:55 EET [2021/01/02 16:43:55 ET]
Table '3086083919 96' 9-max Seat #9 is the button
Seat 1: vladlen101 (33442 in chips) 
Seat 2: jcarlos.vale (11832 in chips) 
Seat 3: MishaSleep (41750 in chips) 
Seat 4: mariafirmina (25340 in chips) 
Seat 5: felipeando (13580 in chips) 
Seat 6: jordan202025 (7755 in chips) 
Seat 7: YaR1qq (16500 in chips) 
Seat 8: Negrata (17395 in chips) 
Seat 9: rac12345 (36212 in chips) 
vladlen101: posts the ante 50
jcarlos.vale: posts the ante 50
MishaSleep: posts the ante 50
mariafirmina: posts the ante 50
felipeando: posts the ante 50
jordan202025: posts the ante 50
YaR1qq: posts the ante 50
Negrata: posts the ante 50
rac12345: posts the ante 50
vladlen101: posts small blind 350
jcarlos.vale: posts big blind 700
*** HOLE CARDS ***
Dealt to jcarlos.vale [8h Kd]
MishaSleep: raises 840 to 1540
mariafirmina: calls 1540
felipeando: folds 
jordan202025: folds 
YaR1qq: raises 840 to 2380
Negrata: folds 
rac12345: folds 
vladlen101: folds 
jcarlos.vale: folds 
MishaSleep: calls 840
mariafirmina: calls 840
*** FLOP *** [3d 2s 6s]
MishaSleep: checks 
mariafirmina: checks 
YaR1qq: bets 3500
MishaSleep: raises 35820 to 39320 and is all-in
mariafirmina: folds 
YaR1qq: folds 
Uncalled bet (35820) returned to MishaSleep
MishaSleep collected 15640 from pot
*** SUMMARY ***
Total pot 15640 | Rake 0 
Board [3d 2s 6s]
Seat 1: vladlen101 (small blind) folded before Flop
Seat 2: jcarlos.vale (big blind) folded before Flop
Seat 3: MishaSleep collected (15640)
Seat 4: mariafirmina folded on the Flop
Seat 5: felipeando folded before Flop (didn't bet)
Seat 6: jordan202025 folded before Flop (didn't bet)
Seat 7: YaR1qq folded on the Flop
Seat 8: Negrata folded before Flop (didn't bet)
Seat 9: rac12345 (button) folded before Flop (didn't bet)



PokerStars Hand #222153472314: Tournament #3086083919, $0.49+$0.06 USD Hold'em No Limit - Level XVI (400/800) - 2021/01/02 23:45:10 EET [2021/01/02 16:45:10 ET]
Table '3086083919 96' 9-max Seat #1 is the button
Seat 1: vladlen101 (33042 in chips) 
Seat 2: jcarlos.vale (11082 in chips) 
Seat 3: MishaSleep (51460 in chips) 
Seat 4: mariafirmina (22910 in chips) 
Seat 5: felipeando (13530 in chips) 
Seat 6: jordan202025 (7705 in chips) 
Seat 7: YaR1qq (10570 in chips) 
Seat 8: Negrata (17345 in chips) 
Seat 9: rac12345 (36162 in chips) 
vladlen101: posts the ante 65
jcarlos.vale: posts the ante 65
MishaSleep: posts the ante 65
mariafirmina: posts the ante 65
felipeando: posts the ante 65
jordan202025: posts the ante 65
YaR1qq: posts the ante 65
Negrata: posts the ante 65
rac12345: posts the ante 65
jcarlos.vale: posts small blind 400
MishaSleep: posts big blind 800
*** HOLE CARDS ***
Dealt to jcarlos.vale [5h 8d]
mariafirmina: folds 
felipeando: raises 12665 to 13465 and is all-in
jordan202025: folds 
YaR1qq: folds 
Negrata: folds 
rac12345: folds 
vladlen101: folds 
jcarlos.vale: folds 
MishaSleep: folds 
Uncalled bet (12665) returned to felipeando
felipeando collected 2585 from pot
felipeando: doesn't show handDTO
*** SUMMARY ***
Total pot 2585 | Rake 0 
Seat 1: vladlen101 (button) folded before Flop (didn't bet)
Seat 2: jcarlos.vale (small blind) folded before Flop
Seat 3: MishaSleep (big blind) folded before Flop
Seat 4: mariafirmina folded before Flop (didn't bet)
Seat 5: felipeando collected (2585)
Seat 6: jordan202025 folded before Flop (didn't bet)
Seat 7: YaR1qq folded before Flop (didn't bet)
Seat 8: Negrata folded before Flop (didn't bet)
Seat 9: rac12345 folded before Flop (didn't bet)



PokerStars Hand #222153506448: Tournament #3086083919, $0.49+$0.06 USD Hold'em No Limit - Level XVI (400/800) - 2021/01/02 23:45:45 EET [2021/01/02 16:45:45 ET]
Table '3086083919 96' 9-max Seat #2 is the button
Seat 1: vladlen101 (32977 in chips) 
Seat 2: jcarlos.vale (10617 in chips) 
Seat 3: MishaSleep (50595 in chips) 
Seat 4: mariafirmina (22845 in chips) 
Seat 5: felipeando (15250 in chips) 
Seat 6: jordan202025 (7640 in chips) 
Seat 7: YaR1qq (10505 in chips) 
Seat 8: Negrata (17280 in chips) 
Seat 9: rac12345 (36097 in chips) 
vladlen101: posts the ante 65
jcarlos.vale: posts the ante 65
MishaSleep: posts the ante 65
mariafirmina: posts the ante 65
felipeando: posts the ante 65
jordan202025: posts the ante 65
YaR1qq: posts the ante 65
Negrata: posts the ante 65
rac12345: posts the ante 65
MishaSleep: posts small blind 400
mariafirmina: posts big blind 800
*** HOLE CARDS ***
Dealt to jcarlos.vale [9c 2s]
felipeando: folds 
jordan202025: raises 960 to 1760
YaR1qq: folds 
Negrata: folds 
rac12345: folds 
vladlen101: folds 
jcarlos.vale: folds 
MishaSleep: folds 
mariafirmina: folds 
Uncalled bet (960) returned to jordan202025
jordan202025 collected 2585 from pot
*** SUMMARY ***
Total pot 2585 | Rake 0 
Seat 1: vladlen101 folded before Flop (didn't bet)
Seat 2: jcarlos.vale (button) folded before Flop (didn't bet)
Seat 3: MishaSleep (small blind) folded before Flop
Seat 4: mariafirmina (big blind) folded before Flop
Seat 5: felipeando folded before Flop (didn't bet)
Seat 6: jordan202025 collected (2585)
Seat 7: YaR1qq folded before Flop (didn't bet)
Seat 8: Negrata folded before Flop (didn't bet)
Seat 9: rac12345 folded before Flop (didn't bet)



PokerStars Hand #222153530963: Tournament #3086083919, $0.49+$0.06 USD Hold'em No Limit - Level XVI (400/800) - 2021/01/02 23:46:11 EET [2021/01/02 16:46:11 ET]
Table '3086083919 96' 9-max Seat #3 is the button
Seat 1: vladlen101 (32912 in chips) 
Seat 2: jcarlos.vale (10552 in chips) 
Seat 3: MishaSleep (50130 in chips) 
Seat 4: mariafirmina (21980 in chips) 
Seat 5: felipeando (15185 in chips) 
Seat 6: jordan202025 (9360 in chips) 
Seat 7: YaR1qq (10440 in chips) 
Seat 8: Negrata (17215 in chips) 
Seat 9: rac12345 (36032 in chips) 
vladlen101: posts the ante 65
jcarlos.vale: posts the ante 65
MishaSleep: posts the ante 65
mariafirmina: posts the ante 65
felipeando: posts the ante 65
jordan202025: posts the ante 65
YaR1qq: posts the ante 65
Negrata: posts the ante 65
rac12345: posts the ante 65
mariafirmina: posts small blind 400
felipeando: posts big blind 800
*** HOLE CARDS ***
Dealt to jcarlos.vale [2h Th]
jordan202025: folds 
YaR1qq: raises 800 to 1600
Negrata: folds 
rac12345: raises 34367 to 35967 and is all-in
vladlen101: folds 
jcarlos.vale: folds 
MishaSleep: folds 
mariafirmina: folds 
felipeando: folds 
YaR1qq: calls 8775 and is all-in
Uncalled bet (25592) returned to rac12345
*** FLOP *** [7h Jc 6d]
*** TURN *** [7h Jc 6d] [Ad]
*** RIVER *** [7h Jc 6d Ad] [Kd]
*** SHOW DOWN ***
YaR1qq: shows [8s Ac] (a pair of Aces)
rac12345: shows [4c 4d] (a pair of Fours)
YaR1qq collected 22535 from pot
*** SUMMARY ***
Total pot 22535 | Rake 0 
Board [7h Jc 6d Ad Kd]
Seat 1: vladlen101 folded before Flop (didn't bet)
Seat 2: jcarlos.vale folded before Flop (didn't bet)
Seat 3: MishaSleep (button) folded before Flop (didn't bet)
Seat 4: mariafirmina (small blind) folded before Flop
Seat 5: felipeando (big blind) folded before Flop
Seat 6: jordan202025 folded before Flop (didn't bet)
Seat 7: YaR1qq showed [8s Ac] and won (22535) with a pair of Aces
Seat 8: Negrata folded before Flop (didn't bet)
Seat 9: rac12345 showed [4c 4d] and lost with a pair of Fours



PokerStars Hand #222153645779: Tournament #3086083919, $0.49+$0.06 USD Hold'em No Limit - Level XVI (400/800) - 2021/01/02 23:48:04 EET [2021/01/02 16:48:04 ET]
Table '3086083919 96' 9-max Seat #4 is the button
Seat 1: vladlen101 (32847 in chips) 
Seat 2: jcarlos.vale (10487 in chips) 
Seat 3: MishaSleep (50065 in chips) 
Seat 4: mariafirmina (21515 in chips) 
Seat 5: felipeando (14320 in chips) 
Seat 6: jordan202025 (9295 in chips) 
Seat 7: YaR1qq (22535 in chips) 
Seat 8: Negrata (17150 in chips) 
Seat 9: rac12345 (25592 in chips) 
vladlen101: posts the ante 65
jcarlos.vale: posts the ante 65
MishaSleep: posts the ante 65
mariafirmina: posts the ante 65
felipeando: posts the ante 65
jordan202025: posts the ante 65
YaR1qq: posts the ante 65
Negrata: posts the ante 65
rac12345: posts the ante 65
felipeando: posts small blind 400
jordan202025: posts big blind 800
*** HOLE CARDS ***
Dealt to jcarlos.vale [Kc 7h]
YaR1qq: folds 
Negrata: folds 
rac12345: raises 24727 to 25527 and is all-in
vladlen101: folds 
jcarlos.vale: folds 
MishaSleep: folds 
mariafirmina has timed out
mariafirmina: folds 
mariafirmina is sitting out
felipeando: folds 
jordan202025: folds 
Uncalled bet (24727) returned to rac12345
rac12345 collected 2585 from pot
rac12345: doesn't show handDTO
*** SUMMARY ***
Total pot 2585 | Rake 0 
Seat 1: vladlen101 folded before Flop (didn't bet)
Seat 2: jcarlos.vale folded before Flop (didn't bet)
Seat 3: MishaSleep folded before Flop (didn't bet)
Seat 4: mariafirmina (button) folded before Flop (didn't bet)
Seat 5: felipeando (small blind) folded before Flop
Seat 6: jordan202025 (big blind) folded before Flop
Seat 7: YaR1qq folded before Flop (didn't bet)
Seat 8: Negrata folded before Flop (didn't bet)
Seat 9: rac12345 collected (2585)



PokerStars Hand #222153685718: Tournament #3086083919, $0.49+$0.06 USD Hold'em No Limit - Level XVI (400/800) - 2021/01/02 23:48:46 EET [2021/01/02 16:48:46 ET]
Table '3086083919 96' 9-max Seat #5 is the button
Seat 1: vladlen101 (32782 in chips) 
Seat 2: jcarlos.vale (10422 in chips) 
Seat 3: MishaSleep (50000 in chips) 
Seat 4: mariafirmina (21450 in chips) is sitting out
Seat 5: felipeando (13855 in chips) 
Seat 6: jordan202025 (8430 in chips) 
Seat 7: YaR1qq (22470 in chips) 
Seat 8: Negrata (17085 in chips) 
Seat 9: rac12345 (27312 in chips) 
vladlen101: posts the ante 65
jcarlos.vale: posts the ante 65
MishaSleep: posts the ante 65
mariafirmina: posts the ante 65
felipeando: posts the ante 65
jordan202025: posts the ante 65
YaR1qq: posts the ante 65
Negrata: posts the ante 65
rac12345: posts the ante 65
jordan202025: posts small blind 400
YaR1qq: posts big blind 800
*** HOLE CARDS ***
Dealt to jcarlos.vale [2d Qc]
mariafirmina has returned
Negrata: folds 
rac12345: calls 800
vladlen101: raises 3385 to 4185
jcarlos.vale: folds 
MishaSleep: folds 
mariafirmina has timed out
mariafirmina: folds 
mariafirmina is sitting out
felipeando: folds 
jordan202025: folds 
YaR1qq: folds 
rac12345: folds 
Uncalled bet (3385) returned to vladlen101
vladlen101 collected 3385 from pot
vladlen101: doesn't show handDTO
*** SUMMARY ***
Total pot 3385 | Rake 0 
Seat 1: vladlen101 collected (3385)
Seat 2: jcarlos.vale folded before Flop (didn't bet)
Seat 3: MishaSleep folded before Flop (didn't bet)
Seat 4: mariafirmina folded before Flop (didn't bet)
Seat 5: felipeando (button) folded before Flop (didn't bet)
Seat 6: jordan202025 (small blind) folded before Flop
Seat 7: YaR1qq (big blind) folded before Flop
Seat 8: Negrata folded before Flop (didn't bet)
Seat 9: rac12345 folded before Flop



PokerStars Hand #222153724038: Tournament #3086083919, $0.49+$0.06 USD Hold'em No Limit - Level XVI (400/800) - 2021/01/02 23:49:27 EET [2021/01/02 16:49:27 ET]
Table '3086083919 96' 9-max Seat #6 is the button
Seat 1: vladlen101 (35302 in chips) 
Seat 2: jcarlos.vale (10357 in chips) 
Seat 3: MishaSleep (49935 in chips) 
Seat 4: mariafirmina (21385 in chips) is sitting out
Seat 5: felipeando (13790 in chips) 
Seat 6: jordan202025 (7965 in chips) 
Seat 7: YaR1qq (21605 in chips) 
Seat 8: Negrata (17020 in chips) 
Seat 9: rac12345 (26447 in chips) 
vladlen101: posts the ante 65
jcarlos.vale: posts the ante 65
MishaSleep: posts the ante 65
mariafirmina: posts the ante 65
felipeando: posts the ante 65
jordan202025: posts the ante 65
YaR1qq: posts the ante 65
Negrata: posts the ante 65
rac12345: posts the ante 65
YaR1qq: posts small blind 400
Negrata: posts big blind 800
*** HOLE CARDS ***
Dealt to jcarlos.vale [6s Qd]
rac12345: folds 
mariafirmina has returned
vladlen101: folds 
jcarlos.vale: folds 
MishaSleep: folds 
mariafirmina: folds 
felipeando: folds 
jordan202025: raises 960 to 1760
YaR1qq: folds 
Negrata: folds 
Uncalled bet (960) returned to jordan202025
jordan202025 collected 2585 from pot
*** SUMMARY ***
Total pot 2585 | Rake 0 
Seat 1: vladlen101 folded before Flop (didn't bet)
Seat 2: jcarlos.vale folded before Flop (didn't bet)
Seat 3: MishaSleep folded before Flop (didn't bet)
Seat 4: mariafirmina folded before Flop (didn't bet)
Seat 5: felipeando folded before Flop (didn't bet)
Seat 6: jordan202025 (button) collected (2585)
Seat 7: YaR1qq (small blind) folded before Flop
Seat 8: Negrata (big blind) folded before Flop
Seat 9: rac12345 folded before Flop (didn't bet)



PokerStars Hand #222153754103: Tournament #3086083919, $0.49+$0.06 USD Hold'em No Limit - Level XVI (400/800) - 2021/01/02 23:49:59 EET [2021/01/02 16:49:59 ET]
Table '3086083919 96' 9-max Seat #7 is the button
Seat 1: vladlen101 (35237 in chips) 
Seat 2: jcarlos.vale (10292 in chips) 
Seat 3: MishaSleep (49870 in chips) 
Seat 4: mariafirmina (21320 in chips) 
Seat 5: felipeando (13725 in chips) 
Seat 6: jordan202025 (9685 in chips) 
Seat 7: YaR1qq (21140 in chips) 
Seat 8: Negrata (16155 in chips) 
Seat 9: rac12345 (26382 in chips) 
vladlen101: posts the ante 65
jcarlos.vale: posts the ante 65
MishaSleep: posts the ante 65
mariafirmina: posts the ante 65
felipeando: posts the ante 65
jordan202025: posts the ante 65
YaR1qq: posts the ante 65
Negrata: posts the ante 65
rac12345: posts the ante 65
Negrata: posts small blind 400
rac12345: posts big blind 800
*** HOLE CARDS ***
Dealt to jcarlos.vale [8c Ks]
vladlen101: folds 
jcarlos.vale: folds 
MishaSleep: folds 
mariafirmina: folds 
felipeando: folds 
jordan202025: folds 
YaR1qq: calls 800
Negrata: folds 
rac12345: raises 25517 to 26317 and is all-in
YaR1qq: calls 20275 and is all-in
Uncalled bet (5242) returned to rac12345
*** FLOP *** [7s Tc 5s]
*** TURN *** [7s Tc 5s] [4h]
*** RIVER *** [7s Tc 5s 4h] [Qd]
*** SHOW DOWN ***
rac12345: shows [3d 3c] (a pair of Threes)
YaR1qq: shows [Ac Td] (a pair of Tens)
YaR1qq collected 43135 from pot
*** SUMMARY ***
Total pot 43135 | Rake 0 
Board [7s Tc 5s 4h Qd]
Seat 1: vladlen101 folded before Flop (didn't bet)
Seat 2: jcarlos.vale folded before Flop (didn't bet)
Seat 3: MishaSleep folded before Flop (didn't bet)
Seat 4: mariafirmina folded before Flop (didn't bet)
Seat 5: felipeando folded before Flop (didn't bet)
Seat 6: jordan202025 folded before Flop (didn't bet)
Seat 7: YaR1qq (button) showed [Ac Td] and won (43135) with a pair of Tens
Seat 8: Negrata (small blind) folded before Flop
Seat 9: rac12345 (big blind) showed [3d 3c] and lost with a pair of Threes



PokerStars Hand #222153791060: Tournament #3086083919, $0.49+$0.06 USD Hold'em No Limit - Level XVI (400/800) - 2021/01/02 23:50:39 EET [2021/01/02 16:50:39 ET]
Table '3086083919 96' 9-max Seat #8 is the button
Seat 1: vladlen101 (35172 in chips) 
Seat 2: jcarlos.vale (10227 in chips) 
Seat 3: MishaSleep (49805 in chips) 
Seat 4: mariafirmina (21255 in chips) 
Seat 5: felipeando (13660 in chips) 
Seat 6: jordan202025 (9620 in chips) 
Seat 7: YaR1qq (43135 in chips) 
Seat 8: Negrata (15690 in chips) 
Seat 9: rac12345 (5242 in chips) 
vladlen101: posts the ante 65
jcarlos.vale: posts the ante 65
MishaSleep: posts the ante 65
mariafirmina: posts the ante 65
felipeando: posts the ante 65
jordan202025: posts the ante 65
YaR1qq: posts the ante 65
Negrata: posts the ante 65
rac12345: posts the ante 65
rac12345: posts small blind 400
vladlen101: posts big blind 800
*** HOLE CARDS ***
Dealt to jcarlos.vale [Ad 4h]
jcarlos.vale: folds 
MishaSleep: folds 
mariafirmina: folds 
felipeando: folds 
jordan202025: folds 
YaR1qq: folds 
YaR1qq is sitting out
Negrata: calls 800
rac12345: folds 
vladlen101: checks 
*** FLOP *** [Td Jd 2c]
vladlen101: checks 
Negrata: checks 
*** TURN *** [Td Jd 2c] [2s]
jcarlos.vale said, "jogando bingo bolsominion?>"
vladlen101: bets 1293
Negrata: folds 
Uncalled bet (1293) returned to vladlen101
vladlen101 collected 2585 from pot
vladlen101: doesn't show handDTO
*** SUMMARY ***
Total pot 2585 | Rake 0 
Board [Td Jd 2c 2s]
Seat 1: vladlen101 (big blind) collected (2585)
Seat 2: jcarlos.vale folded before Flop (didn't bet)
Seat 3: MishaSleep folded before Flop (didn't bet)
Seat 4: mariafirmina folded before Flop (didn't bet)
Seat 5: felipeando folded before Flop (didn't bet)
Seat 6: jordan202025 folded before Flop (didn't bet)
Seat 7: YaR1qq folded before Flop (didn't bet)
Seat 8: Negrata (button) folded on the Turn
Seat 9: rac12345 (small blind) folded before Flop



PokerStars Hand #222153836552: Tournament #3086083919, $0.49+$0.06 USD Hold'em No Limit - Level XVI (400/800) - 2021/01/02 23:51:27 EET [2021/01/02 16:51:27 ET]
Table '3086083919 96' 9-max Seat #9 is the button
Seat 1: vladlen101 (36892 in chips) 
Seat 2: jcarlos.vale (10162 in chips) 
Seat 3: MishaSleep (49740 in chips) 
Seat 4: mariafirmina (21190 in chips) 
Seat 5: felipeando (13595 in chips) 
Seat 6: jordan202025 (9555 in chips) 
Seat 7: YaR1qq (43070 in chips) is sitting out
Seat 8: Negrata (14825 in chips) 
Seat 9: rac12345 (4777 in chips) 
vladlen101: posts the ante 65
jcarlos.vale: posts the ante 65
MishaSleep: posts the ante 65
mariafirmina: posts the ante 65
felipeando: posts the ante 65
jordan202025: posts the ante 65
YaR1qq: posts the ante 65
Negrata: posts the ante 65
rac12345: posts the ante 65
vladlen101: posts small blind 400
jcarlos.vale: posts big blind 800
*** HOLE CARDS ***
Dealt to jcarlos.vale [5d 8c]
MishaSleep: folds 
mariafirmina: folds 
felipeando: folds 
jordan202025: folds 
YaR1qq: folds 
Negrata: folds 
rac12345: raises 3912 to 4712 and is all-in
vladlen101: folds 
jcarlos.vale: folds 
Uncalled bet (3912) returned to rac12345
rac12345 collected 2585 from pot
rac12345: doesn't show handDTO
*** SUMMARY ***
Total pot 2585 | Rake 0 
Seat 1: vladlen101 (small blind) folded before Flop
Seat 2: jcarlos.vale (big blind) folded before Flop
Seat 3: MishaSleep folded before Flop (didn't bet)
Seat 4: mariafirmina folded before Flop (didn't bet)
Seat 5: felipeando folded before Flop (didn't bet)
Seat 6: jordan202025 folded before Flop (didn't bet)
Seat 7: YaR1qq folded before Flop (didn't bet)
Seat 8: Negrata folded before Flop (didn't bet)
Seat 9: rac12345 (button) collected (2585)



PokerStars Hand #222153852121: Tournament #3086083919, $0.49+$0.06 USD Hold'em No Limit - Level XVI (400/800) - 2021/01/02 23:51:44 EET [2021/01/02 16:51:44 ET]
Table '3086083919 96' 9-max Seat #1 is the button
Seat 1: vladlen101 (36427 in chips) 
Seat 2: jcarlos.vale (9297 in chips) 
Seat 3: MishaSleep (49675 in chips) 
Seat 4: mariafirmina (21125 in chips) 
Seat 5: felipeando (13530 in chips) 
Seat 6: jordan202025 (9490 in chips) 
Seat 7: YaR1qq (43005 in chips) is sitting out
Seat 8: Negrata (14760 in chips) 
Seat 9: rac12345 (6497 in chips) 
vladlen101: posts the ante 65
jcarlos.vale: posts the ante 65
MishaSleep: posts the ante 65
mariafirmina: posts the ante 65
felipeando: posts the ante 65
jordan202025: posts the ante 65
YaR1qq: posts the ante 65
Negrata: posts the ante 65
rac12345: posts the ante 65
jcarlos.vale: posts small blind 400
MishaSleep: posts big blind 800
*** HOLE CARDS ***
Dealt to jcarlos.vale [5d Qc]
mariafirmina: raises 800 to 1600
felipeando: folds 
jordan202025: folds 
YaR1qq: folds 
Negrata: folds 
rac12345: folds 
vladlen101: folds 
jcarlos.vale: folds 
MishaSleep: folds 
Uncalled bet (800) returned to mariafirmina
mariafirmina collected 2585 from pot
*** SUMMARY ***
Total pot 2585 | Rake 0 
Seat 1: vladlen101 (button) folded before Flop (didn't bet)
Seat 2: jcarlos.vale (small blind) folded before Flop
Seat 3: MishaSleep (big blind) folded before Flop
Seat 4: mariafirmina collected (2585)
Seat 5: felipeando folded before Flop (didn't bet)
Seat 6: jordan202025 folded before Flop (didn't bet)
Seat 7: YaR1qq folded before Flop (didn't bet)
Seat 8: Negrata folded before Flop (didn't bet)
Seat 9: rac12345 folded before Flop (didn't bet)



PokerStars Hand #222153868518: Tournament #3086083919, $0.49+$0.06 USD Hold'em No Limit - Level XVI (400/800) - 2021/01/02 23:52:01 EET [2021/01/02 16:52:01 ET]
Table '3086083919 96' 9-max Seat #2 is the button
Seat 1: vladlen101 (36362 in chips) 
Seat 2: jcarlos.vale (8832 in chips) 
Seat 3: MishaSleep (48810 in chips) 
Seat 4: mariafirmina (22845 in chips) 
Seat 5: felipeando (13465 in chips) 
Seat 6: jordan202025 (9425 in chips) 
Seat 7: YaR1qq (42940 in chips) is sitting out
Seat 8: Negrata (14695 in chips) 
Seat 9: rac12345 (6432 in chips) 
vladlen101: posts the ante 65
jcarlos.vale: posts the ante 65
MishaSleep: posts the ante 65
mariafirmina: posts the ante 65
felipeando: posts the ante 65
jordan202025: posts the ante 65
YaR1qq: posts the ante 65
Negrata: posts the ante 65
rac12345: posts the ante 65
MishaSleep: posts small blind 400
mariafirmina: posts big blind 800
*** HOLE CARDS ***
Dealt to jcarlos.vale [3c 2d]
felipeando: folds 
jordan202025: folds 
YaR1qq: folds 
Negrata: folds 
rac12345: folds 
vladlen101: folds 
jcarlos.vale: folds 
MishaSleep: raises 1200 to 2000
mariafirmina: folds 
Uncalled bet (1200) returned to MishaSleep
MishaSleep collected 2185 from pot
*** SUMMARY ***
Total pot 2185 | Rake 0 
Seat 1: vladlen101 folded before Flop (didn't bet)
Seat 2: jcarlos.vale (button) folded before Flop (didn't bet)
Seat 3: MishaSleep (small blind) collected (2185)
Seat 4: mariafirmina (big blind) folded before Flop
Seat 5: felipeando folded before Flop (didn't bet)
Seat 6: jordan202025 folded before Flop (didn't bet)
Seat 7: YaR1qq folded before Flop (didn't bet)
Seat 8: Negrata folded before Flop (didn't bet)
Seat 9: rac12345 folded before Flop (didn't bet)



PokerStars Hand #222153891412: Tournament #3086083919, $0.49+$0.06 USD Hold'em No Limit - Level XVI (400/800) - 2021/01/02 23:52:25 EET [2021/01/02 16:52:25 ET]
Table '3086083919 96' 9-max Seat #3 is the button
Seat 1: vladlen101 (36297 in chips) 
Seat 2: jcarlos.vale (8767 in chips) 
Seat 3: MishaSleep (50130 in chips) 
Seat 4: mariafirmina (21980 in chips) 
Seat 5: felipeando (13400 in chips) 
Seat 6: jordan202025 (9360 in chips) 
Seat 7: YaR1qq (42875 in chips) is sitting out
Seat 8: Negrata (14630 in chips) 
Seat 9: rac12345 (6367 in chips) 
vladlen101: posts the ante 65
jcarlos.vale: posts the ante 65
MishaSleep: posts the ante 65
mariafirmina: posts the ante 65
felipeando: posts the ante 65
jordan202025: posts the ante 65
YaR1qq: posts the ante 65
Negrata: posts the ante 65
rac12345: posts the ante 65
mariafirmina: posts small blind 400
felipeando: posts big blind 800
*** HOLE CARDS ***
Dealt to jcarlos.vale [Ad 6d]
jordan202025 has timed out
jordan202025: folds 
jordan202025 is sitting out
YaR1qq: folds 
jordan202025 has returned
Negrata: folds 
rac12345: folds 
vladlen101: folds 
jcarlos.vale: raises 7902 to 8702 and is all-in
MishaSleep: folds 
mariafirmina: folds 
felipeando: folds 
Uncalled bet (7902) returned to jcarlos.vale
jcarlos.vale collected 2585 from pot
jcarlos.vale: doesn't show handDTO
*** SUMMARY ***
Total pot 2585 | Rake 0 
Seat 1: vladlen101 folded before Flop (didn't bet)
Seat 2: jcarlos.vale collected (2585)
Seat 3: MishaSleep (button) folded before Flop (didn't bet)
Seat 4: mariafirmina (small blind) folded before Flop
Seat 5: felipeando (big blind) folded before Flop
Seat 6: jordan202025 folded before Flop (didn't bet)
Seat 7: YaR1qq folded before Flop (didn't bet)
Seat 8: Negrata folded before Flop (didn't bet)
Seat 9: rac12345 folded before Flop (didn't bet)



PokerStars Hand #222153918696: Tournament #3086083919, $0.49+$0.06 USD Hold'em No Limit - Level XVI (400/800) - 2021/01/02 23:52:54 EET [2021/01/02 16:52:54 ET]
Table '3086083919 96' 9-max Seat #4 is the button
Seat 1: vladlen101 (36232 in chips) 
Seat 2: jcarlos.vale (10487 in chips) 
Seat 3: MishaSleep (50065 in chips) 
Seat 4: mariafirmina (21515 in chips) 
Seat 5: felipeando (12535 in chips) 
Seat 6: jordan202025 (9295 in chips) 
Seat 7: YaR1qq (42810 in chips) is sitting out
Seat 8: Negrata (14565 in chips) 
Seat 9: rac12345 (6302 in chips) 
vladlen101: posts the ante 65
jcarlos.vale: posts the ante 65
MishaSleep: posts the ante 65
mariafirmina: posts the ante 65
felipeando: posts the ante 65
jordan202025: posts the ante 65
YaR1qq: posts the ante 65
Negrata: posts the ante 65
rac12345: posts the ante 65
felipeando: posts small blind 400
jordan202025: posts big blind 800
*** HOLE CARDS ***
Dealt to jcarlos.vale [6d 3c]
YaR1qq: folds 
Negrata: calls 800
rac12345: folds 
vladlen101: folds 
jcarlos.vale: folds 
MishaSleep: calls 800
mariafirmina: folds 
felipeando: calls 400
jordan202025: checks 
*** FLOP *** [5h Ks 8h]
felipeando: checks 
jordan202025: checks 
Negrata: checks 
MishaSleep: checks 
*** TURN *** [5h Ks 8h] [2d]
felipeando: bets 1779
jordan202025: folds 
Negrata: folds 
MishaSleep: folds 
Uncalled bet (1779) returned to felipeando
felipeando collected 3785 from pot
felipeando: doesn't show handDTO
*** SUMMARY ***
Total pot 3785 | Rake 0 
Board [5h Ks 8h 2d]
Seat 1: vladlen101 folded before Flop (didn't bet)
Seat 2: jcarlos.vale folded before Flop (didn't bet)
Seat 3: MishaSleep folded on the Turn
Seat 4: mariafirmina (button) folded before Flop (didn't bet)
Seat 5: felipeando (small blind) collected (3785)
Seat 6: jordan202025 (big blind) folded on the Turn
Seat 7: YaR1qq folded before Flop (didn't bet)
Seat 8: Negrata folded on the Turn
Seat 9: rac12345 folded before Flop (didn't bet)



PokerStars Hand #222153956225: Tournament #3086083919, $0.49+$0.06 USD Hold'em No Limit - Level XVI (400/800) - 2021/01/02 23:53:33 EET [2021/01/02 16:53:33 ET]
Table '3086083919 96' 9-max Seat #5 is the button
Seat 1: vladlen101 (36167 in chips) 
Seat 2: jcarlos.vale (10422 in chips) 
Seat 4: mariafirmina (21450 in chips) 
Seat 5: felipeando (15455 in chips) 
Seat 6: jordan202025 (8430 in chips) 
Seat 7: YaR1qq (42745 in chips) is sitting out
Seat 8: Negrata (13700 in chips) 
Seat 9: rac12345 (6237 in chips) 
vladlen101: posts the ante 65
jcarlos.vale: posts the ante 65
mariafirmina: posts the ante 65
felipeando: posts the ante 65
jordan202025: posts the ante 65
YaR1qq: posts the ante 65
Negrata: posts the ante 65
rac12345: posts the ante 65
jordan202025: posts small blind 400
YaR1qq: posts big blind 800
*** HOLE CARDS ***
Dealt to jcarlos.vale [Kh Tc]
Negrata: calls 800
rac12345: raises 5372 to 6172 and is all-in
vladlen101: folds 
jcarlos.vale: folds 
mariafirmina: folds 
felipeando: folds 
jordan202025: folds 
YaR1qq: folds 
Negrata: calls 5372
*** FLOP *** [4d Ts 2d]
*** TURN *** [4d Ts 2d] [3d]
*** RIVER *** [4d Ts 2d 3d] [7c]
*** SHOW DOWN ***
Negrata: shows [Ks Js] (high pairOfCards King)
rac12345: shows [As 9c] (high pairOfCards Ace)
rac12345 collected 14064 from pot
*** SUMMARY ***
Total pot 14064 | Rake 0 
Board [4d Ts 2d 3d 7c]
Seat 1: vladlen101 folded before Flop (didn't bet)
Seat 2: jcarlos.vale folded before Flop (didn't bet)
Seat 4: mariafirmina folded before Flop (didn't bet)
Seat 5: felipeando (button) folded before Flop (didn't bet)
Seat 6: jordan202025 (small blind) folded before Flop
Seat 7: YaR1qq (big blind) folded before Flop
Seat 8: Negrata showed [Ks Js] and lost with high pairOfCards King
Seat 9: rac12345 showed [As 9c] and won (14064) with high pairOfCards Ace



PokerStars Hand #222153995957: Tournament #3086083919, $0.49+$0.06 USD Hold'em No Limit - Level XVI (400/800) - 2021/01/02 23:54:15 EET [2021/01/02 16:54:15 ET]
Table '3086083919 96' 9-max Seat #6 is the button
Seat 1: vladlen101 (36102 in chips) 
Seat 2: jcarlos.vale (10357 in chips) 
Seat 3: biscom2007 (11705 in chips) 
Seat 4: mariafirmina (21385 in chips) 
Seat 5: felipeando (15390 in chips) 
Seat 6: jordan202025 (7965 in chips) 
Seat 7: YaR1qq (41880 in chips) is sitting out
Seat 8: Negrata (7463 in chips) 
Seat 9: rac12345 (14064 in chips) 
vladlen101: posts the ante 65
jcarlos.vale: posts the ante 65
biscom2007: posts the ante 65
mariafirmina: posts the ante 65
felipeando: posts the ante 65
jordan202025: posts the ante 65
YaR1qq: posts the ante 65
Negrata: posts the ante 65
rac12345: posts the ante 65
YaR1qq: posts small blind 400
Negrata: posts big blind 800
*** HOLE CARDS ***
Dealt to jcarlos.vale [2s 4s]
rac12345: folds 
vladlen101: raises 2585 to 3385
jcarlos.vale: folds 
biscom2007: folds 
mariafirmina: folds 
felipeando: folds 
jordan202025: folds 
YaR1qq: folds 
Negrata: folds 
Uncalled bet (2585) returned to vladlen101
vladlen101 collected 2585 from pot
vladlen101: doesn't show handDTO
*** SUMMARY ***
Total pot 2585 | Rake 0 
Seat 1: vladlen101 collected (2585)
Seat 2: jcarlos.vale folded before Flop (didn't bet)
Seat 3: biscom2007 folded before Flop (didn't bet)
Seat 4: mariafirmina folded before Flop (didn't bet)
Seat 5: felipeando folded before Flop (didn't bet)
Seat 6: jordan202025 (button) folded before Flop (didn't bet)
Seat 7: YaR1qq (small blind) folded before Flop
Seat 8: Negrata (big blind) folded before Flop
Seat 9: rac12345 folded before Flop (didn't bet)



PokerStars Hand #222154016849: Tournament #3086083919, $0.49+$0.06 USD Hold'em No Limit - Level XVII (500/1000) - 2021/01/02 23:54:37 EET [2021/01/02 16:54:37 ET]
Table '3086083919 96' 9-max Seat #7 is the button
Seat 1: vladlen101 (37822 in chips) 
Seat 2: jcarlos.vale (10292 in chips) 
Seat 3: biscom2007 (11640 in chips) 
Seat 4: mariafirmina (21320 in chips) 
Seat 5: felipeando (15325 in chips) 
Seat 6: jordan202025 (7900 in chips) 
Seat 7: YaR1qq (41415 in chips) is sitting out
Seat 8: Negrata (6598 in chips) 
Seat 9: rac12345 (13999 in chips) 
vladlen101: posts the ante 75
jcarlos.vale: posts the ante 75
biscom2007: posts the ante 75
mariafirmina: posts the ante 75
felipeando: posts the ante 75
jordan202025: posts the ante 75
YaR1qq: posts the ante 75
Negrata: posts the ante 75
rac12345: posts the ante 75
Negrata: posts small blind 500
rac12345: posts big blind 1000
*** HOLE CARDS ***
Dealt to jcarlos.vale [Js Ah]
vladlen101: folds 
jcarlos.vale: raises 9217 to 10217 and is all-in
biscom2007: folds 
mariafirmina: folds 
felipeando: folds 
jordan202025: folds 
YaR1qq: folds 
Negrata: folds 
rac12345: folds 
Uncalled bet (9217) returned to jcarlos.vale
jcarlos.vale collected 3175 from pot
jcarlos.vale: doesn't show handDTO
*** SUMMARY ***
Total pot 3175 | Rake 0 
Seat 1: vladlen101 folded before Flop (didn't bet)
Seat 2: jcarlos.vale collected (3175)
Seat 3: biscom2007 folded before Flop (didn't bet)
Seat 4: mariafirmina folded before Flop (didn't bet)
Seat 5: felipeando folded before Flop (didn't bet)
Seat 6: jordan202025 folded before Flop (didn't bet)
Seat 7: YaR1qq (button) folded before Flop (didn't bet)
Seat 8: Negrata (small blind) folded before Flop
Seat 9: rac12345 (big blind) folded before Flop



PokerStars Hand #222154031646: Tournament #3086083919, $0.49+$0.06 USD Hold'em No Limit - Level XVII (500/1000) - 2021/01/02 23:54:53 EET [2021/01/02 16:54:53 ET]
Table '3086083919 96' 9-max Seat #8 is the button
Seat 1: vladlen101 (37747 in chips) 
Seat 2: jcarlos.vale (12392 in chips) 
Seat 3: biscom2007 (11565 in chips) 
Seat 4: mariafirmina (21245 in chips) 
Seat 5: felipeando (15250 in chips) 
Seat 6: jordan202025 (7825 in chips) 
Seat 7: YaR1qq (41340 in chips) is sitting out
Seat 8: Negrata (6023 in chips) 
Seat 9: rac12345 (12924 in chips) 
vladlen101: posts the ante 75
jcarlos.vale: posts the ante 75
biscom2007: posts the ante 75
mariafirmina: posts the ante 75
felipeando: posts the ante 75
jordan202025: posts the ante 75
YaR1qq: posts the ante 75
Negrata: posts the ante 75
rac12345: posts the ante 75
rac12345: posts small blind 500
vladlen101: posts big blind 1000
*** HOLE CARDS ***
Dealt to jcarlos.vale [Js Ts]
jcarlos.vale: folds 
biscom2007: raises 1000 to 2000
mariafirmina: folds 
felipeando: folds 
jordan202025: folds 
YaR1qq: folds 
Negrata: folds 
rac12345: folds 
vladlen101: folds 
Uncalled bet (1000) returned to biscom2007
biscom2007 collected 3175 from pot
biscom2007: doesn't show handDTO
*** SUMMARY ***
Total pot 3175 | Rake 0 
Seat 1: vladlen101 (big blind) folded before Flop
Seat 2: jcarlos.vale folded before Flop (didn't bet)
Seat 3: biscom2007 collected (3175)
Seat 4: mariafirmina folded before Flop (didn't bet)
Seat 5: felipeando folded before Flop (didn't bet)
Seat 6: jordan202025 folded before Flop (didn't bet)
Seat 7: YaR1qq folded before Flop (didn't bet)
Seat 8: Negrata (button) folded before Flop (didn't bet)
Seat 9: rac12345 (small blind) folded before Flop



PokerStars Hand #222154307434: Tournament #3086083919, $0.49+$0.06 USD Hold'em No Limit - Level XVII (500/1000) - 2021/01/03 0:01:35 EET [2021/01/02 17:01:35 ET]
Table '3086083919 96' 9-max Seat #9 is the button
Seat 1: vladlen101 (36672 in chips) 
Seat 2: jcarlos.vale (12317 in chips) 
Seat 3: biscom2007 (13665 in chips) 
Seat 4: mariafirmina (21170 in chips) 
Seat 5: felipeando (15175 in chips) 
Seat 6: jordan202025 (7750 in chips) 
Seat 7: YaR1qq (41265 in chips) is sitting out
Seat 8: Negrata (5948 in chips) 
Seat 9: rac12345 (12349 in chips) 
vladlen101: posts the ante 75
jcarlos.vale: posts the ante 75
biscom2007: posts the ante 75
mariafirmina: posts the ante 75
felipeando: posts the ante 75
jordan202025: posts the ante 75
YaR1qq: posts the ante 75
Negrata: posts the ante 75
rac12345: posts the ante 75
vladlen101: posts small blind 500
jcarlos.vale: posts big blind 1000
*** HOLE CARDS ***
Dealt to jcarlos.vale [7c Td]
biscom2007: calls 1000
mariafirmina: folds 
felipeando: raises 14100 to 15100 and is all-in
jordan202025: folds 
YaR1qq: folds 
Negrata: folds 
rac12345: calls 12274 and is all-in
vladlen101 has timed out
vladlen101: folds 
vladlen101 is sitting out
jcarlos.vale: folds 
biscom2007: folds 
Uncalled bet (2826) returned to felipeando
*** FLOP *** [7s 3s 9h]
*** TURN *** [7s 3s 9h] [2d]
*** RIVER *** [7s 3s 9h 2d] [9s]
*** SHOW DOWN ***
felipeando: shows [8c 8h] (two pair, Nines and Eights)
rac12345: shows [Jd As] (a pair of Nines)
felipeando collected 27723 from pot
rac12345 finished the tournament in 542nd place and received $0.85.
*** SUMMARY ***
Total pot 27723 | Rake 0 
Board [7s 3s 9h 2d 9s]
Seat 1: vladlen101 (small blind) folded before Flop
Seat 2: jcarlos.vale (big blind) folded before Flop
Seat 3: biscom2007 folded before Flop
Seat 4: mariafirmina folded before Flop (didn't bet)
Seat 5: felipeando showed [8c 8h] and won (27723) with two pair, Nines and Eights
Seat 6: jordan202025 folded before Flop (didn't bet)
Seat 7: YaR1qq folded before Flop (didn't bet)
Seat 8: Negrata folded before Flop (didn't bet)
Seat 9: rac12345 (button) showed [Jd As] and lost with a pair of Nines



PokerStars Hand #222154432137: Tournament #3086083919, $0.49+$0.06 USD Hold'em No Limit - Level XVII (500/1000) - 2021/01/03 0:03:54 EET [2021/01/02 17:03:54 ET]
Table '3086083919 96' 9-max Seat #1 is the button
Seat 1: vladlen101 (36097 in chips) is sitting out
Seat 2: jcarlos.vale (11242 in chips) 
Seat 3: biscom2007 (12590 in chips) 
Seat 4: mariafirmina (21095 in chips) 
Seat 5: felipeando (30549 in chips) 
Seat 6: jordan202025 (7675 in chips) 
Seat 7: YaR1qq (41190 in chips) is sitting out
Seat 8: Negrata (5873 in chips) 
Seat 9: Mitnick.K.D. (32405 in chips) 
vladlen101: posts the ante 75
jcarlos.vale: posts the ante 75
biscom2007: posts the ante 75
mariafirmina: posts the ante 75
felipeando: posts the ante 75
jordan202025: posts the ante 75
YaR1qq: posts the ante 75
Negrata: posts the ante 75
Mitnick.K.D.: posts the ante 75
jcarlos.vale: posts small blind 500
biscom2007: posts big blind 1000
*** HOLE CARDS ***
Dealt to jcarlos.vale [9d Qd]
mariafirmina: folds 
felipeando: raises 1000 to 2000
jordan202025: folds 
YaR1qq: folds 
Negrata: folds 
Mitnick.K.D.: folds 
vladlen101: folds 
jcarlos.vale: folds 
biscom2007: folds 
Uncalled bet (1000) returned to felipeando
felipeando collected 3175 from pot
felipeando: doesn't show handDTO
*** SUMMARY ***
Total pot 3175 | Rake 0 
Seat 1: vladlen101 (button) folded before Flop (didn't bet)
Seat 2: jcarlos.vale (small blind) folded before Flop
Seat 3: biscom2007 (big blind) folded before Flop
Seat 4: mariafirmina folded before Flop (didn't bet)
Seat 5: felipeando collected (3175)
Seat 6: jordan202025 folded before Flop (didn't bet)
Seat 7: YaR1qq folded before Flop (didn't bet)
Seat 8: Negrata folded before Flop (didn't bet)
Seat 9: Mitnick.K.D. folded before Flop (didn't bet)



PokerStars Hand #222154458767: Tournament #3086083919, $0.49+$0.06 USD Hold'em No Limit - Level XVII (500/1000) - 2021/01/03 0:04:22 EET [2021/01/02 17:04:22 ET]
Table '3086083919 96' 9-max Seat #2 is the button
Seat 1: vladlen101 (36022 in chips) is sitting out
Seat 2: jcarlos.vale (10667 in chips) 
Seat 3: biscom2007 (11515 in chips) 
Seat 4: mariafirmina (21020 in chips) 
Seat 5: felipeando (32649 in chips) 
Seat 6: jordan202025 (7600 in chips) 
Seat 7: YaR1qq (41115 in chips) is sitting out
Seat 8: Negrata (5798 in chips) 
Seat 9: Mitnick.K.D. (32330 in chips) 
vladlen101: posts the ante 75
jcarlos.vale: posts the ante 75
biscom2007: posts the ante 75
mariafirmina: posts the ante 75
felipeando: posts the ante 75
jordan202025: posts the ante 75
YaR1qq: posts the ante 75
Negrata: posts the ante 75
Mitnick.K.D.: posts the ante 75
biscom2007: posts small blind 500
mariafirmina: posts big blind 1000
*** HOLE CARDS ***
Dealt to jcarlos.vale [7h 8d]
felipeando: folds 
jordan202025: folds 
YaR1qq: folds 
Negrata: calls 1000
Mitnick.K.D.: folds 
vladlen101: folds 
jcarlos.vale: folds 
biscom2007: raises 10440 to 11440 and is all-in
mariafirmina: folds 
Negrata: calls 4723 and is all-in
Uncalled bet (5717) returned to biscom2007
*** FLOP *** [Jd 6h 7c]
*** TURN *** [Jd 6h 7c] [Qc]
*** RIVER *** [Jd 6h 7c Qc] [4c]
*** SHOW DOWN ***
biscom2007: shows [Ah Jc] (a pair of Jacks)
Negrata: shows [Kh Kc] (a pair of Kings)
Negrata collected 13121 from pot
*** SUMMARY ***
Total pot 13121 | Rake 0 
Board [Jd 6h 7c Qc 4c]
Seat 1: vladlen101 folded before Flop (didn't bet)
Seat 2: jcarlos.vale (button) folded before Flop (didn't bet)
Seat 3: biscom2007 (small blind) showed [Ah Jc] and lost with a pair of Jacks
Seat 4: mariafirmina (big blind) folded before Flop
Seat 5: felipeando folded before Flop (didn't bet)
Seat 6: jordan202025 folded before Flop (didn't bet)
Seat 7: YaR1qq folded before Flop (didn't bet)
Seat 8: Negrata showed [Kh Kc] and won (13121) with a pair of Kings
Seat 9: Mitnick.K.D. folded before Flop (didn't bet)



PokerStars Hand #222154506603: Tournament #3086083919, $0.49+$0.06 USD Hold'em No Limit - Level XVII (500/1000) - 2021/01/03 0:05:11 EET [2021/01/02 17:05:11 ET]
Table '3086083919 96' 9-max Seat #3 is the button
Seat 1: vladlen101 (35947 in chips) is sitting out
Seat 2: jcarlos.vale (10592 in chips) 
Seat 3: biscom2007 (5717 in chips) 
Seat 4: mariafirmina (19945 in chips) 
Seat 5: felipeando (32574 in chips) 
Seat 6: jordan202025 (7525 in chips) 
Seat 7: YaR1qq (41040 in chips) is sitting out
Seat 8: Negrata (13121 in chips) 
Seat 9: Mitnick.K.D. (32255 in chips) 
vladlen101: posts the ante 75
jcarlos.vale: posts the ante 75
biscom2007: posts the ante 75
mariafirmina: posts the ante 75
felipeando: posts the ante 75
jordan202025: posts the ante 75
YaR1qq: posts the ante 75
Negrata: posts the ante 75
Mitnick.K.D.: posts the ante 75
mariafirmina: posts small blind 500
felipeando: posts big blind 1000
*** HOLE CARDS ***
Dealt to jcarlos.vale [7c Tc]
jordan202025: folds 
YaR1qq: folds 
Negrata: folds 
Mitnick.K.D.: folds 
vladlen101: folds 
jcarlos.vale: folds 
biscom2007: raises 4642 to 5642 and is all-in
mariafirmina: folds 
felipeando: folds 
Uncalled bet (4642) returned to biscom2007
biscom2007 collected 3175 from pot
biscom2007: doesn't show handDTO
*** SUMMARY ***
Total pot 3175 | Rake 0 
Seat 1: vladlen101 folded before Flop (didn't bet)
Seat 2: jcarlos.vale folded before Flop (didn't bet)
Seat 3: biscom2007 (button) collected (3175)
Seat 4: mariafirmina (small blind) folded before Flop
Seat 5: felipeando (big blind) folded before Flop
Seat 6: jordan202025 folded before Flop (didn't bet)
Seat 7: YaR1qq folded before Flop (didn't bet)
Seat 8: Negrata folded before Flop (didn't bet)
Seat 9: Mitnick.K.D. folded before Flop (didn't bet)



PokerStars Hand #222154529302: Tournament #3086083919, $0.49+$0.06 USD Hold'em No Limit - Level XVII (500/1000) - 2021/01/03 0:05:35 EET [2021/01/02 17:05:35 ET]
Table '3086083919 96' 9-max Seat #4 is the button
Seat 1: vladlen101 (35872 in chips) is sitting out
Seat 2: jcarlos.vale (10517 in chips) 
Seat 3: biscom2007 (7817 in chips) 
Seat 4: mariafirmina (19370 in chips) 
Seat 5: felipeando (31499 in chips) 
Seat 6: jordan202025 (7450 in chips) 
Seat 7: YaR1qq (40965 in chips) is sitting out
Seat 8: Negrata (13046 in chips) 
Seat 9: Mitnick.K.D. (32180 in chips) 
vladlen101: posts the ante 75
jcarlos.vale: posts the ante 75
biscom2007: posts the ante 75
mariafirmina: posts the ante 75
felipeando: posts the ante 75
jordan202025: posts the ante 75
YaR1qq: posts the ante 75
Negrata: posts the ante 75
Mitnick.K.D.: posts the ante 75
felipeando: posts small blind 500
jordan202025: posts big blind 1000
*** HOLE CARDS ***
Dealt to jcarlos.vale [Tc 3d]
YaR1qq: folds 
Negrata: folds 
Mitnick.K.D.: folds 
vladlen101: folds 
jcarlos.vale: folds 
biscom2007: raises 6742 to 7742 and is all-in
mariafirmina: folds 
felipeando: folds 
vladlen101 has returned
jordan202025: folds 
Uncalled bet (6742) returned to biscom2007
biscom2007 collected 3175 from pot
biscom2007: doesn't show handDTO
*** SUMMARY ***
Total pot 3175 | Rake 0 
Seat 1: vladlen101 folded before Flop (didn't bet)
Seat 2: jcarlos.vale folded before Flop (didn't bet)
Seat 3: biscom2007 collected (3175)
Seat 4: mariafirmina (button) folded before Flop (didn't bet)
Seat 5: felipeando (small blind) folded before Flop
Seat 6: jordan202025 (big blind) folded before Flop
Seat 7: YaR1qq folded before Flop (didn't bet)
Seat 8: Negrata folded before Flop (didn't bet)
Seat 9: Mitnick.K.D. folded before Flop (didn't bet)



PokerStars Hand #222154554111: Tournament #3086083919, $0.49+$0.06 USD Hold'em No Limit - Level XVII (500/1000) - 2021/01/03 0:06:00 EET [2021/01/02 17:06:00 ET]
Table '3086083919 96' 9-max Seat #5 is the button
Seat 1: vladlen101 (35797 in chips) 
Seat 2: jcarlos.vale (10442 in chips) 
Seat 3: biscom2007 (9917 in chips) 
Seat 4: mariafirmina (19295 in chips) 
Seat 5: felipeando (30924 in chips) 
Seat 6: jordan202025 (6375 in chips) 
Seat 7: YaR1qq (40890 in chips) is sitting out
Seat 8: Negrata (12971 in chips) 
Seat 9: Mitnick.K.D. (32105 in chips) 
vladlen101: posts the ante 75
jcarlos.vale: posts the ante 75
biscom2007: posts the ante 75
mariafirmina: posts the ante 75
felipeando: posts the ante 75
jordan202025: posts the ante 75
YaR1qq: posts the ante 75
Negrata: posts the ante 75
Mitnick.K.D.: posts the ante 75
jordan202025: posts small blind 500
YaR1qq: posts big blind 1000
*** HOLE CARDS ***
Dealt to jcarlos.vale [Kc 7c]
Negrata: folds 
Mitnick.K.D.: folds 
vladlen101: folds 
jcarlos.vale: folds 
biscom2007: folds 
mariafirmina: folds 
felipeando: folds 
jordan202025: raises 1000 to 2000
YaR1qq: folds 
Uncalled bet (1000) returned to jordan202025
jordan202025 collected 2675 from pot
*** SUMMARY ***
Total pot 2675 | Rake 0 
Seat 1: vladlen101 folded before Flop (didn't bet)
Seat 2: jcarlos.vale folded before Flop (didn't bet)
Seat 3: biscom2007 folded before Flop (didn't bet)
Seat 4: mariafirmina folded before Flop (didn't bet)
Seat 5: felipeando (button) folded before Flop (didn't bet)
Seat 6: jordan202025 (small blind) collected (2675)
Seat 7: YaR1qq (big blind) folded before Flop
Seat 8: Negrata folded before Flop (didn't bet)
Seat 9: Mitnick.K.D. folded before Flop (didn't bet)



PokerStars Hand #222154578818: Tournament #3086083919, $0.49+$0.06 USD Hold'em No Limit - Level XVII (500/1000) - 2021/01/03 0:06:26 EET [2021/01/02 17:06:26 ET]
Table '3086083919 96' 9-max Seat #6 is the button
Seat 1: vladlen101 (35722 in chips) 
Seat 2: jcarlos.vale (10367 in chips) 
Seat 3: biscom2007 (9842 in chips) 
Seat 4: mariafirmina (19220 in chips) 
Seat 5: felipeando (30849 in chips) 
Seat 6: jordan202025 (7975 in chips) 
Seat 7: YaR1qq (39815 in chips) is sitting out
Seat 8: Negrata (12896 in chips) 
Seat 9: Mitnick.K.D. (32030 in chips) 
vladlen101: posts the ante 75
jcarlos.vale: posts the ante 75
biscom2007: posts the ante 75
mariafirmina: posts the ante 75
felipeando: posts the ante 75
jordan202025: posts the ante 75
YaR1qq: posts the ante 75
Negrata: posts the ante 75
Mitnick.K.D.: posts the ante 75
YaR1qq: posts small blind 500
Negrata: posts big blind 1000
*** HOLE CARDS ***
Dealt to jcarlos.vale [8c Td]
Mitnick.K.D.: folds 
vladlen101: raises 1000 to 2000
jcarlos.vale: folds 
biscom2007: folds 
mariafirmina: calls 2000
felipeando: folds 
jordan202025: folds 
YaR1qq: folds 
Negrata: folds 
*** FLOP *** [6s Ts Ad]
vladlen101: bets 3088
mariafirmina: folds 
Uncalled bet (3088) returned to vladlen101
vladlen101 collected 6175 from pot
vladlen101: doesn't show handDTO
*** SUMMARY ***
Total pot 6175 | Rake 0 
Board [6s Ts Ad]
Seat 1: vladlen101 collected (6175)
Seat 2: jcarlos.vale folded before Flop (didn't bet)
Seat 3: biscom2007 folded before Flop (didn't bet)
Seat 4: mariafirmina folded on the Flop
Seat 5: felipeando folded before Flop (didn't bet)
Seat 6: jordan202025 (button) folded before Flop (didn't bet)
Seat 7: YaR1qq (small blind) folded before Flop
Seat 8: Negrata (big blind) folded before Flop
Seat 9: Mitnick.K.D. folded before Flop (didn't bet)



PokerStars Hand #222154638264: Tournament #3086083919, $0.49+$0.06 USD Hold'em No Limit - Level XVII (500/1000) - 2021/01/03 0:07:26 EET [2021/01/02 17:07:26 ET]
Table '3086083919 96' 9-max Seat #7 is the button
Seat 1: vladlen101 (39822 in chips) 
Seat 2: jcarlos.vale (10292 in chips) 
Seat 3: biscom2007 (9767 in chips) 
Seat 4: mariafirmina (17145 in chips) 
Seat 5: felipeando (30774 in chips) 
Seat 6: jordan202025 (7900 in chips) 
Seat 7: YaR1qq (39240 in chips) is sitting out
Seat 8: Negrata (11821 in chips) 
Seat 9: Mitnick.K.D. (31955 in chips) 
vladlen101: posts the ante 75
jcarlos.vale: posts the ante 75
biscom2007: posts the ante 75
mariafirmina: posts the ante 75
felipeando: posts the ante 75
jordan202025: posts the ante 75
YaR1qq: posts the ante 75
Negrata: posts the ante 75
Mitnick.K.D.: posts the ante 75
Negrata: posts small blind 500
Mitnick.K.D.: posts big blind 1000
*** HOLE CARDS ***
Dealt to jcarlos.vale [Ts 6c]
vladlen101: folds 
jcarlos.vale: folds 
biscom2007: calls 1000
mariafirmina: folds 
felipeando: folds 
jordan202025: folds 
YaR1qq: folds 
Negrata: folds 
Mitnick.K.D.: checks 
*** FLOP *** [Js 2c Kh]
Mitnick.K.D.: checks 
biscom2007: checks 
*** TURN *** [Js 2c Kh] [Tc]
Mitnick.K.D.: checks 
biscom2007: bets 1000
Mitnick.K.D.: folds 
Uncalled bet (1000) returned to biscom2007
biscom2007 collected 3175 from pot
biscom2007: doesn't show handDTO
*** SUMMARY ***
Total pot 3175 | Rake 0 
Board [Js 2c Kh Tc]
Seat 1: vladlen101 folded before Flop (didn't bet)
Seat 2: jcarlos.vale folded before Flop (didn't bet)
Seat 3: biscom2007 collected (3175)
Seat 4: mariafirmina folded before Flop (didn't bet)
Seat 5: felipeando folded before Flop (didn't bet)
Seat 6: jordan202025 folded before Flop (didn't bet)
Seat 7: YaR1qq (button) folded before Flop (didn't bet)
Seat 8: Negrata (small blind) folded before Flop
Seat 9: Mitnick.K.D. (big blind) folded on the Turn



PokerStars Hand #222154678816: Tournament #3086083919, $0.49+$0.06 USD Hold'em No Limit - Level XVII (500/1000) - 2021/01/03 0:08:08 EET [2021/01/02 17:08:08 ET]
Table '3086083919 96' 9-max Seat #8 is the button
Seat 1: vladlen101 (39747 in chips) 
Seat 2: jcarlos.vale (10217 in chips) 
Seat 3: biscom2007 (11867 in chips) 
Seat 4: mariafirmina (17070 in chips) 
Seat 5: felipeando (30699 in chips) 
Seat 6: jordan202025 (7825 in chips) 
Seat 7: YaR1qq (39165 in chips) is sitting out
Seat 8: Negrata (11246 in chips) 
Seat 9: Mitnick.K.D. (30880 in chips) 
vladlen101: posts the ante 75
jcarlos.vale: posts the ante 75
biscom2007: posts the ante 75
mariafirmina: posts the ante 75
felipeando: posts the ante 75
jordan202025: posts the ante 75
YaR1qq: posts the ante 75
Negrata: posts the ante 75
Mitnick.K.D.: posts the ante 75
Mitnick.K.D.: posts small blind 500
vladlen101: posts big blind 1000
*** HOLE CARDS ***
Dealt to jcarlos.vale [8c Qs]
jcarlos.vale: folds 
biscom2007: raises 1000 to 2000
mariafirmina: folds 
felipeando: folds 
jordan202025: folds 
YaR1qq: folds 
Negrata: folds 
Mitnick.K.D.: folds 
vladlen101: folds 
Uncalled bet (1000) returned to biscom2007
biscom2007 collected 3175 from pot
biscom2007: doesn't show handDTO
*** SUMMARY ***
Total pot 3175 | Rake 0 
Seat 1: vladlen101 (big blind) folded before Flop
Seat 2: jcarlos.vale folded before Flop (didn't bet)
Seat 3: biscom2007 collected (3175)
Seat 4: mariafirmina folded before Flop (didn't bet)
Seat 5: felipeando folded before Flop (didn't bet)
Seat 6: jordan202025 folded before Flop (didn't bet)
Seat 7: YaR1qq folded before Flop (didn't bet)
Seat 8: Negrata (button) folded before Flop (didn't bet)
Seat 9: Mitnick.K.D. (small blind) folded before Flop



PokerStars Hand #222154719180: Tournament #3086083919, $0.49+$0.06 USD Hold'em No Limit - Level XVII (500/1000) - 2021/01/03 0:08:49 EET [2021/01/02 17:08:49 ET]
Table '3086083919 96' 9-max Seat #9 is the button
Seat 1: vladlen101 (38672 in chips) 
Seat 2: jcarlos.vale (10142 in chips) 
Seat 3: biscom2007 (13967 in chips) 
Seat 4: mariafirmina (16995 in chips) 
Seat 5: felipeando (30624 in chips) 
Seat 6: jordan202025 (7750 in chips) 
Seat 7: YaR1qq (39090 in chips) is sitting out
Seat 8: Negrata (11171 in chips) 
Seat 9: Mitnick.K.D. (30305 in chips) 
vladlen101: posts the ante 75
jcarlos.vale: posts the ante 75
biscom2007: posts the ante 75
mariafirmina: posts the ante 75
felipeando: posts the ante 75
jordan202025: posts the ante 75
YaR1qq: posts the ante 75
Negrata: posts the ante 75
Mitnick.K.D.: posts the ante 75
vladlen101: posts small blind 500
jcarlos.vale: posts big blind 1000
*** HOLE CARDS ***
Dealt to jcarlos.vale [Qs 9s]
biscom2007: folds 
mariafirmina: folds 
felipeando: folds 
jordan202025 has timed out
jordan202025: folds 
jordan202025 is sitting out
YaR1qq: folds 
jordan202025 has returned
Negrata: folds 
Mitnick.K.D.: folds 
vladlen101: folds 
Uncalled bet (500) returned to jcarlos.vale
jcarlos.vale collected 1675 from pot
jcarlos.vale: doesn't show handDTO
*** SUMMARY ***
Total pot 1675 | Rake 0 
Seat 1: vladlen101 (small blind) folded before Flop
Seat 2: jcarlos.vale (big blind) collected (1675)
Seat 3: biscom2007 folded before Flop (didn't bet)
Seat 4: mariafirmina folded before Flop (didn't bet)
Seat 5: felipeando folded before Flop (didn't bet)
Seat 6: jordan202025 folded before Flop (didn't bet)
Seat 7: YaR1qq folded before Flop (didn't bet)
Seat 8: Negrata folded before Flop (didn't bet)
Seat 9: Mitnick.K.D. (button) folded before Flop (didn't bet)



PokerStars Hand #222154755177: Tournament #3086083919, $0.49+$0.06 USD Hold'em No Limit - Level XVII (500/1000) - 2021/01/03 0:09:26 EET [2021/01/02 17:09:26 ET]
Table '3086083919 96' 9-max Seat #1 is the button
Seat 1: vladlen101 (38097 in chips) 
Seat 2: jcarlos.vale (11242 in chips) 
Seat 3: biscom2007 (13892 in chips) 
Seat 4: mariafirmina (16920 in chips) 
Seat 5: felipeando (30549 in chips) 
Seat 6: jordan202025 (7675 in chips) 
Seat 7: YaR1qq (39015 in chips) is sitting out
Seat 8: Negrata (11096 in chips) 
Seat 9: Mitnick.K.D. (30230 in chips) 
vladlen101: posts the ante 75
jcarlos.vale: posts the ante 75
biscom2007: posts the ante 75
mariafirmina: posts the ante 75
felipeando: posts the ante 75
jordan202025: posts the ante 75
YaR1qq: posts the ante 75
Negrata: posts the ante 75
Mitnick.K.D.: posts the ante 75
jcarlos.vale: posts small blind 500
biscom2007: posts big blind 1000
*** HOLE CARDS ***
Dealt to jcarlos.vale [3d Jh]
mariafirmina: raises 1000 to 2000
felipeando: folds 
jordan202025: folds 
YaR1qq: folds 
Negrata: folds 
Mitnick.K.D.: folds 
vladlen101: folds 
jcarlos.vale: folds 
biscom2007: folds 
Uncalled bet (1000) returned to mariafirmina
mariafirmina collected 3175 from pot
*** SUMMARY ***
Total pot 3175 | Rake 0 
Seat 1: vladlen101 (button) folded before Flop (didn't bet)
Seat 2: jcarlos.vale (small blind) folded before Flop
Seat 3: biscom2007 (big blind) folded before Flop
Seat 4: mariafirmina collected (3175)
Seat 5: felipeando folded before Flop (didn't bet)
Seat 6: jordan202025 folded before Flop (didn't bet)
Seat 7: YaR1qq folded before Flop (didn't bet)
Seat 8: Negrata folded before Flop (didn't bet)
Seat 9: Mitnick.K.D. folded before Flop (didn't bet)



PokerStars Hand #222154782202: Tournament #3086083919, $0.49+$0.06 USD Hold'em No Limit - Level XVII (500/1000) - 2021/01/03 0:09:54 EET [2021/01/02 17:09:54 ET]
Table '3086083919 96' 9-max Seat #2 is the button
Seat 1: vladlen101 (38022 in chips) 
Seat 2: jcarlos.vale (10667 in chips) 
Seat 3: biscom2007 (12817 in chips) 
Seat 4: mariafirmina (19020 in chips) 
Seat 5: felipeando (30474 in chips) 
Seat 6: jordan202025 (7600 in chips) 
Seat 7: YaR1qq (38940 in chips) is sitting out
Seat 8: Negrata (11021 in chips) 
Seat 9: Mitnick.K.D. (30155 in chips) 
vladlen101: posts the ante 75
jcarlos.vale: posts the ante 75
biscom2007: posts the ante 75
mariafirmina: posts the ante 75
felipeando: posts the ante 75
jordan202025: posts the ante 75
YaR1qq: posts the ante 75
Negrata: posts the ante 75
Mitnick.K.D.: posts the ante 75
biscom2007: posts small blind 500
mariafirmina: posts big blind 1000
*** HOLE CARDS ***
Dealt to jcarlos.vale [5d 9d]
felipeando: folds 
jordan202025: folds 
YaR1qq: folds 
Negrata: folds 
Mitnick.K.D.: folds 
vladlen101: raises 3175 to 4175
jcarlos.vale: folds 
biscom2007: folds 
mariafirmina: folds 
Uncalled bet (3175) returned to vladlen101
vladlen101 collected 3175 from pot
vladlen101: doesn't show handDTO
*** SUMMARY ***
Total pot 3175 | Rake 0 
Seat 1: vladlen101 collected (3175)
Seat 2: jcarlos.vale (button) folded before Flop (didn't bet)
Seat 3: biscom2007 (small blind) folded before Flop
Seat 4: mariafirmina (big blind) folded before Flop
Seat 5: felipeando folded before Flop (didn't bet)
Seat 6: jordan202025 folded before Flop (didn't bet)
Seat 7: YaR1qq folded before Flop (didn't bet)
Seat 8: Negrata folded before Flop (didn't bet)
Seat 9: Mitnick.K.D. folded before Flop (didn't bet)



PokerStars Hand #222154817531: Tournament #3086083919, $0.49+$0.06 USD Hold'em No Limit - Level XVII (500/1000) - 2021/01/03 0:10:30 EET [2021/01/02 17:10:30 ET]
Table '3086083919 96' 9-max Seat #3 is the button
Seat 1: vladlen101 (40122 in chips) 
Seat 2: jcarlos.vale (10592 in chips) 
Seat 3: biscom2007 (12242 in chips) 
Seat 4: mariafirmina (17945 in chips) 
Seat 5: felipeando (30399 in chips) 
Seat 6: jordan202025 (7525 in chips) 
Seat 7: YaR1qq (38865 in chips) is sitting out
Seat 8: Negrata (10946 in chips) 
Seat 9: Mitnick.K.D. (30080 in chips) 
vladlen101: posts the ante 75
jcarlos.vale: posts the ante 75
biscom2007: posts the ante 75
mariafirmina: posts the ante 75
felipeando: posts the ante 75
jordan202025: posts the ante 75
YaR1qq: posts the ante 75
Negrata: posts the ante 75
Mitnick.K.D.: posts the ante 75
mariafirmina: posts small blind 500
felipeando: posts big blind 1000
*** HOLE CARDS ***
Dealt to jcarlos.vale [Qc 5d]
jordan202025: folds 
YaR1qq: folds 
Negrata: folds 
Mitnick.K.D.: folds 
vladlen101: calls 1000
jcarlos.vale: folds 
biscom2007: raises 1000 to 2000
mariafirmina: folds 
felipeando: folds 
vladlen101: calls 1000
*** FLOP *** [Kd 9c Qs]
vladlen101: checks 
biscom2007: checks 
*** TURN *** [Kd 9c Qs] [5h]
vladlen101: checks 
biscom2007: bets 1000
vladlen101: calls 1000
*** RIVER *** [Kd 9c Qs 5h] [2c]
vladlen101: checks 
biscom2007: bets 1000
vladlen101: folds 
Uncalled bet (1000) returned to biscom2007
biscom2007 collected 8175 from pot
biscom2007: doesn't show handDTO
*** SUMMARY ***
Total pot 8175 | Rake 0 
Board [Kd 9c Qs 5h 2c]
Seat 1: vladlen101 folded on the River
Seat 2: jcarlos.vale folded before Flop (didn't bet)
Seat 3: biscom2007 (button) collected (8175)
Seat 4: mariafirmina (small blind) folded before Flop
Seat 5: felipeando (big blind) folded before Flop
Seat 6: jordan202025 folded before Flop (didn't bet)
Seat 7: YaR1qq folded before Flop (didn't bet)
Seat 8: Negrata folded before Flop (didn't bet)
Seat 9: Mitnick.K.D. folded before Flop (didn't bet)



PokerStars Hand #222154874883: Tournament #3086083919, $0.49+$0.06 USD Hold'em No Limit - Level XVIII (600/1200) - 2021/01/03 0:11:29 EET [2021/01/02 17:11:29 ET]
Table '3086083919 96' 9-max Seat #4 is the button
Seat 1: vladlen101 (37047 in chips) 
Seat 2: jcarlos.vale (10517 in chips) 
Seat 3: biscom2007 (17342 in chips) 
Seat 4: mariafirmina (17370 in chips) 
Seat 5: felipeando (29324 in chips) 
Seat 6: jordan202025 (7450 in chips) 
Seat 7: YaR1qq (38790 in chips) is sitting out
Seat 8: Negrata (10871 in chips) 
Seat 9: Mitnick.K.D. (30005 in chips) 
vladlen101: posts the ante 90
jcarlos.vale: posts the ante 90
biscom2007: posts the ante 90
mariafirmina: posts the ante 90
felipeando: posts the ante 90
jordan202025: posts the ante 90
YaR1qq: posts the ante 90
Negrata: posts the ante 90
Mitnick.K.D.: posts the ante 90
felipeando: posts small blind 600
jordan202025: posts big blind 1200
*** HOLE CARDS ***
Dealt to jcarlos.vale [7h Td]
YaR1qq: folds 
Negrata: folds 
Mitnick.K.D.: folds 
vladlen101: folds 
jcarlos.vale: folds 
biscom2007: folds 
mariafirmina: raises 1200 to 2400
felipeando: folds 
jordan202025 has timed out
jordan202025: folds 
jordan202025 is sitting out
Uncalled bet (1200) returned to mariafirmina
mariafirmina collected 3810 from pot
jordan202025 has returned
*** SUMMARY ***
Total pot 3810 | Rake 0 
Seat 1: vladlen101 folded before Flop (didn't bet)
Seat 2: jcarlos.vale folded before Flop (didn't bet)
Seat 3: biscom2007 folded before Flop (didn't bet)
Seat 4: mariafirmina (button) collected (3810)
Seat 5: felipeando (small blind) folded before Flop
Seat 6: jordan202025 (big blind) folded before Flop
Seat 7: YaR1qq folded before Flop (didn't bet)
Seat 8: Negrata folded before Flop (didn't bet)
Seat 9: Mitnick.K.D. folded before Flop (didn't bet)



PokerStars Hand #222154920947: Tournament #3086083919, $0.49+$0.06 USD Hold'em No Limit - Level XVIII (600/1200) - 2021/01/03 0:12:16 EET [2021/01/02 17:12:16 ET]
Table '3086083919 96' 9-max Seat #5 is the button
Seat 1: vladlen101 (36957 in chips) 
Seat 2: jcarlos.vale (10427 in chips) 
Seat 3: biscom2007 (17252 in chips) 
Seat 4: mariafirmina (19890 in chips) 
Seat 5: felipeando (28634 in chips) 
Seat 6: jordan202025 (6160 in chips) 
Seat 7: YaR1qq (38700 in chips) is sitting out
Seat 8: Negrata (10781 in chips) 
Seat 9: Mitnick.K.D. (29915 in chips) 
vladlen101: posts the ante 90
jcarlos.vale: posts the ante 90
biscom2007: posts the ante 90
mariafirmina: posts the ante 90
felipeando: posts the ante 90
jordan202025: posts the ante 90
YaR1qq: posts the ante 90
Negrata: posts the ante 90
Mitnick.K.D.: posts the ante 90
jordan202025: posts small blind 600
YaR1qq: posts big blind 1200
*** HOLE CARDS ***
Dealt to jcarlos.vale [Jh Qs]
Negrata: folds 
Mitnick.K.D.: folds 
vladlen101: folds 
jcarlos.vale: raises 9137 to 10337 and is all-in
biscom2007: folds 
mariafirmina: folds 
felipeando: folds 
jordan202025: folds 
YaR1qq: folds 
Uncalled bet (9137) returned to jcarlos.vale
jcarlos.vale collected 3810 from pot
jcarlos.vale: doesn't show handDTO
*** SUMMARY ***
Total pot 3810 | Rake 0 
Seat 1: vladlen101 folded before Flop (didn't bet)
Seat 2: jcarlos.vale collected (3810)
Seat 3: biscom2007 folded before Flop (didn't bet)
Seat 4: mariafirmina folded before Flop (didn't bet)
Seat 5: felipeando (button) folded before Flop (didn't bet)
Seat 6: jordan202025 (small blind) folded before Flop
Seat 7: YaR1qq (big blind) folded before Flop
Seat 8: Negrata folded before Flop (didn't bet)
Seat 9: Mitnick.K.D. folded before Flop (didn't bet)



PokerStars Hand #222154941551: Tournament #3086083919, $0.49+$0.06 USD Hold'em No Limit - Level XVIII (600/1200) - 2021/01/03 0:12:37 EET [2021/01/02 17:12:37 ET]
Table '3086083919 96' 9-max Seat #6 is the button
Seat 1: vladlen101 (36867 in chips) 
Seat 2: jcarlos.vale (12947 in chips) 
Seat 3: biscom2007 (17162 in chips) 
Seat 4: mariafirmina (19800 in chips) 
Seat 5: felipeando (28544 in chips) 
Seat 6: jordan202025 (5470 in chips) 
Seat 7: YaR1qq (37410 in chips) is sitting out
Seat 8: Negrata (10691 in chips) 
Seat 9: Mitnick.K.D. (29825 in chips) 
vladlen101: posts the ante 90
jcarlos.vale: posts the ante 90
biscom2007: posts the ante 90
mariafirmina: posts the ante 90
felipeando: posts the ante 90
jordan202025: posts the ante 90
YaR1qq: posts the ante 90
Negrata: posts the ante 90
Mitnick.K.D.: posts the ante 90
YaR1qq: posts small blind 600
Negrata: posts big blind 1200
*** HOLE CARDS ***
Dealt to jcarlos.vale [7d 5c]
Mitnick.K.D.: folds 
vladlen101: folds 
jcarlos.vale: folds 
biscom2007: folds 
mariafirmina: folds 
felipeando: folds 
YaR1qq has returned
jordan202025: folds 
YaR1qq: folds 
Uncalled bet (600) returned to Negrata
Negrata collected 2010 from pot
Negrata: doesn't show handDTO
*** SUMMARY ***
Total pot 2010 | Rake 0 
Seat 1: vladlen101 folded before Flop (didn't bet)
Seat 2: jcarlos.vale folded before Flop (didn't bet)
Seat 3: biscom2007 folded before Flop (didn't bet)
Seat 4: mariafirmina folded before Flop (didn't bet)
Seat 5: felipeando folded before Flop (didn't bet)
Seat 6: jordan202025 (button) folded before Flop (didn't bet)
Seat 7: YaR1qq (small blind) folded before Flop
Seat 8: Negrata (big blind) collected (2010)
Seat 9: Mitnick.K.D. folded before Flop (didn't bet)



PokerStars Hand #222154970792: Tournament #3086083919, $0.49+$0.06 USD Hold'em No Limit - Level XVIII (600/1200) - 2021/01/03 0:13:07 EET [2021/01/02 17:13:07 ET]
Table '3086083919 96' 9-max Seat #7 is the button
Seat 1: vladlen101 (36777 in chips) 
Seat 2: jcarlos.vale (12857 in chips) 
Seat 3: biscom2007 (17072 in chips) 
Seat 4: mariafirmina (19710 in chips) 
Seat 5: felipeando (28454 in chips) 
Seat 6: jordan202025 (5380 in chips) 
Seat 7: YaR1qq (36720 in chips) 
Seat 8: Negrata (12011 in chips) 
Seat 9: Mitnick.K.D. (29735 in chips) 
vladlen101: posts the ante 90
jcarlos.vale: posts the ante 90
biscom2007: posts the ante 90
mariafirmina: posts the ante 90
felipeando: posts the ante 90
jordan202025: posts the ante 90
YaR1qq: posts the ante 90
Negrata: posts the ante 90
Mitnick.K.D.: posts the ante 90
Negrata: posts small blind 600
Mitnick.K.D.: posts big blind 1200
*** HOLE CARDS ***
Dealt to jcarlos.vale [Ts Ah]
vladlen101: folds 
jcarlos.vale has timed out
jcarlos.vale: folds 
jcarlos.vale is sitting out
biscom2007: folds 
mariafirmina: folds 
felipeando: folds 
jcarlos.vale has returned
jordan202025: folds 
YaR1qq: folds 
Negrata: folds 
Uncalled bet (600) returned to Mitnick.K.D.
Mitnick.K.D. collected 2010 from pot
Mitnick.K.D.: doesn't show handDTO
*** SUMMARY ***
Total pot 2010 | Rake 0 
Seat 1: vladlen101 folded before Flop (didn't bet)
Seat 2: jcarlos.vale folded before Flop (didn't bet)
Seat 3: biscom2007 folded before Flop (didn't bet)
Seat 4: mariafirmina folded before Flop (didn't bet)
Seat 5: felipeando folded before Flop (didn't bet)
Seat 6: jordan202025 folded before Flop (didn't bet)
Seat 7: YaR1qq (button) folded before Flop (didn't bet)
Seat 8: Negrata (small blind) folded before Flop
Seat 9: Mitnick.K.D. (big blind) collected (2010)



PokerStars Hand #222155001768: Tournament #3086083919, $0.49+$0.06 USD Hold'em No Limit - Level XVIII (600/1200) - 2021/01/03 0:13:39 EET [2021/01/02 17:13:39 ET]
Table '3086083919 96' 9-max Seat #8 is the button
Seat 1: vladlen101 (36687 in chips) 
Seat 2: jcarlos.vale (12767 in chips) 
Seat 3: biscom2007 (16982 in chips) 
Seat 4: mariafirmina (19620 in chips) 
Seat 5: felipeando (28364 in chips) 
Seat 6: jordan202025 (5290 in chips) 
Seat 7: YaR1qq (36630 in chips) 
Seat 8: Negrata (11321 in chips) 
Seat 9: Mitnick.K.D. (31055 in chips) 
vladlen101: posts the ante 90
jcarlos.vale: posts the ante 90
biscom2007: posts the ante 90
mariafirmina: posts the ante 90
felipeando: posts the ante 90
jordan202025: posts the ante 90
YaR1qq: posts the ante 90
Negrata: posts the ante 90
Mitnick.K.D.: posts the ante 90
Mitnick.K.D.: posts small blind 600
vladlen101: posts big blind 1200
*** HOLE CARDS ***
Dealt to jcarlos.vale [Qh 3s]
jcarlos.vale: folds 
biscom2007: folds 
mariafirmina: folds 
felipeando: folds 
jordan202025 has timed out
jordan202025: folds 
jordan202025 is sitting out
YaR1qq: folds 
jordan202025 has returned
Negrata: folds 
Mitnick.K.D.: raises 3600 to 4800
vladlen101: folds 
Uncalled bet (3600) returned to Mitnick.K.D.
Mitnick.K.D. collected 3210 from pot
Mitnick.K.D.: doesn't show handDTO
*** SUMMARY ***
Total pot 3210 | Rake 0 
Seat 1: vladlen101 (big blind) folded before Flop
Seat 2: jcarlos.vale folded before Flop (didn't bet)
Seat 3: biscom2007 folded before Flop (didn't bet)
Seat 4: mariafirmina folded before Flop (didn't bet)
Seat 5: felipeando folded before Flop (didn't bet)
Seat 6: jordan202025 folded before Flop (didn't bet)
Seat 7: YaR1qq folded before Flop (didn't bet)
Seat 8: Negrata (button) folded before Flop (didn't bet)
Seat 9: Mitnick.K.D. (small blind) collected (3210)



PokerStars Hand #222155039927: Tournament #3086083919, $0.49+$0.06 USD Hold'em No Limit - Level XVIII (600/1200) - 2021/01/03 0:14:18 EET [2021/01/02 17:14:18 ET]
Table '3086083919 96' 9-max Seat #9 is the button
Seat 1: vladlen101 (35397 in chips) 
Seat 2: jcarlos.vale (12677 in chips) 
Seat 3: biscom2007 (16892 in chips) 
Seat 4: mariafirmina (19530 in chips) 
Seat 5: felipeando (28274 in chips) 
Seat 6: jordan202025 (5200 in chips) 
Seat 7: YaR1qq (36540 in chips) 
Seat 8: Negrata (11231 in chips) 
Seat 9: Mitnick.K.D. (32975 in chips) 
vladlen101: posts the ante 90
jcarlos.vale: posts the ante 90
biscom2007: posts the ante 90
mariafirmina: posts the ante 90
felipeando: posts the ante 90
jordan202025: posts the ante 90
YaR1qq: posts the ante 90
Negrata: posts the ante 90
Mitnick.K.D.: posts the ante 90
vladlen101: posts small blind 600
jcarlos.vale: posts big blind 1200
*** HOLE CARDS ***
Dealt to jcarlos.vale [9s Tc]
biscom2007: folds 
mariafirmina: folds 
felipeando: raises 1200 to 2400
jordan202025: folds 
YaR1qq: folds 
Negrata: folds 
Mitnick.K.D.: folds 
vladlen101: folds 
jcarlos.vale: folds 
Uncalled bet (1200) returned to felipeando
felipeando collected 3810 from pot
felipeando: doesn't show handDTO
*** SUMMARY ***
Total pot 3810 | Rake 0 
Seat 1: vladlen101 (small blind) folded before Flop
Seat 2: jcarlos.vale (big blind) folded before Flop
Seat 3: biscom2007 folded before Flop (didn't bet)
Seat 4: mariafirmina folded before Flop (didn't bet)
Seat 5: felipeando collected (3810)
Seat 6: jordan202025 folded before Flop (didn't bet)
Seat 7: YaR1qq folded before Flop (didn't bet)
Seat 8: Negrata folded before Flop (didn't bet)
Seat 9: Mitnick.K.D. (button) folded before Flop (didn't bet)



PokerStars Hand #222155076093: Tournament #3086083919, $0.49+$0.06 USD Hold'em No Limit - Level XVIII (600/1200) - 2021/01/03 0:14:56 EET [2021/01/02 17:14:56 ET]
Table '3086083919 96' 9-max Seat #1 is the button
Seat 1: vladlen101 (34707 in chips) 
Seat 2: jcarlos.vale (11387 in chips) 
Seat 3: biscom2007 (16802 in chips) 
Seat 4: mariafirmina (19440 in chips) 
Seat 5: felipeando (30794 in chips) 
Seat 6: jordan202025 (5110 in chips) 
Seat 7: YaR1qq (36450 in chips) 
Seat 8: Negrata (11141 in chips) 
Seat 9: Mitnick.K.D. (32885 in chips) 
vladlen101: posts the ante 90
jcarlos.vale: posts the ante 90
biscom2007: posts the ante 90
mariafirmina: posts the ante 90
felipeando: posts the ante 90
jordan202025: posts the ante 90
YaR1qq: posts the ante 90
Negrata: posts the ante 90
Mitnick.K.D.: posts the ante 90
jcarlos.vale: posts small blind 600
biscom2007: posts big blind 1200
*** HOLE CARDS ***
Dealt to jcarlos.vale [8c 4d]
mariafirmina: folds 
felipeando: folds 
jordan202025: raises 3820 to 5020 and is all-in
YaR1qq: folds 
Negrata: folds 
Mitnick.K.D.: folds 
vladlen101: folds 
jcarlos.vale: folds 
biscom2007: folds 
Uncalled bet (3820) returned to jordan202025
jordan202025 collected 3810 from pot
*** SUMMARY ***
Total pot 3810 | Rake 0 
Seat 1: vladlen101 (button) folded before Flop (didn't bet)
Seat 2: jcarlos.vale (small blind) folded before Flop
Seat 3: biscom2007 (big blind) folded before Flop
Seat 4: mariafirmina folded before Flop (didn't bet)
Seat 5: felipeando folded before Flop (didn't bet)
Seat 6: jordan202025 collected (3810)
Seat 7: YaR1qq folded before Flop (didn't bet)
Seat 8: Negrata folded before Flop (didn't bet)
Seat 9: Mitnick.K.D. folded before Flop (didn't bet)



PokerStars Hand #222155104974: Tournament #3086083919, $0.49+$0.06 USD Hold'em No Limit - Level XVIII (600/1200) - 2021/01/03 0:15:25 EET [2021/01/02 17:15:25 ET]
Table '3086083919 96' 9-max Seat #2 is the button
Seat 1: vladlen101 (34617 in chips) 
Seat 2: jcarlos.vale (10697 in chips) 
Seat 3: biscom2007 (15512 in chips) 
Seat 4: mariafirmina (19350 in chips) 
Seat 5: felipeando (30704 in chips) 
Seat 6: jordan202025 (7630 in chips) 
Seat 7: YaR1qq (36360 in chips) 
Seat 8: Negrata (11051 in chips) 
Seat 9: Mitnick.K.D. (32795 in chips) 
vladlen101: posts the ante 90
jcarlos.vale: posts the ante 90
biscom2007: posts the ante 90
mariafirmina: posts the ante 90
felipeando: posts the ante 90
jordan202025: posts the ante 90
YaR1qq: posts the ante 90
Negrata: posts the ante 90
Mitnick.K.D.: posts the ante 90
biscom2007: posts small blind 600
mariafirmina: posts big blind 1200
*** HOLE CARDS ***
Dealt to jcarlos.vale [Ad As]
felipeando: folds 
jordan202025: folds 
YaR1qq: folds 
Negrata: folds 
Mitnick.K.D.: folds 
vladlen101: folds 
jcarlos.vale: raises 1920 to 3120
biscom2007: folds 
mariafirmina: calls 1920
*** FLOP *** [5c Js 9s]
mariafirmina: checks 
jcarlos.vale: bets 5738
mariafirmina: folds 
Uncalled bet (5738) returned to jcarlos.vale
jcarlos.vale collected 7650 from pot
jcarlos.vale: doesn't show handDTO
*** SUMMARY ***
Total pot 7650 | Rake 0 
Board [5c Js 9s]
Seat 1: vladlen101 folded before Flop (didn't bet)
Seat 2: jcarlos.vale (button) collected (7650)
Seat 3: biscom2007 (small blind) folded before Flop
Seat 4: mariafirmina (big blind) folded on the Flop
Seat 5: felipeando folded before Flop (didn't bet)
Seat 6: jordan202025 folded before Flop (didn't bet)
Seat 7: YaR1qq folded before Flop (didn't bet)
Seat 8: Negrata folded before Flop (didn't bet)
Seat 9: Mitnick.K.D. folded before Flop (didn't bet)



PokerStars Hand #222155149795: Tournament #3086083919, $0.49+$0.06 USD Hold'em No Limit - Level XVIII (600/1200) - 2021/01/03 0:16:11 EET [2021/01/02 17:16:11 ET]
Table '3086083919 96' 9-max Seat #3 is the button
Seat 1: vladlen101 (34527 in chips) 
Seat 2: jcarlos.vale (15137 in chips) 
Seat 3: biscom2007 (14822 in chips) 
Seat 4: mariafirmina (16140 in chips) 
Seat 5: felipeando (30614 in chips) 
Seat 6: jordan202025 (7540 in chips) 
Seat 7: YaR1qq (36270 in chips) 
Seat 8: Negrata (10961 in chips) 
Seat 9: Mitnick.K.D. (32705 in chips) 
vladlen101: posts the ante 90
jcarlos.vale: posts the ante 90
biscom2007: posts the ante 90
mariafirmina: posts the ante 90
felipeando: posts the ante 90
jordan202025: posts the ante 90
YaR1qq: posts the ante 90
Negrata: posts the ante 90
Mitnick.K.D.: posts the ante 90
mariafirmina: posts small blind 600
felipeando: posts big blind 1200
*** HOLE CARDS ***
Dealt to jcarlos.vale [Td 4h]
jordan202025 has timed out
jordan202025: folds 
jordan202025 is sitting out
YaR1qq: folds 
jordan202025 has returned
Negrata: folds 
Mitnick.K.D.: folds 
vladlen101: folds 
jcarlos.vale: folds 
biscom2007: folds 
mariafirmina: folds 
Uncalled bet (600) returned to felipeando
felipeando collected 2010 from pot
felipeando: doesn't show handDTO
*** SUMMARY ***
Total pot 2010 | Rake 0 
Seat 1: vladlen101 folded before Flop (didn't bet)
Seat 2: jcarlos.vale folded before Flop (didn't bet)
Seat 3: biscom2007 (button) folded before Flop (didn't bet)
Seat 4: mariafirmina (small blind) folded before Flop
Seat 5: felipeando (big blind) collected (2010)
Seat 6: jordan202025 folded before Flop (didn't bet)
Seat 7: YaR1qq folded before Flop (didn't bet)
Seat 8: Negrata folded before Flop (didn't bet)
Seat 9: Mitnick.K.D. folded before Flop (didn't bet)



PokerStars Hand #222155174995: Tournament #3086083919, $0.49+$0.06 USD Hold'em No Limit - Level XVIII (600/1200) - 2021/01/03 0:16:36 EET [2021/01/02 17:16:36 ET]
Table '3086083919 96' 9-max Seat #4 is the button
Seat 1: vladlen101 (34437 in chips) 
Seat 2: jcarlos.vale (15047 in chips) 
Seat 3: biscom2007 (14732 in chips) 
Seat 4: mariafirmina (15450 in chips) 
Seat 5: felipeando (31934 in chips) 
Seat 6: jordan202025 (7450 in chips) 
Seat 7: YaR1qq (36180 in chips) 
Seat 8: Negrata (10871 in chips) 
Seat 9: Mitnick.K.D. (32615 in chips) 
vladlen101: posts the ante 90
jcarlos.vale: posts the ante 90
biscom2007: posts the ante 90
mariafirmina: posts the ante 90
felipeando: posts the ante 90
jordan202025: posts the ante 90
YaR1qq: posts the ante 90
Negrata: posts the ante 90
Mitnick.K.D.: posts the ante 90
felipeando: posts small blind 600
jordan202025: posts big blind 1200
*** HOLE CARDS ***
Dealt to jcarlos.vale [Qd 3c]
YaR1qq: folds 
Negrata: folds 
Mitnick.K.D.: folds 
vladlen101: folds 
jcarlos.vale: folds 
biscom2007: folds 
mariafirmina: raises 1200 to 2400
felipeando: folds 
jordan202025: folds 
Uncalled bet (1200) returned to mariafirmina
mariafirmina collected 3810 from pot
*** SUMMARY ***
Total pot 3810 | Rake 0 
Seat 1: vladlen101 folded before Flop (didn't bet)
Seat 2: jcarlos.vale folded before Flop (didn't bet)
Seat 3: biscom2007 folded before Flop (didn't bet)
Seat 4: mariafirmina (button) collected (3810)
Seat 5: felipeando (small blind) folded before Flop
Seat 6: jordan202025 (big blind) folded before Flop
Seat 7: YaR1qq folded before Flop (didn't bet)
Seat 8: Negrata folded before Flop (didn't bet)
Seat 9: Mitnick.K.D. folded before Flop (didn't bet)



PokerStars Hand #222155219007: Tournament #3086083919, $0.49+$0.06 USD Hold'em No Limit - Level XVIII (600/1200) - 2021/01/03 0:17:13 EET [2021/01/02 17:17:13 ET]
Table '3086083919 96' 9-max Seat #5 is the button
Seat 1: vladlen101 (34347 in chips) 
Seat 2: jcarlos.vale (14957 in chips) 
Seat 3: biscom2007 (14642 in chips) 
Seat 4: mariafirmina (17970 in chips) 
Seat 5: felipeando (31244 in chips) 
Seat 6: jordan202025 (6160 in chips) 
Seat 7: YaR1qq (36090 in chips) 
Seat 8: Negrata (10781 in chips) 
Seat 9: Mitnick.K.D. (32525 in chips) 
vladlen101: posts the ante 90
jcarlos.vale: posts the ante 90
biscom2007: posts the ante 90
mariafirmina: posts the ante 90
felipeando: posts the ante 90
jordan202025: posts the ante 90
YaR1qq: posts the ante 90
Negrata: posts the ante 90
Mitnick.K.D.: posts the ante 90
jordan202025: posts small blind 600
YaR1qq: posts big blind 1200
*** HOLE CARDS ***
Dealt to jcarlos.vale [Jd 2d]
Negrata: calls 1200
Mitnick.K.D.: folds 
vladlen101: calls 1200
jcarlos.vale: folds 
biscom2007: calls 1200
mariafirmina: folds 
felipeando: folds 
jordan202025: calls 600
YaR1qq: checks 
*** FLOP *** [Ks 5c 2h]
jordan202025: checks 
YaR1qq: checks 
Negrata: checks 
vladlen101: checks 
biscom2007: checks 
*** TURN *** [Ks 5c 2h] [4c]
jordan202025: bets 4870 and is all-in
YaR1qq: folds 
Negrata: folds 
vladlen101: folds 
biscom2007: folds 
Uncalled bet (4870) returned to jordan202025
jordan202025 collected 6810 from pot
*** SUMMARY ***
Total pot 6810 | Rake 0 
Board [Ks 5c 2h 4c]
Seat 1: vladlen101 folded on the Turn
Seat 2: jcarlos.vale folded before Flop (didn't bet)
Seat 3: biscom2007 folded on the Turn
Seat 4: mariafirmina folded before Flop (didn't bet)
Seat 5: felipeando (button) folded before Flop (didn't bet)
Seat 6: jordan202025 (small blind) collected (6810)
Seat 7: YaR1qq (big blind) folded on the Turn
Seat 8: Negrata folded on the Turn
Seat 9: Mitnick.K.D. folded before Flop (didn't bet)



PokerStars Hand #222155274359: Tournament #3086083919, $0.49+$0.06 USD Hold'em No Limit - Level XVIII (600/1200) - 2021/01/03 0:18:10 EET [2021/01/02 17:18:10 ET]
Table '3086083919 96' 9-max Seat #6 is the button
Seat 1: vladlen101 (33057 in chips) 
Seat 2: jcarlos.vale (14867 in chips) 
Seat 3: biscom2007 (13352 in chips) 
Seat 4: mariafirmina (17880 in chips) 
Seat 5: felipeando (31154 in chips) 
Seat 6: jordan202025 (11680 in chips) 
Seat 7: YaR1qq (34800 in chips) 
Seat 8: Negrata (9491 in chips) 
Seat 9: Mitnick.K.D. (32435 in chips) 
vladlen101: posts the ante 90
jcarlos.vale: posts the ante 90
biscom2007: posts the ante 90
mariafirmina: posts the ante 90
felipeando: posts the ante 90
jordan202025: posts the ante 90
YaR1qq: posts the ante 90
Negrata: posts the ante 90
Mitnick.K.D.: posts the ante 90
YaR1qq: posts small blind 600
Negrata: posts big blind 1200
*** HOLE CARDS ***
Dealt to jcarlos.vale [Ac Ah]
Mitnick.K.D.: folds 
vladlen101: folds 
jcarlos.vale: raises 1920 to 3120
biscom2007: folds 
mariafirmina: folds 
felipeando: folds 
jordan202025: folds 
YaR1qq: folds 
Negrata: folds 
Uncalled bet (1920) returned to jcarlos.vale
jcarlos.vale collected 3810 from pot
jcarlos.vale: doesn't show handDTO
*** SUMMARY ***
Total pot 3810 | Rake 0 
Seat 1: vladlen101 folded before Flop (didn't bet)
Seat 2: jcarlos.vale collected (3810)
Seat 3: biscom2007 folded before Flop (didn't bet)
Seat 4: mariafirmina folded before Flop (didn't bet)
Seat 5: felipeando folded before Flop (didn't bet)
Seat 6: jordan202025 (button) folded before Flop (didn't bet)
Seat 7: YaR1qq (small blind) folded before Flop
Seat 8: Negrata (big blind) folded before Flop
Seat 9: Mitnick.K.D. folded before Flop (didn't bet)



PokerStars Hand #222155307717: Tournament #3086083919, $0.49+$0.06 USD Hold'em No Limit - Level XVIII (600/1200) - 2021/01/03 0:18:44 EET [2021/01/02 17:18:44 ET]
Table '3086083919 96' 9-max Seat #7 is the button
Seat 1: vladlen101 (32967 in chips) 
Seat 2: jcarlos.vale (17387 in chips) 
Seat 3: biscom2007 (13262 in chips) 
Seat 4: mariafirmina (17790 in chips) 
Seat 5: felipeando (31064 in chips) 
Seat 6: jordan202025 (11590 in chips) 
Seat 7: YaR1qq (34110 in chips) 
Seat 8: Negrata (8201 in chips) 
Seat 9: Mitnick.K.D. (32345 in chips) 
vladlen101: posts the ante 90
jcarlos.vale: posts the ante 90
biscom2007: posts the ante 90
mariafirmina: posts the ante 90
felipeando: posts the ante 90
jordan202025: posts the ante 90
YaR1qq: posts the ante 90
Negrata: posts the ante 90
Mitnick.K.D.: posts the ante 90
Negrata: posts small blind 600
Mitnick.K.D.: posts big blind 1200
*** HOLE CARDS ***
Dealt to jcarlos.vale [Qc 7c]
vladlen101: folds 
jcarlos.vale: folds 
biscom2007: folds 
mariafirmina: folds 
felipeando: raises 1200 to 2400
jordan202025: folds 
YaR1qq: folds 
Negrata: folds 
Mitnick.K.D.: raises 29855 to 32255 and is all-in
felipeando: folds 
Uncalled bet (29855) returned to Mitnick.K.D.
Mitnick.K.D. collected 6210 from pot
Mitnick.K.D.: doesn't show handDTO
*** SUMMARY ***
Total pot 6210 | Rake 0 
Seat 1: vladlen101 folded before Flop (didn't bet)
Seat 2: jcarlos.vale folded before Flop (didn't bet)
Seat 3: biscom2007 folded before Flop (didn't bet)
Seat 4: mariafirmina folded before Flop (didn't bet)
Seat 5: felipeando folded before Flop
Seat 6: jordan202025 folded before Flop (didn't bet)
Seat 7: YaR1qq (button) folded before Flop (didn't bet)
Seat 8: Negrata (small blind) folded before Flop
Seat 9: Mitnick.K.D. (big blind) collected (6210)



PokerStars Hand #222155335599: Tournament #3086083919, $0.49+$0.06 USD Hold'em No Limit - Level XVIII (600/1200) - 2021/01/03 0:19:13 EET [2021/01/02 17:19:13 ET]
Table '3086083919 96' 9-max Seat #8 is the button
Seat 1: vladlen101 (32877 in chips) 
Seat 2: jcarlos.vale (17297 in chips) 
Seat 3: biscom2007 (13172 in chips) 
Seat 4: mariafirmina (17700 in chips) 
Seat 5: felipeando (28574 in chips) 
Seat 6: jordan202025 (11500 in chips) 
Seat 7: YaR1qq (34020 in chips) 
Seat 8: Negrata (7511 in chips) 
Seat 9: Mitnick.K.D. (36065 in chips) 
vladlen101: posts the ante 90
jcarlos.vale: posts the ante 90
biscom2007: posts the ante 90
mariafirmina: posts the ante 90
felipeando: posts the ante 90
jordan202025: posts the ante 90
YaR1qq: posts the ante 90
Negrata: posts the ante 90
Mitnick.K.D.: posts the ante 90
Mitnick.K.D.: posts small blind 600
vladlen101: posts big blind 1200
*** HOLE CARDS ***
Dealt to jcarlos.vale [5c Ah]
jcarlos.vale: folds 
biscom2007: folds 
mariafirmina: folds 
felipeando: raises 1200 to 2400
jordan202025 has timed out
jordan202025: folds 
jordan202025 is sitting out
YaR1qq: folds 
jordan202025 has returned
Negrata: folds 
Mitnick.K.D.: raises 33575 to 35975 and is all-in
vladlen101: folds 
felipeando: folds 
Uncalled bet (33575) returned to Mitnick.K.D.
Mitnick.K.D. collected 6810 from pot
Mitnick.K.D.: doesn't show handDTO
*** SUMMARY ***
Total pot 6810 | Rake 0 
Seat 1: vladlen101 (big blind) folded before Flop
Seat 2: jcarlos.vale folded before Flop (didn't bet)
Seat 3: biscom2007 folded before Flop (didn't bet)
Seat 4: mariafirmina folded before Flop (didn't bet)
Seat 5: felipeando folded before Flop
Seat 6: jordan202025 folded before Flop (didn't bet)
Seat 7: YaR1qq folded before Flop (didn't bet)
Seat 8: Negrata (button) folded before Flop (didn't bet)
Seat 9: Mitnick.K.D. (small blind) collected (6810)



PokerStars Hand #222155370428: Tournament #3086083919, $0.49+$0.06 USD Hold'em No Limit - Level XVIII (600/1200) - 2021/01/03 0:19:49 EET [2021/01/02 17:19:49 ET]
Table '3086083919 96' 9-max Seat #9 is the button
Seat 1: vladlen101 (31587 in chips) 
Seat 2: jcarlos.vale (17207 in chips) 
Seat 3: biscom2007 (13082 in chips) 
Seat 4: mariafirmina (17610 in chips) 
Seat 5: felipeando (26084 in chips) 
Seat 6: jordan202025 (11410 in chips) 
Seat 7: YaR1qq (33930 in chips) 
Seat 8: Negrata (7421 in chips) 
Seat 9: Mitnick.K.D. (40385 in chips) 
vladlen101: posts the ante 90
jcarlos.vale: posts the ante 90
biscom2007: posts the ante 90
mariafirmina: posts the ante 90
felipeando: posts the ante 90
jordan202025: posts the ante 90
YaR1qq: posts the ante 90
Negrata: posts the ante 90
Mitnick.K.D.: posts the ante 90
vladlen101: posts small blind 600
jcarlos.vale: posts big blind 1200
*** HOLE CARDS ***
Dealt to jcarlos.vale [Qc Qh]
biscom2007: folds 
mariafirmina has timed out
mariafirmina: folds 
mariafirmina is sitting out
felipeando: folds 
jordan202025: folds 
YaR1qq: folds 
Negrata: folds 
Mitnick.K.D.: folds 
vladlen101: folds 
Uncalled bet (600) returned to jcarlos.vale
jcarlos.vale collected 2010 from pot
jcarlos.vale: doesn't show handDTO
*** SUMMARY ***
Total pot 2010 | Rake 0 
Seat 1: vladlen101 (small blind) folded before Flop
Seat 2: jcarlos.vale (big blind) collected (2010)
Seat 3: biscom2007 folded before Flop (didn't bet)
Seat 4: mariafirmina folded before Flop (didn't bet)
Seat 5: felipeando folded before Flop (didn't bet)
Seat 6: jordan202025 folded before Flop (didn't bet)
Seat 7: YaR1qq folded before Flop (didn't bet)
Seat 8: Negrata folded before Flop (didn't bet)
Seat 9: Mitnick.K.D. (button) folded before Flop (didn't bet)



PokerStars Hand #222155396454: Tournament #3086083919, $0.49+$0.06 USD Hold'em No Limit - Level XVIII (600/1200) - 2021/01/03 0:20:16 EET [2021/01/02 17:20:16 ET]
Table '3086083919 96' 9-max Seat #1 is the button
Seat 1: vladlen101 (30897 in chips) 
Seat 2: jcarlos.vale (18527 in chips) 
Seat 3: biscom2007 (12992 in chips) 
Seat 4: mariafirmina (17520 in chips) is sitting out
Seat 5: felipeando (25994 in chips) 
Seat 6: jordan202025 (11320 in chips) 
Seat 7: YaR1qq (33840 in chips) 
Seat 8: Negrata (7331 in chips) 
Seat 9: Mitnick.K.D. (40295 in chips) 
vladlen101: posts the ante 90
jcarlos.vale: posts the ante 90
biscom2007: posts the ante 90
mariafirmina: posts the ante 90
felipeando: posts the ante 90
jordan202025: posts the ante 90
YaR1qq: posts the ante 90
Negrata: posts the ante 90
Mitnick.K.D.: posts the ante 90
jcarlos.vale: posts small blind 600
biscom2007: posts big blind 1200
*** HOLE CARDS ***
Dealt to jcarlos.vale [3d 8s]
mariafirmina: folds 
felipeando: folds 
jordan202025: folds 
YaR1qq: calls 1200
Negrata: folds 
mariafirmina has returned
Mitnick.K.D.: folds 
vladlen101: calls 1200
jcarlos.vale: calls 600
biscom2007: checks 
*** FLOP *** [Qd 7h 7c]
jcarlos.vale: checks 
biscom2007: checks 
YaR1qq: checks 
vladlen101: bets 2805
jcarlos.vale: folds 
biscom2007: folds 
YaR1qq: folds 
Uncalled bet (2805) returned to vladlen101
vladlen101 collected 5610 from pot
vladlen101: doesn't show handDTO
*** SUMMARY ***
Total pot 5610 | Rake 0 
Board [Qd 7h 7c]
Seat 1: vladlen101 (button) collected (5610)
Seat 2: jcarlos.vale (small blind) folded on the Flop
Seat 3: biscom2007 (big blind) folded on the Flop
Seat 4: mariafirmina folded before Flop (didn't bet)
Seat 5: felipeando folded before Flop (didn't bet)
Seat 6: jordan202025 folded before Flop (didn't bet)
Seat 7: YaR1qq folded on the Flop
Seat 8: Negrata folded before Flop (didn't bet)
Seat 9: Mitnick.K.D. folded before Flop (didn't bet)



PokerStars Hand #222155444113: Tournament #3086083919, $0.49+$0.06 USD Hold'em No Limit - Level XIX (700/1400) - 2021/01/03 0:21:05 EET [2021/01/02 17:21:05 ET]
Table '3086083919 96' 9-max Seat #2 is the button
Seat 1: vladlen101 (35217 in chips) 
Seat 2: jcarlos.vale (17237 in chips) 
Seat 3: biscom2007 (11702 in chips) 
Seat 4: mariafirmina (17430 in chips) 
Seat 5: felipeando (25904 in chips) 
Seat 6: jordan202025 (11230 in chips) 
Seat 7: YaR1qq (32550 in chips) 
Seat 8: Negrata (7241 in chips) 
Seat 9: Mitnick.K.D. (40205 in chips) 
vladlen101: posts the ante 100
jcarlos.vale: posts the ante 100
biscom2007: posts the ante 100
mariafirmina: posts the ante 100
felipeando: posts the ante 100
jordan202025: posts the ante 100
YaR1qq: posts the ante 100
Negrata: posts the ante 100
Mitnick.K.D.: posts the ante 100
biscom2007: posts small blind 700
mariafirmina: posts big blind 1400
*** HOLE CARDS ***
Dealt to jcarlos.vale [7s Js]
felipeando: folds 
jordan202025: folds 
YaR1qq: calls 1400
Negrata: folds 
Mitnick.K.D.: folds 
vladlen101: folds 
jcarlos.vale: folds 
biscom2007: calls 700
mariafirmina: checks 
*** FLOP *** [8d 6h Td]
biscom2007: checks 
mariafirmina: checks 
YaR1qq: checks 
*** TURN *** [8d 6h Td] [Jh]
biscom2007: bets 1400
mariafirmina: calls 1400
YaR1qq: folds 
*** RIVER *** [8d 6h Td Jh] [5c]
biscom2007: checks 
mariafirmina: checks 
*** SHOW DOWN ***
biscom2007: shows [7h 8s] (a pair of Eights)
mariafirmina: mucks handDTO
biscom2007 collected 7900 from pot
*** SUMMARY ***
Total pot 7900 | Rake 0 
Board [8d 6h Td Jh 5c]
Seat 1: vladlen101 folded before Flop (didn't bet)
Seat 2: jcarlos.vale (button) folded before Flop (didn't bet)
Seat 3: biscom2007 (small blind) showed [7h 8s] and won (7900) with a pair of Eights
Seat 4: mariafirmina (big blind) mucked [9c 5h]
Seat 5: felipeando folded before Flop (didn't bet)
Seat 6: jordan202025 folded before Flop (didn't bet)
Seat 7: YaR1qq folded on the Turn
Seat 8: Negrata folded before Flop (didn't bet)
Seat 9: Mitnick.K.D. folded before Flop (didn't bet)



PokerStars Hand #222155499646: Tournament #3086083919, $0.49+$0.06 USD Hold'em No Limit - Level XIX (700/1400) - 2021/01/03 0:22:03 EET [2021/01/02 17:22:03 ET]
Table '3086083919 96' 9-max Seat #3 is the button
Seat 1: vladlen101 (35117 in chips) 
Seat 2: jcarlos.vale (17137 in chips) 
Seat 3: biscom2007 (16702 in chips) 
Seat 4: mariafirmina (14530 in chips) 
Seat 5: felipeando (25804 in chips) 
Seat 6: jordan202025 (11130 in chips) 
Seat 7: YaR1qq (31050 in chips) 
Seat 8: Negrata (7141 in chips) 
Seat 9: Mitnick.K.D. (40105 in chips) 
vladlen101: posts the ante 100
jcarlos.vale: posts the ante 100
biscom2007: posts the ante 100
mariafirmina: posts the ante 100
felipeando: posts the ante 100
jordan202025: posts the ante 100
YaR1qq: posts the ante 100
Negrata: posts the ante 100
Mitnick.K.D.: posts the ante 100
mariafirmina: posts small blind 700
felipeando: posts big blind 1400
*** HOLE CARDS ***
Dealt to jcarlos.vale [Qc Qd]
jordan202025: folds 
YaR1qq: folds 
Negrata: folds 
Mitnick.K.D.: raises 4900 to 6300
vladlen101: folds 
jcarlos.vale: raises 10737 to 17037 and is all-in
biscom2007: folds 
mariafirmina: folds 
felipeando: folds 
Mitnick.K.D.: calls 10737
*** FLOP *** [2c 3d 4h]
*** TURN *** [2c 3d 4h] [6s]
*** RIVER *** [2c 3d 4h 6s] [4c]
*** SHOW DOWN ***
Mitnick.K.D.: shows [Jd Jh] (two pair, Jacks and Fours)
jcarlos.vale: shows [Qc Qd] (two pair, Queens and Fours)
jcarlos.vale collected 37074 from pot
*** SUMMARY ***
Total pot 37074 | Rake 0 
Board [2c 3d 4h 6s 4c]
Seat 1: vladlen101 folded before Flop (didn't bet)
Seat 2: jcarlos.vale showed [Qc Qd] and won (37074) with two pair, Queens and Fours
Seat 3: biscom2007 (button) folded before Flop (didn't bet)
Seat 4: mariafirmina (small blind) folded before Flop
Seat 5: felipeando (big blind) folded before Flop
Seat 6: jordan202025 folded before Flop (didn't bet)
Seat 7: YaR1qq folded before Flop (didn't bet)
Seat 8: Negrata folded before Flop (didn't bet)
Seat 9: Mitnick.K.D. showed [Jd Jh] and lost with two pair, Jacks and Fours



PokerStars Hand #222155530803: Tournament #3086083919, $0.49+$0.06 USD Hold'em No Limit - Level XIX (700/1400) - 2021/01/03 0:22:35 EET [2021/01/02 17:22:35 ET]
Table '3086083919 96' 9-max Seat #4 is the button
Seat 1: vladlen101 (35017 in chips) 
Seat 2: jcarlos.vale (37074 in chips) 
Seat 3: biscom2007 (16602 in chips) 
Seat 4: mariafirmina (13730 in chips) 
Seat 5: felipeando (24304 in chips) 
Seat 6: jordan202025 (11030 in chips) 
Seat 7: YaR1qq (30950 in chips) 
Seat 8: Negrata (7041 in chips) 
Seat 9: Mitnick.K.D. (22968 in chips) 
vladlen101: posts the ante 100
jcarlos.vale: posts the ante 100
biscom2007: posts the ante 100
mariafirmina: posts the ante 100
felipeando: posts the ante 100
jordan202025: posts the ante 100
YaR1qq: posts the ante 100
Negrata: posts the ante 100
Mitnick.K.D.: posts the ante 100
felipeando: posts small blind 700
jordan202025: posts big blind 1400
*** HOLE CARDS ***
Dealt to jcarlos.vale [7c 2d]
YaR1qq: calls 1400
Negrata: folds 
Mitnick.K.D.: folds 
vladlen101: folds 
jcarlos.vale: folds 
biscom2007: calls 1400
mariafirmina: raises 12230 to 13630 and is all-in
felipeando: raises 10574 to 24204 and is all-in
jordan202025: folds 
YaR1qq: folds 
biscom2007: folds 
Uncalled bet (10574) returned to felipeando
*** FLOP *** [7s Ac 2h]
*** TURN *** [7s Ac 2h] [4d]
*** RIVER *** [7s Ac 2h 4d] [3c]
*** SHOW DOWN ***
felipeando: shows [Kc Ad] (a pair of Aces)
mariafirmina: shows [Tc Ts] (a pair of Tens)
felipeando collected 32360 from pot
mariafirmina finished the tournament in 389th place and received $1.15.
*** SUMMARY ***
Total pot 32360 | Rake 0 
Board [7s Ac 2h 4d 3c]
Seat 1: vladlen101 folded before Flop (didn't bet)
Seat 2: jcarlos.vale folded before Flop (didn't bet)
Seat 3: biscom2007 folded before Flop
Seat 4: mariafirmina (button) showed [Tc Ts] and lost with a pair of Tens
Seat 5: felipeando (small blind) showed [Kc Ad] and won (32360) with a pair of Aces
Seat 6: jordan202025 (big blind) folded before Flop
Seat 7: YaR1qq folded before Flop
Seat 8: Negrata folded before Flop (didn't bet)
Seat 9: Mitnick.K.D. folded before Flop (didn't bet)



PokerStars Hand #222155569801: Tournament #3086083919, $0.49+$0.06 USD Hold'em No Limit - Level XIX (700/1400) - 2021/01/03 0:23:16 EET [2021/01/02 17:23:16 ET]
Table '3086083919 96' 9-max Seat #5 is the button
Seat 1: vladlen101 (34917 in chips) 
Seat 2: jcarlos.vale (36974 in chips) 
Seat 3: biscom2007 (15102 in chips) 
Seat 5: felipeando (42934 in chips) 
Seat 6: jordan202025 (9530 in chips) 
Seat 7: YaR1qq (29450 in chips) 
Seat 8: Negrata (6941 in chips) 
Seat 9: Mitnick.K.D. (22868 in chips) 
vladlen101: posts the ante 100
jcarlos.vale: posts the ante 100
biscom2007: posts the ante 100
felipeando: posts the ante 100
jordan202025: posts the ante 100
YaR1qq: posts the ante 100
Negrata: posts the ante 100
Mitnick.K.D.: posts the ante 100
jordan202025: posts small blind 700
YaR1qq: posts big blind 1400
*** HOLE CARDS ***
Dealt to jcarlos.vale [5s Qd]
Negrata: folds 
Mitnick.K.D.: folds 
vladlen101: folds 
jcarlos.vale: folds 
biscom2007: folds 
felipeando: folds 
jordan202025: folds 
Uncalled bet (700) returned to YaR1qq
YaR1qq collected 2200 from pot
YaR1qq: doesn't show handDTO
*** SUMMARY ***
Total pot 2200 | Rake 0 
Seat 1: vladlen101 folded before Flop (didn't bet)
Seat 2: jcarlos.vale folded before Flop (didn't bet)
Seat 3: biscom2007 folded before Flop (didn't bet)
Seat 5: felipeando (button) folded before Flop (didn't bet)
Seat 6: jordan202025 (small blind) folded before Flop
Seat 7: YaR1qq (big blind) collected (2200)
Seat 8: Negrata folded before Flop (didn't bet)
Seat 9: Mitnick.K.D. folded before Flop (didn't bet)



PokerStars Hand #222155589583: Tournament #3086083919, $0.49+$0.06 USD Hold'em No Limit - Level XIX (700/1400) - 2021/01/03 0:23:37 EET [2021/01/02 17:23:37 ET]
Table '3086083919 96' 9-max Seat #6 is the button
Seat 1: vladlen101 (34817 in chips) 
Seat 2: jcarlos.vale (36874 in chips) 
Seat 3: biscom2007 (15002 in chips) 
Seat 4: Garrik26 (65181 in chips) 
Seat 5: felipeando (42834 in chips) 
Seat 6: jordan202025 (8730 in chips) 
Seat 7: YaR1qq (30850 in chips) 
Seat 8: Negrata (6841 in chips) 
Seat 9: Mitnick.K.D. (22768 in chips) 
vladlen101: posts the ante 100
jcarlos.vale: posts the ante 100
biscom2007: posts the ante 100
Garrik26: posts the ante 100
felipeando: posts the ante 100
jordan202025: posts the ante 100
YaR1qq: posts the ante 100
Negrata: posts the ante 100
Mitnick.K.D.: posts the ante 100
YaR1qq: posts small blind 700
Negrata: posts big blind 1400
*** HOLE CARDS ***
Dealt to jcarlos.vale [9h 9d]
Mitnick.K.D.: folds 
vladlen101: folds 
jcarlos.vale: raises 2240 to 3640
biscom2007: folds 
Garrik26: folds 
felipeando: folds 
jordan202025: folds 
YaR1qq: folds 
Negrata: folds 
Uncalled bet (2240) returned to jcarlos.vale
jcarlos.vale collected 4400 from pot
jcarlos.vale: doesn't show handDTO
*** SUMMARY ***
Total pot 4400 | Rake 0 
Seat 1: vladlen101 folded before Flop (didn't bet)
Seat 2: jcarlos.vale collected (4400)
Seat 3: biscom2007 folded before Flop (didn't bet)
Seat 4: Garrik26 folded before Flop (didn't bet)
Seat 5: felipeando folded before Flop (didn't bet)
Seat 6: jordan202025 (button) folded before Flop (didn't bet)
Seat 7: YaR1qq (small blind) folded before Flop
Seat 8: Negrata (big blind) folded before Flop
Seat 9: Mitnick.K.D. folded before Flop (didn't bet)



PokerStars Hand #222155621061: Tournament #3086083919, $0.49+$0.06 USD Hold'em No Limit - Level XIX (700/1400) - 2021/01/03 0:24:09 EET [2021/01/02 17:24:09 ET]
Table '3086083919 96' 9-max Seat #7 is the button
Seat 1: vladlen101 (34717 in chips) 
Seat 2: jcarlos.vale (39774 in chips) 
Seat 3: biscom2007 (14902 in chips) 
Seat 4: Garrik26 (65081 in chips) 
Seat 5: felipeando (42734 in chips) 
Seat 6: jordan202025 (8630 in chips) 
Seat 7: YaR1qq (30050 in chips) 
Seat 8: Negrata (5341 in chips) 
Seat 9: Mitnick.K.D. (22668 in chips) 
vladlen101: posts the ante 100
jcarlos.vale: posts the ante 100
biscom2007: posts the ante 100
Garrik26: posts the ante 100
felipeando: posts the ante 100
jordan202025: posts the ante 100
YaR1qq: posts the ante 100
Negrata: posts the ante 100
Mitnick.K.D.: posts the ante 100
Negrata: posts small blind 700
Mitnick.K.D.: posts big blind 1400
*** HOLE CARDS ***
Dealt to jcarlos.vale [7h 8d]
vladlen101: folds 
jcarlos.vale: folds 
biscom2007: folds 
Garrik26: folds 
felipeando: raises 1400 to 2800
jordan202025: folds 
YaR1qq: folds 
Negrata: folds 
Mitnick.K.D.: folds 
Uncalled bet (1400) returned to felipeando
felipeando collected 4400 from pot
felipeando: doesn't show handDTO
*** SUMMARY ***
Total pot 4400 | Rake 0 
Seat 1: vladlen101 folded before Flop (didn't bet)
Seat 2: jcarlos.vale folded before Flop (didn't bet)
Seat 3: biscom2007 folded before Flop (didn't bet)
Seat 4: Garrik26 folded before Flop (didn't bet)
Seat 5: felipeando collected (4400)
Seat 6: jordan202025 folded before Flop (didn't bet)
Seat 7: YaR1qq (button) folded before Flop (didn't bet)
Seat 8: Negrata (small blind) folded before Flop
Seat 9: Mitnick.K.D. (big blind) folded before Flop



PokerStars Hand #222155653608: Tournament #3086083919, $0.49+$0.06 USD Hold'em No Limit - Level XIX (700/1400) - 2021/01/03 0:24:43 EET [2021/01/02 17:24:43 ET]
Table '3086083919 96' 9-max Seat #8 is the button
Seat 1: vladlen101 (34617 in chips) 
Seat 2: jcarlos.vale (39674 in chips) 
Seat 3: biscom2007 (14802 in chips) 
Seat 4: Garrik26 (64981 in chips) 
Seat 5: felipeando (45634 in chips) 
Seat 6: jordan202025 (8530 in chips) 
Seat 7: YaR1qq (29950 in chips) 
Seat 8: Negrata (4541 in chips) 
Seat 9: Mitnick.K.D. (21168 in chips) 
vladlen101: posts the ante 100
jcarlos.vale: posts the ante 100
biscom2007: posts the ante 100
Garrik26: posts the ante 100
felipeando: posts the ante 100
jordan202025: posts the ante 100
YaR1qq: posts the ante 100
Negrata: posts the ante 100
Mitnick.K.D.: posts the ante 100
Mitnick.K.D.: posts small blind 700
vladlen101: posts big blind 1400
*** HOLE CARDS ***
Dealt to jcarlos.vale [As 5c]
jcarlos.vale: folds 
biscom2007: folds 
Garrik26: folds 
felipeando: folds 
jordan202025: raises 7030 to 8430 and is all-in
YaR1qq: folds 
Negrata: calls 4441 and is all-in
Mitnick.K.D.: folds 
vladlen101: folds 
Uncalled bet (3989) returned to jordan202025
*** FLOP *** [9d Ad Qc]
*** TURN *** [9d Ad Qc] [Js]
*** RIVER *** [9d Ad Qc Js] [8h]
*** SHOW DOWN ***
jordan202025: shows [3d 3s] (a pair of Threes)
Negrata: shows [Qs Ks] (a pair of Queens)
Negrata collected 11882 from pot
*** SUMMARY ***
Total pot 11882 | Rake 0 
Board [9d Ad Qc Js 8h]
Seat 1: vladlen101 (big blind) folded before Flop
Seat 2: jcarlos.vale folded before Flop (didn't bet)
Seat 3: biscom2007 folded before Flop (didn't bet)
Seat 4: Garrik26 folded before Flop (didn't bet)
Seat 5: felipeando folded before Flop (didn't bet)
Seat 6: jordan202025 showed [3d 3s] and lost with a pair of Threes
Seat 7: YaR1qq folded before Flop (didn't bet)
Seat 8: Negrata (button) showed [Qs Ks] and won (11882) with a pair of Queens
Seat 9: Mitnick.K.D. (small blind) folded before Flop



PokerStars Hand #222155684365: Tournament #3086083919, $0.49+$0.06 USD Hold'em No Limit - Level XIX (700/1400) - 2021/01/03 0:25:15 EET [2021/01/02 17:25:15 ET]
Table '3086083919 96' 9-max Seat #9 is the button
Seat 1: vladlen101 (33117 in chips) 
Seat 2: jcarlos.vale (39574 in chips) 
Seat 3: biscom2007 (14702 in chips) 
Seat 4: Garrik26 (64881 in chips) 
Seat 5: felipeando (45534 in chips) 
Seat 6: jordan202025 (3989 in chips) 
Seat 7: YaR1qq (29850 in chips) 
Seat 8: Negrata (11882 in chips) 
Seat 9: Mitnick.K.D. (20368 in chips) 
vladlen101: posts the ante 100
jcarlos.vale: posts the ante 100
biscom2007: posts the ante 100
Garrik26: posts the ante 100
felipeando: posts the ante 100
jordan202025: posts the ante 100
YaR1qq: posts the ante 100
Negrata: posts the ante 100
Mitnick.K.D.: posts the ante 100
vladlen101: posts small blind 700
jcarlos.vale: posts big blind 1400
*** HOLE CARDS ***
Dealt to jcarlos.vale [Qs 2h]
biscom2007: raises 1400 to 2800
Garrik26: folds 
felipeando: folds 
jordan202025: folds 
YaR1qq: folds 
Negrata: folds 
Mitnick.K.D.: folds 
vladlen101: folds 
jcarlos.vale: folds 
Uncalled bet (1400) returned to biscom2007
biscom2007 collected 4400 from pot
biscom2007: doesn't show handDTO
*** SUMMARY ***
Total pot 4400 | Rake 0 
Seat 1: vladlen101 (small blind) folded before Flop
Seat 2: jcarlos.vale (big blind) folded before Flop
Seat 3: biscom2007 collected (4400)
Seat 4: Garrik26 folded before Flop (didn't bet)
Seat 5: felipeando folded before Flop (didn't bet)
Seat 6: jordan202025 folded before Flop (didn't bet)
Seat 7: YaR1qq folded before Flop (didn't bet)
Seat 8: Negrata folded before Flop (didn't bet)
Seat 9: Mitnick.K.D. (button) folded before Flop (didn't bet)



PokerStars Hand #222155702779: Tournament #3086083919, $0.49+$0.06 USD Hold'em No Limit - Level XIX (700/1400) - 2021/01/03 0:25:34 EET [2021/01/02 17:25:34 ET]
Table '3086083919 96' 9-max Seat #1 is the button
Seat 1: vladlen101 (32317 in chips) 
Seat 2: jcarlos.vale (38074 in chips) 
Seat 3: biscom2007 (17602 in chips) 
Seat 4: Garrik26 (64781 in chips) 
Seat 5: felipeando (45434 in chips) 
Seat 6: jordan202025 (3889 in chips) 
Seat 7: YaR1qq (29750 in chips) 
Seat 8: Negrata (11782 in chips) 
Seat 9: Mitnick.K.D. (20268 in chips) 
vladlen101: posts the ante 100
jcarlos.vale: posts the ante 100
biscom2007: posts the ante 100
Garrik26: posts the ante 100
felipeando: posts the ante 100
jordan202025: posts the ante 100
YaR1qq: posts the ante 100
Negrata: posts the ante 100
Mitnick.K.D.: posts the ante 100
jcarlos.vale: posts small blind 700
biscom2007: posts big blind 1400
*** HOLE CARDS ***
Dealt to jcarlos.vale [Ks 4c]
Garrik26: folds 
felipeando: folds 
jordan202025: folds 
YaR1qq: folds 
Negrata: folds 
Mitnick.K.D.: raises 4900 to 6300
vladlen101: folds 
jcarlos.vale: folds 
biscom2007: folds 
Uncalled bet (4900) returned to Mitnick.K.D.
Mitnick.K.D. collected 4400 from pot
Mitnick.K.D.: doesn't show handDTO
*** SUMMARY ***
Total pot 4400 | Rake 0 
Seat 1: vladlen101 (button) folded before Flop (didn't bet)
Seat 2: jcarlos.vale (small blind) folded before Flop
Seat 3: biscom2007 (big blind) folded before Flop
Seat 4: Garrik26 folded before Flop (didn't bet)
Seat 5: felipeando folded before Flop (didn't bet)
Seat 6: jordan202025 folded before Flop (didn't bet)
Seat 7: YaR1qq folded before Flop (didn't bet)
Seat 8: Negrata folded before Flop (didn't bet)
Seat 9: Mitnick.K.D. collected (4400)



PokerStars Hand #222155725742: Tournament #3086083919, $0.49+$0.06 USD Hold'em No Limit - Level XIX (700/1400) - 2021/01/03 0:25:58 EET [2021/01/02 17:25:58 ET]
Table '3086083919 96' 9-max Seat #2 is the button
Seat 1: vladlen101 (32217 in chips) 
Seat 2: jcarlos.vale (37274 in chips) 
Seat 3: biscom2007 (16102 in chips) 
Seat 4: Garrik26 (64681 in chips) 
Seat 5: felipeando (45334 in chips) 
Seat 6: jordan202025 (3789 in chips) 
Seat 7: YaR1qq (29650 in chips) 
Seat 8: Negrata (11682 in chips) 
Seat 9: Mitnick.K.D. (23168 in chips) 
vladlen101: posts the ante 100
jcarlos.vale: posts the ante 100
biscom2007: posts the ante 100
Garrik26: posts the ante 100
felipeando: posts the ante 100
jordan202025: posts the ante 100
YaR1qq: posts the ante 100
Negrata: posts the ante 100
Mitnick.K.D.: posts the ante 100
biscom2007: posts small blind 700
Garrik26: posts big blind 1400
*** HOLE CARDS ***
Dealt to jcarlos.vale [Ks Th]
felipeando: folds 
jordan202025: raises 2289 to 3689 and is all-in
YaR1qq: folds 
Negrata: folds 
Mitnick.K.D.: folds 
vladlen101: folds 
jcarlos.vale: folds 
biscom2007: folds 
Garrik26: folds 
Uncalled bet (2289) returned to jordan202025
jordan202025 collected 4400 from pot
*** SUMMARY ***
Total pot 4400 | Rake 0 
Seat 1: vladlen101 folded before Flop (didn't bet)
Seat 2: jcarlos.vale (button) folded before Flop (didn't bet)
Seat 3: biscom2007 (small blind) folded before Flop
Seat 4: Garrik26 (big blind) folded before Flop
Seat 5: felipeando folded before Flop (didn't bet)
Seat 6: jordan202025 collected (4400)
Seat 7: YaR1qq folded before Flop (didn't bet)
Seat 8: Negrata folded before Flop (didn't bet)
Seat 9: Mitnick.K.D. folded before Flop (didn't bet)



PokerStars Hand #222155743834: Tournament #3086083919, $0.49+$0.06 USD Hold'em No Limit - Level XIX (700/1400) - 2021/01/03 0:26:17 EET [2021/01/02 17:26:17 ET]
Table '3086083919 96' 9-max Seat #3 is the button
Seat 1: vladlen101 (32117 in chips) 
Seat 2: jcarlos.vale (37174 in chips) 
Seat 3: biscom2007 (15302 in chips) 
Seat 4: Garrik26 (63181 in chips) 
Seat 5: felipeando (45234 in chips) 
Seat 6: jordan202025 (6689 in chips) 
Seat 7: YaR1qq (29550 in chips) 
Seat 8: Negrata (11582 in chips) 
Seat 9: Mitnick.K.D. (23068 in chips) 
vladlen101: posts the ante 100
jcarlos.vale: posts the ante 100
biscom2007: posts the ante 100
Garrik26: posts the ante 100
felipeando: posts the ante 100
jordan202025: posts the ante 100
YaR1qq: posts the ante 100
Negrata: posts the ante 100
Mitnick.K.D.: posts the ante 100
Garrik26: posts small blind 700
felipeando: posts big blind 1400
*** HOLE CARDS ***
Dealt to jcarlos.vale [4h Jd]
jordan202025: folds 
YaR1qq: folds 
Negrata: folds 
Mitnick.K.D.: folds 
vladlen101: calls 1400
jcarlos.vale: folds 
biscom2007: folds 
Garrik26: folds 
felipeando: checks 
*** FLOP *** [9s 4s Td]
felipeando: checks 
vladlen101: bets 2200
felipeando: raises 41534 to 43734 and is all-in
vladlen101: calls 28417 and is all-in
Uncalled bet (13117) returned to felipeando
*** TURN *** [9s 4s Td] [Ad]
*** RIVER *** [9s 4s Td Ad] [Ah]
*** SHOW DOWN ***
felipeando: shows [Th 4d] (two pair, Aces and Tens)
vladlen101: shows [Ks Qs] (a pair of Aces)
felipeando collected 65634 from pot
vladlen101 finished the tournament in 360th place and received $1.45.
*** SUMMARY ***
Total pot 65634 | Rake 0 
Board [9s 4s Td Ad Ah]
Seat 1: vladlen101 showed [Ks Qs] and lost with a pair of Aces
Seat 2: jcarlos.vale folded before Flop (didn't bet)
Seat 3: biscom2007 (button) folded before Flop (didn't bet)
Seat 4: Garrik26 (small blind) folded before Flop
Seat 5: felipeando (big blind) showed [Th 4d] and won (65634) with two pair, Aces and Tens
Seat 6: jordan202025 folded before Flop (didn't bet)
Seat 7: YaR1qq folded before Flop (didn't bet)
Seat 8: Negrata folded before Flop (didn't bet)
Seat 9: Mitnick.K.D. folded before Flop (didn't bet)



PokerStars Hand #222155784389: Tournament #3086083919, $0.49+$0.06 USD Hold'em No Limit - Level XIX (700/1400) - 2021/01/03 0:27:00 EET [2021/01/02 17:27:00 ET]
Table '3086083919 96' 9-max Seat #4 is the button
Seat 2: jcarlos.vale (37074 in chips) 
Seat 3: biscom2007 (15202 in chips) 
Seat 4: Garrik26 (62381 in chips) 
Seat 5: felipeando (78751 in chips) 
Seat 6: jordan202025 (6589 in chips) 
Seat 7: YaR1qq (29450 in chips) 
Seat 8: Negrata (11482 in chips) 
Seat 9: Mitnick.K.D. (22968 in chips) 
jcarlos.vale: posts the ante 100
biscom2007: posts the ante 100
Garrik26: posts the ante 100
felipeando: posts the ante 100
jordan202025: posts the ante 100
YaR1qq: posts the ante 100
Negrata: posts the ante 100
Mitnick.K.D.: posts the ante 100
felipeando: posts small blind 700
jordan202025: posts big blind 1400
*** HOLE CARDS ***
Dealt to jcarlos.vale [7s 4h]
YaR1qq: calls 1400
Negrata: folds 
Mitnick.K.D.: folds 
jcarlos.vale: folds 
biscom2007: folds 
Garrik26: folds 
felipeando: calls 700
jordan202025: checks 
*** FLOP *** [Jh 4c Tc]
felipeando: checks 
jordan202025: checks 
YaR1qq: checks 
*** TURN *** [Jh 4c Tc] [6s]
felipeando: checks 
jordan202025: checks 
YaR1qq: bets 1400
felipeando: folds 
jordan202025: folds 
Uncalled bet (1400) returned to YaR1qq
YaR1qq collected 5000 from pot
YaR1qq: doesn't show handDTO
*** SUMMARY ***
Total pot 5000 | Rake 0 
Board [Jh 4c Tc 6s]
Seat 2: jcarlos.vale folded before Flop (didn't bet)
Seat 3: biscom2007 folded before Flop (didn't bet)
Seat 4: Garrik26 (button) folded before Flop (didn't bet)
Seat 5: felipeando (small blind) folded on the Turn
Seat 6: jordan202025 (big blind) folded on the Turn
Seat 7: YaR1qq collected (5000)
Seat 8: Negrata folded before Flop (didn't bet)
Seat 9: Mitnick.K.D. folded before Flop (didn't bet)



PokerStars Hand #222155823718: Tournament #3086083919, $0.49+$0.06 USD Hold'em No Limit - Level XIX (700/1400) - 2021/01/03 0:27:41 EET [2021/01/02 17:27:41 ET]
Table '3086083919 96' 9-max Seat #5 is the button
Seat 2: jcarlos.vale (36974 in chips) 
Seat 3: biscom2007 (15102 in chips) 
Seat 4: Garrik26 (62281 in chips) 
Seat 5: felipeando (77251 in chips) 
Seat 6: jordan202025 (5089 in chips) 
Seat 7: YaR1qq (32950 in chips) 
Seat 8: Negrata (11382 in chips) 
Seat 9: Mitnick.K.D. (22868 in chips) 
jcarlos.vale: posts the ante 100
biscom2007: posts the ante 100
Garrik26: posts the ante 100
felipeando: posts the ante 100
jordan202025: posts the ante 100
YaR1qq: posts the ante 100
Negrata: posts the ante 100
Mitnick.K.D.: posts the ante 100
jordan202025: posts small blind 700
YaR1qq: posts big blind 1400
*** HOLE CARDS ***
Dealt to jcarlos.vale [7d 8d]
Negrata: folds 
Mitnick.K.D.: folds 
jcarlos.vale: raises 2240 to 3640
biscom2007: calls 3640
Garrik26: folds 
felipeando: folds 
jordan202025: folds 
YaR1qq: calls 2240
*** FLOP *** [Qh 2h Tc]
YaR1qq: checks 
jcarlos.vale: checks 
biscom2007: bets 11362 and is all-in
YaR1qq: folds 
jcarlos.vale: folds 
Uncalled bet (11362) returned to biscom2007
biscom2007 collected 12420 from pot
biscom2007: doesn't show handDTO
*** SUMMARY ***
Total pot 12420 | Rake 0 
Board [Qh 2h Tc]
Seat 2: jcarlos.vale folded on the Flop
Seat 3: biscom2007 collected (12420)
Seat 4: Garrik26 folded before Flop (didn't bet)
Seat 5: felipeando (button) folded before Flop (didn't bet)
Seat 6: jordan202025 (small blind) folded before Flop
Seat 7: YaR1qq (big blind) folded on the Flop
Seat 8: Negrata folded before Flop (didn't bet)
Seat 9: Mitnick.K.D. folded before Flop (didn't bet)



PokerStars Hand #222155881826: Tournament #3086083919, $0.49+$0.06 USD Hold'em No Limit - Level XIX (700/1400) - 2021/01/03 0:28:42 EET [2021/01/02 17:28:42 ET]
Table '3086083919 96' 9-max Seat #6 is the button
Seat 1: hcc2412 (96011 in chips) 
Seat 2: jcarlos.vale (33234 in chips) 
Seat 3: biscom2007 (23782 in chips) 
Seat 4: Garrik26 (62181 in chips) 
Seat 5: felipeando (77151 in chips) 
Seat 6: jordan202025 (4289 in chips) 
Seat 7: YaR1qq (29210 in chips) 
Seat 8: Negrata (11282 in chips) 
Seat 9: Mitnick.K.D. (22768 in chips) 
hcc2412: posts the ante 100
jcarlos.vale: posts the ante 100
biscom2007: posts the ante 100
Garrik26: posts the ante 100
felipeando: posts the ante 100
jordan202025: posts the ante 100
YaR1qq: posts the ante 100
Negrata: posts the ante 100
Mitnick.K.D.: posts the ante 100
YaR1qq: posts small blind 700
Negrata: posts big blind 1400
*** HOLE CARDS ***
Dealt to jcarlos.vale [5d Jd]
Mitnick.K.D.: folds 
hcc2412: folds 
jcarlos.vale: folds 
biscom2007: folds 
Garrik26: folds 
felipeando: folds 
jordan202025: folds 
YaR1qq: calls 700
Negrata: checks 
*** FLOP *** [Ac As Ad]
YaR1qq: checks 
Negrata: bets 9782 and is all-in
YaR1qq: folds 
Uncalled bet (9782) returned to Negrata
Negrata collected 3700 from pot
Negrata: doesn't show handDTO
*** SUMMARY ***
Total pot 3700 | Rake 0 
Board [Ac As Ad]
Seat 1: hcc2412 folded before Flop (didn't bet)
Seat 2: jcarlos.vale folded before Flop (didn't bet)
Seat 3: biscom2007 folded before Flop (didn't bet)
Seat 4: Garrik26 folded before Flop (didn't bet)
Seat 5: felipeando folded before Flop (didn't bet)
Seat 6: jordan202025 (button) folded before Flop (didn't bet)
Seat 7: YaR1qq (small blind) folded on the Flop
Seat 8: Negrata (big blind) collected (3700)
Seat 9: Mitnick.K.D. folded before Flop (didn't bet)



PokerStars Hand #222155924372: Tournament #3086083919, $0.49+$0.06 USD Hold'em No Limit - Level XIX (700/1400) - 2021/01/03 0:29:27 EET [2021/01/02 17:29:27 ET]
Table '3086083919 96' 9-max Seat #7 is the button
Seat 1: hcc2412 (95911 in chips) 
Seat 2: jcarlos.vale (33134 in chips) 
Seat 3: biscom2007 (23682 in chips) 
Seat 4: Garrik26 (62081 in chips) 
Seat 5: felipeando (77051 in chips) 
Seat 6: jordan202025 (4189 in chips) 
Seat 7: YaR1qq (27710 in chips) 
Seat 8: Negrata (13482 in chips) 
Seat 9: Mitnick.K.D. (22668 in chips) 
hcc2412: posts the ante 100
jcarlos.vale: posts the ante 100
biscom2007: posts the ante 100
Garrik26: posts the ante 100
felipeando: posts the ante 100
jordan202025: posts the ante 100
YaR1qq: posts the ante 100
Negrata: posts the ante 100
Mitnick.K.D.: posts the ante 100
Negrata: posts small blind 700
Mitnick.K.D.: posts big blind 1400
*** HOLE CARDS ***
Dealt to jcarlos.vale [Th 3h]
hcc2412: raises 1400 to 2800
jcarlos.vale: folds 
biscom2007: folds 
Garrik26: folds 
felipeando: folds 
jordan202025: folds 
YaR1qq: folds 
Negrata: folds 
Mitnick.K.D.: folds 
Uncalled bet (1400) returned to hcc2412
hcc2412 collected 4400 from pot
hcc2412: doesn't show handDTO
*** SUMMARY ***
Total pot 4400 | Rake 0 
Seat 1: hcc2412 collected (4400)
Seat 2: jcarlos.vale folded before Flop (didn't bet)
Seat 3: biscom2007 folded before Flop (didn't bet)
Seat 4: Garrik26 folded before Flop (didn't bet)
Seat 5: felipeando folded before Flop (didn't bet)
Seat 6: jordan202025 folded before Flop (didn't bet)
Seat 7: YaR1qq (button) folded before Flop (didn't bet)
Seat 8: Negrata (small blind) folded before Flop
Seat 9: Mitnick.K.D. (big blind) folded before Flop



PokerStars Hand #222155963664: Tournament #3086083919, $0.49+$0.06 USD Hold'em No Limit - Level XIX (700/1400) - 2021/01/03 0:30:11 EET [2021/01/02 17:30:11 ET]
Table '3086083919 96' 9-max Seat #8 is the button
Seat 1: hcc2412 (98811 in chips) 
Seat 2: jcarlos.vale (33034 in chips) 
Seat 3: biscom2007 (23582 in chips) 
Seat 4: Garrik26 (61981 in chips) 
Seat 5: felipeando (76951 in chips) 
Seat 6: jordan202025 (4089 in chips) 
Seat 7: YaR1qq (27610 in chips) 
Seat 8: Negrata (12682 in chips) 
Seat 9: Mitnick.K.D. (21168 in chips) 
hcc2412: posts the ante 100
jcarlos.vale: posts the ante 100
biscom2007: posts the ante 100
Garrik26: posts the ante 100
felipeando: posts the ante 100
jordan202025: posts the ante 100
YaR1qq: posts the ante 100
Negrata: posts the ante 100
Mitnick.K.D.: posts the ante 100
Mitnick.K.D.: posts small blind 700
hcc2412: posts big blind 1400
*** HOLE CARDS ***
Dealt to jcarlos.vale [2h 7h]
jcarlos.vale: folds 
biscom2007: folds 
Garrik26: folds 
felipeando: folds 
jordan202025: folds 
YaR1qq: folds 
Negrata: folds 
Mitnick.K.D. has timed out while disconnected
Mitnick.K.D.: folds 
Mitnick.K.D. is sitting out
Uncalled bet (700) returned to hcc2412
hcc2412 collected 2300 from pot
hcc2412: doesn't show handDTO
*** SUMMARY ***
Total pot 2300 | Rake 0 
Seat 1: hcc2412 (big blind) collected (2300)
Seat 2: jcarlos.vale folded before Flop (didn't bet)
Seat 3: biscom2007 folded before Flop (didn't bet)
Seat 4: Garrik26 folded before Flop (didn't bet)
Seat 5: felipeando folded before Flop (didn't bet)
Seat 6: jordan202025 folded before Flop (didn't bet)
Seat 7: YaR1qq folded before Flop (didn't bet)
Seat 8: Negrata (button) folded before Flop (didn't bet)
Seat 9: Mitnick.K.D. (small blind) folded before Flop



PokerStars Hand #222155990845: Tournament #3086083919, $0.49+$0.06 USD Hold'em No Limit - Level XIX (700/1400) - 2021/01/03 0:30:40 EET [2021/01/02 17:30:40 ET]
Table '3086083919 96' 9-max Seat #9 is the button
Seat 1: hcc2412 (100311 in chips) 
Seat 2: jcarlos.vale (32934 in chips) 
Seat 3: biscom2007 (23482 in chips) 
Seat 4: Garrik26 (61881 in chips) 
Seat 5: felipeando (76851 in chips) 
Seat 6: jordan202025 (3989 in chips) 
Seat 7: YaR1qq (27510 in chips) 
Seat 8: Negrata (12582 in chips) 
Seat 9: Mitnick.K.D. (20368 in chips) is sitting out
hcc2412: posts the ante 100
jcarlos.vale: posts the ante 100
biscom2007: posts the ante 100
Garrik26: posts the ante 100
felipeando: posts the ante 100
jordan202025: posts the ante 100
YaR1qq: posts the ante 100
Negrata: posts the ante 100
Mitnick.K.D.: posts the ante 100
hcc2412: posts small blind 700
jcarlos.vale: posts big blind 1400
*** HOLE CARDS ***
Dealt to jcarlos.vale [9h Qs]
biscom2007: folds 
Garrik26: folds 
felipeando: folds 
Mitnick.K.D. has returned
jordan202025: raises 2489 to 3889 and is all-in
YaR1qq: folds 
Negrata: folds 
Mitnick.K.D.: raises 16379 to 20268 and is all-in
hcc2412: folds 
jcarlos.vale: folds 
Uncalled bet (16379) returned to Mitnick.K.D.
*** FLOP *** [4h Qc 8c]
*** TURN *** [4h Qc 8c] [Qh]
*** RIVER *** [4h Qc 8c Qh] [5c]
*** SHOW DOWN ***
jordan202025: shows [7s Ac] (a pair of Queens)
Mitnick.K.D.: shows [Jh Jc] (two pair, Queens and Jacks)
Mitnick.K.D. collected 10778 from pot
jordan202025 finished the tournament in 328th place and received $1.45.
*** SUMMARY ***
Total pot 10778 | Rake 0 
Board [4h Qc 8c Qh 5c]
Seat 1: hcc2412 (small blind) folded before Flop
Seat 2: jcarlos.vale (big blind) folded before Flop
Seat 3: biscom2007 folded before Flop (didn't bet)
Seat 4: Garrik26 folded before Flop (didn't bet)
Seat 5: felipeando folded before Flop (didn't bet)
Seat 6: jordan202025 showed [7s Ac] and lost with a pair of Queens
Seat 7: YaR1qq folded before Flop (didn't bet)
Seat 8: Negrata folded before Flop (didn't bet)
Seat 9: Mitnick.K.D. (button) showed [Jh Jc] and won (10778) with two pair, Queens and Jacks



PokerStars Hand #222156023764: Tournament #3086083919, $0.49+$0.06 USD Hold'em No Limit - Level XX (800/1600) - 2021/01/03 0:31:15 EET [2021/01/02 17:31:15 ET]
Table '3086083919 96' 9-max Seat #1 is the button
Seat 1: hcc2412 (99511 in chips) 
Seat 2: jcarlos.vale (31434 in chips) 
Seat 3: biscom2007 (23382 in chips) 
Seat 4: Garrik26 (61781 in chips) 
Seat 5: felipeando (76751 in chips) 
Seat 7: YaR1qq (27410 in chips) 
Seat 8: Negrata (12482 in chips) 
Seat 9: Mitnick.K.D. (27157 in chips) 
hcc2412: posts the ante 125
jcarlos.vale: posts the ante 125
biscom2007: posts the ante 125
Garrik26: posts the ante 125
felipeando: posts the ante 125
YaR1qq: posts the ante 125
Negrata: posts the ante 125
Mitnick.K.D.: posts the ante 125
jcarlos.vale: posts small blind 800
biscom2007: posts big blind 1600
*** HOLE CARDS ***
Dealt to jcarlos.vale [7c Ad]
Garrik26: folds 
felipeando: folds 
YaR1qq: folds 
Negrata: folds 
Mitnick.K.D.: folds 
hcc2412: raises 1600 to 3200
jcarlos.vale: folds 
biscom2007: folds 
Uncalled bet (1600) returned to hcc2412
hcc2412 collected 5000 from pot
hcc2412: doesn't show handDTO
*** SUMMARY ***
Total pot 5000 | Rake 0 
Seat 1: hcc2412 (button) collected (5000)
Seat 2: jcarlos.vale (small blind) folded before Flop
Seat 3: biscom2007 (big blind) folded before Flop
Seat 4: Garrik26 folded before Flop (didn't bet)
Seat 5: felipeando folded before Flop (didn't bet)
Seat 7: YaR1qq folded before Flop (didn't bet)
Seat 8: Negrata folded before Flop (didn't bet)
Seat 9: Mitnick.K.D. folded before Flop (didn't bet)



PokerStars Hand #222156044862: Tournament #3086083919, $0.49+$0.06 USD Hold'em No Limit - Level XX (800/1600) - 2021/01/03 0:31:38 EET [2021/01/02 17:31:38 ET]
Table '3086083919 96' 9-max Seat #2 is the button
Seat 1: hcc2412 (102786 in chips) 
Seat 2: jcarlos.vale (30509 in chips) 
Seat 3: biscom2007 (21657 in chips) 
Seat 4: Garrik26 (61656 in chips) 
Seat 5: felipeando (76626 in chips) 
Seat 7: YaR1qq (27285 in chips) 
Seat 8: Negrata (12357 in chips) 
Seat 9: Mitnick.K.D. (27032 in chips) 
hcc2412: posts the ante 125
jcarlos.vale: posts the ante 125
biscom2007: posts the ante 125
Garrik26: posts the ante 125
felipeando: posts the ante 125
YaR1qq: posts the ante 125
Negrata: posts the ante 125
Mitnick.K.D.: posts the ante 125
biscom2007: posts small blind 800
Garrik26: posts big blind 1600
*** HOLE CARDS ***
Dealt to jcarlos.vale [7d 3d]
felipeando: folds 
YaR1qq: folds 
Negrata: calls 1600
Mitnick.K.D.: folds 
hcc2412: folds 
jcarlos.vale: folds 
biscom2007: calls 800
Garrik26: checks 
*** FLOP *** [3s 6d As]
biscom2007: checks 
Garrik26: checks 
Negrata: checks 
*** TURN *** [3s 6d As] [3h]
biscom2007: bets 1600
Garrik26: folds 
Negrata: calls 1600
*** RIVER *** [3s 6d As 3h] [Jd]
biscom2007: checks 
Negrata: bets 4500
biscom2007: folds 
Uncalled bet (4500) returned to Negrata
Negrata collected 9000 from pot
Negrata: doesn't show handDTO
*** SUMMARY ***
Total pot 9000 | Rake 0 
Board [3s 6d As 3h Jd]
Seat 1: hcc2412 folded before Flop (didn't bet)
Seat 2: jcarlos.vale (button) folded before Flop (didn't bet)
Seat 3: biscom2007 (small blind) folded on the River
Seat 4: Garrik26 (big blind) folded on the Turn
Seat 5: felipeando folded before Flop (didn't bet)
Seat 7: YaR1qq folded before Flop (didn't bet)
Seat 8: Negrata collected (9000)
Seat 9: Mitnick.K.D. folded before Flop (didn't bet)



PokerStars Hand #222156102990: Tournament #3086083919, $0.49+$0.06 USD Hold'em No Limit - Level XX (800/1600) - 2021/01/03 0:32:40 EET [2021/01/02 17:32:40 ET]
Table '3086083919 96' 9-max Seat #3 is the button
Seat 1: hcc2412 (102661 in chips) 
Seat 2: jcarlos.vale (30384 in chips) 
Seat 3: biscom2007 (18332 in chips) 
Seat 4: Garrik26 (59931 in chips) 
Seat 5: felipeando (76501 in chips) 
Seat 6: Stickes1987 (27805 in chips) 
Seat 7: YaR1qq (27160 in chips) 
Seat 8: Negrata (18032 in chips) 
Seat 9: Mitnick.K.D. (26907 in chips) 
hcc2412: posts the ante 125
jcarlos.vale: posts the ante 125
biscom2007: posts the ante 125
Garrik26: posts the ante 125
felipeando: posts the ante 125
Stickes1987: posts the ante 125
YaR1qq: posts the ante 125
Negrata: posts the ante 125
Mitnick.K.D.: posts the ante 125
Garrik26: posts small blind 800
felipeando: posts big blind 1600
*** HOLE CARDS ***
Dealt to jcarlos.vale [Kd Jd]
Stickes1987: folds 
YaR1qq: folds 
Negrata: folds 
Mitnick.K.D.: calls 1600
hcc2412: calls 1600
jcarlos.vale: calls 1600
biscom2007: folds 
Garrik26: folds 
felipeando: checks 
*** FLOP *** [4c Ah 5s]
felipeando: checks 
Mitnick.K.D.: checks 
hcc2412: checks 
jcarlos.vale: checks 
*** TURN *** [4c Ah 5s] [8d]
felipeando: checks 
Mitnick.K.D.: checks 
hcc2412: checks 
jcarlos.vale: bets 3200
felipeando: folds 
Mitnick.K.D.: folds 
hcc2412: folds 
Uncalled bet (3200) returned to jcarlos.vale
jcarlos.vale collected 8325 from pot
jcarlos.vale: doesn't show handDTO
*** SUMMARY ***
Total pot 8325 | Rake 0 
Board [4c Ah 5s 8d]
Seat 1: hcc2412 folded on the Turn
Seat 2: jcarlos.vale collected (8325)
Seat 3: biscom2007 (button) folded before Flop (didn't bet)
Seat 4: Garrik26 (small blind) folded before Flop
Seat 5: felipeando (big blind) folded on the Turn
Seat 6: Stickes1987 folded before Flop (didn't bet)
Seat 7: YaR1qq folded before Flop (didn't bet)
Seat 8: Negrata folded before Flop (didn't bet)
Seat 9: Mitnick.K.D. folded on the Turn



PokerStars Hand #222156160316: Tournament #3086083919, $0.49+$0.06 USD Hold'em No Limit - Level XX (800/1600) - 2021/01/03 0:33:40 EET [2021/01/02 17:33:40 ET]
Table '3086083919 96' 9-max Seat #4 is the button
Seat 1: hcc2412 (100936 in chips) 
Seat 2: jcarlos.vale (36984 in chips) 
Seat 3: biscom2007 (18207 in chips) 
Seat 4: Garrik26 (59006 in chips) 
Seat 5: felipeando (74776 in chips) 
Seat 6: Stickes1987 (27680 in chips) 
Seat 7: YaR1qq (27035 in chips) 
Seat 8: Negrata (17907 in chips) 
Seat 9: Mitnick.K.D. (25182 in chips) 
hcc2412: posts the ante 125
jcarlos.vale: posts the ante 125
biscom2007: posts the ante 125
Garrik26: posts the ante 125
felipeando: posts the ante 125
Stickes1987: posts the ante 125
YaR1qq: posts the ante 125
Negrata: posts the ante 125
Mitnick.K.D.: posts the ante 125
felipeando: posts small blind 800
Stickes1987: posts big blind 1600
*** HOLE CARDS ***
Dealt to jcarlos.vale [Ts Kh]
YaR1qq: raises 1600 to 3200
Negrata: folds 
Mitnick.K.D.: folds 
hcc2412: folds 
jcarlos.vale: folds 
biscom2007: folds 
Garrik26: folds 
felipeando: folds 
Stickes1987: folds 
Uncalled bet (1600) returned to YaR1qq
YaR1qq collected 5125 from pot
YaR1qq: doesn't show handDTO
*** SUMMARY ***
Total pot 5125 | Rake 0 
Seat 1: hcc2412 folded before Flop (didn't bet)
Seat 2: jcarlos.vale folded before Flop (didn't bet)
Seat 3: biscom2007 folded before Flop (didn't bet)
Seat 4: Garrik26 (button) folded before Flop (didn't bet)
Seat 5: felipeando (small blind) folded before Flop
Seat 6: Stickes1987 (big blind) folded before Flop
Seat 7: YaR1qq collected (5125)
Seat 8: Negrata folded before Flop (didn't bet)
Seat 9: Mitnick.K.D. folded before Flop (didn't bet)



PokerStars Hand #222156178231: Tournament #3086083919, $0.49+$0.06 USD Hold'em No Limit - Level XX (800/1600) - 2021/01/03 0:34:00 EET [2021/01/02 17:34:00 ET]
Table '3086083919 96' 9-max Seat #5 is the button
Seat 1: hcc2412 (100811 in chips) 
Seat 2: jcarlos.vale (36859 in chips) 
Seat 3: biscom2007 (18082 in chips) 
Seat 4: Garrik26 (58881 in chips) 
Seat 5: felipeando (73851 in chips) 
Seat 6: Stickes1987 (25955 in chips) 
Seat 7: YaR1qq (30435 in chips) 
Seat 8: Negrata (17782 in chips) 
Seat 9: Mitnick.K.D. (25057 in chips) 
hcc2412: posts the ante 125
jcarlos.vale: posts the ante 125
biscom2007: posts the ante 125
Garrik26: posts the ante 125
felipeando: posts the ante 125
Stickes1987: posts the ante 125
YaR1qq: posts the ante 125
Negrata: posts the ante 125
Mitnick.K.D.: posts the ante 125
Stickes1987: posts small blind 800
YaR1qq: posts big blind 1600
*** HOLE CARDS ***
Dealt to jcarlos.vale [2s 2h]
Negrata: folds 
Mitnick.K.D.: raises 2400 to 4000
hcc2412: calls 4000
jcarlos.vale: folds 
biscom2007: folds 
Garrik26: folds 
felipeando: folds 
Stickes1987: folds 
YaR1qq: calls 2400
*** FLOP *** [8c Kd 3h]
YaR1qq: checks 
Mitnick.K.D.: bets 9283
hcc2412: folds 
YaR1qq: folds 
Uncalled bet (9283) returned to Mitnick.K.D.
Mitnick.K.D. collected 13925 from pot
Mitnick.K.D.: doesn't show handDTO
*** SUMMARY ***
Total pot 13925 | Rake 0 
Board [8c Kd 3h]
Seat 1: hcc2412 folded on the Flop
Seat 2: jcarlos.vale folded before Flop (didn't bet)
Seat 3: biscom2007 folded before Flop (didn't bet)
Seat 4: Garrik26 folded before Flop (didn't bet)
Seat 5: felipeando (button) folded before Flop (didn't bet)
Seat 6: Stickes1987 (small blind) folded before Flop
Seat 7: YaR1qq (big blind) folded on the Flop
Seat 8: Negrata folded before Flop (didn't bet)
Seat 9: Mitnick.K.D. collected (13925)



PokerStars Hand #222156212213: Tournament #3086083919, $0.49+$0.06 USD Hold'em No Limit - Level XX (800/1600) - 2021/01/03 0:34:36 EET [2021/01/02 17:34:36 ET]
Table '3086083919 96' 9-max Seat #6 is the button
Seat 1: hcc2412 (96686 in chips) 
Seat 2: jcarlos.vale (36734 in chips) 
Seat 3: biscom2007 (17957 in chips) 
Seat 4: Garrik26 (58756 in chips) 
Seat 5: felipeando (73726 in chips) 
Seat 6: Stickes1987 (25030 in chips) 
Seat 7: YaR1qq (26310 in chips) 
Seat 8: Negrata (17657 in chips) 
Seat 9: Mitnick.K.D. (34857 in chips) 
hcc2412: posts the ante 125
jcarlos.vale: posts the ante 125
biscom2007: posts the ante 125
Garrik26: posts the ante 125
felipeando: posts the ante 125
Stickes1987: posts the ante 125
YaR1qq: posts the ante 125
Negrata: posts the ante 125
Mitnick.K.D.: posts the ante 125
YaR1qq: posts small blind 800
Negrata: posts big blind 1600
*** HOLE CARDS ***
Dealt to jcarlos.vale [As 6c]
Mitnick.K.D.: folds 
hcc2412: folds 
jcarlos.vale: folds 
biscom2007: folds 
Garrik26: folds 
felipeando: folds 
Stickes1987: raises 2400 to 4000
YaR1qq: folds 
Negrata: folds 
Uncalled bet (2400) returned to Stickes1987
Stickes1987 collected 5125 from pot
Stickes1987: doesn't show handDTO
*** SUMMARY ***
Total pot 5125 | Rake 0 
Seat 1: hcc2412 folded before Flop (didn't bet)
Seat 2: jcarlos.vale folded before Flop (didn't bet)
Seat 3: biscom2007 folded before Flop (didn't bet)
Seat 4: Garrik26 folded before Flop (didn't bet)
Seat 5: felipeando folded before Flop (didn't bet)
Seat 6: Stickes1987 (button) collected (5125)
Seat 7: YaR1qq (small blind) folded before Flop
Seat 8: Negrata (big blind) folded before Flop
Seat 9: Mitnick.K.D. folded before Flop (didn't bet)



PokerStars Hand #222156239098: Tournament #3086083919, $0.49+$0.06 USD Hold'em No Limit - Level XX (800/1600) - 2021/01/03 0:35:04 EET [2021/01/02 17:35:04 ET]
Table '3086083919 96' 9-max Seat #7 is the button
Seat 1: hcc2412 (96561 in chips) 
Seat 2: jcarlos.vale (36609 in chips) 
Seat 3: biscom2007 (17832 in chips) 
Seat 4: Garrik26 (58631 in chips) 
Seat 5: felipeando (73601 in chips) 
Seat 6: Stickes1987 (28430 in chips) 
Seat 7: YaR1qq (25385 in chips) 
Seat 8: Negrata (15932 in chips) 
Seat 9: Mitnick.K.D. (34732 in chips) 
hcc2412: posts the ante 125
jcarlos.vale: posts the ante 125
biscom2007: posts the ante 125
Garrik26: posts the ante 125
felipeando: posts the ante 125
Stickes1987: posts the ante 125
YaR1qq: posts the ante 125
Negrata: posts the ante 125
Mitnick.K.D.: posts the ante 125
Negrata: posts small blind 800
Mitnick.K.D.: posts big blind 1600
*** HOLE CARDS ***
Dealt to jcarlos.vale [4h 9d]
hcc2412: folds 
jcarlos.vale: folds 
biscom2007: folds 
Garrik26: folds 
felipeando: folds 
Stickes1987: folds 
YaR1qq: folds 
Negrata: folds 
Uncalled bet (800) returned to Mitnick.K.D.
Mitnick.K.D. collected 2725 from pot
Mitnick.K.D.: doesn't show handDTO
*** SUMMARY ***
Total pot 2725 | Rake 0 
Seat 1: hcc2412 folded before Flop (didn't bet)
Seat 2: jcarlos.vale folded before Flop (didn't bet)
Seat 3: biscom2007 folded before Flop (didn't bet)
Seat 4: Garrik26 folded before Flop (didn't bet)
Seat 5: felipeando folded before Flop (didn't bet)
Seat 6: Stickes1987 folded before Flop (didn't bet)
Seat 7: YaR1qq (button) folded before Flop (didn't bet)
Seat 8: Negrata (small blind) folded before Flop
Seat 9: Mitnick.K.D. (big blind) collected (2725)



PokerStars Hand #222156256554: Tournament #3086083919, $0.49+$0.06 USD Hold'em No Limit - Level XX (800/1600) - 2021/01/03 0:35:23 EET [2021/01/02 17:35:23 ET]
Table '3086083919 96' 9-max Seat #8 is the button
Seat 1: hcc2412 (96436 in chips) 
Seat 2: jcarlos.vale (36484 in chips) 
Seat 3: biscom2007 (17707 in chips) 
Seat 4: Garrik26 (58506 in chips) 
Seat 5: felipeando (73476 in chips) 
Seat 6: Stickes1987 (28305 in chips) 
Seat 7: YaR1qq (25260 in chips) 
Seat 8: Negrata (15007 in chips) 
Seat 9: Mitnick.K.D. (36532 in chips) 
hcc2412: posts the ante 125
jcarlos.vale: posts the ante 125
biscom2007: posts the ante 125
Garrik26: posts the ante 125
felipeando: posts the ante 125
Stickes1987: posts the ante 125
YaR1qq: posts the ante 125
Negrata: posts the ante 125
Mitnick.K.D.: posts the ante 125
Mitnick.K.D.: posts small blind 800
hcc2412: posts big blind 1600
*** HOLE CARDS ***
Dealt to jcarlos.vale [7s 2c]
jcarlos.vale: folds 
biscom2007: folds 
Garrik26: folds 
felipeando: raises 1600 to 3200
Stickes1987: calls 3200
YaR1qq: folds 
Negrata: folds 
Mitnick.K.D.: folds 
hcc2412: calls 1600
*** FLOP *** [Th Jc Jd]
hcc2412: checks 
felipeando: bets 3803
Stickes1987: folds 
hcc2412: calls 3803
*** TURN *** [Th Jc Jd] [8h]
hcc2412: checks 
felipeando: checks 
*** RIVER *** [Th Jc Jd 8h] [6s]
hcc2412: bets 9566
felipeando: folds 
Uncalled bet (9566) returned to hcc2412
hcc2412 collected 19131 from pot
hcc2412: doesn't show handDTO
*** SUMMARY ***
Total pot 19131 | Rake 0 
Board [Th Jc Jd 8h 6s]
Seat 1: hcc2412 (big blind) collected (19131)
Seat 2: jcarlos.vale folded before Flop (didn't bet)
Seat 3: biscom2007 folded before Flop (didn't bet)
Seat 4: Garrik26 folded before Flop (didn't bet)
Seat 5: felipeando folded on the River
Seat 6: Stickes1987 folded on the Flop
Seat 7: YaR1qq folded before Flop (didn't bet)
Seat 8: Negrata (button) folded before Flop (didn't bet)
Seat 9: Mitnick.K.D. (small blind) folded before Flop



PokerStars Hand #222156326146: Tournament #3086083919, $0.49+$0.06 USD Hold'em No Limit - Level XX (800/1600) - 2021/01/03 0:36:30 EET [2021/01/02 17:36:30 ET]
Table '3086083919 96' 9-max Seat #9 is the button
Seat 1: hcc2412 (108439 in chips) 
Seat 2: jcarlos.vale (36359 in chips) 
Seat 3: biscom2007 (17582 in chips) 
Seat 4: Garrik26 (58381 in chips) 
Seat 5: felipeando (66348 in chips) 
Seat 6: Stickes1987 (24980 in chips) 
Seat 7: YaR1qq (25135 in chips) 
Seat 8: Negrata (14882 in chips) 
Seat 9: Mitnick.K.D. (35607 in chips) 
hcc2412: posts the ante 125
jcarlos.vale: posts the ante 125
biscom2007: posts the ante 125
Garrik26: posts the ante 125
felipeando: posts the ante 125
Stickes1987: posts the ante 125
YaR1qq: posts the ante 125
Negrata: posts the ante 125
Mitnick.K.D.: posts the ante 125
hcc2412: posts small blind 800
jcarlos.vale: posts big blind 1600
*** HOLE CARDS ***
Dealt to jcarlos.vale [Kh Js]
biscom2007: calls 1600
Garrik26: folds 
felipeando: folds 
Stickes1987: folds 
YaR1qq: folds 
Negrata: calls 1600
Mitnick.K.D.: folds 
hcc2412: calls 800
jcarlos.vale: checks 
*** FLOP *** [Qs 6h Jd]
hcc2412: checks 
jcarlos.vale: bets 1600
biscom2007: folds 
Negrata: folds 
hcc2412: calls 1600
*** TURN *** [Qs 6h Jd] [7s]
hcc2412: checks 
jcarlos.vale: checks 
*** RIVER *** [Qs 6h Jd 7s] [2d]
hcc2412: checks 
jcarlos.vale: checks 
*** SHOW DOWN ***
hcc2412: shows [6d Th] (a pair of Sixes)
jcarlos.vale: shows [Kh Js] (a pair of Jacks)
jcarlos.vale collected 10725 from pot
*** SUMMARY ***
Total pot 10725 | Rake 0 
Board [Qs 6h Jd 7s 2d]
Seat 1: hcc2412 (small blind) showed [6d Th] and lost with a pair of Sixes
Seat 2: jcarlos.vale (big blind) showed [Kh Js] and won (10725) with a pair of Jacks
Seat 3: biscom2007 folded on the Flop
Seat 4: Garrik26 folded before Flop (didn't bet)
Seat 5: felipeando folded before Flop (didn't bet)
Seat 6: Stickes1987 folded before Flop (didn't bet)
Seat 7: YaR1qq folded before Flop (didn't bet)
Seat 8: Negrata folded on the Flop
Seat 9: Mitnick.K.D. (button) folded before Flop (didn't bet)



PokerStars Hand #222156377573: Tournament #3086083919, $0.49+$0.06 USD Hold'em No Limit - Level XX (800/1600) - 2021/01/03 0:37:25 EET [2021/01/02 17:37:25 ET]
Table '3086083919 96' 9-max Seat #1 is the button
Seat 1: hcc2412 (105114 in chips) 
Seat 2: jcarlos.vale (43759 in chips) 
Seat 3: biscom2007 (15857 in chips) 
Seat 4: Garrik26 (58256 in chips) 
Seat 5: felipeando (66223 in chips) 
Seat 6: Stickes1987 (24855 in chips) 
Seat 7: YaR1qq (25010 in chips) 
Seat 8: Negrata (13157 in chips) 
Seat 9: Mitnick.K.D. (35482 in chips) 
hcc2412: posts the ante 125
jcarlos.vale: posts the ante 125
biscom2007: posts the ante 125
Garrik26: posts the ante 125
felipeando: posts the ante 125
Stickes1987: posts the ante 125
YaR1qq: posts the ante 125
Negrata: posts the ante 125
Mitnick.K.D.: posts the ante 125
jcarlos.vale: posts small blind 800
biscom2007: posts big blind 1600
*** HOLE CARDS ***
Dealt to jcarlos.vale [9c Ts]
Garrik26: folds 
felipeando: folds 
Stickes1987: folds 
YaR1qq: folds 
Negrata: folds 
Mitnick.K.D.: folds 
hcc2412: raises 1600 to 3200
jcarlos.vale: folds 
biscom2007: folds 
Uncalled bet (1600) returned to hcc2412
hcc2412 collected 5125 from pot
hcc2412: doesn't show handDTO
*** SUMMARY ***
Total pot 5125 | Rake 0 
Seat 1: hcc2412 (button) collected (5125)
Seat 2: jcarlos.vale (small blind) folded before Flop
Seat 3: biscom2007 (big blind) folded before Flop
Seat 4: Garrik26 folded before Flop (didn't bet)
Seat 5: felipeando folded before Flop (didn't bet)
Seat 6: Stickes1987 folded before Flop (didn't bet)
Seat 7: YaR1qq folded before Flop (didn't bet)
Seat 8: Negrata folded before Flop (didn't bet)
Seat 9: Mitnick.K.D. folded before Flop (didn't bet)



PokerStars Hand #222156420805: Tournament #3086083919, $0.49+$0.06 USD Hold'em No Limit - Level XX (800/1600) - 2021/01/03 0:38:02 EET [2021/01/02 17:38:02 ET]
Table '3086083919 96' 9-max Seat #2 is the button
Seat 1: hcc2412 (108514 in chips) 
Seat 2: jcarlos.vale (42834 in chips) 
Seat 3: biscom2007 (14132 in chips) 
Seat 4: Garrik26 (58131 in chips) 
Seat 5: felipeando (66098 in chips) 
Seat 6: Stickes1987 (24730 in chips) 
Seat 7: YaR1qq (24885 in chips) 
Seat 8: Negrata (13032 in chips) 
Seat 9: Mitnick.K.D. (35357 in chips) 
hcc2412: posts the ante 125
jcarlos.vale: posts the ante 125
biscom2007: posts the ante 125
Garrik26: posts the ante 125
felipeando: posts the ante 125
Stickes1987: posts the ante 125
YaR1qq: posts the ante 125
Negrata: posts the ante 125
Mitnick.K.D.: posts the ante 125
biscom2007: posts small blind 800
Garrik26: posts big blind 1600
*** HOLE CARDS ***
Dealt to jcarlos.vale [Ks 6c]
felipeando: folds 
Stickes1987: folds 
YaR1qq: folds 
Negrata: folds 
Mitnick.K.D.: folds 
hcc2412: raises 1600 to 3200
jcarlos.vale: folds 
biscom2007: folds 
Garrik26: folds 
Uncalled bet (1600) returned to hcc2412
hcc2412 collected 5125 from pot
hcc2412: doesn't show handDTO
*** SUMMARY ***
Total pot 5125 | Rake 0 
Seat 1: hcc2412 collected (5125)
Seat 2: jcarlos.vale (button) folded before Flop (didn't bet)
Seat 3: biscom2007 (small blind) folded before Flop
Seat 4: Garrik26 (big blind) folded before Flop
Seat 5: felipeando folded before Flop (didn't bet)
Seat 6: Stickes1987 folded before Flop (didn't bet)
Seat 7: YaR1qq folded before Flop (didn't bet)
Seat 8: Negrata folded before Flop (didn't bet)
Seat 9: Mitnick.K.D. folded before Flop (didn't bet)



PokerStars Hand #222156441887: Tournament #3086083919, $0.49+$0.06 USD Hold'em No Limit - Level XX (800/1600) - 2021/01/03 0:38:25 EET [2021/01/02 17:38:25 ET]
Table '3086083919 96' 9-max Seat #3 is the button
Seat 1: hcc2412 (111914 in chips) 
Seat 2: jcarlos.vale (42709 in chips) 
Seat 3: biscom2007 (13207 in chips) 
Seat 4: Garrik26 (56406 in chips) 
Seat 5: felipeando (65973 in chips) 
Seat 6: Stickes1987 (24605 in chips) 
Seat 7: YaR1qq (24760 in chips) 
Seat 8: Negrata (12907 in chips) 
Seat 9: Mitnick.K.D. (35232 in chips) 
hcc2412: posts the ante 125
jcarlos.vale: posts the ante 125
biscom2007: posts the ante 125
Garrik26: posts the ante 125
felipeando: posts the ante 125
Stickes1987: posts the ante 125
YaR1qq: posts the ante 125
Negrata: posts the ante 125
Mitnick.K.D.: posts the ante 125
Garrik26: posts small blind 800
felipeando: posts big blind 1600
*** HOLE CARDS ***
Dealt to jcarlos.vale [2s Ac]
Stickes1987: folds 
YaR1qq: folds 
Negrata: folds 
Mitnick.K.D.: folds 
hcc2412: folds 
jcarlos.vale: folds 
biscom2007: folds 
Garrik26: folds 
Uncalled bet (800) returned to felipeando
felipeando collected 2725 from pot
felipeando: doesn't show handDTO
*** SUMMARY ***
Total pot 2725 | Rake 0 
Seat 1: hcc2412 folded before Flop (didn't bet)
Seat 2: jcarlos.vale folded before Flop (didn't bet)
Seat 3: biscom2007 (button) folded before Flop (didn't bet)
Seat 4: Garrik26 (small blind) folded before Flop
Seat 5: felipeando (big blind) collected (2725)
Seat 6: Stickes1987 folded before Flop (didn't bet)
Seat 7: YaR1qq folded before Flop (didn't bet)
Seat 8: Negrata folded before Flop (didn't bet)
Seat 9: Mitnick.K.D. folded before Flop (didn't bet)



PokerStars Hand #222156457445: Tournament #3086083919, $0.49+$0.06 USD Hold'em No Limit - Level XX (800/1600) - 2021/01/03 0:38:41 EET [2021/01/02 17:38:41 ET]
Table '3086083919 96' 9-max Seat #4 is the button
Seat 2: jcarlos.vale (42584 in chips) 
Seat 3: biscom2007 (13082 in chips) 
Seat 4: Garrik26 (55481 in chips) 
Seat 5: felipeando (67773 in chips) 
Seat 6: Stickes1987 (24480 in chips) 
Seat 7: YaR1qq (24635 in chips) 
Seat 8: Negrata (12782 in chips) 
Seat 9: Mitnick.K.D. (35107 in chips) 
jcarlos.vale: posts the ante 125
biscom2007: posts the ante 125
Garrik26: posts the ante 125
felipeando: posts the ante 125
Stickes1987: posts the ante 125
YaR1qq: posts the ante 125
Negrata: posts the ante 125
Mitnick.K.D.: posts the ante 125
felipeando: posts small blind 800
Stickes1987: posts big blind 1600
*** HOLE CARDS ***
Dealt to jcarlos.vale [3d 7d]
YaR1qq: calls 1600
Negrata: folds 
Mitnick.K.D.: folds 
jcarlos.vale: folds 
biscom2007: folds 
Garrik26: folds 
felipeando: calls 800
Stickes1987: checks 
*** FLOP *** [5d Qd 9h]
felipeando: checks 
Stickes1987: checks 
YaR1qq: checks 
*** TURN *** [5d Qd 9h] [2d]
felipeando: bets 2726
Stickes1987: folds 
YaR1qq: calls 2726
*** RIVER *** [5d Qd 9h 2d] [7c]
felipeando: bets 7989
YaR1qq: calls 7989
*** SHOW DOWN ***
felipeando: shows [Ad 9d] (a flush, Ace high)
YaR1qq: mucks handDTO
felipeando collected 27230 from pot
*** SUMMARY ***
Total pot 27230 | Rake 0 
Board [5d Qd 9h 2d 7c]
Seat 2: jcarlos.vale folded before Flop (didn't bet)
Seat 3: biscom2007 folded before Flop (didn't bet)
Seat 4: Garrik26 (button) folded before Flop (didn't bet)
Seat 5: felipeando (small blind) showed [Ad 9d] and won (27230) with a flush, Ace high
Seat 6: Stickes1987 (big blind) folded on the Turn
Seat 7: YaR1qq mucked [Qs Qc]
Seat 8: Negrata folded before Flop (didn't bet)
Seat 9: Mitnick.K.D. folded before Flop (didn't bet)



PokerStars Hand #222156502223: Tournament #3086083919, $0.49+$0.06 USD Hold'em No Limit - Level XX (800/1600) - 2021/01/03 0:39:29 EET [2021/01/02 17:39:29 ET]
Table '3086083919 96' 9-max Seat #5 is the button
Seat 1: all sebas in (41838 in chips) 
Seat 2: jcarlos.vale (42459 in chips) 
Seat 3: biscom2007 (12957 in chips) 
Seat 4: Garrik26 (55356 in chips) 
Seat 5: felipeando (82563 in chips) 
Seat 6: Stickes1987 (22755 in chips) 
Seat 7: YaR1qq (12195 in chips) 
Seat 8: Negrata (12657 in chips) 
Seat 9: Mitnick.K.D. (34982 in chips) 
all sebas in: posts the ante 125
jcarlos.vale: posts the ante 125
biscom2007: posts the ante 125
Garrik26: posts the ante 125
felipeando: posts the ante 125
Stickes1987: posts the ante 125
YaR1qq: posts the ante 125
Negrata: posts the ante 125
Mitnick.K.D.: posts the ante 125
Stickes1987: posts small blind 800
YaR1qq: posts big blind 1600
*** HOLE CARDS ***
Dealt to jcarlos.vale [4s 7h]
Negrata: folds 
Mitnick.K.D.: folds 
all sebas in: folds 
jcarlos.vale: folds 
biscom2007: folds 
Garrik26: raises 53631 to 55231 and is all-in
felipeando: folds 
Stickes1987: folds 
YaR1qq: calls 10470 and is all-in
Uncalled bet (43161) returned to Garrik26
*** FLOP *** [Jc 2d 3d]
*** TURN *** [Jc 2d 3d] [Tc]
*** RIVER *** [Jc 2d 3d Tc] [7c]
*** SHOW DOWN ***
YaR1qq: shows [6h 6d] (a pair of Sixes)
Garrik26: shows [Qd Ad] (high pairOfCards Ace)
YaR1qq collected 26065 from pot
*** SUMMARY ***
Total pot 26065 | Rake 0 
Board [Jc 2d 3d Tc 7c]
Seat 1: all sebas in folded before Flop (didn't bet)
Seat 2: jcarlos.vale folded before Flop (didn't bet)
Seat 3: biscom2007 folded before Flop (didn't bet)
Seat 4: Garrik26 showed [Qd Ad] and lost with high pairOfCards Ace
Seat 5: felipeando (button) folded before Flop (didn't bet)
Seat 6: Stickes1987 (small blind) folded before Flop
Seat 7: YaR1qq (big blind) showed [6h 6d] and won (26065) with a pair of Sixes
Seat 8: Negrata folded before Flop (didn't bet)
Seat 9: Mitnick.K.D. folded before Flop (didn't bet)



PokerStars Hand #222156528288: Tournament #3086083919, $0.49+$0.06 USD Hold'em No Limit - Level XX (800/1600) - 2021/01/03 0:39:58 EET [2021/01/02 17:39:58 ET]
Table '3086083919 96' 9-max Seat #6 is the button
Seat 1: all sebas in (41713 in chips) 
Seat 2: jcarlos.vale (42334 in chips) 
Seat 3: biscom2007 (12832 in chips) 
Seat 4: Garrik26 (43161 in chips) 
Seat 5: felipeando (82438 in chips) 
Seat 6: Stickes1987 (21830 in chips) 
Seat 7: YaR1qq (26065 in chips) 
Seat 8: Negrata (12532 in chips) 
Seat 9: Mitnick.K.D. (34857 in chips) 
all sebas in: posts the ante 125
jcarlos.vale: posts the ante 125
biscom2007: posts the ante 125
Garrik26: posts the ante 125
felipeando: posts the ante 125
Stickes1987: posts the ante 125
YaR1qq: posts the ante 125
Negrata: posts the ante 125
Mitnick.K.D.: posts the ante 125
YaR1qq: posts small blind 800
Negrata: posts big blind 1600
*** HOLE CARDS ***
Dealt to jcarlos.vale [Ac 4s]
Mitnick.K.D.: folds 
all sebas in: calls 1600
jcarlos.vale: folds 
biscom2007: folds 
Garrik26: folds 
felipeando: folds 
Stickes1987: folds 
YaR1qq: calls 800
Negrata: checks 
*** FLOP *** [Ad Tc As]
YaR1qq: checks 
Negrata: checks 
all sebas in: bets 39988 and is all-in
YaR1qq: folds 
Negrata: folds 
Uncalled bet (39988) returned to all sebas in
all sebas in collected 5925 from pot
*** SUMMARY ***
Total pot 5925 | Rake 0 
Board [Ad Tc As]
Seat 1: all sebas in collected (5925)
Seat 2: jcarlos.vale folded before Flop (didn't bet)
Seat 3: biscom2007 folded before Flop (didn't bet)
Seat 4: Garrik26 folded before Flop (didn't bet)
Seat 5: felipeando folded before Flop (didn't bet)
Seat 6: Stickes1987 (button) folded before Flop (didn't bet)
Seat 7: YaR1qq (small blind) folded on the Flop
Seat 8: Negrata (big blind) folded on the Flop
Seat 9: Mitnick.K.D. folded before Flop (didn't bet)



PokerStars Hand #222156587842: Tournament #3086083919, $0.49+$0.06 USD Hold'em No Limit - Level XXI (900/1800) - 2021/01/03 0:41:03 EET [2021/01/02 17:41:03 ET]
Table '3086083919 96' 9-max Seat #7 is the button
Seat 1: all sebas in (45913 in chips) 
Seat 2: jcarlos.vale (42209 in chips) 
Seat 3: biscom2007 (12707 in chips) 
Seat 4: Garrik26 (43036 in chips) 
Seat 5: felipeando (82313 in chips) 
Seat 6: Stickes1987 (21705 in chips) 
Seat 7: YaR1qq (24340 in chips) 
Seat 8: Negrata (10807 in chips) 
Seat 9: Mitnick.K.D. (34732 in chips) 
all sebas in: posts the ante 150
jcarlos.vale: posts the ante 150
biscom2007: posts the ante 150
Garrik26: posts the ante 150
felipeando: posts the ante 150
Stickes1987: posts the ante 150
YaR1qq: posts the ante 150
Negrata: posts the ante 150
Mitnick.K.D.: posts the ante 150
Negrata: posts small blind 900
Mitnick.K.D.: posts big blind 1800
*** HOLE CARDS ***
Dealt to jcarlos.vale [7d 4s]
all sebas in: folds 
jcarlos.vale: folds 
biscom2007: folds 
Garrik26: folds 
felipeando: folds 
Stickes1987: folds 
YaR1qq: folds 
Negrata: calls 900
Mitnick.K.D.: checks 
*** FLOP *** [Ad 9h Jd]
Negrata: bets 1800
Mitnick.K.D.: folds 
Uncalled bet (1800) returned to Negrata
Negrata collected 4950 from pot
Negrata: doesn't show handDTO
*** SUMMARY ***
Total pot 4950 | Rake 0 
Board [Ad 9h Jd]
Seat 1: all sebas in folded before Flop (didn't bet)
Seat 2: jcarlos.vale folded before Flop (didn't bet)
Seat 3: biscom2007 folded before Flop (didn't bet)
Seat 4: Garrik26 folded before Flop (didn't bet)
Seat 5: felipeando folded before Flop (didn't bet)
Seat 6: Stickes1987 folded before Flop (didn't bet)
Seat 7: YaR1qq (button) folded before Flop (didn't bet)
Seat 8: Negrata (small blind) collected (4950)
Seat 9: Mitnick.K.D. (big blind) folded on the Flop



PokerStars Hand #222156618119: Tournament #3086083919, $0.49+$0.06 USD Hold'em No Limit - Level XXI (900/1800) - 2021/01/03 0:41:36 EET [2021/01/02 17:41:36 ET]
Table '3086083919 96' 9-max Seat #8 is the button
Seat 1: all sebas in (45763 in chips) 
Seat 2: jcarlos.vale (42059 in chips) 
Seat 3: biscom2007 (12557 in chips) 
Seat 4: Garrik26 (42886 in chips) 
Seat 5: felipeando (82163 in chips) 
Seat 6: Stickes1987 (21555 in chips) 
Seat 7: YaR1qq (24190 in chips) 
Seat 8: Negrata (13807 in chips) 
Seat 9: Mitnick.K.D. (32782 in chips) 
all sebas in: posts the ante 150
jcarlos.vale: posts the ante 150
biscom2007: posts the ante 150
Garrik26: posts the ante 150
felipeando: posts the ante 150
Stickes1987: posts the ante 150
YaR1qq: posts the ante 150
Negrata: posts the ante 150
Mitnick.K.D.: posts the ante 150
Mitnick.K.D.: posts small blind 900
all sebas in: posts big blind 1800
*** HOLE CARDS ***
Dealt to jcarlos.vale [Ad Ts]
jcarlos.vale: raises 2880 to 4680
biscom2007: folds 
Garrik26: folds 
felipeando: folds 
Stickes1987: folds 
YaR1qq: raises 19360 to 24040 and is all-in
Negrata: folds 
Mitnick.K.D.: folds 
all sebas in: folds 
jcarlos.vale: folds 
Uncalled bet (19360) returned to YaR1qq
YaR1qq collected 13410 from pot
YaR1qq: doesn't show handDTO
*** SUMMARY ***
Total pot 13410 | Rake 0 
Seat 1: all sebas in (big blind) folded before Flop
Seat 2: jcarlos.vale folded before Flop
Seat 3: biscom2007 folded before Flop (didn't bet)
Seat 4: Garrik26 folded before Flop (didn't bet)
Seat 5: felipeando folded before Flop (didn't bet)
Seat 6: Stickes1987 folded before Flop (didn't bet)
Seat 7: YaR1qq collected (13410)
Seat 8: Negrata (button) folded before Flop (didn't bet)
Seat 9: Mitnick.K.D. (small blind) folded before Flop



PokerStars Hand #222156647254: Tournament #3086083919, $0.49+$0.06 USD Hold'em No Limit - Level XXI (900/1800) - 2021/01/03 0:42:07 EET [2021/01/02 17:42:07 ET]
Table '3086083919 96' 9-max Seat #9 is the button
Seat 1: all sebas in (43813 in chips) 
Seat 2: jcarlos.vale (37229 in chips) 
Seat 3: biscom2007 (12407 in chips) 
Seat 4: Garrik26 (42736 in chips) 
Seat 5: felipeando (82013 in chips) 
Seat 6: Stickes1987 (21405 in chips) 
Seat 7: YaR1qq (32770 in chips) 
Seat 8: Negrata (13657 in chips) 
Seat 9: Mitnick.K.D. (31732 in chips) 
all sebas in: posts the ante 150
jcarlos.vale: posts the ante 150
biscom2007: posts the ante 150
Garrik26: posts the ante 150
felipeando: posts the ante 150
Stickes1987: posts the ante 150
YaR1qq: posts the ante 150
Negrata: posts the ante 150
Mitnick.K.D.: posts the ante 150
all sebas in: posts small blind 900
jcarlos.vale: posts big blind 1800
*** HOLE CARDS ***
Dealt to jcarlos.vale [9h 7d]
biscom2007: folds 
Garrik26: folds 
felipeando: folds 
Stickes1987: folds 
YaR1qq: raises 2200 to 4000
Negrata: folds 
Mitnick.K.D.: folds 
all sebas in: calls 3100
jcarlos.vale: folds 
*** FLOP *** [Kd Td 3h]
all sebas in: checks 
YaR1qq: bets 5400
all sebas in: calls 5400
*** TURN *** [Kd Td 3h] [4s]
all sebas in: checks 
YaR1qq: bets 23220 and is all-in
all sebas in: calls 23220
*** RIVER *** [Kd Td 3h 4s] [Th]
*** SHOW DOWN ***
all sebas in: shows [Jd Tc] (three of a kind, Tens)
YaR1qq: shows [Ad Qs] (a pair of Tens)
all sebas in collected 68390 from pot
YaR1qq finished the tournament in 275th place and received $1.75.
*** SUMMARY ***
Total pot 68390 | Rake 0 
Board [Kd Td 3h 4s Th]
Seat 1: all sebas in (small blind) showed [Jd Tc] and won (68390) with three of a kind, Tens
Seat 2: jcarlos.vale (big blind) folded before Flop
Seat 3: biscom2007 folded before Flop (didn't bet)
Seat 4: Garrik26 folded before Flop (didn't bet)
Seat 5: felipeando folded before Flop (didn't bet)
Seat 6: Stickes1987 folded before Flop (didn't bet)
Seat 7: YaR1qq showed [Ad Qs] and lost with a pair of Tens
Seat 8: Negrata folded before Flop (didn't bet)
Seat 9: Mitnick.K.D. (button) folded before Flop (didn't bet)



PokerStars Hand #222156689983: Tournament #3086083919, $0.49+$0.06 USD Hold'em No Limit - Level XXI (900/1800) - 2021/01/03 0:42:54 EET [2021/01/02 17:42:54 ET]
Table '3086083919 96' 9-max Seat #1 is the button
Seat 1: all sebas in (79433 in chips) 
Seat 2: jcarlos.vale (35279 in chips) 
Seat 3: biscom2007 (12257 in chips) 
Seat 4: Garrik26 (42586 in chips) 
Seat 5: felipeando (81863 in chips) 
Seat 6: Stickes1987 (21255 in chips) 
Seat 8: Negrata (13507 in chips) 
Seat 9: Mitnick.K.D. (31582 in chips) 
all sebas in: posts the ante 150
jcarlos.vale: posts the ante 150
biscom2007: posts the ante 150
Garrik26: posts the ante 150
felipeando: posts the ante 150
Stickes1987: posts the ante 150
Negrata: posts the ante 150
Mitnick.K.D.: posts the ante 150
jcarlos.vale: posts small blind 900
biscom2007: posts big blind 1800
*** HOLE CARDS ***
Dealt to jcarlos.vale [9h Ts]
Garrik26: folds 
felipeando: folds 
Stickes1987: folds 
Negrata: folds 
Mitnick.K.D.: folds 
all sebas in: folds 
jcarlos.vale: folds 
Uncalled bet (900) returned to biscom2007
biscom2007 collected 3000 from pot
biscom2007: doesn't show handDTO
*** SUMMARY ***
Total pot 3000 | Rake 0 
Seat 1: all sebas in (button) folded before Flop (didn't bet)
Seat 2: jcarlos.vale (small blind) folded before Flop
Seat 3: biscom2007 (big blind) collected (3000)
Seat 4: Garrik26 folded before Flop (didn't bet)
Seat 5: felipeando folded before Flop (didn't bet)
Seat 6: Stickes1987 folded before Flop (didn't bet)
Seat 8: Negrata folded before Flop (didn't bet)
Seat 9: Mitnick.K.D. folded before Flop (didn't bet)



PokerStars Hand #222156708759: Tournament #3086083919, $0.49+$0.06 USD Hold'em No Limit - Level XXI (900/1800) - 2021/01/03 0:43:14 EET [2021/01/02 17:43:14 ET]
Table '3086083919 96' 9-max Seat #2 is the button
Seat 1: all sebas in (79283 in chips) 
Seat 2: jcarlos.vale (34229 in chips) 
Seat 3: biscom2007 (14207 in chips) 
Seat 4: Garrik26 (42436 in chips) 
Seat 5: felipeando (81713 in chips) 
Seat 6: Stickes1987 (21105 in chips) 
Seat 8: Negrata (13357 in chips) 
Seat 9: Mitnick.K.D. (31432 in chips) 
all sebas in: posts the ante 150
jcarlos.vale: posts the ante 150
biscom2007: posts the ante 150
Garrik26: posts the ante 150
felipeando: posts the ante 150
Stickes1987: posts the ante 150
Negrata: posts the ante 150
Mitnick.K.D.: posts the ante 150
biscom2007: posts small blind 900
Garrik26: posts big blind 1800
*** HOLE CARDS ***
Dealt to jcarlos.vale [9c 5s]
felipeando: folds 
Stickes1987: folds 
Negrata: folds 
Mitnick.K.D.: folds 
all sebas in: calls 1800
jcarlos.vale: folds 
biscom2007: calls 900
Garrik26: checks 
*** FLOP *** [4s Jc 4h]
biscom2007: checks 
Garrik26: checks 
all sebas in: bets 3300
biscom2007: folds 
Garrik26: raises 3300 to 6600
all sebas in: calls 3300
*** TURN *** [4s Jc 4h] [7d]
Garrik26: checks 
all sebas in: checks 
*** RIVER *** [4s Jc 4h 7d] [6d]
Garrik26: bets 19800
all sebas in: folds 
Uncalled bet (19800) returned to Garrik26
Garrik26 collected 19800 from pot
Garrik26: doesn't show handDTO
*** SUMMARY ***
Total pot 19800 | Rake 0 
Board [4s Jc 4h 7d 6d]
Seat 1: all sebas in folded on the River
Seat 2: jcarlos.vale (button) folded before Flop (didn't bet)
Seat 3: biscom2007 (small blind) folded on the Flop
Seat 4: Garrik26 (big blind) collected (19800)
Seat 5: felipeando folded before Flop (didn't bet)
Seat 6: Stickes1987 folded before Flop (didn't bet)
Seat 8: Negrata folded before Flop (didn't bet)
Seat 9: Mitnick.K.D. folded before Flop (didn't bet)



PokerStars Hand #222156755615: Tournament #3086083919, $0.49+$0.06 USD Hold'em No Limit - Level XXI (900/1800) - 2021/01/03 0:44:06 EET [2021/01/02 17:44:06 ET]
Table '3086083919 96' 9-max Seat #3 is the button
Seat 1: all sebas in (70733 in chips) 
Seat 2: jcarlos.vale (34079 in chips) 
Seat 3: biscom2007 (12257 in chips) 
Seat 4: Garrik26 (53686 in chips) 
Seat 5: felipeando (81563 in chips) 
Seat 6: Stickes1987 (20955 in chips) 
Seat 7: Slav1an (52632 in chips) 
Seat 8: Negrata (13207 in chips) 
Seat 9: Mitnick.K.D. (31282 in chips) 
all sebas in: posts the ante 150
jcarlos.vale: posts the ante 150
biscom2007: posts the ante 150
Garrik26: posts the ante 150
felipeando: posts the ante 150
Stickes1987: posts the ante 150
Slav1an: posts the ante 150
Negrata: posts the ante 150
Mitnick.K.D.: posts the ante 150
Garrik26: posts small blind 900
felipeando: posts big blind 1800
*** HOLE CARDS ***
Dealt to jcarlos.vale [4d 5h]
Stickes1987: folds 
Slav1an: raises 3600 to 5400
Negrata: folds 
Mitnick.K.D.: raises 25732 to 31132 and is all-in
all sebas in: folds 
jcarlos.vale: folds 
biscom2007: folds 
Garrik26: folds 
felipeando: folds 
Slav1an: calls 25732
*** FLOP *** [As Tc 7d]
*** TURN *** [As Tc 7d] [5s]
*** RIVER *** [As Tc 7d 5s] [7s]
*** SHOW DOWN ***
Slav1an: shows [Ah Ks] (two pair, Aces and Sevens)
Mitnick.K.D.: shows [6c 6s] (two pair, Sevens and Sixes)
Slav1an collected 66314 from pot
Mitnick.K.D. finished the tournament in 264th place and received $1.75.
*** SUMMARY ***
Total pot 66314 | Rake 0 
Board [As Tc 7d 5s 7s]
Seat 1: all sebas in folded before Flop (didn't bet)
Seat 2: jcarlos.vale folded before Flop (didn't bet)
Seat 3: biscom2007 (button) folded before Flop (didn't bet)
Seat 4: Garrik26 (small blind) folded before Flop
Seat 5: felipeando (big blind) folded before Flop
Seat 6: Stickes1987 folded before Flop (didn't bet)
Seat 7: Slav1an showed [Ah Ks] and won (66314) with two pair, Aces and Sevens
Seat 8: Negrata folded before Flop (didn't bet)
Seat 9: Mitnick.K.D. showed [6c 6s] and lost with two pair, Sevens and Sixes



PokerStars Hand #222156782037: Tournament #3086083919, $0.49+$0.06 USD Hold'em No Limit - Level XXI (900/1800) - 2021/01/03 0:44:35 EET [2021/01/02 17:44:35 ET]
Table '3086083919 96' 9-max Seat #4 is the button
Seat 1: all sebas in (70583 in chips) 
Seat 2: jcarlos.vale (33929 in chips) 
Seat 3: biscom2007 (12107 in chips) 
Seat 4: Garrik26 (52636 in chips) 
Seat 5: felipeando (79613 in chips) 
Seat 6: Stickes1987 (20805 in chips) 
Seat 7: Slav1an (87664 in chips) 
Seat 8: Negrata (13057 in chips) 
all sebas in: posts the ante 150
jcarlos.vale: posts the ante 150
biscom2007: posts the ante 150
Garrik26: posts the ante 150
felipeando: posts the ante 150
Stickes1987: posts the ante 150
Slav1an: posts the ante 150
Negrata: posts the ante 150
felipeando: posts small blind 900
Stickes1987: posts big blind 1800
*** HOLE CARDS ***
Dealt to jcarlos.vale [6h 9s]
Slav1an: folds 
Negrata: folds 
all sebas in: folds 
jcarlos.vale: folds 
biscom2007: folds 
Garrik26: folds 
felipeando: folds 
Uncalled bet (900) returned to Stickes1987
Stickes1987 collected 3000 from pot
Stickes1987: doesn't show handDTO
*** SUMMARY ***
Total pot 3000 | Rake 0 
Seat 1: all sebas in folded before Flop (didn't bet)
Seat 2: jcarlos.vale folded before Flop (didn't bet)
Seat 3: biscom2007 folded before Flop (didn't bet)
Seat 4: Garrik26 (button) folded before Flop (didn't bet)
Seat 5: felipeando (small blind) folded before Flop
Seat 6: Stickes1987 (big blind) collected (3000)
Seat 7: Slav1an folded before Flop (didn't bet)
Seat 8: Negrata folded before Flop (didn't bet)



PokerStars Hand #222156805907: Tournament #3086083919, $0.49+$0.06 USD Hold'em No Limit - Level XXI (900/1800) - 2021/01/03 0:45:01 EET [2021/01/02 17:45:01 ET]
Table '3086083919 96' 9-max Seat #5 is the button
Seat 1: all sebas in (70433 in chips) 
Seat 2: jcarlos.vale (33779 in chips) 
Seat 3: biscom2007 (11957 in chips) 
Seat 4: Garrik26 (52486 in chips) 
Seat 5: felipeando (78563 in chips) 
Seat 6: Stickes1987 (22755 in chips) 
Seat 7: Slav1an (87514 in chips) 
Seat 8: Negrata (12907 in chips) 
all sebas in: posts the ante 150
jcarlos.vale: posts the ante 150
biscom2007: posts the ante 150
Garrik26: posts the ante 150
felipeando: posts the ante 150
Stickes1987: posts the ante 150
Slav1an: posts the ante 150
Negrata: posts the ante 150
Stickes1987: posts small blind 900
Slav1an: posts big blind 1800
*** HOLE CARDS ***
Dealt to jcarlos.vale [8s Ah]
Negrata: folds 
all sebas in: calls 1800
jcarlos.vale: folds 
biscom2007: folds 
Garrik26: calls 1800
felipeando: folds 
Stickes1987: folds 
Slav1an: checks 
*** FLOP *** [Ts 2s 6c]
Slav1an: checks 
all sebas in: bets 1800
Garrik26: folds 
Slav1an: folds 
Uncalled bet (1800) returned to all sebas in
all sebas in collected 7500 from pot
*** SUMMARY ***
Total pot 7500 | Rake 0 
Board [Ts 2s 6c]
Seat 1: all sebas in collected (7500)
Seat 2: jcarlos.vale folded before Flop (didn't bet)
Seat 3: biscom2007 folded before Flop (didn't bet)
Seat 4: Garrik26 folded on the Flop
Seat 5: felipeando (button) folded before Flop (didn't bet)
Seat 6: Stickes1987 (small blind) folded before Flop
Seat 7: Slav1an (big blind) folded on the Flop
Seat 8: Negrata folded before Flop (didn't bet)



PokerStars Hand #222156837181: Tournament #3086083919, $0.49+$0.06 USD Hold'em No Limit - Level XXI (900/1800) - 2021/01/03 0:45:35 EET [2021/01/02 17:45:35 ET]
Table '3086083919 96' 9-max Seat #6 is the button
Seat 1: all sebas in (75983 in chips) 
Seat 2: jcarlos.vale (33629 in chips) 
Seat 3: biscom2007 (11807 in chips) 
Seat 4: Garrik26 (50536 in chips) 
Seat 5: felipeando (78413 in chips) 
Seat 6: Stickes1987 (21705 in chips) 
Seat 7: Slav1an (85564 in chips) 
Seat 8: Negrata (12757 in chips) 
Seat 9: XJIOPKA85 (149317 in chips) 
all sebas in: posts the ante 150
jcarlos.vale: posts the ante 150
biscom2007: posts the ante 150
Garrik26: posts the ante 150
felipeando: posts the ante 150
Stickes1987: posts the ante 150
Slav1an: posts the ante 150
Negrata: posts the ante 150
XJIOPKA85: posts the ante 150
Slav1an: posts small blind 900
Negrata: posts big blind 1800
*** HOLE CARDS ***
Dealt to jcarlos.vale [7s Qc]
XJIOPKA85: folds 
all sebas in: folds 
jcarlos.vale: folds 
biscom2007: raises 1800 to 3600
Garrik26: folds 
felipeando: folds 
Stickes1987: folds 
Slav1an: folds 
Negrata: folds 
Uncalled bet (1800) returned to biscom2007
biscom2007 collected 5850 from pot
biscom2007: doesn't show handDTO
*** SUMMARY ***
Total pot 5850 | Rake 0 
Seat 1: all sebas in folded before Flop (didn't bet)
Seat 2: jcarlos.vale folded before Flop (didn't bet)
Seat 3: biscom2007 collected (5850)
Seat 4: Garrik26 folded before Flop (didn't bet)
Seat 5: felipeando folded before Flop (didn't bet)
Seat 6: Stickes1987 (button) folded before Flop (didn't bet)
Seat 7: Slav1an (small blind) folded before Flop
Seat 8: Negrata (big blind) folded before Flop
Seat 9: XJIOPKA85 folded before Flop (didn't bet)



PokerStars Hand #222156860468: Tournament #3086083919, $0.49+$0.06 USD Hold'em No Limit - Level XXI (900/1800) - 2021/01/03 0:46:01 EET [2021/01/02 17:46:01 ET]
Table '3086083919 96' 9-max Seat #7 is the button
Seat 1: all sebas in (75833 in chips) 
Seat 2: jcarlos.vale (33479 in chips) 
Seat 3: biscom2007 (15707 in chips) 
Seat 4: Garrik26 (50386 in chips) 
Seat 5: felipeando (78263 in chips) 
Seat 6: Stickes1987 (21555 in chips) 
Seat 7: Slav1an (84514 in chips) 
Seat 8: Negrata (10807 in chips) 
Seat 9: XJIOPKA85 (149167 in chips) 
all sebas in: posts the ante 150
jcarlos.vale: posts the ante 150
biscom2007: posts the ante 150
Garrik26: posts the ante 150
felipeando: posts the ante 150
Stickes1987: posts the ante 150
Slav1an: posts the ante 150
Negrata: posts the ante 150
XJIOPKA85: posts the ante 150
Negrata: posts small blind 900
XJIOPKA85: posts big blind 1800
*** HOLE CARDS ***
Dealt to jcarlos.vale [7h 9h]
all sebas in: folds 
jcarlos.vale: folds 
biscom2007: folds 
Garrik26: folds 
felipeando: raises 1800 to 3600
Stickes1987: folds 
Slav1an: folds 
Negrata: folds 
XJIOPKA85: calls 1800
*** FLOP *** [As Kh 2c]
XJIOPKA85: checks 
felipeando: checks 
*** TURN *** [As Kh 2c] [7c]
XJIOPKA85: bets 5400
felipeando: calls 5400
*** RIVER *** [As Kh 2c 7c] [2s]
XJIOPKA85: bets 15188
felipeando: folds 
Uncalled bet (15188) returned to XJIOPKA85
XJIOPKA85 collected 20250 from pot
*** SUMMARY ***
Total pot 20250 | Rake 0 
Board [As Kh 2c 7c 2s]
Seat 1: all sebas in folded before Flop (didn't bet)
Seat 2: jcarlos.vale folded before Flop (didn't bet)
Seat 3: biscom2007 folded before Flop (didn't bet)
Seat 4: Garrik26 folded before Flop (didn't bet)
Seat 5: felipeando folded on the River
Seat 6: Stickes1987 folded before Flop (didn't bet)
Seat 7: Slav1an (button) folded before Flop (didn't bet)
Seat 8: Negrata (small blind) folded before Flop
Seat 9: XJIOPKA85 (big blind) collected (20250)



PokerStars Hand #222156917684: Tournament #3086083919, $0.49+$0.06 USD Hold'em No Limit - Level XXI (900/1800) - 2021/01/03 0:47:05 EET [2021/01/02 17:47:05 ET]
Table '3086083919 96' 9-max Seat #8 is the button
Seat 1: all sebas in (75683 in chips) 
Seat 2: jcarlos.vale (33329 in chips) 
Seat 3: biscom2007 (15557 in chips) 
Seat 4: Garrik26 (50236 in chips) 
Seat 5: felipeando (69113 in chips) 
Seat 6: Stickes1987 (21405 in chips) 
Seat 7: Slav1an (84364 in chips) 
Seat 8: Negrata (9757 in chips) 
Seat 9: XJIOPKA85 (160267 in chips) 
all sebas in: posts the ante 150
jcarlos.vale: posts the ante 150
biscom2007: posts the ante 150
Garrik26: posts the ante 150
felipeando: posts the ante 150
Stickes1987: posts the ante 150
Slav1an: posts the ante 150
Negrata: posts the ante 150
XJIOPKA85: posts the ante 150
XJIOPKA85: posts small blind 900
all sebas in: posts big blind 1800
*** HOLE CARDS ***
Dealt to jcarlos.vale [3s As]
jcarlos.vale: folds 
biscom2007: folds 
Garrik26: folds 
felipeando: folds 
Stickes1987: folds 
Slav1an: raises 3600 to 5400
Negrata: folds 
XJIOPKA85: raises 14400 to 19800
all sebas in: folds 
Slav1an: folds 
Uncalled bet (14400) returned to XJIOPKA85
XJIOPKA85 collected 13950 from pot
*** SUMMARY ***
Total pot 13950 | Rake 0 
Seat 1: all sebas in (big blind) folded before Flop
Seat 2: jcarlos.vale folded before Flop (didn't bet)
Seat 3: biscom2007 folded before Flop (didn't bet)
Seat 4: Garrik26 folded before Flop (didn't bet)
Seat 5: felipeando folded before Flop (didn't bet)
Seat 6: Stickes1987 folded before Flop (didn't bet)
Seat 7: Slav1an folded before Flop
Seat 8: Negrata (button) folded before Flop (didn't bet)
Seat 9: XJIOPKA85 (small blind) collected (13950)



PokerStars Hand #222156958686: Tournament #3086083919, $0.49+$0.06 USD Hold'em No Limit - Level XXI (900/1800) - 2021/01/03 0:47:51 EET [2021/01/02 17:47:51 ET]
Table '3086083919 96' 9-max Seat #9 is the button
Seat 1: all sebas in (73733 in chips) 
Seat 2: jcarlos.vale (33179 in chips) 
Seat 3: biscom2007 (15407 in chips) 
Seat 4: Garrik26 (50086 in chips) 
Seat 5: felipeando (68963 in chips) 
Seat 6: Stickes1987 (21255 in chips) 
Seat 7: Slav1an (78814 in chips) 
Seat 8: Negrata (9607 in chips) 
Seat 9: XJIOPKA85 (168667 in chips) 
all sebas in: posts the ante 150
jcarlos.vale: posts the ante 150
biscom2007: posts the ante 150
Garrik26: posts the ante 150
felipeando: posts the ante 150
Stickes1987: posts the ante 150
Slav1an: posts the ante 150
Negrata: posts the ante 150
XJIOPKA85: posts the ante 150
all sebas in: posts small blind 900
jcarlos.vale: posts big blind 1800
*** HOLE CARDS ***
Dealt to jcarlos.vale [2h Qh]
biscom2007: folds 
Garrik26: folds 
felipeando: folds 
Stickes1987: folds 
Slav1an: raises 1801 to 3601
Negrata: folds 
XJIOPKA85: folds 
all sebas in: folds 
jcarlos.vale: folds 
Uncalled bet (1801) returned to Slav1an
Slav1an collected 5850 from pot
*** SUMMARY ***
Total pot 5850 | Rake 0 
Seat 1: all sebas in (small blind) folded before Flop
Seat 2: jcarlos.vale (big blind) folded before Flop
Seat 3: biscom2007 folded before Flop (didn't bet)
Seat 4: Garrik26 folded before Flop (didn't bet)
Seat 5: felipeando folded before Flop (didn't bet)
Seat 6: Stickes1987 folded before Flop (didn't bet)
Seat 7: Slav1an collected (5850)
Seat 8: Negrata folded before Flop (didn't bet)
Seat 9: XJIOPKA85 (button) folded before Flop (didn't bet)



PokerStars Hand #222156981856: Tournament #3086083919, $0.49+$0.06 USD Hold'em No Limit - Level XXI (900/1800) - 2021/01/03 0:48:17 EET [2021/01/02 17:48:17 ET]
Table '3086083919 96' 9-max Seat #1 is the button
Seat 1: all sebas in (72683 in chips) 
Seat 2: jcarlos.vale (31229 in chips) 
Seat 3: biscom2007 (15257 in chips) 
Seat 4: Garrik26 (49936 in chips) 
Seat 5: felipeando (68813 in chips) 
Seat 6: Stickes1987 (21105 in chips) 
Seat 7: Slav1an (82714 in chips) 
Seat 8: Negrata (9457 in chips) 
Seat 9: XJIOPKA85 (168517 in chips) 
all sebas in: posts the ante 150
jcarlos.vale: posts the ante 150
biscom2007: posts the ante 150
Garrik26: posts the ante 150
felipeando: posts the ante 150
Stickes1987: posts the ante 150
Slav1an: posts the ante 150
Negrata: posts the ante 150
XJIOPKA85: posts the ante 150
jcarlos.vale: posts small blind 900
biscom2007: posts big blind 1800
*** HOLE CARDS ***
Dealt to jcarlos.vale [3d Kc]
Garrik26: raises 1800 to 3600
felipeando: folds 
Stickes1987: folds 
Slav1an: folds 
Negrata: folds 
XJIOPKA85: folds 
all sebas in: calls 3600
jcarlos.vale: folds 
biscom2007: calls 1800
*** FLOP *** [Ad Ts Qd]
biscom2007: checks 
Garrik26: bets 46186 and is all-in
all sebas in: folds 
biscom2007: folds 
Uncalled bet (46186) returned to Garrik26
Garrik26 collected 13050 from pot
Garrik26: doesn't show handDTO
*** SUMMARY ***
Total pot 13050 | Rake 0 
Board [Ad Ts Qd]
Seat 1: all sebas in (button) folded on the Flop
Seat 2: jcarlos.vale (small blind) folded before Flop
Seat 3: biscom2007 (big blind) folded on the Flop
Seat 4: Garrik26 collected (13050)
Seat 5: felipeando folded before Flop (didn't bet)
Seat 6: Stickes1987 folded before Flop (didn't bet)
Seat 7: Slav1an folded before Flop (didn't bet)
Seat 8: Negrata folded before Flop (didn't bet)
Seat 9: XJIOPKA85 folded before Flop (didn't bet)



PokerStars Hand #222157019347: Tournament #3086083919, $0.49+$0.06 USD Hold'em No Limit - Level XXI (900/1800) - 2021/01/03 0:49:00 EET [2021/01/02 17:49:00 ET]
Table '3086083919 96' 9-max Seat #2 is the button
Seat 1: all sebas in (68933 in chips) 
Seat 2: jcarlos.vale (30179 in chips) 
Seat 3: biscom2007 (11507 in chips) 
Seat 4: Garrik26 (59236 in chips) 
Seat 5: felipeando (68663 in chips) 
Seat 6: Stickes1987 (20955 in chips) 
Seat 7: Slav1an (82564 in chips) 
Seat 8: Negrata (9307 in chips) 
Seat 9: XJIOPKA85 (168367 in chips) 
all sebas in: posts the ante 150
jcarlos.vale: posts the ante 150
biscom2007: posts the ante 150
Garrik26: posts the ante 150
felipeando: posts the ante 150
Stickes1987: posts the ante 150
Slav1an: posts the ante 150
Negrata: posts the ante 150
XJIOPKA85: posts the ante 150
biscom2007: posts small blind 900
Garrik26: posts big blind 1800
*** HOLE CARDS ***
Dealt to jcarlos.vale [2h 5h]
felipeando: folds 
Stickes1987: folds 
Slav1an: raises 1801 to 3601
Negrata: folds 
XJIOPKA85: folds 
all sebas in: calls 3601
jcarlos.vale: folds 
biscom2007: folds 
Garrik26: folds 
*** FLOP *** [9s Jh Kd]
Slav1an: checks 
all sebas in: checks 
*** TURN *** [9s Jh Kd] [Jc]
Slav1an: checks 
all sebas in: checks 
*** RIVER *** [9s Jh Kd Jc] [6c]
Slav1an: bets 3376
all sebas in: calls 3376
*** SHOW DOWN ***
Slav1an: shows [5s 5c] (two pair, Jacks and Fives)
all sebas in: shows [7c 7d] (two pair, Jacks and Sevens)
all sebas in collected 18004 from pot
*** SUMMARY ***
Total pot 18004 | Rake 0 
Board [9s Jh Kd Jc 6c]
Seat 1: all sebas in showed [7c 7d] and won (18004) with two pair, Jacks and Sevens
Seat 2: jcarlos.vale (button) folded before Flop (didn't bet)
Seat 3: biscom2007 (small blind) folded before Flop
Seat 4: Garrik26 (big blind) folded before Flop
Seat 5: felipeando folded before Flop (didn't bet)
Seat 6: Stickes1987 folded before Flop (didn't bet)
Seat 7: Slav1an showed [5s 5c] and lost with two pair, Jacks and Fives
Seat 8: Negrata folded before Flop (didn't bet)
Seat 9: XJIOPKA85 folded before Flop (didn't bet)



PokerStars Hand #222157062188: Tournament #3086083919, $0.49+$0.06 USD Hold'em No Limit - Level XXI (900/1800) - 2021/01/03 0:49:49 EET [2021/01/02 17:49:49 ET]
Table '3086083919 96' 9-max Seat #3 is the button
Seat 1: all sebas in (79810 in chips) 
Seat 2: jcarlos.vale (30029 in chips) 
Seat 3: biscom2007 (10457 in chips) 
Seat 4: Garrik26 (57286 in chips) 
Seat 5: felipeando (68513 in chips) 
Seat 6: Stickes1987 (20805 in chips) 
Seat 7: Slav1an (75437 in chips) 
Seat 8: Negrata (9157 in chips) 
Seat 9: XJIOPKA85 (168217 in chips) 
all sebas in: posts the ante 150
jcarlos.vale: posts the ante 150
biscom2007: posts the ante 150
Garrik26: posts the ante 150
felipeando: posts the ante 150
Stickes1987: posts the ante 150
Slav1an: posts the ante 150
Negrata: posts the ante 150
XJIOPKA85: posts the ante 150
Garrik26: posts small blind 900
felipeando: posts big blind 1800
*** HOLE CARDS ***
Dealt to jcarlos.vale [6d 8d]
Stickes1987: folds 
Slav1an: folds 
Negrata: folds 
XJIOPKA85: folds 
all sebas in: folds 
jcarlos.vale: folds 
biscom2007: raises 8507 to 10307 and is all-in
Garrik26: folds 
felipeando: folds 
Uncalled bet (8507) returned to biscom2007
biscom2007 collected 5850 from pot
biscom2007: doesn't show handDTO
*** SUMMARY ***
Total pot 5850 | Rake 0 
Seat 1: all sebas in folded before Flop (didn't bet)
Seat 2: jcarlos.vale folded before Flop (didn't bet)
Seat 3: biscom2007 (button) collected (5850)
Seat 4: Garrik26 (small blind) folded before Flop
Seat 5: felipeando (big blind) folded before Flop
Seat 6: Stickes1987 folded before Flop (didn't bet)
Seat 7: Slav1an folded before Flop (didn't bet)
Seat 8: Negrata folded before Flop (didn't bet)
Seat 9: XJIOPKA85 folded before Flop (didn't bet)



PokerStars Hand #222157090567: Tournament #3086083919, $0.49+$0.06 USD Hold'em No Limit - Level XXI (900/1800) - 2021/01/03 0:50:21 EET [2021/01/02 17:50:21 ET]
Table '3086083919 96' 9-max Seat #4 is the button
Seat 1: all sebas in (79660 in chips) 
Seat 2: jcarlos.vale (29879 in chips) 
Seat 3: biscom2007 (14357 in chips) 
Seat 4: Garrik26 (56236 in chips) 
Seat 5: felipeando (66563 in chips) 
Seat 6: Stickes1987 (20655 in chips) 
Seat 7: Slav1an (75287 in chips) 
Seat 8: Negrata (9007 in chips) 
Seat 9: XJIOPKA85 (168067 in chips) 
all sebas in: posts the ante 150
jcarlos.vale: posts the ante 150
biscom2007: posts the ante 150
Garrik26: posts the ante 150
felipeando: posts the ante 150
Stickes1987: posts the ante 150
Slav1an: posts the ante 150
Negrata: posts the ante 150
XJIOPKA85: posts the ante 150
felipeando: posts small blind 900
Stickes1987: posts big blind 1800
*** HOLE CARDS ***
Dealt to jcarlos.vale [7s Kc]
Slav1an: folds 
Negrata: folds 
XJIOPKA85: raises 2034 to 3834
all sebas in: folds 
jcarlos.vale: folds 
biscom2007: folds 
Garrik26: folds 
felipeando: folds 
Stickes1987: folds 
Uncalled bet (2034) returned to XJIOPKA85
XJIOPKA85 collected 5850 from pot
*** SUMMARY ***
Total pot 5850 | Rake 0 
Seat 1: all sebas in folded before Flop (didn't bet)
Seat 2: jcarlos.vale folded before Flop (didn't bet)
Seat 3: biscom2007 folded before Flop (didn't bet)
Seat 4: Garrik26 (button) folded before Flop (didn't bet)
Seat 5: felipeando (small blind) folded before Flop
Seat 6: Stickes1987 (big blind) folded before Flop
Seat 7: Slav1an folded before Flop (didn't bet)
Seat 8: Negrata folded before Flop (didn't bet)
Seat 9: XJIOPKA85 collected (5850)



PokerStars Hand #222157116811: Tournament #3086083919, $0.49+$0.06 USD Hold'em No Limit - Level XXII (1000/2000) - 2021/01/03 0:50:51 EET [2021/01/02 17:50:51 ET]
Table '3086083919 96' 9-max Seat #5 is the button
Seat 1: all sebas in (79510 in chips) 
Seat 2: jcarlos.vale (29729 in chips) 
Seat 3: biscom2007 (14207 in chips) 
Seat 4: Garrik26 (56086 in chips) 
Seat 5: felipeando (65513 in chips) 
Seat 6: Stickes1987 (18705 in chips) 
Seat 7: Slav1an (75137 in chips) 
Seat 8: Negrata (8857 in chips) 
Seat 9: XJIOPKA85 (171967 in chips) 
all sebas in: posts the ante 175
jcarlos.vale: posts the ante 175
biscom2007: posts the ante 175
Garrik26: posts the ante 175
felipeando: posts the ante 175
Stickes1987: posts the ante 175
Slav1an: posts the ante 175
Negrata: posts the ante 175
XJIOPKA85: posts the ante 175
Stickes1987: posts small blind 1000
Slav1an: posts big blind 2000
*** HOLE CARDS ***
Dealt to jcarlos.vale [Qs Th]
Negrata: calls 2000
XJIOPKA85: folds 
all sebas in: folds 
jcarlos.vale: folds 
biscom2007: folds 
Garrik26: calls 2000
felipeando: folds 
Stickes1987: folds 
Slav1an: checks 
*** FLOP *** [7s Ad Qh]
Slav1an: checks 
Negrata: bets 6682 and is all-in
Garrik26: folds 
Slav1an: folds 
Uncalled bet (6682) returned to Negrata
Negrata collected 8575 from pot
Negrata: doesn't show handDTO
*** SUMMARY ***
Total pot 8575 | Rake 0 
Board [7s Ad Qh]
Seat 1: all sebas in folded before Flop (didn't bet)
Seat 2: jcarlos.vale folded before Flop (didn't bet)
Seat 3: biscom2007 folded before Flop (didn't bet)
Seat 4: Garrik26 folded on the Flop
Seat 5: felipeando (button) folded before Flop (didn't bet)
Seat 6: Stickes1987 (small blind) folded before Flop
Seat 7: Slav1an (big blind) folded on the Flop
Seat 8: Negrata collected (8575)
Seat 9: XJIOPKA85 folded before Flop (didn't bet)



PokerStars Hand #222157164490: Tournament #3086083919, $0.49+$0.06 USD Hold'em No Limit - Level XXII (1000/2000) - 2021/01/03 0:51:46 EET [2021/01/02 17:51:46 ET]
Table '3086083919 96' 9-max Seat #6 is the button
Seat 1: all sebas in (79335 in chips) 
Seat 2: jcarlos.vale (29554 in chips) 
Seat 3: biscom2007 (14032 in chips) 
Seat 4: Garrik26 (53911 in chips) 
Seat 5: felipeando (65338 in chips) 
Seat 6: Stickes1987 (17530 in chips) 
Seat 7: Slav1an (72962 in chips) 
Seat 8: Negrata (15257 in chips) 
Seat 9: XJIOPKA85 (171792 in chips) 
all sebas in: posts the ante 175
jcarlos.vale: posts the ante 175
biscom2007: posts the ante 175
Garrik26: posts the ante 175
felipeando: posts the ante 175
Stickes1987: posts the ante 175
Slav1an: posts the ante 175
Negrata: posts the ante 175
XJIOPKA85: posts the ante 175
Slav1an: posts small blind 1000
Negrata: posts big blind 2000
*** HOLE CARDS ***
Dealt to jcarlos.vale [4s Qd]
XJIOPKA85: folds 
all sebas in: calls 2000
jcarlos.vale: folds 
biscom2007: folds 
Garrik26: calls 2000
felipeando: folds 
Stickes1987: folds 
Slav1an: folds 
Negrata: checks 
*** FLOP *** [7d 8d Qs]
Negrata: checks 
all sebas in: bets 2000
Garrik26: calls 2000
Negrata: folds 
*** TURN *** [7d 8d Qs] [Qc]
all sebas in: bets 2000
Garrik26: calls 2000
*** RIVER *** [7d 8d Qs Qc] [6c]
all sebas in: bets 2000
Garrik26: folds 
Uncalled bet (2000) returned to all sebas in
all sebas in collected 16575 from pot
*** SUMMARY ***
Total pot 16575 | Rake 0 
Board [7d 8d Qs Qc 6c]
Seat 1: all sebas in collected (16575)
Seat 2: jcarlos.vale folded before Flop (didn't bet)
Seat 3: biscom2007 folded before Flop (didn't bet)
Seat 4: Garrik26 folded on the River
Seat 5: felipeando folded before Flop (didn't bet)
Seat 6: Stickes1987 (button) folded before Flop (didn't bet)
Seat 7: Slav1an (small blind) folded before Flop
Seat 8: Negrata (big blind) folded on the Flop
Seat 9: XJIOPKA85 folded before Flop (didn't bet)



PokerStars Hand #222157224982: Tournament #3086083919, $0.49+$0.06 USD Hold'em No Limit - Level XXII (1000/2000) - 2021/01/03 0:52:56 EET [2021/01/02 17:52:56 ET]
Table '3086083919 96' 9-max Seat #7 is the button
Seat 1: all sebas in (89735 in chips) 
Seat 2: jcarlos.vale (29379 in chips) 
Seat 3: biscom2007 (13857 in chips) 
Seat 4: Garrik26 (47736 in chips) 
Seat 5: felipeando (65163 in chips) 
Seat 6: Stickes1987 (17355 in chips) 
Seat 7: Slav1an (71787 in chips) 
Seat 8: Negrata (13082 in chips) 
Seat 9: XJIOPKA85 (171617 in chips) 
all sebas in: posts the ante 175
jcarlos.vale: posts the ante 175
biscom2007: posts the ante 175
Garrik26: posts the ante 175
felipeando: posts the ante 175
Stickes1987: posts the ante 175
Slav1an: posts the ante 175
Negrata: posts the ante 175
XJIOPKA85: posts the ante 175
Negrata: posts small blind 1000
XJIOPKA85: posts big blind 2000
*** HOLE CARDS ***
Dealt to jcarlos.vale [2s 6h]
all sebas in: calls 2000
jcarlos.vale: folds 
biscom2007: folds 
Garrik26: folds 
felipeando: folds 
Stickes1987: folds 
Slav1an: raises 2001 to 4001
Negrata: folds 
XJIOPKA85: folds 
all sebas in: calls 2001
*** FLOP *** [7c 3s 5c]
all sebas in: checks 
Slav1an: bets 9433
all sebas in: folds 
Uncalled bet (9433) returned to Slav1an
Slav1an collected 12577 from pot
*** SUMMARY ***
Total pot 12577 | Rake 0 
Board [7c 3s 5c]
Seat 1: all sebas in folded on the Flop
Seat 2: jcarlos.vale folded before Flop (didn't bet)
Seat 3: biscom2007 folded before Flop (didn't bet)
Seat 4: Garrik26 folded before Flop (didn't bet)
Seat 5: felipeando folded before Flop (didn't bet)
Seat 6: Stickes1987 folded before Flop (didn't bet)
Seat 7: Slav1an (button) collected (12577)
Seat 8: Negrata (small blind) folded before Flop
Seat 9: XJIOPKA85 (big blind) folded before Flop



PokerStars Hand #222157263850: Tournament #3086083919, $0.49+$0.06 USD Hold'em No Limit - Level XXII (1000/2000) - 2021/01/03 0:53:41 EET [2021/01/02 17:53:41 ET]
Table '3086083919 96' 9-max Seat #8 is the button
Seat 1: all sebas in (85559 in chips) 
Seat 2: jcarlos.vale (29204 in chips) 
Seat 3: biscom2007 (13682 in chips) 
Seat 4: Garrik26 (47561 in chips) 
Seat 5: felipeando (64988 in chips) 
Seat 6: Stickes1987 (17180 in chips) 
Seat 7: Slav1an (80188 in chips) 
Seat 8: Negrata (11907 in chips) 
Seat 9: XJIOPKA85 (169442 in chips) 
all sebas in: posts the ante 175
jcarlos.vale: posts the ante 175
biscom2007: posts the ante 175
Garrik26: posts the ante 175
felipeando: posts the ante 175
Stickes1987: posts the ante 175
Slav1an: posts the ante 175
Negrata: posts the ante 175
XJIOPKA85: posts the ante 175
XJIOPKA85: posts small blind 1000
all sebas in: posts big blind 2000
*** HOLE CARDS ***
Dealt to jcarlos.vale [5h As]
jcarlos.vale: folds 
biscom2007: folds 
Garrik26: raises 6575 to 8575
felipeando: folds 
Stickes1987: folds 
Slav1an: folds 
Negrata: folds 
XJIOPKA85: folds 
all sebas in: folds 
Uncalled bet (6575) returned to Garrik26
Garrik26 collected 6575 from pot
Garrik26: doesn't show handDTO
*** SUMMARY ***
Total pot 6575 | Rake 0 
Seat 1: all sebas in (big blind) folded before Flop
Seat 2: jcarlos.vale folded before Flop (didn't bet)
Seat 3: biscom2007 folded before Flop (didn't bet)
Seat 4: Garrik26 collected (6575)
Seat 5: felipeando folded before Flop (didn't bet)
Seat 6: Stickes1987 folded before Flop (didn't bet)
Seat 7: Slav1an folded before Flop (didn't bet)
Seat 8: Negrata (button) folded before Flop (didn't bet)
Seat 9: XJIOPKA85 (small blind) folded before Flop



PokerStars Hand #222157293878: Tournament #3086083919, $0.49+$0.06 USD Hold'em No Limit - Level XXII (1000/2000) - 2021/01/03 0:54:16 EET [2021/01/02 17:54:16 ET]
Table '3086083919 96' 9-max Seat #9 is the button
Seat 1: all sebas in (83384 in chips) 
Seat 2: jcarlos.vale (29029 in chips) 
Seat 3: biscom2007 (13507 in chips) 
Seat 4: Garrik26 (51961 in chips) 
Seat 5: felipeando (64813 in chips) 
Seat 6: Stickes1987 (17005 in chips) 
Seat 7: Slav1an (80013 in chips) 
Seat 8: Negrata (11732 in chips) 
Seat 9: XJIOPKA85 (168267 in chips) 
all sebas in: posts the ante 175
jcarlos.vale: posts the ante 175
biscom2007: posts the ante 175
Garrik26: posts the ante 175
felipeando: posts the ante 175
Stickes1987: posts the ante 175
Slav1an: posts the ante 175
Negrata: posts the ante 175
XJIOPKA85: posts the ante 175
all sebas in: posts small blind 1000
jcarlos.vale: posts big blind 2000
*** HOLE CARDS ***
Dealt to jcarlos.vale [Kc 8c]
biscom2007: folds 
Garrik26: folds 
felipeando: folds 
Stickes1987: folds 
Slav1an: folds 
Negrata: folds 
XJIOPKA85: folds 
all sebas in: calls 1000
jcarlos.vale: checks 
*** FLOP *** [9d 8d As]
all sebas in: bets 2000
jcarlos.vale: folds 
Uncalled bet (2000) returned to all sebas in
all sebas in collected 5575 from pot
*** SUMMARY ***
Total pot 5575 | Rake 0 
Board [9d 8d As]
Seat 1: all sebas in (small blind) collected (5575)
Seat 2: jcarlos.vale (big blind) folded on the Flop
Seat 3: biscom2007 folded before Flop (didn't bet)
Seat 4: Garrik26 folded before Flop (didn't bet)
Seat 5: felipeando folded before Flop (didn't bet)
Seat 6: Stickes1987 folded before Flop (didn't bet)
Seat 7: Slav1an folded before Flop (didn't bet)
Seat 8: Negrata folded before Flop (didn't bet)
Seat 9: XJIOPKA85 (button) folded before Flop (didn't bet)



PokerStars Hand #222157326357: Tournament #3086083919, $0.49+$0.06 USD Hold'em No Limit - Level XXII (1000/2000) - 2021/01/03 0:54:54 EET [2021/01/02 17:54:54 ET]
Table '3086083919 96' 9-max Seat #1 is the button
Seat 1: all sebas in (86784 in chips) 
Seat 2: jcarlos.vale (26854 in chips) 
Seat 3: biscom2007 (13332 in chips) 
Seat 4: Garrik26 (51786 in chips) 
Seat 5: felipeando (64638 in chips) 
Seat 6: Stickes1987 (16830 in chips) 
Seat 7: Slav1an (79838 in chips) 
Seat 8: Negrata (11557 in chips) 
Seat 9: XJIOPKA85 (168092 in chips) 
all sebas in: posts the ante 175
jcarlos.vale: posts the ante 175
biscom2007: posts the ante 175
Garrik26: posts the ante 175
felipeando: posts the ante 175
Stickes1987: posts the ante 175
Slav1an: posts the ante 175
Negrata: posts the ante 175
XJIOPKA85: posts the ante 175
jcarlos.vale: posts small blind 1000
biscom2007: posts big blind 2000
*** HOLE CARDS ***
Dealt to jcarlos.vale [4d 7d]
Garrik26: folds 
felipeando: folds 
Stickes1987: folds 
Slav1an: raises 2001 to 4001
Negrata: folds 
XJIOPKA85: folds 
all sebas in: folds 
jcarlos.vale: folds 
biscom2007: calls 2001
*** FLOP *** [3d 9h Th]
biscom2007: checks 
Slav1an: bets 75662 and is all-in
biscom2007: calls 9156 and is all-in
Uncalled bet (66506) returned to Slav1an
*** TURN *** [3d 9h Th] [4h]
*** RIVER *** [3d 9h Th 4h] [5h]
*** SHOW DOWN ***
biscom2007: shows [Tc Jc] (a pair of Tens)
Slav1an: shows [9d 8d] (a pair of Nines)
biscom2007 collected 28889 from pot
*** SUMMARY ***
Total pot 28889 | Rake 0 
Board [3d 9h Th 4h 5h]
Seat 1: all sebas in (button) folded before Flop (didn't bet)
Seat 2: jcarlos.vale (small blind) folded before Flop
Seat 3: biscom2007 (big blind) showed [Tc Jc] and won (28889) with a pair of Tens
Seat 4: Garrik26 folded before Flop (didn't bet)
Seat 5: felipeando folded before Flop (didn't bet)
Seat 6: Stickes1987 folded before Flop (didn't bet)
Seat 7: Slav1an showed [9d 8d] and lost with a pair of Nines
Seat 8: Negrata folded before Flop (didn't bet)
Seat 9: XJIOPKA85 folded before Flop (didn't bet)



PokerStars Hand #222157598821: Tournament #3086083919, $0.49+$0.06 USD Hold'em No Limit - Level XXII (1000/2000) - 2021/01/03 1:01:54 EET [2021/01/02 18:01:54 ET]
Table '3086083919 96' 9-max Seat #2 is the button
Seat 1: all sebas in (86609 in chips) 
Seat 2: jcarlos.vale (25679 in chips) 
Seat 3: biscom2007 (28889 in chips) 
Seat 4: Garrik26 (51611 in chips) 
Seat 5: felipeando (64463 in chips) 
Seat 6: Stickes1987 (16655 in chips) 
Seat 7: Slav1an (66506 in chips) 
Seat 8: Negrata (11382 in chips) 
Seat 9: XJIOPKA85 (167917 in chips) 
all sebas in: posts the ante 175
jcarlos.vale: posts the ante 175
biscom2007: posts the ante 175
Garrik26: posts the ante 175
felipeando: posts the ante 175
Stickes1987: posts the ante 175
Slav1an: posts the ante 175
Negrata: posts the ante 175
XJIOPKA85: posts the ante 175
biscom2007: posts small blind 1000
Garrik26: posts big blind 2000
*** HOLE CARDS ***
Dealt to jcarlos.vale [Qc 6h]
felipeando: folds 
Stickes1987: folds 
Slav1an: folds 
Negrata: folds 
XJIOPKA85: folds 
all sebas in: folds 
jcarlos.vale: folds 
biscom2007: raises 2000 to 4000
Garrik26: folds 
Uncalled bet (2000) returned to biscom2007
biscom2007 collected 5575 from pot
biscom2007: doesn't show handDTO
*** SUMMARY ***
Total pot 5575 | Rake 0 
Seat 1: all sebas in folded before Flop (didn't bet)
Seat 2: jcarlos.vale (button) folded before Flop (didn't bet)
Seat 3: biscom2007 (small blind) collected (5575)
Seat 4: Garrik26 (big blind) folded before Flop
Seat 5: felipeando folded before Flop (didn't bet)
Seat 6: Stickes1987 folded before Flop (didn't bet)
Seat 7: Slav1an folded before Flop (didn't bet)
Seat 8: Negrata folded before Flop (didn't bet)
Seat 9: XJIOPKA85 folded before Flop (didn't bet)



PokerStars Hand #222157626681: Tournament #3086083919, $0.49+$0.06 USD Hold'em No Limit - Level XXII (1000/2000) - 2021/01/03 1:02:28 EET [2021/01/02 18:02:28 ET]
Table '3086083919 96' 9-max Seat #3 is the button
Seat 1: all sebas in (86434 in chips) 
Seat 2: jcarlos.vale (25504 in chips) 
Seat 3: biscom2007 (32289 in chips) 
Seat 4: Garrik26 (49436 in chips) 
Seat 5: felipeando (64288 in chips) 
Seat 6: Stickes1987 (16480 in chips) 
Seat 7: Slav1an (66331 in chips) 
Seat 8: Negrata (11207 in chips) 
Seat 9: XJIOPKA85 (167742 in chips) 
all sebas in: posts the ante 175
jcarlos.vale: posts the ante 175
biscom2007: posts the ante 175
Garrik26: posts the ante 175
felipeando: posts the ante 175
Stickes1987: posts the ante 175
Slav1an: posts the ante 175
Negrata: posts the ante 175
XJIOPKA85: posts the ante 175
Garrik26: posts small blind 1000
felipeando: posts big blind 2000
*** HOLE CARDS ***
Dealt to jcarlos.vale [8h 4s]
Stickes1987: folds 
Slav1an: folds 
Negrata: folds 
XJIOPKA85: folds 
all sebas in: folds 
jcarlos.vale: folds 
biscom2007: raises 2000 to 4000
Garrik26: folds 
felipeando: calls 2000
*** FLOP *** [7s Ac Ah]
felipeando: checks 
biscom2007: checks 
*** TURN *** [7s Ac Ah] [5d]
felipeando: checks 
biscom2007: checks 
*** RIVER *** [7s Ac Ah 5d] [5s]
felipeando: checks 
biscom2007: bets 4000
felipeando: folds 
Uncalled bet (4000) returned to biscom2007
biscom2007 collected 10575 from pot
biscom2007: doesn't show handDTO
*** SUMMARY ***
Total pot 10575 | Rake 0 
Board [7s Ac Ah 5d 5s]
Seat 1: all sebas in folded before Flop (didn't bet)
Seat 2: jcarlos.vale folded before Flop (didn't bet)
Seat 3: biscom2007 (button) collected (10575)
Seat 4: Garrik26 (small blind) folded before Flop
Seat 5: felipeando (big blind) folded on the River
Seat 6: Stickes1987 folded before Flop (didn't bet)
Seat 7: Slav1an folded before Flop (didn't bet)
Seat 8: Negrata folded before Flop (didn't bet)
Seat 9: XJIOPKA85 folded before Flop (didn't bet)



PokerStars Hand #222157679972: Tournament #3086083919, $0.49+$0.06 USD Hold'em No Limit - Level XXII (1000/2000) - 2021/01/03 1:03:32 EET [2021/01/02 18:03:32 ET]
Table '3086083919 96' 9-max Seat #4 is the button
Seat 1: all sebas in (86259 in chips) 
Seat 2: jcarlos.vale (25329 in chips) 
Seat 3: biscom2007 (38689 in chips) 
Seat 4: Garrik26 (48261 in chips) 
Seat 5: felipeando (60113 in chips) 
Seat 6: Stickes1987 (16305 in chips) 
Seat 7: Slav1an (66156 in chips) 
Seat 8: Negrata (11032 in chips) 
Seat 9: XJIOPKA85 (167567 in chips) 
all sebas in: posts the ante 175
jcarlos.vale: posts the ante 175
biscom2007: posts the ante 175
Garrik26: posts the ante 175
felipeando: posts the ante 175
Stickes1987: posts the ante 175
Slav1an: posts the ante 175
Negrata: posts the ante 175
XJIOPKA85: posts the ante 175
felipeando: posts small blind 1000
Stickes1987: posts big blind 2000
*** HOLE CARDS ***
Dealt to jcarlos.vale [Js Tc]
Slav1an: folds 
Negrata: folds 
XJIOPKA85: raises 2260 to 4260
all sebas in: folds 
jcarlos.vale: folds 
biscom2007: folds 
Garrik26: folds 
felipeando: folds 
Stickes1987: folds 
Uncalled bet (2260) returned to XJIOPKA85
XJIOPKA85 collected 6575 from pot
*** SUMMARY ***
Total pot 6575 | Rake 0 
Seat 1: all sebas in folded before Flop (didn't bet)
Seat 2: jcarlos.vale folded before Flop (didn't bet)
Seat 3: biscom2007 folded before Flop (didn't bet)
Seat 4: Garrik26 (button) folded before Flop (didn't bet)
Seat 5: felipeando (small blind) folded before Flop
Seat 6: Stickes1987 (big blind) folded before Flop
Seat 7: Slav1an folded before Flop (didn't bet)
Seat 8: Negrata folded before Flop (didn't bet)
Seat 9: XJIOPKA85 collected (6575)



PokerStars Hand #222157705968: Tournament #3086083919, $0.49+$0.06 USD Hold'em No Limit - Level XXII (1000/2000) - 2021/01/03 1:04:03 EET [2021/01/02 18:04:03 ET]
Table '3086083919 96' 9-max Seat #5 is the button
Seat 1: all sebas in (86084 in chips) 
Seat 2: jcarlos.vale (25154 in chips) 
Seat 3: biscom2007 (38514 in chips) 
Seat 4: Garrik26 (48086 in chips) 
Seat 5: felipeando (58938 in chips) 
Seat 6: Stickes1987 (14130 in chips) 
Seat 7: Slav1an (65981 in chips) 
Seat 8: Negrata (10857 in chips) 
Seat 9: XJIOPKA85 (171967 in chips) 
all sebas in: posts the ante 175
jcarlos.vale: posts the ante 175
biscom2007: posts the ante 175
Garrik26: posts the ante 175
felipeando: posts the ante 175
Stickes1987: posts the ante 175
Slav1an: posts the ante 175
Negrata: posts the ante 175
XJIOPKA85: posts the ante 175
Stickes1987: posts small blind 1000
Slav1an: posts big blind 2000
*** HOLE CARDS ***
Dealt to jcarlos.vale [Td Kd]
Negrata: folds 
XJIOPKA85: folds 
all sebas in: calls 2000
jcarlos.vale: calls 2000
biscom2007: folds 
Garrik26: raises 45911 to 47911 and is all-in
felipeando: folds 
Stickes1987: folds 
Slav1an: folds 
all sebas in: calls 45911
jcarlos.vale: folds 
*** FLOP *** [2s Tc 4h]
*** TURN *** [2s Tc 4h] [3h]
*** RIVER *** [2s Tc 4h 3h] [Ks]
*** SHOW DOWN ***
all sebas in: shows [Ac Kh] (a pair of Kings)
Garrik26: shows [Ad Kc] (a pair of Kings)
all sebas in collected 51199 from pot
Garrik26 collected 51198 from pot
*** SUMMARY ***
Total pot 102397 | Rake 0 
Board [2s Tc 4h 3h Ks]
Seat 1: all sebas in showed [Ac Kh] and won (51199) with a pair of Kings
Seat 2: jcarlos.vale folded before Flop
Seat 3: biscom2007 folded before Flop (didn't bet)
Seat 4: Garrik26 showed [Ad Kc] and won (51198) with a pair of Kings
Seat 5: felipeando (button) folded before Flop (didn't bet)
Seat 6: Stickes1987 (small blind) folded before Flop
Seat 7: Slav1an (big blind) folded before Flop
Seat 8: Negrata folded before Flop (didn't bet)
Seat 9: XJIOPKA85 folded before Flop (didn't bet)



PokerStars Hand #222157744795: Tournament #3086083919, $0.49+$0.06 USD Hold'em No Limit - Level XXII (1000/2000) - 2021/01/03 1:04:50 EET [2021/01/02 18:04:50 ET]
Table '3086083919 96' 9-max Seat #6 is the button
Seat 1: all sebas in (89197 in chips) 
Seat 2: jcarlos.vale (22979 in chips) 
Seat 3: biscom2007 (38339 in chips) 
Seat 4: Garrik26 (51198 in chips) 
Seat 5: felipeando (58763 in chips) 
Seat 6: Stickes1987 (12955 in chips) 
Seat 7: Slav1an (63806 in chips) 
Seat 8: Negrata (10682 in chips) 
Seat 9: XJIOPKA85 (171792 in chips) 
all sebas in: posts the ante 175
jcarlos.vale: posts the ante 175
biscom2007: posts the ante 175
Garrik26: posts the ante 175
felipeando: posts the ante 175
Stickes1987: posts the ante 175
Slav1an: posts the ante 175
Negrata: posts the ante 175
XJIOPKA85: posts the ante 175
Slav1an: posts small blind 1000
Negrata: posts big blind 2000
*** HOLE CARDS ***
Dealt to jcarlos.vale [Qd Ac]
XJIOPKA85: folds 
all sebas in: folds 
jcarlos.vale: raises 20804 to 22804 and is all-in
biscom2007: folds 
Garrik26: folds 
felipeando: folds 
Stickes1987: folds 
Slav1an: folds 
Negrata: calls 8507 and is all-in
Uncalled bet (12297) returned to jcarlos.vale
*** FLOP *** [Ts 7c 7h]
*** TURN *** [Ts 7c 7h] [2d]
*** RIVER *** [Ts 7c 7h 2d] [5s]
*** SHOW DOWN ***
Negrata: shows [Qh Ks] (a pair of Sevens)
jcarlos.vale: shows [Qd Ac] (a pair of Sevens - Ace kicker)
jcarlos.vale collected 23589 from pot
Negrata finished the tournament in 220th place and received $1.75.
*** SUMMARY ***
Total pot 23589 | Rake 0 
Board [Ts 7c 7h 2d 5s]
Seat 1: all sebas in folded before Flop (didn't bet)
Seat 2: jcarlos.vale showed [Qd Ac] and won (23589) with a pair of Sevens
Seat 3: biscom2007 folded before Flop (didn't bet)
Seat 4: Garrik26 folded before Flop (didn't bet)
Seat 5: felipeando folded before Flop (didn't bet)
Seat 6: Stickes1987 (button) folded before Flop (didn't bet)
Seat 7: Slav1an (small blind) folded before Flop
Seat 8: Negrata (big blind) showed [Qh Ks] and lost with a pair of Sevens
Seat 9: XJIOPKA85 folded before Flop (didn't bet)



PokerStars Hand #222157772334: Tournament #3086083919, $0.49+$0.06 USD Hold'em No Limit - Level XXII (1000/2000) - 2021/01/03 1:05:23 EET [2021/01/02 18:05:23 ET]
Table '3086083919 96' 9-max Seat #7 is the button
Seat 1: all sebas in (89022 in chips) 
Seat 2: jcarlos.vale (35886 in chips) 
Seat 3: biscom2007 (38164 in chips) 
Seat 4: Garrik26 (51023 in chips) 
Seat 5: felipeando (58588 in chips) 
Seat 6: Stickes1987 (12780 in chips) 
Seat 7: Slav1an (62631 in chips) 
Seat 9: XJIOPKA85 (171617 in chips) 
all sebas in: posts the ante 175
jcarlos.vale: posts the ante 175
biscom2007: posts the ante 175
Garrik26: posts the ante 175
felipeando: posts the ante 175
Stickes1987: posts the ante 175
Slav1an: posts the ante 175
XJIOPKA85: posts the ante 175
XJIOPKA85: posts small blind 1000
all sebas in: posts big blind 2000
*** HOLE CARDS ***
Dealt to jcarlos.vale [7c Th]
jcarlos.vale: folds 
biscom2007: calls 2000
Garrik26: calls 2000
felipeando: folds 
Stickes1987: folds 
Slav1an: folds 
XJIOPKA85: folds 
all sebas in: checks 
*** FLOP *** [8s Qd Jc]
all sebas in: bets 2000
biscom2007: folds 
Garrik26: calls 2000
*** TURN *** [8s Qd Jc] [9d]
all sebas in: bets 2000
Garrik26: raises 2000 to 4000
all sebas in: calls 2000
*** RIVER *** [8s Qd Jc 9d] [Ah]
all sebas in: bets 2000
Garrik26: raises 2000 to 4000
all sebas in: calls 2000
*** SHOW DOWN ***
Garrik26: shows [Ac Td] (a straight, Eight to Queen)
all sebas in: mucks handDTO
Garrik26 collected 28400 from pot
*** SUMMARY ***
Total pot 28400 | Rake 0 
Board [8s Qd Jc 9d Ah]
Seat 1: all sebas in (big blind) mucked [8h Qc]
Seat 2: jcarlos.vale folded before Flop (didn't bet)
Seat 3: biscom2007 folded on the Flop
Seat 4: Garrik26 showed [Ac Td] and won (28400) with a straight, Eight to Queen
Seat 5: felipeando folded before Flop (didn't bet)
Seat 6: Stickes1987 folded before Flop (didn't bet)
Seat 7: Slav1an (button) folded before Flop (didn't bet)
Seat 9: XJIOPKA85 (small blind) folded before Flop



PokerStars Hand #222157815189: Tournament #3086083919, $0.49+$0.06 USD Hold'em No Limit - Level XXII (1000/2000) - 2021/01/03 1:06:15 EET [2021/01/02 18:06:15 ET]
Table '3086083919 96' 9-max Seat #9 is the button
Seat 1: all sebas in (76847 in chips) 
Seat 2: jcarlos.vale (35711 in chips) 
Seat 3: biscom2007 (35989 in chips) 
Seat 4: Garrik26 (67248 in chips) 
Seat 5: felipeando (58413 in chips) 
Seat 6: Stickes1987 (12605 in chips) 
Seat 7: Slav1an (62456 in chips) 
Seat 9: XJIOPKA85 (170442 in chips) 
all sebas in: posts the ante 175
jcarlos.vale: posts the ante 175
biscom2007: posts the ante 175
Garrik26: posts the ante 175
felipeando: posts the ante 175
Stickes1987: posts the ante 175
Slav1an: posts the ante 175
XJIOPKA85: posts the ante 175
all sebas in: posts small blind 1000
jcarlos.vale: posts big blind 2000
*** HOLE CARDS ***
Dealt to jcarlos.vale [3s Ac]
biscom2007: folds 
Garrik26: calls 2000
felipeando: folds 
Stickes1987: folds 
Slav1an: folds 
XJIOPKA85: raises 4000 to 6000
all sebas in: folds 
jcarlos.vale: folds 
Garrik26: folds 
Uncalled bet (4000) returned to XJIOPKA85
XJIOPKA85 collected 8400 from pot
*** SUMMARY ***
Total pot 8400 | Rake 0 
Seat 1: all sebas in (small blind) folded before Flop
Seat 2: jcarlos.vale (big blind) folded before Flop
Seat 3: biscom2007 folded before Flop (didn't bet)
Seat 4: Garrik26 folded before Flop
Seat 5: felipeando folded before Flop (didn't bet)
Seat 6: Stickes1987 folded before Flop (didn't bet)
Seat 7: Slav1an folded before Flop (didn't bet)
Seat 9: XJIOPKA85 (button) collected (8400)



PokerStars Hand #222157831166: Tournament #3086083919, $0.49+$0.06 USD Hold'em No Limit - Level XXII (1000/2000) - 2021/01/03 1:06:34 EET [2021/01/02 18:06:34 ET]
Table '3086083919 96' 9-max Seat #1 is the button
Seat 1: all sebas in (75672 in chips) 
Seat 2: jcarlos.vale (33536 in chips) 
Seat 3: biscom2007 (35814 in chips) 
Seat 4: Garrik26 (65073 in chips) 
Seat 5: felipeando (58238 in chips) 
Seat 6: Stickes1987 (12430 in chips) 
Seat 7: Slav1an (62281 in chips) 
Seat 9: XJIOPKA85 (176667 in chips) 
all sebas in: posts the ante 175
jcarlos.vale: posts the ante 175
biscom2007: posts the ante 175
Garrik26: posts the ante 175
felipeando: posts the ante 175
Stickes1987: posts the ante 175
Slav1an: posts the ante 175
XJIOPKA85: posts the ante 175
jcarlos.vale: posts small blind 1000
biscom2007: posts big blind 2000
*** HOLE CARDS ***
Dealt to jcarlos.vale [7s Kh]
Garrik26: folds 
felipeando: folds 
Stickes1987: folds 
Slav1an: folds 
XJIOPKA85: folds 
all sebas in: folds 
jcarlos.vale: calls 1000
biscom2007: checks 
*** FLOP *** [7d 6c Ac]
jcarlos.vale: bets 2000
biscom2007: folds 
Uncalled bet (2000) returned to jcarlos.vale
jcarlos.vale collected 5400 from pot
jcarlos.vale: doesn't show handDTO
*** SUMMARY ***
Total pot 5400 | Rake 0 
Board [7d 6c Ac]
Seat 1: all sebas in (button) folded before Flop (didn't bet)
Seat 2: jcarlos.vale (small blind) collected (5400)
Seat 3: biscom2007 (big blind) folded on the Flop
Seat 4: Garrik26 folded before Flop (didn't bet)
Seat 5: felipeando folded before Flop (didn't bet)
Seat 6: Stickes1987 folded before Flop (didn't bet)
Seat 7: Slav1an folded before Flop (didn't bet)
Seat 9: XJIOPKA85 folded before Flop (didn't bet)



PokerStars Hand #222157866375: Tournament #3086083919, $0.49+$0.06 USD Hold'em No Limit - Level XXII (1000/2000) - 2021/01/03 1:07:17 EET [2021/01/02 18:07:17 ET]
Table '3086083919 96' 9-max Seat #2 is the button
Seat 1: all sebas in (75497 in chips) 
Seat 2: jcarlos.vale (36761 in chips) 
Seat 3: biscom2007 (33639 in chips) 
Seat 4: Garrik26 (64898 in chips) 
Seat 5: felipeando (58063 in chips) 
Seat 6: Stickes1987 (12255 in chips) 
Seat 7: Slav1an (62106 in chips) 
Seat 8: Russian Goat (49602 in chips) 
Seat 9: XJIOPKA85 (176492 in chips) 
all sebas in: posts the ante 175
jcarlos.vale: posts the ante 175
biscom2007: posts the ante 175
Garrik26: posts the ante 175
felipeando: posts the ante 175
Stickes1987: posts the ante 175
Slav1an: posts the ante 175
Russian Goat: posts the ante 175
XJIOPKA85: posts the ante 175
biscom2007: posts small blind 1000
Garrik26: posts big blind 2000
*** HOLE CARDS ***
Dealt to jcarlos.vale [2h Kh]
felipeando: folds 
Stickes1987 is disconnected 
Stickes1987 is connected 
Stickes1987: raises 10080 to 12080 and is all-in
Slav1an: folds 
Russian Goat: folds 
XJIOPKA85: folds 
all sebas in: calls 12080
jcarlos.vale: folds 
biscom2007: folds 
Garrik26: folds 
*** FLOP *** [4d 3h 8d]
*** TURN *** [4d 3h 8d] [Tc]
*** RIVER *** [4d 3h 8d Tc] [7h]
*** SHOW DOWN ***
Stickes1987: shows [Qh Ad] (high pairOfCards Ace)
all sebas in: shows [2d 2s] (a pair of Deuces)
all sebas in collected 28735 from pot
Stickes1987 finished the tournament in 212th place and received $1.75.
*** SUMMARY ***
Total pot 28735 | Rake 0 
Board [4d 3h 8d Tc 7h]
Seat 1: all sebas in showed [2d 2s] and won (28735) with a pair of Deuces
Seat 2: jcarlos.vale (button) folded before Flop (didn't bet)
Seat 3: biscom2007 (small blind) folded before Flop
Seat 4: Garrik26 (big blind) folded before Flop
Seat 5: felipeando folded before Flop (didn't bet)
Seat 6: Stickes1987 showed [Qh Ad] and lost with high pairOfCards Ace
Seat 7: Slav1an folded before Flop (didn't bet)
Seat 8: Russian Goat folded before Flop (didn't bet)
Seat 9: XJIOPKA85 folded before Flop (didn't bet)



PokerStars Hand #222157902225: Tournament #3086083919, $0.49+$0.06 USD Hold'em No Limit - Level XXIII (1250/2500) - 2021/01/03 1:08:01 EET [2021/01/02 18:08:01 ET]
Table '3086083919 96' 9-max Seat #3 is the button
Seat 1: all sebas in (91977 in chips) 
Seat 2: jcarlos.vale (36586 in chips) 
Seat 3: biscom2007 (32464 in chips) 
Seat 4: Garrik26 (62723 in chips) 
Seat 5: felipeando (57888 in chips) 
Seat 7: Slav1an (61931 in chips) 
Seat 8: Russian Goat (49427 in chips) 
Seat 9: XJIOPKA85 (176317 in chips) 
all sebas in: posts the ante 200
jcarlos.vale: posts the ante 200
biscom2007: posts the ante 200
Garrik26: posts the ante 200
felipeando: posts the ante 200
Slav1an: posts the ante 200
Russian Goat: posts the ante 200
XJIOPKA85: posts the ante 200
Garrik26: posts small blind 1250
felipeando: posts big blind 2500
*** HOLE CARDS ***
Dealt to jcarlos.vale [6d 4d]
Slav1an: raises 2501 to 5001
Russian Goat: folds 
XJIOPKA85: folds 
all sebas in: calls 5001
jcarlos.vale: folds 
biscom2007: folds 
Garrik26: folds 
felipeando: folds 
*** FLOP *** [2s 9s 3c]
Slav1an: bets 4606
all sebas in: folds 
Uncalled bet (4606) returned to Slav1an
Slav1an collected 15352 from pot
*** SUMMARY ***
Total pot 15352 | Rake 0 
Board [2s 9s 3c]
Seat 1: all sebas in folded on the Flop
Seat 2: jcarlos.vale folded before Flop (didn't bet)
Seat 3: biscom2007 (button) folded before Flop (didn't bet)
Seat 4: Garrik26 (small blind) folded before Flop
Seat 5: felipeando (big blind) folded before Flop
Seat 7: Slav1an collected (15352)
Seat 8: Russian Goat folded before Flop (didn't bet)
Seat 9: XJIOPKA85 folded before Flop (didn't bet)



PokerStars Hand #222157944403: Tournament #3086083919, $0.49+$0.06 USD Hold'em No Limit - Level XXIII (1250/2500) - 2021/01/03 1:08:52 EET [2021/01/02 18:08:52 ET]
Table '3086083919 96' 9-max Seat #4 is the button
Seat 1: all sebas in (86776 in chips) 
Seat 2: jcarlos.vale (36386 in chips) 
Seat 3: biscom2007 (32264 in chips) 
Seat 4: Garrik26 (61273 in chips) 
Seat 5: felipeando (55188 in chips) 
Seat 7: Slav1an (72082 in chips) 
Seat 8: Russian Goat (49227 in chips) 
Seat 9: XJIOPKA85 (176117 in chips) 
all sebas in: posts the ante 200
jcarlos.vale: posts the ante 200
biscom2007: posts the ante 200
Garrik26: posts the ante 200
felipeando: posts the ante 200
Slav1an: posts the ante 200
Russian Goat: posts the ante 200
XJIOPKA85: posts the ante 200
felipeando: posts small blind 1250
Slav1an: posts big blind 2500
*** HOLE CARDS ***
Dealt to jcarlos.vale [Ac 7c]
Russian Goat: folds 
XJIOPKA85: folds 
all sebas in: folds 
jcarlos.vale: raises 4000 to 6500
biscom2007: folds 
Garrik26: folds 
felipeando: folds 
Slav1an: folds 
Uncalled bet (4000) returned to jcarlos.vale
jcarlos.vale collected 7850 from pot
jcarlos.vale: doesn't show handDTO
*** SUMMARY ***
Total pot 7850 | Rake 0 
Seat 1: all sebas in folded before Flop (didn't bet)
Seat 2: jcarlos.vale collected (7850)
Seat 3: biscom2007 folded before Flop (didn't bet)
Seat 4: Garrik26 (button) folded before Flop (didn't bet)
Seat 5: felipeando (small blind) folded before Flop
Seat 7: Slav1an (big blind) folded before Flop
Seat 8: Russian Goat folded before Flop (didn't bet)
Seat 9: XJIOPKA85 folded before Flop (didn't bet)



PokerStars Hand #222157963193: Tournament #3086083919, $0.49+$0.06 USD Hold'em No Limit - Level XXIII (1250/2500) - 2021/01/03 1:09:15 EET [2021/01/02 18:09:15 ET]
Table '3086083919 96' 9-max Seat #5 is the button
Seat 1: all sebas in (86576 in chips) 
Seat 2: jcarlos.vale (41536 in chips) 
Seat 3: biscom2007 (32064 in chips) 
Seat 4: Garrik26 (61073 in chips) 
Seat 5: felipeando (53738 in chips) 
Seat 7: Slav1an (69382 in chips) 
Seat 8: Russian Goat (49027 in chips) 
Seat 9: XJIOPKA85 (175917 in chips) 
all sebas in: posts the ante 200
jcarlos.vale: posts the ante 200
biscom2007: posts the ante 200
Garrik26: posts the ante 200
felipeando: posts the ante 200
Slav1an: posts the ante 200
Russian Goat: posts the ante 200
XJIOPKA85: posts the ante 200
Slav1an: posts small blind 1250
Russian Goat: posts big blind 2500
*** HOLE CARDS ***
Dealt to jcarlos.vale [3c Js]
XJIOPKA85: folds 
all sebas in: folds 
jcarlos.vale: folds 
biscom2007: folds 
Garrik26: folds 
felipeando: folds 
Slav1an: raises 2500 to 5000
Russian Goat: calls 2500
*** FLOP *** [Kc Th Tc]
Slav1an: bets 3480
Russian Goat: folds 
Uncalled bet (3480) returned to Slav1an
Slav1an collected 11600 from pot
*** SUMMARY ***
Total pot 11600 | Rake 0 
Board [Kc Th Tc]
Seat 1: all sebas in folded before Flop (didn't bet)
Seat 2: jcarlos.vale folded before Flop (didn't bet)
Seat 3: biscom2007 folded before Flop (didn't bet)
Seat 4: Garrik26 folded before Flop (didn't bet)
Seat 5: felipeando (button) folded before Flop (didn't bet)
Seat 7: Slav1an (small blind) collected (11600)
Seat 8: Russian Goat (big blind) folded on the Flop
Seat 9: XJIOPKA85 folded before Flop (didn't bet)



PokerStars Hand #222158006261: Tournament #3086083919, $0.49+$0.06 USD Hold'em No Limit - Level XXIII (1250/2500) - 2021/01/03 1:10:08 EET [2021/01/02 18:10:08 ET]
Table '3086083919 96' 9-max Seat #7 is the button
Seat 1: all sebas in (86376 in chips) 
Seat 2: jcarlos.vale (41336 in chips) 
Seat 3: biscom2007 (31864 in chips) 
Seat 4: Garrik26 (60873 in chips) 
Seat 5: felipeando (53538 in chips) 
Seat 6: loowayking (37119 in chips) 
Seat 7: Slav1an (75782 in chips) 
Seat 8: Russian Goat (43827 in chips) 
Seat 9: XJIOPKA85 (175717 in chips) 
all sebas in: posts the ante 200
jcarlos.vale: posts the ante 200
biscom2007: posts the ante 200
Garrik26: posts the ante 200
felipeando: posts the ante 200
loowayking: posts the ante 200
Slav1an: posts the ante 200
Russian Goat: posts the ante 200
XJIOPKA85: posts the ante 200
Russian Goat: posts small blind 1250
XJIOPKA85: posts big blind 2500
*** HOLE CARDS ***
Dealt to jcarlos.vale [Jh 4c]
all sebas in: folds 
jcarlos.vale: folds 
biscom2007: calls 2500
Garrik26: folds 
felipeando: folds 
loowayking: folds 
Slav1an: folds 
Russian Goat: calls 1250
XJIOPKA85: checks 
*** FLOP *** [Ks 7s Ah]
Russian Goat: checks 
XJIOPKA85: checks 
biscom2007: bets 4650
Russian Goat: folds 
XJIOPKA85: folds 
Uncalled bet (4650) returned to biscom2007
biscom2007 collected 9300 from pot
biscom2007: doesn't show handDTO
*** SUMMARY ***
Total pot 9300 | Rake 0 
Board [Ks 7s Ah]
Seat 1: all sebas in folded before Flop (didn't bet)
Seat 2: jcarlos.vale folded before Flop (didn't bet)
Seat 3: biscom2007 collected (9300)
Seat 4: Garrik26 folded before Flop (didn't bet)
Seat 5: felipeando folded before Flop (didn't bet)
Seat 6: loowayking folded before Flop (didn't bet)
Seat 7: Slav1an (button) folded before Flop (didn't bet)
Seat 8: Russian Goat (small blind) folded on the Flop
Seat 9: XJIOPKA85 (big blind) folded on the Flop



PokerStars Hand #222158047496: Tournament #3086083919, $0.49+$0.06 USD Hold'em No Limit - Level XXIII (1250/2500) - 2021/01/03 1:10:59 EET [2021/01/02 18:10:59 ET]
Table '3086083919 96' 9-max Seat #8 is the button
Seat 1: all sebas in (86176 in chips) 
Seat 2: jcarlos.vale (41136 in chips) 
Seat 3: biscom2007 (38464 in chips) 
Seat 4: Garrik26 (60673 in chips) 
Seat 5: felipeando (53338 in chips) 
Seat 6: loowayking (36919 in chips) 
Seat 7: Slav1an (75582 in chips) 
Seat 8: Russian Goat (41127 in chips) 
Seat 9: XJIOPKA85 (173017 in chips) 
all sebas in: posts the ante 200
jcarlos.vale: posts the ante 200
biscom2007: posts the ante 200
Garrik26: posts the ante 200
felipeando: posts the ante 200
loowayking: posts the ante 200
Slav1an: posts the ante 200
Russian Goat: posts the ante 200
XJIOPKA85: posts the ante 200
XJIOPKA85: posts small blind 1250
all sebas in: posts big blind 2500
*** HOLE CARDS ***
Dealt to jcarlos.vale [9h Qc]
jcarlos.vale: folds 
biscom2007: folds 
Garrik26: folds 
felipeando: raises 2500 to 5000
loowayking: folds 
Slav1an: folds 
Russian Goat: folds 
XJIOPKA85: folds 
all sebas in: calls 2500
*** FLOP *** [8h Jc 7c]
all sebas in: bets 2500
felipeando: raises 45638 to 48138 and is all-in
all sebas in: calls 45638
*** TURN *** [8h Jc 7c] [As]
*** RIVER *** [8h Jc 7c As] [6s]
*** SHOW DOWN ***
all sebas in: shows [Ah Tc] (a pair of Aces)
felipeando: shows [Ac Js] (two pair, Aces and Jacks)
felipeando collected 109326 from pot
*** SUMMARY ***
Total pot 109326 | Rake 0 
Board [8h Jc 7c As 6s]
Seat 1: all sebas in (big blind) showed [Ah Tc] and lost with a pair of Aces
Seat 2: jcarlos.vale folded before Flop (didn't bet)
Seat 3: biscom2007 folded before Flop (didn't bet)
Seat 4: Garrik26 folded before Flop (didn't bet)
Seat 5: felipeando showed [Ac Js] and won (109326) with two pair, Aces and Jacks
Seat 6: loowayking folded before Flop (didn't bet)
Seat 7: Slav1an folded before Flop (didn't bet)
Seat 8: Russian Goat (button) folded before Flop (didn't bet)
Seat 9: XJIOPKA85 (small blind) folded before Flop



PokerStars Hand #222158080783: Tournament #3086083919, $0.49+$0.06 USD Hold'em No Limit - Level XXIII (1250/2500) - 2021/01/03 1:11:40 EET [2021/01/02 18:11:40 ET]
Table '3086083919 96' 9-max Seat #9 is the button
Seat 1: all sebas in (32838 in chips) 
Seat 2: jcarlos.vale (40936 in chips) 
Seat 3: biscom2007 (38264 in chips) 
Seat 4: Garrik26 (60473 in chips) 
Seat 5: felipeando (109326 in chips) 
Seat 6: loowayking (36719 in chips) 
Seat 7: Slav1an (75382 in chips) 
Seat 8: Russian Goat (40927 in chips) 
Seat 9: XJIOPKA85 (171567 in chips) 
all sebas in: posts the ante 200
jcarlos.vale: posts the ante 200
biscom2007: posts the ante 200
Garrik26: posts the ante 200
felipeando: posts the ante 200
loowayking: posts the ante 200
Slav1an: posts the ante 200
Russian Goat: posts the ante 200
XJIOPKA85: posts the ante 200
all sebas in: posts small blind 1250
jcarlos.vale: posts big blind 2500
*** HOLE CARDS ***
Dealt to jcarlos.vale [5h 9h]
biscom2007: calls 2500
Garrik26: folds 
felipeando: folds 
loowayking: raises 34019 to 36519 and is all-in
Slav1an: folds 
Russian Goat: folds 
XJIOPKA85: folds 
all sebas in: folds 
jcarlos.vale: folds 
biscom2007: folds 
Uncalled bet (34019) returned to loowayking
loowayking collected 10550 from pot
*** SUMMARY ***
Total pot 10550 | Rake 0 
Seat 1: all sebas in (small blind) folded before Flop
Seat 2: jcarlos.vale (big blind) folded before Flop
Seat 3: biscom2007 folded before Flop
Seat 4: Garrik26 folded before Flop (didn't bet)
Seat 5: felipeando folded before Flop (didn't bet)
Seat 6: loowayking collected (10550)
Seat 7: Slav1an folded before Flop (didn't bet)
Seat 8: Russian Goat folded before Flop (didn't bet)
Seat 9: XJIOPKA85 (button) folded before Flop (didn't bet)



PokerStars Hand #222158116420: Tournament #3086083919, $0.49+$0.06 USD Hold'em No Limit - Level XXIII (1250/2500) - 2021/01/03 1:12:25 EET [2021/01/02 18:12:25 ET]
Table '3086083919 96' 9-max Seat #1 is the button
Seat 1: all sebas in (31388 in chips) 
Seat 2: jcarlos.vale (38236 in chips) 
Seat 3: biscom2007 (35564 in chips) 
Seat 4: Garrik26 (60273 in chips) 
Seat 5: felipeando (109126 in chips) 
Seat 6: loowayking (44569 in chips) 
Seat 7: Slav1an (75182 in chips) 
Seat 8: Russian Goat (40727 in chips) 
Seat 9: XJIOPKA85 (171367 in chips) 
all sebas in: posts the ante 200
jcarlos.vale: posts the ante 200
biscom2007: posts the ante 200
Garrik26: posts the ante 200
felipeando: posts the ante 200
loowayking: posts the ante 200
Slav1an: posts the ante 200
Russian Goat: posts the ante 200
XJIOPKA85: posts the ante 200
jcarlos.vale: posts small blind 1250
biscom2007: posts big blind 2500
*** HOLE CARDS ***
Dealt to jcarlos.vale [Qh 2s]
Garrik26: folds 
felipeando: folds 
loowayking: folds 
Slav1an: raises 5000 to 7500
Russian Goat: folds 
XJIOPKA85: folds 
all sebas in: folds 
jcarlos.vale: folds 
biscom2007: folds 
Uncalled bet (5000) returned to Slav1an
Slav1an collected 8050 from pot
*** SUMMARY ***
Total pot 8050 | Rake 0 
Seat 1: all sebas in (button) folded before Flop (didn't bet)
Seat 2: jcarlos.vale (small blind) folded before Flop
Seat 3: biscom2007 (big blind) folded before Flop
Seat 4: Garrik26 folded before Flop (didn't bet)
Seat 5: felipeando folded before Flop (didn't bet)
Seat 6: loowayking folded before Flop (didn't bet)
Seat 7: Slav1an collected (8050)
Seat 8: Russian Goat folded before Flop (didn't bet)
Seat 9: XJIOPKA85 folded before Flop (didn't bet)



PokerStars Hand #222158139929: Tournament #3086083919, $0.49+$0.06 USD Hold'em No Limit - Level XXIII (1250/2500) - 2021/01/03 1:12:54 EET [2021/01/02 18:12:54 ET]
Table '3086083919 96' 9-max Seat #2 is the button
Seat 1: all sebas in (31188 in chips) 
Seat 2: jcarlos.vale (36786 in chips) 
Seat 3: biscom2007 (32864 in chips) 
Seat 4: Garrik26 (60073 in chips) 
Seat 5: felipeando (108926 in chips) 
Seat 6: loowayking (44369 in chips) 
Seat 7: Slav1an (80532 in chips) 
Seat 8: Russian Goat (40527 in chips) 
Seat 9: XJIOPKA85 (171167 in chips) 
all sebas in: posts the ante 200
jcarlos.vale: posts the ante 200
biscom2007: posts the ante 200
Garrik26: posts the ante 200
felipeando: posts the ante 200
loowayking: posts the ante 200
Slav1an: posts the ante 200
Russian Goat: posts the ante 200
XJIOPKA85: posts the ante 200
biscom2007: posts small blind 1250
Garrik26: posts big blind 2500
*** HOLE CARDS ***
Dealt to jcarlos.vale [2d Qc]
felipeando: folds 
loowayking: folds 
Slav1an: raises 2501 to 5001
Russian Goat: folds 
XJIOPKA85: folds 
all sebas in: folds 
jcarlos.vale: folds 
biscom2007: folds 
Garrik26: calls 2501
*** FLOP *** [Qs 8d 8c]
Garrik26: checks 
Slav1an: bets 3916
Garrik26: folds 
Uncalled bet (3916) returned to Slav1an
Slav1an collected 13052 from pot
*** SUMMARY ***
Total pot 13052 | Rake 0 
Board [Qs 8d 8c]
Seat 1: all sebas in folded before Flop (didn't bet)
Seat 2: jcarlos.vale (button) folded before Flop (didn't bet)
Seat 3: biscom2007 (small blind) folded before Flop
Seat 4: Garrik26 (big blind) folded on the Flop
Seat 5: felipeando folded before Flop (didn't bet)
Seat 6: loowayking folded before Flop (didn't bet)
Seat 7: Slav1an collected (13052)
Seat 8: Russian Goat folded before Flop (didn't bet)
Seat 9: XJIOPKA85 folded before Flop (didn't bet)



PokerStars Hand #222158178737: Tournament #3086083919, $0.49+$0.06 USD Hold'em No Limit - Level XXIII (1250/2500) - 2021/01/03 1:13:42 EET [2021/01/02 18:13:42 ET]
Table '3086083919 96' 9-max Seat #3 is the button
Seat 1: all sebas in (30988 in chips) 
Seat 2: jcarlos.vale (36586 in chips) 
Seat 3: biscom2007 (31414 in chips) 
Seat 4: Garrik26 (54872 in chips) 
Seat 5: felipeando (108726 in chips) 
Seat 6: loowayking (44169 in chips) 
Seat 7: Slav1an (88383 in chips) 
Seat 8: Russian Goat (40327 in chips) 
Seat 9: XJIOPKA85 (170967 in chips) 
all sebas in: posts the ante 200
jcarlos.vale: posts the ante 200
biscom2007: posts the ante 200
Garrik26: posts the ante 200
felipeando: posts the ante 200
loowayking: posts the ante 200
Slav1an: posts the ante 200
Russian Goat: posts the ante 200
XJIOPKA85: posts the ante 200
Garrik26: posts small blind 1250
felipeando: posts big blind 2500
*** HOLE CARDS ***
Dealt to jcarlos.vale [As Qc]
loowayking: folds 
Slav1an: folds 
Russian Goat: folds 
XJIOPKA85: folds 
all sebas in: folds 
jcarlos.vale: raises 33886 to 36386 and is all-in
biscom2007: folds 
Garrik26: folds 
felipeando: folds 
Uncalled bet (33886) returned to jcarlos.vale
jcarlos.vale collected 8050 from pot
jcarlos.vale: doesn't show handDTO
*** SUMMARY ***
Total pot 8050 | Rake 0 
Seat 1: all sebas in folded before Flop (didn't bet)
Seat 2: jcarlos.vale collected (8050)
Seat 3: biscom2007 (button) folded before Flop (didn't bet)
Seat 4: Garrik26 (small blind) folded before Flop
Seat 5: felipeando (big blind) folded before Flop
Seat 6: loowayking folded before Flop (didn't bet)
Seat 7: Slav1an folded before Flop (didn't bet)
Seat 8: Russian Goat folded before Flop (didn't bet)
Seat 9: XJIOPKA85 folded before Flop (didn't bet)



PokerStars Hand #222158202070: Tournament #3086083919, $0.49+$0.06 USD Hold'em No Limit - Level XXIII (1250/2500) - 2021/01/03 1:14:11 EET [2021/01/02 18:14:11 ET]
Table '3086083919 96' 9-max Seat #4 is the button
Seat 1: all sebas in (30788 in chips) 
Seat 2: jcarlos.vale (41936 in chips) 
Seat 3: biscom2007 (31214 in chips) 
Seat 4: Garrik26 (53422 in chips) 
Seat 5: felipeando (106026 in chips) 
Seat 6: loowayking (43969 in chips) 
Seat 7: Slav1an (88183 in chips) 
Seat 8: Russian Goat (40127 in chips) 
Seat 9: XJIOPKA85 (170767 in chips) 
all sebas in: posts the ante 200
jcarlos.vale: posts the ante 200
biscom2007: posts the ante 200
Garrik26: posts the ante 200
felipeando: posts the ante 200
loowayking: posts the ante 200
Slav1an: posts the ante 200
Russian Goat: posts the ante 200
XJIOPKA85: posts the ante 200
felipeando: posts small blind 1250
loowayking: posts big blind 2500
*** HOLE CARDS ***
Dealt to jcarlos.vale [8h 4h]
Slav1an: folds 
Russian Goat: folds 
XJIOPKA85: folds 
all sebas in: folds 
jcarlos.vale: folds 
biscom2007: folds 
Garrik26: calls 2500
felipeando: calls 1250
loowayking: checks 
*** FLOP *** [5s Qs Jc]
felipeando: checks 
loowayking: checks 
Garrik26: bets 2500
felipeando: calls 2500
loowayking: folds 
*** TURN *** [5s Qs Jc] [7h]
felipeando: checks 
Garrik26: bets 2500
felipeando: calls 2500
*** RIVER *** [5s Qs Jc 7h] [4d]
felipeando: checks 
Garrik26: checks 
*** SHOW DOWN ***
felipeando: shows [Qh 9c] (a pair of Queens)
Garrik26: mucks handDTO
felipeando collected 19300 from pot
*** SUMMARY ***
Total pot 19300 | Rake 0 
Board [5s Qs Jc 7h 4d]
Seat 1: all sebas in folded before Flop (didn't bet)
Seat 2: jcarlos.vale folded before Flop (didn't bet)
Seat 3: biscom2007 folded before Flop (didn't bet)
Seat 4: Garrik26 (button) mucked [Jh Ks]
Seat 5: felipeando (small blind) showed [Qh 9c] and won (19300) with a pair of Queens
Seat 6: loowayking (big blind) folded on the Flop
Seat 7: Slav1an folded before Flop (didn't bet)
Seat 8: Russian Goat folded before Flop (didn't bet)
Seat 9: XJIOPKA85 folded before Flop (didn't bet)



PokerStars Hand #222158262713: Tournament #3086083919, $0.49+$0.06 USD Hold'em No Limit - Level XXIII (1250/2500) - 2021/01/03 1:15:26 EET [2021/01/02 18:15:26 ET]
Table '3086083919 96' 9-max Seat #5 is the button
Seat 1: all sebas in (30588 in chips) 
Seat 2: jcarlos.vale (41736 in chips) 
Seat 3: biscom2007 (31014 in chips) 
Seat 4: Garrik26 (45722 in chips) 
Seat 5: felipeando (117626 in chips) 
Seat 6: loowayking (41269 in chips) 
Seat 7: Slav1an (87983 in chips) 
Seat 8: Russian Goat (39927 in chips) 
Seat 9: XJIOPKA85 (170567 in chips) 
all sebas in: posts the ante 200
jcarlos.vale: posts the ante 200
biscom2007: posts the ante 200
Garrik26: posts the ante 200
felipeando: posts the ante 200
loowayking: posts the ante 200
Slav1an: posts the ante 200
Russian Goat: posts the ante 200
XJIOPKA85: posts the ante 200
loowayking: posts small blind 1250
Slav1an: posts big blind 2500
*** HOLE CARDS ***
Dealt to jcarlos.vale [7h As]
Russian Goat: folds 
XJIOPKA85: folds 
all sebas in: raises 27888 to 30388 and is all-in
jcarlos.vale has timed out
jcarlos.vale: folds 
jcarlos.vale is sitting out
biscom2007: folds 
Garrik26: folds 
felipeando: folds 
loowayking: folds 
Slav1an: folds 
Uncalled bet (27888) returned to all sebas in
all sebas in collected 8050 from pot
*** SUMMARY ***
Total pot 8050 | Rake 0 
Seat 1: all sebas in collected (8050)
Seat 2: jcarlos.vale folded before Flop (didn't bet)
Seat 3: biscom2007 folded before Flop (didn't bet)
Seat 4: Garrik26 folded before Flop (didn't bet)
Seat 5: felipeando (button) folded before Flop (didn't bet)
Seat 6: loowayking (small blind) folded before Flop
Seat 7: Slav1an (big blind) folded before Flop
Seat 8: Russian Goat folded before Flop (didn't bet)
Seat 9: XJIOPKA85 folded before Flop (didn't bet)



PokerStars Hand #222158296954: Tournament #3086083919, $0.49+$0.06 USD Hold'em No Limit - Level XXIII (1250/2500) - 2021/01/03 1:16:09 EET [2021/01/02 18:16:09 ET]
Table '3086083919 96' 9-max Seat #6 is the button
Seat 1: all sebas in (35938 in chips) 
Seat 2: jcarlos.vale (41536 in chips) is sitting out
Seat 3: biscom2007 (30814 in chips) 
Seat 4: Garrik26 (45522 in chips) 
Seat 5: felipeando (117426 in chips) 
Seat 6: loowayking (39819 in chips) 
Seat 7: Slav1an (85283 in chips) 
Seat 8: Russian Goat (39727 in chips) 
Seat 9: XJIOPKA85 (170367 in chips) 
all sebas in: posts the ante 200
jcarlos.vale: posts the ante 200
biscom2007: posts the ante 200
Garrik26: posts the ante 200
felipeando: posts the ante 200
loowayking: posts the ante 200
Slav1an: posts the ante 200
Russian Goat: posts the ante 200
XJIOPKA85: posts the ante 200
Slav1an: posts small blind 1250
Russian Goat: posts big blind 2500
*** HOLE CARDS ***
Dealt to jcarlos.vale [5s Js]
jcarlos.vale has returned
XJIOPKA85: folds 
all sebas in: calls 2500
jcarlos.vale: folds 
biscom2007: folds 
Garrik26: raises 42822 to 45322 and is all-in
felipeando: folds 
loowayking: folds 
Slav1an: folds 
Russian Goat: folds 
all sebas in: calls 33238 and is all-in
Uncalled bet (9584) returned to Garrik26
*** FLOP *** [4c Td Kh]
*** TURN *** [4c Td Kh] [9s]
*** RIVER *** [4c Td Kh 9s] [2s]
*** SHOW DOWN ***
all sebas in: shows [8h 8d] (a pair of Eights)
Garrik26: shows [Ac Jd] (high pairOfCards Ace)
all sebas in collected 77026 from pot
*** SUMMARY ***
Total pot 77026 | Rake 0 
Board [4c Td Kh 9s 2s]
Seat 1: all sebas in showed [8h 8d] and won (77026) with a pair of Eights
Seat 2: jcarlos.vale folded before Flop (didn't bet)
Seat 3: biscom2007 folded before Flop (didn't bet)
Seat 4: Garrik26 showed [Ac Jd] and lost with high pairOfCards Ace
Seat 5: felipeando folded before Flop (didn't bet)
Seat 6: loowayking (button) folded before Flop (didn't bet)
Seat 7: Slav1an (small blind) folded before Flop
Seat 8: Russian Goat (big blind) folded before Flop
Seat 9: XJIOPKA85 folded before Flop (didn't bet)



PokerStars Hand #222158328138: Tournament #3086083919, $0.49+$0.06 USD Hold'em No Limit - Level XXIII (1250/2500) - 2021/01/03 1:16:48 EET [2021/01/02 18:16:48 ET]
Table '3086083919 96' 9-max Seat #7 is the button
Seat 1: all sebas in (77026 in chips) 
Seat 2: jcarlos.vale (41336 in chips) 
Seat 3: biscom2007 (30614 in chips) 
Seat 4: Garrik26 (9584 in chips) 
Seat 5: felipeando (117226 in chips) 
Seat 6: loowayking (39619 in chips) 
Seat 7: Slav1an (83833 in chips) 
Seat 8: Russian Goat (37027 in chips) 
Seat 9: XJIOPKA85 (170167 in chips) 
all sebas in: posts the ante 200
jcarlos.vale: posts the ante 200
biscom2007: posts the ante 200
Garrik26: posts the ante 200
felipeando: posts the ante 200
loowayking: posts the ante 200
Slav1an: posts the ante 200
Russian Goat: posts the ante 200
XJIOPKA85: posts the ante 200
Russian Goat: posts small blind 1250
XJIOPKA85: posts big blind 2500
*** HOLE CARDS ***
Dealt to jcarlos.vale [Qs 3h]
all sebas in: folds 
jcarlos.vale: folds 
biscom2007: folds 
Garrik26: folds 
felipeando: folds 
loowayking: raises 2500 to 5000
Slav1an: folds 
Russian Goat: raises 31827 to 36827 and is all-in
XJIOPKA85: folds 
loowayking: calls 31827
*** FLOP *** [7h 2h 6s]
*** TURN *** [7h 2h 6s] [Tc]
*** RIVER *** [7h 2h 6s Tc] [7s]
*** SHOW DOWN ***
Russian Goat: shows [Kh Jh] (a pair of Sevens)
loowayking: shows [6c Ac] (two pair, Sevens and Sixes)
loowayking collected 77954 from pot
Russian Goat finished the tournament in 183rd place and received $2.08.
*** SUMMARY ***
Total pot 77954 | Rake 0 
Board [7h 2h 6s Tc 7s]
Seat 1: all sebas in folded before Flop (didn't bet)
Seat 2: jcarlos.vale folded before Flop (didn't bet)
Seat 3: biscom2007 folded before Flop (didn't bet)
Seat 4: Garrik26 folded before Flop (didn't bet)
Seat 5: felipeando folded before Flop (didn't bet)
Seat 6: loowayking showed [6c Ac] and won (77954) with two pair, Sevens and Sixes
Seat 7: Slav1an (button) folded before Flop (didn't bet)
Seat 8: Russian Goat (small blind) showed [Kh Jh] and lost with a pair of Sevens
Seat 9: XJIOPKA85 (big blind) folded before Flop



PokerStars Hand #222158361152: Tournament #3086083919, $0.49+$0.06 USD Hold'em No Limit - Level XXIII (1250/2500) - 2021/01/03 1:17:31 EET [2021/01/02 18:17:31 ET]
Table '3086083919 96' 9-max Seat #9 is the button
Seat 1: all sebas in (76826 in chips) 
Seat 2: jcarlos.vale (41136 in chips) 
Seat 3: biscom2007 (30414 in chips) 
Seat 4: Garrik26 (9384 in chips) 
Seat 5: felipeando (117026 in chips) 
Seat 6: loowayking (80546 in chips) 
Seat 7: Slav1an (83633 in chips) 
Seat 9: XJIOPKA85 (167467 in chips) 
all sebas in: posts the ante 200
jcarlos.vale: posts the ante 200
biscom2007: posts the ante 200
Garrik26: posts the ante 200
felipeando: posts the ante 200
loowayking: posts the ante 200
Slav1an: posts the ante 200
XJIOPKA85: posts the ante 200
all sebas in: posts small blind 1250
jcarlos.vale: posts big blind 2500
*** HOLE CARDS ***
Dealt to jcarlos.vale [8h 6d]
biscom2007: calls 2500
Garrik26: folds 
felipeando: folds 
loowayking: folds 
Slav1an: folds 
XJIOPKA85: raises 5000 to 7500
all sebas in: folds 
jcarlos.vale: folds 
biscom2007: calls 5000
*** FLOP *** [6s Ac Td]
biscom2007: checks 
XJIOPKA85: checks 
*** TURN *** [6s Ac Td] [4s]
biscom2007: checks 
XJIOPKA85: bets 6512
biscom2007: folds 
Uncalled bet (6512) returned to XJIOPKA85
XJIOPKA85 collected 20350 from pot
*** SUMMARY ***
Total pot 20350 | Rake 0 
Board [6s Ac Td 4s]
Seat 1: all sebas in (small blind) folded before Flop
Seat 2: jcarlos.vale (big blind) folded before Flop
Seat 3: biscom2007 folded on the Turn
Seat 4: Garrik26 folded before Flop (didn't bet)
Seat 5: felipeando folded before Flop (didn't bet)
Seat 6: loowayking folded before Flop (didn't bet)
Seat 7: Slav1an folded before Flop (didn't bet)
Seat 9: XJIOPKA85 (button) collected (20350)



PokerStars Hand #222158405116: Tournament #3086083919, $0.49+$0.06 USD Hold'em No Limit - Level XXIV (1500/3000) - 2021/01/03 1:18:27 EET [2021/01/02 18:18:27 ET]
Table '3086083919 96' 9-max Seat #1 is the button
Seat 1: all sebas in (75376 in chips) 
Seat 2: jcarlos.vale (38436 in chips) 
Seat 3: biscom2007 (22714 in chips) 
Seat 4: Garrik26 (9184 in chips) 
Seat 5: felipeando (116826 in chips) 
Seat 6: loowayking (80346 in chips) 
Seat 7: Slav1an (83433 in chips) 
Seat 8: V.A.Moskalev (142037 in chips) 
Seat 9: XJIOPKA85 (180117 in chips) 
all sebas in: posts the ante 225
jcarlos.vale: posts the ante 225
biscom2007: posts the ante 225
Garrik26: posts the ante 225
felipeando: posts the ante 225
loowayking: posts the ante 225
Slav1an: posts the ante 225
V.A.Moskalev: posts the ante 225
XJIOPKA85: posts the ante 225
jcarlos.vale: posts small blind 1500
biscom2007: posts big blind 3000
*** HOLE CARDS ***
Dealt to jcarlos.vale [Jh Qh]
Garrik26: folds 
felipeando: folds 
loowayking: folds 
Slav1an: folds 
V.A.Moskalev: raises 3000 to 6000
XJIOPKA85: folds 
all sebas in: calls 6000
jcarlos.vale: raises 32211 to 38211 and is all-in
biscom2007: folds 
V.A.Moskalev: calls 32211
all sebas in: calls 32211
*** FLOP *** [4d 8c Jc]
V.A.Moskalev: bets 103601 and is all-in
all sebas in: calls 36940 and is all-in
Uncalled bet (66661) returned to V.A.Moskalev
*** TURN *** [4d 8c Jc] [6h]
*** RIVER *** [4d 8c Jc 6h] [4c]
*** SHOW DOWN ***
V.A.Moskalev: shows [Ts Js] (two pair, Jacks and Fours)
all sebas in: shows [8s Ad] (two pair, Eights and Fours)
V.A.Moskalev collected 73880 from side pot
jcarlos.vale: shows [Jh Qh] (two pair, Jacks and Fours - Queen kicker)
jcarlos.vale collected 119658 from main pot
all sebas in finished the tournament in 176th place and received $2.08.
*** SUMMARY ***
Total pot 193538 Main pot 119658. Side pot 73880. | Rake 0 
Board [4d 8c Jc 6h 4c]
Seat 1: all sebas in (button) showed [8s Ad] and lost with two pair, Eights and Fours
Seat 2: jcarlos.vale (small blind) showed [Jh Qh] and won (119658) with two pair, Jacks and Fours
Seat 3: biscom2007 (big blind) folded before Flop
Seat 4: Garrik26 folded before Flop (didn't bet)
Seat 5: felipeando folded before Flop (didn't bet)
Seat 6: loowayking folded before Flop (didn't bet)
Seat 7: Slav1an folded before Flop (didn't bet)
Seat 8: V.A.Moskalev showed [Ts Js] and won (73880) with two pair, Jacks and Fours
Seat 9: XJIOPKA85 folded before Flop (didn't bet)



PokerStars Hand #222158454386: Tournament #3086083919, $0.49+$0.06 USD Hold'em No Limit - Level XXIV (1500/3000) - 2021/01/03 1:19:21 EET [2021/01/02 18:19:21 ET]
Table '3086083919 96' 9-max Seat #2 is the button
Seat 2: jcarlos.vale (119658 in chips) 
Seat 3: biscom2007 (19489 in chips) 
Seat 4: Garrik26 (8959 in chips) 
Seat 5: felipeando (116601 in chips) 
Seat 6: loowayking (80121 in chips) 
Seat 7: Slav1an (83208 in chips) 
Seat 8: V.A.Moskalev (140541 in chips) 
Seat 9: XJIOPKA85 (179892 in chips) 
jcarlos.vale: posts the ante 225
biscom2007: posts the ante 225
Garrik26: posts the ante 225
felipeando: posts the ante 225
loowayking: posts the ante 225
Slav1an: posts the ante 225
V.A.Moskalev: posts the ante 225
XJIOPKA85: posts the ante 225
biscom2007: posts small blind 1500
Garrik26: posts big blind 3000
*** HOLE CARDS ***
Dealt to jcarlos.vale [8h Qs]
felipeando: folds 
loowayking: raises 3000 to 6000
Slav1an: folds 
V.A.Moskalev: folds 
XJIOPKA85: folds 
jcarlos.vale: folds 
biscom2007: calls 4500
Garrik26: folds 
*** FLOP *** [Kh 4d Qc]
biscom2007: checks 
loowayking: checks 
*** TURN *** [Kh 4d Qc] [8s]
biscom2007: checks 
loowayking: checks 
*** RIVER *** [Kh 4d Qc 8s] [5h]
biscom2007: bets 8400
loowayking: folds 
Uncalled bet (8400) returned to biscom2007
biscom2007 collected 16800 from pot
biscom2007: doesn't show handDTO
*** SUMMARY ***
Total pot 16800 | Rake 0 
Board [Kh 4d Qc 8s 5h]
Seat 2: jcarlos.vale (button) folded before Flop (didn't bet)
Seat 3: biscom2007 (small blind) collected (16800)
Seat 4: Garrik26 (big blind) folded before Flop
Seat 5: felipeando folded before Flop (didn't bet)
Seat 6: loowayking folded on the River
Seat 7: Slav1an folded before Flop (didn't bet)
Seat 8: V.A.Moskalev folded before Flop (didn't bet)
Seat 9: XJIOPKA85 folded before Flop (didn't bet)



PokerStars Hand #222158524015: Tournament #3086083919, $0.49+$0.06 USD Hold'em No Limit - Level XXIV (1500/3000) - 2021/01/03 1:20:41 EET [2021/01/02 18:20:41 ET]
Table '3086083919 96' 9-max Seat #3 is the button
Seat 1: ycTpyGaf1 (109347 in chips) 
Seat 2: jcarlos.vale (119433 in chips) 
Seat 3: biscom2007 (30064 in chips) 
Seat 4: Garrik26 (5734 in chips) 
Seat 5: felipeando (116376 in chips) 
Seat 6: loowayking (73896 in chips) 
Seat 7: Slav1an (82983 in chips) 
Seat 8: V.A.Moskalev (140316 in chips) 
Seat 9: XJIOPKA85 (179667 in chips) 
ycTpyGaf1: posts the ante 225
jcarlos.vale: posts the ante 225
biscom2007: posts the ante 225
Garrik26: posts the ante 225
felipeando: posts the ante 225
loowayking: posts the ante 225
Slav1an: posts the ante 225
V.A.Moskalev: posts the ante 225
XJIOPKA85: posts the ante 225
Garrik26: posts small blind 1500
felipeando: posts big blind 3000
*** HOLE CARDS ***
Dealt to jcarlos.vale [6d 5h]
loowayking: folds 
Slav1an: folds 
V.A.Moskalev: raises 3000 to 6000
XJIOPKA85: folds 
ycTpyGaf1: folds 
jcarlos.vale: folds 
biscom2007: folds 
Garrik26: calls 4009 and is all-in
felipeando: folds 
Uncalled bet (491) returned to V.A.Moskalev
*** FLOP *** [2c 8h 8d]
*** TURN *** [2c 8h 8d] [3h]
*** RIVER *** [2c 8h 8d 3h] [Js]
*** SHOW DOWN ***
Garrik26: shows [9s As] (a pair of Eights)
V.A.Moskalev: shows [Kd 9d] (a pair of Eights - lower kicker)
Garrik26 collected 16043 from pot
*** SUMMARY ***
Total pot 16043 | Rake 0 
Board [2c 8h 8d 3h Js]
Seat 1: ycTpyGaf1 folded before Flop (didn't bet)
Seat 2: jcarlos.vale folded before Flop (didn't bet)
Seat 3: biscom2007 (button) folded before Flop (didn't bet)
Seat 4: Garrik26 (small blind) showed [9s As] and won (16043) with a pair of Eights
Seat 5: felipeando (big blind) folded before Flop
Seat 6: loowayking folded before Flop (didn't bet)
Seat 7: Slav1an folded before Flop (didn't bet)
Seat 8: V.A.Moskalev showed [Kd 9d] and lost with a pair of Eights
Seat 9: XJIOPKA85 folded before Flop (didn't bet)



PokerStars Hand #222158550412: Tournament #3086083919, $0.49+$0.06 USD Hold'em No Limit - Level XXIV (1500/3000) - 2021/01/03 1:21:15 EET [2021/01/02 18:21:15 ET]
Table '3086083919 96' 9-max Seat #4 is the button
Seat 1: ycTpyGaf1 (109122 in chips) 
Seat 2: jcarlos.vale (119208 in chips) 
Seat 3: biscom2007 (29839 in chips) 
Seat 4: Garrik26 (16043 in chips) 
Seat 5: felipeando (113151 in chips) 
Seat 6: loowayking (73671 in chips) 
Seat 7: Slav1an (82758 in chips) 
Seat 8: V.A.Moskalev (134582 in chips) 
Seat 9: XJIOPKA85 (179442 in chips) 
ycTpyGaf1: posts the ante 225
jcarlos.vale: posts the ante 225
biscom2007: posts the ante 225
Garrik26: posts the ante 225
felipeando: posts the ante 225
loowayking: posts the ante 225
Slav1an: posts the ante 225
V.A.Moskalev: posts the ante 225
XJIOPKA85: posts the ante 225
felipeando: posts small blind 1500
loowayking: posts big blind 3000
*** HOLE CARDS ***
Dealt to jcarlos.vale [9c Th]
Slav1an: folds 
V.A.Moskalev: folds 
XJIOPKA85: raises 3390 to 6390
ycTpyGaf1: calls 6390
jcarlos.vale: folds 
biscom2007: folds 
Garrik26: folds 
felipeando: folds 
loowayking: calls 3390
*** FLOP *** [Qh 4d 9s]
loowayking: checks 
XJIOPKA85: bets 12000
ycTpyGaf1: calls 12000
loowayking: folds 
*** TURN *** [Qh 4d 9s] [5c]
XJIOPKA85: bets 35021
ycTpyGaf1: raises 36979 to 72000
XJIOPKA85: raises 88827 to 160827 and is all-in
ycTpyGaf1: calls 18507 and is all-in
Uncalled bet (70320) returned to XJIOPKA85
*** RIVER *** [Qh 4d 9s 5c] [Ts]
*** SHOW DOWN ***
XJIOPKA85: shows [Kd Ks] (a pair of Kings)
ycTpyGaf1: shows [Ac Qc] (a pair of Queens)
XJIOPKA85 collected 227709 from pot
ycTpyGaf1 finished the tournament in 161st place and received $2.08.
*** SUMMARY ***
Total pot 227709 | Rake 0 
Board [Qh 4d 9s 5c Ts]
Seat 1: ycTpyGaf1 showed [Ac Qc] and lost with a pair of Queens
Seat 2: jcarlos.vale folded before Flop (didn't bet)
Seat 3: biscom2007 folded before Flop (didn't bet)
Seat 4: Garrik26 (button) folded before Flop (didn't bet)
Seat 5: felipeando (small blind) folded before Flop
Seat 6: loowayking (big blind) folded on the Flop
Seat 7: Slav1an folded before Flop (didn't bet)
Seat 8: V.A.Moskalev folded before Flop (didn't bet)
Seat 9: XJIOPKA85 showed [Kd Ks] and won (227709) with a pair of Kings



PokerStars Hand #222158634045: Tournament #3086083919, $0.49+$0.06 USD Hold'em No Limit - Level XXIV (1500/3000) - 2021/01/03 1:23:04 EET [2021/01/02 18:23:04 ET]
Table '3086083919 96' 9-max Seat #5 is the button
Seat 2: jcarlos.vale (118983 in chips) 
Seat 3: biscom2007 (29614 in chips) 
Seat 4: Garrik26 (15818 in chips) 
Seat 5: felipeando (111426 in chips) 
Seat 6: loowayking (67056 in chips) 
Seat 7: Slav1an (82533 in chips) 
Seat 8: V.A.Moskalev (134357 in chips) 
Seat 9: XJIOPKA85 (298029 in chips) 
jcarlos.vale: posts the ante 225
biscom2007: posts the ante 225
Garrik26: posts the ante 225
felipeando: posts the ante 225
loowayking: posts the ante 225
Slav1an: posts the ante 225
V.A.Moskalev: posts the ante 225
XJIOPKA85: posts the ante 225
loowayking: posts small blind 1500
Slav1an: posts big blind 3000
*** HOLE CARDS ***
Dealt to jcarlos.vale [4h 2s]
V.A.Moskalev: folds 
XJIOPKA85: raises 3390 to 6390
jcarlos.vale: folds 
biscom2007: folds 
Garrik26: raises 9203 to 15593 and is all-in
felipeando: folds 
loowayking: folds 
Slav1an: folds 
XJIOPKA85: calls 9203
*** FLOP *** [Kd 9c 6c]
*** TURN *** [Kd 9c 6c] [Qh]
*** RIVER *** [Kd 9c 6c Qh] [Jh]
*** SHOW DOWN ***
XJIOPKA85: shows [8h As] (high pairOfCards Ace)
Garrik26: shows [Jd Ad] (a pair of Jacks)
Garrik26 collected 37486 from pot
*** SUMMARY ***
Total pot 37486 | Rake 0 
Board [Kd 9c 6c Qh Jh]
Seat 2: jcarlos.vale folded before Flop (didn't bet)
Seat 3: biscom2007 folded before Flop (didn't bet)
Seat 4: Garrik26 showed [Jd Ad] and won (37486) with a pair of Jacks
Seat 5: felipeando (button) folded before Flop (didn't bet)
Seat 6: loowayking (small blind) folded before Flop
Seat 7: Slav1an (big blind) folded before Flop
Seat 8: V.A.Moskalev folded before Flop (didn't bet)
Seat 9: XJIOPKA85 showed [8h As] and lost with high pairOfCards Ace



PokerStars Hand #222158660539: Tournament #3086083919, $0.49+$0.06 USD Hold'em No Limit - Level XXIV (1500/3000) - 2021/01/03 1:23:38 EET [2021/01/02 18:23:38 ET]
Table '3086083919 96' 9-max Seat #6 is the button
Seat 2: jcarlos.vale (118758 in chips) 
Seat 3: biscom2007 (29389 in chips) 
Seat 4: Garrik26 (37486 in chips) 
Seat 5: felipeando (111201 in chips) 
Seat 6: loowayking (65331 in chips) 
Seat 7: Slav1an (79308 in chips) 
Seat 8: V.A.Moskalev (134132 in chips) 
Seat 9: XJIOPKA85 (282211 in chips) 
jcarlos.vale: posts the ante 225
biscom2007: posts the ante 225
Garrik26: posts the ante 225
felipeando: posts the ante 225
loowayking: posts the ante 225
Slav1an: posts the ante 225
V.A.Moskalev: posts the ante 225
XJIOPKA85: posts the ante 225
Slav1an: posts small blind 1500
V.A.Moskalev: posts big blind 3000
*** HOLE CARDS ***
Dealt to jcarlos.vale [Kc Jh]
XJIOPKA85: folds 
jcarlos.vale: raises 4800 to 7800
biscom2007: folds 
Garrik26: folds 
felipeando: folds 
loowayking: folds 
Slav1an: folds 
V.A.Moskalev: calls 4800
*** FLOP *** [3c Qc 6d]
V.A.Moskalev: checks 
jcarlos.vale: checks 
*** TURN *** [3c Qc 6d] [4c]
V.A.Moskalev: bets 6237
jcarlos.vale: calls 6237
*** RIVER *** [3c Qc 6d 4c] [9d]
V.A.Moskalev: checks 
jcarlos.vale: checks 
*** SHOW DOWN ***
V.A.Moskalev: shows [Ah Kd] (high pairOfCards Ace)
jcarlos.vale: mucks handDTO
V.A.Moskalev collected 31374 from pot
*** SUMMARY ***
Total pot 31374 | Rake 0 
Board [3c Qc 6d 4c 9d]
Seat 2: jcarlos.vale mucked [Kc Jh]
Seat 3: biscom2007 folded before Flop (didn't bet)
Seat 4: Garrik26 folded before Flop (didn't bet)
Seat 5: felipeando folded before Flop (didn't bet)
Seat 6: loowayking (button) folded before Flop (didn't bet)
Seat 7: Slav1an (small blind) folded before Flop
Seat 8: V.A.Moskalev (big blind) showed [Ah Kd] and won (31374) with high pairOfCards Ace
Seat 9: XJIOPKA85 folded before Flop (didn't bet)



PokerStars Hand #222158688137: Tournament #3086083919, $0.49+$0.06 USD Hold'em No Limit - Level XXIV (1500/3000) - 2021/01/03 1:24:15 EET [2021/01/02 18:24:15 ET]
Table '3086083919 96' 9-max Seat #7 is the button
Seat 2: jcarlos.vale (104496 in chips) 
Seat 3: biscom2007 (29164 in chips) 
Seat 4: Garrik26 (37261 in chips) 
Seat 5: felipeando (110976 in chips) 
Seat 6: loowayking (65106 in chips) 
Seat 7: Slav1an (77583 in chips) 
Seat 8: V.A.Moskalev (151244 in chips) 
Seat 9: XJIOPKA85 (281986 in chips) 
jcarlos.vale: posts the ante 225
biscom2007: posts the ante 225
Garrik26: posts the ante 225
felipeando: posts the ante 225
loowayking: posts the ante 225
Slav1an: posts the ante 225
V.A.Moskalev: posts the ante 225
XJIOPKA85: posts the ante 225
V.A.Moskalev: posts small blind 1500
XJIOPKA85: posts big blind 3000
*** HOLE CARDS ***
Dealt to jcarlos.vale [9c 7d]
jcarlos.vale: folds 
biscom2007: calls 3000
Garrik26: raises 34036 to 37036 and is all-in
felipeando: folds 
loowayking: folds 
Slav1an: folds 
V.A.Moskalev: folds 
XJIOPKA85: folds 
biscom2007: folds 
Uncalled bet (34036) returned to Garrik26
Garrik26 collected 12300 from pot
Garrik26: doesn't show handDTO
*** SUMMARY ***
Total pot 12300 | Rake 0 
Seat 2: jcarlos.vale folded before Flop (didn't bet)
Seat 3: biscom2007 folded before Flop
Seat 4: Garrik26 collected (12300)
Seat 5: felipeando folded before Flop (didn't bet)
Seat 6: loowayking folded before Flop (didn't bet)
Seat 7: Slav1an (button) folded before Flop (didn't bet)
Seat 8: V.A.Moskalev (small blind) folded before Flop
Seat 9: XJIOPKA85 (big blind) folded before Flop



PokerStars Hand #222158711493: Tournament #3086083919, $0.49+$0.06 USD Hold'em No Limit - Level XXIV (1500/3000) - 2021/01/03 1:24:45 EET [2021/01/02 18:24:45 ET]
Table '3086083919 96' 9-max Seat #8 is the button
Seat 2: jcarlos.vale (104271 in chips) 
Seat 3: biscom2007 (25939 in chips) 
Seat 4: Garrik26 (46336 in chips) 
Seat 5: felipeando (110751 in chips) 
Seat 6: loowayking (64881 in chips) 
Seat 7: Slav1an (77358 in chips) 
Seat 8: V.A.Moskalev (149519 in chips) 
Seat 9: XJIOPKA85 (278761 in chips) 
jcarlos.vale: posts the ante 225
biscom2007: posts the ante 225
Garrik26: posts the ante 225
felipeando: posts the ante 225
loowayking: posts the ante 225
Slav1an: posts the ante 225
V.A.Moskalev: posts the ante 225
XJIOPKA85: posts the ante 225
XJIOPKA85: posts small blind 1500
jcarlos.vale: posts big blind 3000
*** HOLE CARDS ***
Dealt to jcarlos.vale [4s As]
biscom2007: folds 
Garrik26: folds 
felipeando: folds 
loowayking: folds 
Slav1an: raises 3001 to 6001
V.A.Moskalev: folds 
XJIOPKA85: folds 
jcarlos.vale: folds 
Uncalled bet (3001) returned to Slav1an
Slav1an collected 9300 from pot
*** SUMMARY ***
Total pot 9300 | Rake 0 
Seat 2: jcarlos.vale (big blind) folded before Flop
Seat 3: biscom2007 folded before Flop (didn't bet)
Seat 4: Garrik26 folded before Flop (didn't bet)
Seat 5: felipeando folded before Flop (didn't bet)
Seat 6: loowayking folded before Flop (didn't bet)
Seat 7: Slav1an collected (9300)
Seat 8: V.A.Moskalev (button) folded before Flop (didn't bet)
Seat 9: XJIOPKA85 (small blind) folded before Flop



PokerStars Hand #222158732275: Tournament #3086083919, $0.49+$0.06 USD Hold'em No Limit - Level XXIV (1500/3000) - 2021/01/03 1:25:12 EET [2021/01/02 18:25:12 ET]
Table '3086083919 96' 9-max Seat #9 is the button
Seat 2: jcarlos.vale (101046 in chips) 
Seat 3: biscom2007 (25714 in chips) 
Seat 4: Garrik26 (46111 in chips) 
Seat 5: felipeando (110526 in chips) 
Seat 6: loowayking (64656 in chips) 
Seat 7: Slav1an (83433 in chips) 
Seat 8: V.A.Moskalev (149294 in chips) 
Seat 9: XJIOPKA85 (277036 in chips) 
jcarlos.vale: posts the ante 225
biscom2007: posts the ante 225
Garrik26: posts the ante 225
felipeando: posts the ante 225
loowayking: posts the ante 225
Slav1an: posts the ante 225
V.A.Moskalev: posts the ante 225
XJIOPKA85: posts the ante 225
jcarlos.vale: posts small blind 1500
biscom2007: posts big blind 3000
*** HOLE CARDS ***
Dealt to jcarlos.vale [Ks 2s]
Garrik26: folds 
felipeando: folds 
loowayking: folds 
Slav1an: folds 
V.A.Moskalev: folds 
XJIOPKA85: raises 3390 to 6390
jcarlos.vale: folds 
biscom2007: folds 
Uncalled bet (3390) returned to XJIOPKA85
XJIOPKA85 collected 9300 from pot
*** SUMMARY ***
Total pot 9300 | Rake 0 
Seat 2: jcarlos.vale (small blind) folded before Flop
Seat 3: biscom2007 (big blind) folded before Flop
Seat 4: Garrik26 folded before Flop (didn't bet)
Seat 5: felipeando folded before Flop (didn't bet)
Seat 6: loowayking folded before Flop (didn't bet)
Seat 7: Slav1an folded before Flop (didn't bet)
Seat 8: V.A.Moskalev folded before Flop (didn't bet)
Seat 9: XJIOPKA85 (button) collected (9300)



PokerStars Hand #222158748621: Tournament #3086083919, $0.49+$0.06 USD Hold'em No Limit - Level XXIV (1500/3000) - 2021/01/03 1:25:34 EET [2021/01/02 18:25:34 ET]
Table '3086083919 96' 9-max Seat #2 is the button
Seat 1: lemp2007 (100249 in chips) 
Seat 2: jcarlos.vale (99321 in chips) 
Seat 3: biscom2007 (22489 in chips) 
Seat 4: Garrik26 (45886 in chips) 
Seat 5: felipeando (110301 in chips) 
Seat 6: loowayking (64431 in chips) 
Seat 7: Slav1an (83208 in chips) 
Seat 8: V.A.Moskalev (149069 in chips) 
Seat 9: XJIOPKA85 (283111 in chips) 
lemp2007: posts the ante 225
jcarlos.vale: posts the ante 225
biscom2007: posts the ante 225
Garrik26: posts the ante 225
felipeando: posts the ante 225
loowayking: posts the ante 225
Slav1an: posts the ante 225
V.A.Moskalev: posts the ante 225
XJIOPKA85: posts the ante 225
biscom2007: posts small blind 1500
Garrik26: posts big blind 3000
*** HOLE CARDS ***
Dealt to jcarlos.vale [5d Kh]
felipeando: folds 
loowayking: folds 
Slav1an: folds 
V.A.Moskalev: raises 3000 to 6000
XJIOPKA85: folds 
lemp2007: folds 
jcarlos.vale: folds 
biscom2007: folds 
Garrik26: calls 3000
*** FLOP *** [7s 6s As]
Garrik26: bets 39661 and is all-in
V.A.Moskalev: folds 
Uncalled bet (39661) returned to Garrik26
Garrik26 collected 15525 from pot
Garrik26: doesn't show handDTO
*** SUMMARY ***
Total pot 15525 | Rake 0 
Board [7s 6s As]
Seat 1: lemp2007 folded before Flop (didn't bet)
Seat 2: jcarlos.vale (button) folded before Flop (didn't bet)
Seat 3: biscom2007 (small blind) folded before Flop
Seat 4: Garrik26 (big blind) collected (15525)
Seat 5: felipeando folded before Flop (didn't bet)
Seat 6: loowayking folded before Flop (didn't bet)
Seat 7: Slav1an folded before Flop (didn't bet)
Seat 8: V.A.Moskalev folded on the Flop
Seat 9: XJIOPKA85 folded before Flop (didn't bet)



PokerStars Hand #222158771891: Tournament #3086083919, $0.49+$0.06 USD Hold'em No Limit - Level XXIV (1500/3000) - 2021/01/03 1:26:04 EET [2021/01/02 18:26:04 ET]
Table '3086083919 96' 9-max Seat #3 is the button
Seat 1: lemp2007 (100024 in chips) 
Seat 2: jcarlos.vale (99096 in chips) 
Seat 3: biscom2007 (20764 in chips) 
Seat 4: Garrik26 (55186 in chips) 
Seat 5: felipeando (110076 in chips) 
Seat 6: loowayking (64206 in chips) 
Seat 7: Slav1an (82983 in chips) 
Seat 8: V.A.Moskalev (142844 in chips) 
Seat 9: XJIOPKA85 (282886 in chips) 
lemp2007: posts the ante 225
jcarlos.vale: posts the ante 225
biscom2007: posts the ante 225
Garrik26: posts the ante 225
felipeando: posts the ante 225
loowayking: posts the ante 225
Slav1an: posts the ante 225
V.A.Moskalev: posts the ante 225
XJIOPKA85: posts the ante 225
Garrik26: posts small blind 1500
felipeando: posts big blind 3000
*** HOLE CARDS ***
Dealt to jcarlos.vale [As 9c]
loowayking: folds 
Slav1an: folds 
V.A.Moskalev: raises 3000 to 6000
XJIOPKA85: folds 
lemp2007: folds 
jcarlos.vale: folds 
biscom2007: folds 
Garrik26: folds 
felipeando: folds 
Uncalled bet (3000) returned to V.A.Moskalev
V.A.Moskalev collected 9525 from pot
*** SUMMARY ***
Total pot 9525 | Rake 0 
Seat 1: lemp2007 folded before Flop (didn't bet)
Seat 2: jcarlos.vale folded before Flop (didn't bet)
Seat 3: biscom2007 (button) folded before Flop (didn't bet)
Seat 4: Garrik26 (small blind) folded before Flop
Seat 5: felipeando (big blind) folded before Flop
Seat 6: loowayking folded before Flop (didn't bet)
Seat 7: Slav1an folded before Flop (didn't bet)
Seat 8: V.A.Moskalev collected (9525)
Seat 9: XJIOPKA85 folded before Flop (didn't bet)



PokerStars Hand #222158792530: Tournament #3086083919, $0.49+$0.06 USD Hold'em No Limit - Level XXIV (1500/3000) - 2021/01/03 1:26:30 EET [2021/01/02 18:26:30 ET]
Table '3086083919 96' 9-max Seat #4 is the button
Seat 1: lemp2007 (99799 in chips) 
Seat 2: jcarlos.vale (98871 in chips) 
Seat 3: biscom2007 (20539 in chips) 
Seat 4: Garrik26 (53461 in chips) 
Seat 5: felipeando (106851 in chips) 
Seat 6: loowayking (63981 in chips) 
Seat 7: Slav1an (82758 in chips) 
Seat 8: V.A.Moskalev (149144 in chips) 
Seat 9: XJIOPKA85 (282661 in chips) 
lemp2007: posts the ante 225
jcarlos.vale: posts the ante 225
biscom2007: posts the ante 225
Garrik26: posts the ante 225
felipeando: posts the ante 225
loowayking: posts the ante 225
Slav1an: posts the ante 225
V.A.Moskalev: posts the ante 225
XJIOPKA85: posts the ante 225
felipeando: posts small blind 1500
loowayking: posts big blind 3000
*** HOLE CARDS ***
Dealt to jcarlos.vale [4s 7c]
Slav1an: folds 
V.A.Moskalev: folds 
XJIOPKA85: folds 
lemp2007: folds 
jcarlos.vale: folds 
biscom2007: folds 
Garrik26: folds 
felipeando: folds 
Uncalled bet (1500) returned to loowayking
loowayking collected 5025 from pot
*** SUMMARY ***
Total pot 5025 | Rake 0 
Seat 1: lemp2007 folded before Flop (didn't bet)
Seat 2: jcarlos.vale folded before Flop (didn't bet)
Seat 3: biscom2007 folded before Flop (didn't bet)
Seat 4: Garrik26 (button) folded before Flop (didn't bet)
Seat 5: felipeando (small blind) folded before Flop
Seat 6: loowayking (big blind) collected (5025)
Seat 7: Slav1an folded before Flop (didn't bet)
Seat 8: V.A.Moskalev folded before Flop (didn't bet)
Seat 9: XJIOPKA85 folded before Flop (didn't bet)



PokerStars Hand #222158804580: Tournament #3086083919, $0.49+$0.06 USD Hold'em No Limit - Level XXIV (1500/3000) - 2021/01/03 1:26:46 EET [2021/01/02 18:26:46 ET]
Table '3086083919 96' 9-max Seat #5 is the button
Seat 1: lemp2007 (99574 in chips) 
Seat 2: jcarlos.vale (98646 in chips) 
Seat 3: biscom2007 (20314 in chips) 
Seat 4: Garrik26 (53236 in chips) 
Seat 5: felipeando (105126 in chips) 
Seat 6: loowayking (67281 in chips) 
Seat 7: Slav1an (82533 in chips) 
Seat 8: V.A.Moskalev (148919 in chips) 
Seat 9: XJIOPKA85 (282436 in chips) 
lemp2007: posts the ante 225
jcarlos.vale: posts the ante 225
biscom2007: posts the ante 225
Garrik26: posts the ante 225
felipeando: posts the ante 225
loowayking: posts the ante 225
Slav1an: posts the ante 225
V.A.Moskalev: posts the ante 225
XJIOPKA85: posts the ante 225
loowayking: posts small blind 1500
Slav1an: posts big blind 3000
*** HOLE CARDS ***
Dealt to jcarlos.vale [8s 6d]
V.A.Moskalev: folds 
XJIOPKA85: folds 
lemp2007: folds 
jcarlos.vale: folds 
biscom2007: folds 
Garrik26: folds 
felipeando: raises 3000 to 6000
loowayking: folds 
Slav1an: folds 
Uncalled bet (3000) returned to felipeando
felipeando collected 9525 from pot
felipeando: doesn't show handDTO
*** SUMMARY ***
Total pot 9525 | Rake 0 
Seat 1: lemp2007 folded before Flop (didn't bet)
Seat 2: jcarlos.vale folded before Flop (didn't bet)
Seat 3: biscom2007 folded before Flop (didn't bet)
Seat 4: Garrik26 folded before Flop (didn't bet)
Seat 5: felipeando (button) collected (9525)
Seat 6: loowayking (small blind) folded before Flop
Seat 7: Slav1an (big blind) folded before Flop
Seat 8: V.A.Moskalev folded before Flop (didn't bet)
Seat 9: XJIOPKA85 folded before Flop (didn't bet)



PokerStars Hand #222158828039: Tournament #3086083919, $0.49+$0.06 USD Hold'em No Limit - Level XXIV (1500/3000) - 2021/01/03 1:27:17 EET [2021/01/02 18:27:17 ET]
Table '3086083919 96' 9-max Seat #6 is the button
Seat 1: lemp2007 (99349 in chips) 
Seat 2: jcarlos.vale (98421 in chips) 
Seat 3: biscom2007 (20089 in chips) 
Seat 4: Garrik26 (53011 in chips) 
Seat 5: felipeando (111426 in chips) 
Seat 6: loowayking (65556 in chips) 
Seat 7: Slav1an (79308 in chips) 
Seat 8: V.A.Moskalev (148694 in chips) 
Seat 9: XJIOPKA85 (282211 in chips) 
lemp2007: posts the ante 225
jcarlos.vale: posts the ante 225
biscom2007: posts the ante 225
Garrik26: posts the ante 225
felipeando: posts the ante 225
loowayking: posts the ante 225
Slav1an: posts the ante 225
V.A.Moskalev: posts the ante 225
XJIOPKA85: posts the ante 225
Slav1an: posts small blind 1500
V.A.Moskalev: posts big blind 3000
*** HOLE CARDS ***
Dealt to jcarlos.vale [4d Kc]
XJIOPKA85: folds 
lemp2007: folds 
jcarlos.vale: folds 
biscom2007: folds 
Garrik26: folds 
felipeando: folds 
loowayking: folds 
Slav1an: calls 1500
V.A.Moskalev: raises 6000 to 9000
Slav1an: calls 6000
*** FLOP *** [2d 3c 7h]
Slav1an: checks 
V.A.Moskalev: bets 6608
Slav1an: calls 6608
*** TURN *** [2d 3c 7h] [6h]
Slav1an: checks 
V.A.Moskalev: checks 
*** RIVER *** [2d 3c 7h 6h] [9d]
Slav1an: checks 
V.A.Moskalev: checks 
*** SHOW DOWN ***
Slav1an: shows [Th 8h] (a straight, Six to Ten)
V.A.Moskalev: mucks handDTO
Slav1an collected 33241 from pot
*** SUMMARY ***
Total pot 33241 | Rake 0 
Board [2d 3c 7h 6h 9d]
Seat 1: lemp2007 folded before Flop (didn't bet)
Seat 2: jcarlos.vale folded before Flop (didn't bet)
Seat 3: biscom2007 folded before Flop (didn't bet)
Seat 4: Garrik26 folded before Flop (didn't bet)
Seat 5: felipeando folded before Flop (didn't bet)
Seat 6: loowayking (button) folded before Flop (didn't bet)
Seat 7: Slav1an (small blind) showed [Th 8h] and won (33241) with a straight, Six to Ten
Seat 8: V.A.Moskalev (big blind) mucked [Ac Js]
Seat 9: XJIOPKA85 folded before Flop (didn't bet)



PokerStars Hand #222158872943: Tournament #3086083919, $0.49+$0.06 USD Hold'em No Limit - Level XXV (1750/3500) - 2021/01/03 1:28:16 EET [2021/01/02 18:28:16 ET]
Table '3086083919 96' 9-max Seat #7 is the button
Seat 1: lemp2007 (99124 in chips) 
Seat 2: jcarlos.vale (98196 in chips) 
Seat 3: biscom2007 (19864 in chips) 
Seat 4: Garrik26 (52786 in chips) 
Seat 5: felipeando (111201 in chips) 
Seat 6: loowayking (65331 in chips) 
Seat 7: Slav1an (96716 in chips) 
Seat 8: V.A.Moskalev (132861 in chips) 
Seat 9: XJIOPKA85 (281986 in chips) 
lemp2007: posts the ante 250
jcarlos.vale: posts the ante 250
biscom2007: posts the ante 250
Garrik26: posts the ante 250
felipeando: posts the ante 250
loowayking: posts the ante 250
Slav1an: posts the ante 250
V.A.Moskalev: posts the ante 250
XJIOPKA85: posts the ante 250
V.A.Moskalev: posts small blind 1750
XJIOPKA85: posts big blind 3500
*** HOLE CARDS ***
Dealt to jcarlos.vale [9h Kh]
lemp2007: folds 
jcarlos.vale: folds 
biscom2007: folds 
Garrik26: folds 
felipeando: folds 
loowayking: folds 
Slav1an: folds 
V.A.Moskalev: raises 3500 to 7000
XJIOPKA85: raises 14000 to 21000
V.A.Moskalev: calls 14000
*** FLOP *** [6h Td 8h]
V.A.Moskalev: checks 
XJIOPKA85: bets 14160
V.A.Moskalev: folds 
Uncalled bet (14160) returned to XJIOPKA85
XJIOPKA85 collected 44250 from pot
*** SUMMARY ***
Total pot 44250 | Rake 0 
Board [6h Td 8h]
Seat 1: lemp2007 folded before Flop (didn't bet)
Seat 2: jcarlos.vale folded before Flop (didn't bet)
Seat 3: biscom2007 folded before Flop (didn't bet)
Seat 4: Garrik26 folded before Flop (didn't bet)
Seat 5: felipeando folded before Flop (didn't bet)
Seat 6: loowayking folded before Flop (didn't bet)
Seat 7: Slav1an (button) folded before Flop (didn't bet)
Seat 8: V.A.Moskalev (small blind) folded on the Flop
Seat 9: XJIOPKA85 (big blind) collected (44250)



PokerStars Hand #222158908846: Tournament #3086083919, $0.49+$0.06 USD Hold'em No Limit - Level XXV (1750/3500) - 2021/01/03 1:29:04 EET [2021/01/02 18:29:04 ET]
Table '3086083919 96' 9-max Seat #8 is the button
Seat 1: lemp2007 (98874 in chips) 
Seat 2: jcarlos.vale (97946 in chips) 
Seat 3: biscom2007 (19614 in chips) 
Seat 4: Garrik26 (52536 in chips) 
Seat 5: felipeando (110951 in chips) 
Seat 6: loowayking (65081 in chips) 
Seat 7: Slav1an (96466 in chips) 
Seat 8: V.A.Moskalev (111611 in chips) 
Seat 9: XJIOPKA85 (304986 in chips) 
lemp2007: posts the ante 250
jcarlos.vale: posts the ante 250
biscom2007: posts the ante 250
Garrik26: posts the ante 250
felipeando: posts the ante 250
loowayking: posts the ante 250
Slav1an: posts the ante 250
V.A.Moskalev: posts the ante 250
XJIOPKA85: posts the ante 250
XJIOPKA85: posts small blind 1750
lemp2007: posts big blind 3500
*** HOLE CARDS ***
Dealt to jcarlos.vale [Td 5d]
jcarlos.vale: folds 
biscom2007: raises 15864 to 19364 and is all-in
Garrik26: folds 
felipeando: folds 
loowayking: raises 45467 to 64831 and is all-in
Slav1an: folds 
V.A.Moskalev: folds 
XJIOPKA85: folds 
lemp2007: folds 
Uncalled bet (45467) returned to loowayking
*** FLOP *** [2d Jh 5h]
*** TURN *** [2d Jh 5h] [2s]
*** RIVER *** [2d Jh 5h 2s] [Qs]
*** SHOW DOWN ***
biscom2007: shows [Jc Ad] (two pair, Jacks and Deuces)
loowayking: shows [Qd Ac] (two pair, Queens and Deuces)
loowayking collected 46228 from pot
biscom2007 finished the tournament in 141st place and received $2.43.
*** SUMMARY ***
Total pot 46228 | Rake 0 
Board [2d Jh 5h 2s Qs]
Seat 1: lemp2007 (big blind) folded before Flop
Seat 2: jcarlos.vale folded before Flop (didn't bet)
Seat 3: biscom2007 showed [Jc Ad] and lost with two pair, Jacks and Deuces
Seat 4: Garrik26 folded before Flop (didn't bet)
Seat 5: felipeando folded before Flop (didn't bet)
Seat 6: loowayking showed [Qd Ac] and won (46228) with two pair, Queens and Deuces
Seat 7: Slav1an folded before Flop (didn't bet)
Seat 8: V.A.Moskalev (button) folded before Flop (didn't bet)
Seat 9: XJIOPKA85 (small blind) folded before Flop



PokerStars Hand #222158936652: Tournament #3086083919, $0.49+$0.06 USD Hold'em No Limit - Level XXV (1750/3500) - 2021/01/03 1:29:41 EET [2021/01/02 18:29:41 ET]
Table '3086083919 96' 9-max Seat #9 is the button
Seat 1: lemp2007 (95124 in chips) 
Seat 2: jcarlos.vale (97696 in chips) 
Seat 4: Garrik26 (52286 in chips) 
Seat 5: felipeando (110701 in chips) 
Seat 6: loowayking (91695 in chips) 
Seat 7: Slav1an (96216 in chips) 
Seat 8: V.A.Moskalev (111361 in chips) 
Seat 9: XJIOPKA85 (302986 in chips) 
lemp2007: posts the ante 250
jcarlos.vale: posts the ante 250
Garrik26: posts the ante 250
felipeando: posts the ante 250
loowayking: posts the ante 250
Slav1an: posts the ante 250
V.A.Moskalev: posts the ante 250
XJIOPKA85: posts the ante 250
lemp2007: posts small blind 1750
jcarlos.vale: posts big blind 3500
*** HOLE CARDS ***
Dealt to jcarlos.vale [7c 2s]
Garrik26: folds 
felipeando: folds 
loowayking: folds 
Slav1an: folds 
V.A.Moskalev: folds 
XJIOPKA85: raises 3955 to 7455
lemp2007: calls 5705
jcarlos.vale: folds 
*** FLOP *** [Tc Kh Ks]
lemp2007: checks 
XJIOPKA85: bets 6531
lemp2007: folds 
Uncalled bet (6531) returned to XJIOPKA85
XJIOPKA85 collected 20410 from pot
*** SUMMARY ***
Total pot 20410 | Rake 0 
Board [Tc Kh Ks]
Seat 1: lemp2007 (small blind) folded on the Flop
Seat 2: jcarlos.vale (big blind) folded before Flop
Seat 4: Garrik26 folded before Flop (didn't bet)
Seat 5: felipeando folded before Flop (didn't bet)
Seat 6: loowayking folded before Flop (didn't bet)
Seat 7: Slav1an folded before Flop (didn't bet)
Seat 8: V.A.Moskalev folded before Flop (didn't bet)
Seat 9: XJIOPKA85 (button) collected (20410)



PokerStars Hand #222158963246: Tournament #3086083919, $0.49+$0.06 USD Hold'em No Limit - Level XXV (1750/3500) - 2021/01/03 1:30:16 EET [2021/01/02 18:30:16 ET]
Table '3086083919 96' 9-max Seat #1 is the button
Seat 1: lemp2007 (87419 in chips) 
Seat 2: jcarlos.vale (93946 in chips) 
Seat 4: Garrik26 (52036 in chips) 
Seat 5: felipeando (110451 in chips) 
Seat 6: loowayking (91445 in chips) 
Seat 7: Slav1an (95966 in chips) 
Seat 8: V.A.Moskalev (111111 in chips) 
Seat 9: XJIOPKA85 (315691 in chips) 
lemp2007: posts the ante 250
jcarlos.vale: posts the ante 250
Garrik26: posts the ante 250
felipeando: posts the ante 250
loowayking: posts the ante 250
Slav1an: posts the ante 250
V.A.Moskalev: posts the ante 250
XJIOPKA85: posts the ante 250
jcarlos.vale: posts small blind 1750
Garrik26: posts big blind 3500
*** HOLE CARDS ***
Dealt to jcarlos.vale [Jc 8h]
felipeando: folds 
loowayking: folds 
Slav1an: folds 
V.A.Moskalev: raises 3500 to 7000
XJIOPKA85: folds 
lemp2007: folds 
jcarlos.vale: folds 
Garrik26: folds 
Uncalled bet (3500) returned to V.A.Moskalev
V.A.Moskalev collected 10750 from pot
*** SUMMARY ***
Total pot 10750 | Rake 0 
Seat 1: lemp2007 (button) folded before Flop (didn't bet)
Seat 2: jcarlos.vale (small blind) folded before Flop
Seat 4: Garrik26 (big blind) folded before Flop
Seat 5: felipeando folded before Flop (didn't bet)
Seat 6: loowayking folded before Flop (didn't bet)
Seat 7: Slav1an folded before Flop (didn't bet)
Seat 8: V.A.Moskalev collected (10750)
Seat 9: XJIOPKA85 folded before Flop (didn't bet)



PokerStars Hand #222158982286: Tournament #3086083919, $0.49+$0.06 USD Hold'em No Limit - Level XXV (1750/3500) - 2021/01/03 1:30:41 EET [2021/01/02 18:30:41 ET]
Table '3086083919 96' 9-max Seat #2 is the button
Seat 1: lemp2007 (87169 in chips) 
Seat 2: jcarlos.vale (91946 in chips) 
Seat 4: Garrik26 (48286 in chips) 
Seat 5: felipeando (110201 in chips) 
Seat 6: loowayking (91195 in chips) 
Seat 7: Slav1an (95716 in chips) 
Seat 8: V.A.Moskalev (118111 in chips) 
Seat 9: XJIOPKA85 (315441 in chips) 
lemp2007: posts the ante 250
jcarlos.vale: posts the ante 250
Garrik26: posts the ante 250
felipeando: posts the ante 250
loowayking: posts the ante 250
Slav1an: posts the ante 250
V.A.Moskalev: posts the ante 250
XJIOPKA85: posts the ante 250
Garrik26: posts small blind 1750
felipeando: posts big blind 3500
*** HOLE CARDS ***
Dealt to jcarlos.vale [Ks 7h]
loowayking: folds 
Slav1an: folds 
V.A.Moskalev: raises 3500 to 7000
XJIOPKA85: folds 
lemp2007: folds 
jcarlos.vale: folds 
Garrik26: folds 
felipeando: folds 
Uncalled bet (3500) returned to V.A.Moskalev
V.A.Moskalev collected 10750 from pot
*** SUMMARY ***
Total pot 10750 | Rake 0 
Seat 1: lemp2007 folded before Flop (didn't bet)
Seat 2: jcarlos.vale (button) folded before Flop (didn't bet)
Seat 4: Garrik26 (small blind) folded before Flop
Seat 5: felipeando (big blind) folded before Flop
Seat 6: loowayking folded before Flop (didn't bet)
Seat 7: Slav1an folded before Flop (didn't bet)
Seat 8: V.A.Moskalev collected (10750)
Seat 9: XJIOPKA85 folded before Flop (didn't bet)



PokerStars Hand #222159008392: Tournament #3086083919, $0.49+$0.06 USD Hold'em No Limit - Level XXV (1750/3500) - 2021/01/03 1:31:15 EET [2021/01/02 18:31:15 ET]
Table '3086083919 96' 9-max Seat #4 is the button
Seat 1: lemp2007 (86919 in chips) 
Seat 2: jcarlos.vale (91696 in chips) 
Seat 4: Garrik26 (46286 in chips) 
Seat 5: felipeando (106451 in chips) 
Seat 6: loowayking (90945 in chips) 
Seat 7: Slav1an (95466 in chips) 
Seat 8: V.A.Moskalev (125111 in chips) 
Seat 9: XJIOPKA85 (315191 in chips) 
lemp2007: posts the ante 250
jcarlos.vale: posts the ante 250
Garrik26: posts the ante 250
felipeando: posts the ante 250
loowayking: posts the ante 250
Slav1an: posts the ante 250
V.A.Moskalev: posts the ante 250
XJIOPKA85: posts the ante 250
felipeando: posts small blind 1750
loowayking: posts big blind 3500
*** HOLE CARDS ***
Dealt to jcarlos.vale [Jc 3d]
Slav1an: raises 3501 to 7001
V.A.Moskalev: folds 
XJIOPKA85: folds 
lemp2007: folds 
jcarlos.vale: folds 
Garrik26: folds 
felipeando: folds 
loowayking: folds 
Uncalled bet (3501) returned to Slav1an
Slav1an collected 10750 from pot
*** SUMMARY ***
Total pot 10750 | Rake 0 
Seat 1: lemp2007 folded before Flop (didn't bet)
Seat 2: jcarlos.vale folded before Flop (didn't bet)
Seat 4: Garrik26 (button) folded before Flop (didn't bet)
Seat 5: felipeando (small blind) folded before Flop
Seat 6: loowayking (big blind) folded before Flop
Seat 7: Slav1an collected (10750)
Seat 8: V.A.Moskalev folded before Flop (didn't bet)
Seat 9: XJIOPKA85 folded before Flop (didn't bet)



PokerStars Hand #222159020628: Tournament #3086083919, $0.49+$0.06 USD Hold'em No Limit - Level XXV (1750/3500) - 2021/01/03 1:31:31 EET [2021/01/02 18:31:31 ET]
Table '3086083919 96' 9-max Seat #5 is the button
Seat 1: lemp2007 (86669 in chips) 
Seat 2: jcarlos.vale (91446 in chips) 
Seat 4: Garrik26 (46036 in chips) 
Seat 5: felipeando (104451 in chips) 
Seat 6: loowayking (87195 in chips) 
Seat 7: Slav1an (102466 in chips) 
Seat 8: V.A.Moskalev (124861 in chips) 
Seat 9: XJIOPKA85 (314941 in chips) 
lemp2007: posts the ante 250
jcarlos.vale: posts the ante 250
Garrik26: posts the ante 250
felipeando: posts the ante 250
loowayking: posts the ante 250
Slav1an: posts the ante 250
V.A.Moskalev: posts the ante 250
XJIOPKA85: posts the ante 250
loowayking: posts small blind 1750
Slav1an: posts big blind 3500
*** HOLE CARDS ***
Dealt to jcarlos.vale [7h Qh]
V.A.Moskalev: folds 
XJIOPKA85: folds 
lemp2007: folds 
jcarlos.vale: folds 
Garrik26: folds 
felipeando: folds 
loowayking: folds 
Uncalled bet (1750) returned to Slav1an
Slav1an collected 5500 from pot
*** SUMMARY ***
Total pot 5500 | Rake 0 
Seat 1: lemp2007 folded before Flop (didn't bet)
Seat 2: jcarlos.vale folded before Flop (didn't bet)
Seat 4: Garrik26 folded before Flop (didn't bet)
Seat 5: felipeando (button) folded before Flop (didn't bet)
Seat 6: loowayking (small blind) folded before Flop
Seat 7: Slav1an (big blind) collected (5500)
Seat 8: V.A.Moskalev folded before Flop (didn't bet)
Seat 9: XJIOPKA85 folded before Flop (didn't bet)



PokerStars Hand #222159032173: Tournament #3086083919, $0.49+$0.06 USD Hold'em No Limit - Level XXV (1750/3500) - 2021/01/03 1:31:47 EET [2021/01/02 18:31:47 ET]
Table '3086083919 96' 9-max Seat #6 is the button
Seat 1: lemp2007 (86419 in chips) 
Seat 2: jcarlos.vale (91196 in chips) 
Seat 4: Garrik26 (45786 in chips) 
Seat 5: felipeando (104201 in chips) 
Seat 6: loowayking (85195 in chips) 
Seat 7: Slav1an (105966 in chips) 
Seat 8: V.A.Moskalev (124611 in chips) 
Seat 9: XJIOPKA85 (314691 in chips) 
lemp2007: posts the ante 250
jcarlos.vale: posts the ante 250
Garrik26: posts the ante 250
felipeando: posts the ante 250
loowayking: posts the ante 250
Slav1an: posts the ante 250
V.A.Moskalev: posts the ante 250
XJIOPKA85: posts the ante 250
Slav1an: posts small blind 1750
V.A.Moskalev: posts big blind 3500
*** HOLE CARDS ***
Dealt to jcarlos.vale [Ah 2d]
XJIOPKA85: folds 
lemp2007: folds 
jcarlos.vale: folds 
Garrik26: folds 
felipeando: raises 3500 to 7000
loowayking: folds 
Slav1an: folds 
V.A.Moskalev: calls 3500
*** FLOP *** [2c 4c 4d]
V.A.Moskalev: checks 
felipeando: bets 8343
V.A.Moskalev: folds 
Uncalled bet (8343) returned to felipeando
felipeando collected 17750 from pot
felipeando: doesn't show handDTO
*** SUMMARY ***
Total pot 17750 | Rake 0 
Board [2c 4c 4d]
Seat 1: lemp2007 folded before Flop (didn't bet)
Seat 2: jcarlos.vale folded before Flop (didn't bet)
Seat 4: Garrik26 folded before Flop (didn't bet)
Seat 5: felipeando collected (17750)
Seat 6: loowayking (button) folded before Flop (didn't bet)
Seat 7: Slav1an (small blind) folded before Flop
Seat 8: V.A.Moskalev (big blind) folded on the Flop
Seat 9: XJIOPKA85 folded before Flop (didn't bet)



PokerStars Hand #222159060774: Tournament #3086083919, $0.49+$0.06 USD Hold'em No Limit - Level XXV (1750/3500) - 2021/01/03 1:32:24 EET [2021/01/02 18:32:24 ET]
Table '3086083919 96' 9-max Seat #7 is the button
Seat 1: lemp2007 (86169 in chips) 
Seat 2: jcarlos.vale (90946 in chips) 
Seat 4: Garrik26 (45536 in chips) 
Seat 5: felipeando (114701 in chips) 
Seat 6: loowayking (84945 in chips) 
Seat 7: Slav1an (103966 in chips) 
Seat 8: V.A.Moskalev (117361 in chips) 
Seat 9: XJIOPKA85 (314441 in chips) 
lemp2007: posts the ante 250
jcarlos.vale: posts the ante 250
Garrik26: posts the ante 250
felipeando: posts the ante 250
loowayking: posts the ante 250
Slav1an: posts the ante 250
V.A.Moskalev: posts the ante 250
XJIOPKA85: posts the ante 250
V.A.Moskalev: posts small blind 1750
XJIOPKA85: posts big blind 3500
*** HOLE CARDS ***
Dealt to jcarlos.vale [7d Js]
lemp2007: raises 3500 to 7000
jcarlos.vale: folds 
Garrik26: folds 
felipeando: folds 
loowayking: folds 
Slav1an: folds 
V.A.Moskalev: calls 5250
XJIOPKA85: calls 3500
*** FLOP *** [5d Kc Jh]
V.A.Moskalev: bets 7590
XJIOPKA85: folds 
lemp2007: calls 7590
*** TURN *** [5d Kc Jh] [5h]
V.A.Moskalev: bets 19090
lemp2007: calls 19090
*** RIVER *** [5d Kc Jh 5h] [6s]
V.A.Moskalev: checks 
lemp2007: checks 
*** SHOW DOWN ***
V.A.Moskalev: shows [Kd Qc] (two pair, Kings and Fives)
lemp2007: mucks handDTO
V.A.Moskalev collected 76360 from pot
*** SUMMARY ***
Total pot 76360 | Rake 0 
Board [5d Kc Jh 5h 6s]
Seat 1: lemp2007 mucked [Tc Jd]
Seat 2: jcarlos.vale folded before Flop (didn't bet)
Seat 4: Garrik26 folded before Flop (didn't bet)
Seat 5: felipeando folded before Flop (didn't bet)
Seat 6: loowayking folded before Flop (didn't bet)
Seat 7: Slav1an (button) folded before Flop (didn't bet)
Seat 8: V.A.Moskalev (small blind) showed [Kd Qc] and won (76360) with two pair, Kings and Fives
Seat 9: XJIOPKA85 (big blind) folded on the Flop



PokerStars Hand #222159101381: Tournament #3086083919, $0.49+$0.06 USD Hold'em No Limit - Level XXV (1750/3500) - 2021/01/03 1:33:18 EET [2021/01/02 18:33:18 ET]
Table '3086083919 96' 9-max Seat #8 is the button
Seat 1: lemp2007 (52239 in chips) 
Seat 2: jcarlos.vale (90696 in chips) 
Seat 4: Garrik26 (45286 in chips) 
Seat 5: felipeando (114451 in chips) 
Seat 6: loowayking (84695 in chips) 
Seat 7: Slav1an (103716 in chips) 
Seat 8: V.A.Moskalev (159791 in chips) 
Seat 9: XJIOPKA85 (307191 in chips) 
lemp2007: posts the ante 250
jcarlos.vale: posts the ante 250
Garrik26: posts the ante 250
felipeando: posts the ante 250
loowayking: posts the ante 250
Slav1an: posts the ante 250
V.A.Moskalev: posts the ante 250
XJIOPKA85: posts the ante 250
XJIOPKA85: posts small blind 1750
lemp2007: posts big blind 3500
*** HOLE CARDS ***
Dealt to jcarlos.vale [As 6c]
jcarlos.vale: folds 
Garrik26: folds 
felipeando: folds 
loowayking: folds 
Slav1an: raises 3501 to 7001
V.A.Moskalev: folds 
XJIOPKA85: folds 
lemp2007: calls 3501
*** FLOP *** [Tc Jd 4c]
lemp2007: checks 
Slav1an: bets 13314
lemp2007: folds 
Uncalled bet (13314) returned to Slav1an
Slav1an collected 17752 from pot
*** SUMMARY ***
Total pot 17752 | Rake 0 
Board [Tc Jd 4c]
Seat 1: lemp2007 (big blind) folded on the Flop
Seat 2: jcarlos.vale folded before Flop (didn't bet)
Seat 4: Garrik26 folded before Flop (didn't bet)
Seat 5: felipeando folded before Flop (didn't bet)
Seat 6: loowayking folded before Flop (didn't bet)
Seat 7: Slav1an collected (17752)
Seat 8: V.A.Moskalev (button) folded before Flop (didn't bet)
Seat 9: XJIOPKA85 (small blind) folded before Flop



PokerStars Hand #222159122993: Tournament #3086083919, $0.49+$0.06 USD Hold'em No Limit - Level XXV (1750/3500) - 2021/01/03 1:33:46 EET [2021/01/02 18:33:46 ET]
Table '3086083919 96' 9-max Seat #9 is the button
Seat 1: lemp2007 (44988 in chips) 
Seat 2: jcarlos.vale (90446 in chips) 
Seat 3: master.zuev (139123 in chips) 
Seat 4: Garrik26 (45036 in chips) 
Seat 5: felipeando (114201 in chips) 
Seat 6: loowayking (84445 in chips) 
Seat 7: Slav1an (114217 in chips) 
Seat 8: V.A.Moskalev (159541 in chips) 
Seat 9: XJIOPKA85 (305191 in chips) 
lemp2007: posts the ante 250
jcarlos.vale: posts the ante 250
master.zuev: posts the ante 250
Garrik26: posts the ante 250
felipeando: posts the ante 250
loowayking: posts the ante 250
Slav1an: posts the ante 250
V.A.Moskalev: posts the ante 250
XJIOPKA85: posts the ante 250
lemp2007: posts small blind 1750
jcarlos.vale: posts big blind 3500
*** HOLE CARDS ***
Dealt to jcarlos.vale [3c 4h]
master.zuev: folds 
Garrik26: folds 
felipeando: folds 
loowayking: folds 
Slav1an: folds 
V.A.Moskalev: folds 
XJIOPKA85: raises 3955 to 7455
lemp2007: folds 
jcarlos.vale: folds 
Uncalled bet (3955) returned to XJIOPKA85
XJIOPKA85 collected 11000 from pot
*** SUMMARY ***
Total pot 11000 | Rake 0 
Seat 1: lemp2007 (small blind) folded before Flop
Seat 2: jcarlos.vale (big blind) folded before Flop
Seat 3: master.zuev folded before Flop (didn't bet)
Seat 4: Garrik26 folded before Flop (didn't bet)
Seat 5: felipeando folded before Flop (didn't bet)
Seat 6: loowayking folded before Flop (didn't bet)
Seat 7: Slav1an folded before Flop (didn't bet)
Seat 8: V.A.Moskalev folded before Flop (didn't bet)
Seat 9: XJIOPKA85 (button) collected (11000)



PokerStars Hand #222159138245: Tournament #3086083919, $0.49+$0.06 USD Hold'em No Limit - Level XXV (1750/3500) - 2021/01/03 1:34:07 EET [2021/01/02 18:34:07 ET]
Table '3086083919 96' 9-max Seat #1 is the button
Seat 1: lemp2007 (42988 in chips) 
Seat 2: jcarlos.vale (86696 in chips) 
Seat 3: master.zuev (138873 in chips) 
Seat 4: Garrik26 (44786 in chips) 
Seat 5: felipeando (113951 in chips) 
Seat 6: loowayking (84195 in chips) 
Seat 7: Slav1an (113967 in chips) 
Seat 8: V.A.Moskalev (159291 in chips) 
Seat 9: XJIOPKA85 (312441 in chips) 
lemp2007: posts the ante 250
jcarlos.vale: posts the ante 250
master.zuev: posts the ante 250
Garrik26: posts the ante 250
felipeando: posts the ante 250
loowayking: posts the ante 250
Slav1an: posts the ante 250
V.A.Moskalev: posts the ante 250
XJIOPKA85: posts the ante 250
jcarlos.vale: posts small blind 1750
master.zuev: posts big blind 3500
*** HOLE CARDS ***
Dealt to jcarlos.vale [Ac Ks]
Garrik26: folds 
felipeando: folds 
loowayking: folds 
Slav1an: folds 
V.A.Moskalev: folds 
XJIOPKA85: folds 
lemp2007: calls 3500
jcarlos.vale: raises 82946 to 86446 and is all-in
master.zuev: folds 
lemp2007: folds 
Uncalled bet (82946) returned to jcarlos.vale
jcarlos.vale collected 12750 from pot
jcarlos.vale: doesn't show handDTO
*** SUMMARY ***
Total pot 12750 | Rake 0 
Seat 1: lemp2007 (button) folded before Flop
Seat 2: jcarlos.vale (small blind) collected (12750)
Seat 3: master.zuev (big blind) folded before Flop
Seat 4: Garrik26 folded before Flop (didn't bet)
Seat 5: felipeando folded before Flop (didn't bet)
Seat 6: loowayking folded before Flop (didn't bet)
Seat 7: Slav1an folded before Flop (didn't bet)
Seat 8: V.A.Moskalev folded before Flop (didn't bet)
Seat 9: XJIOPKA85 folded before Flop (didn't bet)



PokerStars Hand #222159156163: Tournament #3086083919, $0.49+$0.06 USD Hold'em No Limit - Level XXV (1750/3500) - 2021/01/03 1:34:31 EET [2021/01/02 18:34:31 ET]
Table '3086083919 96' 9-max Seat #2 is the button
Seat 1: lemp2007 (39238 in chips) 
Seat 2: jcarlos.vale (95696 in chips) 
Seat 3: master.zuev (135123 in chips) 
Seat 4: Garrik26 (44536 in chips) 
Seat 5: felipeando (113701 in chips) 
Seat 6: loowayking (83945 in chips) 
Seat 7: Slav1an (113717 in chips) 
Seat 8: V.A.Moskalev (159041 in chips) 
Seat 9: XJIOPKA85 (312191 in chips) 
lemp2007: posts the ante 250
jcarlos.vale: posts the ante 250
master.zuev: posts the ante 250
Garrik26: posts the ante 250
felipeando: posts the ante 250
loowayking: posts the ante 250
Slav1an: posts the ante 250
V.A.Moskalev: posts the ante 250
XJIOPKA85: posts the ante 250
master.zuev: posts small blind 1750
Garrik26: posts big blind 3500
*** HOLE CARDS ***
Dealt to jcarlos.vale [8d 3s]
felipeando: raises 3500 to 7000
loowayking: folds 
Slav1an: folds 
V.A.Moskalev: folds 
XJIOPKA85: folds 
lemp2007: folds 
jcarlos.vale: folds 
master.zuev: folds 
Garrik26: folds 
Uncalled bet (3500) returned to felipeando
felipeando collected 11000 from pot
*** SUMMARY ***
Total pot 11000 | Rake 0 
Seat 1: lemp2007 folded before Flop (didn't bet)
Seat 2: jcarlos.vale (button) folded before Flop (didn't bet)
Seat 3: master.zuev (small blind) folded before Flop
Seat 4: Garrik26 (big blind) folded before Flop
Seat 5: felipeando collected (11000)
Seat 6: loowayking folded before Flop (didn't bet)
Seat 7: Slav1an folded before Flop (didn't bet)
Seat 8: V.A.Moskalev folded before Flop (didn't bet)
Seat 9: XJIOPKA85 folded before Flop (didn't bet)



PokerStars Hand #222159176237: Tournament #3086083919, $0.49+$0.06 USD Hold'em No Limit - Level XXV (1750/3500) - 2021/01/03 1:34:58 EET [2021/01/02 18:34:58 ET]
Table '3086083919 96' 9-max Seat #3 is the button
Seat 1: lemp2007 (38988 in chips) 
Seat 2: jcarlos.vale (95446 in chips) 
Seat 3: master.zuev (133123 in chips) 
Seat 4: Garrik26 (40786 in chips) 
Seat 5: felipeando (120951 in chips) 
Seat 6: loowayking (83695 in chips) 
Seat 7: Slav1an (113467 in chips) 
Seat 8: V.A.Moskalev (158791 in chips) 
Seat 9: XJIOPKA85 (311941 in chips) 
lemp2007: posts the ante 250
jcarlos.vale: posts the ante 250
master.zuev: posts the ante 250
Garrik26: posts the ante 250
felipeando: posts the ante 250
loowayking: posts the ante 250
Slav1an: posts the ante 250
V.A.Moskalev: posts the ante 250
XJIOPKA85: posts the ante 250
Garrik26: posts small blind 1750
felipeando: posts big blind 3500
*** HOLE CARDS ***
Dealt to jcarlos.vale [Ks 9h]
loowayking: folds 
Slav1an: raises 3501 to 7001
V.A.Moskalev: folds 
XJIOPKA85: folds 
lemp2007: folds 
jcarlos.vale: folds 
master.zuev: folds 
Garrik26: folds 
felipeando: folds 
Uncalled bet (3501) returned to Slav1an
Slav1an collected 11000 from pot
*** SUMMARY ***
Total pot 11000 | Rake 0 
Seat 1: lemp2007 folded before Flop (didn't bet)
Seat 2: jcarlos.vale folded before Flop (didn't bet)
Seat 3: master.zuev (button) folded before Flop (didn't bet)
Seat 4: Garrik26 (small blind) folded before Flop
Seat 5: felipeando (big blind) folded before Flop
Seat 6: loowayking folded before Flop (didn't bet)
Seat 7: Slav1an collected (11000)
Seat 8: V.A.Moskalev folded before Flop (didn't bet)
Seat 9: XJIOPKA85 folded before Flop (didn't bet)



PokerStars Hand #222159195139: Tournament #3086083919, $0.49+$0.06 USD Hold'em No Limit - Level XXV (1750/3500) - 2021/01/03 1:35:23 EET [2021/01/02 18:35:23 ET]
Table '3086083919 96' 9-max Seat #4 is the button
Seat 1: lemp2007 (38738 in chips) 
Seat 2: jcarlos.vale (95196 in chips) 
Seat 3: master.zuev (132873 in chips) 
Seat 4: Garrik26 (38786 in chips) 
Seat 5: felipeando (117201 in chips) 
Seat 6: loowayking (83445 in chips) 
Seat 7: Slav1an (120717 in chips) 
Seat 8: V.A.Moskalev (158541 in chips) 
Seat 9: XJIOPKA85 (311691 in chips) 
lemp2007: posts the ante 250
jcarlos.vale: posts the ante 250
master.zuev: posts the ante 250
Garrik26: posts the ante 250
felipeando: posts the ante 250
loowayking: posts the ante 250
Slav1an: posts the ante 250
V.A.Moskalev: posts the ante 250
XJIOPKA85: posts the ante 250
felipeando: posts small blind 1750
loowayking: posts big blind 3500
*** HOLE CARDS ***
Dealt to jcarlos.vale [Qd 7d]
Slav1an: folds 
V.A.Moskalev: folds 
XJIOPKA85: folds 
lemp2007: folds 
jcarlos.vale: folds 
master.zuev: raises 4410 to 7910
Garrik26: folds 
felipeando: folds 
loowayking: folds 
Uncalled bet (4410) returned to master.zuev
master.zuev collected 11000 from pot
master.zuev: doesn't show handDTO
*** SUMMARY ***
Total pot 11000 | Rake 0 
Seat 1: lemp2007 folded before Flop (didn't bet)
Seat 2: jcarlos.vale folded before Flop (didn't bet)
Seat 3: master.zuev collected (11000)
Seat 4: Garrik26 (button) folded before Flop (didn't bet)
Seat 5: felipeando (small blind) folded before Flop
Seat 6: loowayking (big blind) folded before Flop
Seat 7: Slav1an folded before Flop (didn't bet)
Seat 8: V.A.Moskalev folded before Flop (didn't bet)
Seat 9: XJIOPKA85 folded before Flop (didn't bet)



PokerStars Hand #222159208727: Tournament #3086083919, $0.49+$0.06 USD Hold'em No Limit - Level XXV (1750/3500) - 2021/01/03 1:35:41 EET [2021/01/02 18:35:41 ET]
Table '3086083919 96' 9-max Seat #5 is the button
Seat 1: lemp2007 (38488 in chips) 
Seat 2: jcarlos.vale (94946 in chips) 
Seat 3: master.zuev (140123 in chips) 
Seat 4: Garrik26 (38536 in chips) 
Seat 5: felipeando (115201 in chips) 
Seat 6: loowayking (79695 in chips) 
Seat 7: Slav1an (120467 in chips) 
Seat 8: V.A.Moskalev (158291 in chips) 
Seat 9: XJIOPKA85 (311441 in chips) 
lemp2007: posts the ante 250
jcarlos.vale: posts the ante 250
master.zuev: posts the ante 250
Garrik26: posts the ante 250
felipeando: posts the ante 250
loowayking: posts the ante 250
Slav1an: posts the ante 250
V.A.Moskalev: posts the ante 250
XJIOPKA85: posts the ante 250
loowayking: posts small blind 1750
Slav1an: posts big blind 3500
*** HOLE CARDS ***
Dealt to jcarlos.vale [Jc Ks]
V.A.Moskalev: folds 
XJIOPKA85: raises 3955 to 7455
lemp2007: calls 7455
jcarlos.vale: folds 
master.zuev: folds 
Garrik26: folds 
felipeando: folds 
loowayking: folds 
Slav1an: calls 3955
*** FLOP *** [Qc As 9c]
Slav1an: checks 
XJIOPKA85: bets 8437
lemp2007: folds 
Slav1an: folds 
Uncalled bet (8437) returned to XJIOPKA85
XJIOPKA85 collected 26365 from pot
*** SUMMARY ***
Total pot 26365 | Rake 0 
Board [Qc As 9c]
Seat 1: lemp2007 folded on the Flop
Seat 2: jcarlos.vale folded before Flop (didn't bet)
Seat 3: master.zuev folded before Flop (didn't bet)
Seat 4: Garrik26 folded before Flop (didn't bet)
Seat 5: felipeando (button) folded before Flop (didn't bet)
Seat 6: loowayking (small blind) folded before Flop
Seat 7: Slav1an (big blind) folded on the Flop
Seat 8: V.A.Moskalev folded before Flop (didn't bet)
Seat 9: XJIOPKA85 collected (26365)



PokerStars Hand #222159256028: Tournament #3086083919, $0.49+$0.06 USD Hold'em No Limit - Level XXV (1750/3500) - 2021/01/03 1:36:38 EET [2021/01/02 18:36:38 ET]
Table '3086083919 96' 9-max Seat #6 is the button
Seat 1: lemp2007 (30783 in chips) 
Seat 2: jcarlos.vale (94696 in chips) 
Seat 3: master.zuev (139873 in chips) 
Seat 4: Garrik26 (38286 in chips) 
Seat 5: felipeando (114951 in chips) 
Seat 6: loowayking (77695 in chips) 
Seat 7: Slav1an (112762 in chips) 
Seat 8: V.A.Moskalev (158041 in chips) 
Seat 9: XJIOPKA85 (330101 in chips) 
lemp2007: posts the ante 250
jcarlos.vale: posts the ante 250
master.zuev: posts the ante 250
Garrik26: posts the ante 250
felipeando: posts the ante 250
loowayking: posts the ante 250
Slav1an: posts the ante 250
V.A.Moskalev: posts the ante 250
XJIOPKA85: posts the ante 250
Slav1an: posts small blind 1750
V.A.Moskalev: posts big blind 3500
*** HOLE CARDS ***
Dealt to jcarlos.vale [7c 4d]
XJIOPKA85: folds 
lemp2007: calls 3500
jcarlos.vale: folds 
master.zuev: folds 
Garrik26: folds 
felipeando: folds 
loowayking: folds 
Slav1an: calls 1750
V.A.Moskalev: checks 
*** FLOP *** [Kd Th 5d]
Slav1an: checks 
V.A.Moskalev: checks 
lemp2007: bets 7000
Slav1an: folds 
V.A.Moskalev: folds 
Uncalled bet (7000) returned to lemp2007
lemp2007 collected 12750 from pot
lemp2007: doesn't show handDTO
*** SUMMARY ***
Total pot 12750 | Rake 0 
Board [Kd Th 5d]
Seat 1: lemp2007 collected (12750)
Seat 2: jcarlos.vale folded before Flop (didn't bet)
Seat 3: master.zuev folded before Flop (didn't bet)
Seat 4: Garrik26 folded before Flop (didn't bet)
Seat 5: felipeando folded before Flop (didn't bet)
Seat 6: loowayking (button) folded before Flop (didn't bet)
Seat 7: Slav1an (small blind) folded on the Flop
Seat 8: V.A.Moskalev (big blind) folded on the Flop
Seat 9: XJIOPKA85 folded before Flop (didn't bet)



PokerStars Hand #222159291857: Tournament #3086083919, $0.49+$0.06 USD Hold'em No Limit - Level XXV (1750/3500) - 2021/01/03 1:37:26 EET [2021/01/02 18:37:26 ET]
Table '3086083919 96' 9-max Seat #7 is the button
Seat 1: lemp2007 (39783 in chips) 
Seat 2: jcarlos.vale (94446 in chips) 
Seat 3: master.zuev (139623 in chips) 
Seat 4: Garrik26 (38036 in chips) 
Seat 5: felipeando (114701 in chips) 
Seat 6: loowayking (77445 in chips) 
Seat 7: Slav1an (109012 in chips) 
Seat 8: V.A.Moskalev (154291 in chips) 
Seat 9: XJIOPKA85 (329851 in chips) 
lemp2007: posts the ante 250
jcarlos.vale: posts the ante 250
master.zuev: posts the ante 250
Garrik26: posts the ante 250
felipeando: posts the ante 250
loowayking: posts the ante 250
Slav1an: posts the ante 250
V.A.Moskalev: posts the ante 250
XJIOPKA85: posts the ante 250
V.A.Moskalev: posts small blind 1750
XJIOPKA85: posts big blind 3500
*** HOLE CARDS ***
Dealt to jcarlos.vale [4s 2d]
lemp2007: folds 
jcarlos.vale: folds 
master.zuev: folds 
Garrik26: folds 
felipeando: folds 
loowayking: folds 
Slav1an: folds 
V.A.Moskalev: raises 3500 to 7000
XJIOPKA85: calls 3500
*** FLOP *** [Jh 8c Jd]
V.A.Moskalev: bets 5363
XJIOPKA85: raises 8637 to 14000
V.A.Moskalev: calls 8637
*** TURN *** [Jh 8c Jd] [Ks]
V.A.Moskalev: checks 
XJIOPKA85: bets 24500
V.A.Moskalev: folds 
Uncalled bet (24500) returned to XJIOPKA85
XJIOPKA85 collected 44250 from pot
*** SUMMARY ***
Total pot 44250 | Rake 0 
Board [Jh 8c Jd Ks]
Seat 1: lemp2007 folded before Flop (didn't bet)
Seat 2: jcarlos.vale folded before Flop (didn't bet)
Seat 3: master.zuev folded before Flop (didn't bet)
Seat 4: Garrik26 folded before Flop (didn't bet)
Seat 5: felipeando folded before Flop (didn't bet)
Seat 6: loowayking folded before Flop (didn't bet)
Seat 7: Slav1an (button) folded before Flop (didn't bet)
Seat 8: V.A.Moskalev (small blind) folded on the Turn
Seat 9: XJIOPKA85 (big blind) collected (44250)



PokerStars Hand #222159332242: Tournament #3086083919, $0.49+$0.06 USD Hold'em No Limit - Level XXVI (2000/4000) - 2021/01/03 1:38:21 EET [2021/01/02 18:38:21 ET]
Table '3086083919 96' 9-max Seat #8 is the button
Seat 1: lemp2007 (39533 in chips) 
Seat 2: jcarlos.vale (94196 in chips) 
Seat 3: master.zuev (139373 in chips) 
Seat 4: Garrik26 (37786 in chips) 
Seat 5: felipeando (114451 in chips) 
Seat 6: loowayking (77195 in chips) 
Seat 7: Slav1an (108762 in chips) 
Seat 8: V.A.Moskalev (133041 in chips) 
Seat 9: XJIOPKA85 (352851 in chips) 
lemp2007: posts the ante 315
jcarlos.vale: posts the ante 315
master.zuev: posts the ante 315
Garrik26: posts the ante 315
felipeando: posts the ante 315
loowayking: posts the ante 315
Slav1an: posts the ante 315
V.A.Moskalev: posts the ante 315
XJIOPKA85: posts the ante 315
XJIOPKA85: posts small blind 2000
lemp2007: posts big blind 4000
*** HOLE CARDS ***
Dealt to jcarlos.vale [7c 5c]
jcarlos.vale: folds 
master.zuev: folds 
Garrik26: folds 
felipeando: folds 
loowayking: folds 
Slav1an: raises 4001 to 8001
V.A.Moskalev: folds 
XJIOPKA85: folds 
lemp2007: calls 4001
*** FLOP *** [6d 2c Ks]
lemp2007: checks 
Slav1an: bets 6251
lemp2007: calls 6251
*** TURN *** [6d 2c Ks] [4s]
lemp2007: bets 24966 and is all-in
Slav1an: calls 24966
*** RIVER *** [6d 2c Ks 4s] [6s]
*** SHOW DOWN ***
lemp2007: shows [Ac Qh] (a pair of Sixes)
Slav1an: shows [4c As] (two pair, Sixes and Fours)
Slav1an collected 83271 from pot
lemp2007 finished the tournament in 127th place and received $2.43.
*** SUMMARY ***
Total pot 83271 | Rake 0 
Board [6d 2c Ks 4s 6s]
Seat 1: lemp2007 (big blind) showed [Ac Qh] and lost with a pair of Sixes
Seat 2: jcarlos.vale folded before Flop (didn't bet)
Seat 3: master.zuev folded before Flop (didn't bet)
Seat 4: Garrik26 folded before Flop (didn't bet)
Seat 5: felipeando folded before Flop (didn't bet)
Seat 6: loowayking folded before Flop (didn't bet)
Seat 7: Slav1an showed [4c As] and won (83271) with two pair, Sixes and Fours
Seat 8: V.A.Moskalev (button) folded before Flop (didn't bet)
Seat 9: XJIOPKA85 (small blind) folded before Flop



PokerStars Hand #222159381718: Tournament #3086083919, $0.49+$0.06 USD Hold'em No Limit - Level XXVI (2000/4000) - 2021/01/03 1:39:29 EET [2021/01/02 18:39:29 ET]
Table '3086083919 111' 9-max Seat #6 is the button
Seat 1: 19bobo76 (65329 in chips) 
Seat 2: jcarlos.vale (93881 in chips) 
Seat 3: xarris_1392 (368777 in chips) 
Seat 4: Redkiy787 (75884 in chips) 
Seat 5: zakusxxx (25515 in chips) 
Seat 6: qw303 (44441 in chips) 
Seat 7: wearehere1980 (133573 in chips) 
Seat 8: amigowHurley (56807 in chips) 
Seat 9: TotoJ9 (79401 in chips) 
19bobo76: posts the ante 315
jcarlos.vale: posts the ante 315
xarris_1392: posts the ante 315
Redkiy787: posts the ante 315
zakusxxx: posts the ante 315
qw303: posts the ante 315
wearehere1980: posts the ante 315
amigowHurley: posts the ante 315
TotoJ9: posts the ante 315
wearehere1980: posts small blind 2000
amigowHurley: posts big blind 4000
*** HOLE CARDS ***
Dealt to jcarlos.vale [3c Jh]
TotoJ9: raises 4000 to 8000
19bobo76: folds 
jcarlos.vale: folds 
xarris_1392: folds 
Redkiy787: folds 
zakusxxx: folds 
qw303: folds 
wearehere1980: calls 6000
amigowHurley: raises 48492 to 56492 and is all-in
TotoJ9: folds 
wearehere1980: folds 
Uncalled bet (48492) returned to amigowHurley
amigowHurley collected 26835 from pot
amigowHurley: doesn't show handDTO
*** SUMMARY ***
Total pot 26835 | Rake 0 
Seat 1: 19bobo76 folded before Flop (didn't bet)
Seat 2: jcarlos.vale folded before Flop (didn't bet)
Seat 3: xarris_1392 folded before Flop (didn't bet)
Seat 4: Redkiy787 folded before Flop (didn't bet)
Seat 5: zakusxxx folded before Flop (didn't bet)
Seat 6: qw303 (button) folded before Flop (didn't bet)
Seat 7: wearehere1980 (small blind) folded before Flop
Seat 8: amigowHurley (big blind) collected (26835)
Seat 9: TotoJ9 folded before Flop



PokerStars Hand #222159411113: Tournament #3086083919, $0.49+$0.06 USD Hold'em No Limit - Level XXVI (2000/4000) - 2021/01/03 1:40:09 EET [2021/01/02 18:40:09 ET]
Table '3086083919 111' 9-max Seat #7 is the button
Seat 1: 19bobo76 (65014 in chips) 
Seat 2: jcarlos.vale (93566 in chips) 
Seat 3: xarris_1392 (368462 in chips) 
Seat 4: Redkiy787 (75569 in chips) 
Seat 5: zakusxxx (25200 in chips) 
Seat 6: qw303 (44126 in chips) 
Seat 7: wearehere1980 (125258 in chips) 
Seat 8: amigowHurley (75327 in chips) 
Seat 9: TotoJ9 (71086 in chips) 
19bobo76: posts the ante 315
jcarlos.vale: posts the ante 315
xarris_1392: posts the ante 315
Redkiy787: posts the ante 315
zakusxxx: posts the ante 315
qw303: posts the ante 315
wearehere1980: posts the ante 315
amigowHurley: posts the ante 315
TotoJ9: posts the ante 315
amigowHurley: posts small blind 2000
TotoJ9: posts big blind 4000
*** HOLE CARDS ***
Dealt to jcarlos.vale [Qs 6s]
19bobo76: folds 
jcarlos.vale: folds 
xarris_1392: raises 4000 to 8000
Redkiy787: folds 
zakusxxx: folds 
qw303: folds 
wearehere1980: folds 
amigowHurley: folds 
TotoJ9: folds 
Uncalled bet (4000) returned to xarris_1392
xarris_1392 collected 12835 from pot
xarris_1392: doesn't show handDTO
*** SUMMARY ***
Total pot 12835 | Rake 0 
Seat 1: 19bobo76 folded before Flop (didn't bet)
Seat 2: jcarlos.vale folded before Flop (didn't bet)
Seat 3: xarris_1392 collected (12835)
Seat 4: Redkiy787 folded before Flop (didn't bet)
Seat 5: zakusxxx folded before Flop (didn't bet)
Seat 6: qw303 folded before Flop (didn't bet)
Seat 7: wearehere1980 (button) folded before Flop (didn't bet)
Seat 8: amigowHurley (small blind) folded before Flop
Seat 9: TotoJ9 (big blind) folded before Flop



PokerStars Hand #222159423596: Tournament #3086083919, $0.49+$0.06 USD Hold'em No Limit - Level XXVI (2000/4000) - 2021/01/03 1:40:26 EET [2021/01/02 18:40:26 ET]
Table '3086083919 111' 9-max Seat #8 is the button
Seat 1: 19bobo76 (64699 in chips) 
Seat 2: jcarlos.vale (93251 in chips) 
Seat 3: xarris_1392 (376982 in chips) 
Seat 4: Redkiy787 (75254 in chips) 
Seat 5: zakusxxx (24885 in chips) 
Seat 6: qw303 (43811 in chips) 
Seat 7: wearehere1980 (124943 in chips) 
Seat 8: amigowHurley (73012 in chips) 
Seat 9: TotoJ9 (66771 in chips) 
19bobo76: posts the ante 315
jcarlos.vale: posts the ante 315
xarris_1392: posts the ante 315
Redkiy787: posts the ante 315
zakusxxx: posts the ante 315
qw303: posts the ante 315
wearehere1980: posts the ante 315
amigowHurley: posts the ante 315
TotoJ9: posts the ante 315
TotoJ9: posts small blind 2000
19bobo76: posts big blind 4000
*** HOLE CARDS ***
Dealt to jcarlos.vale [2s Jh]
jcarlos.vale: folds 
xarris_1392: folds 
Redkiy787: folds 
zakusxxx: folds 
qw303: folds 
wearehere1980: folds 
amigowHurley: raises 4000 to 8000
TotoJ9: folds 
19bobo76: calls 4000
*** FLOP *** [Qh 6d Th]
19bobo76: checks 
amigowHurley: bets 20835
19bobo76: folds 
Uncalled bet (20835) returned to amigowHurley
amigowHurley collected 20835 from pot
amigowHurley: doesn't show handDTO
*** SUMMARY ***
Total pot 20835 | Rake 0 
Board [Qh 6d Th]
Seat 1: 19bobo76 (big blind) folded on the Flop
Seat 2: jcarlos.vale folded before Flop (didn't bet)
Seat 3: xarris_1392 folded before Flop (didn't bet)
Seat 4: Redkiy787 folded before Flop (didn't bet)
Seat 5: zakusxxx folded before Flop (didn't bet)
Seat 6: qw303 folded before Flop (didn't bet)
Seat 7: wearehere1980 folded before Flop (didn't bet)
Seat 8: amigowHurley (button) collected (20835)
Seat 9: TotoJ9 (small blind) folded before Flop



PokerStars Hand #222159471844: Tournament #3086083919, $0.49+$0.06 USD Hold'em No Limit - Level XXVI (2000/4000) - 2021/01/03 1:41:33 EET [2021/01/02 18:41:33 ET]
Table '3086083919 111' 9-max Seat #9 is the button
Seat 1: 19bobo76 (56384 in chips) 
Seat 2: jcarlos.vale (92936 in chips) 
Seat 3: xarris_1392 (376667 in chips) 
Seat 4: Redkiy787 (74939 in chips) 
Seat 5: zakusxxx (24570 in chips) 
Seat 6: qw303 (43496 in chips) 
Seat 7: wearehere1980 (124628 in chips) 
Seat 8: amigowHurley (85532 in chips) 
Seat 9: TotoJ9 (64456 in chips) 
19bobo76: posts the ante 315
jcarlos.vale: posts the ante 315
xarris_1392: posts the ante 315
Redkiy787: posts the ante 315
zakusxxx: posts the ante 315
qw303: posts the ante 315
wearehere1980: posts the ante 315
amigowHurley: posts the ante 315
TotoJ9: posts the ante 315
19bobo76: posts small blind 2000
jcarlos.vale: posts big blind 4000
*** HOLE CARDS ***
Dealt to jcarlos.vale [3s 8c]
xarris_1392: folds 
Redkiy787: raises 4000 to 8000
zakusxxx: calls 8000
qw303: folds 
wearehere1980: folds 
amigowHurley: folds 
TotoJ9: folds 
19bobo76: raises 48069 to 56069 and is all-in
jcarlos.vale: folds 
Redkiy787: raises 18555 to 74624 and is all-in
zakusxxx: calls 16255 and is all-in
Uncalled bet (18555) returned to Redkiy787
*** FLOP *** [3c Tc 5h]
*** TURN *** [3c Tc 5h] [6h]
*** RIVER *** [3c Tc 5h 6h] [3h]
*** SHOW DOWN ***
19bobo76: shows [Jh Jc] (two pair, Jacks and Threes)
Redkiy787: shows [Th Td] (a full house, Tens full of Threes)
Redkiy787 collected 63628 from side pot
zakusxxx: shows [Ah 3d] (three of a kind, Threes)
Redkiy787 collected 79600 from main pot
19bobo76 finished the tournament in 122nd place and received $2.43.
zakusxxx finished the tournament in 123rd place and received $2.43.
*** SUMMARY ***
Total pot 143228 Main pot 79600. Side pot 63628. | Rake 0 
Board [3c Tc 5h 6h 3h]
Seat 1: 19bobo76 (small blind) showed [Jh Jc] and lost with two pair, Jacks and Threes
Seat 2: jcarlos.vale (big blind) folded before Flop
Seat 3: xarris_1392 folded before Flop (didn't bet)
Seat 4: Redkiy787 showed [Th Td] and won (143228) with a full house, Tens full of Threes
Seat 5: zakusxxx showed [Ah 3d] and lost with three of a kind, Threes
Seat 6: qw303 folded before Flop (didn't bet)
Seat 7: wearehere1980 folded before Flop (didn't bet)
Seat 8: amigowHurley folded before Flop (didn't bet)
Seat 9: TotoJ9 (button) folded before Flop (didn't bet)



PokerStars Hand #222159499379: Tournament #3086083919, $0.49+$0.06 USD Hold'em No Limit - Level XXVI (2000/4000) - 2021/01/03 1:42:10 EET [2021/01/02 18:42:10 ET]
Table '3086083919 111' 9-max Seat #2 is the button
Seat 2: jcarlos.vale (88621 in chips) 
Seat 3: xarris_1392 (376352 in chips) 
Seat 4: Redkiy787 (161783 in chips) 
Seat 6: qw303 (43181 in chips) 
Seat 7: wearehere1980 (124313 in chips) 
Seat 8: amigowHurley (85217 in chips) 
Seat 9: TotoJ9 (64141 in chips) 
jcarlos.vale: posts the ante 315
xarris_1392: posts the ante 315
Redkiy787: posts the ante 315
qw303: posts the ante 315
wearehere1980: posts the ante 315
amigowHurley: posts the ante 315
TotoJ9: posts the ante 315
xarris_1392: posts small blind 2000
Redkiy787: posts big blind 4000
*** HOLE CARDS ***
Dealt to jcarlos.vale [Jd 9d]
qw303: folds 
wearehere1980: folds 
amigowHurley: folds 
TotoJ9: calls 4000
jcarlos.vale: calls 4000
xarris_1392: calls 2000
Redkiy787: checks 
*** FLOP *** [5h Ah 3s]
xarris_1392: checks 
Redkiy787: checks 
TotoJ9: checks 
jcarlos.vale: checks 
*** TURN *** [5h Ah 3s] [8s]
xarris_1392: bets 8000
Redkiy787: folds 
TotoJ9: folds 
jcarlos.vale: folds 
Uncalled bet (8000) returned to xarris_1392
xarris_1392 collected 18205 from pot
xarris_1392: doesn't show handDTO
*** SUMMARY ***
Total pot 18205 | Rake 0 
Board [5h Ah 3s 8s]
Seat 2: jcarlos.vale (button) folded on the Turn
Seat 3: xarris_1392 (small blind) collected (18205)
Seat 4: Redkiy787 (big blind) folded on the Turn
Seat 6: qw303 folded before Flop (didn't bet)
Seat 7: wearehere1980 folded before Flop (didn't bet)
Seat 8: amigowHurley folded before Flop (didn't bet)
Seat 9: TotoJ9 folded on the Turn



PokerStars Hand #222159537069: Tournament #3086083919, $0.49+$0.06 USD Hold'em No Limit - Level XXVI (2000/4000) - 2021/01/03 1:43:02 EET [2021/01/02 18:43:02 ET]
Table '3086083919 111' 9-max Seat #3 is the button
Seat 2: jcarlos.vale (84306 in chips) 
Seat 3: xarris_1392 (390242 in chips) 
Seat 4: Redkiy787 (157468 in chips) 
Seat 5: andi9103 (50444 in chips) 
Seat 6: qw303 (42866 in chips) 
Seat 7: wearehere1980 (123998 in chips) 
Seat 8: amigowHurley (84902 in chips) 
Seat 9: TotoJ9 (59826 in chips) 
jcarlos.vale: posts the ante 315
xarris_1392: posts the ante 315
Redkiy787: posts the ante 315
andi9103: posts the ante 315
qw303: posts the ante 315
wearehere1980: posts the ante 315
amigowHurley: posts the ante 315
TotoJ9: posts the ante 315
Redkiy787: posts small blind 2000
andi9103: posts big blind 4000
*** HOLE CARDS ***
Dealt to jcarlos.vale [3c 8s]
qw303: folds 
wearehere1980: folds 
amigowHurley: folds 
TotoJ9: calls 4000
jcarlos.vale: folds 
xarris_1392: raises 4000 to 8000
Redkiy787: calls 6000
andi9103: folds 
TotoJ9: calls 4000
*** FLOP *** [8c 5c 9h]
Redkiy787: checks 
TotoJ9: checks 
xarris_1392: checks 
*** TURN *** [8c 5c 9h] [6d]
Redkiy787: checks 
TotoJ9: checks 
xarris_1392: checks 
*** RIVER *** [8c 5c 9h 6d] [Jh]
Redkiy787: checks 
TotoJ9: bets 15260
xarris_1392: folds 
Redkiy787: folds 
Uncalled bet (15260) returned to TotoJ9
TotoJ9 collected 30520 from pot
TotoJ9: doesn't show handDTO
*** SUMMARY ***
Total pot 30520 | Rake 0 
Board [8c 5c 9h 6d Jh]
Seat 2: jcarlos.vale folded before Flop (didn't bet)
Seat 3: xarris_1392 (button) folded on the River
Seat 4: Redkiy787 (small blind) folded on the River
Seat 5: andi9103 (big blind) folded before Flop
Seat 6: qw303 folded before Flop (didn't bet)
Seat 7: wearehere1980 folded before Flop (didn't bet)
Seat 8: amigowHurley folded before Flop (didn't bet)
Seat 9: TotoJ9 collected (30520)



PokerStars Hand #222159593563: Tournament #3086083919, $0.49+$0.06 USD Hold'em No Limit - Level XXVI (2000/4000) - 2021/01/03 1:44:21 EET [2021/01/02 18:44:21 ET]
Table '3086083919 111' 9-max Seat #4 is the button
Seat 2: jcarlos.vale (83991 in chips) 
Seat 3: xarris_1392 (381927 in chips) 
Seat 4: Redkiy787 (149153 in chips) 
Seat 5: andi9103 (46129 in chips) 
Seat 6: qw303 (42551 in chips) 
Seat 7: wearehere1980 (123683 in chips) 
Seat 8: amigowHurley (84587 in chips) 
Seat 9: TotoJ9 (82031 in chips) 
jcarlos.vale: posts the ante 315
xarris_1392: posts the ante 315
Redkiy787: posts the ante 315
andi9103: posts the ante 315
qw303: posts the ante 315
wearehere1980: posts the ante 315
amigowHurley: posts the ante 315
TotoJ9: posts the ante 315
andi9103: posts small blind 2000
qw303: posts big blind 4000
*** HOLE CARDS ***
Dealt to jcarlos.vale [Qd Qc]
wearehere1980: calls 4000
amigowHurley: folds 
TotoJ9: raises 8000 to 12000
jcarlos.vale: raises 71676 to 83676 and is all-in
xarris_1392: folds 
Redkiy787: folds 
andi9103: folds 
qw303: folds 
wearehere1980: folds 
TotoJ9: calls 69716 and is all-in
Uncalled bet (1960) returned to jcarlos.vale
*** FLOP *** [Ah Jh Js]
*** TURN *** [Ah Jh Js] [Kd]
*** RIVER *** [Ah Jh Js Kd] [9s]
*** SHOW DOWN ***
TotoJ9: shows [Kc Kh] (a full house, Kings full of Jacks)
jcarlos.vale: shows [Qd Qc] (two pair, Queens and Jacks)
TotoJ9 collected 175952 from pot
*** SUMMARY ***
Total pot 175952 | Rake 0 
Board [Ah Jh Js Kd 9s]
Seat 2: jcarlos.vale showed [Qd Qc] and lost with two pair, Queens and Jacks
Seat 3: xarris_1392 folded before Flop (didn't bet)
Seat 4: Redkiy787 (button) folded before Flop (didn't bet)
Seat 5: andi9103 (small blind) folded before Flop
Seat 6: qw303 (big blind) folded before Flop
Seat 7: wearehere1980 folded before Flop
Seat 8: amigowHurley folded before Flop (didn't bet)
Seat 9: TotoJ9 showed [Kc Kh] and won (175952) with a full house, Kings full of Jacks



PokerStars Hand #222159627204: Tournament #3086083919, $0.49+$0.06 USD Hold'em No Limit - Level XXVI (2000/4000) - 2021/01/03 1:45:08 EET [2021/01/02 18:45:08 ET]
Table '3086083919 111' 9-max Seat #5 is the button
Seat 1: BetterMySelf (239831 in chips) 
Seat 2: jcarlos.vale (1960 in chips) 
Seat 3: xarris_1392 (381612 in chips) 
Seat 4: Redkiy787 (148838 in chips) 
Seat 5: andi9103 (43814 in chips) 
Seat 6: qw303 (38236 in chips) 
Seat 7: wearehere1980 (119368 in chips) 
Seat 8: amigowHurley (84272 in chips) 
Seat 9: TotoJ9 (175952 in chips) 
BetterMySelf: posts the ante 315
jcarlos.vale: posts the ante 315
xarris_1392: posts the ante 315
Redkiy787: posts the ante 315
andi9103: posts the ante 315
qw303: posts the ante 315
wearehere1980: posts the ante 315
amigowHurley: posts the ante 315
TotoJ9: posts the ante 315
qw303: posts small blind 2000
wearehere1980: posts big blind 4000
*** HOLE CARDS ***
Dealt to jcarlos.vale [Ac 3h]
amigowHurley: folds 
TotoJ9: folds 
BetterMySelf: folds 
jcarlos.vale: calls 1645 and is all-in
xarris_1392: raises 4000 to 8000
Redkiy787: folds 
andi9103: folds 
qw303: folds 
wearehere1980: folds 
Uncalled bet (4000) returned to xarris_1392
*** FLOP *** [Jh 6d 9h]
*** TURN *** [Jh 6d 9h] [Th]
*** RIVER *** [Jh 6d 9h Th] [2h]
*** SHOW DOWN ***
xarris_1392: shows [8d Ad] (high pairOfCards Ace)
xarris_1392 collected 5065 from side pot
jcarlos.vale: shows [Ac 3h] (a flush, Jack high)
jcarlos.vale collected 9415 from main pot
*** SUMMARY ***
Total pot 14480 Main pot 9415. Side pot 5065. | Rake 0 
Board [Jh 6d 9h Th 2h]
Seat 1: BetterMySelf folded before Flop (didn't bet)
Seat 2: jcarlos.vale showed [Ac 3h] and won (9415) with a flush, Jack high
Seat 3: xarris_1392 showed [8d Ad] and won (5065) with high pairOfCards Ace
Seat 4: Redkiy787 folded before Flop (didn't bet)
Seat 5: andi9103 (button) folded before Flop (didn't bet)
Seat 6: qw303 (small blind) folded before Flop
Seat 7: wearehere1980 (big blind) folded before Flop
Seat 8: amigowHurley folded before Flop (didn't bet)
Seat 9: TotoJ9 folded before Flop (didn't bet)



PokerStars Hand #222159652748: Tournament #3086083919, $0.49+$0.06 USD Hold'em No Limit - Level XXVI (2000/4000) - 2021/01/03 1:45:44 EET [2021/01/02 18:45:44 ET]
Table '3086083919 111' 9-max Seat #6 is the button
Seat 1: BetterMySelf (239516 in chips) 
Seat 2: jcarlos.vale (9415 in chips) 
Seat 3: xarris_1392 (382362 in chips) 
Seat 4: Redkiy787 (148523 in chips) 
Seat 5: andi9103 (43499 in chips) 
Seat 6: qw303 (35921 in chips) 
Seat 7: wearehere1980 (115053 in chips) 
Seat 8: amigowHurley (83957 in chips) 
Seat 9: TotoJ9 (175637 in chips) 
BetterMySelf: posts the ante 315
jcarlos.vale: posts the ante 315
xarris_1392: posts the ante 315
Redkiy787: posts the ante 315
andi9103: posts the ante 315
qw303: posts the ante 315
wearehere1980: posts the ante 315
amigowHurley: posts the ante 315
TotoJ9: posts the ante 315
wearehere1980: posts small blind 2000
amigowHurley: posts big blind 4000
*** HOLE CARDS ***
Dealt to jcarlos.vale [8h 9c]
TotoJ9: folds 
BetterMySelf: folds 
jcarlos.vale: folds 
xarris_1392: folds 
Redkiy787: raises 4000 to 8000
andi9103: folds 
qw303: folds 
wearehere1980: folds 
amigowHurley: calls 4000
*** FLOP *** [Jd 2h 3c]
amigowHurley: checks 
Redkiy787: bets 14417
amigowHurley: folds 
Uncalled bet (14417) returned to Redkiy787
Redkiy787 collected 20835 from pot
Redkiy787: doesn't show handDTO
*** SUMMARY ***
Total pot 20835 | Rake 0 
Board [Jd 2h 3c]
Seat 1: BetterMySelf folded before Flop (didn't bet)
Seat 2: jcarlos.vale folded before Flop (didn't bet)
Seat 3: xarris_1392 folded before Flop (didn't bet)
Seat 4: Redkiy787 collected (20835)
Seat 5: andi9103 folded before Flop (didn't bet)
Seat 6: qw303 (button) folded before Flop (didn't bet)
Seat 7: wearehere1980 (small blind) folded before Flop
Seat 8: amigowHurley (big blind) folded on the Flop
Seat 9: TotoJ9 folded before Flop (didn't bet)



PokerStars Hand #222159678064: Tournament #3086083919, $0.49+$0.06 USD Hold'em No Limit - Level XXVI (2000/4000) - 2021/01/03 1:46:19 EET [2021/01/02 18:46:19 ET]
Table '3086083919 111' 9-max Seat #7 is the button
Seat 1: BetterMySelf (239201 in chips) 
Seat 2: jcarlos.vale (9100 in chips) 
Seat 3: xarris_1392 (382047 in chips) 
Seat 4: Redkiy787 (161043 in chips) 
Seat 5: andi9103 (43184 in chips) 
Seat 6: qw303 (35606 in chips) 
Seat 7: wearehere1980 (112738 in chips) 
Seat 8: amigowHurley (75642 in chips) 
Seat 9: TotoJ9 (175322 in chips) 
BetterMySelf: posts the ante 315
jcarlos.vale: posts the ante 315
xarris_1392: posts the ante 315
Redkiy787: posts the ante 315
andi9103: posts the ante 315
qw303: posts the ante 315
wearehere1980: posts the ante 315
amigowHurley: posts the ante 315
TotoJ9: posts the ante 315
amigowHurley: posts small blind 2000
TotoJ9: posts big blind 4000
*** HOLE CARDS ***
Dealt to jcarlos.vale [6d Kh]
BetterMySelf: raises 6000 to 10000
jcarlos.vale: folds 
xarris_1392: folds 
Redkiy787: folds 
andi9103: folds 
qw303: folds 
wearehere1980: calls 10000
amigowHurley: folds 
TotoJ9: calls 6000
*** FLOP *** [Ah 5s Js]
TotoJ9: checks 
BetterMySelf: checks 
wearehere1980: bets 17417
TotoJ9: folds 
BetterMySelf: folds 
Uncalled bet (17417) returned to wearehere1980
wearehere1980 collected 34835 from pot
wearehere1980: doesn't show handDTO
*** SUMMARY ***
Total pot 34835 | Rake 0 
Board [Ah 5s Js]
Seat 1: BetterMySelf folded on the Flop
Seat 2: jcarlos.vale folded before Flop (didn't bet)
Seat 3: xarris_1392 folded before Flop (didn't bet)
Seat 4: Redkiy787 folded before Flop (didn't bet)
Seat 5: andi9103 folded before Flop (didn't bet)
Seat 6: qw303 folded before Flop (didn't bet)
Seat 7: wearehere1980 (button) collected (34835)
Seat 8: amigowHurley (small blind) folded before Flop
Seat 9: TotoJ9 (big blind) folded on the Flop



PokerStars Hand #222159703075: Tournament #3086083919, $0.49+$0.06 USD Hold'em No Limit - Level XXVI (2000/4000) - 2021/01/03 1:46:55 EET [2021/01/02 18:46:55 ET]
Table '3086083919 111' 9-max Seat #8 is the button
Seat 1: BetterMySelf (228886 in chips) 
Seat 2: jcarlos.vale (8785 in chips) 
Seat 3: xarris_1392 (381732 in chips) 
Seat 4: Redkiy787 (160728 in chips) 
Seat 5: andi9103 (42869 in chips) 
Seat 6: qw303 (35291 in chips) 
Seat 7: wearehere1980 (137258 in chips) 
Seat 8: amigowHurley (73327 in chips) 
Seat 9: TotoJ9 (165007 in chips) 
BetterMySelf: posts the ante 315
jcarlos.vale: posts the ante 315
xarris_1392: posts the ante 315
Redkiy787: posts the ante 315
andi9103: posts the ante 315
qw303: posts the ante 315
wearehere1980: posts the ante 315
amigowHurley: posts the ante 315
TotoJ9: posts the ante 315
TotoJ9: posts small blind 2000
BetterMySelf: posts big blind 4000
*** HOLE CARDS ***
Dealt to jcarlos.vale [5d Qc]
jcarlos.vale: folds 
xarris_1392: folds 
Redkiy787: folds 
andi9103: folds 
qw303: folds 
wearehere1980: calls 4000
amigowHurley: folds 
TotoJ9: folds 
BetterMySelf: checks 
*** FLOP *** [Qh Jh 9h]
BetterMySelf: bets 4000
wearehere1980: calls 4000
*** TURN *** [Qh Jh 9h] [Kc]
BetterMySelf: bets 5625
wearehere1980: calls 5625
*** RIVER *** [Qh Jh 9h Kc] [4h]
BetterMySelf: bets 8663
wearehere1980: folds 
Uncalled bet (8663) returned to BetterMySelf
BetterMySelf collected 32085 from pot
*** SUMMARY ***
Total pot 32085 | Rake 0 
Board [Qh Jh 9h Kc 4h]
Seat 1: BetterMySelf (big blind) collected (32085)
Seat 2: jcarlos.vale folded before Flop (didn't bet)
Seat 3: xarris_1392 folded before Flop (didn't bet)
Seat 4: Redkiy787 folded before Flop (didn't bet)
Seat 5: andi9103 folded before Flop (didn't bet)
Seat 6: qw303 folded before Flop (didn't bet)
Seat 7: wearehere1980 folded on the River
Seat 8: amigowHurley (button) folded before Flop (didn't bet)
Seat 9: TotoJ9 (small blind) folded before Flop



PokerStars Hand #222159747275: Tournament #3086083919, $0.49+$0.06 USD Hold'em No Limit - Level XXVII (2500/5000) - 2021/01/03 1:47:55 EET [2021/01/02 18:47:55 ET]
Table '3086083919 111' 9-max Seat #9 is the button
Seat 1: BetterMySelf (247031 in chips) 
Seat 2: jcarlos.vale (8470 in chips) 
Seat 3: xarris_1392 (381417 in chips) 
Seat 4: Redkiy787 (160413 in chips) 
Seat 5: andi9103 (42554 in chips) 
Seat 6: qw303 (34976 in chips) 
Seat 7: wearehere1980 (123318 in chips) 
Seat 8: amigowHurley (73012 in chips) 
Seat 9: TotoJ9 (162692 in chips) 
BetterMySelf: posts the ante 375
jcarlos.vale: posts the ante 375
xarris_1392: posts the ante 375
Redkiy787: posts the ante 375
andi9103: posts the ante 375
qw303: posts the ante 375
wearehere1980: posts the ante 375
amigowHurley: posts the ante 375
TotoJ9: posts the ante 375
BetterMySelf: posts small blind 2500
jcarlos.vale: posts big blind 5000
*** HOLE CARDS ***
Dealt to jcarlos.vale [8c 4c]
xarris_1392: folds 
Redkiy787: folds 
andi9103: folds 
qw303: folds 
wearehere1980: folds 
amigowHurley: folds 
TotoJ9: folds 
BetterMySelf: raises 12500 to 17500
jcarlos.vale: calls 3095 and is all-in
Uncalled bet (9405) returned to BetterMySelf
*** FLOP *** [3d 9s 6c]
*** TURN *** [3d 9s 6c] [3h]
*** RIVER *** [3d 9s 6c 3h] [Qd]
*** SHOW DOWN ***
BetterMySelf: shows [Jh Kc] (a pair of Threes)
jcarlos.vale: shows [8c 4c] (a pair of Threes - lower kicker)
BetterMySelf collected 19565 from pot
jcarlos.vale finished the tournament in 114th place and received $2.43.
*** SUMMARY ***
Total pot 19565 | Rake 0 
Board [3d 9s 6c 3h Qd]
Seat 1: BetterMySelf (small blind) showed [Jh Kc] and won (19565) with a pair of Threes
Seat 2: jcarlos.vale (big blind) showed [8c 4c] and lost with a pair of Threes
Seat 3: xarris_1392 folded before Flop (didn't bet)
Seat 4: Redkiy787 folded before Flop (didn't bet)
Seat 5: andi9103 folded before Flop (didn't bet)
Seat 6: qw303 folded before Flop (didn't bet)
Seat 7: wearehere1980 folded before Flop (didn't bet)
Seat 8: amigowHurley folded before Flop (didn't bet)
Seat 9: TotoJ9 (button) folded before Flop (didn't bet)



