PokerStars Hand #222096701498: Tournament #3082583698, $0.98+$0.12 USD Hold'em No Limit - Level I (15/30) - 2021/01/01 20:00:15 EET [2021/01/01 13:00:15 ET]
Table '3082583698 30' 9-max Seat #1 is the button
Seat 1: marquitopoker4 (5000 in chips) 
Seat 2: Lokobarys Ninja (5000 in chips) 
Seat 3: 4RING8 (5000 in chips) 
Seat 4: jcarlos.vale (5000 in chips) 
Seat 5: RCABelVedeRVerd (5000 in chips) is sitting out
Seat 6: Mimishka004 (5000 in chips) 
Seat 7: kalimero1848 (5000 in chips) 
Seat 8: 84nurik84 (5000 in chips) 
Seat 9: ScheminVirgo (5000 in chips) 
marquitopoker4: posts the ante 4
Lokobarys Ninja: posts the ante 4
4RING8: posts the ante 4
jcarlos.vale: posts the ante 4
RCABelVedeRVerd: posts the ante 4
Mimishka004: posts the ante 4
kalimero1848: posts the ante 4
84nurik84: posts the ante 4
ScheminVirgo: posts the ante 4
Lokobarys Ninja: posts small blind 15
4RING8: posts big blind 30
*** HOLE CARDS ***
Dealt to jcarlos.vale [2d Qd]
RCABelVedeRVerd has returned
jcarlos.vale: folds 
RCABelVedeRVerd: raises 30 to 60
Mimishka004: folds 
kalimero1848: folds 
84nurik84: raises 120 to 180
ScheminVirgo: folds 
marquitopoker4: folds 
Lokobarys Ninja: folds 
4RING8: folds 
RCABelVedeRVerd: raises 4816 to 4996 and is all-in
84nurik84: folds 
Uncalled bet (4816) returned to RCABelVedeRVerd
RCABelVedeRVerd collected 441 from pot
*** SUMMARY ***
Total pot 441 | Rake 0 
Seat 1: marquitopoker4 (button) folded before Flop (didn't bet)
Seat 2: Lokobarys Ninja (small blind) folded before Flop
Seat 3: 4RING8 (big blind) folded before Flop
Seat 4: jcarlos.vale folded before Flop (didn't bet)
Seat 5: RCABelVedeRVerd collected (441)
Seat 6: Mimishka004 folded before Flop (didn't bet)
Seat 7: kalimero1848 folded before Flop (didn't bet)
Seat 8: 84nurik84 folded before Flop
Seat 9: ScheminVirgo folded before Flop (didn't bet)



PokerStars Hand #222096739362: Tournament #3082583698, $0.98+$0.12 USD Hold'em No Limit - Level I (15/30) - 2021/01/01 20:01:38 EET [2021/01/01 13:01:38 ET]
Table '3082583698 30' 9-max Seat #2 is the button
Seat 1: marquitopoker4 (4996 in chips) 
Seat 2: Lokobarys Ninja (4981 in chips) 
Seat 3: 4RING8 (4966 in chips) 
Seat 4: jcarlos.vale (4996 in chips) 
Seat 5: RCABelVedeRVerd (5257 in chips) 
Seat 6: Mimishka004 (4996 in chips) 
Seat 7: kalimero1848 (4996 in chips) 
Seat 8: 84nurik84 (4816 in chips) 
Seat 9: ScheminVirgo (4996 in chips) 
marquitopoker4: posts the ante 4
Lokobarys Ninja: posts the ante 4
4RING8: posts the ante 4
jcarlos.vale: posts the ante 4
RCABelVedeRVerd: posts the ante 4
Mimishka004: posts the ante 4
kalimero1848: posts the ante 4
84nurik84: posts the ante 4
ScheminVirgo: posts the ante 4
4RING8: posts small blind 15
jcarlos.vale: posts big blind 30
*** HOLE CARDS ***
Dealt to jcarlos.vale [Kc 6c]
RCABelVedeRVerd: calls 30
Mimishka004: raises 60 to 90
kalimero1848: folds 
84nurik84: folds 
ScheminVirgo: folds 
marquitopoker4: folds 
Lokobarys Ninja: folds 
4RING8: folds 
jcarlos.vale: folds 
RCABelVedeRVerd: calls 60
*** FLOP *** [7c 5d 7d]
RCABelVedeRVerd: checks 
Mimishka004: bets 75
RCABelVedeRVerd: calls 75
*** TURN *** [7c 5d 7d] [Tc]
RCABelVedeRVerd: checks 
Mimishka004: bets 136
RCABelVedeRVerd: calls 136
*** RIVER *** [7c 5d 7d Tc] [3d]
RCABelVedeRVerd: checks 
Mimishka004: bets 225
RCABelVedeRVerd: raises 4727 to 4952 and is all-in
Mimishka004: folds [Ac Ad]
Uncalled bet (4727) returned to RCABelVedeRVerd
RCABelVedeRVerd collected 1133 from pot
*** SUMMARY ***
Total pot 1133 | Rake 0 
Board [7c 5d 7d Tc 3d]
Seat 1: marquitopoker4 folded before Flop (didn't bet)
Seat 2: Lokobarys Ninja (button) folded before Flop (didn't bet)
Seat 3: 4RING8 (small blind) folded before Flop
Seat 4: jcarlos.vale (big blind) folded before Flop
Seat 5: RCABelVedeRVerd collected (1133)
Seat 6: Mimishka004 folded on the River
Seat 7: kalimero1848 folded before Flop (didn't bet)
Seat 8: 84nurik84 folded before Flop (didn't bet)
Seat 9: ScheminVirgo folded before Flop (didn't bet)



PokerStars Hand #222096806668: Tournament #3082583698, $0.98+$0.12 USD Hold'em No Limit - Level I (15/30) - 2021/01/01 20:03:40 EET [2021/01/01 13:03:40 ET]
Table '3082583698 30' 9-max Seat #3 is the button
Seat 1: marquitopoker4 (4992 in chips) 
Seat 2: Lokobarys Ninja (4977 in chips) 
Seat 3: 4RING8 (4947 in chips) 
Seat 4: jcarlos.vale (4962 in chips) 
Seat 5: RCABelVedeRVerd (5860 in chips) 
Seat 6: Mimishka004 (4466 in chips) 
Seat 7: kalimero1848 (4992 in chips) 
Seat 8: 84nurik84 (4812 in chips) 
Seat 9: ScheminVirgo (4992 in chips) 
marquitopoker4: posts the ante 4
Lokobarys Ninja: posts the ante 4
4RING8: posts the ante 4
jcarlos.vale: posts the ante 4
RCABelVedeRVerd: posts the ante 4
Mimishka004: posts the ante 4
kalimero1848: posts the ante 4
84nurik84: posts the ante 4
ScheminVirgo: posts the ante 4
jcarlos.vale: posts small blind 15
RCABelVedeRVerd: posts big blind 30
*** HOLE CARDS ***
Dealt to jcarlos.vale [Kh 9s]
Mimishka004: folds 
kalimero1848: folds 
84nurik84: folds 
ScheminVirgo: raises 45 to 75
marquitopoker4: folds 
Lokobarys Ninja: folds 
4RING8: calls 75
jcarlos.vale: folds 
RCABelVedeRVerd: calls 45
*** FLOP *** [Jd 8s Kc]
RCABelVedeRVerd said, "sorry"
RCABelVedeRVerd: checks 
ScheminVirgo: bets 110
4RING8: folds 
RCABelVedeRVerd: calls 110
*** TURN *** [Jd 8s Kc] [Qs]
RCABelVedeRVerd: checks 
ScheminVirgo: bets 198
RCABelVedeRVerd: folds 
Uncalled bet (198) returned to ScheminVirgo
ScheminVirgo collected 496 from pot
ScheminVirgo: doesn't show hand 
*** SUMMARY ***
Total pot 496 | Rake 0 
Board [Jd 8s Kc Qs]
Seat 1: marquitopoker4 folded before Flop (didn't bet)
Seat 2: Lokobarys Ninja folded before Flop (didn't bet)
Seat 3: 4RING8 (button) folded on the Flop
Seat 4: jcarlos.vale (small blind) folded before Flop
Seat 5: RCABelVedeRVerd (big blind) folded on the Turn
Seat 6: Mimishka004 folded before Flop (didn't bet)
Seat 7: kalimero1848 folded before Flop (didn't bet)
Seat 8: 84nurik84 folded before Flop (didn't bet)
Seat 9: ScheminVirgo collected (496)



PokerStars Hand #222096848754: Tournament #3082583698, $0.98+$0.12 USD Hold'em No Limit - Level I (15/30) - 2021/01/01 20:04:55 EET [2021/01/01 13:04:55 ET]
Table '3082583698 30' 9-max Seat #4 is the button
Seat 1: marquitopoker4 (4988 in chips) 
Seat 2: Lokobarys Ninja (4973 in chips) 
Seat 3: 4RING8 (4868 in chips) 
Seat 4: jcarlos.vale (4943 in chips) 
Seat 5: RCABelVedeRVerd (5671 in chips) 
Seat 6: Mimishka004 (4462 in chips) 
Seat 7: kalimero1848 (4988 in chips) 
Seat 8: 84nurik84 (4808 in chips) 
Seat 9: ScheminVirgo (5299 in chips) 
marquitopoker4: posts the ante 4
Lokobarys Ninja: posts the ante 4
4RING8: posts the ante 4
jcarlos.vale: posts the ante 4
RCABelVedeRVerd: posts the ante 4
Mimishka004: posts the ante 4
kalimero1848: posts the ante 4
84nurik84: posts the ante 4
ScheminVirgo: posts the ante 4
RCABelVedeRVerd: posts small blind 15
Mimishka004: posts big blind 30
*** HOLE CARDS ***
Dealt to jcarlos.vale [4s 8d]
kalimero1848: folds 
84nurik84: folds 
ScheminVirgo: raises 45 to 75
marquitopoker4: folds 
Lokobarys Ninja: folds 
4RING8: folds 
jcarlos.vale: folds 
RCABelVedeRVerd: calls 60
Mimishka004: folds 
*** FLOP *** [Qs Jd 5s]
RCABelVedeRVerd: checks 
ScheminVirgo: bets 86
RCABelVedeRVerd: calls 86
*** TURN *** [Qs Jd 5s] [Th]
RCABelVedeRVerd: checks 
ScheminVirgo: bets 155
RCABelVedeRVerd: calls 155
*** RIVER *** [Qs Jd 5s Th] [5h]
RCABelVedeRVerd: checks 
ScheminVirgo: checks 
*** SHOW DOWN ***
RCABelVedeRVerd: shows [Jh 8h] (two pair, Jacks and Fives)
ScheminVirgo: shows [Ad Js] (two pair, Jacks and Fives - Ace kicker)
ScheminVirgo collected 698 from pot
*** SUMMARY ***
Total pot 698 | Rake 0 
Board [Qs Jd 5s Th 5h]
Seat 1: marquitopoker4 folded before Flop (didn't bet)
Seat 2: Lokobarys Ninja folded before Flop (didn't bet)
Seat 3: 4RING8 folded before Flop (didn't bet)
Seat 4: jcarlos.vale (button) folded before Flop (didn't bet)
Seat 5: RCABelVedeRVerd (small blind) showed [Jh 8h] and lost with two pair, Jacks and Fives
Seat 6: Mimishka004 (big blind) folded before Flop
Seat 7: kalimero1848 folded before Flop (didn't bet)
Seat 8: 84nurik84 folded before Flop (didn't bet)
Seat 9: ScheminVirgo showed [Ad Js] and won (698) with two pair, Jacks and Fives



PokerStars Hand #222096885929: Tournament #3082583698, $0.98+$0.12 USD Hold'em No Limit - Level I (15/30) - 2021/01/01 20:06:03 EET [2021/01/01 13:06:03 ET]
Table '3082583698 30' 9-max Seat #5 is the button
Seat 1: marquitopoker4 (4984 in chips) 
Seat 2: Lokobarys Ninja (4969 in chips) 
Seat 3: 4RING8 (4864 in chips) 
Seat 4: jcarlos.vale (4939 in chips) 
Seat 5: RCABelVedeRVerd (5351 in chips) 
Seat 6: Mimishka004 (4428 in chips) 
Seat 7: kalimero1848 (4984 in chips) 
Seat 8: 84nurik84 (4804 in chips) 
Seat 9: ScheminVirgo (5677 in chips) 
marquitopoker4: posts the ante 4
Lokobarys Ninja: posts the ante 4
4RING8: posts the ante 4
jcarlos.vale: posts the ante 4
RCABelVedeRVerd: posts the ante 4
Mimishka004: posts the ante 4
kalimero1848: posts the ante 4
84nurik84: posts the ante 4
ScheminVirgo: posts the ante 4
Mimishka004: posts small blind 15
kalimero1848: posts big blind 30
*** HOLE CARDS ***
Dealt to jcarlos.vale [Th Qc]
84nurik84: folds 
ScheminVirgo: folds 
marquitopoker4: folds 
Lokobarys Ninja: folds 
4RING8: folds 
jcarlos.vale: folds 
RCABelVedeRVerd: raises 60 to 90
Mimishka004: folds 
kalimero1848: calls 60
*** FLOP *** [Ad 2d 7c]
kalimero1848: bets 115
RCABelVedeRVerd: folds 
Uncalled bet (115) returned to kalimero1848
kalimero1848 collected 231 from pot
kalimero1848: doesn't show hand 
*** SUMMARY ***
Total pot 231 | Rake 0 
Board [Ad 2d 7c]
Seat 1: marquitopoker4 folded before Flop (didn't bet)
Seat 2: Lokobarys Ninja folded before Flop (didn't bet)
Seat 3: 4RING8 folded before Flop (didn't bet)
Seat 4: jcarlos.vale folded before Flop (didn't bet)
Seat 5: RCABelVedeRVerd (button) folded on the Flop
Seat 6: Mimishka004 (small blind) folded before Flop
Seat 7: kalimero1848 (big blind) collected (231)
Seat 8: 84nurik84 folded before Flop (didn't bet)
Seat 9: ScheminVirgo folded before Flop (didn't bet)



PokerStars Hand #222096926966: Tournament #3082583698, $0.98+$0.12 USD Hold'em No Limit - Level I (15/30) - 2021/01/01 20:07:30 EET [2021/01/01 13:07:30 ET]
Table '3082583698 30' 9-max Seat #6 is the button
Seat 1: marquitopoker4 (4980 in chips) 
Seat 2: Lokobarys Ninja (4965 in chips) 
Seat 3: 4RING8 (4860 in chips) 
Seat 4: jcarlos.vale (4935 in chips) 
Seat 5: RCABelVedeRVerd (5257 in chips) 
Seat 6: Mimishka004 (4409 in chips) 
Seat 7: kalimero1848 (5121 in chips) 
Seat 8: 84nurik84 (4800 in chips) 
Seat 9: ScheminVirgo (5673 in chips) 
marquitopoker4: posts the ante 4
Lokobarys Ninja: posts the ante 4
4RING8: posts the ante 4
jcarlos.vale: posts the ante 4
RCABelVedeRVerd: posts the ante 4
Mimishka004: posts the ante 4
kalimero1848: posts the ante 4
84nurik84: posts the ante 4
ScheminVirgo: posts the ante 4
kalimero1848: posts small blind 15
84nurik84: posts big blind 30
*** HOLE CARDS ***
Dealt to jcarlos.vale [3h 5d]
ScheminVirgo: folds 
marquitopoker4: folds 
Lokobarys Ninja: folds 
4RING8: folds 
jcarlos.vale: folds 
RCABelVedeRVerd: folds 
Mimishka004: raises 31 to 61
kalimero1848: calls 46
84nurik84: calls 31
*** FLOP *** [Kc 2h 6c]
kalimero1848: checks 
84nurik84: checks 
Mimishka004: bets 72
kalimero1848: calls 72
84nurik84: folds 
*** TURN *** [Kc 2h 6c] [2d]
kalimero1848: checks 
Mimishka004: bets 135
kalimero1848: folds 
Uncalled bet (135) returned to Mimishka004
Mimishka004 collected 363 from pot
*** SUMMARY ***
Total pot 363 | Rake 0 
Board [Kc 2h 6c 2d]
Seat 1: marquitopoker4 folded before Flop (didn't bet)
Seat 2: Lokobarys Ninja folded before Flop (didn't bet)
Seat 3: 4RING8 folded before Flop (didn't bet)
Seat 4: jcarlos.vale folded before Flop (didn't bet)
Seat 5: RCABelVedeRVerd folded before Flop (didn't bet)
Seat 6: Mimishka004 (button) collected (363)
Seat 7: kalimero1848 (small blind) folded on the Turn
Seat 8: 84nurik84 (big blind) folded on the Flop
Seat 9: ScheminVirgo folded before Flop (didn't bet)



PokerStars Hand #222096960769: Tournament #3082583698, $0.98+$0.12 USD Hold'em No Limit - Level I (15/30) - 2021/01/01 20:08:33 EET [2021/01/01 13:08:33 ET]
Table '3082583698 30' 9-max Seat #7 is the button
Seat 1: marquitopoker4 (4976 in chips) 
Seat 2: Lokobarys Ninja (4961 in chips) 
Seat 3: 4RING8 (4856 in chips) 
Seat 4: jcarlos.vale (4931 in chips) 
Seat 5: RCABelVedeRVerd (5253 in chips) 
Seat 6: Mimishka004 (4635 in chips) 
Seat 7: kalimero1848 (4984 in chips) 
Seat 8: 84nurik84 (4735 in chips) 
marquitopoker4: posts the ante 4
Lokobarys Ninja: posts the ante 4
4RING8: posts the ante 4
jcarlos.vale: posts the ante 4
RCABelVedeRVerd: posts the ante 4
Mimishka004: posts the ante 4
kalimero1848: posts the ante 4
84nurik84: posts the ante 4
84nurik84: posts small blind 15
marquitopoker4: posts big blind 30
*** HOLE CARDS ***
Dealt to jcarlos.vale [9h Jc]
Lokobarys Ninja: folds 
4RING8: folds 
jcarlos.vale: folds 
jcarlos.vale is sitting out
RCABelVedeRVerd is disconnected 
RCABelVedeRVerd has timed out while disconnected
RCABelVedeRVerd: folds 
RCABelVedeRVerd is sitting out
Mimishka004: folds 
kalimero1848: folds 
84nurik84: folds 
Uncalled bet (15) returned to marquitopoker4
marquitopoker4 collected 62 from pot
marquitopoker4: doesn't show hand 
*** SUMMARY ***
Total pot 62 | Rake 0 
Seat 1: marquitopoker4 (big blind) collected (62)
Seat 2: Lokobarys Ninja folded before Flop (didn't bet)
Seat 3: 4RING8 folded before Flop (didn't bet)
Seat 4: jcarlos.vale folded before Flop (didn't bet)
Seat 5: RCABelVedeRVerd folded before Flop (didn't bet)
Seat 6: Mimishka004 folded before Flop (didn't bet)
Seat 7: kalimero1848 (button) folded before Flop (didn't bet)
Seat 8: 84nurik84 (small blind) folded before Flop



PokerStars Hand #222097000852: Tournament #3082583698, $0.98+$0.12 USD Hold'em No Limit - Level I (15/30) - 2021/01/01 20:09:48 EET [2021/01/01 13:09:48 ET]
Table '3082583698 30' 9-max Seat #8 is the button
Seat 1: marquitopoker4 (5019 in chips) 
Seat 2: Lokobarys Ninja (4957 in chips) 
Seat 3: 4RING8 (4852 in chips) 
Seat 4: jcarlos.vale (4927 in chips) is sitting out
Seat 5: RCABelVedeRVerd (5249 in chips) is sitting out
Seat 6: Mimishka004 (4631 in chips) 
Seat 7: kalimero1848 (4980 in chips) 
Seat 8: 84nurik84 (4716 in chips) 
Seat 9: 48621537590 (5000 in chips) out of hand (moved from another table into small blind)
48621537590 will be allowed to play after the button
marquitopoker4: posts the ante 4
Lokobarys Ninja: posts the ante 4
4RING8: posts the ante 4
jcarlos.vale: posts the ante 4
RCABelVedeRVerd: posts the ante 4
Mimishka004: posts the ante 4
kalimero1848: posts the ante 4
84nurik84: posts the ante 4
marquitopoker4: posts small blind 15
Lokobarys Ninja: posts big blind 30
*** HOLE CARDS ***
Dealt to jcarlos.vale [5h Ah]
4RING8: raises 35 to 65
jcarlos.vale: folds 
RCABelVedeRVerd: folds 
Mimishka004: folds 
kalimero1848: folds 
84nurik84: calls 65
marquitopoker4: folds 
Lokobarys Ninja: calls 35
*** FLOP *** [Kc Kh Td]
Lokobarys Ninja: checks 
4RING8: checks 
84nurik84: checks 
*** TURN *** [Kc Kh Td] [Jd]
jcarlos.vale has returned
Lokobarys Ninja: bets 60
4RING8: calls 60
84nurik84: calls 60
*** RIVER *** [Kc Kh Td Jd] [5c]
Lokobarys Ninja has timed out
Lokobarys Ninja: checks 
4RING8: checks 
84nurik84: checks 
*** SHOW DOWN ***
Lokobarys Ninja: shows [Jh 9h] (two pair, Kings and Jacks)
4RING8: shows [Ts Js] (two pair, Kings and Jacks)
84nurik84: mucks hand 
Lokobarys Ninja collected 211 from pot
4RING8 collected 211 from pot
*** SUMMARY ***
Total pot 422 | Rake 0 
Board [Kc Kh Td Jd 5c]
Seat 1: marquitopoker4 (small blind) folded before Flop
Seat 2: Lokobarys Ninja (big blind) showed [Jh 9h] and won (211) with two pair, Kings and Jacks
Seat 3: 4RING8 showed [Ts Js] and won (211) with two pair, Kings and Jacks
Seat 4: jcarlos.vale folded before Flop (didn't bet)
Seat 5: RCABelVedeRVerd folded before Flop (didn't bet)
Seat 6: Mimishka004 folded before Flop (didn't bet)
Seat 7: kalimero1848 folded before Flop (didn't bet)
Seat 8: 84nurik84 (button) mucked [5d 6d]



PokerStars Hand #222097085948: Tournament #3082583698, $0.98+$0.12 USD Hold'em No Limit - Level II (20/40) - 2021/01/01 20:11:31 EET [2021/01/01 13:11:31 ET]
Table '3082583698 30' 9-max Seat #1 is the button
Seat 1: marquitopoker4 (5000 in chips) 
Seat 2: Lokobarys Ninja (5039 in chips) 
Seat 3: 4RING8 (4934 in chips) 
Seat 4: jcarlos.vale (4923 in chips) 
Seat 5: RCABelVedeRVerd (5245 in chips) is sitting out
Seat 6: Mimishka004 (4627 in chips) 
Seat 7: kalimero1848 (4976 in chips) 
Seat 8: 84nurik84 (4587 in chips) 
Seat 9: 48621537590 (5000 in chips) 
marquitopoker4: posts the ante 5
Lokobarys Ninja: posts the ante 5
4RING8: posts the ante 5
jcarlos.vale: posts the ante 5
RCABelVedeRVerd: posts the ante 5
Mimishka004: posts the ante 5
kalimero1848: posts the ante 5
84nurik84: posts the ante 5
48621537590: posts the ante 5
Lokobarys Ninja: posts small blind 20
4RING8: posts big blind 40
*** HOLE CARDS ***
Dealt to jcarlos.vale [9d Ah]
jcarlos.vale: folds 
RCABelVedeRVerd: folds 
Mimishka004: folds 
kalimero1848: raises 80 to 120
84nurik84: folds 
48621537590: folds 
marquitopoker4: folds 
Lokobarys Ninja: folds 
4RING8: calls 80
*** FLOP *** [8c Kd 3h]
4RING8: checks 
kalimero1848: bets 305
4RING8: calls 305
*** TURN *** [8c Kd 3h] [7d]
4RING8: checks 
kalimero1848: checks 
*** RIVER *** [8c Kd 3h 7d] [7s]
4RING8: checks 
kalimero1848: checks 
*** SHOW DOWN ***
4RING8: shows [Qh Kc] (two pair, Kings and Sevens)
kalimero1848: mucks hand 
4RING8 collected 915 from pot
*** SUMMARY ***
Total pot 915 | Rake 0 
Board [8c Kd 3h 7d 7s]
Seat 1: marquitopoker4 (button) folded before Flop (didn't bet)
Seat 2: Lokobarys Ninja (small blind) folded before Flop
Seat 3: 4RING8 (big blind) showed [Qh Kc] and won (915) with two pair, Kings and Sevens
Seat 4: jcarlos.vale folded before Flop (didn't bet)
Seat 5: RCABelVedeRVerd folded before Flop (didn't bet)
Seat 6: Mimishka004 folded before Flop (didn't bet)
Seat 7: kalimero1848 mucked [6c 6d]
Seat 8: 84nurik84 folded before Flop (didn't bet)
Seat 9: 48621537590 folded before Flop (didn't bet)



PokerStars Hand #222097133076: Tournament #3082583698, $0.98+$0.12 USD Hold'em No Limit - Level II (20/40) - 2021/01/01 20:12:23 EET [2021/01/01 13:12:23 ET]
Table '3082583698 30' 9-max Seat #2 is the button
Seat 1: marquitopoker4 (4995 in chips) 
Seat 2: Lokobarys Ninja (5014 in chips) 
Seat 3: 4RING8 (5419 in chips) 
Seat 4: jcarlos.vale (4918 in chips) 
Seat 5: RCABelVedeRVerd (5240 in chips) is sitting out
Seat 6: Mimishka004 (4622 in chips) 
Seat 7: kalimero1848 (4546 in chips) 
Seat 8: 84nurik84 (4582 in chips) 
Seat 9: 48621537590 (4995 in chips) 
marquitopoker4: posts the ante 5
Lokobarys Ninja: posts the ante 5
4RING8: posts the ante 5
jcarlos.vale: posts the ante 5
RCABelVedeRVerd: posts the ante 5
Mimishka004: posts the ante 5
kalimero1848: posts the ante 5
84nurik84: posts the ante 5
48621537590: posts the ante 5
4RING8: posts small blind 20
jcarlos.vale: posts big blind 40
*** HOLE CARDS ***
Dealt to jcarlos.vale [Jc 8h]
RCABelVedeRVerd: folds 
Mimishka004: folds 
kalimero1848: calls 40
84nurik84: calls 40
48621537590: folds 
marquitopoker4: folds 
Lokobarys Ninja: folds 
4RING8: calls 20
jcarlos.vale: checks 
*** FLOP *** [6c 4s Qh]
4RING8: checks 
jcarlos.vale: checks 
kalimero1848: checks 
84nurik84: checks 
*** TURN *** [6c 4s Qh] [Js]
4RING8: checks 
jcarlos.vale: checks 
kalimero1848: checks 
84nurik84: checks 
*** RIVER *** [6c 4s Qh Js] [5c]
4RING8: checks 
jcarlos.vale: checks 
kalimero1848: checks 
84nurik84: checks 
*** SHOW DOWN ***
4RING8: shows [9s As] (high card Ace)
jcarlos.vale: shows [Jc 8h] (a pair of Jacks)
kalimero1848: mucks hand 
84nurik84: mucks hand 
jcarlos.vale collected 205 from pot
*** SUMMARY ***
Total pot 205 | Rake 0 
Board [6c 4s Qh Js 5c]
Seat 1: marquitopoker4 folded before Flop (didn't bet)
Seat 2: Lokobarys Ninja (button) folded before Flop (didn't bet)
Seat 3: 4RING8 (small blind) showed [9s As] and lost with high card Ace
Seat 4: jcarlos.vale (big blind) showed [Jc 8h] and won (205) with a pair of Jacks
Seat 5: RCABelVedeRVerd folded before Flop (didn't bet)
Seat 6: Mimishka004 folded before Flop (didn't bet)
Seat 7: kalimero1848 mucked [Td 8d]
Seat 8: 84nurik84 mucked [Ac 7c]
Seat 9: 48621537590 folded before Flop (didn't bet)



PokerStars Hand #222097199808: Tournament #3082583698, $0.98+$0.12 USD Hold'em No Limit - Level II (20/40) - 2021/01/01 20:13:29 EET [2021/01/01 13:13:29 ET]
Table '3082583698 30' 9-max Seat #3 is the button
Seat 1: marquitopoker4 (4990 in chips) 
Seat 2: Lokobarys Ninja (5009 in chips) 
Seat 3: 4RING8 (5374 in chips) 
Seat 4: jcarlos.vale (5078 in chips) 
Seat 5: RCABelVedeRVerd (5235 in chips) is sitting out
Seat 6: Mimishka004 (4617 in chips) 
Seat 7: kalimero1848 (4501 in chips) 
Seat 8: 84nurik84 (4537 in chips) 
Seat 9: 48621537590 (4990 in chips) 
marquitopoker4: posts the ante 5
Lokobarys Ninja: posts the ante 5
4RING8: posts the ante 5
jcarlos.vale: posts the ante 5
RCABelVedeRVerd: posts the ante 5
Mimishka004: posts the ante 5
kalimero1848: posts the ante 5
84nurik84: posts the ante 5
48621537590: posts the ante 5
jcarlos.vale: posts small blind 20
RCABelVedeRVerd: posts big blind 40
*** HOLE CARDS ***
Dealt to jcarlos.vale [3c 5d]
Mimishka004: folds 
kalimero1848: calls 40
84nurik84: calls 40
48621537590: folds 
marquitopoker4: folds 
Lokobarys Ninja: folds 
4RING8: folds 
jcarlos.vale: calls 20
RCABelVedeRVerd: folds 
*** FLOP *** [9s 3h 9h]
jcarlos.vale: checks 
kalimero1848: checks 
84nurik84: checks 
*** TURN *** [9s 3h 9h] [2s]
jcarlos.vale: checks 
RCABelVedeRVerd has returned
kalimero1848: checks 
84nurik84: checks 
*** RIVER *** [9s 3h 9h 2s] [Td]
jcarlos.vale: checks 
kalimero1848: checks 
84nurik84: checks 
*** SHOW DOWN ***
jcarlos.vale: shows [3c 5d] (two pair, Nines and Threes)
kalimero1848: mucks hand 
84nurik84: mucks hand 
jcarlos.vale collected 205 from pot
*** SUMMARY ***
Total pot 205 | Rake 0 
Board [9s 3h 9h 2s Td]
Seat 1: marquitopoker4 folded before Flop (didn't bet)
Seat 2: Lokobarys Ninja folded before Flop (didn't bet)
Seat 3: 4RING8 (button) folded before Flop (didn't bet)
Seat 4: jcarlos.vale (small blind) showed [3c 5d] and won (205) with two pair, Nines and Threes
Seat 5: RCABelVedeRVerd (big blind) folded before Flop
Seat 6: Mimishka004 folded before Flop (didn't bet)
Seat 7: kalimero1848 mucked [7d 8d]
Seat 8: 84nurik84 mucked [Js Qh]
Seat 9: 48621537590 folded before Flop (didn't bet)



PokerStars Hand #222097274869: Tournament #3082583698, $0.98+$0.12 USD Hold'em No Limit - Level II (20/40) - 2021/01/01 20:14:33 EET [2021/01/01 13:14:33 ET]
Table '3082583698 30' 9-max Seat #4 is the button
Seat 1: marquitopoker4 (4985 in chips) 
Seat 2: Lokobarys Ninja (5004 in chips) 
Seat 3: 4RING8 (5369 in chips) 
Seat 4: jcarlos.vale (5238 in chips) 
Seat 5: RCABelVedeRVerd (5190 in chips) 
Seat 6: Mimishka004 (4612 in chips) 
Seat 7: kalimero1848 (4456 in chips) 
Seat 8: 84nurik84 (4492 in chips) 
Seat 9: 48621537590 (4985 in chips) 
marquitopoker4: posts the ante 5
Lokobarys Ninja: posts the ante 5
4RING8: posts the ante 5
jcarlos.vale: posts the ante 5
RCABelVedeRVerd: posts the ante 5
Mimishka004: posts the ante 5
kalimero1848: posts the ante 5
84nurik84: posts the ante 5
48621537590: posts the ante 5
RCABelVedeRVerd: posts small blind 20
Mimishka004: posts big blind 40
*** HOLE CARDS ***
Dealt to jcarlos.vale [Tc Jh]
kalimero1848: calls 40
84nurik84: folds 
48621537590: folds 
marquitopoker4: folds 
Lokobarys Ninja: folds 
4RING8: folds 
jcarlos.vale: folds 
RCABelVedeRVerd: calls 20
Mimishka004: checks 
*** FLOP *** [7d 5c Th]
RCABelVedeRVerd: checks 
Mimishka004: checks 
kalimero1848: checks 
*** TURN *** [7d 5c Th] [3d]
RCABelVedeRVerd has timed out
RCABelVedeRVerd: checks 
RCABelVedeRVerd is disconnected 
Mimishka004: checks 
kalimero1848: bets 165
RCABelVedeRVerd is connected 
RCABelVedeRVerd: folds 
Mimishka004: folds 
Uncalled bet (165) returned to kalimero1848
kalimero1848 collected 165 from pot
kalimero1848: doesn't show hand 
*** SUMMARY ***
Total pot 165 | Rake 0 
Board [7d 5c Th 3d]
Seat 1: marquitopoker4 folded before Flop (didn't bet)
Seat 2: Lokobarys Ninja folded before Flop (didn't bet)
Seat 3: 4RING8 folded before Flop (didn't bet)
Seat 4: jcarlos.vale (button) folded before Flop (didn't bet)
Seat 5: RCABelVedeRVerd (small blind) folded on the Turn
Seat 6: Mimishka004 (big blind) folded on the Turn
Seat 7: kalimero1848 collected (165)
Seat 8: 84nurik84 folded before Flop (didn't bet)
Seat 9: 48621537590 folded before Flop (didn't bet)



PokerStars Hand #222097377234: Tournament #3082583698, $0.98+$0.12 USD Hold'em No Limit - Level II (20/40) - 2021/01/01 20:16:07 EET [2021/01/01 13:16:07 ET]
Table '3082583698 30' 9-max Seat #5 is the button
Seat 1: marquitopoker4 (4980 in chips) 
Seat 2: Lokobarys Ninja (4999 in chips) 
Seat 3: 4RING8 (5364 in chips) 
Seat 4: jcarlos.vale (5233 in chips) 
Seat 5: RCABelVedeRVerd (5145 in chips) 
Seat 6: Mimishka004 (4567 in chips) 
Seat 7: kalimero1848 (4576 in chips) 
Seat 8: 84nurik84 (4487 in chips) 
Seat 9: 48621537590 (4980 in chips) 
marquitopoker4: posts the ante 5
Lokobarys Ninja: posts the ante 5
4RING8: posts the ante 5
jcarlos.vale: posts the ante 5
RCABelVedeRVerd: posts the ante 5
Mimishka004: posts the ante 5
kalimero1848: posts the ante 5
84nurik84: posts the ante 5
48621537590: posts the ante 5
Mimishka004: posts small blind 20
kalimero1848: posts big blind 40
*** HOLE CARDS ***
Dealt to jcarlos.vale [4s 5s]
84nurik84: raises 60 to 100
48621537590: folds 
marquitopoker4: folds 
Lokobarys Ninja has timed out
Lokobarys Ninja: folds 
Lokobarys Ninja is sitting out
4RING8: folds 
jcarlos.vale: folds 
RCABelVedeRVerd has timed out
RCABelVedeRVerd: folds 
RCABelVedeRVerd is sitting out
Mimishka004: folds 
kalimero1848: folds 
Uncalled bet (60) returned to 84nurik84
84nurik84 collected 145 from pot
84nurik84: doesn't show hand 
*** SUMMARY ***
Total pot 145 | Rake 0 
Seat 1: marquitopoker4 folded before Flop (didn't bet)
Seat 2: Lokobarys Ninja folded before Flop (didn't bet)
Seat 3: 4RING8 folded before Flop (didn't bet)
Seat 4: jcarlos.vale folded before Flop (didn't bet)
Seat 5: RCABelVedeRVerd (button) folded before Flop (didn't bet)
Seat 6: Mimishka004 (small blind) folded before Flop
Seat 7: kalimero1848 (big blind) folded before Flop
Seat 8: 84nurik84 collected (145)
Seat 9: 48621537590 folded before Flop (didn't bet)



PokerStars Hand #222097440546: Tournament #3082583698, $0.98+$0.12 USD Hold'em No Limit - Level II (20/40) - 2021/01/01 20:17:06 EET [2021/01/01 13:17:06 ET]
Table '3082583698 30' 9-max Seat #6 is the button
Seat 1: marquitopoker4 (4975 in chips) 
Seat 2: Lokobarys Ninja (4994 in chips) is sitting out
Seat 3: 4RING8 (5359 in chips) 
Seat 4: jcarlos.vale (5228 in chips) 
Seat 5: RCABelVedeRVerd (5140 in chips) is sitting out
Seat 6: Mimishka004 (4542 in chips) 
Seat 7: kalimero1848 (4531 in chips) 
Seat 8: 84nurik84 (4587 in chips) 
Seat 9: 48621537590 (4975 in chips) 
marquitopoker4: posts the ante 5
Lokobarys Ninja: posts the ante 5
4RING8: posts the ante 5
jcarlos.vale: posts the ante 5
RCABelVedeRVerd: posts the ante 5
Mimishka004: posts the ante 5
kalimero1848: posts the ante 5
84nurik84: posts the ante 5
48621537590: posts the ante 5
kalimero1848: posts small blind 20
84nurik84: posts big blind 40
*** HOLE CARDS ***
Dealt to jcarlos.vale [4h 4s]
RCABelVedeRVerd has returned
Lokobarys Ninja has returned
48621537590: folds 
marquitopoker4: folds 
Lokobarys Ninja: folds 
4RING8: folds 
jcarlos.vale: raises 64 to 104
RCABelVedeRVerd: calls 104
Mimishka004: raises 316 to 420
kalimero1848: folds 
84nurik84: folds 
jcarlos.vale: folds 
RCABelVedeRVerd: raises 4715 to 5135 and is all-in
Mimishka004: folds 
Uncalled bet (4715) returned to RCABelVedeRVerd
RCABelVedeRVerd collected 1049 from pot
*** SUMMARY ***
Total pot 1049 | Rake 0 
Seat 1: marquitopoker4 folded before Flop (didn't bet)
Seat 2: Lokobarys Ninja folded before Flop (didn't bet)
Seat 3: 4RING8 folded before Flop (didn't bet)
Seat 4: jcarlos.vale folded before Flop
Seat 5: RCABelVedeRVerd collected (1049)
Seat 6: Mimishka004 (button) folded before Flop
Seat 7: kalimero1848 (small blind) folded before Flop
Seat 8: 84nurik84 (big blind) folded before Flop
Seat 9: 48621537590 folded before Flop (didn't bet)



PokerStars Hand #222097509966: Tournament #3082583698, $0.98+$0.12 USD Hold'em No Limit - Level II (20/40) - 2021/01/01 20:18:11 EET [2021/01/01 13:18:11 ET]
Table '3082583698 30' 9-max Seat #7 is the button
Seat 1: marquitopoker4 (4970 in chips) 
Seat 2: Lokobarys Ninja (4989 in chips) 
Seat 3: 4RING8 (5354 in chips) 
Seat 4: jcarlos.vale (5119 in chips) 
Seat 5: RCABelVedeRVerd (5764 in chips) 
Seat 6: Mimishka004 (4117 in chips) 
Seat 7: kalimero1848 (4506 in chips) 
Seat 8: 84nurik84 (4542 in chips) 
Seat 9: 48621537590 (4970 in chips) 
marquitopoker4: posts the ante 5
Lokobarys Ninja: posts the ante 5
4RING8: posts the ante 5
jcarlos.vale: posts the ante 5
RCABelVedeRVerd: posts the ante 5
Mimishka004: posts the ante 5
kalimero1848: posts the ante 5
84nurik84: posts the ante 5
48621537590: posts the ante 5
84nurik84: posts small blind 20
48621537590: posts big blind 40
*** HOLE CARDS ***
Dealt to jcarlos.vale [Qd 6h]
marquitopoker4: folds 
Lokobarys Ninja: folds 
4RING8: folds 
jcarlos.vale: folds 
RCABelVedeRVerd: raises 40 to 80
Mimishka004: folds 
kalimero1848: folds 
84nurik84: folds 
48621537590: folds 
Uncalled bet (40) returned to RCABelVedeRVerd
RCABelVedeRVerd collected 145 from pot
*** SUMMARY ***
Total pot 145 | Rake 0 
Seat 1: marquitopoker4 folded before Flop (didn't bet)
Seat 2: Lokobarys Ninja folded before Flop (didn't bet)
Seat 3: 4RING8 folded before Flop (didn't bet)
Seat 4: jcarlos.vale folded before Flop (didn't bet)
Seat 5: RCABelVedeRVerd collected (145)
Seat 6: Mimishka004 folded before Flop (didn't bet)
Seat 7: kalimero1848 (button) folded before Flop (didn't bet)
Seat 8: 84nurik84 (small blind) folded before Flop
Seat 9: 48621537590 (big blind) folded before Flop



PokerStars Hand #222097550345: Tournament #3082583698, $0.98+$0.12 USD Hold'em No Limit - Level II (20/40) - 2021/01/01 20:18:49 EET [2021/01/01 13:18:49 ET]
Table '3082583698 30' 9-max Seat #8 is the button
Seat 1: marquitopoker4 (4965 in chips) 
Seat 2: Lokobarys Ninja (4984 in chips) 
Seat 3: 4RING8 (5349 in chips) 
Seat 4: jcarlos.vale (5114 in chips) 
Seat 5: RCABelVedeRVerd (5864 in chips) 
Seat 6: Mimishka004 (4112 in chips) 
Seat 7: kalimero1848 (4501 in chips) 
Seat 8: 84nurik84 (4517 in chips) 
Seat 9: 48621537590 (4925 in chips) 
marquitopoker4: posts the ante 5
Lokobarys Ninja: posts the ante 5
4RING8: posts the ante 5
jcarlos.vale: posts the ante 5
RCABelVedeRVerd: posts the ante 5
Mimishka004: posts the ante 5
kalimero1848: posts the ante 5
84nurik84: posts the ante 5
48621537590: posts the ante 5
48621537590: posts small blind 20
marquitopoker4: posts big blind 40
*** HOLE CARDS ***
Dealt to jcarlos.vale [4s Jd]
Lokobarys Ninja: folds 
4RING8: folds 
jcarlos.vale: folds 
RCABelVedeRVerd: calls 40
Mimishka004: raises 80 to 120
kalimero1848: folds 
84nurik84: folds 
48621537590: folds 
marquitopoker4: folds 
RCABelVedeRVerd: calls 80
*** FLOP *** [9s 9c 8h]
RCABelVedeRVerd: checks 
Mimishka004: bets 114
RCABelVedeRVerd: calls 114
*** TURN *** [9s 9c 8h] [5h]
RCABelVedeRVerd: checks 
Mimishka004: bets 367
RCABelVedeRVerd: folds 
Uncalled bet (367) returned to Mimishka004
Mimishka004 collected 573 from pot
*** SUMMARY ***
Total pot 573 | Rake 0 
Board [9s 9c 8h 5h]
Seat 1: marquitopoker4 (big blind) folded before Flop
Seat 2: Lokobarys Ninja folded before Flop (didn't bet)
Seat 3: 4RING8 folded before Flop (didn't bet)
Seat 4: jcarlos.vale folded before Flop (didn't bet)
Seat 5: RCABelVedeRVerd folded on the Turn
Seat 6: Mimishka004 collected (573)
Seat 7: kalimero1848 folded before Flop (didn't bet)
Seat 8: 84nurik84 (button) folded before Flop (didn't bet)
Seat 9: 48621537590 (small blind) folded before Flop



PokerStars Hand #222097620700: Tournament #3082583698, $0.98+$0.12 USD Hold'em No Limit - Level II (20/40) - 2021/01/01 20:19:56 EET [2021/01/01 13:19:56 ET]
Table '3082583698 30' 9-max Seat #9 is the button
Seat 1: marquitopoker4 (4920 in chips) 
Seat 2: Lokobarys Ninja (4979 in chips) 
Seat 3: 4RING8 (5344 in chips) 
Seat 4: jcarlos.vale (5109 in chips) 
Seat 5: RCABelVedeRVerd (5625 in chips) 
Seat 6: Mimishka004 (4446 in chips) 
Seat 7: kalimero1848 (4496 in chips) 
Seat 8: 84nurik84 (4512 in chips) 
Seat 9: 48621537590 (4900 in chips) 
marquitopoker4: posts the ante 5
Lokobarys Ninja: posts the ante 5
4RING8: posts the ante 5
jcarlos.vale: posts the ante 5
RCABelVedeRVerd: posts the ante 5
Mimishka004: posts the ante 5
kalimero1848: posts the ante 5
84nurik84: posts the ante 5
48621537590: posts the ante 5
marquitopoker4: posts small blind 20
Lokobarys Ninja: posts big blind 40
*** HOLE CARDS ***
Dealt to jcarlos.vale [Ks 6s]
4RING8: folds 
jcarlos.vale: folds 
RCABelVedeRVerd: raises 120 to 160
Mimishka004: folds 
kalimero1848: folds 
84nurik84: folds 
48621537590: folds 
marquitopoker4: folds 
Lokobarys Ninja has timed out
Lokobarys Ninja: folds 
Lokobarys Ninja is sitting out
Uncalled bet (120) returned to RCABelVedeRVerd
RCABelVedeRVerd collected 145 from pot
*** SUMMARY ***
Total pot 145 | Rake 0 
Seat 1: marquitopoker4 (small blind) folded before Flop
Seat 2: Lokobarys Ninja (big blind) folded before Flop
Seat 3: 4RING8 folded before Flop (didn't bet)
Seat 4: jcarlos.vale folded before Flop (didn't bet)
Seat 5: RCABelVedeRVerd collected (145)
Seat 6: Mimishka004 folded before Flop (didn't bet)
Seat 7: kalimero1848 folded before Flop (didn't bet)
Seat 8: 84nurik84 folded before Flop (didn't bet)
Seat 9: 48621537590 (button) folded before Flop (didn't bet)



PokerStars Hand #222097656853: Tournament #3082583698, $0.98+$0.12 USD Hold'em No Limit - Level III (25/50) - 2021/01/01 20:20:31 EET [2021/01/01 13:20:31 ET]
Table '3082583698 30' 9-max Seat #1 is the button
Seat 1: marquitopoker4 (4895 in chips) 
Seat 2: Lokobarys Ninja (4934 in chips) 
Seat 3: 4RING8 (5339 in chips) 
Seat 4: jcarlos.vale (5104 in chips) 
Seat 5: RCABelVedeRVerd (5725 in chips) 
Seat 6: Mimishka004 (4441 in chips) 
Seat 7: kalimero1848 (4491 in chips) 
Seat 8: 84nurik84 (4507 in chips) 
Seat 9: 48621537590 (4895 in chips) 
marquitopoker4: posts the ante 6
Lokobarys Ninja: posts the ante 6
4RING8: posts the ante 6
jcarlos.vale: posts the ante 6
RCABelVedeRVerd: posts the ante 6
Mimishka004: posts the ante 6
kalimero1848: posts the ante 6
84nurik84: posts the ante 6
48621537590: posts the ante 6
Lokobarys Ninja: posts small blind 25
4RING8: posts big blind 50
*** HOLE CARDS ***
Dealt to jcarlos.vale [8d 2h]
jcarlos.vale: folds 
RCABelVedeRVerd: calls 50
Mimishka004: folds 
kalimero1848: folds 
84nurik84: folds 
48621537590: folds 
marquitopoker4: folds 
kalimero1848 is disconnected 
Lokobarys Ninja has timed out
Lokobarys Ninja: folds 
Lokobarys Ninja is sitting out
Lokobarys Ninja has returned
4RING8: checks 
*** FLOP *** [6h 4h Th]
4RING8: checks 
RCABelVedeRVerd: checks 
*** TURN *** [6h 4h Th] [2c]
4RING8: bets 50
RCABelVedeRVerd: calls 50
*** RIVER *** [6h 4h Th 2c] [Tc]
4RING8: checks 
RCABelVedeRVerd: checks 
*** SHOW DOWN ***
4RING8: shows [4d Ah] (two pair, Tens and Fours)
RCABelVedeRVerd: mucks hand 
4RING8 collected 279 from pot
*** SUMMARY ***
Total pot 279 | Rake 0 
Board [6h 4h Th 2c Tc]
Seat 1: marquitopoker4 (button) folded before Flop (didn't bet)
Seat 2: Lokobarys Ninja (small blind) folded before Flop
Seat 3: 4RING8 (big blind) showed [4d Ah] and won (279) with two pair, Tens and Fours
Seat 4: jcarlos.vale folded before Flop (didn't bet)
Seat 5: RCABelVedeRVerd mucked [Ac 9c]
Seat 6: Mimishka004 folded before Flop (didn't bet)
Seat 7: kalimero1848 folded before Flop (didn't bet)
Seat 8: 84nurik84 folded before Flop (didn't bet)
Seat 9: 48621537590 folded before Flop (didn't bet)



PokerStars Hand #222097719076: Tournament #3082583698, $0.98+$0.12 USD Hold'em No Limit - Level III (25/50) - 2021/01/01 20:21:30 EET [2021/01/01 13:21:30 ET]
Table '3082583698 30' 9-max Seat #2 is the button
Seat 1: marquitopoker4 (4889 in chips) 
Seat 2: Lokobarys Ninja (4903 in chips) 
Seat 3: 4RING8 (5512 in chips) 
Seat 4: jcarlos.vale (5098 in chips) 
Seat 5: RCABelVedeRVerd (5619 in chips) 
Seat 6: Mimishka004 (4435 in chips) 
Seat 7: kalimero1848 (4485 in chips) 
Seat 8: 84nurik84 (4501 in chips) 
Seat 9: 48621537590 (4889 in chips) 
marquitopoker4: posts the ante 6
Lokobarys Ninja: posts the ante 6
4RING8: posts the ante 6
jcarlos.vale: posts the ante 6
RCABelVedeRVerd: posts the ante 6
Mimishka004: posts the ante 6
kalimero1848: posts the ante 6
84nurik84: posts the ante 6
48621537590: posts the ante 6
4RING8: posts small blind 25
jcarlos.vale: posts big blind 50
*** HOLE CARDS ***
Dealt to jcarlos.vale [2s 4s]
RCABelVedeRVerd: folds 
Mimishka004: raises 100 to 150
kalimero1848 has timed out while disconnected
kalimero1848: folds 
kalimero1848 is sitting out
84nurik84: folds 
48621537590: folds 
marquitopoker4: folds 
Lokobarys Ninja: folds 
4RING8: folds 
jcarlos.vale: folds 
Uncalled bet (100) returned to Mimishka004
Mimishka004 collected 179 from pot
*** SUMMARY ***
Total pot 179 | Rake 0 
Seat 1: marquitopoker4 folded before Flop (didn't bet)
Seat 2: Lokobarys Ninja (button) folded before Flop (didn't bet)
Seat 3: 4RING8 (small blind) folded before Flop
Seat 4: jcarlos.vale (big blind) folded before Flop
Seat 5: RCABelVedeRVerd folded before Flop (didn't bet)
Seat 6: Mimishka004 collected (179)
Seat 7: kalimero1848 folded before Flop (didn't bet)
Seat 8: 84nurik84 folded before Flop (didn't bet)
Seat 9: 48621537590 folded before Flop (didn't bet)



PokerStars Hand #222097766136: Tournament #3082583698, $0.98+$0.12 USD Hold'em No Limit - Level III (25/50) - 2021/01/01 20:22:16 EET [2021/01/01 13:22:16 ET]
Table '3082583698 30' 9-max Seat #3 is the button
Seat 1: marquitopoker4 (4883 in chips) 
Seat 2: Lokobarys Ninja (4897 in chips) 
Seat 3: 4RING8 (5481 in chips) 
Seat 4: jcarlos.vale (5042 in chips) 
Seat 5: RCABelVedeRVerd (5613 in chips) 
Seat 6: Mimishka004 (4558 in chips) 
Seat 7: kalimero1848 (4479 in chips) is sitting out
Seat 8: 84nurik84 (4495 in chips) 
Seat 9: 48621537590 (4883 in chips) 
marquitopoker4: posts the ante 6
Lokobarys Ninja: posts the ante 6
4RING8: posts the ante 6
jcarlos.vale: posts the ante 6
RCABelVedeRVerd: posts the ante 6
Mimishka004: posts the ante 6
kalimero1848: posts the ante 6
84nurik84: posts the ante 6
48621537590: posts the ante 6
jcarlos.vale: posts small blind 25
RCABelVedeRVerd: posts big blind 50
*** HOLE CARDS ***
Dealt to jcarlos.vale [7s 5s]
Mimishka004: folds 
kalimero1848: folds 
84nurik84: folds 
48621537590: folds 
marquitopoker4: raises 69 to 119
Lokobarys Ninja: folds 
4RING8: calls 119
jcarlos.vale: folds 
RCABelVedeRVerd: calls 69
*** FLOP *** [As 4c 7c]
RCABelVedeRVerd: checks 
marquitopoker4: bets 148
4RING8: calls 148
RCABelVedeRVerd: calls 148
*** TURN *** [As 4c 7c] [Ad]
RCABelVedeRVerd: checks 
marquitopoker4: bets 279
4RING8: calls 279
RCABelVedeRVerd: folds 
*** RIVER *** [As 4c 7c Ad] [Ts]
marquitopoker4: checks 
4RING8: bets 375
marquitopoker4: folds 
Uncalled bet (375) returned to 4RING8
4RING8 collected 1438 from pot
4RING8: doesn't show hand 
*** SUMMARY ***
Total pot 1438 | Rake 0 
Board [As 4c 7c Ad Ts]
Seat 1: marquitopoker4 folded on the River
Seat 2: Lokobarys Ninja folded before Flop (didn't bet)
Seat 3: 4RING8 (button) collected (1438)
Seat 4: jcarlos.vale (small blind) folded before Flop
Seat 5: RCABelVedeRVerd (big blind) folded on the Turn
Seat 6: Mimishka004 folded before Flop (didn't bet)
Seat 7: kalimero1848 folded before Flop (didn't bet)
Seat 8: 84nurik84 folded before Flop (didn't bet)
Seat 9: 48621537590 folded before Flop (didn't bet)



PokerStars Hand #222097844049: Tournament #3082583698, $0.98+$0.12 USD Hold'em No Limit - Level III (25/50) - 2021/01/01 20:23:30 EET [2021/01/01 13:23:30 ET]
Table '3082583698 30' 9-max Seat #4 is the button
Seat 1: marquitopoker4 (4331 in chips) 
Seat 2: Lokobarys Ninja (4891 in chips) 
Seat 3: 4RING8 (6367 in chips) 
Seat 4: jcarlos.vale (5011 in chips) 
Seat 5: RCABelVedeRVerd (5340 in chips) 
Seat 6: Mimishka004 (4552 in chips) 
Seat 7: kalimero1848 (4473 in chips) is sitting out
Seat 8: 84nurik84 (4489 in chips) 
Seat 9: 48621537590 (4877 in chips) 
marquitopoker4: posts the ante 6
Lokobarys Ninja: posts the ante 6
4RING8: posts the ante 6
jcarlos.vale: posts the ante 6
RCABelVedeRVerd: posts the ante 6
Mimishka004: posts the ante 6
kalimero1848: posts the ante 6
84nurik84: posts the ante 6
48621537590: posts the ante 6
RCABelVedeRVerd: posts small blind 25
Mimishka004: posts big blind 50
*** HOLE CARDS ***
Dealt to jcarlos.vale [2c As]
kalimero1848: folds 
84nurik84: folds 
48621537590: folds 
marquitopoker4: folds 
Lokobarys Ninja has timed out
Lokobarys Ninja: folds 
Lokobarys Ninja is sitting out
4RING8: folds 
jcarlos.vale: folds 
RCABelVedeRVerd: calls 25
Mimishka004: checks 
*** FLOP *** [Jh Tc 9c]
RCABelVedeRVerd: checks 
Mimishka004: bets 99
RCABelVedeRVerd: calls 99
*** TURN *** [Jh Tc 9c] [Jc]
Lokobarys Ninja has returned
RCABelVedeRVerd: checks 
Mimishka004: checks 
*** RIVER *** [Jh Tc 9c Jc] [Th]
RCABelVedeRVerd: bets 150
kalimero1848 has returned
Mimishka004: raises 500 to 650
RCABelVedeRVerd: calls 500
*** SHOW DOWN ***
Mimishka004: shows [Ts 8s] (a full house, Tens full of Jacks)
RCABelVedeRVerd: shows [9s Td] (a full house, Tens full of Jacks)
RCABelVedeRVerd collected 826 from pot
Mimishka004 collected 826 from pot
*** SUMMARY ***
Total pot 1652 | Rake 0 
Board [Jh Tc 9c Jc Th]
Seat 1: marquitopoker4 folded before Flop (didn't bet)
Seat 2: Lokobarys Ninja folded before Flop (didn't bet)
Seat 3: 4RING8 folded before Flop (didn't bet)
Seat 4: jcarlos.vale (button) folded before Flop (didn't bet)
Seat 5: RCABelVedeRVerd (small blind) showed [9s Td] and won (826) with a full house, Tens full of Jacks
Seat 6: Mimishka004 (big blind) showed [Ts 8s] and won (826) with a full house, Tens full of Jacks
Seat 7: kalimero1848 folded before Flop (didn't bet)
Seat 8: 84nurik84 folded before Flop (didn't bet)
Seat 9: 48621537590 folded before Flop (didn't bet)



PokerStars Hand #222097923882: Tournament #3082583698, $0.98+$0.12 USD Hold'em No Limit - Level III (25/50) - 2021/01/01 20:24:46 EET [2021/01/01 13:24:46 ET]
Table '3082583698 30' 9-max Seat #5 is the button
Seat 1: marquitopoker4 (4325 in chips) 
Seat 2: Lokobarys Ninja (4885 in chips) 
Seat 3: 4RING8 (6361 in chips) 
Seat 4: jcarlos.vale (5005 in chips) 
Seat 5: RCABelVedeRVerd (5361 in chips) 
Seat 6: Mimishka004 (4573 in chips) 
Seat 7: kalimero1848 (4467 in chips) 
Seat 8: 84nurik84 (4483 in chips) 
Seat 9: 48621537590 (4871 in chips) 
marquitopoker4: posts the ante 6
Lokobarys Ninja: posts the ante 6
4RING8: posts the ante 6
jcarlos.vale: posts the ante 6
RCABelVedeRVerd: posts the ante 6
Mimishka004: posts the ante 6
kalimero1848: posts the ante 6
84nurik84: posts the ante 6
48621537590: posts the ante 6
Mimishka004: posts small blind 25
kalimero1848: posts big blind 50
*** HOLE CARDS ***
Dealt to jcarlos.vale [2d 5s]
84nurik84: folds 
48621537590: folds 
marquitopoker4: folds 
Lokobarys Ninja: raises 50 to 100
4RING8: folds 
jcarlos.vale: folds 
RCABelVedeRVerd: folds 
Mimishka004: folds 
kalimero1848: folds 
Uncalled bet (50) returned to Lokobarys Ninja
Lokobarys Ninja collected 179 from pot
*** SUMMARY ***
Total pot 179 | Rake 0 
Seat 1: marquitopoker4 folded before Flop (didn't bet)
Seat 2: Lokobarys Ninja collected (179)
Seat 3: 4RING8 folded before Flop (didn't bet)
Seat 4: jcarlos.vale folded before Flop (didn't bet)
Seat 5: RCABelVedeRVerd (button) folded before Flop (didn't bet)
Seat 6: Mimishka004 (small blind) folded before Flop
Seat 7: kalimero1848 (big blind) folded before Flop
Seat 8: 84nurik84 folded before Flop (didn't bet)
Seat 9: 48621537590 folded before Flop (didn't bet)



PokerStars Hand #222097956692: Tournament #3082583698, $0.98+$0.12 USD Hold'em No Limit - Level III (25/50) - 2021/01/01 20:25:18 EET [2021/01/01 13:25:18 ET]
Table '3082583698 30' 9-max Seat #6 is the button
Seat 1: marquitopoker4 (4319 in chips) 
Seat 2: Lokobarys Ninja (5008 in chips) 
Seat 3: 4RING8 (6355 in chips) 
Seat 4: jcarlos.vale (4999 in chips) 
Seat 5: RCABelVedeRVerd (5355 in chips) 
Seat 6: Mimishka004 (4542 in chips) 
Seat 7: kalimero1848 (4411 in chips) 
Seat 8: 84nurik84 (4477 in chips) 
Seat 9: 48621537590 (4865 in chips) 
marquitopoker4: posts the ante 6
Lokobarys Ninja: posts the ante 6
4RING8: posts the ante 6
jcarlos.vale: posts the ante 6
RCABelVedeRVerd: posts the ante 6
Mimishka004: posts the ante 6
kalimero1848: posts the ante 6
84nurik84: posts the ante 6
48621537590: posts the ante 6
kalimero1848: posts small blind 25
84nurik84: posts big blind 50
*** HOLE CARDS ***
Dealt to jcarlos.vale [2c Qh]
48621537590: folds 
marquitopoker4: folds 
Lokobarys Ninja: folds 
4RING8: folds 
jcarlos.vale: folds 
RCABelVedeRVerd: folds 
Mimishka004: raises 52 to 102
kalimero1848: folds 
84nurik84: raises 248 to 350
Mimishka004: calls 248
*** FLOP *** [Ks 5d 3s]
84nurik84: checks 
Mimishka004: bets 257
84nurik84: folds 
Uncalled bet (257) returned to Mimishka004
Mimishka004 collected 779 from pot
*** SUMMARY ***
Total pot 779 | Rake 0 
Board [Ks 5d 3s]
Seat 1: marquitopoker4 folded before Flop (didn't bet)
Seat 2: Lokobarys Ninja folded before Flop (didn't bet)
Seat 3: 4RING8 folded before Flop (didn't bet)
Seat 4: jcarlos.vale folded before Flop (didn't bet)
Seat 5: RCABelVedeRVerd folded before Flop (didn't bet)
Seat 6: Mimishka004 (button) collected (779)
Seat 7: kalimero1848 (small blind) folded before Flop
Seat 8: 84nurik84 (big blind) folded on the Flop
Seat 9: 48621537590 folded before Flop (didn't bet)



PokerStars Hand #222098043179: Tournament #3082583698, $0.98+$0.12 USD Hold'em No Limit - Level III (25/50) - 2021/01/01 20:26:41 EET [2021/01/01 13:26:41 ET]
Table '3082583698 30' 9-max Seat #7 is the button
Seat 1: marquitopoker4 (4313 in chips) 
Seat 2: Lokobarys Ninja (5002 in chips) 
Seat 3: 4RING8 (6349 in chips) 
Seat 4: jcarlos.vale (4993 in chips) 
Seat 5: RCABelVedeRVerd (5349 in chips) 
Seat 6: Mimishka004 (4965 in chips) 
Seat 7: kalimero1848 (4380 in chips) 
Seat 8: 84nurik84 (4121 in chips) 
Seat 9: 48621537590 (4859 in chips) 
marquitopoker4: posts the ante 6
Lokobarys Ninja: posts the ante 6
4RING8: posts the ante 6
jcarlos.vale: posts the ante 6
RCABelVedeRVerd: posts the ante 6
Mimishka004: posts the ante 6
kalimero1848: posts the ante 6
84nurik84: posts the ante 6
48621537590: posts the ante 6
84nurik84: posts small blind 25
48621537590: posts big blind 50
*** HOLE CARDS ***
Dealt to jcarlos.vale [Kc Jc]
marquitopoker4: folds 
Lokobarys Ninja has timed out
Lokobarys Ninja: folds 
Lokobarys Ninja is sitting out
Lokobarys Ninja has returned
4RING8: folds 
jcarlos.vale: raises 80 to 130
RCABelVedeRVerd: folds 
Mimishka004: folds 
kalimero1848: folds 
84nurik84: folds 
48621537590: calls 80
*** FLOP *** [8d 3c Qc]
48621537590: checks 
jcarlos.vale: checks 
*** TURN *** [8d 3c Qc] [7s]
48621537590: checks 
jcarlos.vale: checks 
*** RIVER *** [8d 3c Qc 7s] [7c]
48621537590: checks 
jcarlos.vale: bets 100
48621537590: folds 
Uncalled bet (100) returned to jcarlos.vale
jcarlos.vale collected 339 from pot
jcarlos.vale: doesn't show hand 
*** SUMMARY ***
Total pot 339 | Rake 0 
Board [8d 3c Qc 7s 7c]
Seat 1: marquitopoker4 folded before Flop (didn't bet)
Seat 2: Lokobarys Ninja folded before Flop (didn't bet)
Seat 3: 4RING8 folded before Flop (didn't bet)
Seat 4: jcarlos.vale collected (339)
Seat 5: RCABelVedeRVerd folded before Flop (didn't bet)
Seat 6: Mimishka004 folded before Flop (didn't bet)
Seat 7: kalimero1848 (button) folded before Flop (didn't bet)
Seat 8: 84nurik84 (small blind) folded before Flop
Seat 9: 48621537590 (big blind) folded on the River



PokerStars Hand #222098106092: Tournament #3082583698, $0.98+$0.12 USD Hold'em No Limit - Level III (25/50) - 2021/01/01 20:27:42 EET [2021/01/01 13:27:42 ET]
Table '3082583698 30' 9-max Seat #8 is the button
Seat 1: marquitopoker4 (4307 in chips) 
Seat 2: Lokobarys Ninja (4996 in chips) 
Seat 3: 4RING8 (6343 in chips) 
Seat 4: jcarlos.vale (5196 in chips) 
Seat 5: RCABelVedeRVerd (5343 in chips) 
Seat 6: Mimishka004 (4959 in chips) 
Seat 7: kalimero1848 (4374 in chips) 
Seat 8: 84nurik84 (4090 in chips) 
Seat 9: 48621537590 (4723 in chips) 
marquitopoker4: posts the ante 6
Lokobarys Ninja: posts the ante 6
4RING8: posts the ante 6
jcarlos.vale: posts the ante 6
RCABelVedeRVerd: posts the ante 6
Mimishka004: posts the ante 6
kalimero1848: posts the ante 6
84nurik84: posts the ante 6
48621537590: posts the ante 6
48621537590: posts small blind 25
marquitopoker4: posts big blind 50
*** HOLE CARDS ***
Dealt to jcarlos.vale [Ac As]
Lokobarys Ninja: raises 50 to 100
4RING8: folds 
jcarlos.vale: raises 150 to 250
RCABelVedeRVerd: folds 
Mimishka004: folds 
kalimero1848: folds 
84nurik84: folds 
48621537590: folds 
marquitopoker4: folds 
Lokobarys Ninja: folds 
Uncalled bet (150) returned to jcarlos.vale
jcarlos.vale collected 329 from pot
jcarlos.vale: doesn't show hand 
*** SUMMARY ***
Total pot 329 | Rake 0 
Seat 1: marquitopoker4 (big blind) folded before Flop
Seat 2: Lokobarys Ninja folded before Flop
Seat 3: 4RING8 folded before Flop (didn't bet)
Seat 4: jcarlos.vale collected (329)
Seat 5: RCABelVedeRVerd folded before Flop (didn't bet)
Seat 6: Mimishka004 folded before Flop (didn't bet)
Seat 7: kalimero1848 folded before Flop (didn't bet)
Seat 8: 84nurik84 (button) folded before Flop (didn't bet)
Seat 9: 48621537590 (small blind) folded before Flop



PokerStars Hand #222098148713: Tournament #3082583698, $0.98+$0.12 USD Hold'em No Limit - Level III (25/50) - 2021/01/01 20:28:23 EET [2021/01/01 13:28:23 ET]
Table '3082583698 30' 9-max Seat #9 is the button
Seat 1: marquitopoker4 (4251 in chips) 
Seat 2: Lokobarys Ninja (4890 in chips) 
Seat 3: 4RING8 (6337 in chips) 
Seat 4: jcarlos.vale (5419 in chips) 
Seat 5: RCABelVedeRVerd (5337 in chips) 
Seat 6: Mimishka004 (4953 in chips) 
Seat 7: kalimero1848 (4368 in chips) 
Seat 8: 84nurik84 (4084 in chips) 
Seat 9: 48621537590 (4692 in chips) 
marquitopoker4: posts the ante 6
Lokobarys Ninja: posts the ante 6
4RING8: posts the ante 6
jcarlos.vale: posts the ante 6
RCABelVedeRVerd: posts the ante 6
Mimishka004: posts the ante 6
kalimero1848: posts the ante 6
84nurik84: posts the ante 6
48621537590: posts the ante 6
marquitopoker4: posts small blind 25
Lokobarys Ninja: posts big blind 50
*** HOLE CARDS ***
Dealt to jcarlos.vale [4d 2h]
4RING8: folds 
jcarlos.vale: folds 
RCABelVedeRVerd: folds 
Mimishka004: folds 
kalimero1848: folds 
84nurik84: folds 
48621537590: folds 
marquitopoker4: calls 25
Lokobarys Ninja has timed out
Lokobarys Ninja: checks 
*** FLOP *** [9d Tc Qc]
marquitopoker4: bets 50
Lokobarys Ninja: folds 
Uncalled bet (50) returned to marquitopoker4
marquitopoker4 collected 154 from pot
marquitopoker4: doesn't show hand 
*** SUMMARY ***
Total pot 154 | Rake 0 
Board [9d Tc Qc]
Seat 1: marquitopoker4 (small blind) collected (154)
Seat 2: Lokobarys Ninja (big blind) folded on the Flop
Seat 3: 4RING8 folded before Flop (didn't bet)
Seat 4: jcarlos.vale folded before Flop (didn't bet)
Seat 5: RCABelVedeRVerd folded before Flop (didn't bet)
Seat 6: Mimishka004 folded before Flop (didn't bet)
Seat 7: kalimero1848 folded before Flop (didn't bet)
Seat 8: 84nurik84 folded before Flop (didn't bet)
Seat 9: 48621537590 (button) folded before Flop (didn't bet)



PokerStars Hand #222098207164: Tournament #3082583698, $0.98+$0.12 USD Hold'em No Limit - Level III (25/50) - 2021/01/01 20:29:19 EET [2021/01/01 13:29:19 ET]
Table '3082583698 30' 9-max Seat #1 is the button
Seat 1: marquitopoker4 (4349 in chips) 
Seat 2: Lokobarys Ninja (4834 in chips) 
Seat 3: 4RING8 (6331 in chips) 
Seat 4: jcarlos.vale (5413 in chips) 
Seat 5: RCABelVedeRVerd (5331 in chips) 
Seat 6: Mimishka004 (4947 in chips) 
Seat 7: kalimero1848 (4362 in chips) 
Seat 8: 84nurik84 (4078 in chips) 
Seat 9: 48621537590 (4686 in chips) 
marquitopoker4: posts the ante 6
Lokobarys Ninja: posts the ante 6
4RING8: posts the ante 6
jcarlos.vale: posts the ante 6
RCABelVedeRVerd: posts the ante 6
Mimishka004: posts the ante 6
kalimero1848: posts the ante 6
84nurik84: posts the ante 6
48621537590: posts the ante 6
Lokobarys Ninja: posts small blind 25
4RING8: posts big blind 50
*** HOLE CARDS ***
Dealt to jcarlos.vale [As Td]
jcarlos.vale: raises 80 to 130
RCABelVedeRVerd: folds 
Mimishka004: folds 
kalimero1848: folds 
84nurik84: folds 
48621537590: folds 
marquitopoker4: folds 
Lokobarys Ninja: calls 105
4RING8: folds 
*** FLOP *** [9c Jh 3h]
kalimero1848 is sitting out
Lokobarys Ninja: checks 
jcarlos.vale: checks 
*** TURN *** [9c Jh 3h] [Ac]
Lokobarys Ninja: checks 
jcarlos.vale: bets 150
Lokobarys Ninja: folds 
Uncalled bet (150) returned to jcarlos.vale
kalimero1848 has returned
jcarlos.vale collected 364 from pot
jcarlos.vale: doesn't show hand 
*** SUMMARY ***
Total pot 364 | Rake 0 
Board [9c Jh 3h Ac]
Seat 1: marquitopoker4 (button) folded before Flop (didn't bet)
Seat 2: Lokobarys Ninja (small blind) folded on the Turn
Seat 3: 4RING8 (big blind) folded before Flop
Seat 4: jcarlos.vale collected (364)
Seat 5: RCABelVedeRVerd folded before Flop (didn't bet)
Seat 6: Mimishka004 folded before Flop (didn't bet)
Seat 7: kalimero1848 folded before Flop (didn't bet)
Seat 8: 84nurik84 folded before Flop (didn't bet)
Seat 9: 48621537590 folded before Flop (didn't bet)



PokerStars Hand #222098273226: Tournament #3082583698, $0.98+$0.12 USD Hold'em No Limit - Level IV (30/60) - 2021/01/01 20:30:23 EET [2021/01/01 13:30:23 ET]
Table '3082583698 30' 9-max Seat #2 is the button
Seat 1: marquitopoker4 (4343 in chips) 
Seat 2: Lokobarys Ninja (4698 in chips) 
Seat 3: 4RING8 (6275 in chips) 
Seat 4: jcarlos.vale (5641 in chips) 
Seat 5: RCABelVedeRVerd (5325 in chips) 
Seat 6: Mimishka004 (4941 in chips) 
Seat 7: kalimero1848 (4356 in chips) 
Seat 8: 84nurik84 (4072 in chips) 
Seat 9: 48621537590 (4680 in chips) 
marquitopoker4: posts the ante 8
Lokobarys Ninja: posts the ante 8
4RING8: posts the ante 8
jcarlos.vale: posts the ante 8
RCABelVedeRVerd: posts the ante 8
Mimishka004: posts the ante 8
kalimero1848: posts the ante 8
84nurik84: posts the ante 8
48621537590: posts the ante 8
4RING8: posts small blind 30
jcarlos.vale: posts big blind 60
*** HOLE CARDS ***
Dealt to jcarlos.vale [Ac Ts]
RCABelVedeRVerd: folds 
Mimishka004: folds 
kalimero1848: folds 
84nurik84: raises 90 to 150
48621537590: folds 
marquitopoker4: folds 
Lokobarys Ninja: folds 
4RING8: folds 
jcarlos.vale: calls 90
*** FLOP *** [Ks Kh Qd]
jcarlos.vale: checks 
84nurik84: bets 201
jcarlos.vale: folds 
Uncalled bet (201) returned to 84nurik84
84nurik84 collected 402 from pot
84nurik84: doesn't show hand 
*** SUMMARY ***
Total pot 402 | Rake 0 
Board [Ks Kh Qd]
Seat 1: marquitopoker4 folded before Flop (didn't bet)
Seat 2: Lokobarys Ninja (button) folded before Flop (didn't bet)
Seat 3: 4RING8 (small blind) folded before Flop
Seat 4: jcarlos.vale (big blind) folded on the Flop
Seat 5: RCABelVedeRVerd folded before Flop (didn't bet)
Seat 6: Mimishka004 folded before Flop (didn't bet)
Seat 7: kalimero1848 folded before Flop (didn't bet)
Seat 8: 84nurik84 collected (402)
Seat 9: 48621537590 folded before Flop (didn't bet)



PokerStars Hand #222098316749: Tournament #3082583698, $0.98+$0.12 USD Hold'em No Limit - Level IV (30/60) - 2021/01/01 20:31:05 EET [2021/01/01 13:31:05 ET]
Table '3082583698 30' 9-max Seat #3 is the button
Seat 1: marquitopoker4 (4335 in chips) 
Seat 2: Lokobarys Ninja (4690 in chips) 
Seat 3: 4RING8 (6237 in chips) 
Seat 4: jcarlos.vale (5483 in chips) 
Seat 5: RCABelVedeRVerd (5317 in chips) 
Seat 6: Mimishka004 (4933 in chips) 
Seat 7: kalimero1848 (4348 in chips) 
Seat 8: 84nurik84 (4316 in chips) 
Seat 9: 48621537590 (4672 in chips) 
marquitopoker4: posts the ante 8
Lokobarys Ninja: posts the ante 8
4RING8: posts the ante 8
jcarlos.vale: posts the ante 8
RCABelVedeRVerd: posts the ante 8
Mimishka004: posts the ante 8
kalimero1848: posts the ante 8
84nurik84: posts the ante 8
48621537590: posts the ante 8
jcarlos.vale: posts small blind 30
RCABelVedeRVerd: posts big blind 60
*** HOLE CARDS ***
Dealt to jcarlos.vale [As 7h]
Mimishka004: folds 
kalimero1848: folds 
84nurik84: folds 
48621537590: folds 
marquitopoker4: folds 
Lokobarys Ninja: raises 90 to 150
4RING8: calls 150
jcarlos.vale: folds 
RCABelVedeRVerd: folds 
*** FLOP *** [8h 9s 3c]
Lokobarys Ninja: checks 
4RING8: checks 
*** TURN *** [8h 9s 3c] [Kd]
Lokobarys Ninja: bets 180
4RING8: folds 
Uncalled bet (180) returned to Lokobarys Ninja
Lokobarys Ninja collected 462 from pot
Lokobarys Ninja: shows [Ks Ah] (a pair of Kings)
*** SUMMARY ***
Total pot 462 | Rake 0 
Board [8h 9s 3c Kd]
Seat 1: marquitopoker4 folded before Flop (didn't bet)
Seat 2: Lokobarys Ninja collected (462)
Seat 3: 4RING8 (button) folded on the Turn
Seat 4: jcarlos.vale (small blind) folded before Flop
Seat 5: RCABelVedeRVerd (big blind) folded before Flop
Seat 6: Mimishka004 folded before Flop (didn't bet)
Seat 7: kalimero1848 folded before Flop (didn't bet)
Seat 8: 84nurik84 folded before Flop (didn't bet)
Seat 9: 48621537590 folded before Flop (didn't bet)



PokerStars Hand #222098383394: Tournament #3082583698, $0.98+$0.12 USD Hold'em No Limit - Level IV (30/60) - 2021/01/01 20:32:02 EET [2021/01/01 13:32:02 ET]
Table '3082583698 30' 9-max Seat #4 is the button
Seat 1: marquitopoker4 (4327 in chips) 
Seat 2: Lokobarys Ninja (4994 in chips) 
Seat 3: 4RING8 (6079 in chips) 
Seat 4: jcarlos.vale (5445 in chips) 
Seat 5: RCABelVedeRVerd (5249 in chips) 
Seat 6: Mimishka004 (4925 in chips) 
Seat 7: kalimero1848 (4340 in chips) 
Seat 8: 84nurik84 (4308 in chips) 
Seat 9: 48621537590 (4664 in chips) 
marquitopoker4: posts the ante 8
Lokobarys Ninja: posts the ante 8
4RING8: posts the ante 8
jcarlos.vale: posts the ante 8
RCABelVedeRVerd: posts the ante 8
Mimishka004: posts the ante 8
kalimero1848: posts the ante 8
84nurik84: posts the ante 8
48621537590: posts the ante 8
RCABelVedeRVerd: posts small blind 30
Mimishka004: posts big blind 60
*** HOLE CARDS ***
Dealt to jcarlos.vale [4s 3h]
kalimero1848: calls 60
84nurik84: folds 
48621537590: folds 
marquitopoker4: folds 
Lokobarys Ninja: raises 270 to 330
4RING8: folds 
jcarlos.vale: folds 
RCABelVedeRVerd: folds 
Mimishka004: raises 540 to 870
kalimero1848: folds 
Lokobarys Ninja: folds 
Uncalled bet (540) returned to Mimishka004
Mimishka004 collected 822 from pot
*** SUMMARY ***
Total pot 822 | Rake 0 
Seat 1: marquitopoker4 folded before Flop (didn't bet)
Seat 2: Lokobarys Ninja folded before Flop
Seat 3: 4RING8 folded before Flop (didn't bet)
Seat 4: jcarlos.vale (button) folded before Flop (didn't bet)
Seat 5: RCABelVedeRVerd (small blind) folded before Flop
Seat 6: Mimishka004 (big blind) collected (822)
Seat 7: kalimero1848 folded before Flop
Seat 8: 84nurik84 folded before Flop (didn't bet)
Seat 9: 48621537590 folded before Flop (didn't bet)



PokerStars Hand #222098432929: Tournament #3082583698, $0.98+$0.12 USD Hold'em No Limit - Level IV (30/60) - 2021/01/01 20:32:50 EET [2021/01/01 13:32:50 ET]
Table '3082583698 30' 9-max Seat #5 is the button
Seat 1: marquitopoker4 (4319 in chips) 
Seat 2: Lokobarys Ninja (4656 in chips) 
Seat 3: 4RING8 (6071 in chips) 
Seat 4: jcarlos.vale (5437 in chips) 
Seat 5: RCABelVedeRVerd (5211 in chips) 
Seat 6: Mimishka004 (5409 in chips) 
Seat 7: kalimero1848 (4272 in chips) 
Seat 8: 84nurik84 (4300 in chips) 
Seat 9: 48621537590 (4656 in chips) 
marquitopoker4: posts the ante 8
Lokobarys Ninja: posts the ante 8
4RING8: posts the ante 8
jcarlos.vale: posts the ante 8
RCABelVedeRVerd: posts the ante 8
Mimishka004: posts the ante 8
kalimero1848: posts the ante 8
84nurik84: posts the ante 8
48621537590: posts the ante 8
Mimishka004: posts small blind 30
kalimero1848: posts big blind 60
*** HOLE CARDS ***
Dealt to jcarlos.vale [6h 4s]
84nurik84: folds 
48621537590: folds 
marquitopoker4: folds 
Lokobarys Ninja: folds 
4RING8: folds 
jcarlos.vale: folds 
RCABelVedeRVerd: calls 60
Mimishka004: folds 
kalimero1848: checks 
*** FLOP *** [9s Kc 9c]
kalimero1848: checks 
RCABelVedeRVerd: checks 
*** TURN *** [9s Kc 9c] [3c]
kalimero1848: checks 
RCABelVedeRVerd: checks 
*** RIVER *** [9s Kc 9c 3c] [7s]
kalimero1848: checks 
RCABelVedeRVerd: bets 100
kalimero1848: folds 
Uncalled bet (100) returned to RCABelVedeRVerd
RCABelVedeRVerd collected 222 from pot
*** SUMMARY ***
Total pot 222 | Rake 0 
Board [9s Kc 9c 3c 7s]
Seat 1: marquitopoker4 folded before Flop (didn't bet)
Seat 2: Lokobarys Ninja folded before Flop (didn't bet)
Seat 3: 4RING8 folded before Flop (didn't bet)
Seat 4: jcarlos.vale folded before Flop (didn't bet)
Seat 5: RCABelVedeRVerd (button) collected (222)
Seat 6: Mimishka004 (small blind) folded before Flop
Seat 7: kalimero1848 (big blind) folded on the River
Seat 8: 84nurik84 folded before Flop (didn't bet)
Seat 9: 48621537590 folded before Flop (didn't bet)



PokerStars Hand #222098475387: Tournament #3082583698, $0.98+$0.12 USD Hold'em No Limit - Level IV (30/60) - 2021/01/01 20:33:31 EET [2021/01/01 13:33:31 ET]
Table '3082583698 30' 9-max Seat #6 is the button
Seat 1: marquitopoker4 (4311 in chips) 
Seat 2: Lokobarys Ninja (4648 in chips) 
Seat 3: 4RING8 (6063 in chips) 
Seat 4: jcarlos.vale (5429 in chips) 
Seat 5: RCABelVedeRVerd (5365 in chips) 
Seat 6: Mimishka004 (5371 in chips) 
Seat 7: kalimero1848 (4204 in chips) 
Seat 8: 84nurik84 (4292 in chips) 
Seat 9: 48621537590 (4648 in chips) 
marquitopoker4: posts the ante 8
Lokobarys Ninja: posts the ante 8
4RING8: posts the ante 8
jcarlos.vale: posts the ante 8
RCABelVedeRVerd: posts the ante 8
Mimishka004: posts the ante 8
kalimero1848: posts the ante 8
84nurik84: posts the ante 8
48621537590: posts the ante 8
kalimero1848: posts small blind 30
84nurik84: posts big blind 60
*** HOLE CARDS ***
Dealt to jcarlos.vale [Td Ah]
48621537590: folds 
marquitopoker4: folds 
Lokobarys Ninja: folds 
4RING8: folds 
jcarlos.vale: raises 96 to 156
RCABelVedeRVerd: folds 
Mimishka004: folds 
kalimero1848: folds 
84nurik84: folds 
Uncalled bet (96) returned to jcarlos.vale
jcarlos.vale collected 222 from pot
jcarlos.vale: doesn't show hand 
*** SUMMARY ***
Total pot 222 | Rake 0 
Seat 1: marquitopoker4 folded before Flop (didn't bet)
Seat 2: Lokobarys Ninja folded before Flop (didn't bet)
Seat 3: 4RING8 folded before Flop (didn't bet)
Seat 4: jcarlos.vale collected (222)
Seat 5: RCABelVedeRVerd folded before Flop (didn't bet)
Seat 6: Mimishka004 (button) folded before Flop (didn't bet)
Seat 7: kalimero1848 (small blind) folded before Flop
Seat 8: 84nurik84 (big blind) folded before Flop
Seat 9: 48621537590 folded before Flop (didn't bet)



PokerStars Hand #222098514498: Tournament #3082583698, $0.98+$0.12 USD Hold'em No Limit - Level IV (30/60) - 2021/01/01 20:34:10 EET [2021/01/01 13:34:10 ET]
Table '3082583698 30' 9-max Seat #7 is the button
Seat 1: marquitopoker4 (4303 in chips) 
Seat 2: Lokobarys Ninja (4640 in chips) 
Seat 3: 4RING8 (6055 in chips) 
Seat 4: jcarlos.vale (5583 in chips) 
Seat 5: RCABelVedeRVerd (5357 in chips) 
Seat 6: Mimishka004 (5363 in chips) 
Seat 7: kalimero1848 (4166 in chips) 
Seat 8: 84nurik84 (4224 in chips) 
Seat 9: 48621537590 (4640 in chips) 
marquitopoker4: posts the ante 8
Lokobarys Ninja: posts the ante 8
4RING8: posts the ante 8
jcarlos.vale: posts the ante 8
RCABelVedeRVerd: posts the ante 8
Mimishka004: posts the ante 8
kalimero1848: posts the ante 8
84nurik84: posts the ante 8
48621537590: posts the ante 8
84nurik84: posts small blind 30
48621537590: posts big blind 60
*** HOLE CARDS ***
Dealt to jcarlos.vale [Tc Qd]
marquitopoker4: folds 
Lokobarys Ninja: folds 
4RING8: folds 
jcarlos.vale: folds 
RCABelVedeRVerd: folds 
Mimishka004: folds 
kalimero1848: folds 
84nurik84: calls 30
48621537590: checks 
*** FLOP *** [7h 5s 4s]
84nurik84: bets 63
48621537590: calls 63
*** TURN *** [7h 5s 4s] [6h]
84nurik84: bets 239
48621537590: raises 239 to 478
84nurik84: raises 542 to 1020
48621537590: calls 542
*** RIVER *** [7h 5s 4s 6h] [9c]
84nurik84: bets 3073 and is all-in
48621537590: folds 
Uncalled bet (3073) returned to 84nurik84
84nurik84 collected 2358 from pot
84nurik84: doesn't show hand 
*** SUMMARY ***
Total pot 2358 | Rake 0 
Board [7h 5s 4s 6h 9c]
Seat 1: marquitopoker4 folded before Flop (didn't bet)
Seat 2: Lokobarys Ninja folded before Flop (didn't bet)
Seat 3: 4RING8 folded before Flop (didn't bet)
Seat 4: jcarlos.vale folded before Flop (didn't bet)
Seat 5: RCABelVedeRVerd folded before Flop (didn't bet)
Seat 6: Mimishka004 folded before Flop (didn't bet)
Seat 7: kalimero1848 (button) folded before Flop (didn't bet)
Seat 8: 84nurik84 (small blind) collected (2358)
Seat 9: 48621537590 (big blind) folded on the River



PokerStars Hand #222098598312: Tournament #3082583698, $0.98+$0.12 USD Hold'em No Limit - Level IV (30/60) - 2021/01/01 20:35:32 EET [2021/01/01 13:35:32 ET]
Table '3082583698 30' 9-max Seat #8 is the button
Seat 1: marquitopoker4 (4295 in chips) 
Seat 2: Lokobarys Ninja (4632 in chips) 
Seat 3: 4RING8 (6047 in chips) 
Seat 4: jcarlos.vale (5575 in chips) 
Seat 5: RCABelVedeRVerd (5349 in chips) 
Seat 6: Mimishka004 (5355 in chips) 
Seat 7: kalimero1848 (4158 in chips) 
Seat 8: 84nurik84 (5431 in chips) 
Seat 9: 48621537590 (3489 in chips) 
marquitopoker4: posts the ante 8
Lokobarys Ninja: posts the ante 8
4RING8: posts the ante 8
jcarlos.vale: posts the ante 8
RCABelVedeRVerd: posts the ante 8
Mimishka004: posts the ante 8
kalimero1848: posts the ante 8
84nurik84: posts the ante 8
48621537590: posts the ante 8
48621537590: posts small blind 30
marquitopoker4: posts big blind 60
*** HOLE CARDS ***
Dealt to jcarlos.vale [Kd 3h]
Lokobarys Ninja: folds 
4RING8: raises 70 to 130
jcarlos.vale: folds 
RCABelVedeRVerd: folds 
Mimishka004: folds 
kalimero1848: calls 130
84nurik84: folds 
48621537590: folds 
marquitopoker4: calls 70
*** FLOP *** [2d Ac 3s]
marquitopoker4: checks 
4RING8: bets 162
kalimero1848: calls 162
marquitopoker4: folds 
*** TURN *** [2d Ac 3s] [Th]
4RING8: checks 
kalimero1848: checks 
*** RIVER *** [2d Ac 3s Th] [2h]
4RING8: checks 
kalimero1848: checks 
*** SHOW DOWN ***
4RING8: shows [Qs Ad] (two pair, Aces and Deuces)
kalimero1848: mucks hand 
4RING8 collected 816 from pot
*** SUMMARY ***
Total pot 816 | Rake 0 
Board [2d Ac 3s Th 2h]
Seat 1: marquitopoker4 (big blind) folded on the Flop
Seat 2: Lokobarys Ninja folded before Flop (didn't bet)
Seat 3: 4RING8 showed [Qs Ad] and won (816) with two pair, Aces and Deuces
Seat 4: jcarlos.vale folded before Flop (didn't bet)
Seat 5: RCABelVedeRVerd folded before Flop (didn't bet)
Seat 6: Mimishka004 folded before Flop (didn't bet)
Seat 7: kalimero1848 mucked [6s 4s]
Seat 8: 84nurik84 (button) folded before Flop (didn't bet)
Seat 9: 48621537590 (small blind) folded before Flop



PokerStars Hand #222098651970: Tournament #3082583698, $0.98+$0.12 USD Hold'em No Limit - Level IV (30/60) - 2021/01/01 20:36:24 EET [2021/01/01 13:36:24 ET]
Table '3082583698 30' 9-max Seat #9 is the button
Seat 1: marquitopoker4 (4157 in chips) 
Seat 2: Lokobarys Ninja (4624 in chips) 
Seat 3: 4RING8 (6563 in chips) 
Seat 4: jcarlos.vale (5567 in chips) 
Seat 5: RCABelVedeRVerd (5341 in chips) 
Seat 6: Mimishka004 (5347 in chips) 
Seat 7: kalimero1848 (3858 in chips) 
Seat 8: 84nurik84 (5423 in chips) 
Seat 9: 48621537590 (3451 in chips) 
marquitopoker4: posts the ante 8
Lokobarys Ninja: posts the ante 8
4RING8: posts the ante 8
jcarlos.vale: posts the ante 8
RCABelVedeRVerd: posts the ante 8
Mimishka004: posts the ante 8
kalimero1848: posts the ante 8
84nurik84: posts the ante 8
48621537590: posts the ante 8
marquitopoker4: posts small blind 30
Lokobarys Ninja: posts big blind 60
*** HOLE CARDS ***
Dealt to jcarlos.vale [7c 6c]
4RING8: folds 
jcarlos.vale: raises 96 to 156
RCABelVedeRVerd: folds 
Mimishka004: calls 156
kalimero1848: calls 156
84nurik84: folds 
48621537590: folds 
marquitopoker4: folds 
Lokobarys Ninja: folds 
*** FLOP *** [Ah Qs 5c]
jcarlos.vale: checks 
Mimishka004: checks 
kalimero1848: checks 
*** TURN *** [Ah Qs 5c] [8c]
jcarlos.vale: bets 120
Mimishka004: folds 
kalimero1848: calls 120
*** RIVER *** [Ah Qs 5c 8c] [9c]
jcarlos.vale: bets 120
kalimero1848: raises 300 to 420
jcarlos.vale: raises 420 to 840
kalimero1848: raises 2734 to 3574 and is all-in
jcarlos.vale: calls 2734
*** SHOW DOWN ***
kalimero1848: shows [Ac Tc] (a flush, Ace high)
jcarlos.vale: shows [7c 6c] (a straight flush, Five to Nine)
jcarlos.vale collected 8018 from pot
kalimero1848 finished the tournament
*** SUMMARY ***
Total pot 8018 | Rake 0 
Board [Ah Qs 5c 8c 9c]
Seat 1: marquitopoker4 (small blind) folded before Flop
Seat 2: Lokobarys Ninja (big blind) folded before Flop
Seat 3: 4RING8 folded before Flop (didn't bet)
Seat 4: jcarlos.vale showed [7c 6c] and won (8018) with a straight flush, Five to Nine
Seat 5: RCABelVedeRVerd folded before Flop (didn't bet)
Seat 6: Mimishka004 folded on the Turn
Seat 7: kalimero1848 showed [Ac Tc] and lost with a flush, Ace high
Seat 8: 84nurik84 folded before Flop (didn't bet)
Seat 9: 48621537590 (button) folded before Flop (didn't bet)



PokerStars Hand #222098741886: Tournament #3082583698, $0.98+$0.12 USD Hold'em No Limit - Level IV (30/60) - 2021/01/01 20:37:50 EET [2021/01/01 13:37:50 ET]
Table '3082583698 30' 9-max Seat #1 is the button
Seat 1: marquitopoker4 (4119 in chips) 
Seat 2: Lokobarys Ninja (4556 in chips) 
Seat 3: 4RING8 (6555 in chips) 
Seat 4: jcarlos.vale (9727 in chips) 
Seat 5: RCABelVedeRVerd (5333 in chips) 
Seat 6: Mimishka004 (5183 in chips) 
Seat 8: 84nurik84 (5415 in chips) 
Seat 9: 48621537590 (3443 in chips) 
marquitopoker4: posts the ante 8
Lokobarys Ninja: posts the ante 8
4RING8: posts the ante 8
jcarlos.vale: posts the ante 8
RCABelVedeRVerd: posts the ante 8
Mimishka004: posts the ante 8
84nurik84: posts the ante 8
48621537590: posts the ante 8
Lokobarys Ninja: posts small blind 30
4RING8: posts big blind 60
*** HOLE CARDS ***
Dealt to jcarlos.vale [9c Ah]
jcarlos.vale: folds 
RCABelVedeRVerd: folds 
Mimishka004: folds 
84nurik84: folds 
48621537590: folds 
marquitopoker4: folds 
Lokobarys Ninja: folds 
Uncalled bet (30) returned to 4RING8
4RING8 collected 124 from pot
*** SUMMARY ***
Total pot 124 | Rake 0 
Seat 1: marquitopoker4 (button) folded before Flop (didn't bet)
Seat 2: Lokobarys Ninja (small blind) folded before Flop
Seat 3: 4RING8 (big blind) collected (124)
Seat 4: jcarlos.vale folded before Flop (didn't bet)
Seat 5: RCABelVedeRVerd folded before Flop (didn't bet)
Seat 6: Mimishka004 folded before Flop (didn't bet)
Seat 8: 84nurik84 folded before Flop (didn't bet)
Seat 9: 48621537590 folded before Flop (didn't bet)



PokerStars Hand #222098790941: Tournament #3082583698, $0.98+$0.12 USD Hold'em No Limit - Level IV (30/60) - 2021/01/01 20:38:37 EET [2021/01/01 13:38:37 ET]
Table '3082583698 30' 9-max Seat #2 is the button
Seat 1: marquitopoker4 (4111 in chips) 
Seat 2: Lokobarys Ninja (4518 in chips) 
Seat 3: 4RING8 (6641 in chips) 
Seat 4: jcarlos.vale (9719 in chips) 
Seat 5: RCABelVedeRVerd (5325 in chips) 
Seat 6: Mimishka004 (5175 in chips) 
Seat 7: richard5189 (2730 in chips) 
Seat 8: 84nurik84 (5407 in chips) 
Seat 9: 48621537590 (3435 in chips) 
marquitopoker4: posts the ante 8
Lokobarys Ninja: posts the ante 8
4RING8: posts the ante 8
jcarlos.vale: posts the ante 8
RCABelVedeRVerd: posts the ante 8
Mimishka004: posts the ante 8
richard5189: posts the ante 8
84nurik84: posts the ante 8
48621537590: posts the ante 8
4RING8: posts small blind 30
jcarlos.vale: posts big blind 60
*** HOLE CARDS ***
Dealt to jcarlos.vale [Kh 3s]
RCABelVedeRVerd has timed out
RCABelVedeRVerd: folds 
RCABelVedeRVerd is sitting out
Mimishka004: folds 
richard5189: calls 60
84nurik84: calls 60
48621537590: folds 
RCABelVedeRVerd has returned
marquitopoker4: folds 
Lokobarys Ninja: raises 180 to 240
4RING8: folds 
jcarlos.vale: folds 
richard5189: calls 180
84nurik84: calls 180
*** FLOP *** [Ac 7h 2h]
richard5189: bets 441
84nurik84: folds 
Lokobarys Ninja: folds 
Uncalled bet (441) returned to richard5189
richard5189 collected 882 from pot
richard5189: doesn't show hand 
*** SUMMARY ***
Total pot 882 | Rake 0 
Board [Ac 7h 2h]
Seat 1: marquitopoker4 folded before Flop (didn't bet)
Seat 2: Lokobarys Ninja (button) folded on the Flop
Seat 3: 4RING8 (small blind) folded before Flop
Seat 4: jcarlos.vale (big blind) folded before Flop
Seat 5: RCABelVedeRVerd folded before Flop (didn't bet)
Seat 6: Mimishka004 folded before Flop (didn't bet)
Seat 7: richard5189 collected (882)
Seat 8: 84nurik84 folded on the Flop
Seat 9: 48621537590 folded before Flop (didn't bet)



PokerStars Hand #222098858636: Tournament #3082583698, $0.98+$0.12 USD Hold'em No Limit - Level IV (30/60) - 2021/01/01 20:39:43 EET [2021/01/01 13:39:43 ET]
Table '3082583698 30' 9-max Seat #3 is the button
Seat 1: marquitopoker4 (4103 in chips) 
Seat 2: Lokobarys Ninja (4270 in chips) 
Seat 3: 4RING8 (6603 in chips) 
Seat 4: jcarlos.vale (9651 in chips) 
Seat 5: RCABelVedeRVerd (5317 in chips) 
Seat 6: Mimishka004 (5167 in chips) 
Seat 7: richard5189 (3364 in chips) 
Seat 8: 84nurik84 (5159 in chips) 
Seat 9: 48621537590 (3427 in chips) 
marquitopoker4: posts the ante 8
Lokobarys Ninja: posts the ante 8
4RING8: posts the ante 8
jcarlos.vale: posts the ante 8
RCABelVedeRVerd: posts the ante 8
Mimishka004: posts the ante 8
richard5189: posts the ante 8
84nurik84: posts the ante 8
48621537590: posts the ante 8
jcarlos.vale: posts small blind 30
RCABelVedeRVerd: posts big blind 60
*** HOLE CARDS ***
Dealt to jcarlos.vale [8d 7h]
Mimishka004: folds 
richard5189: folds 
84nurik84: raises 72 to 132
48621537590: folds 
marquitopoker4: folds 
Lokobarys Ninja: folds 
4RING8: folds 
jcarlos.vale: folds 
RCABelVedeRVerd: calls 72
*** FLOP *** [Qh 4d Js]
RCABelVedeRVerd: checks 
84nurik84: checks 
*** TURN *** [Qh 4d Js] [Jd]
RCABelVedeRVerd: checks 
84nurik84: checks 
*** RIVER *** [Qh 4d Js Jd] [5s]
RCABelVedeRVerd: checks 
84nurik84: checks 
*** SHOW DOWN ***
RCABelVedeRVerd: shows [9d 8c] (a pair of Jacks)
84nurik84: shows [Ac 6c] (a pair of Jacks - Ace kicker)
84nurik84 collected 366 from pot
*** SUMMARY ***
Total pot 366 | Rake 0 
Board [Qh 4d Js Jd 5s]
Seat 1: marquitopoker4 folded before Flop (didn't bet)
Seat 2: Lokobarys Ninja folded before Flop (didn't bet)
Seat 3: 4RING8 (button) folded before Flop (didn't bet)
Seat 4: jcarlos.vale (small blind) folded before Flop
Seat 5: RCABelVedeRVerd (big blind) showed [9d 8c] and lost with a pair of Jacks
Seat 6: Mimishka004 folded before Flop (didn't bet)
Seat 7: richard5189 folded before Flop (didn't bet)
Seat 8: 84nurik84 showed [Ac 6c] and won (366) with a pair of Jacks
Seat 9: 48621537590 folded before Flop (didn't bet)



PokerStars Hand #222098952261: Tournament #3082583698, $0.98+$0.12 USD Hold'em No Limit - Level V (40/80) - 2021/01/01 20:41:14 EET [2021/01/01 13:41:14 ET]
Table '3082583698 30' 9-max Seat #4 is the button
Seat 1: marquitopoker4 (4095 in chips) 
Seat 2: Lokobarys Ninja (4262 in chips) 
Seat 3: 4RING8 (6595 in chips) 
Seat 4: jcarlos.vale (9613 in chips) 
Seat 5: RCABelVedeRVerd (5177 in chips) 
Seat 6: Mimishka004 (5159 in chips) 
Seat 7: richard5189 (3356 in chips) 
Seat 8: 84nurik84 (5385 in chips) 
Seat 9: 48621537590 (3419 in chips) 
marquitopoker4: posts the ante 9
Lokobarys Ninja: posts the ante 9
4RING8: posts the ante 9
jcarlos.vale: posts the ante 9
RCABelVedeRVerd: posts the ante 9
Mimishka004: posts the ante 9
richard5189: posts the ante 9
84nurik84: posts the ante 9
48621537590: posts the ante 9
RCABelVedeRVerd: posts small blind 40
Mimishka004: posts big blind 80
*** HOLE CARDS ***
Dealt to jcarlos.vale [Kh 5s]
richard5189: folds 
84nurik84: folds 
48621537590: folds 
marquitopoker4: raises 111 to 191
Lokobarys Ninja: folds 
4RING8: folds 
jcarlos.vale: folds 
RCABelVedeRVerd has timed out
RCABelVedeRVerd: folds 
RCABelVedeRVerd is sitting out
Mimishka004: folds 
Uncalled bet (111) returned to marquitopoker4
marquitopoker4 collected 281 from pot
marquitopoker4: doesn't show hand 
*** SUMMARY ***
Total pot 281 | Rake 0 
Seat 1: marquitopoker4 collected (281)
Seat 2: Lokobarys Ninja folded before Flop (didn't bet)
Seat 3: 4RING8 folded before Flop (didn't bet)
Seat 4: jcarlos.vale (button) folded before Flop (didn't bet)
Seat 5: RCABelVedeRVerd (small blind) folded before Flop
Seat 6: Mimishka004 (big blind) folded before Flop
Seat 7: richard5189 folded before Flop (didn't bet)
Seat 8: 84nurik84 folded before Flop (didn't bet)
Seat 9: 48621537590 folded before Flop (didn't bet)



PokerStars Hand #222098986301: Tournament #3082583698, $0.98+$0.12 USD Hold'em No Limit - Level V (40/80) - 2021/01/01 20:41:47 EET [2021/01/01 13:41:47 ET]
Table '3082583698 30' 9-max Seat #5 is the button
Seat 1: marquitopoker4 (4287 in chips) 
Seat 2: Lokobarys Ninja (4253 in chips) 
Seat 3: 4RING8 (6586 in chips) 
Seat 4: jcarlos.vale (9604 in chips) 
Seat 5: RCABelVedeRVerd (5128 in chips) is sitting out
Seat 6: Mimishka004 (5070 in chips) 
Seat 7: richard5189 (3347 in chips) 
Seat 8: 84nurik84 (5376 in chips) 
Seat 9: 48621537590 (3410 in chips) 
marquitopoker4: posts the ante 9
Lokobarys Ninja: posts the ante 9
4RING8: posts the ante 9
jcarlos.vale: posts the ante 9
RCABelVedeRVerd: posts the ante 9
Mimishka004: posts the ante 9
richard5189: posts the ante 9
84nurik84: posts the ante 9
48621537590: posts the ante 9
Mimishka004: posts small blind 40
richard5189: posts big blind 80
*** HOLE CARDS ***
Dealt to jcarlos.vale [6c 8s]
84nurik84: folds 
48621537590: folds 
marquitopoker4: raises 111 to 191
RCABelVedeRVerd has returned
Lokobarys Ninja: folds 
4RING8: folds 
jcarlos.vale: folds 
RCABelVedeRVerd: folds 
Mimishka004: folds 
richard5189: folds 
Uncalled bet (111) returned to marquitopoker4
marquitopoker4 collected 281 from pot
marquitopoker4: doesn't show hand 
*** SUMMARY ***
Total pot 281 | Rake 0 
Seat 1: marquitopoker4 collected (281)
Seat 2: Lokobarys Ninja folded before Flop (didn't bet)
Seat 3: 4RING8 folded before Flop (didn't bet)
Seat 4: jcarlos.vale folded before Flop (didn't bet)
Seat 5: RCABelVedeRVerd (button) folded before Flop (didn't bet)
Seat 6: Mimishka004 (small blind) folded before Flop
Seat 7: richard5189 (big blind) folded before Flop
Seat 8: 84nurik84 folded before Flop (didn't bet)
Seat 9: 48621537590 folded before Flop (didn't bet)



PokerStars Hand #222099034583: Tournament #3082583698, $0.98+$0.12 USD Hold'em No Limit - Level V (40/80) - 2021/01/01 20:42:34 EET [2021/01/01 13:42:34 ET]
Table '3082583698 30' 9-max Seat #6 is the button
Seat 1: marquitopoker4 (4479 in chips) 
Seat 2: Lokobarys Ninja (4244 in chips) 
Seat 3: 4RING8 (6577 in chips) 
Seat 4: jcarlos.vale (9595 in chips) 
Seat 5: RCABelVedeRVerd (5119 in chips) 
Seat 6: Mimishka004 (5021 in chips) 
Seat 7: richard5189 (3258 in chips) 
Seat 8: 84nurik84 (5367 in chips) 
Seat 9: 48621537590 (3401 in chips) 
marquitopoker4: posts the ante 9
Lokobarys Ninja: posts the ante 9
4RING8: posts the ante 9
jcarlos.vale: posts the ante 9
RCABelVedeRVerd: posts the ante 9
Mimishka004: posts the ante 9
richard5189: posts the ante 9
84nurik84: posts the ante 9
48621537590: posts the ante 9
richard5189: posts small blind 40
84nurik84: posts big blind 80
*** HOLE CARDS ***
Dealt to jcarlos.vale [7c Qs]
48621537590: folds 
marquitopoker4: folds 
Lokobarys Ninja: folds 
4RING8: folds 
jcarlos.vale: folds 
RCABelVedeRVerd: folds 
Mimishka004: folds 
richard5189: calls 40
84nurik84: checks 
*** FLOP *** [3h 9c 7d]
richard5189: bets 121
84nurik84: calls 121
*** TURN *** [3h 9c 7d] [7s]
richard5189: bets 242
84nurik84: calls 242
*** RIVER *** [3h 9c 7d 7s] [2d]
richard5189: checks 
84nurik84: checks 
*** SHOW DOWN ***
richard5189: shows [9d 3s] (two pair, Nines and Sevens)
84nurik84: shows [9h 5s] (two pair, Nines and Sevens - Five kicker)
84nurik84 collected 967 from pot
*** SUMMARY ***
Total pot 967 | Rake 0 
Board [3h 9c 7d 7s 2d]
Seat 1: marquitopoker4 folded before Flop (didn't bet)
Seat 2: Lokobarys Ninja folded before Flop (didn't bet)
Seat 3: 4RING8 folded before Flop (didn't bet)
Seat 4: jcarlos.vale folded before Flop (didn't bet)
Seat 5: RCABelVedeRVerd folded before Flop (didn't bet)
Seat 6: Mimishka004 (button) folded before Flop (didn't bet)
Seat 7: richard5189 (small blind) showed [9d 3s] and lost with two pair, Nines and Sevens
Seat 8: 84nurik84 (big blind) showed [9h 5s] and won (967) with two pair, Nines and Sevens
Seat 9: 48621537590 folded before Flop (didn't bet)



PokerStars Hand #222099128924: Tournament #3082583698, $0.98+$0.12 USD Hold'em No Limit - Level V (40/80) - 2021/01/01 20:44:06 EET [2021/01/01 13:44:06 ET]
Table '3082583698 30' 9-max Seat #7 is the button
Seat 1: marquitopoker4 (4470 in chips) 
Seat 2: Lokobarys Ninja (4235 in chips) 
Seat 3: 4RING8 (6568 in chips) 
Seat 4: jcarlos.vale (9586 in chips) 
Seat 5: RCABelVedeRVerd (5110 in chips) 
Seat 6: Mimishka004 (5012 in chips) 
Seat 7: richard5189 (2806 in chips) 
Seat 8: 84nurik84 (5882 in chips) 
Seat 9: 48621537590 (3392 in chips) 
marquitopoker4: posts the ante 9
Lokobarys Ninja: posts the ante 9
4RING8: posts the ante 9
jcarlos.vale: posts the ante 9
RCABelVedeRVerd: posts the ante 9
Mimishka004: posts the ante 9
richard5189: posts the ante 9
84nurik84: posts the ante 9
48621537590: posts the ante 9
84nurik84: posts small blind 40
48621537590: posts big blind 80
*** HOLE CARDS ***
Dealt to jcarlos.vale [2h 2s]
marquitopoker4: folds 
Lokobarys Ninja: folds 
4RING8: folds 
jcarlos.vale: folds 
RCABelVedeRVerd has timed out
RCABelVedeRVerd: folds 
RCABelVedeRVerd is sitting out
Mimishka004: raises 84 to 164
richard5189: calls 164
84nurik84: calls 124
48621537590: folds 
*** FLOP *** [3h Qc 2c]
84nurik84: checks 
RCABelVedeRVerd has returned
Mimishka004: checks 
richard5189: checks 
*** TURN *** [3h Qc 2c] [7d]
84nurik84: checks 
Mimishka004: checks 
richard5189: checks 
*** RIVER *** [3h Qc 2c 7d] [Th]
84nurik84: checks 
Mimishka004: checks 
richard5189: checks 
*** SHOW DOWN ***
84nurik84: shows [9s 8s] (high card Queen)
Mimishka004: shows [5h Kh] (high card King)
richard5189: shows [Ah Ks] (high card Ace)
richard5189 collected 653 from pot
*** SUMMARY ***
Total pot 653 | Rake 0 
Board [3h Qc 2c 7d Th]
Seat 1: marquitopoker4 folded before Flop (didn't bet)
Seat 2: Lokobarys Ninja folded before Flop (didn't bet)
Seat 3: 4RING8 folded before Flop (didn't bet)
Seat 4: jcarlos.vale folded before Flop (didn't bet)
Seat 5: RCABelVedeRVerd folded before Flop (didn't bet)
Seat 6: Mimishka004 showed [5h Kh] and lost with high card King
Seat 7: richard5189 (button) showed [Ah Ks] and won (653) with high card Ace
Seat 8: 84nurik84 (small blind) showed [9s 8s] and lost with high card Queen
Seat 9: 48621537590 (big blind) folded before Flop



PokerStars Hand #222099207715: Tournament #3082583698, $0.98+$0.12 USD Hold'em No Limit - Level V (40/80) - 2021/01/01 20:45:23 EET [2021/01/01 13:45:23 ET]
Table '3082583698 30' 9-max Seat #8 is the button
Seat 1: marquitopoker4 (4461 in chips) 
Seat 2: Lokobarys Ninja (4226 in chips) 
Seat 3: 4RING8 (6559 in chips) 
Seat 4: jcarlos.vale (9577 in chips) 
Seat 5: RCABelVedeRVerd (5101 in chips) 
Seat 6: Mimishka004 (4839 in chips) 
Seat 7: richard5189 (3286 in chips) 
Seat 8: 84nurik84 (5709 in chips) 
Seat 9: 48621537590 (3303 in chips) 
marquitopoker4: posts the ante 9
Lokobarys Ninja: posts the ante 9
4RING8: posts the ante 9
jcarlos.vale: posts the ante 9
RCABelVedeRVerd: posts the ante 9
Mimishka004: posts the ante 9
richard5189: posts the ante 9
84nurik84: posts the ante 9
48621537590: posts the ante 9
48621537590: posts small blind 40
marquitopoker4: posts big blind 80
*** HOLE CARDS ***
Dealt to jcarlos.vale [7h Ah]
Lokobarys Ninja: raises 80 to 160
4RING8: folds 
jcarlos.vale: calls 160
RCABelVedeRVerd: folds 
Mimishka004: folds 
richard5189: folds 
84nurik84: folds 
48621537590: folds 
marquitopoker4: calls 80
*** FLOP *** [Kc 4d 8d]
marquitopoker4: checks 
Lokobarys Ninja: checks 
jcarlos.vale: checks 
*** TURN *** [Kc 4d 8d] [6h]
marquitopoker4: checks 
Lokobarys Ninja: bets 240
jcarlos.vale: folds 
marquitopoker4: folds 
Uncalled bet (240) returned to Lokobarys Ninja
Lokobarys Ninja collected 601 from pot
*** SUMMARY ***
Total pot 601 | Rake 0 
Board [Kc 4d 8d 6h]
Seat 1: marquitopoker4 (big blind) folded on the Turn
Seat 2: Lokobarys Ninja collected (601)
Seat 3: 4RING8 folded before Flop (didn't bet)
Seat 4: jcarlos.vale folded on the Turn
Seat 5: RCABelVedeRVerd folded before Flop (didn't bet)
Seat 6: Mimishka004 folded before Flop (didn't bet)
Seat 7: richard5189 folded before Flop (didn't bet)
Seat 8: 84nurik84 (button) folded before Flop (didn't bet)
Seat 9: 48621537590 (small blind) folded before Flop



PokerStars Hand #222099299097: Tournament #3082583698, $0.98+$0.12 USD Hold'em No Limit - Level V (40/80) - 2021/01/01 20:46:54 EET [2021/01/01 13:46:54 ET]
Table '3082583698 30' 9-max Seat #9 is the button
Seat 1: marquitopoker4 (4292 in chips) 
Seat 2: Lokobarys Ninja (4658 in chips) 
Seat 3: 4RING8 (6550 in chips) 
Seat 4: jcarlos.vale (9408 in chips) 
Seat 5: RCABelVedeRVerd (5092 in chips) 
Seat 6: Mimishka004 (4830 in chips) 
Seat 7: richard5189 (3277 in chips) 
Seat 8: 84nurik84 (5700 in chips) 
Seat 9: 48621537590 (3254 in chips) 
marquitopoker4: posts the ante 9
Lokobarys Ninja: posts the ante 9
4RING8: posts the ante 9
jcarlos.vale: posts the ante 9
RCABelVedeRVerd: posts the ante 9
Mimishka004: posts the ante 9
richard5189: posts the ante 9
84nurik84: posts the ante 9
48621537590: posts the ante 9
marquitopoker4: posts small blind 40
Lokobarys Ninja: posts big blind 80
*** HOLE CARDS ***
Dealt to jcarlos.vale [8h 7c]
4RING8: raises 94 to 174
jcarlos.vale: folds 
RCABelVedeRVerd: folds 
Mimishka004: folds 
richard5189: folds 
84nurik84: calls 174
48621537590: folds 
marquitopoker4: folds 
Lokobarys Ninja: calls 94
*** FLOP *** [9c 8c 7s]
Lokobarys Ninja: checks 
4RING8: checks 
84nurik84: checks 
*** TURN *** [9c 8c 7s] [Th]
Lokobarys Ninja: checks 
4RING8: checks 
84nurik84: bets 322
Lokobarys Ninja: folds 
4RING8: calls 322
*** RIVER *** [9c 8c 7s Th] [Tc]
4RING8: checks 
84nurik84: bets 425
4RING8: calls 425
*** SHOW DOWN ***
84nurik84: shows [Qd Js] (a straight, Eight to Queen)
4RING8: mucks hand 
84nurik84 collected 2137 from pot
*** SUMMARY ***
Total pot 2137 | Rake 0 
Board [9c 8c 7s Th Tc]
Seat 1: marquitopoker4 (small blind) folded before Flop
Seat 2: Lokobarys Ninja (big blind) folded on the Turn
Seat 3: 4RING8 mucked [6h Ah]
Seat 4: jcarlos.vale folded before Flop (didn't bet)
Seat 5: RCABelVedeRVerd folded before Flop (didn't bet)
Seat 6: Mimishka004 folded before Flop (didn't bet)
Seat 7: richard5189 folded before Flop (didn't bet)
Seat 8: 84nurik84 showed [Qd Js] and won (2137) with a straight, Eight to Queen
Seat 9: 48621537590 (button) folded before Flop (didn't bet)



PokerStars Hand #222099364947: Tournament #3082583698, $0.98+$0.12 USD Hold'em No Limit - Level V (40/80) - 2021/01/01 20:47:58 EET [2021/01/01 13:47:58 ET]
Table '3082583698 30' 9-max Seat #1 is the button
Seat 1: marquitopoker4 (4243 in chips) 
Seat 2: Lokobarys Ninja (4475 in chips) 
Seat 3: 4RING8 (5620 in chips) 
Seat 4: jcarlos.vale (9399 in chips) 
Seat 5: RCABelVedeRVerd (5083 in chips) 
Seat 6: Mimishka004 (4821 in chips) 
Seat 7: richard5189 (3268 in chips) 
Seat 8: 84nurik84 (6907 in chips) 
Seat 9: 48621537590 (3245 in chips) 
marquitopoker4: posts the ante 9
Lokobarys Ninja: posts the ante 9
4RING8: posts the ante 9
jcarlos.vale: posts the ante 9
RCABelVedeRVerd: posts the ante 9
Mimishka004: posts the ante 9
richard5189: posts the ante 9
84nurik84: posts the ante 9
48621537590: posts the ante 9
Lokobarys Ninja: posts small blind 40
4RING8: posts big blind 80
*** HOLE CARDS ***
Dealt to jcarlos.vale [Kh 9c]
jcarlos.vale: folds 
RCABelVedeRVerd: folds 
Mimishka004: folds 
richard5189: folds 
84nurik84: folds 
48621537590: raises 240 to 320
marquitopoker4: folds 
Lokobarys Ninja: folds 
4RING8: folds 
Uncalled bet (240) returned to 48621537590
48621537590 collected 281 from pot
48621537590: doesn't show hand 
*** SUMMARY ***
Total pot 281 | Rake 0 
Seat 1: marquitopoker4 (button) folded before Flop (didn't bet)
Seat 2: Lokobarys Ninja (small blind) folded before Flop
Seat 3: 4RING8 (big blind) folded before Flop
Seat 4: jcarlos.vale folded before Flop (didn't bet)
Seat 5: RCABelVedeRVerd folded before Flop (didn't bet)
Seat 6: Mimishka004 folded before Flop (didn't bet)
Seat 7: richard5189 folded before Flop (didn't bet)
Seat 8: 84nurik84 folded before Flop (didn't bet)
Seat 9: 48621537590 collected (281)



PokerStars Hand #222099437793: Tournament #3082583698, $0.98+$0.12 USD Hold'em No Limit - Level V (40/80) - 2021/01/01 20:49:01 EET [2021/01/01 13:49:01 ET]
Table '3082583698 30' 9-max Seat #2 is the button
Seat 1: marquitopoker4 (4234 in chips) 
Seat 2: Lokobarys Ninja (4426 in chips) 
Seat 3: 4RING8 (5531 in chips) 
Seat 4: jcarlos.vale (9390 in chips) 
Seat 5: RCABelVedeRVerd (5074 in chips) 
Seat 6: Mimishka004 (4812 in chips) 
Seat 7: richard5189 (3259 in chips) 
Seat 8: 84nurik84 (6898 in chips) 
Seat 9: 48621537590 (3437 in chips) 
marquitopoker4: posts the ante 9
Lokobarys Ninja: posts the ante 9
4RING8: posts the ante 9
jcarlos.vale: posts the ante 9
RCABelVedeRVerd: posts the ante 9
Mimishka004: posts the ante 9
richard5189: posts the ante 9
84nurik84: posts the ante 9
48621537590: posts the ante 9
4RING8: posts small blind 40
jcarlos.vale: posts big blind 80
*** HOLE CARDS ***
Dealt to jcarlos.vale [Qh 6s]
RCABelVedeRVerd: folds 
Mimishka004: folds 
richard5189: raises 80 to 160
84nurik84: folds 
48621537590: raises 80 to 240
marquitopoker4: folds 
Lokobarys Ninja: folds 
4RING8: calls 200
jcarlos.vale: folds 
richard5189: calls 80
*** FLOP *** [7s Jh 2c]
4RING8: checks 
richard5189: checks 
48621537590: checks 
*** TURN *** [7s Jh 2c] [9d]
4RING8: checks 
richard5189: bets 320
48621537590: folds 
4RING8: folds 
Uncalled bet (320) returned to richard5189
richard5189 collected 881 from pot
richard5189: doesn't show hand 
*** SUMMARY ***
Total pot 881 | Rake 0 
Board [7s Jh 2c 9d]
Seat 1: marquitopoker4 folded before Flop (didn't bet)
Seat 2: Lokobarys Ninja (button) folded before Flop (didn't bet)
Seat 3: 4RING8 (small blind) folded on the Turn
Seat 4: jcarlos.vale (big blind) folded before Flop
Seat 5: RCABelVedeRVerd folded before Flop (didn't bet)
Seat 6: Mimishka004 folded before Flop (didn't bet)
Seat 7: richard5189 collected (881)
Seat 8: 84nurik84 folded before Flop (didn't bet)
Seat 9: 48621537590 folded on the Turn



PokerStars Hand #222099539021: Tournament #3082583698, $0.98+$0.12 USD Hold'em No Limit - Level VI (50/100) - 2021/01/01 20:50:40 EET [2021/01/01 13:50:40 ET]
Table '3082583698 30' 9-max Seat #3 is the button
Seat 1: marquitopoker4 (4225 in chips) 
Seat 2: Lokobarys Ninja (4417 in chips) 
Seat 3: 4RING8 (5282 in chips) 
Seat 4: jcarlos.vale (9301 in chips) 
Seat 5: RCABelVedeRVerd (5065 in chips) 
Seat 6: Mimishka004 (4803 in chips) 
Seat 7: richard5189 (3891 in chips) 
Seat 8: 84nurik84 (6889 in chips) 
Seat 9: 48621537590 (3188 in chips) 
marquitopoker4: posts the ante 10
Lokobarys Ninja: posts the ante 10
4RING8: posts the ante 10
jcarlos.vale: posts the ante 10
RCABelVedeRVerd: posts the ante 10
Mimishka004: posts the ante 10
richard5189: posts the ante 10
84nurik84: posts the ante 10
48621537590: posts the ante 10
jcarlos.vale: posts small blind 50
RCABelVedeRVerd: posts big blind 100
*** HOLE CARDS ***
Dealt to jcarlos.vale [6d Td]
Mimishka004: raises 120 to 220
richard5189: folds 
84nurik84: folds 
48621537590: folds 
marquitopoker4: folds 
Lokobarys Ninja: folds 
4RING8: folds 
jcarlos.vale: folds 
RCABelVedeRVerd: folds 
Uncalled bet (120) returned to Mimishka004
Mimishka004 collected 340 from pot
*** SUMMARY ***
Total pot 340 | Rake 0 
Seat 1: marquitopoker4 folded before Flop (didn't bet)
Seat 2: Lokobarys Ninja folded before Flop (didn't bet)
Seat 3: 4RING8 (button) folded before Flop (didn't bet)
Seat 4: jcarlos.vale (small blind) folded before Flop
Seat 5: RCABelVedeRVerd (big blind) folded before Flop
Seat 6: Mimishka004 collected (340)
Seat 7: richard5189 folded before Flop (didn't bet)
Seat 8: 84nurik84 folded before Flop (didn't bet)
Seat 9: 48621537590 folded before Flop (didn't bet)



PokerStars Hand #222099579747: Tournament #3082583698, $0.98+$0.12 USD Hold'em No Limit - Level VI (50/100) - 2021/01/01 20:51:21 EET [2021/01/01 13:51:21 ET]
Table '3082583698 30' 9-max Seat #4 is the button
Seat 1: marquitopoker4 (4215 in chips) 
Seat 2: Lokobarys Ninja (4407 in chips) 
Seat 3: 4RING8 (5272 in chips) 
Seat 4: jcarlos.vale (9241 in chips) 
Seat 5: RCABelVedeRVerd (4955 in chips) 
Seat 6: Mimishka004 (5033 in chips) 
Seat 7: richard5189 (3881 in chips) 
Seat 8: 84nurik84 (6879 in chips) 
Seat 9: 48621537590 (3178 in chips) 
marquitopoker4: posts the ante 10
Lokobarys Ninja: posts the ante 10
4RING8: posts the ante 10
jcarlos.vale: posts the ante 10
RCABelVedeRVerd: posts the ante 10
Mimishka004: posts the ante 10
richard5189: posts the ante 10
84nurik84: posts the ante 10
48621537590: posts the ante 10
RCABelVedeRVerd: posts small blind 50
Mimishka004: posts big blind 100
*** HOLE CARDS ***
Dealt to jcarlos.vale [6s 5c]
richard5189: folds 
84nurik84: folds 
48621537590: folds 
marquitopoker4: folds 
Lokobarys Ninja: folds 
4RING8: folds 
jcarlos.vale: folds 
RCABelVedeRVerd: folds 
Uncalled bet (50) returned to Mimishka004
Mimishka004 collected 190 from pot
*** SUMMARY ***
Total pot 190 | Rake 0 
Seat 1: marquitopoker4 folded before Flop (didn't bet)
Seat 2: Lokobarys Ninja folded before Flop (didn't bet)
Seat 3: 4RING8 folded before Flop (didn't bet)
Seat 4: jcarlos.vale (button) folded before Flop (didn't bet)
Seat 5: RCABelVedeRVerd (small blind) folded before Flop
Seat 6: Mimishka004 (big blind) collected (190)
Seat 7: richard5189 folded before Flop (didn't bet)
Seat 8: 84nurik84 folded before Flop (didn't bet)
Seat 9: 48621537590 folded before Flop (didn't bet)



PokerStars Hand #222099631610: Tournament #3082583698, $0.98+$0.12 USD Hold'em No Limit - Level VI (50/100) - 2021/01/01 20:52:12 EET [2021/01/01 13:52:12 ET]
Table '3082583698 30' 9-max Seat #5 is the button
Seat 1: marquitopoker4 (4205 in chips) 
Seat 2: Lokobarys Ninja (4397 in chips) 
Seat 3: 4RING8 (5262 in chips) 
Seat 4: jcarlos.vale (9231 in chips) 
Seat 5: RCABelVedeRVerd (4895 in chips) 
Seat 6: Mimishka004 (5163 in chips) 
Seat 7: richard5189 (3871 in chips) 
Seat 8: 84nurik84 (6869 in chips) 
Seat 9: 48621537590 (3168 in chips) 
marquitopoker4: posts the ante 10
Lokobarys Ninja: posts the ante 10
4RING8: posts the ante 10
jcarlos.vale: posts the ante 10
RCABelVedeRVerd: posts the ante 10
Mimishka004: posts the ante 10
richard5189: posts the ante 10
84nurik84: posts the ante 10
48621537590: posts the ante 10
Mimishka004: posts small blind 50
richard5189: posts big blind 100
*** HOLE CARDS ***
Dealt to jcarlos.vale [Qs Ah]
84nurik84: folds 
48621537590: folds 
marquitopoker4: raises 101 to 201
Lokobarys Ninja: folds 
4RING8: calls 201
jcarlos.vale: calls 201
RCABelVedeRVerd: raises 699 to 900
Mimishka004: folds 
richard5189: folds 
marquitopoker4: folds 
4RING8: folds 
jcarlos.vale: folds 
Uncalled bet (699) returned to RCABelVedeRVerd
RCABelVedeRVerd collected 1044 from pot
*** SUMMARY ***
Total pot 1044 | Rake 0 
Seat 1: marquitopoker4 folded before Flop
Seat 2: Lokobarys Ninja folded before Flop (didn't bet)
Seat 3: 4RING8 folded before Flop
Seat 4: jcarlos.vale folded before Flop
Seat 5: RCABelVedeRVerd (button) collected (1044)
Seat 6: Mimishka004 (small blind) folded before Flop
Seat 7: richard5189 (big blind) folded before Flop
Seat 8: 84nurik84 folded before Flop (didn't bet)
Seat 9: 48621537590 folded before Flop (didn't bet)



PokerStars Hand #222099694247: Tournament #3082583698, $0.98+$0.12 USD Hold'em No Limit - Level VI (50/100) - 2021/01/01 20:53:14 EET [2021/01/01 13:53:14 ET]
Table '3082583698 30' 9-max Seat #6 is the button
Seat 1: marquitopoker4 (3994 in chips) 
Seat 2: Lokobarys Ninja (4387 in chips) 
Seat 3: 4RING8 (5051 in chips) 
Seat 4: jcarlos.vale (9020 in chips) 
Seat 5: RCABelVedeRVerd (5728 in chips) 
Seat 6: Mimishka004 (5103 in chips) 
Seat 7: richard5189 (3761 in chips) 
Seat 8: 84nurik84 (6859 in chips) 
Seat 9: 48621537590 (3158 in chips) 
marquitopoker4: posts the ante 10
Lokobarys Ninja: posts the ante 10
4RING8: posts the ante 10
jcarlos.vale: posts the ante 10
RCABelVedeRVerd: posts the ante 10
Mimishka004: posts the ante 10
richard5189: posts the ante 10
84nurik84: posts the ante 10
48621537590: posts the ante 10
richard5189: posts small blind 50
84nurik84: posts big blind 100
*** HOLE CARDS ***
Dealt to jcarlos.vale [7h 3c]
48621537590: folds 
marquitopoker4: raises 101 to 201
Lokobarys Ninja: folds 
4RING8: folds 
jcarlos.vale: folds 
RCABelVedeRVerd: calls 201
Mimishka004: calls 201
richard5189: folds 
84nurik84: calls 101
*** FLOP *** [2h 6d 6h]
84nurik84: checks 
marquitopoker4: checks 
RCABelVedeRVerd: checks 
Mimishka004: checks 
*** TURN *** [2h 6d 6h] [Th]
84nurik84: checks 
marquitopoker4: checks 
RCABelVedeRVerd: checks 
Mimishka004: checks 
*** RIVER *** [2h 6d 6h Th] [Ks]
84nurik84: checks 
marquitopoker4: checks 
RCABelVedeRVerd: checks 
Mimishka004: checks 
*** SHOW DOWN ***
84nurik84: shows [Qd 9s] (a pair of Sixes)
marquitopoker4: shows [Ad Kc] (two pair, Kings and Sixes)
RCABelVedeRVerd: mucks hand 
Mimishka004: mucks hand 
marquitopoker4 collected 944 from pot
*** SUMMARY ***
Total pot 944 | Rake 0 
Board [2h 6d 6h Th Ks]
Seat 1: marquitopoker4 showed [Ad Kc] and won (944) with two pair, Kings and Sixes
Seat 2: Lokobarys Ninja folded before Flop (didn't bet)
Seat 3: 4RING8 folded before Flop (didn't bet)
Seat 4: jcarlos.vale folded before Flop (didn't bet)
Seat 5: RCABelVedeRVerd mucked [Qs Kd]
Seat 6: Mimishka004 (button) mucked [7d 7c]
Seat 7: richard5189 (small blind) folded before Flop
Seat 8: 84nurik84 (big blind) showed [Qd 9s] and lost with a pair of Sixes
Seat 9: 48621537590 folded before Flop (didn't bet)



PokerStars Hand #222099784422: Tournament #3082583698, $0.98+$0.12 USD Hold'em No Limit - Level VI (50/100) - 2021/01/01 20:54:43 EET [2021/01/01 13:54:43 ET]
Table '3082583698 30' 9-max Seat #7 is the button
Seat 1: marquitopoker4 (4727 in chips) 
Seat 2: Lokobarys Ninja (4377 in chips) 
Seat 3: 4RING8 (5041 in chips) 
Seat 4: jcarlos.vale (9010 in chips) 
Seat 5: RCABelVedeRVerd (5517 in chips) 
Seat 6: Mimishka004 (4892 in chips) 
Seat 7: richard5189 (3701 in chips) 
Seat 8: 84nurik84 (6648 in chips) 
Seat 9: 48621537590 (3148 in chips) 
marquitopoker4: posts the ante 10
Lokobarys Ninja: posts the ante 10
4RING8: posts the ante 10
jcarlos.vale: posts the ante 10
RCABelVedeRVerd: posts the ante 10
Mimishka004: posts the ante 10
richard5189: posts the ante 10
84nurik84: posts the ante 10
48621537590: posts the ante 10
84nurik84: posts small blind 50
48621537590: posts big blind 100
*** HOLE CARDS ***
Dealt to jcarlos.vale [4c Jc]
marquitopoker4: folds 
Lokobarys Ninja: folds 
4RING8: folds 
jcarlos.vale: folds 
RCABelVedeRVerd: calls 100
Mimishka004: folds 
richard5189: raises 200 to 300
84nurik84: folds 
48621537590: folds 
RCABelVedeRVerd: calls 200
*** FLOP *** [Qd 7h 9s]
RCABelVedeRVerd: checks 
richard5189: checks 
*** TURN *** [Qd 7h 9s] [6d]
RCABelVedeRVerd: checks 
richard5189: checks 
*** RIVER *** [Qd 7h 9s 6d] [Qh]
RCABelVedeRVerd: checks 
richard5189: checks 
*** SHOW DOWN ***
RCABelVedeRVerd: shows [3c 5s] (a pair of Queens)
richard5189: shows [Kh Jh] (a pair of Queens - King kicker)
richard5189 collected 840 from pot
*** SUMMARY ***
Total pot 840 | Rake 0 
Board [Qd 7h 9s 6d Qh]
Seat 1: marquitopoker4 folded before Flop (didn't bet)
Seat 2: Lokobarys Ninja folded before Flop (didn't bet)
Seat 3: 4RING8 folded before Flop (didn't bet)
Seat 4: jcarlos.vale folded before Flop (didn't bet)
Seat 5: RCABelVedeRVerd showed [3c 5s] and lost with a pair of Queens
Seat 6: Mimishka004 folded before Flop (didn't bet)
Seat 7: richard5189 (button) showed [Kh Jh] and won (840) with a pair of Queens
Seat 8: 84nurik84 (small blind) folded before Flop
Seat 9: 48621537590 (big blind) folded before Flop



PokerStars Hand #222099980135: Tournament #3082583698, $0.98+$0.12 USD Hold'em No Limit - Level VI (50/100) - 2021/01/01 21:02:47 EET [2021/01/01 14:02:47 ET]
Table '3082583698 30' 9-max Seat #8 is the button
Seat 1: marquitopoker4 (4717 in chips) 
Seat 2: Lokobarys Ninja (4367 in chips) 
Seat 3: 4RING8 (5031 in chips) 
Seat 4: jcarlos.vale (9000 in chips) 
Seat 5: RCABelVedeRVerd (5207 in chips) 
Seat 6: Mimishka004 (4882 in chips) 
Seat 7: richard5189 (4231 in chips) 
Seat 8: 84nurik84 (6588 in chips) 
Seat 9: 48621537590 (3038 in chips) 
marquitopoker4: posts the ante 10
Lokobarys Ninja: posts the ante 10
4RING8: posts the ante 10
jcarlos.vale: posts the ante 10
RCABelVedeRVerd: posts the ante 10
Mimishka004: posts the ante 10
richard5189: posts the ante 10
84nurik84: posts the ante 10
48621537590: posts the ante 10
48621537590: posts small blind 50
marquitopoker4: posts big blind 100
*** HOLE CARDS ***
Dealt to jcarlos.vale [Js Qd]
Lokobarys Ninja: raises 100 to 200
4RING8: raises 450 to 650
jcarlos.vale: folds 
RCABelVedeRVerd has timed out
RCABelVedeRVerd: folds 
RCABelVedeRVerd is sitting out
Mimishka004: folds 
richard5189: calls 650
84nurik84: folds 
48621537590: raises 2340 to 2990
marquitopoker4: folds 
Lokobarys Ninja: folds 
4RING8: raises 2031 to 5021 and is all-in
richard5189: calls 3571 and is all-in
48621537590: calls 38 and is all-in
Uncalled bet (800) returned to 4RING8
*** FLOP *** [9d 3h As]
*** TURN *** [9d 3h As] [Td]
*** RIVER *** [9d 3h As Td] [Jh]
*** SHOW DOWN ***
4RING8: shows [Kd Ad] (a pair of Aces)
richard5189: shows [Ah Th] (two pair, Aces and Tens)
richard5189 collected 2386 from side pot
48621537590: shows [Ac Qs] (a pair of Aces)
richard5189 collected 9474 from main pot
48621537590 finished the tournament
*** SUMMARY ***
Total pot 11860 Main pot 9474. Side pot 2386. | Rake 0 
Board [9d 3h As Td Jh]
Seat 1: marquitopoker4 (big blind) folded before Flop
Seat 2: Lokobarys Ninja folded before Flop
Seat 3: 4RING8 showed [Kd Ad] and lost with a pair of Aces
Seat 4: jcarlos.vale folded before Flop (didn't bet)
Seat 5: RCABelVedeRVerd folded before Flop (didn't bet)
Seat 6: Mimishka004 folded before Flop (didn't bet)
Seat 7: richard5189 showed [Ah Th] and won (11860) with two pair, Aces and Tens
Seat 8: 84nurik84 (button) folded before Flop (didn't bet)
Seat 9: 48621537590 (small blind) showed [Ac Qs] and lost with a pair of Aces



PokerStars Hand #222100046538: Tournament #3082583698, $0.98+$0.12 USD Hold'em No Limit - Level VI (50/100) - 2021/01/01 21:04:01 EET [2021/01/01 14:04:01 ET]
Table '3082583698 30' 9-max Seat #1 is the button
Seat 1: marquitopoker4 (4607 in chips) 
Seat 2: Lokobarys Ninja (4157 in chips) 
Seat 3: 4RING8 (800 in chips) 
Seat 4: jcarlos.vale (8990 in chips) 
Seat 5: RCABelVedeRVerd (5197 in chips) is sitting out
Seat 6: Mimishka004 (4872 in chips) 
Seat 7: richard5189 (11860 in chips) 
Seat 8: 84nurik84 (6578 in chips) 
marquitopoker4: posts the ante 10
Lokobarys Ninja: posts the ante 10
4RING8: posts the ante 10
jcarlos.vale: posts the ante 10
RCABelVedeRVerd: posts the ante 10
Mimishka004: posts the ante 10
richard5189: posts the ante 10
84nurik84: posts the ante 10
Lokobarys Ninja: posts small blind 50
4RING8: posts big blind 100
*** HOLE CARDS ***
Dealt to jcarlos.vale [2s 4s]
jcarlos.vale: folds 
RCABelVedeRVerd: folds 
Mimishka004: folds 
richard5189: folds 
84nurik84: raises 120 to 220
marquitopoker4: folds 
Lokobarys Ninja: folds 
4RING8: folds 
Uncalled bet (120) returned to 84nurik84
84nurik84 collected 330 from pot
84nurik84: doesn't show hand 
*** SUMMARY ***
Total pot 330 | Rake 0 
Seat 1: marquitopoker4 (button) folded before Flop (didn't bet)
Seat 2: Lokobarys Ninja (small blind) folded before Flop
Seat 3: 4RING8 (big blind) folded before Flop
Seat 4: jcarlos.vale folded before Flop (didn't bet)
Seat 5: RCABelVedeRVerd folded before Flop (didn't bet)
Seat 6: Mimishka004 folded before Flop (didn't bet)
Seat 7: richard5189 folded before Flop (didn't bet)
Seat 8: 84nurik84 collected (330)



PokerStars Hand #222100075442: Tournament #3082583698, $0.98+$0.12 USD Hold'em No Limit - Level VI (50/100) - 2021/01/01 21:04:30 EET [2021/01/01 14:04:30 ET]
Table '3082583698 30' 9-max Seat #2 is the button
Seat 1: marquitopoker4 (4597 in chips) 
Seat 2: Lokobarys Ninja (4097 in chips) 
Seat 3: 4RING8 (690 in chips) 
Seat 4: jcarlos.vale (8980 in chips) 
Seat 5: RCABelVedeRVerd (5187 in chips) is sitting out
Seat 6: Mimishka004 (4862 in chips) 
Seat 7: richard5189 (11850 in chips) 
Seat 8: 84nurik84 (6798 in chips) 
Seat 9: remedy74 (5000 in chips) 
marquitopoker4: posts the ante 10
Lokobarys Ninja: posts the ante 10
4RING8: posts the ante 10
jcarlos.vale: posts the ante 10
RCABelVedeRVerd: posts the ante 10
Mimishka004: posts the ante 10
richard5189: posts the ante 10
84nurik84: posts the ante 10
remedy74: posts the ante 10
4RING8: posts small blind 50
jcarlos.vale: posts big blind 100
*** HOLE CARDS ***
Dealt to jcarlos.vale [8s 7d]
RCABelVedeRVerd: folds 
Mimishka004: folds 
richard5189: folds 
84nurik84: raises 120 to 220
remedy74: folds 
marquitopoker4: folds 
Lokobarys Ninja: folds 
4RING8: folds 
jcarlos.vale: folds 
Uncalled bet (120) returned to 84nurik84
84nurik84 collected 340 from pot
84nurik84: doesn't show hand 
*** SUMMARY ***
Total pot 340 | Rake 0 
Seat 1: marquitopoker4 folded before Flop (didn't bet)
Seat 2: Lokobarys Ninja (button) folded before Flop (didn't bet)
Seat 3: 4RING8 (small blind) folded before Flop
Seat 4: jcarlos.vale (big blind) folded before Flop
Seat 5: RCABelVedeRVerd folded before Flop (didn't bet)
Seat 6: Mimishka004 folded before Flop (didn't bet)
Seat 7: richard5189 folded before Flop (didn't bet)
Seat 8: 84nurik84 collected (340)
Seat 9: remedy74 folded before Flop (didn't bet)



PokerStars Hand #222100112098: Tournament #3082583698, $0.98+$0.12 USD Hold'em No Limit - Level VI (50/100) - 2021/01/01 21:05:02 EET [2021/01/01 14:05:02 ET]
Table '3082583698 30' 9-max Seat #3 is the button
Seat 1: marquitopoker4 (4587 in chips) 
Seat 2: Lokobarys Ninja (4087 in chips) 
Seat 3: 4RING8 (630 in chips) 
Seat 4: jcarlos.vale (8870 in chips) 
Seat 5: RCABelVedeRVerd (5177 in chips) is sitting out
Seat 6: Mimishka004 (4852 in chips) 
Seat 7: richard5189 (11840 in chips) 
Seat 8: 84nurik84 (7028 in chips) 
Seat 9: remedy74 (4990 in chips) 
marquitopoker4: posts the ante 10
Lokobarys Ninja: posts the ante 10
4RING8: posts the ante 10
jcarlos.vale: posts the ante 10
RCABelVedeRVerd: posts the ante 10
Mimishka004: posts the ante 10
richard5189: posts the ante 10
84nurik84: posts the ante 10
remedy74: posts the ante 10
jcarlos.vale: posts small blind 50
RCABelVedeRVerd: posts big blind 100
*** HOLE CARDS ***
Dealt to jcarlos.vale [7d 3s]
Mimishka004: folds 
richard5189: raises 100 to 200
84nurik84: folds 
remedy74: folds 
marquitopoker4: folds 
Lokobarys Ninja: folds 
RCABelVedeRVerd has returned
4RING8: folds 
jcarlos.vale: folds 
RCABelVedeRVerd: folds 
Uncalled bet (100) returned to richard5189
richard5189 collected 340 from pot
richard5189: doesn't show hand 
*** SUMMARY ***
Total pot 340 | Rake 0 
Seat 1: marquitopoker4 folded before Flop (didn't bet)
Seat 2: Lokobarys Ninja folded before Flop (didn't bet)
Seat 3: 4RING8 (button) folded before Flop (didn't bet)
Seat 4: jcarlos.vale (small blind) folded before Flop
Seat 5: RCABelVedeRVerd (big blind) folded before Flop
Seat 6: Mimishka004 folded before Flop (didn't bet)
Seat 7: richard5189 collected (340)
Seat 8: 84nurik84 folded before Flop (didn't bet)
Seat 9: remedy74 folded before Flop (didn't bet)



PokerStars Hand #222100150392: Tournament #3082583698, $0.98+$0.12 USD Hold'em No Limit - Level VI (50/100) - 2021/01/01 21:05:36 EET [2021/01/01 14:05:36 ET]
Table '3082583698 30' 9-max Seat #4 is the button
Seat 1: marquitopoker4 (4577 in chips) 
Seat 2: Lokobarys Ninja (4077 in chips) 
Seat 3: 4RING8 (620 in chips) 
Seat 4: jcarlos.vale (8810 in chips) 
Seat 5: RCABelVedeRVerd (5067 in chips) 
Seat 6: Mimishka004 (4842 in chips) 
Seat 7: richard5189 (12070 in chips) 
Seat 8: 84nurik84 (7018 in chips) 
Seat 9: remedy74 (4980 in chips) 
marquitopoker4: posts the ante 10
Lokobarys Ninja: posts the ante 10
4RING8: posts the ante 10
jcarlos.vale: posts the ante 10
RCABelVedeRVerd: posts the ante 10
Mimishka004: posts the ante 10
richard5189: posts the ante 10
84nurik84: posts the ante 10
remedy74: posts the ante 10
RCABelVedeRVerd: posts small blind 50
Mimishka004: posts big blind 100
*** HOLE CARDS ***
Dealt to jcarlos.vale [9s 3s]
richard5189: folds 
84nurik84: raises 150 to 250
remedy74: folds 
marquitopoker4: folds 
Lokobarys Ninja: folds 
4RING8: folds 
jcarlos.vale: folds 
RCABelVedeRVerd: folds 
Mimishka004: calls 150
*** FLOP *** [9h 3d Ah]
Mimishka004: checks 
84nurik84: bets 320
Mimishka004: folds 
Uncalled bet (320) returned to 84nurik84
84nurik84 collected 640 from pot
84nurik84: doesn't show hand 
*** SUMMARY ***
Total pot 640 | Rake 0 
Board [9h 3d Ah]
Seat 1: marquitopoker4 folded before Flop (didn't bet)
Seat 2: Lokobarys Ninja folded before Flop (didn't bet)
Seat 3: 4RING8 folded before Flop (didn't bet)
Seat 4: jcarlos.vale (button) folded before Flop (didn't bet)
Seat 5: RCABelVedeRVerd (small blind) folded before Flop
Seat 6: Mimishka004 (big blind) folded on the Flop
Seat 7: richard5189 folded before Flop (didn't bet)
Seat 8: 84nurik84 collected (640)
Seat 9: remedy74 folded before Flop (didn't bet)



PokerStars Hand #222100190538: Tournament #3082583698, $0.98+$0.12 USD Hold'em No Limit - Level VI (50/100) - 2021/01/01 21:06:12 EET [2021/01/01 14:06:12 ET]
Table '3082583698 30' 9-max Seat #5 is the button
Seat 1: marquitopoker4 (4567 in chips) 
Seat 2: Lokobarys Ninja (4067 in chips) 
Seat 3: 4RING8 (610 in chips) 
Seat 4: jcarlos.vale (8800 in chips) 
Seat 5: RCABelVedeRVerd (5007 in chips) 
Seat 6: Mimishka004 (4582 in chips) 
Seat 7: richard5189 (12060 in chips) 
Seat 8: 84nurik84 (7398 in chips) 
Seat 9: remedy74 (4970 in chips) 
marquitopoker4: posts the ante 10
Lokobarys Ninja: posts the ante 10
4RING8: posts the ante 10
jcarlos.vale: posts the ante 10
RCABelVedeRVerd: posts the ante 10
Mimishka004: posts the ante 10
richard5189: posts the ante 10
84nurik84: posts the ante 10
remedy74: posts the ante 10
Mimishka004: posts small blind 50
richard5189: posts big blind 100
*** HOLE CARDS ***
Dealt to jcarlos.vale [Kd 5c]
84nurik84: folds 
remedy74: folds 
marquitopoker4: folds 
Lokobarys Ninja: folds 
4RING8: raises 500 to 600 and is all-in
jcarlos.vale: folds 
RCABelVedeRVerd: folds 
Mimishka004: folds 
richard5189: folds 
Uncalled bet (500) returned to 4RING8
4RING8 collected 340 from pot
*** SUMMARY ***
Total pot 340 | Rake 0 
Seat 1: marquitopoker4 folded before Flop (didn't bet)
Seat 2: Lokobarys Ninja folded before Flop (didn't bet)
Seat 3: 4RING8 collected (340)
Seat 4: jcarlos.vale folded before Flop (didn't bet)
Seat 5: RCABelVedeRVerd (button) folded before Flop (didn't bet)
Seat 6: Mimishka004 (small blind) folded before Flop
Seat 7: richard5189 (big blind) folded before Flop
Seat 8: 84nurik84 folded before Flop (didn't bet)
Seat 9: remedy74 folded before Flop (didn't bet)



PokerStars Hand #222100214129: Tournament #3082583698, $0.98+$0.12 USD Hold'em No Limit - Level VI (50/100) - 2021/01/01 21:06:33 EET [2021/01/01 14:06:33 ET]
Table '3082583698 30' 9-max Seat #6 is the button
Seat 1: marquitopoker4 (4557 in chips) 
Seat 2: Lokobarys Ninja (4057 in chips) 
Seat 3: 4RING8 (840 in chips) 
Seat 4: jcarlos.vale (8790 in chips) 
Seat 5: RCABelVedeRVerd (4997 in chips) 
Seat 6: Mimishka004 (4522 in chips) 
Seat 7: richard5189 (11950 in chips) 
Seat 8: 84nurik84 (7388 in chips) 
Seat 9: remedy74 (4960 in chips) 
marquitopoker4: posts the ante 10
Lokobarys Ninja: posts the ante 10
4RING8: posts the ante 10
jcarlos.vale: posts the ante 10
RCABelVedeRVerd: posts the ante 10
Mimishka004: posts the ante 10
richard5189: posts the ante 10
84nurik84: posts the ante 10
remedy74: posts the ante 10
richard5189: posts small blind 50
84nurik84: posts big blind 100
*** HOLE CARDS ***
Dealt to jcarlos.vale [7s 2s]
remedy74: folds 
marquitopoker4: folds 
Lokobarys Ninja: folds 
4RING8: raises 730 to 830 and is all-in
jcarlos.vale: folds 
RCABelVedeRVerd: folds 
Mimishka004: folds 
richard5189: folds 
84nurik84: folds 
Uncalled bet (730) returned to 4RING8
4RING8 collected 340 from pot
*** SUMMARY ***
Total pot 340 | Rake 0 
Seat 1: marquitopoker4 folded before Flop (didn't bet)
Seat 2: Lokobarys Ninja folded before Flop (didn't bet)
Seat 3: 4RING8 collected (340)
Seat 4: jcarlos.vale folded before Flop (didn't bet)
Seat 5: RCABelVedeRVerd folded before Flop (didn't bet)
Seat 6: Mimishka004 (button) folded before Flop (didn't bet)
Seat 7: richard5189 (small blind) folded before Flop
Seat 8: 84nurik84 (big blind) folded before Flop
Seat 9: remedy74 folded before Flop (didn't bet)



PokerStars Hand #222100262025: Tournament #3082583698, $0.98+$0.12 USD Hold'em No Limit - Level VI (50/100) - 2021/01/01 21:07:14 EET [2021/01/01 14:07:14 ET]
Table '3082583698 30' 9-max Seat #7 is the button
Seat 1: marquitopoker4 (4547 in chips) 
Seat 2: Lokobarys Ninja (4047 in chips) 
Seat 3: 4RING8 (1070 in chips) 
Seat 4: jcarlos.vale (8780 in chips) 
Seat 5: RCABelVedeRVerd (4987 in chips) 
Seat 6: Mimishka004 (4512 in chips) 
Seat 7: richard5189 (11890 in chips) 
Seat 8: 84nurik84 (7278 in chips) 
Seat 9: remedy74 (4950 in chips) 
marquitopoker4: posts the ante 10
Lokobarys Ninja: posts the ante 10
4RING8: posts the ante 10
jcarlos.vale: posts the ante 10
RCABelVedeRVerd: posts the ante 10
Mimishka004: posts the ante 10
richard5189: posts the ante 10
84nurik84: posts the ante 10
remedy74: posts the ante 10
84nurik84: posts small blind 50
remedy74: posts big blind 100
*** HOLE CARDS ***
Dealt to jcarlos.vale [9h 9d]
marquitopoker4: folds 
Lokobarys Ninja: folds 
4RING8: folds 
jcarlos.vale: raises 160 to 260
RCABelVedeRVerd: folds 
Mimishka004: folds 
richard5189: folds 
84nurik84: folds 
remedy74: folds 
Uncalled bet (160) returned to jcarlos.vale
jcarlos.vale collected 340 from pot
jcarlos.vale: doesn't show hand 
*** SUMMARY ***
Total pot 340 | Rake 0 
Seat 1: marquitopoker4 folded before Flop (didn't bet)
Seat 2: Lokobarys Ninja folded before Flop (didn't bet)
Seat 3: 4RING8 folded before Flop (didn't bet)
Seat 4: jcarlos.vale collected (340)
Seat 5: RCABelVedeRVerd folded before Flop (didn't bet)
Seat 6: Mimishka004 folded before Flop (didn't bet)
Seat 7: richard5189 (button) folded before Flop (didn't bet)
Seat 8: 84nurik84 (small blind) folded before Flop
Seat 9: remedy74 (big blind) folded before Flop



PokerStars Hand #222100295948: Tournament #3082583698, $0.98+$0.12 USD Hold'em No Limit - Level VI (50/100) - 2021/01/01 21:07:43 EET [2021/01/01 14:07:43 ET]
Table '3082583698 30' 9-max Seat #8 is the button
Seat 1: marquitopoker4 (4537 in chips) 
Seat 2: Lokobarys Ninja (4037 in chips) 
Seat 3: 4RING8 (1060 in chips) 
Seat 4: jcarlos.vale (9010 in chips) 
Seat 5: RCABelVedeRVerd (4977 in chips) 
Seat 6: Mimishka004 (4502 in chips) 
Seat 7: richard5189 (11880 in chips) 
Seat 8: 84nurik84 (7218 in chips) 
Seat 9: remedy74 (4840 in chips) 
marquitopoker4: posts the ante 10
Lokobarys Ninja: posts the ante 10
4RING8: posts the ante 10
jcarlos.vale: posts the ante 10
RCABelVedeRVerd: posts the ante 10
Mimishka004: posts the ante 10
richard5189: posts the ante 10
84nurik84: posts the ante 10
remedy74: posts the ante 10
remedy74: posts small blind 50
marquitopoker4: posts big blind 100
*** HOLE CARDS ***
Dealt to jcarlos.vale [7c 8d]
Lokobarys Ninja: folds 
4RING8: folds 
jcarlos.vale: folds 
RCABelVedeRVerd: raises 200 to 300
Mimishka004: folds 
richard5189: folds 
84nurik84: folds 
remedy74: folds 
marquitopoker4: calls 200
*** FLOP *** [Ad 5c 9s]
marquitopoker4: checks 
RCABelVedeRVerd: bets 300
marquitopoker4: calls 300
*** TURN *** [Ad 5c 9s] [Ks]
marquitopoker4: checks 
RCABelVedeRVerd: bets 442
marquitopoker4: calls 442
*** RIVER *** [Ad 5c 9s Ks] [5s]
marquitopoker4: checks 
RCABelVedeRVerd: checks 
*** SHOW DOWN ***
marquitopoker4: shows [Th Ah] (two pair, Aces and Fives)
RCABelVedeRVerd: shows [Ac 8c] (two pair, Aces and Fives)
marquitopoker4 collected 1112 from pot
RCABelVedeRVerd collected 1112 from pot
*** SUMMARY ***
Total pot 2224 | Rake 0 
Board [Ad 5c 9s Ks 5s]
Seat 1: marquitopoker4 (big blind) showed [Th Ah] and won (1112) with two pair, Aces and Fives
Seat 2: Lokobarys Ninja folded before Flop (didn't bet)
Seat 3: 4RING8 folded before Flop (didn't bet)
Seat 4: jcarlos.vale folded before Flop (didn't bet)
Seat 5: RCABelVedeRVerd showed [Ac 8c] and won (1112) with two pair, Aces and Fives
Seat 6: Mimishka004 folded before Flop (didn't bet)
Seat 7: richard5189 folded before Flop (didn't bet)
Seat 8: 84nurik84 (button) folded before Flop (didn't bet)
Seat 9: remedy74 (small blind) folded before Flop



PokerStars Hand #222100389929: Tournament #3082583698, $0.98+$0.12 USD Hold'em No Limit - Level VII (60/120) - 2021/01/01 21:09:03 EET [2021/01/01 14:09:03 ET]
Table '3082583698 30' 9-max Seat #9 is the button
Seat 1: marquitopoker4 (4597 in chips) 
Seat 2: Lokobarys Ninja (4027 in chips) 
Seat 3: 4RING8 (1050 in chips) 
Seat 4: jcarlos.vale (9000 in chips) 
Seat 5: RCABelVedeRVerd (5037 in chips) 
Seat 6: Mimishka004 (4492 in chips) 
Seat 7: richard5189 (11870 in chips) 
Seat 8: 84nurik84 (7208 in chips) 
Seat 9: remedy74 (4780 in chips) 
marquitopoker4: posts the ante 12
Lokobarys Ninja: posts the ante 12
4RING8: posts the ante 12
jcarlos.vale: posts the ante 12
RCABelVedeRVerd: posts the ante 12
Mimishka004: posts the ante 12
richard5189: posts the ante 12
84nurik84: posts the ante 12
remedy74: posts the ante 12
marquitopoker4: posts small blind 60
Lokobarys Ninja: posts big blind 120
*** HOLE CARDS ***
Dealt to jcarlos.vale [Qs 4c]
4RING8: folds 
jcarlos.vale: folds 
RCABelVedeRVerd: calls 120
Mimishka004: folds 
richard5189: folds 
84nurik84: folds 
remedy74: raises 360 to 480
marquitopoker4: folds 
Lokobarys Ninja: folds 
RCABelVedeRVerd: calls 360
*** FLOP *** [9s 4d 2d]
RCABelVedeRVerd: checks 
remedy74: bets 480
RCABelVedeRVerd: raises 840 to 1320
remedy74: raises 2968 to 4288 and is all-in
RCABelVedeRVerd: calls 2968
*** TURN *** [9s 4d 2d] [7c]
*** RIVER *** [9s 4d 2d 7c] [As]
*** SHOW DOWN ***
RCABelVedeRVerd: shows [Ad 5d] (a pair of Aces)
remedy74: shows [8c 8h] (a pair of Eights)
RCABelVedeRVerd collected 9824 from pot
remedy74 finished the tournament
*** SUMMARY ***
Total pot 9824 | Rake 0 
Board [9s 4d 2d 7c As]
Seat 1: marquitopoker4 (small blind) folded before Flop
Seat 2: Lokobarys Ninja (big blind) folded before Flop
Seat 3: 4RING8 folded before Flop (didn't bet)
Seat 4: jcarlos.vale folded before Flop (didn't bet)
Seat 5: RCABelVedeRVerd showed [Ad 5d] and won (9824) with a pair of Aces
Seat 6: Mimishka004 folded before Flop (didn't bet)
Seat 7: richard5189 folded before Flop (didn't bet)
Seat 8: 84nurik84 folded before Flop (didn't bet)
Seat 9: remedy74 (button) showed [8c 8h] and lost with a pair of Eights



PokerStars Hand #222100483493: Tournament #3082583698, $0.98+$0.12 USD Hold'em No Limit - Level VII (60/120) - 2021/01/01 21:10:23 EET [2021/01/01 14:10:23 ET]
Table '3082583698 30' 9-max Seat #1 is the button
Seat 1: marquitopoker4 (4525 in chips) 
Seat 2: Lokobarys Ninja (3895 in chips) 
Seat 3: 4RING8 (1038 in chips) 
Seat 4: jcarlos.vale (8988 in chips) 
Seat 5: RCABelVedeRVerd (10081 in chips) 
Seat 6: Mimishka004 (4480 in chips) 
Seat 7: richard5189 (11858 in chips) 
Seat 8: 84nurik84 (7196 in chips) 
marquitopoker4: posts the ante 12
Lokobarys Ninja: posts the ante 12
4RING8: posts the ante 12
jcarlos.vale: posts the ante 12
RCABelVedeRVerd: posts the ante 12
Mimishka004: posts the ante 12
richard5189: posts the ante 12
84nurik84: posts the ante 12
Lokobarys Ninja: posts small blind 60
4RING8: posts big blind 120
*** HOLE CARDS ***
Dealt to jcarlos.vale [7s 3d]
jcarlos.vale: folds 
RCABelVedeRVerd: folds 
Mimishka004: folds 
richard5189: raises 240 to 360
84nurik84: folds 
marquitopoker4: calls 360
Lokobarys Ninja: folds 
4RING8: calls 240
*** FLOP *** [2h Kd As]
4RING8: checks 
richard5189: bets 618
marquitopoker4: calls 618
4RING8: folds 
*** TURN *** [2h Kd As] [8d]
richard5189: checks 
marquitopoker4: checks 
*** RIVER *** [2h Kd As 8d] [Kc]
richard5189: checks 
marquitopoker4: bets 840
richard5189: calls 840
*** SHOW DOWN ***
marquitopoker4: shows [Td Ac] (two pair, Aces and Kings)
richard5189: mucks hand 
marquitopoker4 collected 4152 from pot
*** SUMMARY ***
Total pot 4152 | Rake 0 
Board [2h Kd As 8d Kc]
Seat 1: marquitopoker4 (button) showed [Td Ac] and won (4152) with two pair, Aces and Kings
Seat 2: Lokobarys Ninja (small blind) folded before Flop
Seat 3: 4RING8 (big blind) folded on the Flop
Seat 4: jcarlos.vale folded before Flop (didn't bet)
Seat 5: RCABelVedeRVerd folded before Flop (didn't bet)
Seat 6: Mimishka004 folded before Flop (didn't bet)
Seat 7: richard5189 mucked [Qh Qc]
Seat 8: 84nurik84 folded before Flop (didn't bet)



PokerStars Hand #222100555838: Tournament #3082583698, $0.98+$0.12 USD Hold'em No Limit - Level VII (60/120) - 2021/01/01 21:11:26 EET [2021/01/01 14:11:26 ET]
Table '3082583698 30' 9-max Seat #2 is the button
Seat 1: marquitopoker4 (6847 in chips) 
Seat 2: Lokobarys Ninja (3823 in chips) 
Seat 3: 4RING8 (666 in chips) 
Seat 4: jcarlos.vale (8976 in chips) 
Seat 5: RCABelVedeRVerd (10069 in chips) 
Seat 6: Mimishka004 (4468 in chips) 
Seat 7: richard5189 (10028 in chips) 
Seat 8: 84nurik84 (7184 in chips) 
Seat 9: BigMoneyJoe1 (5000 in chips) 
marquitopoker4: posts the ante 12
Lokobarys Ninja: posts the ante 12
4RING8: posts the ante 12
jcarlos.vale: posts the ante 12
RCABelVedeRVerd: posts the ante 12
Mimishka004: posts the ante 12
richard5189: posts the ante 12
84nurik84: posts the ante 12
BigMoneyJoe1: posts the ante 12
4RING8: posts small blind 60
jcarlos.vale: posts big blind 120
*** HOLE CARDS ***
Dealt to jcarlos.vale [7c Tc]
RCABelVedeRVerd: calls 120
Mimishka004: folds 
richard5189: calls 120
84nurik84: folds 
BigMoneyJoe1: folds 
marquitopoker4: folds 
Lokobarys Ninja: folds 
4RING8: folds 
jcarlos.vale: checks 
*** FLOP *** [Qh Jh 7h]
jcarlos.vale: checks 
RCABelVedeRVerd: bets 240
richard5189: raises 504 to 744
jcarlos.vale: folds 
RCABelVedeRVerd: calls 504
*** TURN *** [Qh Jh 7h] [8c]
RCABelVedeRVerd: checks 
richard5189: checks 
*** RIVER *** [Qh Jh 7h 8c] [5h]
RCABelVedeRVerd: checks 
richard5189: bets 840
RCABelVedeRVerd: calls 840
*** SHOW DOWN ***
richard5189: shows [Qs Js] (two pair, Queens and Jacks)
RCABelVedeRVerd: shows [Jc Jd] (three of a kind, Jacks)
RCABelVedeRVerd collected 3696 from pot
*** SUMMARY ***
Total pot 3696 | Rake 0 
Board [Qh Jh 7h 8c 5h]
Seat 1: marquitopoker4 folded before Flop (didn't bet)
Seat 2: Lokobarys Ninja (button) folded before Flop (didn't bet)
Seat 3: 4RING8 (small blind) folded before Flop
Seat 4: jcarlos.vale (big blind) folded on the Flop
Seat 5: RCABelVedeRVerd showed [Jc Jd] and won (3696) with three of a kind, Jacks
Seat 6: Mimishka004 folded before Flop (didn't bet)
Seat 7: richard5189 showed [Qs Js] and lost with two pair, Queens and Jacks
Seat 8: 84nurik84 folded before Flop (didn't bet)
Seat 9: BigMoneyJoe1 folded before Flop (didn't bet)



PokerStars Hand #222100630920: Tournament #3082583698, $0.98+$0.12 USD Hold'em No Limit - Level VII (60/120) - 2021/01/01 21:12:31 EET [2021/01/01 14:12:31 ET]
Table '3082583698 30' 9-max Seat #3 is the button
Seat 1: marquitopoker4 (6835 in chips) 
Seat 2: Lokobarys Ninja (3811 in chips) 
Seat 3: 4RING8 (594 in chips) 
Seat 4: jcarlos.vale (8844 in chips) 
Seat 5: RCABelVedeRVerd (12049 in chips) 
Seat 6: Mimishka004 (4456 in chips) 
Seat 7: richard5189 (8312 in chips) 
Seat 8: 84nurik84 (7172 in chips) 
Seat 9: BigMoneyJoe1 (4988 in chips) 
marquitopoker4: posts the ante 12
Lokobarys Ninja: posts the ante 12
4RING8: posts the ante 12
jcarlos.vale: posts the ante 12
RCABelVedeRVerd: posts the ante 12
Mimishka004: posts the ante 12
richard5189: posts the ante 12
84nurik84: posts the ante 12
BigMoneyJoe1: posts the ante 12
jcarlos.vale: posts small blind 60
RCABelVedeRVerd: posts big blind 120
*** HOLE CARDS ***
Dealt to jcarlos.vale [2d 7h]
Mimishka004: folds 
richard5189: folds 
84nurik84: folds 
BigMoneyJoe1: calls 120
marquitopoker4: folds 
Lokobarys Ninja: folds 
4RING8: folds 
jcarlos.vale: calls 60
RCABelVedeRVerd: checks 
*** FLOP *** [4s Jd 8c]
jcarlos.vale: checks 
RCABelVedeRVerd: checks 
BigMoneyJoe1: bets 120
jcarlos.vale: folds 
RCABelVedeRVerd: calls 120
*** TURN *** [4s Jd 8c] [Ts]
RCABelVedeRVerd: checks 
BigMoneyJoe1: bets 240
RCABelVedeRVerd: calls 240
*** RIVER *** [4s Jd 8c Ts] [Kh]
RCABelVedeRVerd: checks 
BigMoneyJoe1: checks 
*** SHOW DOWN ***
RCABelVedeRVerd: shows [Jh Qd] (a pair of Jacks)
BigMoneyJoe1: mucks hand 
RCABelVedeRVerd collected 1188 from pot
*** SUMMARY ***
Total pot 1188 | Rake 0 
Board [4s Jd 8c Ts Kh]
Seat 1: marquitopoker4 folded before Flop (didn't bet)
Seat 2: Lokobarys Ninja folded before Flop (didn't bet)
Seat 3: 4RING8 (button) folded before Flop (didn't bet)
Seat 4: jcarlos.vale (small blind) folded on the Flop
Seat 5: RCABelVedeRVerd (big blind) showed [Jh Qd] and won (1188) with a pair of Jacks
Seat 6: Mimishka004 folded before Flop (didn't bet)
Seat 7: richard5189 folded before Flop (didn't bet)
Seat 8: 84nurik84 folded before Flop (didn't bet)
Seat 9: BigMoneyJoe1 mucked [Ac 8d]



PokerStars Hand #222100743773: Tournament #3082583698, $0.98+$0.12 USD Hold'em No Limit - Level VII (60/120) - 2021/01/01 21:14:01 EET [2021/01/01 14:14:01 ET]
Table '3082583698 30' 9-max Seat #4 is the button
Seat 1: marquitopoker4 (6823 in chips) 
Seat 2: Lokobarys Ninja (3799 in chips) 
Seat 3: 4RING8 (582 in chips) 
Seat 4: jcarlos.vale (8712 in chips) 
Seat 5: RCABelVedeRVerd (12745 in chips) 
Seat 6: Mimishka004 (4444 in chips) 
Seat 7: richard5189 (8300 in chips) 
Seat 8: 84nurik84 (7160 in chips) 
Seat 9: BigMoneyJoe1 (4496 in chips) 
marquitopoker4: posts the ante 12
Lokobarys Ninja: posts the ante 12
4RING8: posts the ante 12
jcarlos.vale: posts the ante 12
RCABelVedeRVerd: posts the ante 12
Mimishka004: posts the ante 12
richard5189: posts the ante 12
84nurik84: posts the ante 12
BigMoneyJoe1: posts the ante 12
RCABelVedeRVerd: posts small blind 60
Mimishka004: posts big blind 120
*** HOLE CARDS ***
Dealt to jcarlos.vale [3d 2c]
richard5189: raises 120 to 240
84nurik84: folds 
BigMoneyJoe1: folds 
marquitopoker4: folds 
Lokobarys Ninja: folds 
4RING8: raises 330 to 570 and is all-in
jcarlos.vale: folds 
RCABelVedeRVerd: folds 
Mimishka004: folds 
richard5189: calls 330
*** FLOP *** [6h Ad Ah]
*** TURN *** [6h Ad Ah] [Tc]
*** RIVER *** [6h Ad Ah Tc] [5c]
*** SHOW DOWN ***
richard5189: shows [Kh Js] (a pair of Aces)
4RING8: shows [Jh Jc] (two pair, Aces and Jacks)
4RING8 collected 1428 from pot
*** SUMMARY ***
Total pot 1428 | Rake 0 
Board [6h Ad Ah Tc 5c]
Seat 1: marquitopoker4 folded before Flop (didn't bet)
Seat 2: Lokobarys Ninja folded before Flop (didn't bet)
Seat 3: 4RING8 showed [Jh Jc] and won (1428) with two pair, Aces and Jacks
Seat 4: jcarlos.vale (button) folded before Flop (didn't bet)
Seat 5: RCABelVedeRVerd (small blind) folded before Flop
Seat 6: Mimishka004 (big blind) folded before Flop
Seat 7: richard5189 showed [Kh Js] and lost with a pair of Aces
Seat 8: 84nurik84 folded before Flop (didn't bet)
Seat 9: BigMoneyJoe1 folded before Flop (didn't bet)



PokerStars Hand #222100793094: Tournament #3082583698, $0.98+$0.12 USD Hold'em No Limit - Level VII (60/120) - 2021/01/01 21:14:44 EET [2021/01/01 14:14:44 ET]
Table '3082583698 30' 9-max Seat #5 is the button
Seat 1: marquitopoker4 (6811 in chips) 
Seat 2: Lokobarys Ninja (3787 in chips) 
Seat 3: 4RING8 (1428 in chips) 
Seat 4: jcarlos.vale (8700 in chips) 
Seat 5: RCABelVedeRVerd (12673 in chips) 
Seat 6: Mimishka004 (4312 in chips) 
Seat 7: richard5189 (7718 in chips) 
Seat 8: 84nurik84 (7148 in chips) 
Seat 9: BigMoneyJoe1 (4484 in chips) 
marquitopoker4: posts the ante 12
Lokobarys Ninja: posts the ante 12
4RING8: posts the ante 12
jcarlos.vale: posts the ante 12
RCABelVedeRVerd: posts the ante 12
Mimishka004: posts the ante 12
richard5189: posts the ante 12
84nurik84: posts the ante 12
BigMoneyJoe1: posts the ante 12
Mimishka004: posts small blind 60
richard5189: posts big blind 120
*** HOLE CARDS ***
Dealt to jcarlos.vale [2d Td]
84nurik84: folds 
BigMoneyJoe1: calls 120
marquitopoker4: calls 120
Lokobarys Ninja: raises 540 to 660
4RING8: folds 
jcarlos.vale: folds 
RCABelVedeRVerd: folds 
Mimishka004: folds 
richard5189: folds 
BigMoneyJoe1: folds 
marquitopoker4: folds 
Uncalled bet (540) returned to Lokobarys Ninja
Lokobarys Ninja collected 648 from pot
*** SUMMARY ***
Total pot 648 | Rake 0 
Seat 1: marquitopoker4 folded before Flop
Seat 2: Lokobarys Ninja collected (648)
Seat 3: 4RING8 folded before Flop (didn't bet)
Seat 4: jcarlos.vale folded before Flop (didn't bet)
Seat 5: RCABelVedeRVerd (button) folded before Flop (didn't bet)
Seat 6: Mimishka004 (small blind) folded before Flop
Seat 7: richard5189 (big blind) folded before Flop
Seat 8: 84nurik84 folded before Flop (didn't bet)
Seat 9: BigMoneyJoe1 folded before Flop



PokerStars Hand #222100858957: Tournament #3082583698, $0.98+$0.12 USD Hold'em No Limit - Level VII (60/120) - 2021/01/01 21:15:42 EET [2021/01/01 14:15:42 ET]
Table '3082583698 30' 9-max Seat #6 is the button
Seat 1: marquitopoker4 (6679 in chips) 
Seat 2: Lokobarys Ninja (4303 in chips) 
Seat 3: 4RING8 (1416 in chips) 
Seat 4: jcarlos.vale (8688 in chips) 
Seat 5: RCABelVedeRVerd (12661 in chips) 
Seat 6: Mimishka004 (4240 in chips) 
Seat 7: richard5189 (7586 in chips) 
Seat 8: 84nurik84 (7136 in chips) 
Seat 9: BigMoneyJoe1 (4352 in chips) 
marquitopoker4: posts the ante 12
Lokobarys Ninja: posts the ante 12
4RING8: posts the ante 12
jcarlos.vale: posts the ante 12
RCABelVedeRVerd: posts the ante 12
Mimishka004: posts the ante 12
richard5189: posts the ante 12
84nurik84: posts the ante 12
BigMoneyJoe1: posts the ante 12
richard5189: posts small blind 60
84nurik84: posts big blind 120
*** HOLE CARDS ***
Dealt to jcarlos.vale [8h 6c]
BigMoneyJoe1: folds 
marquitopoker4: raises 121 to 241
Lokobarys Ninja: folds 
4RING8: folds 
jcarlos.vale: folds 
RCABelVedeRVerd: folds 
Mimishka004: folds 
richard5189: calls 181
84nurik84: calls 121
*** FLOP *** [3s Ks 4s]
richard5189: checks 
84nurik84: bets 274
marquitopoker4: folds 
richard5189: folds 
Uncalled bet (274) returned to 84nurik84
84nurik84 collected 831 from pot
84nurik84: doesn't show hand 
*** SUMMARY ***
Total pot 831 | Rake 0 
Board [3s Ks 4s]
Seat 1: marquitopoker4 folded on the Flop
Seat 2: Lokobarys Ninja folded before Flop (didn't bet)
Seat 3: 4RING8 folded before Flop (didn't bet)
Seat 4: jcarlos.vale folded before Flop (didn't bet)
Seat 5: RCABelVedeRVerd folded before Flop (didn't bet)
Seat 6: Mimishka004 (button) folded before Flop (didn't bet)
Seat 7: richard5189 (small blind) folded on the Flop
Seat 8: 84nurik84 (big blind) collected (831)
Seat 9: BigMoneyJoe1 folded before Flop (didn't bet)



PokerStars Hand #222100933582: Tournament #3082583698, $0.98+$0.12 USD Hold'em No Limit - Level VII (60/120) - 2021/01/01 21:16:47 EET [2021/01/01 14:16:47 ET]
Table '3082583698 30' 9-max Seat #7 is the button
Seat 1: marquitopoker4 (6426 in chips) 
Seat 2: Lokobarys Ninja (4291 in chips) 
Seat 3: 4RING8 (1404 in chips) 
Seat 4: jcarlos.vale (8676 in chips) 
Seat 5: RCABelVedeRVerd (12649 in chips) 
Seat 6: Mimishka004 (4228 in chips) 
Seat 7: richard5189 (7333 in chips) 
Seat 8: 84nurik84 (7714 in chips) 
Seat 9: BigMoneyJoe1 (4340 in chips) 
marquitopoker4: posts the ante 12
Lokobarys Ninja: posts the ante 12
4RING8: posts the ante 12
jcarlos.vale: posts the ante 12
RCABelVedeRVerd: posts the ante 12
Mimishka004: posts the ante 12
richard5189: posts the ante 12
84nurik84: posts the ante 12
BigMoneyJoe1: posts the ante 12
84nurik84: posts small blind 60
BigMoneyJoe1: posts big blind 120
*** HOLE CARDS ***
Dealt to jcarlos.vale [Qd 9s]
marquitopoker4: folds 
Lokobarys Ninja: folds 
4RING8: folds 
jcarlos.vale: folds 
RCABelVedeRVerd has timed out
RCABelVedeRVerd: folds 
RCABelVedeRVerd is sitting out
Mimishka004: folds 
richard5189: folds 
84nurik84: raises 180 to 300
BigMoneyJoe1: calls 180
*** FLOP *** [9c Th Ks]
84nurik84: checks 
BigMoneyJoe1: bets 360
84nurik84: calls 360
*** TURN *** [9c Th Ks] [Kd]
84nurik84: checks 
BigMoneyJoe1: bets 600
84nurik84: folds 
Uncalled bet (600) returned to BigMoneyJoe1
BigMoneyJoe1 collected 1428 from pot
BigMoneyJoe1: doesn't show hand 
*** SUMMARY ***
Total pot 1428 | Rake 0 
Board [9c Th Ks Kd]
Seat 1: marquitopoker4 folded before Flop (didn't bet)
Seat 2: Lokobarys Ninja folded before Flop (didn't bet)
Seat 3: 4RING8 folded before Flop (didn't bet)
Seat 4: jcarlos.vale folded before Flop (didn't bet)
Seat 5: RCABelVedeRVerd folded before Flop (didn't bet)
Seat 6: Mimishka004 folded before Flop (didn't bet)
Seat 7: richard5189 (button) folded before Flop (didn't bet)
Seat 8: 84nurik84 (small blind) folded on the Turn
Seat 9: BigMoneyJoe1 (big blind) collected (1428)



PokerStars Hand #222101042867: Tournament #3082583698, $0.98+$0.12 USD Hold'em No Limit - Level VIII (75/150) - 2021/01/01 21:18:22 EET [2021/01/01 14:18:22 ET]
Table '3082583698 30' 9-max Seat #8 is the button
Seat 1: marquitopoker4 (6414 in chips) 
Seat 2: Lokobarys Ninja (4279 in chips) 
Seat 3: 4RING8 (1392 in chips) 
Seat 4: jcarlos.vale (8664 in chips) 
Seat 5: RCABelVedeRVerd (12637 in chips) is sitting out
Seat 6: Mimishka004 (4216 in chips) 
Seat 7: richard5189 (7321 in chips) 
Seat 8: 84nurik84 (7042 in chips) 
Seat 9: BigMoneyJoe1 (5096 in chips) 
marquitopoker4: posts the ante 15
Lokobarys Ninja: posts the ante 15
4RING8: posts the ante 15
jcarlos.vale: posts the ante 15
RCABelVedeRVerd: posts the ante 15
Mimishka004: posts the ante 15
richard5189: posts the ante 15
84nurik84: posts the ante 15
BigMoneyJoe1: posts the ante 15
BigMoneyJoe1: posts small blind 75
marquitopoker4: posts big blind 150
*** HOLE CARDS ***
Dealt to jcarlos.vale [8s 2s]
Lokobarys Ninja: folds 
4RING8: folds 
jcarlos.vale: folds 
RCABelVedeRVerd: folds 
Mimishka004: raises 157 to 307
richard5189: folds 
84nurik84: folds 
RCABelVedeRVerd has returned
BigMoneyJoe1: folds 
marquitopoker4: folds 
Uncalled bet (157) returned to Mimishka004
Mimishka004 collected 510 from pot
*** SUMMARY ***
Total pot 510 | Rake 0 
Seat 1: marquitopoker4 (big blind) folded before Flop
Seat 2: Lokobarys Ninja folded before Flop (didn't bet)
Seat 3: 4RING8 folded before Flop (didn't bet)
Seat 4: jcarlos.vale folded before Flop (didn't bet)
Seat 5: RCABelVedeRVerd folded before Flop (didn't bet)
Seat 6: Mimishka004 collected (510)
Seat 7: richard5189 folded before Flop (didn't bet)
Seat 8: 84nurik84 (button) folded before Flop (didn't bet)
Seat 9: BigMoneyJoe1 (small blind) folded before Flop



PokerStars Hand #222101074278: Tournament #3082583698, $0.98+$0.12 USD Hold'em No Limit - Level VIII (75/150) - 2021/01/01 21:18:49 EET [2021/01/01 14:18:49 ET]
Table '3082583698 30' 9-max Seat #9 is the button
Seat 1: marquitopoker4 (6249 in chips) 
Seat 2: Lokobarys Ninja (4264 in chips) 
Seat 3: 4RING8 (1377 in chips) 
Seat 4: jcarlos.vale (8649 in chips) 
Seat 5: RCABelVedeRVerd (12622 in chips) 
Seat 6: Mimishka004 (4561 in chips) 
Seat 7: richard5189 (7306 in chips) 
Seat 8: 84nurik84 (7027 in chips) 
Seat 9: BigMoneyJoe1 (5006 in chips) 
marquitopoker4: posts the ante 15
Lokobarys Ninja: posts the ante 15
4RING8: posts the ante 15
jcarlos.vale: posts the ante 15
RCABelVedeRVerd: posts the ante 15
Mimishka004: posts the ante 15
richard5189: posts the ante 15
84nurik84: posts the ante 15
BigMoneyJoe1: posts the ante 15
marquitopoker4: posts small blind 75
Lokobarys Ninja: posts big blind 150
*** HOLE CARDS ***
Dealt to jcarlos.vale [2h Td]
4RING8: raises 1212 to 1362 and is all-in
jcarlos.vale: folds 
RCABelVedeRVerd: folds 
Mimishka004: folds 
richard5189: calls 1362
84nurik84: folds 
BigMoneyJoe1: folds 
marquitopoker4: folds 
Lokobarys Ninja: folds 
*** FLOP *** [5s 9d 4d]
*** TURN *** [5s 9d 4d] [Kd]
*** RIVER *** [5s 9d 4d Kd] [8d]
*** SHOW DOWN ***
4RING8: shows [Ac Qs] (high card Ace)
richard5189: shows [Qd As] (a flush, King high)
richard5189 collected 3084 from pot
4RING8 finished the tournament
*** SUMMARY ***
Total pot 3084 | Rake 0 
Board [5s 9d 4d Kd 8d]
Seat 1: marquitopoker4 (small blind) folded before Flop
Seat 2: Lokobarys Ninja (big blind) folded before Flop
Seat 3: 4RING8 showed [Ac Qs] and lost with high card Ace
Seat 4: jcarlos.vale folded before Flop (didn't bet)
Seat 5: RCABelVedeRVerd folded before Flop (didn't bet)
Seat 6: Mimishka004 folded before Flop (didn't bet)
Seat 7: richard5189 showed [Qd As] and won (3084) with a flush, King high
Seat 8: 84nurik84 folded before Flop (didn't bet)
Seat 9: BigMoneyJoe1 (button) folded before Flop (didn't bet)



PokerStars Hand #222101157487: Tournament #3082583698, $0.98+$0.12 USD Hold'em No Limit - Level VIII (75/150) - 2021/01/01 21:20:01 EET [2021/01/01 14:20:01 ET]
Table '3082583698 30' 9-max Seat #1 is the button
Seat 1: marquitopoker4 (6159 in chips) 
Seat 2: Lokobarys Ninja (4099 in chips) 
Seat 3: ganadormx (5000 in chips) 
Seat 4: jcarlos.vale (8634 in chips) 
Seat 5: RCABelVedeRVerd (12607 in chips) 
Seat 6: Mimishka004 (4546 in chips) 
Seat 7: richard5189 (9013 in chips) 
Seat 8: 84nurik84 (7012 in chips) 
Seat 9: BigMoneyJoe1 (4991 in chips) 
marquitopoker4: posts the ante 15
Lokobarys Ninja: posts the ante 15
ganadormx: posts the ante 15
jcarlos.vale: posts the ante 15
RCABelVedeRVerd: posts the ante 15
Mimishka004: posts the ante 15
richard5189: posts the ante 15
84nurik84: posts the ante 15
BigMoneyJoe1: posts the ante 15
Lokobarys Ninja: posts small blind 75
ganadormx: posts big blind 150
*** HOLE CARDS ***
Dealt to jcarlos.vale [9s 3s]
jcarlos.vale: folds 
RCABelVedeRVerd: raises 150 to 300
Mimishka004: folds 
richard5189: folds 
84nurik84: folds 
BigMoneyJoe1: folds 
marquitopoker4: folds 
Lokobarys Ninja: folds 
ganadormx: folds 
Uncalled bet (150) returned to RCABelVedeRVerd
RCABelVedeRVerd collected 510 from pot
*** SUMMARY ***
Total pot 510 | Rake 0 
Seat 1: marquitopoker4 (button) folded before Flop (didn't bet)
Seat 2: Lokobarys Ninja (small blind) folded before Flop
Seat 3: ganadormx (big blind) folded before Flop
Seat 4: jcarlos.vale folded before Flop (didn't bet)
Seat 5: RCABelVedeRVerd collected (510)
Seat 6: Mimishka004 folded before Flop (didn't bet)
Seat 7: richard5189 folded before Flop (didn't bet)
Seat 8: 84nurik84 folded before Flop (didn't bet)
Seat 9: BigMoneyJoe1 folded before Flop (didn't bet)



PokerStars Hand #222101217208: Tournament #3082583698, $0.98+$0.12 USD Hold'em No Limit - Level VIII (75/150) - 2021/01/01 21:20:53 EET [2021/01/01 14:20:53 ET]
Table '3082583698 30' 9-max Seat #2 is the button
Seat 1: marquitopoker4 (6144 in chips) 
Seat 2: Lokobarys Ninja (4009 in chips) 
Seat 3: ganadormx (4835 in chips) 
Seat 4: jcarlos.vale (8619 in chips) 
Seat 5: RCABelVedeRVerd (12952 in chips) 
Seat 6: Mimishka004 (4531 in chips) 
Seat 7: richard5189 (8998 in chips) 
Seat 8: 84nurik84 (6997 in chips) 
Seat 9: BigMoneyJoe1 (4976 in chips) 
marquitopoker4: posts the ante 15
Lokobarys Ninja: posts the ante 15
ganadormx: posts the ante 15
jcarlos.vale: posts the ante 15
RCABelVedeRVerd: posts the ante 15
Mimishka004: posts the ante 15
richard5189: posts the ante 15
84nurik84: posts the ante 15
BigMoneyJoe1: posts the ante 15
ganadormx: posts small blind 75
jcarlos.vale: posts big blind 150
*** HOLE CARDS ***
Dealt to jcarlos.vale [4s Jd]
RCABelVedeRVerd: folds 
Mimishka004: folds 
richard5189: folds 
84nurik84: folds 
BigMoneyJoe1: folds 
marquitopoker4: folds 
Lokobarys Ninja: raises 225 to 375
ganadormx: folds 
jcarlos.vale: folds 
Uncalled bet (225) returned to Lokobarys Ninja
Lokobarys Ninja collected 510 from pot
*** SUMMARY ***
Total pot 510 | Rake 0 
Seat 1: marquitopoker4 folded before Flop (didn't bet)
Seat 2: Lokobarys Ninja (button) collected (510)
Seat 3: ganadormx (small blind) folded before Flop
Seat 4: jcarlos.vale (big blind) folded before Flop
Seat 5: RCABelVedeRVerd folded before Flop (didn't bet)
Seat 6: Mimishka004 folded before Flop (didn't bet)
Seat 7: richard5189 folded before Flop (didn't bet)
Seat 8: 84nurik84 folded before Flop (didn't bet)
Seat 9: BigMoneyJoe1 folded before Flop (didn't bet)



PokerStars Hand #222101260727: Tournament #3082583698, $0.98+$0.12 USD Hold'em No Limit - Level VIII (75/150) - 2021/01/01 21:21:30 EET [2021/01/01 14:21:30 ET]
Table '3082583698 30' 9-max Seat #3 is the button
Seat 1: marquitopoker4 (6129 in chips) 
Seat 2: Lokobarys Ninja (4354 in chips) 
Seat 3: ganadormx (4745 in chips) 
Seat 4: jcarlos.vale (8454 in chips) 
Seat 5: RCABelVedeRVerd (12937 in chips) 
Seat 6: Mimishka004 (4516 in chips) 
Seat 7: richard5189 (8983 in chips) 
Seat 8: 84nurik84 (6982 in chips) 
Seat 9: BigMoneyJoe1 (4961 in chips) 
marquitopoker4: posts the ante 15
Lokobarys Ninja: posts the ante 15
ganadormx: posts the ante 15
jcarlos.vale: posts the ante 15
RCABelVedeRVerd: posts the ante 15
Mimishka004: posts the ante 15
richard5189: posts the ante 15
84nurik84: posts the ante 15
BigMoneyJoe1: posts the ante 15
jcarlos.vale: posts small blind 75
RCABelVedeRVerd: posts big blind 150
*** HOLE CARDS ***
Dealt to jcarlos.vale [Qc 3s]
Mimishka004: folds 
richard5189: folds 
84nurik84: raises 180 to 330
BigMoneyJoe1: calls 330
marquitopoker4: folds 
Lokobarys Ninja: folds 
ganadormx: folds 
jcarlos.vale: folds 
RCABelVedeRVerd has timed out
RCABelVedeRVerd: folds 
RCABelVedeRVerd is sitting out
*** FLOP *** [6s Ac Kh]
RCABelVedeRVerd has returned
84nurik84: bets 337
BigMoneyJoe1: calls 337
*** TURN *** [6s Ac Kh] [7s]
84nurik84: checks 
BigMoneyJoe1: checks 
*** RIVER *** [6s Ac Kh 7s] [Td]
84nurik84: checks 
BigMoneyJoe1: checks 
*** SHOW DOWN ***
84nurik84: shows [Ah Qs] (a pair of Aces)
BigMoneyJoe1: mucks hand 
84nurik84 collected 1694 from pot
*** SUMMARY ***
Total pot 1694 | Rake 0 
Board [6s Ac Kh 7s Td]
Seat 1: marquitopoker4 folded before Flop (didn't bet)
Seat 2: Lokobarys Ninja folded before Flop (didn't bet)
Seat 3: ganadormx (button) folded before Flop (didn't bet)
Seat 4: jcarlos.vale (small blind) folded before Flop
Seat 5: RCABelVedeRVerd (big blind) folded before Flop
Seat 6: Mimishka004 folded before Flop (didn't bet)
Seat 7: richard5189 folded before Flop (didn't bet)
Seat 8: 84nurik84 showed [Ah Qs] and won (1694) with a pair of Aces
Seat 9: BigMoneyJoe1 mucked [Js Th]



PokerStars Hand #222101342324: Tournament #3082583698, $0.98+$0.12 USD Hold'em No Limit - Level VIII (75/150) - 2021/01/01 21:22:41 EET [2021/01/01 14:22:41 ET]
Table '3082583698 30' 9-max Seat #4 is the button
Seat 1: marquitopoker4 (6114 in chips) 
Seat 2: Lokobarys Ninja (4339 in chips) 
Seat 3: ganadormx (4730 in chips) 
Seat 4: jcarlos.vale (8364 in chips) 
Seat 5: RCABelVedeRVerd (12772 in chips) 
Seat 6: Mimishka004 (4501 in chips) 
Seat 7: richard5189 (8968 in chips) 
Seat 8: 84nurik84 (7994 in chips) 
Seat 9: BigMoneyJoe1 (4279 in chips) 
marquitopoker4: posts the ante 15
Lokobarys Ninja: posts the ante 15
ganadormx: posts the ante 15
jcarlos.vale: posts the ante 15
RCABelVedeRVerd: posts the ante 15
Mimishka004: posts the ante 15
richard5189: posts the ante 15
84nurik84: posts the ante 15
BigMoneyJoe1: posts the ante 15
RCABelVedeRVerd: posts small blind 75
Mimishka004: posts big blind 150
*** HOLE CARDS ***
Dealt to jcarlos.vale [Qd 8c]
richard5189: folds 
84nurik84: raises 165 to 315
BigMoneyJoe1: folds 
marquitopoker4: folds 
RCABelVedeRVerd is disconnected 
Lokobarys Ninja: folds 
ganadormx: folds 
jcarlos.vale: folds 
RCABelVedeRVerd: folds 
Mimishka004: folds 
Uncalled bet (165) returned to 84nurik84
84nurik84 collected 510 from pot
84nurik84: doesn't show hand 
*** SUMMARY ***
Total pot 510 | Rake 0 
Seat 1: marquitopoker4 folded before Flop (didn't bet)
Seat 2: Lokobarys Ninja folded before Flop (didn't bet)
Seat 3: ganadormx folded before Flop (didn't bet)
Seat 4: jcarlos.vale (button) folded before Flop (didn't bet)
Seat 5: RCABelVedeRVerd (small blind) folded before Flop
Seat 6: Mimishka004 (big blind) folded before Flop
Seat 7: richard5189 folded before Flop (didn't bet)
Seat 8: 84nurik84 collected (510)
Seat 9: BigMoneyJoe1 folded before Flop (didn't bet)



PokerStars Hand #222101377660: Tournament #3082583698, $0.98+$0.12 USD Hold'em No Limit - Level VIII (75/150) - 2021/01/01 21:23:12 EET [2021/01/01 14:23:12 ET]
Table '3082583698 30' 9-max Seat #5 is the button
Seat 1: marquitopoker4 (6099 in chips) 
Seat 2: Lokobarys Ninja (4324 in chips) 
Seat 3: ganadormx (4715 in chips) 
Seat 4: jcarlos.vale (8349 in chips) 
Seat 5: RCABelVedeRVerd (12682 in chips) 
Seat 6: Mimishka004 (4336 in chips) 
Seat 7: richard5189 (8953 in chips) 
Seat 8: 84nurik84 (8339 in chips) 
Seat 9: BigMoneyJoe1 (4264 in chips) 
marquitopoker4: posts the ante 15
Lokobarys Ninja: posts the ante 15
ganadormx: posts the ante 15
jcarlos.vale: posts the ante 15
RCABelVedeRVerd: posts the ante 15
Mimishka004: posts the ante 15
richard5189: posts the ante 15
84nurik84: posts the ante 15
BigMoneyJoe1: posts the ante 15
Mimishka004: posts small blind 75
richard5189: posts big blind 150
*** HOLE CARDS ***
Dealt to jcarlos.vale [Js 7d]
84nurik84: folds 
BigMoneyJoe1: folds 
marquitopoker4: folds 
Lokobarys Ninja: folds 
ganadormx: folds 
jcarlos.vale: folds 
RCABelVedeRVerd: calls 150
Mimishka004: raises 375 to 525
richard5189: calls 375
RCABelVedeRVerd: raises 12142 to 12667 and is all-in
Mimishka004: folds 
richard5189: folds 
Uncalled bet (12142) returned to RCABelVedeRVerd
RCABelVedeRVerd collected 1710 from pot
*** SUMMARY ***
Total pot 1710 | Rake 0 
Seat 1: marquitopoker4 folded before Flop (didn't bet)
Seat 2: Lokobarys Ninja folded before Flop (didn't bet)
Seat 3: ganadormx folded before Flop (didn't bet)
Seat 4: jcarlos.vale folded before Flop (didn't bet)
Seat 5: RCABelVedeRVerd (button) collected (1710)
Seat 6: Mimishka004 (small blind) folded before Flop
Seat 7: richard5189 (big blind) folded before Flop
Seat 8: 84nurik84 folded before Flop (didn't bet)
Seat 9: BigMoneyJoe1 folded before Flop (didn't bet)



PokerStars Hand #222101446945: Tournament #3082583698, $0.98+$0.12 USD Hold'em No Limit - Level VIII (75/150) - 2021/01/01 21:24:12 EET [2021/01/01 14:24:12 ET]
Table '3082583698 30' 9-max Seat #6 is the button
Seat 1: marquitopoker4 (6084 in chips) 
Seat 2: Lokobarys Ninja (4309 in chips) 
Seat 3: ganadormx (4700 in chips) 
Seat 4: jcarlos.vale (8334 in chips) 
Seat 5: RCABelVedeRVerd (13852 in chips) 
Seat 6: Mimishka004 (3796 in chips) 
Seat 7: richard5189 (8413 in chips) 
Seat 8: 84nurik84 (8324 in chips) 
Seat 9: BigMoneyJoe1 (4249 in chips) 
marquitopoker4: posts the ante 15
Lokobarys Ninja: posts the ante 15
ganadormx: posts the ante 15
jcarlos.vale: posts the ante 15
RCABelVedeRVerd: posts the ante 15
Mimishka004: posts the ante 15
richard5189: posts the ante 15
84nurik84: posts the ante 15
BigMoneyJoe1: posts the ante 15
richard5189: posts small blind 75
84nurik84: posts big blind 150
*** HOLE CARDS ***
Dealt to jcarlos.vale [Jd 2h]
BigMoneyJoe1: raises 150 to 300
marquitopoker4: folds 
Lokobarys Ninja: folds 
ganadormx: folds 
jcarlos.vale: folds 
RCABelVedeRVerd: calls 300
Mimishka004: folds 
richard5189: folds 
84nurik84: calls 150
*** FLOP *** [Ks 5d 3h]
84nurik84: checks 
BigMoneyJoe1: bets 300
RCABelVedeRVerd: calls 300
84nurik84: folds 
*** TURN *** [Ks 5d 3h] [Kd]
BigMoneyJoe1: bets 855
RCABelVedeRVerd: calls 855
*** RIVER *** [Ks 5d 3h Kd] [7d]
BigMoneyJoe1: checks 
RCABelVedeRVerd: bets 1800
BigMoneyJoe1: calls 1800
*** SHOW DOWN ***
RCABelVedeRVerd: shows [Tc Kc] (three of a kind, Kings)
BigMoneyJoe1: mucks hand 
RCABelVedeRVerd collected 7020 from pot
*** SUMMARY ***
Total pot 7020 | Rake 0 
Board [Ks 5d 3h Kd 7d]
Seat 1: marquitopoker4 folded before Flop (didn't bet)
Seat 2: Lokobarys Ninja folded before Flop (didn't bet)
Seat 3: ganadormx folded before Flop (didn't bet)
Seat 4: jcarlos.vale folded before Flop (didn't bet)
Seat 5: RCABelVedeRVerd showed [Tc Kc] and won (7020) with three of a kind, Kings
Seat 6: Mimishka004 (button) folded before Flop (didn't bet)
Seat 7: richard5189 (small blind) folded before Flop
Seat 8: 84nurik84 (big blind) folded on the Flop
Seat 9: BigMoneyJoe1 mucked [6d 6c]



PokerStars Hand #222101539201: Tournament #3082583698, $0.98+$0.12 USD Hold'em No Limit - Level VIII (75/150) - 2021/01/01 21:25:33 EET [2021/01/01 14:25:33 ET]
Table '3082583698 30' 9-max Seat #7 is the button
Seat 1: marquitopoker4 (6069 in chips) 
Seat 2: Lokobarys Ninja (4294 in chips) 
Seat 3: ganadormx (4685 in chips) 
Seat 4: jcarlos.vale (8319 in chips) 
Seat 5: RCABelVedeRVerd (17602 in chips) 
Seat 6: Mimishka004 (3781 in chips) 
Seat 7: richard5189 (8323 in chips) 
Seat 8: 84nurik84 (8009 in chips) 
Seat 9: BigMoneyJoe1 (979 in chips) 
marquitopoker4: posts the ante 15
Lokobarys Ninja: posts the ante 15
ganadormx: posts the ante 15
jcarlos.vale: posts the ante 15
RCABelVedeRVerd: posts the ante 15
Mimishka004: posts the ante 15
richard5189: posts the ante 15
84nurik84: posts the ante 15
BigMoneyJoe1: posts the ante 15
84nurik84: posts small blind 75
BigMoneyJoe1: posts big blind 150
*** HOLE CARDS ***
Dealt to jcarlos.vale [2s 3s]
marquitopoker4: folds 
Lokobarys Ninja: folds 
ganadormx: folds 
jcarlos.vale: folds 
RCABelVedeRVerd: folds 
Mimishka004: folds 
richard5189: calls 150
84nurik84: folds 
BigMoneyJoe1: checks 
*** FLOP *** [8s Ts 6c]
BigMoneyJoe1: checks 
richard5189: checks 
*** TURN *** [8s Ts 6c] [7h]
BigMoneyJoe1: bets 255
richard5189: folds 
Uncalled bet (255) returned to BigMoneyJoe1
BigMoneyJoe1 collected 510 from pot
BigMoneyJoe1: doesn't show hand 
*** SUMMARY ***
Total pot 510 | Rake 0 
Board [8s Ts 6c 7h]
Seat 1: marquitopoker4 folded before Flop (didn't bet)
Seat 2: Lokobarys Ninja folded before Flop (didn't bet)
Seat 3: ganadormx folded before Flop (didn't bet)
Seat 4: jcarlos.vale folded before Flop (didn't bet)
Seat 5: RCABelVedeRVerd folded before Flop (didn't bet)
Seat 6: Mimishka004 folded before Flop (didn't bet)
Seat 7: richard5189 (button) folded on the Turn
Seat 8: 84nurik84 (small blind) folded before Flop
Seat 9: BigMoneyJoe1 (big blind) collected (510)



PokerStars Hand #222101627872: Tournament #3082583698, $0.98+$0.12 USD Hold'em No Limit - Level VIII (75/150) - 2021/01/01 21:26:50 EET [2021/01/01 14:26:50 ET]
Table '3082583698 30' 9-max Seat #8 is the button
Seat 1: marquitopoker4 (6054 in chips) 
Seat 2: Lokobarys Ninja (4279 in chips) 
Seat 3: ganadormx (4670 in chips) 
Seat 4: jcarlos.vale (8304 in chips) 
Seat 5: RCABelVedeRVerd (17587 in chips) 
Seat 6: Mimishka004 (3766 in chips) 
Seat 7: richard5189 (8158 in chips) 
Seat 8: 84nurik84 (7919 in chips) 
Seat 9: BigMoneyJoe1 (1324 in chips) 
marquitopoker4: posts the ante 15
Lokobarys Ninja: posts the ante 15
ganadormx: posts the ante 15
jcarlos.vale: posts the ante 15
RCABelVedeRVerd: posts the ante 15
Mimishka004: posts the ante 15
richard5189: posts the ante 15
84nurik84: posts the ante 15
BigMoneyJoe1: posts the ante 15
BigMoneyJoe1: posts small blind 75
marquitopoker4: posts big blind 150
*** HOLE CARDS ***
Dealt to jcarlos.vale [Jh 6s]
Lokobarys Ninja: folds 
ganadormx: folds 
jcarlos.vale: folds 
RCABelVedeRVerd: raises 232 to 382
Mimishka004: folds 
richard5189: calls 382
84nurik84: folds 
BigMoneyJoe1: calls 307
marquitopoker4: calls 232
*** FLOP *** [3d 8s Qc]
BigMoneyJoe1: checks 
marquitopoker4: checks 
RCABelVedeRVerd: checks 
richard5189: checks 
*** TURN *** [3d 8s Qc] [Qs]
BigMoneyJoe1: checks 
marquitopoker4: checks 
RCABelVedeRVerd: checks 
richard5189: checks 
*** RIVER *** [3d 8s Qc Qs] [Kc]
BigMoneyJoe1: checks 
marquitopoker4: checks 
RCABelVedeRVerd: bets 600
richard5189: folds 
BigMoneyJoe1: folds 
marquitopoker4: folds 
Uncalled bet (600) returned to RCABelVedeRVerd
RCABelVedeRVerd collected 1663 from pot
*** SUMMARY ***
Total pot 1663 | Rake 0 
Board [3d 8s Qc Qs Kc]
Seat 1: marquitopoker4 (big blind) folded on the River
Seat 2: Lokobarys Ninja folded before Flop (didn't bet)
Seat 3: ganadormx folded before Flop (didn't bet)
Seat 4: jcarlos.vale folded before Flop (didn't bet)
Seat 5: RCABelVedeRVerd collected (1663)
Seat 6: Mimishka004 folded before Flop (didn't bet)
Seat 7: richard5189 folded on the River
Seat 8: 84nurik84 (button) folded before Flop (didn't bet)
Seat 9: BigMoneyJoe1 (small blind) folded on the River



PokerStars Hand #222101748394: Tournament #3082583698, $0.98+$0.12 USD Hold'em No Limit - Level IX (100/200) - 2021/01/01 21:28:31 EET [2021/01/01 14:28:31 ET]
Table '3082583698 30' 9-max Seat #9 is the button
Seat 1: marquitopoker4 (5657 in chips) 
Seat 2: Lokobarys Ninja (4264 in chips) 
Seat 3: ganadormx (4655 in chips) 
Seat 4: jcarlos.vale (8289 in chips) 
Seat 5: RCABelVedeRVerd (18853 in chips) 
Seat 6: Mimishka004 (3751 in chips) 
Seat 7: richard5189 (7761 in chips) 
Seat 8: 84nurik84 (7904 in chips) 
Seat 9: BigMoneyJoe1 (927 in chips) 
marquitopoker4: posts the ante 18
Lokobarys Ninja: posts the ante 18
ganadormx: posts the ante 18
jcarlos.vale: posts the ante 18
RCABelVedeRVerd: posts the ante 18
Mimishka004: posts the ante 18
richard5189: posts the ante 18
84nurik84: posts the ante 18
BigMoneyJoe1: posts the ante 18
marquitopoker4: posts small blind 100
Lokobarys Ninja: posts big blind 200
*** HOLE CARDS ***
Dealt to jcarlos.vale [Js 4h]
RCABelVedeRVerd has returned
ganadormx: folds 
jcarlos.vale: folds 
RCABelVedeRVerd: raises 200 to 400
Mimishka004: raises 3333 to 3733 and is all-in
richard5189: folds 
84nurik84: folds 
BigMoneyJoe1: calls 909 and is all-in
marquitopoker4: folds 
Lokobarys Ninja: folds 
RCABelVedeRVerd: calls 3333
*** FLOP *** [8d Ts Jh]
*** TURN *** [8d Ts Jh] [Jd]
*** RIVER *** [8d Ts Jh Jd] [7c]
*** SHOW DOWN ***
RCABelVedeRVerd: shows [Ac Ks] (a pair of Jacks)
Mimishka004: shows [Th Tc] (a full house, Tens full of Jacks)
Mimishka004 collected 5648 from side pot
BigMoneyJoe1: shows [Ah Qs] (a pair of Jacks)
Mimishka004 collected 3189 from main pot
BigMoneyJoe1 finished the tournament
*** SUMMARY ***
Total pot 8837 Main pot 3189. Side pot 5648. | Rake 0 
Board [8d Ts Jh Jd 7c]
Seat 1: marquitopoker4 (small blind) folded before Flop
Seat 2: Lokobarys Ninja (big blind) folded before Flop
Seat 3: ganadormx folded before Flop (didn't bet)
Seat 4: jcarlos.vale folded before Flop (didn't bet)
Seat 5: RCABelVedeRVerd showed [Ac Ks] and lost with a pair of Jacks
Seat 6: Mimishka004 showed [Th Tc] and won (8837) with a full house, Tens full of Jacks
Seat 7: richard5189 folded before Flop (didn't bet)
Seat 8: 84nurik84 folded before Flop (didn't bet)
Seat 9: BigMoneyJoe1 (button) showed [Ah Qs] and lost with a pair of Jacks



PokerStars Hand #222101792271: Tournament #3082583698, $0.98+$0.12 USD Hold'em No Limit - Level IX (100/200) - 2021/01/01 21:29:12 EET [2021/01/01 14:29:12 ET]
Table '3082583698 30' 9-max Seat #1 is the button
Seat 1: marquitopoker4 (5539 in chips) 
Seat 2: Lokobarys Ninja (4046 in chips) 
Seat 3: ganadormx (4637 in chips) 
Seat 4: jcarlos.vale (8271 in chips) 
Seat 5: RCABelVedeRVerd (15102 in chips) 
Seat 6: Mimishka004 (8837 in chips) 
Seat 7: richard5189 (7743 in chips) 
Seat 8: 84nurik84 (7886 in chips) 
marquitopoker4: posts the ante 18
Lokobarys Ninja: posts the ante 18
ganadormx: posts the ante 18
jcarlos.vale: posts the ante 18
RCABelVedeRVerd: posts the ante 18
Mimishka004: posts the ante 18
richard5189: posts the ante 18
84nurik84: posts the ante 18
Lokobarys Ninja: posts small blind 100
ganadormx: posts big blind 200
*** HOLE CARDS ***
Dealt to jcarlos.vale [Kh 8c]
jcarlos.vale: folds 
RCABelVedeRVerd: calls 200
Mimishka004: folds 
richard5189: folds 
84nurik84: calls 200
marquitopoker4: folds 
Lokobarys Ninja: calls 100
ganadormx: checks 
*** FLOP *** [2d As Ts]
Lokobarys Ninja: checks 
ganadormx: checks 
RCABelVedeRVerd: bets 400
84nurik84: raises 600 to 1000
Lokobarys Ninja: folds 
ganadormx: folds 
RCABelVedeRVerd: folds 
Uncalled bet (600) returned to 84nurik84
84nurik84 collected 1744 from pot
84nurik84: doesn't show hand 
*** SUMMARY ***
Total pot 1744 | Rake 0 
Board [2d As Ts]
Seat 1: marquitopoker4 (button) folded before Flop (didn't bet)
Seat 2: Lokobarys Ninja (small blind) folded on the Flop
Seat 3: ganadormx (big blind) folded on the Flop
Seat 4: jcarlos.vale folded before Flop (didn't bet)
Seat 5: RCABelVedeRVerd folded on the Flop
Seat 6: Mimishka004 folded before Flop (didn't bet)
Seat 7: richard5189 folded before Flop (didn't bet)
Seat 8: 84nurik84 collected (1744)



PokerStars Hand #222101873564: Tournament #3082583698, $0.98+$0.12 USD Hold'em No Limit - Level IX (100/200) - 2021/01/01 21:30:27 EET [2021/01/01 14:30:27 ET]
Table '3082583698 30' 9-max Seat #2 is the button
Seat 1: marquitopoker4 (5521 in chips) 
Seat 2: Lokobarys Ninja (3828 in chips) 
Seat 3: ganadormx (4419 in chips) 
Seat 4: jcarlos.vale (8253 in chips) 
Seat 5: RCABelVedeRVerd (14484 in chips) 
Seat 6: Mimishka004 (8819 in chips) 
Seat 7: richard5189 (7725 in chips) 
Seat 8: 84nurik84 (9012 in chips) 
Seat 9: applefriend (1561 in chips) 
marquitopoker4: posts the ante 18
Lokobarys Ninja: posts the ante 18
ganadormx: posts the ante 18
jcarlos.vale: posts the ante 18
RCABelVedeRVerd: posts the ante 18
Mimishka004: posts the ante 18
richard5189: posts the ante 18
84nurik84: posts the ante 18
applefriend: posts the ante 18
ganadormx: posts small blind 100
jcarlos.vale: posts big blind 200
*** HOLE CARDS ***
Dealt to jcarlos.vale [2s 5d]
RCABelVedeRVerd: folds 
Mimishka004: folds 
richard5189: folds 
84nurik84: folds 
applefriend: folds 
marquitopoker4: folds 
Lokobarys Ninja: folds 
RCABelVedeRVerd is sitting out
ganadormx: folds 
Uncalled bet (100) returned to jcarlos.vale
jcarlos.vale collected 362 from pot
jcarlos.vale: doesn't show hand 
*** SUMMARY ***
Total pot 362 | Rake 0 
Seat 1: marquitopoker4 folded before Flop (didn't bet)
Seat 2: Lokobarys Ninja (button) folded before Flop (didn't bet)
Seat 3: ganadormx (small blind) folded before Flop
Seat 4: jcarlos.vale (big blind) collected (362)
Seat 5: RCABelVedeRVerd folded before Flop (didn't bet)
Seat 6: Mimishka004 folded before Flop (didn't bet)
Seat 7: richard5189 folded before Flop (didn't bet)
Seat 8: 84nurik84 folded before Flop (didn't bet)
Seat 9: applefriend folded before Flop (didn't bet)



PokerStars Hand #222101907860: Tournament #3082583698, $0.98+$0.12 USD Hold'em No Limit - Level IX (100/200) - 2021/01/01 21:30:58 EET [2021/01/01 14:30:58 ET]
Table '3082583698 30' 9-max Seat #3 is the button
Seat 1: marquitopoker4 (5503 in chips) 
Seat 2: Lokobarys Ninja (3810 in chips) 
Seat 3: ganadormx (4301 in chips) 
Seat 4: jcarlos.vale (8497 in chips) 
Seat 5: RCABelVedeRVerd (14466 in chips) is sitting out
Seat 6: Mimishka004 (8801 in chips) 
Seat 7: richard5189 (7707 in chips) 
Seat 8: 84nurik84 (8994 in chips) 
Seat 9: applefriend (1543 in chips) 
marquitopoker4: posts the ante 18
Lokobarys Ninja: posts the ante 18
ganadormx: posts the ante 18
jcarlos.vale: posts the ante 18
RCABelVedeRVerd: posts the ante 18
Mimishka004: posts the ante 18
richard5189: posts the ante 18
84nurik84: posts the ante 18
applefriend: posts the ante 18
jcarlos.vale: posts small blind 100
RCABelVedeRVerd: posts big blind 200
*** HOLE CARDS ***
Dealt to jcarlos.vale [Ad 6s]
Mimishka004: folds 
richard5189: calls 200
84nurik84: folds 
applefriend: folds 
marquitopoker4: folds 
Lokobarys Ninja: folds 
ganadormx: folds 
jcarlos.vale: calls 100
RCABelVedeRVerd: folds 
*** FLOP *** [9s 5c Th]
jcarlos.vale: checks 
richard5189: checks 
*** TURN *** [9s 5c Th] [Js]
jcarlos.vale: bets 200
richard5189: calls 200
*** RIVER *** [9s 5c Th Js] [8s]
jcarlos.vale: bets 200
richard5189: raises 781 to 981
jcarlos.vale: folds 
Uncalled bet (781) returned to richard5189
richard5189 collected 1562 from pot
richard5189: doesn't show hand 
*** SUMMARY ***
Total pot 1562 | Rake 0 
Board [9s 5c Th Js 8s]
Seat 1: marquitopoker4 folded before Flop (didn't bet)
Seat 2: Lokobarys Ninja folded before Flop (didn't bet)
Seat 3: ganadormx (button) folded before Flop (didn't bet)
Seat 4: jcarlos.vale (small blind) folded on the River
Seat 5: RCABelVedeRVerd (big blind) folded before Flop
Seat 6: Mimishka004 folded before Flop (didn't bet)
Seat 7: richard5189 collected (1562)
Seat 8: 84nurik84 folded before Flop (didn't bet)
Seat 9: applefriend folded before Flop (didn't bet)



PokerStars Hand #222101956948: Tournament #3082583698, $0.98+$0.12 USD Hold'em No Limit - Level IX (100/200) - 2021/01/01 21:31:43 EET [2021/01/01 14:31:43 ET]
Table '3082583698 30' 9-max Seat #4 is the button
Seat 1: marquitopoker4 (5485 in chips) 
Seat 2: Lokobarys Ninja (3792 in chips) 
Seat 3: ganadormx (4283 in chips) 
Seat 4: jcarlos.vale (7879 in chips) 
Seat 5: RCABelVedeRVerd (14248 in chips) is sitting out
Seat 6: Mimishka004 (8783 in chips) 
Seat 7: richard5189 (8651 in chips) 
Seat 8: 84nurik84 (8976 in chips) 
Seat 9: applefriend (1525 in chips) 
marquitopoker4: posts the ante 18
Lokobarys Ninja: posts the ante 18
ganadormx: posts the ante 18
jcarlos.vale: posts the ante 18
RCABelVedeRVerd: posts the ante 18
Mimishka004: posts the ante 18
richard5189: posts the ante 18
84nurik84: posts the ante 18
applefriend: posts the ante 18
RCABelVedeRVerd: posts small blind 100
Mimishka004: posts big blind 200
*** HOLE CARDS ***
Dealt to jcarlos.vale [8h 4d]
richard5189: calls 200
84nurik84: raises 300 to 500
applefriend: folds 
marquitopoker4: folds 
Lokobarys Ninja: folds 
ganadormx: folds 
jcarlos.vale: folds 
RCABelVedeRVerd: folds 
Mimishka004: calls 300
richard5189: calls 300
*** FLOP *** [7d Qc Js]
Mimishka004: bets 581
richard5189: folds 
84nurik84: calls 581
*** TURN *** [7d Qc Js] [4s]
Mimishka004: bets 1300
84nurik84: calls 1300
*** RIVER *** [7d Qc Js 4s] [Th]
Mimishka004: bets 1823
84nurik84: calls 1823
*** SHOW DOWN ***
Mimishka004: shows [7c 7h] (three of a kind, Sevens)
84nurik84: mucks hand 
Mimishka004 collected 9170 from pot
*** SUMMARY ***
Total pot 9170 | Rake 0 
Board [7d Qc Js 4s Th]
Seat 1: marquitopoker4 folded before Flop (didn't bet)
Seat 2: Lokobarys Ninja folded before Flop (didn't bet)
Seat 3: ganadormx folded before Flop (didn't bet)
Seat 4: jcarlos.vale (button) folded before Flop (didn't bet)
Seat 5: RCABelVedeRVerd (small blind) folded before Flop
Seat 6: Mimishka004 (big blind) showed [7c 7h] and won (9170) with three of a kind, Sevens
Seat 7: richard5189 folded on the Flop
Seat 8: 84nurik84 mucked [Ac Qh]
Seat 9: applefriend folded before Flop (didn't bet)



PokerStars Hand #222102013604: Tournament #3082583698, $0.98+$0.12 USD Hold'em No Limit - Level IX (100/200) - 2021/01/01 21:32:36 EET [2021/01/01 14:32:36 ET]
Table '3082583698 30' 9-max Seat #5 is the button
Seat 1: marquitopoker4 (5467 in chips) 
Seat 2: Lokobarys Ninja (3774 in chips) 
Seat 3: ganadormx (4265 in chips) 
Seat 4: jcarlos.vale (7861 in chips) 
Seat 5: RCABelVedeRVerd (14130 in chips) is sitting out
Seat 6: Mimishka004 (13731 in chips) 
Seat 7: richard5189 (8133 in chips) 
Seat 8: 84nurik84 (4754 in chips) 
Seat 9: applefriend (1507 in chips) 
marquitopoker4: posts the ante 18
Lokobarys Ninja: posts the ante 18
ganadormx: posts the ante 18
jcarlos.vale: posts the ante 18
RCABelVedeRVerd: posts the ante 18
Mimishka004: posts the ante 18
richard5189: posts the ante 18
84nurik84: posts the ante 18
applefriend: posts the ante 18
Mimishka004: posts small blind 100
richard5189: posts big blind 200
*** HOLE CARDS ***
Dealt to jcarlos.vale [Ac 9h]
84nurik84: folds 
applefriend: folds 
marquitopoker4: folds 
Lokobarys Ninja: folds 
ganadormx: folds 
jcarlos.vale: raises 320 to 520
RCABelVedeRVerd: folds 
Mimishka004: raises 1180 to 1700
richard5189: folds 
jcarlos.vale: folds 
Uncalled bet (1180) returned to Mimishka004
Mimishka004 collected 1402 from pot
*** SUMMARY ***
Total pot 1402 | Rake 0 
Seat 1: marquitopoker4 folded before Flop (didn't bet)
Seat 2: Lokobarys Ninja folded before Flop (didn't bet)
Seat 3: ganadormx folded before Flop (didn't bet)
Seat 4: jcarlos.vale folded before Flop
Seat 5: RCABelVedeRVerd (button) folded before Flop (didn't bet)
Seat 6: Mimishka004 (small blind) collected (1402)
Seat 7: richard5189 (big blind) folded before Flop
Seat 8: 84nurik84 folded before Flop (didn't bet)
Seat 9: applefriend folded before Flop (didn't bet)



PokerStars Hand #222102051264: Tournament #3082583698, $0.98+$0.12 USD Hold'em No Limit - Level IX (100/200) - 2021/01/01 21:33:11 EET [2021/01/01 14:33:11 ET]
Table '3082583698 30' 9-max Seat #6 is the button
Seat 1: marquitopoker4 (5449 in chips) 
Seat 2: Lokobarys Ninja (3756 in chips) 
Seat 3: ganadormx (4247 in chips) 
Seat 4: jcarlos.vale (7323 in chips) 
Seat 5: RCABelVedeRVerd (14112 in chips) is sitting out
Seat 6: Mimishka004 (14595 in chips) 
Seat 7: richard5189 (7915 in chips) 
Seat 8: 84nurik84 (4736 in chips) 
Seat 9: applefriend (1489 in chips) 
marquitopoker4: posts the ante 18
Lokobarys Ninja: posts the ante 18
ganadormx: posts the ante 18
jcarlos.vale: posts the ante 18
RCABelVedeRVerd: posts the ante 18
Mimishka004: posts the ante 18
richard5189: posts the ante 18
84nurik84: posts the ante 18
applefriend: posts the ante 18
richard5189: posts small blind 100
84nurik84: posts big blind 200
*** HOLE CARDS ***
Dealt to jcarlos.vale [9d Kh]
applefriend: folds 
marquitopoker4: raises 202 to 402
Lokobarys Ninja: folds 
ganadormx: folds 
jcarlos.vale: folds 
RCABelVedeRVerd: folds 
Mimishka004: folds 
richard5189: folds 
84nurik84: folds 
Uncalled bet (202) returned to marquitopoker4
marquitopoker4 collected 662 from pot
marquitopoker4: doesn't show hand 
*** SUMMARY ***
Total pot 662 | Rake 0 
Seat 1: marquitopoker4 collected (662)
Seat 2: Lokobarys Ninja folded before Flop (didn't bet)
Seat 3: ganadormx folded before Flop (didn't bet)
Seat 4: jcarlos.vale folded before Flop (didn't bet)
Seat 5: RCABelVedeRVerd folded before Flop (didn't bet)
Seat 6: Mimishka004 (button) folded before Flop (didn't bet)
Seat 7: richard5189 (small blind) folded before Flop
Seat 8: 84nurik84 (big blind) folded before Flop
Seat 9: applefriend folded before Flop (didn't bet)



PokerStars Hand #222102080540: Tournament #3082583698, $0.98+$0.12 USD Hold'em No Limit - Level IX (100/200) - 2021/01/01 21:33:38 EET [2021/01/01 14:33:38 ET]
Table '3082583698 30' 9-max Seat #7 is the button
Seat 1: marquitopoker4 (5893 in chips) 
Seat 2: Lokobarys Ninja (3738 in chips) 
Seat 3: ganadormx (4229 in chips) 
Seat 4: jcarlos.vale (7305 in chips) 
Seat 5: RCABelVedeRVerd (14094 in chips) is sitting out
Seat 6: Mimishka004 (14577 in chips) 
Seat 7: richard5189 (7797 in chips) 
Seat 8: 84nurik84 (4518 in chips) 
Seat 9: applefriend (1471 in chips) 
marquitopoker4: posts the ante 18
Lokobarys Ninja: posts the ante 18
ganadormx: posts the ante 18
jcarlos.vale: posts the ante 18
RCABelVedeRVerd: posts the ante 18
Mimishka004: posts the ante 18
richard5189: posts the ante 18
84nurik84: posts the ante 18
applefriend: posts the ante 18
84nurik84: posts small blind 100
applefriend: posts big blind 200
*** HOLE CARDS ***
Dealt to jcarlos.vale [9c Kd]
marquitopoker4: folds 
Lokobarys Ninja: raises 400 to 600
ganadormx: folds 
jcarlos.vale: folds 
RCABelVedeRVerd: folds 
Mimishka004: folds 
richard5189: folds 
84nurik84: folds 
applefriend: raises 853 to 1453 and is all-in
Lokobarys Ninja has timed out
Lokobarys Ninja: folds 
Lokobarys Ninja is sitting out
Uncalled bet (853) returned to applefriend
applefriend collected 1462 from pot
applefriend: doesn't show hand 
*** SUMMARY ***
Total pot 1462 | Rake 0 
Seat 1: marquitopoker4 folded before Flop (didn't bet)
Seat 2: Lokobarys Ninja folded before Flop
Seat 3: ganadormx folded before Flop (didn't bet)
Seat 4: jcarlos.vale folded before Flop (didn't bet)
Seat 5: RCABelVedeRVerd folded before Flop (didn't bet)
Seat 6: Mimishka004 folded before Flop (didn't bet)
Seat 7: richard5189 (button) folded before Flop (didn't bet)
Seat 8: 84nurik84 (small blind) folded before Flop
Seat 9: applefriend (big blind) collected (1462)



PokerStars Hand #222102128161: Tournament #3082583698, $0.98+$0.12 USD Hold'em No Limit - Level IX (100/200) - 2021/01/01 21:34:23 EET [2021/01/01 14:34:23 ET]
Table '3082583698 30' 9-max Seat #8 is the button
Seat 1: marquitopoker4 (5875 in chips) 
Seat 2: Lokobarys Ninja (3120 in chips) is sitting out
Seat 3: ganadormx (4211 in chips) 
Seat 4: jcarlos.vale (7287 in chips) 
Seat 5: RCABelVedeRVerd (14076 in chips) is sitting out
Seat 6: Mimishka004 (14559 in chips) 
Seat 7: richard5189 (7779 in chips) 
Seat 8: 84nurik84 (4400 in chips) 
Seat 9: applefriend (2315 in chips) 
marquitopoker4: posts the ante 18
Lokobarys Ninja: posts the ante 18
ganadormx: posts the ante 18
jcarlos.vale: posts the ante 18
RCABelVedeRVerd: posts the ante 18
Mimishka004: posts the ante 18
richard5189: posts the ante 18
84nurik84: posts the ante 18
applefriend: posts the ante 18
applefriend: posts small blind 100
marquitopoker4: posts big blind 200
*** HOLE CARDS ***
Dealt to jcarlos.vale [8c 9d]
Lokobarys Ninja: folds 
ganadormx: folds 
jcarlos.vale: folds 
RCABelVedeRVerd: folds 
Mimishka004: raises 210 to 410
richard5189: calls 410
84nurik84: folds 
applefriend: folds 
marquitopoker4: calls 210
*** FLOP *** [2h Th 5h]
marquitopoker4: checks 
Mimishka004: checks 
richard5189: bets 746
Lokobarys Ninja has returned
marquitopoker4: folds 
Mimishka004: folds 
Uncalled bet (746) returned to richard5189
richard5189 collected 1492 from pot
richard5189: doesn't show hand 
*** SUMMARY ***
Total pot 1492 | Rake 0 
Board [2h Th 5h]
Seat 1: marquitopoker4 (big blind) folded on the Flop
Seat 2: Lokobarys Ninja folded before Flop (didn't bet)
Seat 3: ganadormx folded before Flop (didn't bet)
Seat 4: jcarlos.vale folded before Flop (didn't bet)
Seat 5: RCABelVedeRVerd folded before Flop (didn't bet)
Seat 6: Mimishka004 folded on the Flop
Seat 7: richard5189 collected (1492)
Seat 8: 84nurik84 (button) folded before Flop (didn't bet)
Seat 9: applefriend (small blind) folded before Flop



PokerStars Hand #222102206835: Tournament #3082583698, $0.98+$0.12 USD Hold'em No Limit - Level IX (100/200) - 2021/01/01 21:35:27 EET [2021/01/01 14:35:27 ET]
Table '3082583698 30' 9-max Seat #9 is the button
Seat 1: marquitopoker4 (5447 in chips) 
Seat 2: Lokobarys Ninja (3102 in chips) 
Seat 3: ganadormx (4193 in chips) 
Seat 4: jcarlos.vale (7269 in chips) 
Seat 5: RCABelVedeRVerd (14058 in chips) is sitting out
Seat 6: Mimishka004 (14131 in chips) 
Seat 7: richard5189 (8843 in chips) 
Seat 8: 84nurik84 (4382 in chips) 
Seat 9: applefriend (2197 in chips) 
marquitopoker4: posts the ante 18
Lokobarys Ninja: posts the ante 18
ganadormx: posts the ante 18
jcarlos.vale: posts the ante 18
RCABelVedeRVerd: posts the ante 18
Mimishka004: posts the ante 18
richard5189: posts the ante 18
84nurik84: posts the ante 18
applefriend: posts the ante 18
marquitopoker4: posts small blind 100
Lokobarys Ninja: posts big blind 200
*** HOLE CARDS ***
Dealt to jcarlos.vale [8c Jh]
ganadormx: raises 3975 to 4175 and is all-in
jcarlos.vale: folds 
RCABelVedeRVerd: folds 
Mimishka004: folds 
richard5189: folds 
84nurik84: folds 
applefriend: folds 
marquitopoker4: folds 
Lokobarys Ninja: folds 
Uncalled bet (3975) returned to ganadormx
ganadormx collected 662 from pot
ganadormx: doesn't show hand 
*** SUMMARY ***
Total pot 662 | Rake 0 
Seat 1: marquitopoker4 (small blind) folded before Flop
Seat 2: Lokobarys Ninja (big blind) folded before Flop
Seat 3: ganadormx collected (662)
Seat 4: jcarlos.vale folded before Flop (didn't bet)
Seat 5: RCABelVedeRVerd folded before Flop (didn't bet)
Seat 6: Mimishka004 folded before Flop (didn't bet)
Seat 7: richard5189 folded before Flop (didn't bet)
Seat 8: 84nurik84 folded before Flop (didn't bet)
Seat 9: applefriend (button) folded before Flop (didn't bet)



PokerStars Hand #222102232226: Tournament #3082583698, $0.98+$0.12 USD Hold'em No Limit - Level IX (100/200) - 2021/01/01 21:35:51 EET [2021/01/01 14:35:51 ET]
Table '3082583698 30' 9-max Seat #1 is the button
Seat 1: marquitopoker4 (5329 in chips) 
Seat 2: Lokobarys Ninja (2884 in chips) 
Seat 3: ganadormx (4637 in chips) 
Seat 4: jcarlos.vale (7251 in chips) 
Seat 5: RCABelVedeRVerd (14040 in chips) is sitting out
Seat 6: Mimishka004 (14113 in chips) 
Seat 7: richard5189 (8825 in chips) 
Seat 8: 84nurik84 (4364 in chips) 
Seat 9: applefriend (2179 in chips) 
marquitopoker4: posts the ante 18
Lokobarys Ninja: posts the ante 18
ganadormx: posts the ante 18
jcarlos.vale: posts the ante 18
RCABelVedeRVerd: posts the ante 18
Mimishka004: posts the ante 18
richard5189: posts the ante 18
84nurik84: posts the ante 18
applefriend: posts the ante 18
Lokobarys Ninja: posts small blind 100
ganadormx: posts big blind 200
*** HOLE CARDS ***
Dealt to jcarlos.vale [Qc 9c]
jcarlos.vale: raises 320 to 520
RCABelVedeRVerd: folds 
Mimishka004: calls 520
richard5189: calls 520
84nurik84: folds 
applefriend: folds 
marquitopoker4: folds 
Lokobarys Ninja: folds 
ganadormx: calls 320
*** FLOP *** [Td 8s 9s]
ganadormx: checks 
jcarlos.vale: bets 1171
Mimishka004: folds 
richard5189: calls 1171
ganadormx: raises 2928 to 4099 and is all-in
jcarlos.vale: raises 2614 to 6713 and is all-in
richard5189: folds 
Uncalled bet (2614) returned to jcarlos.vale
*** TURN *** [Td 8s 9s] [7d]
*** RIVER *** [Td 8s 9s 7d] [9d]
*** SHOW DOWN ***
ganadormx: shows [3s As] (a pair of Nines)
jcarlos.vale: shows [Qc 9c] (three of a kind, Nines)
jcarlos.vale collected 11711 from pot
ganadormx finished the tournament
*** SUMMARY ***
Total pot 11711 | Rake 0 
Board [Td 8s 9s 7d 9d]
Seat 1: marquitopoker4 (button) folded before Flop (didn't bet)
Seat 2: Lokobarys Ninja (small blind) folded before Flop
Seat 3: ganadormx (big blind) showed [3s As] and lost with a pair of Nines
Seat 4: jcarlos.vale showed [Qc 9c] and won (11711) with three of a kind, Nines
Seat 5: RCABelVedeRVerd folded before Flop (didn't bet)
Seat 6: Mimishka004 folded on the Flop
Seat 7: richard5189 folded on the Flop
Seat 8: 84nurik84 folded before Flop (didn't bet)
Seat 9: applefriend folded before Flop (didn't bet)



PokerStars Hand #222102301104: Tournament #3082583698, $0.98+$0.12 USD Hold'em No Limit - Level IX (100/200) - 2021/01/01 21:36:55 EET [2021/01/01 14:36:55 ET]
Table '3082583698 30' 9-max Seat #2 is the button
Seat 1: marquitopoker4 (5311 in chips) 
Seat 2: Lokobarys Ninja (2766 in chips) 
Seat 4: jcarlos.vale (14325 in chips) 
Seat 5: RCABelVedeRVerd (14022 in chips) is sitting out
Seat 6: Mimishka004 (13575 in chips) 
Seat 7: richard5189 (7116 in chips) 
Seat 8: 84nurik84 (4346 in chips) 
Seat 9: applefriend (2161 in chips) 
marquitopoker4: posts the ante 18
Lokobarys Ninja: posts the ante 18
jcarlos.vale: posts the ante 18
RCABelVedeRVerd: posts the ante 18
Mimishka004: posts the ante 18
richard5189: posts the ante 18
84nurik84: posts the ante 18
applefriend: posts the ante 18
jcarlos.vale: posts small blind 100
RCABelVedeRVerd: posts big blind 200
*** HOLE CARDS ***
Dealt to jcarlos.vale [Jd 6c]
Mimishka004: raises 240 to 440
richard5189: calls 440
84nurik84: folds 
applefriend: raises 1703 to 2143 and is all-in
marquitopoker4: folds 
Lokobarys Ninja: folds 
jcarlos.vale: folds 
RCABelVedeRVerd: folds 
Mimishka004: raises 11414 to 13557 and is all-in
richard5189: folds 
Uncalled bet (11414) returned to Mimishka004
*** FLOP *** [Qc 3s 4d]
*** TURN *** [Qc 3s 4d] [Ad]
*** RIVER *** [Qc 3s 4d Ad] [Qh]
*** SHOW DOWN ***
Mimishka004: shows [Kd Ac] (two pair, Aces and Queens)
applefriend: shows [Ah Tc] (two pair, Aces and Queens - lower kicker)
Mimishka004 collected 5170 from pot
applefriend finished the tournament
*** SUMMARY ***
Total pot 5170 | Rake 0 
Board [Qc 3s 4d Ad Qh]
Seat 1: marquitopoker4 folded before Flop (didn't bet)
Seat 2: Lokobarys Ninja (button) folded before Flop (didn't bet)
Seat 4: jcarlos.vale (small blind) folded before Flop
Seat 5: RCABelVedeRVerd (big blind) folded before Flop
Seat 6: Mimishka004 showed [Kd Ac] and won (5170) with two pair, Aces and Queens
Seat 7: richard5189 folded before Flop
Seat 8: 84nurik84 folded before Flop (didn't bet)
Seat 9: applefriend showed [Ah Tc] and lost with two pair, Aces and Queens



PokerStars Hand #222102359450: Tournament #3082583698, $0.98+$0.12 USD Hold'em No Limit - Level IX (100/200) - 2021/01/01 21:37:50 EET [2021/01/01 14:37:50 ET]
Table '3082583698 30' 9-max Seat #4 is the button
Seat 1: marquitopoker4 (5293 in chips) 
Seat 2: Lokobarys Ninja (2748 in chips) 
Seat 3: maajussi1 (5000 in chips) 
Seat 4: jcarlos.vale (14207 in chips) 
Seat 5: RCABelVedeRVerd (13804 in chips) is sitting out
Seat 6: Mimishka004 (16584 in chips) 
Seat 7: richard5189 (6658 in chips) 
Seat 8: 84nurik84 (4328 in chips) 
marquitopoker4: posts the ante 18
Lokobarys Ninja: posts the ante 18
maajussi1: posts the ante 18
jcarlos.vale: posts the ante 18
RCABelVedeRVerd: posts the ante 18
Mimishka004: posts the ante 18
richard5189: posts the ante 18
84nurik84: posts the ante 18
RCABelVedeRVerd: posts small blind 100
Mimishka004: posts big blind 200
*** HOLE CARDS ***
Dealt to jcarlos.vale [Ks 6h]
richard5189: folds 
84nurik84: folds 
marquitopoker4: folds 
Lokobarys Ninja: raises 2530 to 2730 and is all-in
maajussi1: folds 
jcarlos.vale: folds 
RCABelVedeRVerd: folds 
Mimishka004: calls 2530
*** FLOP *** [4d 2c 3s]
*** TURN *** [4d 2c 3s] [9d]
*** RIVER *** [4d 2c 3s 9d] [7c]
*** SHOW DOWN ***
Mimishka004: shows [As Ah] (a pair of Aces)
Lokobarys Ninja: shows [Kh Ac] (high card Ace)
Mimishka004 collected 5704 from pot
Lokobarys Ninja finished the tournament
*** SUMMARY ***
Total pot 5704 | Rake 0 
Board [4d 2c 3s 9d 7c]
Seat 1: marquitopoker4 folded before Flop (didn't bet)
Seat 2: Lokobarys Ninja showed [Kh Ac] and lost with high card Ace
Seat 3: maajussi1 folded before Flop (didn't bet)
Seat 4: jcarlos.vale (button) folded before Flop (didn't bet)
Seat 5: RCABelVedeRVerd (small blind) folded before Flop
Seat 6: Mimishka004 (big blind) showed [As Ah] and won (5704) with a pair of Aces
Seat 7: richard5189 folded before Flop (didn't bet)
Seat 8: 84nurik84 folded before Flop (didn't bet)



PokerStars Hand #222102394891: Tournament #3082583698, $0.98+$0.12 USD Hold'em No Limit - Level X (125/250) - 2021/01/01 21:38:23 EET [2021/01/01 14:38:23 ET]
Table '3082583698 30' 9-max Seat #5 is the button
Seat 1: marquitopoker4 (5275 in chips) 
Seat 2: Tooninone (5000 in chips) 
Seat 3: maajussi1 (4982 in chips) 
Seat 4: jcarlos.vale (14189 in chips) 
Seat 5: RCABelVedeRVerd (13686 in chips) is sitting out
Seat 6: Mimishka004 (19540 in chips) 
Seat 7: richard5189 (6640 in chips) 
Seat 8: 84nurik84 (4310 in chips) 
Seat 9: Vitrex555 (9263 in chips) 
marquitopoker4: posts the ante 20
Tooninone: posts the ante 20
maajussi1: posts the ante 20
jcarlos.vale: posts the ante 20
RCABelVedeRVerd: posts the ante 20
Mimishka004: posts the ante 20
richard5189: posts the ante 20
84nurik84: posts the ante 20
Vitrex555: posts the ante 20
Mimishka004: posts small blind 125
richard5189: posts big blind 250
*** HOLE CARDS ***
Dealt to jcarlos.vale [9c 9h]
84nurik84: folds 
Vitrex555: folds 
marquitopoker4: folds 
Tooninone: folds 
maajussi1: folds 
RCABelVedeRVerd is disconnected 
jcarlos.vale: raises 400 to 650
RCABelVedeRVerd: folds 
Mimishka004: folds 
richard5189: folds 
Uncalled bet (400) returned to jcarlos.vale
jcarlos.vale collected 805 from pot
jcarlos.vale: doesn't show hand 
*** SUMMARY ***
Total pot 805 | Rake 0 
Seat 1: marquitopoker4 folded before Flop (didn't bet)
Seat 2: Tooninone folded before Flop (didn't bet)
Seat 3: maajussi1 folded before Flop (didn't bet)
Seat 4: jcarlos.vale collected (805)
Seat 5: RCABelVedeRVerd (button) folded before Flop (didn't bet)
Seat 6: Mimishka004 (small blind) folded before Flop
Seat 7: richard5189 (big blind) folded before Flop
Seat 8: 84nurik84 folded before Flop (didn't bet)
Seat 9: Vitrex555 folded before Flop (didn't bet)



PokerStars Hand #222102430728: Tournament #3082583698, $0.98+$0.12 USD Hold'em No Limit - Level X (125/250) - 2021/01/01 21:38:57 EET [2021/01/01 14:38:57 ET]
Table '3082583698 30' 9-max Seat #6 is the button
Seat 1: marquitopoker4 (5255 in chips) 
Seat 2: Tooninone (4980 in chips) 
Seat 3: maajussi1 (4962 in chips) 
Seat 4: jcarlos.vale (14724 in chips) 
Seat 5: RCABelVedeRVerd (13666 in chips) is sitting out
Seat 6: Mimishka004 (19395 in chips) 
Seat 7: richard5189 (6370 in chips) 
Seat 8: 84nurik84 (4290 in chips) 
Seat 9: Vitrex555 (9243 in chips) 
marquitopoker4: posts the ante 20
Tooninone: posts the ante 20
maajussi1: posts the ante 20
jcarlos.vale: posts the ante 20
RCABelVedeRVerd: posts the ante 20
Mimishka004: posts the ante 20
richard5189: posts the ante 20
84nurik84: posts the ante 20
Vitrex555: posts the ante 20
richard5189: posts small blind 125
84nurik84: posts big blind 250
*** HOLE CARDS ***
Dealt to jcarlos.vale [3c Qh]
Vitrex555: folds 
marquitopoker4: folds 
Tooninone: folds 
maajussi1: raises 250 to 500
jcarlos.vale: folds 
RCABelVedeRVerd: folds 
Mimishka004: folds 
richard5189: folds 
84nurik84: calls 250
*** FLOP *** [5c Qd 8s]
84nurik84: checks 
maajussi1: bets 250
84nurik84: folds 
Uncalled bet (250) returned to maajussi1
maajussi1 collected 1305 from pot
maajussi1: doesn't show hand 
*** SUMMARY ***
Total pot 1305 | Rake 0 
Board [5c Qd 8s]
Seat 1: marquitopoker4 folded before Flop (didn't bet)
Seat 2: Tooninone folded before Flop (didn't bet)
Seat 3: maajussi1 collected (1305)
Seat 4: jcarlos.vale folded before Flop (didn't bet)
Seat 5: RCABelVedeRVerd folded before Flop (didn't bet)
Seat 6: Mimishka004 (button) folded before Flop (didn't bet)
Seat 7: richard5189 (small blind) folded before Flop
Seat 8: 84nurik84 (big blind) folded on the Flop
Seat 9: Vitrex555 folded before Flop (didn't bet)



PokerStars Hand #222102483182: Tournament #3082583698, $0.98+$0.12 USD Hold'em No Limit - Level X (125/250) - 2021/01/01 21:39:47 EET [2021/01/01 14:39:47 ET]
Table '3082583698 30' 9-max Seat #7 is the button
Seat 1: marquitopoker4 (5235 in chips) 
Seat 2: Tooninone (4960 in chips) 
Seat 3: maajussi1 (5747 in chips) 
Seat 4: jcarlos.vale (14704 in chips) 
Seat 5: RCABelVedeRVerd (13646 in chips) is sitting out
Seat 6: Mimishka004 (19375 in chips) 
Seat 7: richard5189 (6225 in chips) 
Seat 8: 84nurik84 (3770 in chips) 
Seat 9: Vitrex555 (9223 in chips) 
marquitopoker4: posts the ante 20
Tooninone: posts the ante 20
maajussi1: posts the ante 20
jcarlos.vale: posts the ante 20
RCABelVedeRVerd: posts the ante 20
Mimishka004: posts the ante 20
richard5189: posts the ante 20
84nurik84: posts the ante 20
Vitrex555: posts the ante 20
84nurik84: posts small blind 125
Vitrex555: posts big blind 250
*** HOLE CARDS ***
Dealt to jcarlos.vale [Qd 4d]
marquitopoker4: folds 
Tooninone: folds 
maajussi1: folds 
jcarlos.vale: folds 
RCABelVedeRVerd: folds 
Mimishka004: raises 262 to 512
richard5189: calls 512
84nurik84: folds 
Vitrex555: folds 
*** FLOP *** [3h 5h Jc]
Mimishka004: bets 625
richard5189: folds 
Uncalled bet (625) returned to Mimishka004
Mimishka004 collected 1579 from pot
*** SUMMARY ***
Total pot 1579 | Rake 0 
Board [3h 5h Jc]
Seat 1: marquitopoker4 folded before Flop (didn't bet)
Seat 2: Tooninone folded before Flop (didn't bet)
Seat 3: maajussi1 folded before Flop (didn't bet)
Seat 4: jcarlos.vale folded before Flop (didn't bet)
Seat 5: RCABelVedeRVerd folded before Flop (didn't bet)
Seat 6: Mimishka004 collected (1579)
Seat 7: richard5189 (button) folded on the Flop
Seat 8: 84nurik84 (small blind) folded before Flop
Seat 9: Vitrex555 (big blind) folded before Flop



PokerStars Hand #222102527547: Tournament #3082583698, $0.98+$0.12 USD Hold'em No Limit - Level X (125/250) - 2021/01/01 21:40:29 EET [2021/01/01 14:40:29 ET]
Table '3082583698 30' 9-max Seat #8 is the button
Seat 1: marquitopoker4 (5215 in chips) 
Seat 2: Tooninone (4940 in chips) 
Seat 3: maajussi1 (5727 in chips) 
Seat 4: jcarlos.vale (14684 in chips) 
Seat 5: RCABelVedeRVerd (13626 in chips) is sitting out
Seat 6: Mimishka004 (20422 in chips) 
Seat 7: richard5189 (5693 in chips) 
Seat 8: 84nurik84 (3625 in chips) 
Seat 9: Vitrex555 (8953 in chips) 
marquitopoker4: posts the ante 20
Tooninone: posts the ante 20
maajussi1: posts the ante 20
jcarlos.vale: posts the ante 20
RCABelVedeRVerd: posts the ante 20
Mimishka004: posts the ante 20
richard5189: posts the ante 20
84nurik84: posts the ante 20
Vitrex555: posts the ante 20
Vitrex555: posts small blind 125
marquitopoker4: posts big blind 250
*** HOLE CARDS ***
Dealt to jcarlos.vale [Jd 5d]
Tooninone: folds 
maajussi1: folds 
jcarlos.vale: folds 
RCABelVedeRVerd: folds 
Mimishka004: folds 
richard5189: calls 250
84nurik84: raises 3355 to 3605 and is all-in
Vitrex555: calls 3480
marquitopoker4: folds 
richard5189: folds 
*** FLOP *** [Kc 6h 4c]
*** TURN *** [Kc 6h 4c] [Qc]
*** RIVER *** [Kc 6h 4c Qc] [Kd]
*** SHOW DOWN ***
Vitrex555: shows [6s 6d] (a full house, Sixes full of Kings)
84nurik84: shows [Ac 8h] (a pair of Kings)
Vitrex555 collected 7890 from pot
84nurik84 finished the tournament
*** SUMMARY ***
Total pot 7890 | Rake 0 
Board [Kc 6h 4c Qc Kd]
Seat 1: marquitopoker4 (big blind) folded before Flop
Seat 2: Tooninone folded before Flop (didn't bet)
Seat 3: maajussi1 folded before Flop (didn't bet)
Seat 4: jcarlos.vale folded before Flop (didn't bet)
Seat 5: RCABelVedeRVerd folded before Flop (didn't bet)
Seat 6: Mimishka004 folded before Flop (didn't bet)
Seat 7: richard5189 folded before Flop
Seat 8: 84nurik84 (button) showed [Ac 8h] and lost with a pair of Kings
Seat 9: Vitrex555 (small blind) showed [6s 6d] and won (7890) with a full house, Sixes full of Kings



PokerStars Hand #222102583998: Tournament #3082583698, $0.98+$0.12 USD Hold'em No Limit - Level X (125/250) - 2021/01/01 21:41:23 EET [2021/01/01 14:41:23 ET]
Table '3082583698 30' 9-max Seat #9 is the button
Seat 1: marquitopoker4 (4945 in chips) 
Seat 2: Tooninone (4920 in chips) 
Seat 3: maajussi1 (5707 in chips) 
Seat 4: jcarlos.vale (14664 in chips) 
Seat 5: RCABelVedeRVerd (13606 in chips) is sitting out
Seat 6: Mimishka004 (20402 in chips) 
Seat 7: richard5189 (5423 in chips) 
Seat 9: Vitrex555 (13218 in chips) 
marquitopoker4: posts the ante 20
Tooninone: posts the ante 20
maajussi1: posts the ante 20
jcarlos.vale: posts the ante 20
RCABelVedeRVerd: posts the ante 20
Mimishka004: posts the ante 20
richard5189: posts the ante 20
Vitrex555: posts the ante 20
marquitopoker4: posts small blind 125
Tooninone: posts big blind 250
*** HOLE CARDS ***
Dealt to jcarlos.vale [3d Kh]
maajussi1: folds 
jcarlos.vale: folds 
RCABelVedeRVerd: folds 
Mimishka004: folds 
richard5189: folds 
RCABelVedeRVerd has returned
Vitrex555: calls 250
marquitopoker4: raises 4675 to 4925 and is all-in
Tooninone: folds 
Vitrex555: folds 
Uncalled bet (4675) returned to marquitopoker4
marquitopoker4 collected 910 from pot
marquitopoker4: doesn't show hand 
*** SUMMARY ***
Total pot 910 | Rake 0 
Seat 1: marquitopoker4 (small blind) collected (910)
Seat 2: Tooninone (big blind) folded before Flop
Seat 3: maajussi1 folded before Flop (didn't bet)
Seat 4: jcarlos.vale folded before Flop (didn't bet)
Seat 5: RCABelVedeRVerd folded before Flop (didn't bet)
Seat 6: Mimishka004 folded before Flop (didn't bet)
Seat 7: richard5189 folded before Flop (didn't bet)
Seat 9: Vitrex555 (button) folded before Flop



PokerStars Hand #222102617670: Tournament #3082583698, $0.98+$0.12 USD Hold'em No Limit - Level X (125/250) - 2021/01/01 21:41:55 EET [2021/01/01 14:41:55 ET]
Table '3082583698 30' 9-max Seat #1 is the button
Seat 1: marquitopoker4 (5585 in chips) 
Seat 2: Tooninone (4650 in chips) 
Seat 3: maajussi1 (5687 in chips) 
Seat 4: jcarlos.vale (14644 in chips) 
Seat 5: RCABelVedeRVerd (13586 in chips) 
Seat 6: Mimishka004 (20382 in chips) 
Seat 7: richard5189 (5403 in chips) 
Seat 8: Serghio2902 (5000 in chips) 
Seat 9: Vitrex555 (12948 in chips) 
marquitopoker4: posts the ante 20
Tooninone: posts the ante 20
maajussi1: posts the ante 20
jcarlos.vale: posts the ante 20
RCABelVedeRVerd: posts the ante 20
Mimishka004: posts the ante 20
richard5189: posts the ante 20
Serghio2902: posts the ante 20
Vitrex555: posts the ante 20
Tooninone: posts small blind 125
maajussi1: posts big blind 250
*** HOLE CARDS ***
Dealt to jcarlos.vale [6c 7s]
jcarlos.vale: folds 
RCABelVedeRVerd: folds 
Mimishka004: folds 
richard5189: folds 
Serghio2902: folds 
Vitrex555: folds 
marquitopoker4: raises 252 to 502
Tooninone: folds 
maajussi1: folds 
Uncalled bet (252) returned to marquitopoker4
marquitopoker4 collected 805 from pot
marquitopoker4: doesn't show hand 
*** SUMMARY ***
Total pot 805 | Rake 0 
Seat 1: marquitopoker4 (button) collected (805)
Seat 2: Tooninone (small blind) folded before Flop
Seat 3: maajussi1 (big blind) folded before Flop
Seat 4: jcarlos.vale folded before Flop (didn't bet)
Seat 5: RCABelVedeRVerd folded before Flop (didn't bet)
Seat 6: Mimishka004 folded before Flop (didn't bet)
Seat 7: richard5189 folded before Flop (didn't bet)
Seat 8: Serghio2902 folded before Flop (didn't bet)
Seat 9: Vitrex555 folded before Flop (didn't bet)



PokerStars Hand #222102656463: Tournament #3082583698, $0.98+$0.12 USD Hold'em No Limit - Level X (125/250) - 2021/01/01 21:42:32 EET [2021/01/01 14:42:32 ET]
Table '3082583698 30' 9-max Seat #2 is the button
Seat 1: marquitopoker4 (6120 in chips) 
Seat 2: Tooninone (4505 in chips) 
Seat 3: maajussi1 (5417 in chips) 
Seat 4: jcarlos.vale (14624 in chips) 
Seat 5: RCABelVedeRVerd (13566 in chips) 
Seat 6: Mimishka004 (20362 in chips) 
Seat 7: richard5189 (5383 in chips) 
Seat 8: Serghio2902 (4980 in chips) 
Seat 9: Vitrex555 (12928 in chips) 
marquitopoker4: posts the ante 20
Tooninone: posts the ante 20
maajussi1: posts the ante 20
jcarlos.vale: posts the ante 20
RCABelVedeRVerd: posts the ante 20
Mimishka004: posts the ante 20
richard5189: posts the ante 20
Serghio2902: posts the ante 20
Vitrex555: posts the ante 20
maajussi1: posts small blind 125
jcarlos.vale: posts big blind 250
*** HOLE CARDS ***
Dealt to jcarlos.vale [7d 2c]
RCABelVedeRVerd: folds 
Mimishka004: folds 
richard5189: calls 250
Serghio2902: folds 
Vitrex555: folds 
marquitopoker4: folds 
Tooninone: raises 500 to 750
maajussi1: folds 
jcarlos.vale: folds 
richard5189: folds 
Uncalled bet (500) returned to Tooninone
Tooninone collected 1055 from pot
Tooninone: doesn't show hand 
*** SUMMARY ***
Total pot 1055 | Rake 0 
Seat 1: marquitopoker4 folded before Flop (didn't bet)
Seat 2: Tooninone (button) collected (1055)
Seat 3: maajussi1 (small blind) folded before Flop
Seat 4: jcarlos.vale (big blind) folded before Flop
Seat 5: RCABelVedeRVerd folded before Flop (didn't bet)
Seat 6: Mimishka004 folded before Flop (didn't bet)
Seat 7: richard5189 folded before Flop
Seat 8: Serghio2902 folded before Flop (didn't bet)
Seat 9: Vitrex555 folded before Flop (didn't bet)



PokerStars Hand #222102693902: Tournament #3082583698, $0.98+$0.12 USD Hold'em No Limit - Level X (125/250) - 2021/01/01 21:43:07 EET [2021/01/01 14:43:07 ET]
Table '3082583698 30' 9-max Seat #3 is the button
Seat 1: marquitopoker4 (6100 in chips) 
Seat 2: Tooninone (5290 in chips) 
Seat 3: maajussi1 (5272 in chips) 
Seat 4: jcarlos.vale (14354 in chips) 
Seat 5: RCABelVedeRVerd (13546 in chips) 
Seat 6: Mimishka004 (20342 in chips) 
Seat 7: richard5189 (5113 in chips) 
Seat 8: Serghio2902 (4960 in chips) 
Seat 9: Vitrex555 (12908 in chips) 
marquitopoker4: posts the ante 20
Tooninone: posts the ante 20
maajussi1: posts the ante 20
jcarlos.vale: posts the ante 20
RCABelVedeRVerd: posts the ante 20
Mimishka004: posts the ante 20
richard5189: posts the ante 20
Serghio2902: posts the ante 20
Vitrex555: posts the ante 20
jcarlos.vale: posts small blind 125
RCABelVedeRVerd: posts big blind 250
*** HOLE CARDS ***
Dealt to jcarlos.vale [As 6d]
Mimishka004: folds 
richard5189: folds 
Serghio2902: folds 
Vitrex555: calls 250
marquitopoker4: calls 250
Tooninone: calls 250
maajussi1: folds 
jcarlos.vale: calls 125
RCABelVedeRVerd: checks 
*** FLOP *** [2d 8s 7s]
jcarlos.vale: checks 
RCABelVedeRVerd: checks 
Vitrex555: checks 
marquitopoker4: checks 
Tooninone: checks 
*** TURN *** [2d 8s 7s] [2s]
jcarlos.vale: bets 500
RCABelVedeRVerd: folds 
Vitrex555: calls 500
marquitopoker4: folds 
Tooninone: folds 
*** RIVER *** [2d 8s 7s 2s] [Ah]
jcarlos.vale: bets 500
Vitrex555: folds 
Uncalled bet (500) returned to jcarlos.vale
jcarlos.vale collected 2430 from pot
jcarlos.vale: doesn't show hand 
*** SUMMARY ***
Total pot 2430 | Rake 0 
Board [2d 8s 7s 2s Ah]
Seat 1: marquitopoker4 folded on the Turn
Seat 2: Tooninone folded on the Turn
Seat 3: maajussi1 (button) folded before Flop (didn't bet)
Seat 4: jcarlos.vale (small blind) collected (2430)
Seat 5: RCABelVedeRVerd (big blind) folded on the Turn
Seat 6: Mimishka004 folded before Flop (didn't bet)
Seat 7: richard5189 folded before Flop (didn't bet)
Seat 8: Serghio2902 folded before Flop (didn't bet)
Seat 9: Vitrex555 folded on the River



PokerStars Hand #222102824767: Tournament #3082583698, $0.98+$0.12 USD Hold'em No Limit - Level X (125/250) - 2021/01/01 21:45:13 EET [2021/01/01 14:45:13 ET]
Table '3082583698 30' 9-max Seat #4 is the button
Seat 1: marquitopoker4 (5830 in chips) 
Seat 2: Tooninone (5020 in chips) 
Seat 3: maajussi1 (5252 in chips) 
Seat 4: jcarlos.vale (16014 in chips) 
Seat 5: RCABelVedeRVerd (13276 in chips) 
Seat 6: Mimishka004 (20322 in chips) 
Seat 7: richard5189 (5093 in chips) 
Seat 8: Serghio2902 (4940 in chips) 
Seat 9: Vitrex555 (12138 in chips) 
marquitopoker4: posts the ante 20
Tooninone: posts the ante 20
maajussi1: posts the ante 20
jcarlos.vale: posts the ante 20
RCABelVedeRVerd: posts the ante 20
Mimishka004: posts the ante 20
richard5189: posts the ante 20
Serghio2902: posts the ante 20
Vitrex555: posts the ante 20
RCABelVedeRVerd: posts small blind 125
Mimishka004: posts big blind 250
*** HOLE CARDS ***
Dealt to jcarlos.vale [Jh 6c]
richard5189: folds 
Serghio2902: folds 
Vitrex555: folds 
marquitopoker4: folds 
Tooninone: folds 
maajussi1: folds 
jcarlos.vale: folds 
RCABelVedeRVerd: calls 125
Mimishka004: checks 
*** FLOP *** [Tc 9s Ts]
RCABelVedeRVerd: checks 
Mimishka004: checks 
*** TURN *** [Tc 9s Ts] [8d]
RCABelVedeRVerd: bets 500
Mimishka004: folds 
Uncalled bet (500) returned to RCABelVedeRVerd
RCABelVedeRVerd collected 680 from pot
*** SUMMARY ***
Total pot 680 | Rake 0 
Board [Tc 9s Ts 8d]
Seat 1: marquitopoker4 folded before Flop (didn't bet)
Seat 2: Tooninone folded before Flop (didn't bet)
Seat 3: maajussi1 folded before Flop (didn't bet)
Seat 4: jcarlos.vale (button) folded before Flop (didn't bet)
Seat 5: RCABelVedeRVerd (small blind) collected (680)
Seat 6: Mimishka004 (big blind) folded on the Turn
Seat 7: richard5189 folded before Flop (didn't bet)
Seat 8: Serghio2902 folded before Flop (didn't bet)
Seat 9: Vitrex555 folded before Flop (didn't bet)



PokerStars Hand #222102876338: Tournament #3082583698, $0.98+$0.12 USD Hold'em No Limit - Level X (125/250) - 2021/01/01 21:46:03 EET [2021/01/01 14:46:03 ET]
Table '3082583698 30' 9-max Seat #5 is the button
Seat 1: marquitopoker4 (5810 in chips) 
Seat 2: Tooninone (5000 in chips) 
Seat 3: maajussi1 (5232 in chips) 
Seat 4: jcarlos.vale (15994 in chips) 
Seat 5: RCABelVedeRVerd (13686 in chips) 
Seat 6: Mimishka004 (20052 in chips) 
Seat 7: richard5189 (5073 in chips) 
Seat 8: Serghio2902 (4920 in chips) 
Seat 9: Vitrex555 (12118 in chips) 
marquitopoker4: posts the ante 20
Tooninone: posts the ante 20
maajussi1: posts the ante 20
jcarlos.vale: posts the ante 20
RCABelVedeRVerd: posts the ante 20
Mimishka004: posts the ante 20
richard5189: posts the ante 20
Serghio2902: posts the ante 20
Vitrex555: posts the ante 20
Mimishka004: posts small blind 125
richard5189: posts big blind 250
*** HOLE CARDS ***
Dealt to jcarlos.vale [3s 7s]
Serghio2902: folds 
Vitrex555: folds 
marquitopoker4: folds 
Tooninone: folds 
maajussi1: folds 
jcarlos.vale: folds 
RCABelVedeRVerd: folds 
Mimishka004: folds 
Uncalled bet (125) returned to richard5189
richard5189 collected 430 from pot
richard5189: doesn't show hand 
*** SUMMARY ***
Total pot 430 | Rake 0 
Seat 1: marquitopoker4 folded before Flop (didn't bet)
Seat 2: Tooninone folded before Flop (didn't bet)
Seat 3: maajussi1 folded before Flop (didn't bet)
Seat 4: jcarlos.vale folded before Flop (didn't bet)
Seat 5: RCABelVedeRVerd (button) folded before Flop (didn't bet)
Seat 6: Mimishka004 (small blind) folded before Flop
Seat 7: richard5189 (big blind) collected (430)
Seat 8: Serghio2902 folded before Flop (didn't bet)
Seat 9: Vitrex555 folded before Flop (didn't bet)



PokerStars Hand #222102913120: Tournament #3082583698, $0.98+$0.12 USD Hold'em No Limit - Level X (125/250) - 2021/01/01 21:46:32 EET [2021/01/01 14:46:32 ET]
Table '3082583698 30' 9-max Seat #6 is the button
Seat 1: marquitopoker4 (5790 in chips) 
Seat 2: Tooninone (4980 in chips) 
Seat 3: maajussi1 (5212 in chips) 
Seat 4: jcarlos.vale (15974 in chips) 
Seat 5: RCABelVedeRVerd (13666 in chips) 
Seat 6: Mimishka004 (19907 in chips) 
Seat 7: richard5189 (5358 in chips) 
Seat 8: Serghio2902 (4900 in chips) 
Seat 9: Vitrex555 (12098 in chips) 
marquitopoker4: posts the ante 20
Tooninone: posts the ante 20
maajussi1: posts the ante 20
jcarlos.vale: posts the ante 20
RCABelVedeRVerd: posts the ante 20
Mimishka004: posts the ante 20
richard5189: posts the ante 20
Serghio2902: posts the ante 20
Vitrex555: posts the ante 20
richard5189: posts small blind 125
Serghio2902: posts big blind 250
*** HOLE CARDS ***
Dealt to jcarlos.vale [4c 3s]
Vitrex555: folds 
marquitopoker4: folds 
Tooninone: calls 250
maajussi1: folds 
jcarlos.vale: folds 
RCABelVedeRVerd has timed out
RCABelVedeRVerd: folds 
RCABelVedeRVerd is sitting out
Mimishka004: raises 750 to 1000
richard5189: folds 
Serghio2902: folds 
Tooninone: folds 
Uncalled bet (750) returned to Mimishka004
Mimishka004 collected 1055 from pot
*** SUMMARY ***
Total pot 1055 | Rake 0 
Seat 1: marquitopoker4 folded before Flop (didn't bet)
Seat 2: Tooninone folded before Flop
Seat 3: maajussi1 folded before Flop (didn't bet)
Seat 4: jcarlos.vale folded before Flop (didn't bet)
Seat 5: RCABelVedeRVerd folded before Flop (didn't bet)
Seat 6: Mimishka004 (button) collected (1055)
Seat 7: richard5189 (small blind) folded before Flop
Seat 8: Serghio2902 (big blind) folded before Flop
Seat 9: Vitrex555 folded before Flop (didn't bet)



PokerStars Hand #222102984929: Tournament #3082583698, $0.98+$0.12 USD Hold'em No Limit - Level X (125/250) - 2021/01/01 21:47:41 EET [2021/01/01 14:47:41 ET]
Table '3082583698 30' 9-max Seat #7 is the button
Seat 1: marquitopoker4 (5770 in chips) 
Seat 2: Tooninone (4710 in chips) 
Seat 3: maajussi1 (5192 in chips) 
Seat 4: jcarlos.vale (15954 in chips) 
Seat 5: RCABelVedeRVerd (13646 in chips) is sitting out
Seat 6: Mimishka004 (20692 in chips) 
Seat 7: richard5189 (5213 in chips) 
Seat 8: Serghio2902 (4630 in chips) 
Seat 9: Vitrex555 (12078 in chips) 
marquitopoker4: posts the ante 20
Tooninone: posts the ante 20
maajussi1: posts the ante 20
jcarlos.vale: posts the ante 20
RCABelVedeRVerd: posts the ante 20
Mimishka004: posts the ante 20
richard5189: posts the ante 20
Serghio2902: posts the ante 20
Vitrex555: posts the ante 20
Serghio2902: posts small blind 125
Vitrex555: posts big blind 250
*** HOLE CARDS ***
Dealt to jcarlos.vale [Jh 9d]
marquitopoker4: folds 
Tooninone: raises 500 to 750
maajussi1: calls 750
jcarlos.vale: folds 
RCABelVedeRVerd: folds 
Mimishka004: folds 
RCABelVedeRVerd is disconnected 
richard5189: folds 
Serghio2902: folds 
Vitrex555: folds 
*** FLOP *** [4s Td 5d]
Tooninone: bets 3940 and is all-in
RCABelVedeRVerd has returned
maajussi1: calls 3940
*** TURN *** [4s Td 5d] [7s]
*** RIVER *** [4s Td 5d 7s] [7d]
*** SHOW DOWN ***
Tooninone: shows [Ac Qc] (a pair of Sevens)
maajussi1: shows [8h 8d] (two pair, Eights and Sevens)
maajussi1 collected 9935 from pot
Tooninone finished the tournament in 1530th place
*** SUMMARY ***
Total pot 9935 | Rake 0 
Board [4s Td 5d 7s 7d]
Seat 1: marquitopoker4 folded before Flop (didn't bet)
Seat 2: Tooninone showed [Ac Qc] and lost with a pair of Sevens
Seat 3: maajussi1 showed [8h 8d] and won (9935) with two pair, Eights and Sevens
Seat 4: jcarlos.vale folded before Flop (didn't bet)
Seat 5: RCABelVedeRVerd folded before Flop (didn't bet)
Seat 6: Mimishka004 folded before Flop (didn't bet)
Seat 7: richard5189 (button) folded before Flop (didn't bet)
Seat 8: Serghio2902 (small blind) folded before Flop
Seat 9: Vitrex555 (big blind) folded before Flop



PokerStars Hand #222103041157: Tournament #3082583698, $0.98+$0.12 USD Hold'em No Limit - Level XI (150/300) - 2021/01/01 21:48:37 EET [2021/01/01 14:48:37 ET]
Table '3082583698 30' 9-max Seat #8 is the button
Seat 1: marquitopoker4 (5750 in chips) 
Seat 3: maajussi1 (10417 in chips) 
Seat 4: jcarlos.vale (15934 in chips) 
Seat 5: RCABelVedeRVerd (13626 in chips) 
Seat 6: Mimishka004 (20672 in chips) 
Seat 7: richard5189 (5193 in chips) 
Seat 8: Serghio2902 (4485 in chips) 
Seat 9: Vitrex555 (11808 in chips) 
marquitopoker4: posts the ante 22
maajussi1: posts the ante 22
jcarlos.vale: posts the ante 22
RCABelVedeRVerd: posts the ante 22
Mimishka004: posts the ante 22
richard5189: posts the ante 22
Serghio2902: posts the ante 22
Vitrex555: posts the ante 22
Vitrex555: posts small blind 150
marquitopoker4: posts big blind 300
*** HOLE CARDS ***
Dealt to jcarlos.vale [Th 8d]
maajussi1: folds 
jcarlos.vale: folds 
RCABelVedeRVerd: calls 300
Mimishka004: folds 
richard5189: calls 300
Serghio2902: raises 300 to 600
Vitrex555: folds 
marquitopoker4: raises 5100 to 5700
RCABelVedeRVerd: folds 
richard5189: folds 
Serghio2902: calls 3863 and is all-in
Uncalled bet (1237) returned to marquitopoker4
*** FLOP *** [Ac Qc 5c]
*** TURN *** [Ac Qc 5c] [8c]
*** RIVER *** [Ac Qc 5c 8c] [6s]
*** SHOW DOWN ***
marquitopoker4: shows [Ad 4d] (a pair of Aces)
Serghio2902: shows [As 8s] (two pair, Aces and Eights)
Serghio2902 collected 9852 from pot
*** SUMMARY ***
Total pot 9852 | Rake 0 
Board [Ac Qc 5c 8c 6s]
Seat 1: marquitopoker4 (big blind) showed [Ad 4d] and lost with a pair of Aces
Seat 3: maajussi1 folded before Flop (didn't bet)
Seat 4: jcarlos.vale folded before Flop (didn't bet)
Seat 5: RCABelVedeRVerd folded before Flop
Seat 6: Mimishka004 folded before Flop (didn't bet)
Seat 7: richard5189 folded before Flop
Seat 8: Serghio2902 (button) showed [As 8s] and won (9852) with two pair, Aces and Eights
Seat 9: Vitrex555 (small blind) folded before Flop



PokerStars Hand #222103106123: Tournament #3082583698, $0.98+$0.12 USD Hold'em No Limit - Level XI (150/300) - 2021/01/01 21:49:40 EET [2021/01/01 14:49:40 ET]
Table '3082583698 30' 9-max Seat #9 is the button
Seat 1: marquitopoker4 (1265 in chips) 
Seat 2: xxMich@ilxx (20116 in chips) 
Seat 3: maajussi1 (10395 in chips) 
Seat 4: jcarlos.vale (15912 in chips) 
Seat 5: RCABelVedeRVerd (13304 in chips) 
Seat 6: Mimishka004 (20650 in chips) 
Seat 7: richard5189 (4871 in chips) 
Seat 8: Serghio2902 (9852 in chips) 
Seat 9: Vitrex555 (11636 in chips) 
marquitopoker4: posts the ante 22
xxMich@ilxx: posts the ante 22
maajussi1: posts the ante 22
jcarlos.vale: posts the ante 22
RCABelVedeRVerd: posts the ante 22
Mimishka004: posts the ante 22
richard5189: posts the ante 22
Serghio2902: posts the ante 22
Vitrex555: posts the ante 22
marquitopoker4: posts small blind 150
xxMich@ilxx: posts big blind 300
*** HOLE CARDS ***
Dealt to jcarlos.vale [8s Jd]
maajussi1: folds 
jcarlos.vale: folds 
RCABelVedeRVerd: raises 300 to 600
Mimishka004: folds 
richard5189: folds 
Serghio2902: folds 
Vitrex555: calls 600
marquitopoker4: folds 
xxMich@ilxx: calls 300
*** FLOP *** [3d 7c 3s]
xxMich@ilxx: checks 
RCABelVedeRVerd: bets 1200
Vitrex555: folds 
xxMich@ilxx: calls 1200
*** TURN *** [3d 7c 3s] [Td]
xxMich@ilxx: checks 
RCABelVedeRVerd: bets 3138
xxMich@ilxx: calls 3138
*** RIVER *** [3d 7c 3s Td] [Ad]
xxMich@ilxx: bets 7500
RCABelVedeRVerd: folds [Qs Qc]
Uncalled bet (7500) returned to xxMich@ilxx
xxMich@ilxx collected 10824 from pot
*** SUMMARY ***
Total pot 10824 | Rake 0 
Board [3d 7c 3s Td Ad]
Seat 1: marquitopoker4 (small blind) folded before Flop
Seat 2: xxMich@ilxx (big blind) collected (10824)
Seat 3: maajussi1 folded before Flop (didn't bet)
Seat 4: jcarlos.vale folded before Flop (didn't bet)
Seat 5: RCABelVedeRVerd folded on the River
Seat 6: Mimishka004 folded before Flop (didn't bet)
Seat 7: richard5189 folded before Flop (didn't bet)
Seat 8: Serghio2902 folded before Flop (didn't bet)
Seat 9: Vitrex555 (button) folded on the Flop



PokerStars Hand #222103206769: Tournament #3082583698, $0.98+$0.12 USD Hold'em No Limit - Level XI (150/300) - 2021/01/01 21:51:18 EET [2021/01/01 14:51:18 ET]
Table '3082583698 30' 9-max Seat #1 is the button
Seat 1: marquitopoker4 (1093 in chips) 
Seat 2: xxMich@ilxx (25980 in chips) 
Seat 3: maajussi1 (10373 in chips) 
Seat 4: jcarlos.vale (15890 in chips) 
Seat 5: RCABelVedeRVerd (8344 in chips) 
Seat 6: Mimishka004 (20628 in chips) 
Seat 7: richard5189 (4849 in chips) 
Seat 8: Serghio2902 (9830 in chips) 
Seat 9: Vitrex555 (11014 in chips) 
marquitopoker4: posts the ante 22
xxMich@ilxx: posts the ante 22
maajussi1: posts the ante 22
jcarlos.vale: posts the ante 22
RCABelVedeRVerd: posts the ante 22
Mimishka004: posts the ante 22
richard5189: posts the ante 22
Serghio2902: posts the ante 22
Vitrex555: posts the ante 22
xxMich@ilxx: posts small blind 150
maajussi1: posts big blind 300
*** HOLE CARDS ***
Dealt to jcarlos.vale [4s 8h]
jcarlos.vale: folds 
RCABelVedeRVerd: folds 
Mimishka004: raises 360 to 660
richard5189: folds 
Serghio2902: folds 
Vitrex555: folds 
marquitopoker4: folds 
xxMich@ilxx: folds 
maajussi1: folds 
Uncalled bet (360) returned to Mimishka004
Mimishka004 collected 948 from pot
*** SUMMARY ***
Total pot 948 | Rake 0 
Seat 1: marquitopoker4 (button) folded before Flop (didn't bet)
Seat 2: xxMich@ilxx (small blind) folded before Flop
Seat 3: maajussi1 (big blind) folded before Flop
Seat 4: jcarlos.vale folded before Flop (didn't bet)
Seat 5: RCABelVedeRVerd folded before Flop (didn't bet)
Seat 6: Mimishka004 collected (948)
Seat 7: richard5189 folded before Flop (didn't bet)
Seat 8: Serghio2902 folded before Flop (didn't bet)
Seat 9: Vitrex555 folded before Flop (didn't bet)



PokerStars Hand #222103230528: Tournament #3082583698, $0.98+$0.12 USD Hold'em No Limit - Level XI (150/300) - 2021/01/01 21:51:41 EET [2021/01/01 14:51:41 ET]
Table '3082583698 30' 9-max Seat #2 is the button
Seat 1: marquitopoker4 (1071 in chips) 
Seat 2: xxMich@ilxx (25808 in chips) 
Seat 3: maajussi1 (10051 in chips) 
Seat 4: jcarlos.vale (15868 in chips) 
Seat 5: RCABelVedeRVerd (8322 in chips) 
Seat 6: Mimishka004 (21254 in chips) 
Seat 7: richard5189 (4827 in chips) 
Seat 8: Serghio2902 (9808 in chips) 
Seat 9: Vitrex555 (10992 in chips) 
marquitopoker4: posts the ante 22
xxMich@ilxx: posts the ante 22
maajussi1: posts the ante 22
jcarlos.vale: posts the ante 22
RCABelVedeRVerd: posts the ante 22
Mimishka004: posts the ante 22
richard5189: posts the ante 22
Serghio2902: posts the ante 22
Vitrex555: posts the ante 22
maajussi1: posts small blind 150
jcarlos.vale: posts big blind 300
*** HOLE CARDS ***
Dealt to jcarlos.vale [7s 5d]
RCABelVedeRVerd has timed out
RCABelVedeRVerd: folds 
RCABelVedeRVerd is sitting out
Mimishka004: folds 
richard5189: folds 
Serghio2902: raises 300 to 600
Vitrex555: folds 
marquitopoker4: folds 
xxMich@ilxx: folds 
maajussi1: folds 
jcarlos.vale: folds 
Uncalled bet (300) returned to Serghio2902
Serghio2902 collected 948 from pot
*** SUMMARY ***
Total pot 948 | Rake 0 
Seat 1: marquitopoker4 folded before Flop (didn't bet)
Seat 2: xxMich@ilxx (button) folded before Flop (didn't bet)
Seat 3: maajussi1 (small blind) folded before Flop
Seat 4: jcarlos.vale (big blind) folded before Flop
Seat 5: RCABelVedeRVerd folded before Flop (didn't bet)
Seat 6: Mimishka004 folded before Flop (didn't bet)
Seat 7: richard5189 folded before Flop (didn't bet)
Seat 8: Serghio2902 collected (948)
Seat 9: Vitrex555 folded before Flop (didn't bet)



PokerStars Hand #222103263094: Tournament #3082583698, $0.98+$0.12 USD Hold'em No Limit - Level XI (150/300) - 2021/01/01 21:52:12 EET [2021/01/01 14:52:12 ET]
Table '3082583698 30' 9-max Seat #3 is the button
Seat 1: marquitopoker4 (1049 in chips) 
Seat 2: xxMich@ilxx (25786 in chips) 
Seat 3: maajussi1 (9879 in chips) 
Seat 4: jcarlos.vale (15546 in chips) 
Seat 5: RCABelVedeRVerd (8300 in chips) is sitting out
Seat 6: Mimishka004 (21232 in chips) 
Seat 7: richard5189 (4805 in chips) 
Seat 8: Serghio2902 (10434 in chips) 
Seat 9: Vitrex555 (10970 in chips) 
marquitopoker4: posts the ante 22
xxMich@ilxx: posts the ante 22
maajussi1: posts the ante 22
jcarlos.vale: posts the ante 22
RCABelVedeRVerd: posts the ante 22
Mimishka004: posts the ante 22
richard5189: posts the ante 22
Serghio2902: posts the ante 22
Vitrex555: posts the ante 22
jcarlos.vale: posts small blind 150
RCABelVedeRVerd: posts big blind 300
*** HOLE CARDS ***
Dealt to jcarlos.vale [2c 9s]
RCABelVedeRVerd has returned
Mimishka004: raises 360 to 660
richard5189: folds 
Serghio2902: folds 
Vitrex555: calls 660
marquitopoker4: raises 360 to 1020
xxMich@ilxx: folds 
maajussi1: folds 
jcarlos.vale: folds 
RCABelVedeRVerd: folds 
Mimishka004: raises 20190 to 21210 and is all-in
Vitrex555: folds 
marquitopoker4: calls 7 and is all-in
Uncalled bet (20183) returned to Mimishka004
*** FLOP *** [Js Ad Tc]
*** TURN *** [Js Ad Tc] [5c]
*** RIVER *** [Js Ad Tc 5c] [2d]
*** SHOW DOWN ***
Mimishka004: shows [Ac Qc] (a pair of Aces)
marquitopoker4: shows [As Ah] (three of a kind, Aces)
marquitopoker4 collected 3362 from pot
*** SUMMARY ***
Total pot 3362 | Rake 0 
Board [Js Ad Tc 5c 2d]
Seat 1: marquitopoker4 showed [As Ah] and won (3362) with three of a kind, Aces
Seat 2: xxMich@ilxx folded before Flop (didn't bet)
Seat 3: maajussi1 (button) folded before Flop (didn't bet)
Seat 4: jcarlos.vale (small blind) folded before Flop
Seat 5: RCABelVedeRVerd (big blind) folded before Flop
Seat 6: Mimishka004 showed [Ac Qc] and lost with a pair of Aces
Seat 7: richard5189 folded before Flop (didn't bet)
Seat 8: Serghio2902 folded before Flop (didn't bet)
Seat 9: Vitrex555 folded before Flop



PokerStars Hand #222103306955: Tournament #3082583698, $0.98+$0.12 USD Hold'em No Limit - Level XI (150/300) - 2021/01/01 21:52:55 EET [2021/01/01 14:52:55 ET]
Table '3082583698 30' 9-max Seat #4 is the button
Seat 1: marquitopoker4 (3362 in chips) 
Seat 2: xxMich@ilxx (25764 in chips) 
Seat 3: maajussi1 (9857 in chips) 
Seat 4: jcarlos.vale (15374 in chips) 
Seat 5: RCABelVedeRVerd (7978 in chips) 
Seat 6: Mimishka004 (20183 in chips) 
Seat 7: richard5189 (4783 in chips) 
Seat 8: Serghio2902 (10412 in chips) 
Seat 9: Vitrex555 (10288 in chips) 
marquitopoker4: posts the ante 22
xxMich@ilxx: posts the ante 22
maajussi1: posts the ante 22
jcarlos.vale: posts the ante 22
RCABelVedeRVerd: posts the ante 22
Mimishka004: posts the ante 22
richard5189: posts the ante 22
Serghio2902: posts the ante 22
Vitrex555: posts the ante 22
RCABelVedeRVerd: posts small blind 150
Mimishka004: posts big blind 300
*** HOLE CARDS ***
Dealt to jcarlos.vale [3s Qc]
richard5189: folds 
Serghio2902: folds 
Vitrex555: folds 
marquitopoker4: folds 
xxMich@ilxx: raises 300 to 600
maajussi1: calls 600
jcarlos.vale: folds 
RCABelVedeRVerd: raises 7356 to 7956 and is all-in
Mimishka004: folds 
xxMich@ilxx: folds 
maajussi1: folds 
Uncalled bet (7356) returned to RCABelVedeRVerd
RCABelVedeRVerd collected 2298 from pot
*** SUMMARY ***
Total pot 2298 | Rake 0 
Seat 1: marquitopoker4 folded before Flop (didn't bet)
Seat 2: xxMich@ilxx folded before Flop
Seat 3: maajussi1 folded before Flop
Seat 4: jcarlos.vale (button) folded before Flop (didn't bet)
Seat 5: RCABelVedeRVerd (small blind) collected (2298)
Seat 6: Mimishka004 (big blind) folded before Flop
Seat 7: richard5189 folded before Flop (didn't bet)
Seat 8: Serghio2902 folded before Flop (didn't bet)
Seat 9: Vitrex555 folded before Flop (didn't bet)



PokerStars Hand #222103349271: Tournament #3082583698, $0.98+$0.12 USD Hold'em No Limit - Level XI (150/300) - 2021/01/01 21:53:37 EET [2021/01/01 14:53:37 ET]
Table '3082583698 30' 9-max Seat #5 is the button
Seat 1: marquitopoker4 (3340 in chips) 
Seat 2: xxMich@ilxx (25142 in chips) 
Seat 3: maajussi1 (9235 in chips) 
Seat 4: jcarlos.vale (15352 in chips) 
Seat 5: RCABelVedeRVerd (9654 in chips) 
Seat 6: Mimishka004 (19861 in chips) 
Seat 7: richard5189 (4761 in chips) 
Seat 8: Serghio2902 (10390 in chips) 
Seat 9: Vitrex555 (10266 in chips) 
marquitopoker4: posts the ante 22
xxMich@ilxx: posts the ante 22
maajussi1: posts the ante 22
jcarlos.vale: posts the ante 22
RCABelVedeRVerd: posts the ante 22
Mimishka004: posts the ante 22
richard5189: posts the ante 22
Serghio2902: posts the ante 22
Vitrex555: posts the ante 22
Mimishka004: posts small blind 150
richard5189: posts big blind 300
*** HOLE CARDS ***
Dealt to jcarlos.vale [Qd 8h]
Serghio2902: folds 
Vitrex555: folds 
marquitopoker4: folds 
xxMich@ilxx: folds 
maajussi1: folds 
jcarlos.vale: folds 
RCABelVedeRVerd: calls 300
Mimishka004: folds 
richard5189: checks 
*** FLOP *** [5c 4d 4s]
richard5189: checks 
RCABelVedeRVerd: bets 300
richard5189: folds 
Uncalled bet (300) returned to RCABelVedeRVerd
RCABelVedeRVerd collected 948 from pot
*** SUMMARY ***
Total pot 948 | Rake 0 
Board [5c 4d 4s]
Seat 1: marquitopoker4 folded before Flop (didn't bet)
Seat 2: xxMich@ilxx folded before Flop (didn't bet)
Seat 3: maajussi1 folded before Flop (didn't bet)
Seat 4: jcarlos.vale folded before Flop (didn't bet)
Seat 5: RCABelVedeRVerd (button) collected (948)
Seat 6: Mimishka004 (small blind) folded before Flop
Seat 7: richard5189 (big blind) folded on the Flop
Seat 8: Serghio2902 folded before Flop (didn't bet)
Seat 9: Vitrex555 folded before Flop (didn't bet)



PokerStars Hand #222103375382: Tournament #3082583698, $0.98+$0.12 USD Hold'em No Limit - Level XI (150/300) - 2021/01/01 21:54:03 EET [2021/01/01 14:54:03 ET]
Table '3082583698 30' 9-max Seat #6 is the button
Seat 1: marquitopoker4 (3318 in chips) 
Seat 2: xxMich@ilxx (25120 in chips) 
Seat 3: maajussi1 (9213 in chips) 
Seat 4: jcarlos.vale (15330 in chips) 
Seat 5: RCABelVedeRVerd (10280 in chips) 
Seat 6: Mimishka004 (19689 in chips) 
Seat 7: richard5189 (4439 in chips) 
Seat 8: Serghio2902 (10368 in chips) 
Seat 9: Vitrex555 (10244 in chips) 
marquitopoker4: posts the ante 22
xxMich@ilxx: posts the ante 22
maajussi1: posts the ante 22
jcarlos.vale: posts the ante 22
RCABelVedeRVerd: posts the ante 22
Mimishka004: posts the ante 22
richard5189: posts the ante 22
Serghio2902: posts the ante 22
Vitrex555: posts the ante 22
richard5189: posts small blind 150
Serghio2902: posts big blind 300
*** HOLE CARDS ***
Dealt to jcarlos.vale [Jc 4h]
Vitrex555: folds 
marquitopoker4: folds 
xxMich@ilxx: folds 
maajussi1: raises 600 to 900
jcarlos.vale: folds 
RCABelVedeRVerd: folds 
Mimishka004: folds 
richard5189: folds 
Serghio2902: folds 
Uncalled bet (600) returned to maajussi1
maajussi1 collected 948 from pot
maajussi1: doesn't show hand 
*** SUMMARY ***
Total pot 948 | Rake 0 
Seat 1: marquitopoker4 folded before Flop (didn't bet)
Seat 2: xxMich@ilxx folded before Flop (didn't bet)
Seat 3: maajussi1 collected (948)
Seat 4: jcarlos.vale folded before Flop (didn't bet)
Seat 5: RCABelVedeRVerd folded before Flop (didn't bet)
Seat 6: Mimishka004 (button) folded before Flop (didn't bet)
Seat 7: richard5189 (small blind) folded before Flop
Seat 8: Serghio2902 (big blind) folded before Flop
Seat 9: Vitrex555 folded before Flop (didn't bet)



PokerStars Hand #222103406202: Tournament #3082583698, $0.98+$0.12 USD Hold'em No Limit - Level XI (150/300) - 2021/01/01 21:54:33 EET [2021/01/01 14:54:33 ET]
Table '3082583698 30' 9-max Seat #7 is the button
Seat 1: marquitopoker4 (3296 in chips) 
Seat 2: xxMich@ilxx (25098 in chips) 
Seat 3: maajussi1 (9839 in chips) 
Seat 4: jcarlos.vale (15308 in chips) 
Seat 5: RCABelVedeRVerd (10258 in chips) 
Seat 6: Mimishka004 (19667 in chips) 
Seat 7: richard5189 (4267 in chips) 
Seat 8: Serghio2902 (10046 in chips) 
Seat 9: Vitrex555 (10222 in chips) 
marquitopoker4: posts the ante 22
xxMich@ilxx: posts the ante 22
maajussi1: posts the ante 22
jcarlos.vale: posts the ante 22
RCABelVedeRVerd: posts the ante 22
Mimishka004: posts the ante 22
richard5189: posts the ante 22
Serghio2902: posts the ante 22
Vitrex555: posts the ante 22
Serghio2902: posts small blind 150
Vitrex555: posts big blind 300
*** HOLE CARDS ***
Dealt to jcarlos.vale [9h 8s]
marquitopoker4: folds 
xxMich@ilxx: folds 
maajussi1: raises 300 to 600
jcarlos.vale: folds 
RCABelVedeRVerd: folds 
Mimishka004: raises 1050 to 1650
richard5189: folds 
Serghio2902: folds 
Vitrex555: folds 
maajussi1: calls 1050
*** FLOP *** [Qd 5h Jd]
maajussi1: checks 
Mimishka004: bets 987
maajussi1: calls 987
*** TURN *** [Qd 5h Jd] [2s]
maajussi1: checks 
Mimishka004: bets 2250
maajussi1: folds 
Uncalled bet (2250) returned to Mimishka004
Mimishka004 collected 5922 from pot
*** SUMMARY ***
Total pot 5922 | Rake 0 
Board [Qd 5h Jd 2s]
Seat 1: marquitopoker4 folded before Flop (didn't bet)
Seat 2: xxMich@ilxx folded before Flop (didn't bet)
Seat 3: maajussi1 folded on the Turn
Seat 4: jcarlos.vale folded before Flop (didn't bet)
Seat 5: RCABelVedeRVerd folded before Flop (didn't bet)
Seat 6: Mimishka004 collected (5922)
Seat 7: richard5189 (button) folded before Flop (didn't bet)
Seat 8: Serghio2902 (small blind) folded before Flop
Seat 9: Vitrex555 (big blind) folded before Flop



PokerStars Hand #222103583371: Tournament #3082583698, $0.98+$0.12 USD Hold'em No Limit - Level XI (150/300) - 2021/01/01 22:01:35 EET [2021/01/01 15:01:35 ET]
Table '3082583698 30' 9-max Seat #8 is the button
Seat 1: marquitopoker4 (3274 in chips) 
Seat 2: xxMich@ilxx (25076 in chips) 
Seat 3: maajussi1 (7180 in chips) 
Seat 4: jcarlos.vale (15286 in chips) 
Seat 5: RCABelVedeRVerd (10236 in chips) 
Seat 6: Mimishka004 (22930 in chips) 
Seat 7: richard5189 (4245 in chips) 
Seat 8: Serghio2902 (9874 in chips) 
Seat 9: Vitrex555 (9900 in chips) 
marquitopoker4: posts the ante 22
xxMich@ilxx: posts the ante 22
maajussi1: posts the ante 22
jcarlos.vale: posts the ante 22
RCABelVedeRVerd: posts the ante 22
Mimishka004: posts the ante 22
richard5189: posts the ante 22
Serghio2902: posts the ante 22
Vitrex555: posts the ante 22
Vitrex555: posts small blind 150
marquitopoker4: posts big blind 300
*** HOLE CARDS ***
Dealt to jcarlos.vale [8c 2c]
xxMich@ilxx: raises 600 to 900
maajussi1: folds 
jcarlos.vale: folds 
RCABelVedeRVerd: folds 
Mimishka004: folds 
richard5189: folds 
Serghio2902: folds 
Vitrex555: folds 
marquitopoker4: folds 
Uncalled bet (600) returned to xxMich@ilxx
xxMich@ilxx collected 948 from pot
*** SUMMARY ***
Total pot 948 | Rake 0 
Seat 1: marquitopoker4 (big blind) folded before Flop
Seat 2: xxMich@ilxx collected (948)
Seat 3: maajussi1 folded before Flop (didn't bet)
Seat 4: jcarlos.vale folded before Flop (didn't bet)
Seat 5: RCABelVedeRVerd folded before Flop (didn't bet)
Seat 6: Mimishka004 folded before Flop (didn't bet)
Seat 7: richard5189 folded before Flop (didn't bet)
Seat 8: Serghio2902 (button) folded before Flop (didn't bet)
Seat 9: Vitrex555 (small blind) folded before Flop



PokerStars Hand #222103599088: Tournament #3082583698, $0.98+$0.12 USD Hold'em No Limit - Level XI (150/300) - 2021/01/01 22:01:59 EET [2021/01/01 15:01:59 ET]
Table '3082583698 30' 9-max Seat #9 is the button
Seat 1: marquitopoker4 (2952 in chips) 
Seat 2: xxMich@ilxx (25702 in chips) 
Seat 3: maajussi1 (7158 in chips) 
Seat 4: jcarlos.vale (15264 in chips) 
Seat 5: RCABelVedeRVerd (10214 in chips) 
Seat 6: Mimishka004 (22908 in chips) 
Seat 7: richard5189 (4223 in chips) 
Seat 8: Serghio2902 (9852 in chips) 
Seat 9: Vitrex555 (9728 in chips) 
marquitopoker4: posts the ante 22
xxMich@ilxx: posts the ante 22
maajussi1: posts the ante 22
jcarlos.vale: posts the ante 22
RCABelVedeRVerd: posts the ante 22
Mimishka004: posts the ante 22
richard5189: posts the ante 22
Serghio2902: posts the ante 22
Vitrex555: posts the ante 22
marquitopoker4: posts small blind 150
xxMich@ilxx: posts big blind 300
*** HOLE CARDS ***
Dealt to jcarlos.vale [3s Jd]
maajussi1: folds 
jcarlos.vale: folds 
RCABelVedeRVerd: folds 
Mimishka004: folds 
richard5189: folds 
Serghio2902: folds 
Vitrex555: folds 
marquitopoker4: calls 150
xxMich@ilxx: checks 
*** FLOP *** [8h 9c 8c]
marquitopoker4: bets 2630 and is all-in
xxMich@ilxx: folds 
Uncalled bet (2630) returned to marquitopoker4
marquitopoker4 collected 798 from pot
marquitopoker4: doesn't show hand 
*** SUMMARY ***
Total pot 798 | Rake 0 
Board [8h 9c 8c]
Seat 1: marquitopoker4 (small blind) collected (798)
Seat 2: xxMich@ilxx (big blind) folded on the Flop
Seat 3: maajussi1 folded before Flop (didn't bet)
Seat 4: jcarlos.vale folded before Flop (didn't bet)
Seat 5: RCABelVedeRVerd folded before Flop (didn't bet)
Seat 6: Mimishka004 folded before Flop (didn't bet)
Seat 7: richard5189 folded before Flop (didn't bet)
Seat 8: Serghio2902 folded before Flop (didn't bet)
Seat 9: Vitrex555 (button) folded before Flop (didn't bet)



PokerStars Hand #222103615618: Tournament #3082583698, $0.98+$0.12 USD Hold'em No Limit - Level XI (150/300) - 2021/01/01 22:02:27 EET [2021/01/01 15:02:27 ET]
Table '3082583698 30' 9-max Seat #1 is the button
Seat 1: marquitopoker4 (3428 in chips) 
Seat 2: xxMich@ilxx (25380 in chips) 
Seat 3: maajussi1 (7136 in chips) 
Seat 4: jcarlos.vale (15242 in chips) 
Seat 5: RCABelVedeRVerd (10192 in chips) 
Seat 6: Mimishka004 (22886 in chips) 
Seat 7: richard5189 (4201 in chips) 
Seat 8: Serghio2902 (9830 in chips) 
Seat 9: Vitrex555 (9706 in chips) 
marquitopoker4: posts the ante 22
xxMich@ilxx: posts the ante 22
maajussi1: posts the ante 22
jcarlos.vale: posts the ante 22
RCABelVedeRVerd: posts the ante 22
Mimishka004: posts the ante 22
richard5189: posts the ante 22
Serghio2902: posts the ante 22
Vitrex555: posts the ante 22
xxMich@ilxx: posts small blind 150
maajussi1: posts big blind 300
*** HOLE CARDS ***
Dealt to jcarlos.vale [4s Ks]
jcarlos.vale: folds 
RCABelVedeRVerd: folds 
Mimishka004: folds 
richard5189: folds 
Serghio2902: folds 
Vitrex555: folds 
marquitopoker4: raises 3000 to 3300
xxMich@ilxx: folds 
maajussi1: folds 
Uncalled bet (3000) returned to marquitopoker4
marquitopoker4 collected 948 from pot
marquitopoker4: doesn't show hand 
*** SUMMARY ***
Total pot 948 | Rake 0 
Seat 1: marquitopoker4 (button) collected (948)
Seat 2: xxMich@ilxx (small blind) folded before Flop
Seat 3: maajussi1 (big blind) folded before Flop
Seat 4: jcarlos.vale folded before Flop (didn't bet)
Seat 5: RCABelVedeRVerd folded before Flop (didn't bet)
Seat 6: Mimishka004 folded before Flop (didn't bet)
Seat 7: richard5189 folded before Flop (didn't bet)
Seat 8: Serghio2902 folded before Flop (didn't bet)
Seat 9: Vitrex555 folded before Flop (didn't bet)



PokerStars Hand #222103632350: Tournament #3082583698, $0.98+$0.12 USD Hold'em No Limit - Level XI (150/300) - 2021/01/01 22:02:54 EET [2021/01/01 15:02:54 ET]
Table '3082583698 30' 9-max Seat #2 is the button
Seat 1: marquitopoker4 (4054 in chips) 
Seat 2: xxMich@ilxx (25208 in chips) 
Seat 3: maajussi1 (6814 in chips) 
Seat 4: jcarlos.vale (15220 in chips) 
Seat 5: RCABelVedeRVerd (10170 in chips) 
Seat 6: Mimishka004 (22864 in chips) 
Seat 7: richard5189 (4179 in chips) 
Seat 8: Serghio2902 (9808 in chips) 
Seat 9: Vitrex555 (9684 in chips) 
marquitopoker4: posts the ante 22
xxMich@ilxx: posts the ante 22
maajussi1: posts the ante 22
jcarlos.vale: posts the ante 22
RCABelVedeRVerd: posts the ante 22
Mimishka004: posts the ante 22
richard5189: posts the ante 22
Serghio2902: posts the ante 22
Vitrex555: posts the ante 22
maajussi1: posts small blind 150
jcarlos.vale: posts big blind 300
*** HOLE CARDS ***
Dealt to jcarlos.vale [8c Kd]
RCABelVedeRVerd: folds 
Mimishka004: folds 
richard5189: calls 300
Serghio2902: folds 
Vitrex555: folds 
marquitopoker4: folds 
xxMich@ilxx: calls 300
maajussi1: folds 
jcarlos.vale: checks 
*** FLOP *** [Tc As 4h]
jcarlos.vale: checks 
richard5189: checks 
xxMich@ilxx: checks 
*** TURN *** [Tc As 4h] [6c]
jcarlos.vale: checks 
richard5189: bets 624
xxMich@ilxx: calls 624
jcarlos.vale: folds 
*** RIVER *** [Tc As 4h 6c] [2h]
richard5189: checks 
xxMich@ilxx: checks 
*** SHOW DOWN ***
richard5189: shows [Td 5d] (a pair of Tens)
xxMich@ilxx: shows [Kh Ts] (a pair of Tens - Ace+King kicker)
xxMich@ilxx collected 2496 from pot
*** SUMMARY ***
Total pot 2496 | Rake 0 
Board [Tc As 4h 6c 2h]
Seat 1: marquitopoker4 folded before Flop (didn't bet)
Seat 2: xxMich@ilxx (button) showed [Kh Ts] and won (2496) with a pair of Tens
Seat 3: maajussi1 (small blind) folded before Flop
Seat 4: jcarlos.vale (big blind) folded on the Turn
Seat 5: RCABelVedeRVerd folded before Flop (didn't bet)
Seat 6: Mimishka004 folded before Flop (didn't bet)
Seat 7: richard5189 showed [Td 5d] and lost with a pair of Tens
Seat 8: Serghio2902 folded before Flop (didn't bet)
Seat 9: Vitrex555 folded before Flop (didn't bet)



PokerStars Hand #222103664663: Tournament #3082583698, $0.98+$0.12 USD Hold'em No Limit - Level XI (150/300) - 2021/01/01 22:03:39 EET [2021/01/01 15:03:39 ET]
Table '3082583698 30' 9-max Seat #3 is the button
Seat 1: marquitopoker4 (4032 in chips) 
Seat 2: xxMich@ilxx (26758 in chips) 
Seat 3: maajussi1 (6642 in chips) 
Seat 4: jcarlos.vale (14898 in chips) 
Seat 5: RCABelVedeRVerd (10148 in chips) 
Seat 6: Mimishka004 (22842 in chips) 
Seat 7: richard5189 (3233 in chips) 
Seat 8: Serghio2902 (9786 in chips) 
Seat 9: Vitrex555 (9662 in chips) 
marquitopoker4: posts the ante 22
xxMich@ilxx: posts the ante 22
maajussi1: posts the ante 22
jcarlos.vale: posts the ante 22
RCABelVedeRVerd: posts the ante 22
Mimishka004: posts the ante 22
richard5189: posts the ante 22
Serghio2902: posts the ante 22
Vitrex555: posts the ante 22
jcarlos.vale: posts small blind 150
RCABelVedeRVerd: posts big blind 300
*** HOLE CARDS ***
Dealt to jcarlos.vale [2d 3h]
Mimishka004: folds 
richard5189: raises 300 to 600
Serghio2902: folds 
Vitrex555: folds 
marquitopoker4: folds 
xxMich@ilxx: folds 
maajussi1: folds 
jcarlos.vale: folds 
RCABelVedeRVerd: folds 
Uncalled bet (300) returned to richard5189
richard5189 collected 948 from pot
richard5189: doesn't show hand 
*** SUMMARY ***
Total pot 948 | Rake 0 
Seat 1: marquitopoker4 folded before Flop (didn't bet)
Seat 2: xxMich@ilxx folded before Flop (didn't bet)
Seat 3: maajussi1 (button) folded before Flop (didn't bet)
Seat 4: jcarlos.vale (small blind) folded before Flop
Seat 5: RCABelVedeRVerd (big blind) folded before Flop
Seat 6: Mimishka004 folded before Flop (didn't bet)
Seat 7: richard5189 collected (948)
Seat 8: Serghio2902 folded before Flop (didn't bet)
Seat 9: Vitrex555 folded before Flop (didn't bet)



PokerStars Hand #222103699640: Tournament #3082583698, $0.98+$0.12 USD Hold'em No Limit - Level XI (150/300) - 2021/01/01 22:04:09 EET [2021/01/01 15:04:09 ET]
Table '3082583698 30' 9-max Seat #4 is the button
Seat 1: marquitopoker4 (4010 in chips) 
Seat 2: xxMich@ilxx (26736 in chips) 
Seat 3: maajussi1 (6620 in chips) 
Seat 4: jcarlos.vale (14726 in chips) 
Seat 5: RCABelVedeRVerd (9826 in chips) 
Seat 6: Mimishka004 (22820 in chips) 
Seat 7: richard5189 (3859 in chips) 
Seat 8: Serghio2902 (9764 in chips) 
Seat 9: Vitrex555 (9640 in chips) 
marquitopoker4: posts the ante 22
xxMich@ilxx: posts the ante 22
maajussi1: posts the ante 22
jcarlos.vale: posts the ante 22
RCABelVedeRVerd: posts the ante 22
Mimishka004: posts the ante 22
richard5189: posts the ante 22
Serghio2902: posts the ante 22
Vitrex555: posts the ante 22
RCABelVedeRVerd: posts small blind 150
Mimishka004: posts big blind 300
*** HOLE CARDS ***
Dealt to jcarlos.vale [7c 3c]
richard5189: folds 
Serghio2902: folds 
Vitrex555: calls 300
marquitopoker4: folds 
xxMich@ilxx: folds 
maajussi1: calls 300
jcarlos.vale: folds 
RCABelVedeRVerd: folds 
Mimishka004: checks 
*** FLOP *** [Tc 8h 5h]
Mimishka004: checks 
Vitrex555: checks 
maajussi1: checks 
*** TURN *** [Tc 8h 5h] [Th]
Mimishka004: bets 412
Vitrex555: folds 
maajussi1: calls 412
*** RIVER *** [Tc 8h 5h Th] [7s]
Mimishka004: checks 
maajussi1: checks 
*** SHOW DOWN ***
Mimishka004: shows [Td 2c] (three of a kind, Tens)
maajussi1: mucks hand 
Mimishka004 collected 2072 from pot
*** SUMMARY ***
Total pot 2072 | Rake 0 
Board [Tc 8h 5h Th 7s]
Seat 1: marquitopoker4 folded before Flop (didn't bet)
Seat 2: xxMich@ilxx folded before Flop (didn't bet)
Seat 3: maajussi1 mucked [2d 2h]
Seat 4: jcarlos.vale (button) folded before Flop (didn't bet)
Seat 5: RCABelVedeRVerd (small blind) folded before Flop
Seat 6: Mimishka004 (big blind) showed [Td 2c] and won (2072) with three of a kind, Tens
Seat 7: richard5189 folded before Flop (didn't bet)
Seat 8: Serghio2902 folded before Flop (didn't bet)
Seat 9: Vitrex555 folded on the Turn



PokerStars Hand #222103762168: Tournament #3082583698, $0.98+$0.12 USD Hold'em No Limit - Level XII (200/400) - 2021/01/01 22:05:13 EET [2021/01/01 15:05:13 ET]
Table '3082583698 30' 9-max Seat #5 is the button
Seat 1: marquitopoker4 (3988 in chips) 
Seat 2: xxMich@ilxx (26714 in chips) 
Seat 3: maajussi1 (5886 in chips) 
Seat 4: jcarlos.vale (14704 in chips) 
Seat 5: RCABelVedeRVerd (9654 in chips) 
Seat 6: Mimishka004 (24158 in chips) 
Seat 7: richard5189 (3837 in chips) 
Seat 8: Serghio2902 (9742 in chips) 
Seat 9: Vitrex555 (9318 in chips) 
marquitopoker4: posts the ante 25
xxMich@ilxx: posts the ante 25
maajussi1: posts the ante 25
jcarlos.vale: posts the ante 25
RCABelVedeRVerd: posts the ante 25
Mimishka004: posts the ante 25
richard5189: posts the ante 25
Serghio2902: posts the ante 25
Vitrex555: posts the ante 25
Mimishka004: posts small blind 200
richard5189: posts big blind 400
*** HOLE CARDS ***
Dealt to jcarlos.vale [8s Qc]
Serghio2902: folds 
Vitrex555: folds 
marquitopoker4: folds 
xxMich@ilxx: folds 
maajussi1: folds 
jcarlos.vale: folds 
RCABelVedeRVerd: folds 
Mimishka004: calls 200
richard5189: checks 
*** FLOP *** [7h Ah Qs]
Mimishka004: bets 656
richard5189: folds 
Uncalled bet (656) returned to Mimishka004
Mimishka004 collected 1025 from pot
*** SUMMARY ***
Total pot 1025 | Rake 0 
Board [7h Ah Qs]
Seat 1: marquitopoker4 folded before Flop (didn't bet)
Seat 2: xxMich@ilxx folded before Flop (didn't bet)
Seat 3: maajussi1 folded before Flop (didn't bet)
Seat 4: jcarlos.vale folded before Flop (didn't bet)
Seat 5: RCABelVedeRVerd (button) folded before Flop (didn't bet)
Seat 6: Mimishka004 (small blind) collected (1025)
Seat 7: richard5189 (big blind) folded on the Flop
Seat 8: Serghio2902 folded before Flop (didn't bet)
Seat 9: Vitrex555 folded before Flop (didn't bet)



PokerStars Hand #222103813098: Tournament #3082583698, $0.98+$0.12 USD Hold'em No Limit - Level XII (200/400) - 2021/01/01 22:06:03 EET [2021/01/01 15:06:03 ET]
Table '3082583698 30' 9-max Seat #6 is the button
Seat 1: marquitopoker4 (3963 in chips) 
Seat 2: xxMich@ilxx (26689 in chips) 
Seat 3: maajussi1 (5861 in chips) 
Seat 4: jcarlos.vale (14679 in chips) 
Seat 5: RCABelVedeRVerd (9629 in chips) 
Seat 6: Mimishka004 (24758 in chips) 
Seat 7: richard5189 (3412 in chips) 
Seat 8: Serghio2902 (9717 in chips) 
Seat 9: Vitrex555 (9293 in chips) 
marquitopoker4: posts the ante 25
xxMich@ilxx: posts the ante 25
maajussi1: posts the ante 25
jcarlos.vale: posts the ante 25
RCABelVedeRVerd: posts the ante 25
Mimishka004: posts the ante 25
richard5189: posts the ante 25
Serghio2902: posts the ante 25
Vitrex555: posts the ante 25
richard5189: posts small blind 200
Serghio2902: posts big blind 400
*** HOLE CARDS ***
Dealt to jcarlos.vale [As 7c]
Vitrex555: folds 
marquitopoker4: folds 
xxMich@ilxx: raises 400 to 800
maajussi1: folds 
jcarlos.vale: folds 
RCABelVedeRVerd: folds 
Mimishka004: raises 1600 to 2400
richard5189: folds 
Serghio2902: folds 
xxMich@ilxx: calls 1600
*** FLOP *** [Jh 4h 6h]
xxMich@ilxx: checks 
Mimishka004: checks 
*** TURN *** [Jh 4h 6h] [8d]
xxMich@ilxx: bets 2000
Mimishka004: folds 
Uncalled bet (2000) returned to xxMich@ilxx
xxMich@ilxx collected 5625 from pot
*** SUMMARY ***
Total pot 5625 | Rake 0 
Board [Jh 4h 6h 8d]
Seat 1: marquitopoker4 folded before Flop (didn't bet)
Seat 2: xxMich@ilxx collected (5625)
Seat 3: maajussi1 folded before Flop (didn't bet)
Seat 4: jcarlos.vale folded before Flop (didn't bet)
Seat 5: RCABelVedeRVerd folded before Flop (didn't bet)
Seat 6: Mimishka004 (button) folded on the Turn
Seat 7: richard5189 (small blind) folded before Flop
Seat 8: Serghio2902 (big blind) folded before Flop
Seat 9: Vitrex555 folded before Flop (didn't bet)



PokerStars Hand #222103867086: Tournament #3082583698, $0.98+$0.12 USD Hold'em No Limit - Level XII (200/400) - 2021/01/01 22:06:55 EET [2021/01/01 15:06:55 ET]
Table '3082583698 30' 9-max Seat #7 is the button
Seat 1: marquitopoker4 (3938 in chips) 
Seat 2: xxMich@ilxx (29889 in chips) 
Seat 3: maajussi1 (5836 in chips) 
Seat 4: jcarlos.vale (14654 in chips) 
Seat 5: RCABelVedeRVerd (9604 in chips) 
Seat 6: Mimishka004 (22333 in chips) 
Seat 7: richard5189 (3187 in chips) 
Seat 8: Serghio2902 (9292 in chips) 
Seat 9: Vitrex555 (9268 in chips) 
marquitopoker4: posts the ante 25
xxMich@ilxx: posts the ante 25
maajussi1: posts the ante 25
jcarlos.vale: posts the ante 25
RCABelVedeRVerd: posts the ante 25
Mimishka004: posts the ante 25
richard5189: posts the ante 25
Serghio2902: posts the ante 25
Vitrex555: posts the ante 25
Serghio2902: posts small blind 200
Vitrex555: posts big blind 400
*** HOLE CARDS ***
Dealt to jcarlos.vale [Js Kd]
marquitopoker4: folds 
xxMich@ilxx: folds 
maajussi1: folds 
jcarlos.vale: raises 640 to 1040
RCABelVedeRVerd has timed out
RCABelVedeRVerd: folds 
RCABelVedeRVerd is sitting out
Mimishka004: folds 
richard5189: folds 
Serghio2902: calls 840
Vitrex555: folds 
*** FLOP *** [Ac As 2d]
RCABelVedeRVerd has returned
Serghio2902: checks 
jcarlos.vale: bets 800
Serghio2902: folds 
Uncalled bet (800) returned to jcarlos.vale
jcarlos.vale collected 2705 from pot
jcarlos.vale: doesn't show hand 
*** SUMMARY ***
Total pot 2705 | Rake 0 
Board [Ac As 2d]
Seat 1: marquitopoker4 folded before Flop (didn't bet)
Seat 2: xxMich@ilxx folded before Flop (didn't bet)
Seat 3: maajussi1 folded before Flop (didn't bet)
Seat 4: jcarlos.vale collected (2705)
Seat 5: RCABelVedeRVerd folded before Flop (didn't bet)
Seat 6: Mimishka004 folded before Flop (didn't bet)
Seat 7: richard5189 (button) folded before Flop (didn't bet)
Seat 8: Serghio2902 (small blind) folded on the Flop
Seat 9: Vitrex555 (big blind) folded before Flop



PokerStars Hand #222103914439: Tournament #3082583698, $0.98+$0.12 USD Hold'em No Limit - Level XII (200/400) - 2021/01/01 22:07:40 EET [2021/01/01 15:07:40 ET]
Table '3082583698 30' 9-max Seat #8 is the button
Seat 1: marquitopoker4 (3913 in chips) 
Seat 2: xxMich@ilxx (29864 in chips) 
Seat 3: maajussi1 (5811 in chips) 
Seat 4: jcarlos.vale (16294 in chips) 
Seat 5: RCABelVedeRVerd (9579 in chips) 
Seat 6: Mimishka004 (22308 in chips) 
Seat 7: richard5189 (3162 in chips) 
Seat 8: Serghio2902 (8227 in chips) 
Seat 9: Vitrex555 (8843 in chips) 
marquitopoker4: posts the ante 25
xxMich@ilxx: posts the ante 25
maajussi1: posts the ante 25
jcarlos.vale: posts the ante 25
RCABelVedeRVerd: posts the ante 25
Mimishka004: posts the ante 25
richard5189: posts the ante 25
Serghio2902: posts the ante 25
Vitrex555: posts the ante 25
Vitrex555: posts small blind 200
marquitopoker4: posts big blind 400
*** HOLE CARDS ***
Dealt to jcarlos.vale [Kd 4s]
xxMich@ilxx: folds 
maajussi1: calls 400
jcarlos.vale: folds 
RCABelVedeRVerd: folds 
Mimishka004: folds 
richard5189: raises 800 to 1200
Serghio2902: folds 
Vitrex555: folds 
marquitopoker4: folds 
maajussi1: folds 
Uncalled bet (800) returned to richard5189
richard5189 collected 1625 from pot
richard5189: doesn't show hand 
*** SUMMARY ***
Total pot 1625 | Rake 0 
Seat 1: marquitopoker4 (big blind) folded before Flop
Seat 2: xxMich@ilxx folded before Flop (didn't bet)
Seat 3: maajussi1 folded before Flop
Seat 4: jcarlos.vale folded before Flop (didn't bet)
Seat 5: RCABelVedeRVerd folded before Flop (didn't bet)
Seat 6: Mimishka004 folded before Flop (didn't bet)
Seat 7: richard5189 collected (1625)
Seat 8: Serghio2902 (button) folded before Flop (didn't bet)
Seat 9: Vitrex555 (small blind) folded before Flop



PokerStars Hand #222103945082: Tournament #3082583698, $0.98+$0.12 USD Hold'em No Limit - Level XII (200/400) - 2021/01/01 22:08:09 EET [2021/01/01 15:08:09 ET]
Table '3082583698 30' 9-max Seat #9 is the button
Seat 1: marquitopoker4 (3488 in chips) 
Seat 2: xxMich@ilxx (29839 in chips) 
Seat 3: maajussi1 (5386 in chips) 
Seat 4: jcarlos.vale (16269 in chips) 
Seat 5: RCABelVedeRVerd (9554 in chips) 
Seat 6: Mimishka004 (22283 in chips) 
Seat 7: richard5189 (4362 in chips) 
Seat 8: Serghio2902 (8202 in chips) 
Seat 9: Vitrex555 (8618 in chips) 
marquitopoker4: posts the ante 25
xxMich@ilxx: posts the ante 25
maajussi1: posts the ante 25
jcarlos.vale: posts the ante 25
RCABelVedeRVerd: posts the ante 25
Mimishka004: posts the ante 25
richard5189: posts the ante 25
Serghio2902: posts the ante 25
Vitrex555: posts the ante 25
marquitopoker4: posts small blind 200
xxMich@ilxx: posts big blind 400
*** HOLE CARDS ***
Dealt to jcarlos.vale [5s Jc]
maajussi1: folds 
jcarlos.vale: folds 
RCABelVedeRVerd: calls 400
Mimishka004: folds 
richard5189: calls 400
Serghio2902: folds 
Vitrex555: folds 
marquitopoker4: raises 2800 to 3200
xxMich@ilxx: folds 
RCABelVedeRVerd: raises 3200 to 6400
richard5189: folds 
marquitopoker4: calls 263 and is all-in
Uncalled bet (2937) returned to RCABelVedeRVerd
*** FLOP *** [Qc 2d 4h]
*** TURN *** [Qc 2d 4h] [9c]
*** RIVER *** [Qc 2d 4h 9c] [9h]
*** SHOW DOWN ***
marquitopoker4: shows [5h Ah] (a pair of Nines)
RCABelVedeRVerd: shows [As 7s] (a pair of Nines - Ace+Queen+Seven kicker)
RCABelVedeRVerd collected 7951 from pot
marquitopoker4 finished the tournament in 1175th place
*** SUMMARY ***
Total pot 7951 | Rake 0 
Board [Qc 2d 4h 9c 9h]
Seat 1: marquitopoker4 (small blind) showed [5h Ah] and lost with a pair of Nines
Seat 2: xxMich@ilxx (big blind) folded before Flop
Seat 3: maajussi1 folded before Flop (didn't bet)
Seat 4: jcarlos.vale folded before Flop (didn't bet)
Seat 5: RCABelVedeRVerd showed [As 7s] and won (7951) with a pair of Nines
Seat 6: Mimishka004 folded before Flop (didn't bet)
Seat 7: richard5189 folded before Flop
Seat 8: Serghio2902 folded before Flop (didn't bet)
Seat 9: Vitrex555 (button) folded before Flop (didn't bet)



PokerStars Hand #222104024429: Tournament #3082583698, $0.98+$0.12 USD Hold'em No Limit - Level XII (200/400) - 2021/01/01 22:09:21 EET [2021/01/01 15:09:21 ET]
Table '3082583698 30' 9-max Seat #2 is the button
Seat 2: xxMich@ilxx (29414 in chips) 
Seat 3: maajussi1 (5361 in chips) 
Seat 4: jcarlos.vale (16244 in chips) 
Seat 5: RCABelVedeRVerd (14017 in chips) 
Seat 6: Mimishka004 (22258 in chips) 
Seat 7: richard5189 (3937 in chips) 
Seat 8: Serghio2902 (8177 in chips) 
Seat 9: Vitrex555 (8593 in chips) 
xxMich@ilxx: posts the ante 25
maajussi1: posts the ante 25
jcarlos.vale: posts the ante 25
RCABelVedeRVerd: posts the ante 25
Mimishka004: posts the ante 25
richard5189: posts the ante 25
Serghio2902: posts the ante 25
Vitrex555: posts the ante 25
maajussi1: posts small blind 200
jcarlos.vale: posts big blind 400
*** HOLE CARDS ***
Dealt to jcarlos.vale [9c 2h]
RCABelVedeRVerd: folds 
Mimishka004: folds 
richard5189: folds 
Serghio2902: folds 
Vitrex555: folds 
xxMich@ilxx: folds 
maajussi1: folds 
Uncalled bet (200) returned to jcarlos.vale
jcarlos.vale collected 600 from pot
jcarlos.vale: doesn't show hand 
*** SUMMARY ***
Total pot 600 | Rake 0 
Seat 2: xxMich@ilxx (button) folded before Flop (didn't bet)
Seat 3: maajussi1 (small blind) folded before Flop
Seat 4: jcarlos.vale (big blind) collected (600)
Seat 5: RCABelVedeRVerd folded before Flop (didn't bet)
Seat 6: Mimishka004 folded before Flop (didn't bet)
Seat 7: richard5189 folded before Flop (didn't bet)
Seat 8: Serghio2902 folded before Flop (didn't bet)
Seat 9: Vitrex555 folded before Flop (didn't bet)



PokerStars Hand #222104050632: Tournament #3082583698, $0.98+$0.12 USD Hold'em No Limit - Level XII (200/400) - 2021/01/01 22:09:47 EET [2021/01/01 15:09:47 ET]
Table '3082583698 30' 9-max Seat #3 is the button
Seat 1: Zwuggl56 (1449 in chips) 
Seat 2: xxMich@ilxx (29389 in chips) 
Seat 3: maajussi1 (5136 in chips) 
Seat 4: jcarlos.vale (16619 in chips) 
Seat 5: RCABelVedeRVerd (13992 in chips) 
Seat 6: Mimishka004 (22233 in chips) 
Seat 7: richard5189 (3912 in chips) 
Seat 8: Serghio2902 (8152 in chips) 
Seat 9: Vitrex555 (8568 in chips) 
Zwuggl56: posts the ante 25
xxMich@ilxx: posts the ante 25
maajussi1: posts the ante 25
jcarlos.vale: posts the ante 25
RCABelVedeRVerd: posts the ante 25
Mimishka004: posts the ante 25
richard5189: posts the ante 25
Serghio2902: posts the ante 25
Vitrex555: posts the ante 25
jcarlos.vale: posts small blind 200
RCABelVedeRVerd: posts big blind 400
*** HOLE CARDS ***
Dealt to jcarlos.vale [Ad Th]
Mimishka004: folds 
richard5189: folds 
Serghio2902: folds 
Vitrex555: calls 400
Zwuggl56: folds 
xxMich@ilxx: folds 
maajussi1: folds 
jcarlos.vale: calls 200
RCABelVedeRVerd: checks 
*** FLOP *** [6c 2d 6s]
jcarlos.vale: checks 
RCABelVedeRVerd: checks 
Vitrex555: bets 400
jcarlos.vale: folds 
RCABelVedeRVerd: folds 
Uncalled bet (400) returned to Vitrex555
Vitrex555 collected 1425 from pot
Vitrex555: doesn't show hand 
*** SUMMARY ***
Total pot 1425 | Rake 0 
Board [6c 2d 6s]
Seat 1: Zwuggl56 folded before Flop (didn't bet)
Seat 2: xxMich@ilxx folded before Flop (didn't bet)
Seat 3: maajussi1 (button) folded before Flop (didn't bet)
Seat 4: jcarlos.vale (small blind) folded on the Flop
Seat 5: RCABelVedeRVerd (big blind) folded on the Flop
Seat 6: Mimishka004 folded before Flop (didn't bet)
Seat 7: richard5189 folded before Flop (didn't bet)
Seat 8: Serghio2902 folded before Flop (didn't bet)
Seat 9: Vitrex555 collected (1425)



PokerStars Hand #222104084549: Tournament #3082583698, $0.98+$0.12 USD Hold'em No Limit - Level XII (200/400) - 2021/01/01 22:10:19 EET [2021/01/01 15:10:19 ET]
Table '3082583698 30' 9-max Seat #4 is the button
Seat 1: Zwuggl56 (1424 in chips) 
Seat 2: xxMich@ilxx (29364 in chips) 
Seat 3: maajussi1 (5111 in chips) 
Seat 4: jcarlos.vale (16194 in chips) 
Seat 5: RCABelVedeRVerd (13567 in chips) 
Seat 6: Mimishka004 (22208 in chips) 
Seat 7: richard5189 (3887 in chips) 
Seat 8: Serghio2902 (8127 in chips) 
Seat 9: Vitrex555 (9568 in chips) 
Zwuggl56: posts the ante 25
xxMich@ilxx: posts the ante 25
maajussi1: posts the ante 25
jcarlos.vale: posts the ante 25
RCABelVedeRVerd: posts the ante 25
Mimishka004: posts the ante 25
richard5189: posts the ante 25
Serghio2902: posts the ante 25
Vitrex555: posts the ante 25
RCABelVedeRVerd: posts small blind 200
Mimishka004: posts big blind 400
*** HOLE CARDS ***
Dealt to jcarlos.vale [Th 4d]
richard5189: folds 
Serghio2902: folds 
Vitrex555: calls 400
Zwuggl56: folds 
xxMich@ilxx: calls 400
maajussi1: calls 400
jcarlos.vale: folds 
RCABelVedeRVerd: calls 200
Mimishka004: checks 
*** FLOP *** [2h Kd 6h]
RCABelVedeRVerd: checks 
Mimishka004: checks 
Vitrex555: checks 
xxMich@ilxx: checks 
maajussi1: bets 1200
RCABelVedeRVerd: folds 
Mimishka004: folds 
Vitrex555: folds 
xxMich@ilxx: folds 
Uncalled bet (1200) returned to maajussi1
maajussi1 collected 2225 from pot
maajussi1: doesn't show hand 
*** SUMMARY ***
Total pot 2225 | Rake 0 
Board [2h Kd 6h]
Seat 1: Zwuggl56 folded before Flop (didn't bet)
Seat 2: xxMich@ilxx folded on the Flop
Seat 3: maajussi1 collected (2225)
Seat 4: jcarlos.vale (button) folded before Flop (didn't bet)
Seat 5: RCABelVedeRVerd (small blind) folded on the Flop
Seat 6: Mimishka004 (big blind) folded on the Flop
Seat 7: richard5189 folded before Flop (didn't bet)
Seat 8: Serghio2902 folded before Flop (didn't bet)
Seat 9: Vitrex555 folded on the Flop



PokerStars Hand #222104162106: Tournament #3082583698, $0.98+$0.12 USD Hold'em No Limit - Level XII (200/400) - 2021/01/01 22:11:34 EET [2021/01/01 15:11:34 ET]
Table '3082583698 30' 9-max Seat #5 is the button
Seat 1: Zwuggl56 (1399 in chips) 
Seat 2: xxMich@ilxx (28939 in chips) 
Seat 3: maajussi1 (6911 in chips) 
Seat 4: jcarlos.vale (16169 in chips) 
Seat 5: RCABelVedeRVerd (13142 in chips) 
Seat 6: Mimishka004 (21783 in chips) 
Seat 7: richard5189 (3862 in chips) 
Seat 8: Serghio2902 (8102 in chips) 
Seat 9: Vitrex555 (9143 in chips) 
Zwuggl56: posts the ante 25
xxMich@ilxx: posts the ante 25
maajussi1: posts the ante 25
jcarlos.vale: posts the ante 25
RCABelVedeRVerd: posts the ante 25
Mimishka004: posts the ante 25
richard5189: posts the ante 25
Serghio2902: posts the ante 25
Vitrex555: posts the ante 25
Mimishka004: posts small blind 200
richard5189: posts big blind 400
*** HOLE CARDS ***
Dealt to jcarlos.vale [Kc Td]
Serghio2902: folds 
Vitrex555: raises 400 to 800
Zwuggl56: folds 
xxMich@ilxx: folds 
maajussi1: calls 800
jcarlos.vale: folds 
RCABelVedeRVerd: folds 
Mimishka004: raises 20958 to 21758 and is all-in
richard5189: folds 
Vitrex555: folds 
maajussi1: calls 6086 and is all-in
Uncalled bet (14872) returned to Mimishka004
*** FLOP *** [Ks 6h Js]
*** TURN *** [Ks 6h Js] [8d]
*** RIVER *** [Ks 6h Js 8d] [Th]
*** SHOW DOWN ***
Mimishka004: shows [9s 9h] (a pair of Nines)
maajussi1: shows [Kh Qd] (a pair of Kings)
maajussi1 collected 15197 from pot
*** SUMMARY ***
Total pot 15197 | Rake 0 
Board [Ks 6h Js 8d Th]
Seat 1: Zwuggl56 folded before Flop (didn't bet)
Seat 2: xxMich@ilxx folded before Flop (didn't bet)
Seat 3: maajussi1 showed [Kh Qd] and won (15197) with a pair of Kings
Seat 4: jcarlos.vale folded before Flop (didn't bet)
Seat 5: RCABelVedeRVerd (button) folded before Flop (didn't bet)
Seat 6: Mimishka004 (small blind) showed [9s 9h] and lost with a pair of Nines
Seat 7: richard5189 (big blind) folded before Flop
Seat 8: Serghio2902 folded before Flop (didn't bet)
Seat 9: Vitrex555 folded before Flop



PokerStars Hand #222104212081: Tournament #3082583698, $0.98+$0.12 USD Hold'em No Limit - Level XII (200/400) - 2021/01/01 22:12:24 EET [2021/01/01 15:12:24 ET]
Table '3082583698 30' 9-max Seat #6 is the button
Seat 1: Zwuggl56 (1374 in chips) 
Seat 2: xxMich@ilxx (28914 in chips) 
Seat 3: maajussi1 (15197 in chips) 
Seat 4: jcarlos.vale (16144 in chips) 
Seat 5: RCABelVedeRVerd (13117 in chips) 
Seat 6: Mimishka004 (14872 in chips) 
Seat 7: richard5189 (3437 in chips) 
Seat 8: Serghio2902 (8077 in chips) 
Seat 9: Vitrex555 (8318 in chips) 
Zwuggl56: posts the ante 25
xxMich@ilxx: posts the ante 25
maajussi1: posts the ante 25
jcarlos.vale: posts the ante 25
RCABelVedeRVerd: posts the ante 25
Mimishka004: posts the ante 25
richard5189: posts the ante 25
Serghio2902: posts the ante 25
Vitrex555: posts the ante 25
richard5189: posts small blind 200
Serghio2902: posts big blind 400
*** HOLE CARDS ***
Dealt to jcarlos.vale [Kd Ts]
Vitrex555: calls 400
Zwuggl56: folds 
xxMich@ilxx: folds 
maajussi1: folds 
jcarlos.vale: raises 640 to 1040
RCABelVedeRVerd: raises 12052 to 13092 and is all-in
Mimishka004: folds 
richard5189: folds 
Serghio2902: folds 
Vitrex555: folds 
jcarlos.vale: folds 
Uncalled bet (12052) returned to RCABelVedeRVerd
RCABelVedeRVerd collected 3305 from pot
*** SUMMARY ***
Total pot 3305 | Rake 0 
Seat 1: Zwuggl56 folded before Flop (didn't bet)
Seat 2: xxMich@ilxx folded before Flop (didn't bet)
Seat 3: maajussi1 folded before Flop (didn't bet)
Seat 4: jcarlos.vale folded before Flop
Seat 5: RCABelVedeRVerd collected (3305)
Seat 6: Mimishka004 (button) folded before Flop (didn't bet)
Seat 7: richard5189 (small blind) folded before Flop
Seat 8: Serghio2902 (big blind) folded before Flop
Seat 9: Vitrex555 folded before Flop



PokerStars Hand #222104236157: Tournament #3082583698, $0.98+$0.12 USD Hold'em No Limit - Level XII (200/400) - 2021/01/01 22:12:47 EET [2021/01/01 15:12:47 ET]
Table '3082583698 30' 9-max Seat #7 is the button
Seat 1: Zwuggl56 (1349 in chips) 
Seat 2: xxMich@ilxx (28889 in chips) 
Seat 3: maajussi1 (15172 in chips) 
Seat 4: jcarlos.vale (15079 in chips) 
Seat 5: RCABelVedeRVerd (15357 in chips) 
Seat 6: Mimishka004 (14847 in chips) 
Seat 7: richard5189 (3212 in chips) 
Seat 8: Serghio2902 (7652 in chips) 
Seat 9: Vitrex555 (7893 in chips) 
Zwuggl56: posts the ante 25
xxMich@ilxx: posts the ante 25
maajussi1: posts the ante 25
jcarlos.vale: posts the ante 25
RCABelVedeRVerd: posts the ante 25
Mimishka004: posts the ante 25
richard5189: posts the ante 25
Serghio2902: posts the ante 25
Vitrex555: posts the ante 25
Serghio2902: posts small blind 200
Vitrex555: posts big blind 400
*** HOLE CARDS ***
Dealt to jcarlos.vale [Ks 4h]
Zwuggl56: folds 
xxMich@ilxx: folds 
maajussi1: folds 
jcarlos.vale: folds 
RCABelVedeRVerd: folds 
Mimishka004: folds 
richard5189: calls 400
Serghio2902: calls 200
Vitrex555: checks 
*** FLOP *** [Qs 3d Kc]
Serghio2902: checks 
Vitrex555: checks 
richard5189: checks 
*** TURN *** [Qs 3d Kc] [Th]
Serghio2902: checks 
Vitrex555: checks 
richard5189: checks 
*** RIVER *** [Qs 3d Kc Th] [Tc]
Serghio2902: bets 800
Vitrex555: folds 
richard5189: calls 800
*** SHOW DOWN ***
Serghio2902: shows [Jc Ts] (three of a kind, Tens)
richard5189: mucks hand 
Serghio2902 collected 3025 from pot
*** SUMMARY ***
Total pot 3025 | Rake 0 
Board [Qs 3d Kc Th Tc]
Seat 1: Zwuggl56 folded before Flop (didn't bet)
Seat 2: xxMich@ilxx folded before Flop (didn't bet)
Seat 3: maajussi1 folded before Flop (didn't bet)
Seat 4: jcarlos.vale folded before Flop (didn't bet)
Seat 5: RCABelVedeRVerd folded before Flop (didn't bet)
Seat 6: Mimishka004 folded before Flop (didn't bet)
Seat 7: richard5189 (button) mucked [9s As]
Seat 8: Serghio2902 (small blind) showed [Jc Ts] and won (3025) with three of a kind, Tens
Seat 9: Vitrex555 (big blind) folded on the River



PokerStars Hand #222104279869: Tournament #3082583698, $0.98+$0.12 USD Hold'em No Limit - Level XII (200/400) - 2021/01/01 22:13:29 EET [2021/01/01 15:13:29 ET]
Table '3082583698 30' 9-max Seat #8 is the button
Seat 1: Zwuggl56 (1324 in chips) 
Seat 2: xxMich@ilxx (28864 in chips) 
Seat 3: maajussi1 (15147 in chips) 
Seat 4: jcarlos.vale (15054 in chips) 
Seat 5: RCABelVedeRVerd (15332 in chips) 
Seat 6: Mimishka004 (14822 in chips) 
Seat 7: richard5189 (1987 in chips) 
Seat 8: Serghio2902 (9452 in chips) 
Seat 9: Vitrex555 (7468 in chips) 
Zwuggl56: posts the ante 25
xxMich@ilxx: posts the ante 25
maajussi1: posts the ante 25
jcarlos.vale: posts the ante 25
RCABelVedeRVerd: posts the ante 25
Mimishka004: posts the ante 25
richard5189: posts the ante 25
Serghio2902: posts the ante 25
Vitrex555: posts the ante 25
Vitrex555: posts small blind 200
Zwuggl56: posts big blind 400
*** HOLE CARDS ***
Dealt to jcarlos.vale [7h Ts]
xxMich@ilxx: folds 
maajussi1: folds 
jcarlos.vale: folds 
RCABelVedeRVerd: folds 
Mimishka004: folds 
richard5189: folds 
Serghio2902: folds 
Vitrex555: folds 
Uncalled bet (200) returned to Zwuggl56
Zwuggl56 collected 625 from pot
Zwuggl56: doesn't show hand 
*** SUMMARY ***
Total pot 625 | Rake 0 
Seat 1: Zwuggl56 (big blind) collected (625)
Seat 2: xxMich@ilxx folded before Flop (didn't bet)
Seat 3: maajussi1 folded before Flop (didn't bet)
Seat 4: jcarlos.vale folded before Flop (didn't bet)
Seat 5: RCABelVedeRVerd folded before Flop (didn't bet)
Seat 6: Mimishka004 folded before Flop (didn't bet)
Seat 7: richard5189 folded before Flop (didn't bet)
Seat 8: Serghio2902 (button) folded before Flop (didn't bet)
Seat 9: Vitrex555 (small blind) folded before Flop



PokerStars Hand #222104293626: Tournament #3082583698, $0.98+$0.12 USD Hold'em No Limit - Level XII (200/400) - 2021/01/01 22:13:42 EET [2021/01/01 15:13:42 ET]
Table '3082583698 30' 9-max Seat #9 is the button
Seat 1: Zwuggl56 (1724 in chips) 
Seat 2: xxMich@ilxx (28839 in chips) 
Seat 3: maajussi1 (15122 in chips) 
Seat 4: jcarlos.vale (15029 in chips) 
Seat 5: RCABelVedeRVerd (15307 in chips) 
Seat 6: Mimishka004 (14797 in chips) 
Seat 7: richard5189 (1962 in chips) 
Seat 8: Serghio2902 (9427 in chips) 
Seat 9: Vitrex555 (7243 in chips) 
Zwuggl56: posts the ante 25
xxMich@ilxx: posts the ante 25
maajussi1: posts the ante 25
jcarlos.vale: posts the ante 25
RCABelVedeRVerd: posts the ante 25
Mimishka004: posts the ante 25
richard5189: posts the ante 25
Serghio2902: posts the ante 25
Vitrex555: posts the ante 25
Zwuggl56: posts small blind 200
xxMich@ilxx: posts big blind 400
*** HOLE CARDS ***
Dealt to jcarlos.vale [Kc 5d]
maajussi1: folds 
jcarlos.vale: folds 
RCABelVedeRVerd has timed out
RCABelVedeRVerd: folds 
RCABelVedeRVerd is sitting out
Mimishka004: folds 
richard5189: calls 400
Serghio2902: folds 
Vitrex555: folds 
Zwuggl56: calls 200
xxMich@ilxx: checks 
*** FLOP *** [6c 2h 5s]
Zwuggl56: checks 
RCABelVedeRVerd is disconnected 
xxMich@ilxx: bets 400
richard5189: folds 
Zwuggl56: folds 
Uncalled bet (400) returned to xxMich@ilxx
xxMich@ilxx collected 1425 from pot
*** SUMMARY ***
Total pot 1425 | Rake 0 
Board [6c 2h 5s]
Seat 1: Zwuggl56 (small blind) folded on the Flop
Seat 2: xxMich@ilxx (big blind) collected (1425)
Seat 3: maajussi1 folded before Flop (didn't bet)
Seat 4: jcarlos.vale folded before Flop (didn't bet)
Seat 5: RCABelVedeRVerd folded before Flop (didn't bet)
Seat 6: Mimishka004 folded before Flop (didn't bet)
Seat 7: richard5189 folded on the Flop
Seat 8: Serghio2902 folded before Flop (didn't bet)
Seat 9: Vitrex555 (button) folded before Flop (didn't bet)



PokerStars Hand #222104350721: Tournament #3082583698, $0.98+$0.12 USD Hold'em No Limit - Level XIII (250/500) - 2021/01/01 22:14:37 EET [2021/01/01 15:14:37 ET]
Table '3082583698 30' 9-max Seat #1 is the button
Seat 1: Zwuggl56 (1299 in chips) 
Seat 2: xxMich@ilxx (29839 in chips) 
Seat 3: maajussi1 (15097 in chips) 
Seat 4: jcarlos.vale (15004 in chips) 
Seat 5: RCABelVedeRVerd (15282 in chips) is sitting out
Seat 6: Mimishka004 (14772 in chips) 
Seat 7: richard5189 (1537 in chips) 
Seat 8: Serghio2902 (9402 in chips) 
Seat 9: Vitrex555 (7218 in chips) 
Zwuggl56: posts the ante 30
xxMich@ilxx: posts the ante 30
maajussi1: posts the ante 30
jcarlos.vale: posts the ante 30
RCABelVedeRVerd: posts the ante 30
Mimishka004: posts the ante 30
richard5189: posts the ante 30
Serghio2902: posts the ante 30
Vitrex555: posts the ante 30
xxMich@ilxx: posts small blind 250
maajussi1: posts big blind 500
*** HOLE CARDS ***
Dealt to jcarlos.vale [2s Td]
jcarlos.vale: folds 
RCABelVedeRVerd: folds 
Mimishka004: folds 
richard5189: folds 
Serghio2902: folds 
Vitrex555: calls 500
RCABelVedeRVerd has returned
Zwuggl56: folds 
xxMich@ilxx: calls 250
maajussi1: checks 
*** FLOP *** [5d Kh 3c]
xxMich@ilxx: checks 
maajussi1: checks 
Vitrex555: checks 
*** TURN *** [5d Kh 3c] [6s]
xxMich@ilxx: bets 1000
maajussi1: folds 
Vitrex555: folds 
Uncalled bet (1000) returned to xxMich@ilxx
xxMich@ilxx collected 1770 from pot
*** SUMMARY ***
Total pot 1770 | Rake 0 
Board [5d Kh 3c 6s]
Seat 1: Zwuggl56 (button) folded before Flop (didn't bet)
Seat 2: xxMich@ilxx (small blind) collected (1770)
Seat 3: maajussi1 (big blind) folded on the Turn
Seat 4: jcarlos.vale folded before Flop (didn't bet)
Seat 5: RCABelVedeRVerd folded before Flop (didn't bet)
Seat 6: Mimishka004 folded before Flop (didn't bet)
Seat 7: richard5189 folded before Flop (didn't bet)
Seat 8: Serghio2902 folded before Flop (didn't bet)
Seat 9: Vitrex555 folded on the Turn



PokerStars Hand #222104398652: Tournament #3082583698, $0.98+$0.12 USD Hold'em No Limit - Level XIII (250/500) - 2021/01/01 22:15:23 EET [2021/01/01 15:15:23 ET]
Table '3082583698 30' 9-max Seat #2 is the button
Seat 1: Zwuggl56 (1269 in chips) 
Seat 2: xxMich@ilxx (31079 in chips) 
Seat 3: maajussi1 (14567 in chips) 
Seat 4: jcarlos.vale (14974 in chips) 
Seat 5: RCABelVedeRVerd (15252 in chips) 
Seat 6: Mimishka004 (14742 in chips) 
Seat 7: richard5189 (1507 in chips) 
Seat 8: Serghio2902 (9372 in chips) 
Seat 9: Vitrex555 (6688 in chips) 
Zwuggl56: posts the ante 30
xxMich@ilxx: posts the ante 30
maajussi1: posts the ante 30
jcarlos.vale: posts the ante 30
RCABelVedeRVerd: posts the ante 30
Mimishka004: posts the ante 30
richard5189: posts the ante 30
Serghio2902: posts the ante 30
Vitrex555: posts the ante 30
maajussi1: posts small blind 250
jcarlos.vale: posts big blind 500
*** HOLE CARDS ***
Dealt to jcarlos.vale [4d 5s]
RCABelVedeRVerd: folds 
Mimishka004: folds 
richard5189: calls 500
Serghio2902: folds 
Vitrex555: calls 500
Zwuggl56: folds 
xxMich@ilxx: folds 
maajussi1: calls 250
jcarlos.vale: checks 
*** FLOP *** [5h 8h 4c]
maajussi1: checks 
jcarlos.vale: checks 
richard5189: checks 
Vitrex555: bets 500
maajussi1: folds 
jcarlos.vale: raises 1500 to 2000
richard5189: folds 
Vitrex555: calls 1500
*** TURN *** [5h 8h 4c] [2c]
jcarlos.vale: bets 3135
Vitrex555: raises 1023 to 4158 and is all-in
jcarlos.vale: calls 1023
*** RIVER *** [5h 8h 4c 2c] [Td]
*** SHOW DOWN ***
jcarlos.vale: shows [4d 5s] (two pair, Fives and Fours)
Vitrex555: shows [5d 6d] (a pair of Fives)
jcarlos.vale collected 14586 from pot
Vitrex555 finished the tournament in 1025th place
*** SUMMARY ***
Total pot 14586 | Rake 0 
Board [5h 8h 4c 2c Td]
Seat 1: Zwuggl56 folded before Flop (didn't bet)
Seat 2: xxMich@ilxx (button) folded before Flop (didn't bet)
Seat 3: maajussi1 (small blind) folded on the Flop
Seat 4: jcarlos.vale (big blind) showed [4d 5s] and won (14586) with two pair, Fives and Fours
Seat 5: RCABelVedeRVerd folded before Flop (didn't bet)
Seat 6: Mimishka004 folded before Flop (didn't bet)
Seat 7: richard5189 folded on the Flop
Seat 8: Serghio2902 folded before Flop (didn't bet)
Seat 9: Vitrex555 showed [5d 6d] and lost with a pair of Fives



PokerStars Hand #222104460291: Tournament #3082583698, $0.98+$0.12 USD Hold'em No Limit - Level XIII (250/500) - 2021/01/01 22:16:22 EET [2021/01/01 15:16:22 ET]
Table '3082583698 30' 9-max Seat #3 is the button
Seat 1: Zwuggl56 (1239 in chips) 
Seat 2: xxMich@ilxx (31049 in chips) 
Seat 3: maajussi1 (14037 in chips) 
Seat 4: jcarlos.vale (22872 in chips) 
Seat 5: RCABelVedeRVerd (15222 in chips) 
Seat 6: Mimishka004 (14712 in chips) 
Seat 7: richard5189 (977 in chips) 
Seat 8: Serghio2902 (9342 in chips) 
Zwuggl56: posts the ante 30
xxMich@ilxx: posts the ante 30
maajussi1: posts the ante 30
jcarlos.vale: posts the ante 30
RCABelVedeRVerd: posts the ante 30
Mimishka004: posts the ante 30
richard5189: posts the ante 30
Serghio2902: posts the ante 30
jcarlos.vale: posts small blind 250
RCABelVedeRVerd: posts big blind 500
*** HOLE CARDS ***
Dealt to jcarlos.vale [2h 2s]
Mimishka004: folds 
richard5189: raises 447 to 947 and is all-in
Serghio2902: folds 
RCABelVedeRVerd is disconnected 
Zwuggl56: folds 
xxMich@ilxx: folds 
maajussi1: folds 
jcarlos.vale: calls 697
RCABelVedeRVerd: calls 447
*** FLOP *** [Kc 8h 3s]
jcarlos.vale: checks 
RCABelVedeRVerd: checks 
*** TURN *** [Kc 8h 3s] [Qh]
jcarlos.vale: checks 
RCABelVedeRVerd: checks 
*** RIVER *** [Kc 8h 3s Qh] [2d]
jcarlos.vale: bets 1500
RCABelVedeRVerd: folds 
Uncalled bet (1500) returned to jcarlos.vale
*** SHOW DOWN ***
jcarlos.vale: shows [2h 2s] (three of a kind, Deuces)
richard5189: shows [Th Jc] (high card King)
jcarlos.vale collected 3081 from pot
richard5189 finished the tournament in 1011th place
*** SUMMARY ***
Total pot 3081 | Rake 0 
Board [Kc 8h 3s Qh 2d]
Seat 1: Zwuggl56 folded before Flop (didn't bet)
Seat 2: xxMich@ilxx folded before Flop (didn't bet)
Seat 3: maajussi1 (button) folded before Flop (didn't bet)
Seat 4: jcarlos.vale (small blind) showed [2h 2s] and won (3081) with three of a kind, Deuces
Seat 5: RCABelVedeRVerd (big blind) folded on the River
Seat 6: Mimishka004 folded before Flop (didn't bet)
Seat 7: richard5189 showed [Th Jc] and lost with high card King
Seat 8: Serghio2902 folded before Flop (didn't bet)



PokerStars Hand #222104511149: Tournament #3082583698, $0.98+$0.12 USD Hold'em No Limit - Level XIII (250/500) - 2021/01/01 22:17:12 EET [2021/01/01 15:17:12 ET]
Table '3082583698 30' 9-max Seat #4 is the button
Seat 1: Zwuggl56 (1209 in chips) 
Seat 2: xxMich@ilxx (31019 in chips) 
Seat 3: maajussi1 (14007 in chips) 
Seat 4: jcarlos.vale (24976 in chips) 
Seat 5: RCABelVedeRVerd (14245 in chips) 
Seat 6: Mimishka004 (14682 in chips) 
Seat 7: RtoG (10903 in chips) 
Seat 8: Serghio2902 (9312 in chips) 
Seat 9: samax15 (7078 in chips) 
Zwuggl56: posts the ante 30
xxMich@ilxx: posts the ante 30
maajussi1: posts the ante 30
jcarlos.vale: posts the ante 30
RCABelVedeRVerd: posts the ante 30
Mimishka004: posts the ante 30
RtoG: posts the ante 30
Serghio2902: posts the ante 30
samax15: posts the ante 30
RCABelVedeRVerd: posts small blind 250
Mimishka004: posts big blind 500
*** HOLE CARDS ***
Dealt to jcarlos.vale [Qc 8d]
RtoG: folds 
Serghio2902: folds 
samax15: folds 
Zwuggl56: folds 
xxMich@ilxx: folds 
maajussi1: folds 
jcarlos.vale: folds 
RCABelVedeRVerd: raises 13715 to 14215 and is all-in
Mimishka004: folds 
Uncalled bet (13715) returned to RCABelVedeRVerd
RCABelVedeRVerd collected 1270 from pot
RCABelVedeRVerd: shows [Ac Kh] (high card Ace)
*** SUMMARY ***
Total pot 1270 | Rake 0 
Seat 1: Zwuggl56 folded before Flop (didn't bet)
Seat 2: xxMich@ilxx folded before Flop (didn't bet)
Seat 3: maajussi1 folded before Flop (didn't bet)
Seat 4: jcarlos.vale (button) folded before Flop (didn't bet)
Seat 5: RCABelVedeRVerd (small blind) collected (1270)
Seat 6: Mimishka004 (big blind) folded before Flop
Seat 7: RtoG folded before Flop (didn't bet)
Seat 8: Serghio2902 folded before Flop (didn't bet)
Seat 9: samax15 folded before Flop (didn't bet)



PokerStars Hand #222104537179: Tournament #3082583698, $0.98+$0.12 USD Hold'em No Limit - Level XIII (250/500) - 2021/01/01 22:17:37 EET [2021/01/01 15:17:37 ET]
Table '3082583698 30' 9-max Seat #5 is the button
Seat 1: Zwuggl56 (1179 in chips) 
Seat 2: xxMich@ilxx (30989 in chips) 
Seat 3: maajussi1 (13977 in chips) 
Seat 4: jcarlos.vale (24946 in chips) 
Seat 5: RCABelVedeRVerd (14985 in chips) 
Seat 6: Mimishka004 (14152 in chips) 
Seat 7: RtoG (10873 in chips) 
Seat 8: Serghio2902 (9282 in chips) 
Seat 9: samax15 (7048 in chips) 
Zwuggl56: posts the ante 30
xxMich@ilxx: posts the ante 30
maajussi1: posts the ante 30
jcarlos.vale: posts the ante 30
RCABelVedeRVerd: posts the ante 30
Mimishka004: posts the ante 30
RtoG: posts the ante 30
Serghio2902: posts the ante 30
samax15: posts the ante 30
Mimishka004: posts small blind 250
RtoG: posts big blind 500
*** HOLE CARDS ***
Dealt to jcarlos.vale [5d 9d]
Serghio2902: folds 
samax15: folds 
Zwuggl56: folds 
xxMich@ilxx: folds 
maajussi1: folds 
jcarlos.vale: folds 
RCABelVedeRVerd: folds 
Mimishka004: calls 250
RtoG: checks 
*** FLOP *** [6s Jc 8c]
Mimishka004: bets 813
RtoG: calls 813
*** TURN *** [6s Jc 8c] [3s]
Mimishka004: bets 2346
RtoG: raises 2346 to 4692
Mimishka004: folds 
Uncalled bet (2346) returned to RtoG
RtoG collected 7588 from pot
RtoG: doesn't show hand 
*** SUMMARY ***
Total pot 7588 | Rake 0 
Board [6s Jc 8c 3s]
Seat 1: Zwuggl56 folded before Flop (didn't bet)
Seat 2: xxMich@ilxx folded before Flop (didn't bet)
Seat 3: maajussi1 folded before Flop (didn't bet)
Seat 4: jcarlos.vale folded before Flop (didn't bet)
Seat 5: RCABelVedeRVerd (button) folded before Flop (didn't bet)
Seat 6: Mimishka004 (small blind) folded on the Turn
Seat 7: RtoG (big blind) collected (7588)
Seat 8: Serghio2902 folded before Flop (didn't bet)
Seat 9: samax15 folded before Flop (didn't bet)



PokerStars Hand #222104602986: Tournament #3082583698, $0.98+$0.12 USD Hold'em No Limit - Level XIII (250/500) - 2021/01/01 22:18:41 EET [2021/01/01 15:18:41 ET]
Table '3082583698 30' 9-max Seat #6 is the button
Seat 1: Zwuggl56 (1149 in chips) 
Seat 2: xxMich@ilxx (30959 in chips) 
Seat 3: maajussi1 (13947 in chips) 
Seat 4: jcarlos.vale (24916 in chips) 
Seat 5: RCABelVedeRVerd (14955 in chips) 
Seat 6: Mimishka004 (10463 in chips) 
Seat 7: RtoG (14772 in chips) 
Seat 8: Serghio2902 (9252 in chips) 
Seat 9: samax15 (7018 in chips) 
Zwuggl56: posts the ante 30
xxMich@ilxx: posts the ante 30
maajussi1: posts the ante 30
jcarlos.vale: posts the ante 30
RCABelVedeRVerd: posts the ante 30
Mimishka004: posts the ante 30
RtoG: posts the ante 30
Serghio2902: posts the ante 30
samax15: posts the ante 30
RtoG: posts small blind 250
Serghio2902: posts big blind 500
*** HOLE CARDS ***
Dealt to jcarlos.vale [8d Qc]
samax15: folds 
Zwuggl56: raises 619 to 1119 and is all-in
xxMich@ilxx: calls 1119
maajussi1: folds 
jcarlos.vale: folds 
RCABelVedeRVerd: folds 
Mimishka004: folds 
RtoG: calls 869
Serghio2902: folds 
*** FLOP *** [Jd 5c Ah]
RtoG: checks 
xxMich@ilxx: bets 1000
RtoG: calls 1000
*** TURN *** [Jd 5c Ah] [Kc]
RtoG: checks 
xxMich@ilxx: bets 2000
RtoG: folds 
Uncalled bet (2000) returned to xxMich@ilxx
*** RIVER *** [Jd 5c Ah Kc] [Jh]
*** SHOW DOWN ***
xxMich@ilxx: shows [Kh Kd] (a full house, Kings full of Jacks)
xxMich@ilxx collected 2000 from side pot
Zwuggl56: shows [9s Ac] (two pair, Aces and Jacks)
xxMich@ilxx collected 4127 from main pot
Zwuggl56 finished the tournament in 956th place
*** SUMMARY ***
Total pot 6127 Main pot 4127. Side pot 2000. | Rake 0 
Board [Jd 5c Ah Kc Jh]
Seat 1: Zwuggl56 showed [9s Ac] and lost with two pair, Aces and Jacks
Seat 2: xxMich@ilxx showed [Kh Kd] and won (6127) with a full house, Kings full of Jacks
Seat 3: maajussi1 folded before Flop (didn't bet)
Seat 4: jcarlos.vale folded before Flop (didn't bet)
Seat 5: RCABelVedeRVerd folded before Flop (didn't bet)
Seat 6: Mimishka004 (button) folded before Flop (didn't bet)
Seat 7: RtoG (small blind) folded on the Turn
Seat 8: Serghio2902 (big blind) folded before Flop
Seat 9: samax15 folded before Flop (didn't bet)



PokerStars Hand #222104660565: Tournament #3082583698, $0.98+$0.12 USD Hold'em No Limit - Level XIII (250/500) - 2021/01/01 22:19:31 EET [2021/01/01 15:19:31 ET]
Table '3082583698 30' 9-max Seat #7 is the button
Seat 2: xxMich@ilxx (34937 in chips) 
Seat 3: maajussi1 (13917 in chips) 
Seat 4: jcarlos.vale (24886 in chips) 
Seat 5: RCABelVedeRVerd (14925 in chips) 
Seat 6: Mimishka004 (10433 in chips) 
Seat 7: RtoG (12623 in chips) 
Seat 8: Serghio2902 (8722 in chips) 
Seat 9: samax15 (6988 in chips) 
xxMich@ilxx: posts the ante 30
maajussi1: posts the ante 30
jcarlos.vale: posts the ante 30
RCABelVedeRVerd: posts the ante 30
Mimishka004: posts the ante 30
RtoG: posts the ante 30
Serghio2902: posts the ante 30
samax15: posts the ante 30
Serghio2902: posts small blind 250
samax15: posts big blind 500
*** HOLE CARDS ***
Dealt to jcarlos.vale [6h Kh]
xxMich@ilxx: folds 
maajussi1: calls 500
jcarlos.vale: folds 
RCABelVedeRVerd: folds 
Mimishka004: calls 500
RtoG: calls 500
Serghio2902: folds 
samax15: checks 
*** FLOP *** [8h Qh 7c]
samax15: checks 
maajussi1: checks 
Mimishka004: bets 1000
RtoG: folds 
samax15: folds 
maajussi1: folds 
Uncalled bet (1000) returned to Mimishka004
Mimishka004 collected 2490 from pot
*** SUMMARY ***
Total pot 2490 | Rake 0 
Board [8h Qh 7c]
Seat 2: xxMich@ilxx folded before Flop (didn't bet)
Seat 3: maajussi1 folded on the Flop
Seat 4: jcarlos.vale folded before Flop (didn't bet)
Seat 5: RCABelVedeRVerd folded before Flop (didn't bet)
Seat 6: Mimishka004 collected (2490)
Seat 7: RtoG (button) folded on the Flop
Seat 8: Serghio2902 (small blind) folded before Flop
Seat 9: samax15 (big blind) folded on the Flop



PokerStars Hand #222104713159: Tournament #3082583698, $0.98+$0.12 USD Hold'em No Limit - Level XIII (250/500) - 2021/01/01 22:20:23 EET [2021/01/01 15:20:23 ET]
Table '3082583698 30' 9-max Seat #8 is the button
Seat 1: sergucci82 (12589 in chips) 
Seat 2: xxMich@ilxx (34907 in chips) 
Seat 3: maajussi1 (13387 in chips) 
Seat 4: jcarlos.vale (24856 in chips) 
Seat 5: RCABelVedeRVerd (14895 in chips) 
Seat 6: Mimishka004 (12393 in chips) 
Seat 7: RtoG (12093 in chips) 
Seat 8: Serghio2902 (8442 in chips) 
Seat 9: samax15 (6458 in chips) 
sergucci82: posts the ante 30
xxMich@ilxx: posts the ante 30
maajussi1: posts the ante 30
jcarlos.vale: posts the ante 30
RCABelVedeRVerd: posts the ante 30
Mimishka004: posts the ante 30
RtoG: posts the ante 30
Serghio2902: posts the ante 30
samax15: posts the ante 30
samax15: posts small blind 250
sergucci82: posts big blind 500
*** HOLE CARDS ***
Dealt to jcarlos.vale [6d Qc]
xxMich@ilxx: raises 500 to 1000
maajussi1: folds 
jcarlos.vale: folds 
RCABelVedeRVerd: folds 
Mimishka004: folds 
RtoG: raises 1500 to 2500
Serghio2902: folds 
samax15: folds 
sergucci82: folds 
xxMich@ilxx: calls 1500
*** FLOP *** [5d 4s Ts]
xxMich@ilxx: checks 
RtoG: bets 9563 and is all-in
xxMich@ilxx: folds 
Uncalled bet (9563) returned to RtoG
RtoG collected 6020 from pot
RtoG: doesn't show hand 
*** SUMMARY ***
Total pot 6020 | Rake 0 
Board [5d 4s Ts]
Seat 1: sergucci82 (big blind) folded before Flop
Seat 2: xxMich@ilxx folded on the Flop
Seat 3: maajussi1 folded before Flop (didn't bet)
Seat 4: jcarlos.vale folded before Flop (didn't bet)
Seat 5: RCABelVedeRVerd folded before Flop (didn't bet)
Seat 6: Mimishka004 folded before Flop (didn't bet)
Seat 7: RtoG collected (6020)
Seat 8: Serghio2902 (button) folded before Flop (didn't bet)
Seat 9: samax15 (small blind) folded before Flop



PokerStars Hand #222104751294: Tournament #3082583698, $0.98+$0.12 USD Hold'em No Limit - Level XIII (250/500) - 2021/01/01 22:21:00 EET [2021/01/01 15:21:00 ET]
Table '3082583698 30' 9-max Seat #9 is the button
Seat 1: sergucci82 (12059 in chips) 
Seat 2: xxMich@ilxx (32377 in chips) 
Seat 3: maajussi1 (13357 in chips) 
Seat 4: jcarlos.vale (24826 in chips) 
Seat 5: RCABelVedeRVerd (14865 in chips) 
Seat 6: Mimishka004 (12363 in chips) 
Seat 7: RtoG (15583 in chips) 
Seat 8: Serghio2902 (8412 in chips) 
Seat 9: samax15 (6178 in chips) 
sergucci82: posts the ante 30
xxMich@ilxx: posts the ante 30
maajussi1: posts the ante 30
jcarlos.vale: posts the ante 30
RCABelVedeRVerd: posts the ante 30
Mimishka004: posts the ante 30
RtoG: posts the ante 30
Serghio2902: posts the ante 30
samax15: posts the ante 30
sergucci82: posts small blind 250
xxMich@ilxx: posts big blind 500
*** HOLE CARDS ***
Dealt to jcarlos.vale [Ah 4c]
maajussi1: raises 500 to 1000
jcarlos.vale: folds 
RCABelVedeRVerd: folds 
Mimishka004: folds 
RtoG: folds 
Serghio2902: calls 1000
samax15: folds 
sergucci82: folds 
xxMich@ilxx: calls 500
*** FLOP *** [Qs 3s 2c]
xxMich@ilxx: checks 
maajussi1: bets 3500
Serghio2902: folds 
xxMich@ilxx: folds 
Uncalled bet (3500) returned to maajussi1
maajussi1 collected 3520 from pot
maajussi1: doesn't show hand 
*** SUMMARY ***
Total pot 3520 | Rake 0 
Board [Qs 3s 2c]
Seat 1: sergucci82 (small blind) folded before Flop
Seat 2: xxMich@ilxx (big blind) folded on the Flop
Seat 3: maajussi1 collected (3520)
Seat 4: jcarlos.vale folded before Flop (didn't bet)
Seat 5: RCABelVedeRVerd folded before Flop (didn't bet)
Seat 6: Mimishka004 folded before Flop (didn't bet)
Seat 7: RtoG folded before Flop (didn't bet)
Seat 8: Serghio2902 folded on the Flop
Seat 9: samax15 (button) folded before Flop (didn't bet)



PokerStars Hand #222104798065: Tournament #3082583698, $0.98+$0.12 USD Hold'em No Limit - Level XIII (250/500) - 2021/01/01 22:21:46 EET [2021/01/01 15:21:46 ET]
Table '3082583698 30' 9-max Seat #1 is the button
Seat 1: sergucci82 (11779 in chips) 
Seat 2: xxMich@ilxx (31347 in chips) 
Seat 3: maajussi1 (15847 in chips) 
Seat 4: jcarlos.vale (24796 in chips) 
Seat 5: RCABelVedeRVerd (14835 in chips) 
Seat 6: Mimishka004 (12333 in chips) 
Seat 7: RtoG (15553 in chips) 
Seat 8: Serghio2902 (7382 in chips) 
Seat 9: samax15 (6148 in chips) 
sergucci82: posts the ante 30
xxMich@ilxx: posts the ante 30
maajussi1: posts the ante 30
jcarlos.vale: posts the ante 30
RCABelVedeRVerd: posts the ante 30
Mimishka004: posts the ante 30
RtoG: posts the ante 30
Serghio2902: posts the ante 30
samax15: posts the ante 30
xxMich@ilxx: posts small blind 250
maajussi1: posts big blind 500
*** HOLE CARDS ***
Dealt to jcarlos.vale [4s 2d]
jcarlos.vale: folds 
RCABelVedeRVerd: folds 
Mimishka004: raises 525 to 1025
RtoG: calls 1025
Serghio2902: folds 
samax15: folds 
sergucci82: folds 
xxMich@ilxx: folds 
maajussi1: calls 525
*** FLOP *** [7c 8d Ks]
maajussi1: bets 500
Mimishka004: calls 500
RtoG: calls 500
*** TURN *** [7c 8d Ks] [Ah]
maajussi1: bets 1000
Mimishka004: folds 
RtoG: raises 1500 to 2500
maajussi1: folds 
Uncalled bet (1500) returned to RtoG
RtoG collected 7095 from pot
RtoG: doesn't show hand 
*** SUMMARY ***
Total pot 7095 | Rake 0 
Board [7c 8d Ks Ah]
Seat 1: sergucci82 (button) folded before Flop (didn't bet)
Seat 2: xxMich@ilxx (small blind) folded before Flop
Seat 3: maajussi1 (big blind) folded on the Turn
Seat 4: jcarlos.vale folded before Flop (didn't bet)
Seat 5: RCABelVedeRVerd folded before Flop (didn't bet)
Seat 6: Mimishka004 folded on the Turn
Seat 7: RtoG collected (7095)
Seat 8: Serghio2902 folded before Flop (didn't bet)
Seat 9: samax15 folded before Flop (didn't bet)



PokerStars Hand #222104880294: Tournament #3082583698, $0.98+$0.12 USD Hold'em No Limit - Level XIII (250/500) - 2021/01/01 22:23:08 EET [2021/01/01 15:23:08 ET]
Table '3082583698 30' 9-max Seat #2 is the button
Seat 1: sergucci82 (11749 in chips) 
Seat 2: xxMich@ilxx (31067 in chips) 
Seat 3: maajussi1 (13292 in chips) 
Seat 4: jcarlos.vale (24766 in chips) 
Seat 5: RCABelVedeRVerd (14805 in chips) 
Seat 6: Mimishka004 (10778 in chips) 
Seat 7: RtoG (20093 in chips) 
Seat 8: Serghio2902 (7352 in chips) 
Seat 9: samax15 (6118 in chips) 
sergucci82: posts the ante 30
xxMich@ilxx: posts the ante 30
maajussi1: posts the ante 30
jcarlos.vale: posts the ante 30
RCABelVedeRVerd: posts the ante 30
Mimishka004: posts the ante 30
RtoG: posts the ante 30
Serghio2902: posts the ante 30
samax15: posts the ante 30
maajussi1: posts small blind 250
jcarlos.vale: posts big blind 500
*** HOLE CARDS ***
Dealt to jcarlos.vale [8h 4d]
RCABelVedeRVerd: calls 500
Mimishka004: raises 1000 to 1500
RtoG: folds 
Serghio2902: raises 5822 to 7322 and is all-in
samax15: folds 
sergucci82: folds 
xxMich@ilxx: folds 
maajussi1: folds 
jcarlos.vale: folds 
RCABelVedeRVerd: folds 
Mimishka004: calls 5822
*** FLOP *** [Kc 6h Qs]
*** TURN *** [Kc 6h Qs] [2c]
*** RIVER *** [Kc 6h Qs 2c] [Th]
*** SHOW DOWN ***
Mimishka004: shows [Qd As] (a pair of Queens)
Serghio2902: shows [Ac Kd] (a pair of Kings)
Serghio2902 collected 16164 from pot
*** SUMMARY ***
Total pot 16164 | Rake 0 
Board [Kc 6h Qs 2c Th]
Seat 1: sergucci82 folded before Flop (didn't bet)
Seat 2: xxMich@ilxx (button) folded before Flop (didn't bet)
Seat 3: maajussi1 (small blind) folded before Flop
Seat 4: jcarlos.vale (big blind) folded before Flop
Seat 5: RCABelVedeRVerd folded before Flop
Seat 6: Mimishka004 showed [Qd As] and lost with a pair of Queens
Seat 7: RtoG folded before Flop (didn't bet)
Seat 8: Serghio2902 showed [Ac Kd] and won (16164) with a pair of Kings
Seat 9: samax15 folded before Flop (didn't bet)



PokerStars Hand #222104919115: Tournament #3082583698, $0.98+$0.12 USD Hold'em No Limit - Level XIII (250/500) - 2021/01/01 22:23:47 EET [2021/01/01 15:23:47 ET]
Table '3082583698 30' 9-max Seat #3 is the button
Seat 1: sergucci82 (11719 in chips) 
Seat 2: xxMich@ilxx (31037 in chips) 
Seat 3: maajussi1 (13012 in chips) 
Seat 4: jcarlos.vale (24236 in chips) 
Seat 5: RCABelVedeRVerd (14275 in chips) 
Seat 6: Mimishka004 (3426 in chips) 
Seat 7: RtoG (20063 in chips) 
Seat 8: Serghio2902 (16164 in chips) 
Seat 9: samax15 (6088 in chips) 
sergucci82: posts the ante 30
xxMich@ilxx: posts the ante 30
maajussi1: posts the ante 30
jcarlos.vale: posts the ante 30
RCABelVedeRVerd: posts the ante 30
Mimishka004: posts the ante 30
RtoG: posts the ante 30
Serghio2902: posts the ante 30
samax15: posts the ante 30
jcarlos.vale: posts small blind 250
RCABelVedeRVerd: posts big blind 500
*** HOLE CARDS ***
Dealt to jcarlos.vale [Ks 3s]
Mimishka004: folds 
RtoG: folds 
Serghio2902: folds 
samax15: folds 
sergucci82: raises 1000 to 1500
xxMich@ilxx: folds 
maajussi1: folds 
jcarlos.vale: folds 
RCABelVedeRVerd: folds 
Uncalled bet (1000) returned to sergucci82
sergucci82 collected 1520 from pot
sergucci82: doesn't show hand 
*** SUMMARY ***
Total pot 1520 | Rake 0 
Seat 1: sergucci82 collected (1520)
Seat 2: xxMich@ilxx folded before Flop (didn't bet)
Seat 3: maajussi1 (button) folded before Flop (didn't bet)
Seat 4: jcarlos.vale (small blind) folded before Flop
Seat 5: RCABelVedeRVerd (big blind) folded before Flop
Seat 6: Mimishka004 folded before Flop (didn't bet)
Seat 7: RtoG folded before Flop (didn't bet)
Seat 8: Serghio2902 folded before Flop (didn't bet)
Seat 9: samax15 folded before Flop (didn't bet)



PokerStars Hand #222104957269: Tournament #3082583698, $0.98+$0.12 USD Hold'em No Limit - Level XIII (250/500) - 2021/01/01 22:24:25 EET [2021/01/01 15:24:25 ET]
Table '3082583698 30' 9-max Seat #4 is the button
Seat 1: sergucci82 (12709 in chips) 
Seat 2: xxMich@ilxx (31007 in chips) 
Seat 3: maajussi1 (12982 in chips) 
Seat 4: jcarlos.vale (23956 in chips) 
Seat 5: RCABelVedeRVerd (13745 in chips) 
Seat 6: Mimishka004 (3396 in chips) 
Seat 7: RtoG (20033 in chips) 
Seat 8: Serghio2902 (16134 in chips) 
Seat 9: samax15 (6058 in chips) 
sergucci82: posts the ante 30
xxMich@ilxx: posts the ante 30
maajussi1: posts the ante 30
jcarlos.vale: posts the ante 30
RCABelVedeRVerd: posts the ante 30
Mimishka004: posts the ante 30
RtoG: posts the ante 30
Serghio2902: posts the ante 30
samax15: posts the ante 30
RCABelVedeRVerd: posts small blind 250
Mimishka004: posts big blind 500
*** HOLE CARDS ***
Dealt to jcarlos.vale [4c Kc]
RtoG: folds 
Serghio2902: folds 
samax15: folds 
sergucci82: folds 
xxMich@ilxx: folds 
maajussi1: calls 500
jcarlos.vale: folds 
RCABelVedeRVerd: folds 
Mimishka004: raises 2866 to 3366 and is all-in
maajussi1: calls 2866
*** FLOP *** [3s Ac 4s]
*** TURN *** [3s Ac 4s] [6h]
*** RIVER *** [3s Ac 4s 6h] [7c]
*** SHOW DOWN ***
Mimishka004: shows [Kh 9h] (high card Ace)
maajussi1: shows [9d Tc] (high card Ace - lower kicker)
Mimishka004 collected 7252 from pot
*** SUMMARY ***
Total pot 7252 | Rake 0 
Board [3s Ac 4s 6h 7c]
Seat 1: sergucci82 folded before Flop (didn't bet)
Seat 2: xxMich@ilxx folded before Flop (didn't bet)
Seat 3: maajussi1 showed [9d Tc] and lost with high card Ace
Seat 4: jcarlos.vale (button) folded before Flop (didn't bet)
Seat 5: RCABelVedeRVerd (small blind) folded before Flop
Seat 6: Mimishka004 (big blind) showed [Kh 9h] and won (7252) with high card Ace
Seat 7: RtoG folded before Flop (didn't bet)
Seat 8: Serghio2902 folded before Flop (didn't bet)
Seat 9: samax15 folded before Flop (didn't bet)



PokerStars Hand #222105006062: Tournament #3082583698, $0.98+$0.12 USD Hold'em No Limit - Level XIV (300/600) - 2021/01/01 22:25:14 EET [2021/01/01 15:25:14 ET]
Table '3082583698 30' 9-max Seat #5 is the button
Seat 1: sergucci82 (12679 in chips) 
Seat 2: xxMich@ilxx (30977 in chips) 
Seat 3: maajussi1 (9586 in chips) 
Seat 4: jcarlos.vale (23926 in chips) 
Seat 5: RCABelVedeRVerd (13465 in chips) 
Seat 6: Mimishka004 (7252 in chips) 
Seat 7: RtoG (20003 in chips) 
Seat 8: Serghio2902 (16104 in chips) 
Seat 9: samax15 (6028 in chips) 
sergucci82: posts the ante 40
xxMich@ilxx: posts the ante 40
maajussi1: posts the ante 40
jcarlos.vale: posts the ante 40
RCABelVedeRVerd: posts the ante 40
Mimishka004: posts the ante 40
RtoG: posts the ante 40
Serghio2902: posts the ante 40
samax15: posts the ante 40
Mimishka004: posts small blind 300
RtoG: posts big blind 600
*** HOLE CARDS ***
Dealt to jcarlos.vale [4s As]
Serghio2902: folds 
samax15: calls 600
sergucci82: folds 
xxMich@ilxx: folds 
maajussi1: folds 
jcarlos.vale: calls 600
RCABelVedeRVerd: folds 
Mimishka004: folds 
RtoG: checks 
*** FLOP *** [3d 5h Td]
RtoG: checks 
samax15: bets 1230
jcarlos.vale: folds 
RtoG: calls 1230
*** TURN *** [3d 5h Td] [Jh]
RtoG: checks 
samax15: bets 4158 and is all-in
RtoG: calls 4158
*** RIVER *** [3d 5h Td Jh] [Ad]
*** SHOW DOWN ***
RtoG: shows [4c Tc] (a pair of Tens)
samax15: shows [Kh Kd] (a pair of Kings)
samax15 collected 13236 from pot
*** SUMMARY ***
Total pot 13236 | Rake 0 
Board [3d 5h Td Jh Ad]
Seat 1: sergucci82 folded before Flop (didn't bet)
Seat 2: xxMich@ilxx folded before Flop (didn't bet)
Seat 3: maajussi1 folded before Flop (didn't bet)
Seat 4: jcarlos.vale folded on the Flop
Seat 5: RCABelVedeRVerd (button) folded before Flop (didn't bet)
Seat 6: Mimishka004 (small blind) folded before Flop
Seat 7: RtoG (big blind) showed [4c Tc] and lost with a pair of Tens
Seat 8: Serghio2902 folded before Flop (didn't bet)
Seat 9: samax15 showed [Kh Kd] and won (13236) with a pair of Kings



PokerStars Hand #222105037855: Tournament #3082583698, $0.98+$0.12 USD Hold'em No Limit - Level XIV (300/600) - 2021/01/01 22:25:46 EET [2021/01/01 15:25:46 ET]
Table '3082583698 30' 9-max Seat #6 is the button
Seat 1: sergucci82 (12639 in chips) 
Seat 2: xxMich@ilxx (30937 in chips) 
Seat 3: maajussi1 (9546 in chips) 
Seat 4: jcarlos.vale (23286 in chips) 
Seat 5: RCABelVedeRVerd (13425 in chips) 
Seat 6: Mimishka004 (6912 in chips) 
Seat 7: RtoG (13975 in chips) 
Seat 8: Serghio2902 (16064 in chips) 
Seat 9: samax15 (13236 in chips) 
sergucci82: posts the ante 40
xxMich@ilxx: posts the ante 40
maajussi1: posts the ante 40
jcarlos.vale: posts the ante 40
RCABelVedeRVerd: posts the ante 40
Mimishka004: posts the ante 40
RtoG: posts the ante 40
Serghio2902: posts the ante 40
samax15: posts the ante 40
RtoG: posts small blind 300
Serghio2902: posts big blind 600
*** HOLE CARDS ***
Dealt to jcarlos.vale [Kd 5h]
samax15: folds 
sergucci82: folds 
xxMich@ilxx: raises 1200 to 1800
maajussi1: folds 
jcarlos.vale: folds 
RCABelVedeRVerd: folds 
Mimishka004: raises 5072 to 6872 and is all-in
RtoG: folds 
Serghio2902: folds 
xxMich@ilxx: calls 5072
*** FLOP *** [Th 7d 3h]
*** TURN *** [Th 7d 3h] [3d]
*** RIVER *** [Th 7d 3h 3d] [3c]
*** SHOW DOWN ***
xxMich@ilxx: shows [Ah Ks] (three of a kind, Threes)
Mimishka004: shows [7h As] (a full house, Threes full of Sevens)
Mimishka004 collected 15004 from pot
*** SUMMARY ***
Total pot 15004 | Rake 0 
Board [Th 7d 3h 3d 3c]
Seat 1: sergucci82 folded before Flop (didn't bet)
Seat 2: xxMich@ilxx showed [Ah Ks] and lost with three of a kind, Threes
Seat 3: maajussi1 folded before Flop (didn't bet)
Seat 4: jcarlos.vale folded before Flop (didn't bet)
Seat 5: RCABelVedeRVerd folded before Flop (didn't bet)
Seat 6: Mimishka004 (button) showed [7h As] and won (15004) with a full house, Threes full of Sevens
Seat 7: RtoG (small blind) folded before Flop
Seat 8: Serghio2902 (big blind) folded before Flop
Seat 9: samax15 folded before Flop (didn't bet)



PokerStars Hand #222105082575: Tournament #3082583698, $0.98+$0.12 USD Hold'em No Limit - Level XIV (300/600) - 2021/01/01 22:26:32 EET [2021/01/01 15:26:32 ET]
Table '3082583698 30' 9-max Seat #7 is the button
Seat 1: sergucci82 (12599 in chips) 
Seat 2: xxMich@ilxx (24025 in chips) 
Seat 3: maajussi1 (9506 in chips) 
Seat 4: jcarlos.vale (23246 in chips) 
Seat 5: RCABelVedeRVerd (13385 in chips) 
Seat 6: Mimishka004 (15004 in chips) 
Seat 7: RtoG (13635 in chips) 
Seat 8: Serghio2902 (15424 in chips) 
Seat 9: samax15 (13196 in chips) 
sergucci82: posts the ante 40
xxMich@ilxx: posts the ante 40
maajussi1: posts the ante 40
jcarlos.vale: posts the ante 40
RCABelVedeRVerd: posts the ante 40
Mimishka004: posts the ante 40
RtoG: posts the ante 40
Serghio2902: posts the ante 40
samax15: posts the ante 40
Serghio2902: posts small blind 300
samax15: posts big blind 600
*** HOLE CARDS ***
Dealt to jcarlos.vale [3d Jc]
sergucci82: folds 
xxMich@ilxx: folds 
maajussi1: folds 
jcarlos.vale: folds 
RCABelVedeRVerd: folds 
Mimishka004: folds 
RtoG: calls 600
Serghio2902: folds 
samax15: checks 
*** FLOP *** [5h 7c 2d]
samax15: checks 
RtoG: bets 1200
samax15: folds 
Uncalled bet (1200) returned to RtoG
RtoG collected 1860 from pot
RtoG: doesn't show hand 
*** SUMMARY ***
Total pot 1860 | Rake 0 
Board [5h 7c 2d]
Seat 1: sergucci82 folded before Flop (didn't bet)
Seat 2: xxMich@ilxx folded before Flop (didn't bet)
Seat 3: maajussi1 folded before Flop (didn't bet)
Seat 4: jcarlos.vale folded before Flop (didn't bet)
Seat 5: RCABelVedeRVerd folded before Flop (didn't bet)
Seat 6: Mimishka004 folded before Flop (didn't bet)
Seat 7: RtoG (button) collected (1860)
Seat 8: Serghio2902 (small blind) folded before Flop
Seat 9: samax15 (big blind) folded on the Flop



PokerStars Hand #222105151375: Tournament #3082583698, $0.98+$0.12 USD Hold'em No Limit - Level XIV (300/600) - 2021/01/01 22:27:43 EET [2021/01/01 15:27:43 ET]
Table '3082583698 30' 9-max Seat #8 is the button
Seat 1: sergucci82 (12559 in chips) 
Seat 2: xxMich@ilxx (23985 in chips) 
Seat 3: maajussi1 (9466 in chips) 
Seat 4: jcarlos.vale (23206 in chips) 
Seat 5: RCABelVedeRVerd (13345 in chips) 
Seat 6: Mimishka004 (14964 in chips) 
Seat 7: RtoG (14855 in chips) 
Seat 8: Serghio2902 (15084 in chips) 
Seat 9: samax15 (12556 in chips) 
sergucci82: posts the ante 40
xxMich@ilxx: posts the ante 40
maajussi1: posts the ante 40
jcarlos.vale: posts the ante 40
RCABelVedeRVerd: posts the ante 40
Mimishka004: posts the ante 40
RtoG: posts the ante 40
Serghio2902: posts the ante 40
samax15: posts the ante 40
samax15: posts small blind 300
sergucci82: posts big blind 600
*** HOLE CARDS ***
Dealt to jcarlos.vale [8c Jh]
xxMich@ilxx: folds 
maajussi1: folds 
jcarlos.vale: folds 
RCABelVedeRVerd: folds 
Mimishka004: raises 630 to 1230
RtoG: calls 1230
Serghio2902: folds 
samax15: folds 
sergucci82: folds 
*** FLOP *** [Js 7c 3d]
Mimishka004: checks 
RtoG: bets 1200
Mimishka004: folds 
Uncalled bet (1200) returned to RtoG
RtoG collected 3720 from pot
RtoG: doesn't show hand 
*** SUMMARY ***
Total pot 3720 | Rake 0 
Board [Js 7c 3d]
Seat 1: sergucci82 (big blind) folded before Flop
Seat 2: xxMich@ilxx folded before Flop (didn't bet)
Seat 3: maajussi1 folded before Flop (didn't bet)
Seat 4: jcarlos.vale folded before Flop (didn't bet)
Seat 5: RCABelVedeRVerd folded before Flop (didn't bet)
Seat 6: Mimishka004 folded on the Flop
Seat 7: RtoG collected (3720)
Seat 8: Serghio2902 (button) folded before Flop (didn't bet)
Seat 9: samax15 (small blind) folded before Flop



PokerStars Hand #222105203184: Tournament #3082583698, $0.98+$0.12 USD Hold'em No Limit - Level XIV (300/600) - 2021/01/01 22:28:36 EET [2021/01/01 15:28:36 ET]
Table '3082583698 30' 9-max Seat #9 is the button
Seat 1: sergucci82 (11919 in chips) 
Seat 2: xxMich@ilxx (23945 in chips) 
Seat 3: maajussi1 (9426 in chips) 
Seat 4: jcarlos.vale (23166 in chips) 
Seat 5: RCABelVedeRVerd (13305 in chips) 
Seat 6: Mimishka004 (13694 in chips) 
Seat 7: RtoG (17305 in chips) 
Seat 8: Serghio2902 (15044 in chips) 
Seat 9: samax15 (12216 in chips) 
sergucci82: posts the ante 40
xxMich@ilxx: posts the ante 40
maajussi1: posts the ante 40
jcarlos.vale: posts the ante 40
RCABelVedeRVerd: posts the ante 40
Mimishka004: posts the ante 40
RtoG: posts the ante 40
Serghio2902: posts the ante 40
samax15: posts the ante 40
sergucci82: posts small blind 300
xxMich@ilxx: posts big blind 600
*** HOLE CARDS ***
Dealt to jcarlos.vale [Qs 4h]
maajussi1: folds 
jcarlos.vale: folds 
RCABelVedeRVerd: folds 
Mimishka004: folds 
RtoG: folds 
Serghio2902: folds 
samax15: folds 
sergucci82: raises 1200 to 1800
xxMich@ilxx: calls 1200
*** FLOP *** [5h Jh Tc]
sergucci82: bets 1307
xxMich@ilxx: folds 
Uncalled bet (1307) returned to sergucci82
sergucci82 collected 3960 from pot
sergucci82: doesn't show hand 
*** SUMMARY ***
Total pot 3960 | Rake 0 
Board [5h Jh Tc]
Seat 1: sergucci82 (small blind) collected (3960)
Seat 2: xxMich@ilxx (big blind) folded on the Flop
Seat 3: maajussi1 folded before Flop (didn't bet)
Seat 4: jcarlos.vale folded before Flop (didn't bet)
Seat 5: RCABelVedeRVerd folded before Flop (didn't bet)
Seat 6: Mimishka004 folded before Flop (didn't bet)
Seat 7: RtoG folded before Flop (didn't bet)
Seat 8: Serghio2902 folded before Flop (didn't bet)
Seat 9: samax15 (button) folded before Flop (didn't bet)



PokerStars Hand #222105257841: Tournament #3082583698, $0.98+$0.12 USD Hold'em No Limit - Level XIV (300/600) - 2021/01/01 22:29:33 EET [2021/01/01 15:29:33 ET]
Table '3082583698 30' 9-max Seat #1 is the button
Seat 1: sergucci82 (14039 in chips) 
Seat 2: xxMich@ilxx (22105 in chips) 
Seat 3: maajussi1 (9386 in chips) 
Seat 4: jcarlos.vale (23126 in chips) 
Seat 5: RCABelVedeRVerd (13265 in chips) 
Seat 6: Mimishka004 (13654 in chips) 
Seat 7: RtoG (17265 in chips) 
Seat 8: Serghio2902 (15004 in chips) 
Seat 9: samax15 (12176 in chips) 
sergucci82: posts the ante 40
xxMich@ilxx: posts the ante 40
maajussi1: posts the ante 40
jcarlos.vale: posts the ante 40
RCABelVedeRVerd: posts the ante 40
Mimishka004: posts the ante 40
RtoG: posts the ante 40
Serghio2902: posts the ante 40
samax15: posts the ante 40
xxMich@ilxx: posts small blind 300
maajussi1: posts big blind 600
*** HOLE CARDS ***
Dealt to jcarlos.vale [8s 2c]
jcarlos.vale: folds 
RCABelVedeRVerd: folds 
Mimishka004: folds 
RtoG: folds 
Serghio2902: folds 
samax15: folds 
sergucci82: folds 
xxMich@ilxx: folds 
Uncalled bet (300) returned to maajussi1
maajussi1 collected 960 from pot
maajussi1: doesn't show hand 
*** SUMMARY ***
Total pot 960 | Rake 0 
Seat 1: sergucci82 (button) folded before Flop (didn't bet)
Seat 2: xxMich@ilxx (small blind) folded before Flop
Seat 3: maajussi1 (big blind) collected (960)
Seat 4: jcarlos.vale folded before Flop (didn't bet)
Seat 5: RCABelVedeRVerd folded before Flop (didn't bet)
Seat 6: Mimishka004 folded before Flop (didn't bet)
Seat 7: RtoG folded before Flop (didn't bet)
Seat 8: Serghio2902 folded before Flop (didn't bet)
Seat 9: samax15 folded before Flop (didn't bet)



PokerStars Hand #222105300451: Tournament #3082583698, $0.98+$0.12 USD Hold'em No Limit - Level XIV (300/600) - 2021/01/01 22:30:17 EET [2021/01/01 15:30:17 ET]
Table '3082583698 30' 9-max Seat #2 is the button
Seat 1: sergucci82 (13999 in chips) 
Seat 2: xxMich@ilxx (21765 in chips) 
Seat 3: maajussi1 (10006 in chips) 
Seat 4: jcarlos.vale (23086 in chips) 
Seat 5: RCABelVedeRVerd (13225 in chips) 
Seat 6: Mimishka004 (13614 in chips) 
Seat 7: RtoG (17225 in chips) 
Seat 8: Serghio2902 (14964 in chips) 
Seat 9: samax15 (12136 in chips) 
sergucci82: posts the ante 40
xxMich@ilxx: posts the ante 40
maajussi1: posts the ante 40
jcarlos.vale: posts the ante 40
RCABelVedeRVerd: posts the ante 40
Mimishka004: posts the ante 40
RtoG: posts the ante 40
Serghio2902: posts the ante 40
samax15: posts the ante 40
maajussi1: posts small blind 300
jcarlos.vale: posts big blind 600
*** HOLE CARDS ***
Dealt to jcarlos.vale [3c Qc]
RCABelVedeRVerd has timed out
RCABelVedeRVerd: folds 
RCABelVedeRVerd is sitting out
Mimishka004: folds 
RtoG: folds 
Serghio2902: folds 
RCABelVedeRVerd has returned
samax15: folds 
sergucci82: folds 
xxMich@ilxx: raises 600 to 1200
maajussi1: folds 
jcarlos.vale: folds 
Uncalled bet (600) returned to xxMich@ilxx
xxMich@ilxx collected 1860 from pot
*** SUMMARY ***
Total pot 1860 | Rake 0 
Seat 1: sergucci82 folded before Flop (didn't bet)
Seat 2: xxMich@ilxx (button) collected (1860)
Seat 3: maajussi1 (small blind) folded before Flop
Seat 4: jcarlos.vale (big blind) folded before Flop
Seat 5: RCABelVedeRVerd folded before Flop (didn't bet)
Seat 6: Mimishka004 folded before Flop (didn't bet)
Seat 7: RtoG folded before Flop (didn't bet)
Seat 8: Serghio2902 folded before Flop (didn't bet)
Seat 9: samax15 folded before Flop (didn't bet)



PokerStars Hand #222105365426: Tournament #3082583698, $0.98+$0.12 USD Hold'em No Limit - Level XIV (300/600) - 2021/01/01 22:31:20 EET [2021/01/01 15:31:20 ET]
Table '3082583698 30' 9-max Seat #3 is the button
Seat 1: sergucci82 (13959 in chips) 
Seat 2: xxMich@ilxx (22985 in chips) 
Seat 3: maajussi1 (9666 in chips) 
Seat 4: jcarlos.vale (22446 in chips) 
Seat 5: RCABelVedeRVerd (13185 in chips) 
Seat 6: Mimishka004 (13574 in chips) 
Seat 7: RtoG (17185 in chips) 
Seat 8: Serghio2902 (14924 in chips) 
Seat 9: samax15 (12096 in chips) 
sergucci82: posts the ante 40
xxMich@ilxx: posts the ante 40
maajussi1: posts the ante 40
jcarlos.vale: posts the ante 40
RCABelVedeRVerd: posts the ante 40
Mimishka004: posts the ante 40
RtoG: posts the ante 40
Serghio2902: posts the ante 40
samax15: posts the ante 40
jcarlos.vale: posts small blind 300
RCABelVedeRVerd: posts big blind 600
*** HOLE CARDS ***
Dealt to jcarlos.vale [7d 3h]
Mimishka004: folds 
RtoG: raises 600 to 1200
Serghio2902: folds 
samax15: folds 
sergucci82: folds 
xxMich@ilxx: folds 
maajussi1: folds 
jcarlos.vale: folds 
RCABelVedeRVerd: folds 
Uncalled bet (600) returned to RtoG
RtoG collected 1860 from pot
RtoG: doesn't show hand 
*** SUMMARY ***
Total pot 1860 | Rake 0 
Seat 1: sergucci82 folded before Flop (didn't bet)
Seat 2: xxMich@ilxx folded before Flop (didn't bet)
Seat 3: maajussi1 (button) folded before Flop (didn't bet)
Seat 4: jcarlos.vale (small blind) folded before Flop
Seat 5: RCABelVedeRVerd (big blind) folded before Flop
Seat 6: Mimishka004 folded before Flop (didn't bet)
Seat 7: RtoG collected (1860)
Seat 8: Serghio2902 folded before Flop (didn't bet)
Seat 9: samax15 folded before Flop (didn't bet)



PokerStars Hand #222105400287: Tournament #3082583698, $0.98+$0.12 USD Hold'em No Limit - Level XIV (300/600) - 2021/01/01 22:31:57 EET [2021/01/01 15:31:57 ET]
Table '3082583698 30' 9-max Seat #4 is the button
Seat 1: sergucci82 (13919 in chips) 
Seat 2: xxMich@ilxx (22945 in chips) 
Seat 3: maajussi1 (9626 in chips) 
Seat 4: jcarlos.vale (22106 in chips) 
Seat 5: RCABelVedeRVerd (12545 in chips) 
Seat 6: Mimishka004 (13534 in chips) 
Seat 7: RtoG (18405 in chips) 
Seat 8: Serghio2902 (14884 in chips) 
Seat 9: samax15 (12056 in chips) 
sergucci82: posts the ante 40
xxMich@ilxx: posts the ante 40
maajussi1: posts the ante 40
jcarlos.vale: posts the ante 40
RCABelVedeRVerd: posts the ante 40
Mimishka004: posts the ante 40
RtoG: posts the ante 40
Serghio2902: posts the ante 40
samax15: posts the ante 40
RCABelVedeRVerd: posts small blind 300
Mimishka004: posts big blind 600
*** HOLE CARDS ***
Dealt to jcarlos.vale [8h 4h]
RtoG: folds 
Serghio2902: folds 
samax15: folds 
sergucci82: folds 
xxMich@ilxx: folds 
maajussi1: folds 
jcarlos.vale: folds 
RCABelVedeRVerd: calls 300
Mimishka004: checks 
*** FLOP *** [8c 5h Js]
RCABelVedeRVerd: checks 
Mimishka004: bets 998
RCABelVedeRVerd: folds 
Uncalled bet (998) returned to Mimishka004
Mimishka004 collected 1560 from pot
*** SUMMARY ***
Total pot 1560 | Rake 0 
Board [8c 5h Js]
Seat 1: sergucci82 folded before Flop (didn't bet)
Seat 2: xxMich@ilxx folded before Flop (didn't bet)
Seat 3: maajussi1 folded before Flop (didn't bet)
Seat 4: jcarlos.vale (button) folded before Flop (didn't bet)
Seat 5: RCABelVedeRVerd (small blind) folded on the Flop
Seat 6: Mimishka004 (big blind) collected (1560)
Seat 7: RtoG folded before Flop (didn't bet)
Seat 8: Serghio2902 folded before Flop (didn't bet)
Seat 9: samax15 folded before Flop (didn't bet)



PokerStars Hand #222105447305: Tournament #3082583698, $0.98+$0.12 USD Hold'em No Limit - Level XIV (300/600) - 2021/01/01 22:32:47 EET [2021/01/01 15:32:47 ET]
Table '3082583698 30' 9-max Seat #5 is the button
Seat 1: sergucci82 (13879 in chips) 
Seat 2: xxMich@ilxx (22905 in chips) 
Seat 3: maajussi1 (9586 in chips) 
Seat 4: jcarlos.vale (22066 in chips) 
Seat 5: RCABelVedeRVerd (11905 in chips) 
Seat 6: Mimishka004 (14454 in chips) 
Seat 7: RtoG (18365 in chips) 
Seat 8: Serghio2902 (14844 in chips) 
Seat 9: samax15 (12016 in chips) 
sergucci82: posts the ante 40
xxMich@ilxx: posts the ante 40
maajussi1: posts the ante 40
jcarlos.vale: posts the ante 40
RCABelVedeRVerd: posts the ante 40
Mimishka004: posts the ante 40
RtoG: posts the ante 40
Serghio2902: posts the ante 40
samax15: posts the ante 40
Mimishka004: posts small blind 300
RtoG: posts big blind 600
*** HOLE CARDS ***
Dealt to jcarlos.vale [Ts 4h]
Serghio2902: folds 
samax15: folds 
sergucci82: folds 
xxMich@ilxx: folds 
maajussi1: calls 600
jcarlos.vale: folds 
RCABelVedeRVerd: folds 
Mimishka004: calls 300
RtoG: checks 
*** FLOP *** [Kh Ah 8d]
Mimishka004: checks 
RtoG: checks 
maajussi1: bets 600
Mimishka004: raises 1200 to 1800
RtoG: folds 
maajussi1: calls 1200
*** TURN *** [Kh Ah 8d] [4d]
Mimishka004: bets 12014 and is all-in
maajussi1: folds 
Uncalled bet (12014) returned to Mimishka004
Mimishka004 collected 5760 from pot
*** SUMMARY ***
Total pot 5760 | Rake 0 
Board [Kh Ah 8d 4d]
Seat 1: sergucci82 folded before Flop (didn't bet)
Seat 2: xxMich@ilxx folded before Flop (didn't bet)
Seat 3: maajussi1 folded on the Turn
Seat 4: jcarlos.vale folded before Flop (didn't bet)
Seat 5: RCABelVedeRVerd (button) folded before Flop (didn't bet)
Seat 6: Mimishka004 (small blind) collected (5760)
Seat 7: RtoG (big blind) folded on the Flop
Seat 8: Serghio2902 folded before Flop (didn't bet)
Seat 9: samax15 folded before Flop (didn't bet)



PokerStars Hand #222105514162: Tournament #3082583698, $0.98+$0.12 USD Hold'em No Limit - Level XIV (300/600) - 2021/01/01 22:33:52 EET [2021/01/01 15:33:52 ET]
Table '3082583698 30' 9-max Seat #6 is the button
Seat 1: sergucci82 (13839 in chips) 
Seat 2: xxMich@ilxx (22865 in chips) 
Seat 3: maajussi1 (7146 in chips) 
Seat 4: jcarlos.vale (22026 in chips) 
Seat 5: RCABelVedeRVerd (11865 in chips) 
Seat 6: Mimishka004 (17774 in chips) 
Seat 7: RtoG (17725 in chips) 
Seat 8: Serghio2902 (14804 in chips) 
Seat 9: samax15 (11976 in chips) 
sergucci82: posts the ante 40
xxMich@ilxx: posts the ante 40
maajussi1: posts the ante 40
jcarlos.vale: posts the ante 40
RCABelVedeRVerd: posts the ante 40
Mimishka004: posts the ante 40
RtoG: posts the ante 40
Serghio2902: posts the ante 40
samax15: posts the ante 40
RtoG: posts small blind 300
Serghio2902: posts big blind 600
*** HOLE CARDS ***
Dealt to jcarlos.vale [3c 7h]
samax15: folds 
sergucci82: folds 
xxMich@ilxx: folds 
maajussi1: folds 
jcarlos.vale: folds 
RCABelVedeRVerd: folds 
Mimishka004: folds 
RtoG: raises 600 to 1200
Serghio2902: folds 
Uncalled bet (600) returned to RtoG
RtoG collected 1560 from pot
RtoG: doesn't show hand 
*** SUMMARY ***
Total pot 1560 | Rake 0 
Seat 1: sergucci82 folded before Flop (didn't bet)
Seat 2: xxMich@ilxx folded before Flop (didn't bet)
Seat 3: maajussi1 folded before Flop (didn't bet)
Seat 4: jcarlos.vale folded before Flop (didn't bet)
Seat 5: RCABelVedeRVerd folded before Flop (didn't bet)
Seat 6: Mimishka004 (button) folded before Flop (didn't bet)
Seat 7: RtoG (small blind) collected (1560)
Seat 8: Serghio2902 (big blind) folded before Flop
Seat 9: samax15 folded before Flop (didn't bet)



PokerStars Hand #222105549427: Tournament #3082583698, $0.98+$0.12 USD Hold'em No Limit - Level XV (350/700) - 2021/01/01 22:34:31 EET [2021/01/01 15:34:31 ET]
Table '3082583698 30' 9-max Seat #7 is the button
Seat 1: sergucci82 (13799 in chips) 
Seat 2: xxMich@ilxx (22825 in chips) 
Seat 3: maajussi1 (7106 in chips) 
Seat 4: jcarlos.vale (21986 in chips) 
Seat 5: RCABelVedeRVerd (11825 in chips) 
Seat 6: Mimishka004 (17734 in chips) 
Seat 7: RtoG (18645 in chips) 
Seat 8: Serghio2902 (14164 in chips) 
Seat 9: samax15 (11936 in chips) 
sergucci82: posts the ante 50
xxMich@ilxx: posts the ante 50
maajussi1: posts the ante 50
jcarlos.vale: posts the ante 50
RCABelVedeRVerd: posts the ante 50
Mimishka004: posts the ante 50
RtoG: posts the ante 50
Serghio2902: posts the ante 50
samax15: posts the ante 50
Serghio2902: posts small blind 350
samax15: posts big blind 700
*** HOLE CARDS ***
Dealt to jcarlos.vale [Ts Ah]
sergucci82: folds 
xxMich@ilxx: folds 
maajussi1: raises 700 to 1400
jcarlos.vale: calls 1400
RCABelVedeRVerd: folds 
Mimishka004: folds 
RtoG: calls 1400
Serghio2902: folds 
samax15: folds 
*** FLOP *** [3d Kc 2s]
maajussi1: bets 5656 and is all-in
jcarlos.vale: folds 
RtoG: calls 5656
*** TURN *** [3d Kc 2s] [Jc]
*** RIVER *** [3d Kc 2s Jc] [6h]
*** SHOW DOWN ***
maajussi1: shows [Ac 9c] (high card Ace)
RtoG: shows [4h Kh] (a pair of Kings)
RtoG collected 17012 from pot
maajussi1 finished the tournament in 731st place
*** SUMMARY ***
Total pot 17012 | Rake 0 
Board [3d Kc 2s Jc 6h]
Seat 1: sergucci82 folded before Flop (didn't bet)
Seat 2: xxMich@ilxx folded before Flop (didn't bet)
Seat 3: maajussi1 showed [Ac 9c] and lost with high card Ace
Seat 4: jcarlos.vale folded on the Flop
Seat 5: RCABelVedeRVerd folded before Flop (didn't bet)
Seat 6: Mimishka004 folded before Flop (didn't bet)
Seat 7: RtoG (button) showed [4h Kh] and won (17012) with a pair of Kings
Seat 8: Serghio2902 (small blind) folded before Flop
Seat 9: samax15 (big blind) folded before Flop



PokerStars Hand #222105598381: Tournament #3082583698, $0.98+$0.12 USD Hold'em No Limit - Level XV (350/700) - 2021/01/01 22:35:24 EET [2021/01/01 15:35:24 ET]
Table '3082583698 30' 9-max Seat #8 is the button
Seat 1: sergucci82 (13749 in chips) 
Seat 2: xxMich@ilxx (22775 in chips) 
Seat 4: jcarlos.vale (20536 in chips) 
Seat 5: RCABelVedeRVerd (11775 in chips) 
Seat 6: Mimishka004 (17684 in chips) 
Seat 7: RtoG (28551 in chips) 
Seat 8: Serghio2902 (13764 in chips) 
Seat 9: samax15 (11186 in chips) 
sergucci82: posts the ante 50
xxMich@ilxx: posts the ante 50
jcarlos.vale: posts the ante 50
RCABelVedeRVerd: posts the ante 50
Mimishka004: posts the ante 50
RtoG: posts the ante 50
Serghio2902: posts the ante 50
samax15: posts the ante 50
samax15: posts small blind 350
sergucci82: posts big blind 700
*** HOLE CARDS ***
Dealt to jcarlos.vale [5d 4d]
xxMich@ilxx: folds 
jcarlos.vale: raises 1120 to 1820
RCABelVedeRVerd: folds 
Mimishka004: folds 
RtoG: folds 
Serghio2902: folds 
samax15: folds 
sergucci82: folds 
Uncalled bet (1120) returned to jcarlos.vale
jcarlos.vale collected 2150 from pot
jcarlos.vale: doesn't show hand 
*** SUMMARY ***
Total pot 2150 | Rake 0 
Seat 1: sergucci82 (big blind) folded before Flop
Seat 2: xxMich@ilxx folded before Flop (didn't bet)
Seat 4: jcarlos.vale collected (2150)
Seat 5: RCABelVedeRVerd folded before Flop (didn't bet)
Seat 6: Mimishka004 folded before Flop (didn't bet)
Seat 7: RtoG folded before Flop (didn't bet)
Seat 8: Serghio2902 (button) folded before Flop (didn't bet)
Seat 9: samax15 (small blind) folded before Flop



PokerStars Hand #222105623915: Tournament #3082583698, $0.98+$0.12 USD Hold'em No Limit - Level XV (350/700) - 2021/01/01 22:35:52 EET [2021/01/01 15:35:52 ET]
Table '3082583698 30' 9-max Seat #9 is the button
Seat 1: sergucci82 (12999 in chips) 
Seat 2: xxMich@ilxx (22725 in chips) 
Seat 3: neebimozgi123 (67174 in chips) 
Seat 4: jcarlos.vale (21936 in chips) 
Seat 5: RCABelVedeRVerd (11725 in chips) 
Seat 6: Mimishka004 (17634 in chips) 
Seat 7: RtoG (28501 in chips) 
Seat 8: Serghio2902 (13714 in chips) 
Seat 9: samax15 (10786 in chips) 
sergucci82: posts the ante 50
xxMich@ilxx: posts the ante 50
neebimozgi123: posts the ante 50
jcarlos.vale: posts the ante 50
RCABelVedeRVerd: posts the ante 50
Mimishka004: posts the ante 50
RtoG: posts the ante 50
Serghio2902: posts the ante 50
samax15: posts the ante 50
sergucci82: posts small blind 350
xxMich@ilxx: posts big blind 700
*** HOLE CARDS ***
Dealt to jcarlos.vale [7d Qh]
neebimozgi123: folds 
jcarlos.vale: folds 
RCABelVedeRVerd: folds 
Mimishka004: folds 
RtoG: folds 
Serghio2902: folds 
samax15: folds 
sergucci82: folds 
Uncalled bet (350) returned to xxMich@ilxx
xxMich@ilxx collected 1150 from pot
*** SUMMARY ***
Total pot 1150 | Rake 0 
Seat 1: sergucci82 (small blind) folded before Flop
Seat 2: xxMich@ilxx (big blind) collected (1150)
Seat 3: neebimozgi123 folded before Flop (didn't bet)
Seat 4: jcarlos.vale folded before Flop (didn't bet)
Seat 5: RCABelVedeRVerd folded before Flop (didn't bet)
Seat 6: Mimishka004 folded before Flop (didn't bet)
Seat 7: RtoG folded before Flop (didn't bet)
Seat 8: Serghio2902 folded before Flop (didn't bet)
Seat 9: samax15 (button) folded before Flop (didn't bet)



PokerStars Hand #222105649104: Tournament #3082583698, $0.98+$0.12 USD Hold'em No Limit - Level XV (350/700) - 2021/01/01 22:36:20 EET [2021/01/01 15:36:20 ET]
Table '3082583698 30' 9-max Seat #1 is the button
Seat 1: sergucci82 (12599 in chips) 
Seat 2: xxMich@ilxx (23475 in chips) 
Seat 3: neebimozgi123 (67124 in chips) 
Seat 4: jcarlos.vale (21886 in chips) 
Seat 5: RCABelVedeRVerd (11675 in chips) 
Seat 6: Mimishka004 (17584 in chips) 
Seat 7: RtoG (28451 in chips) 
Seat 8: Serghio2902 (13664 in chips) 
Seat 9: samax15 (10736 in chips) 
sergucci82: posts the ante 50
xxMich@ilxx: posts the ante 50
neebimozgi123: posts the ante 50
jcarlos.vale: posts the ante 50
RCABelVedeRVerd: posts the ante 50
Mimishka004: posts the ante 50
RtoG: posts the ante 50
Serghio2902: posts the ante 50
samax15: posts the ante 50
xxMich@ilxx: posts small blind 350
neebimozgi123: posts big blind 700
*** HOLE CARDS ***
Dealt to jcarlos.vale [Qc Ah]
jcarlos.vale: raises 1120 to 1820
RCABelVedeRVerd: folds 
Mimishka004: folds 
RtoG: folds 
Serghio2902: folds 
samax15 has timed out
samax15: folds 
samax15 is sitting out
sergucci82: folds 
xxMich@ilxx: folds 
samax15 has returned
neebimozgi123: calls 1120
*** FLOP *** [3s Jc 6c]
neebimozgi123: checks 
jcarlos.vale: bets 1400
neebimozgi123: calls 1400
*** TURN *** [3s Jc 6c] [Ks]
neebimozgi123: checks 
jcarlos.vale: checks 
*** RIVER *** [3s Jc 6c Ks] [Jh]
neebimozgi123: bets 700
jcarlos.vale: calls 700
*** SHOW DOWN ***
neebimozgi123: shows [3h Th] (two pair, Jacks and Threes)
jcarlos.vale: mucks hand 
neebimozgi123 collected 8640 from pot
*** SUMMARY ***
Total pot 8640 | Rake 0 
Board [3s Jc 6c Ks Jh]
Seat 1: sergucci82 (button) folded before Flop (didn't bet)
Seat 2: xxMich@ilxx (small blind) folded before Flop
Seat 3: neebimozgi123 (big blind) showed [3h Th] and won (8640) with two pair, Jacks and Threes
Seat 4: jcarlos.vale mucked [Qc Ah]
Seat 5: RCABelVedeRVerd folded before Flop (didn't bet)
Seat 6: Mimishka004 folded before Flop (didn't bet)
Seat 7: RtoG folded before Flop (didn't bet)
Seat 8: Serghio2902 folded before Flop (didn't bet)
Seat 9: samax15 folded before Flop (didn't bet)



PokerStars Hand #222105697087: Tournament #3082583698, $0.98+$0.12 USD Hold'em No Limit - Level XV (350/700) - 2021/01/01 22:37:12 EET [2021/01/01 15:37:12 ET]
Table '3082583698 30' 9-max Seat #2 is the button
Seat 1: sergucci82 (12549 in chips) 
Seat 2: xxMich@ilxx (23075 in chips) 
Seat 3: neebimozgi123 (71794 in chips) 
Seat 4: jcarlos.vale (17916 in chips) 
Seat 5: RCABelVedeRVerd (11625 in chips) 
Seat 6: Mimishka004 (17534 in chips) 
Seat 7: RtoG (28401 in chips) 
Seat 8: Serghio2902 (13614 in chips) 
Seat 9: samax15 (10686 in chips) 
sergucci82: posts the ante 50
xxMich@ilxx: posts the ante 50
neebimozgi123: posts the ante 50
jcarlos.vale: posts the ante 50
RCABelVedeRVerd: posts the ante 50
Mimishka004: posts the ante 50
RtoG: posts the ante 50
Serghio2902: posts the ante 50
samax15: posts the ante 50
neebimozgi123: posts small blind 350
jcarlos.vale: posts big blind 700
*** HOLE CARDS ***
Dealt to jcarlos.vale [Ac 3c]
RCABelVedeRVerd: folds 
Mimishka004: folds 
RtoG: folds 
Serghio2902: folds 
samax15 has timed out
samax15: folds 
samax15 is sitting out
samax15 has returned
sergucci82: raises 11799 to 12499 and is all-in
xxMich@ilxx: folds 
neebimozgi123: folds 
jcarlos.vale: folds 
Uncalled bet (11799) returned to sergucci82
sergucci82 collected 2200 from pot
sergucci82: doesn't show hand 
*** SUMMARY ***
Total pot 2200 | Rake 0 
Seat 1: sergucci82 collected (2200)
Seat 2: xxMich@ilxx (button) folded before Flop (didn't bet)
Seat 3: neebimozgi123 (small blind) folded before Flop
Seat 4: jcarlos.vale (big blind) folded before Flop
Seat 5: RCABelVedeRVerd folded before Flop (didn't bet)
Seat 6: Mimishka004 folded before Flop (didn't bet)
Seat 7: RtoG folded before Flop (didn't bet)
Seat 8: Serghio2902 folded before Flop (didn't bet)
Seat 9: samax15 folded before Flop (didn't bet)



PokerStars Hand #222105734266: Tournament #3082583698, $0.98+$0.12 USD Hold'em No Limit - Level XV (350/700) - 2021/01/01 22:37:54 EET [2021/01/01 15:37:54 ET]
Table '3082583698 30' 9-max Seat #3 is the button
Seat 1: sergucci82 (13999 in chips) 
Seat 2: xxMich@ilxx (23025 in chips) 
Seat 3: neebimozgi123 (71394 in chips) 
Seat 4: jcarlos.vale (17166 in chips) 
Seat 5: RCABelVedeRVerd (11575 in chips) 
Seat 6: Mimishka004 (17484 in chips) 
Seat 7: RtoG (28351 in chips) 
Seat 8: Serghio2902 (13564 in chips) 
Seat 9: samax15 (10636 in chips) 
sergucci82: posts the ante 50
xxMich@ilxx: posts the ante 50
neebimozgi123: posts the ante 50
jcarlos.vale: posts the ante 50
RCABelVedeRVerd: posts the ante 50
Mimishka004: posts the ante 50
RtoG: posts the ante 50
Serghio2902: posts the ante 50
samax15: posts the ante 50
jcarlos.vale: posts small blind 350
RCABelVedeRVerd: posts big blind 700
*** HOLE CARDS ***
Dealt to jcarlos.vale [6s Th]
Mimishka004: calls 700
RtoG: folds 
Serghio2902: calls 700
samax15 has timed out
samax15: folds 
samax15 is sitting out
sergucci82: folds 
samax15 has returned
xxMich@ilxx: raises 22275 to 22975 and is all-in
neebimozgi123: folds 
jcarlos.vale: folds 
RCABelVedeRVerd: folds 
Mimishka004: calls 16734 and is all-in
Serghio2902: folds 
Uncalled bet (5541) returned to xxMich@ilxx
*** FLOP *** [3c 3h Td]
*** TURN *** [3c 3h Td] [Jh]
*** RIVER *** [3c 3h Td Jh] [Kh]
*** SHOW DOWN ***
Mimishka004: shows [Ah As] (two pair, Aces and Threes)
xxMich@ilxx: shows [7c 7h] (two pair, Sevens and Threes)
Mimishka004 collected 37068 from pot
*** SUMMARY ***
Total pot 37068 | Rake 0 
Board [3c 3h Td Jh Kh]
Seat 1: sergucci82 folded before Flop (didn't bet)
Seat 2: xxMich@ilxx showed [7c 7h] and lost with two pair, Sevens and Threes
Seat 3: neebimozgi123 (button) folded before Flop (didn't bet)
Seat 4: jcarlos.vale (small blind) folded before Flop
Seat 5: RCABelVedeRVerd (big blind) folded before Flop
Seat 6: Mimishka004 showed [Ah As] and won (37068) with two pair, Aces and Threes
Seat 7: RtoG folded before Flop (didn't bet)
Seat 8: Serghio2902 folded before Flop
Seat 9: samax15 folded before Flop (didn't bet)



PokerStars Hand #222105777642: Tournament #3082583698, $0.98+$0.12 USD Hold'em No Limit - Level XV (350/700) - 2021/01/01 22:38:43 EET [2021/01/01 15:38:43 ET]
Table '3082583698 30' 9-max Seat #4 is the button
Seat 1: sergucci82 (13949 in chips) 
Seat 2: xxMich@ilxx (5541 in chips) 
Seat 3: neebimozgi123 (71344 in chips) 
Seat 4: jcarlos.vale (16766 in chips) 
Seat 5: RCABelVedeRVerd (10825 in chips) 
Seat 6: Mimishka004 (37068 in chips) 
Seat 7: RtoG (28301 in chips) 
Seat 8: Serghio2902 (12814 in chips) 
Seat 9: samax15 (10586 in chips) 
sergucci82: posts the ante 50
xxMich@ilxx: posts the ante 50
neebimozgi123: posts the ante 50
jcarlos.vale: posts the ante 50
RCABelVedeRVerd: posts the ante 50
Mimishka004: posts the ante 50
RtoG: posts the ante 50
Serghio2902: posts the ante 50
samax15: posts the ante 50
RCABelVedeRVerd: posts small blind 350
Mimishka004: posts big blind 700
*** HOLE CARDS ***
Dealt to jcarlos.vale [8c Kh]
RtoG: folds 
Serghio2902: folds 
samax15 has timed out
samax15: folds 
samax15 is sitting out
sergucci82: folds 
samax15 has returned
xxMich@ilxx: folds 
neebimozgi123: folds 
jcarlos.vale: folds 
RCABelVedeRVerd: calls 350
Mimishka004: checks 
*** FLOP *** [6c 5h 5c]
RCABelVedeRVerd: checks 
Mimishka004: checks 
*** TURN *** [6c 5h 5c] [7h]
RCABelVedeRVerd: checks 
Mimishka004: checks 
*** RIVER *** [6c 5h 5c 7h] [Tc]
RCABelVedeRVerd: checks 
Mimishka004: checks 
*** SHOW DOWN ***
RCABelVedeRVerd: shows [Qc 9h] (a pair of Fives)
Mimishka004: shows [7d Ks] (two pair, Sevens and Fives)
Mimishka004 collected 1850 from pot
*** SUMMARY ***
Total pot 1850 | Rake 0 
Board [6c 5h 5c 7h Tc]
Seat 1: sergucci82 folded before Flop (didn't bet)
Seat 2: xxMich@ilxx folded before Flop (didn't bet)
Seat 3: neebimozgi123 folded before Flop (didn't bet)
Seat 4: jcarlos.vale (button) folded before Flop (didn't bet)
Seat 5: RCABelVedeRVerd (small blind) showed [Qc 9h] and lost with a pair of Fives
Seat 6: Mimishka004 (big blind) showed [7d Ks] and won (1850) with two pair, Sevens and Fives
Seat 7: RtoG folded before Flop (didn't bet)
Seat 8: Serghio2902 folded before Flop (didn't bet)
Seat 9: samax15 folded before Flop (didn't bet)



PokerStars Hand #222105831509: Tournament #3082583698, $0.98+$0.12 USD Hold'em No Limit - Level XV (350/700) - 2021/01/01 22:39:44 EET [2021/01/01 15:39:44 ET]
Table '3082583698 30' 9-max Seat #5 is the button
Seat 1: sergucci82 (13899 in chips) 
Seat 2: xxMich@ilxx (5491 in chips) 
Seat 3: neebimozgi123 (71294 in chips) 
Seat 4: jcarlos.vale (16716 in chips) 
Seat 5: RCABelVedeRVerd (10075 in chips) 
Seat 6: Mimishka004 (38168 in chips) 
Seat 7: RtoG (28251 in chips) 
Seat 8: Serghio2902 (12764 in chips) 
Seat 9: samax15 (10536 in chips) 
sergucci82: posts the ante 50
xxMich@ilxx: posts the ante 50
neebimozgi123: posts the ante 50
jcarlos.vale: posts the ante 50
RCABelVedeRVerd: posts the ante 50
Mimishka004: posts the ante 50
RtoG: posts the ante 50
Serghio2902: posts the ante 50
samax15: posts the ante 50
Mimishka004: posts small blind 350
RtoG: posts big blind 700
*** HOLE CARDS ***
Dealt to jcarlos.vale [9c Ks]
Serghio2902: folds 
samax15 has timed out
samax15: folds 
samax15 is sitting out
samax15 has returned
sergucci82: folds 
xxMich@ilxx: raises 4741 to 5441 and is all-in
neebimozgi123: folds 
jcarlos.vale: folds 
RCABelVedeRVerd: folds 
Mimishka004: folds 
RtoG: folds 
Uncalled bet (4741) returned to xxMich@ilxx
xxMich@ilxx collected 2200 from pot
*** SUMMARY ***
Total pot 2200 | Rake 0 
Seat 1: sergucci82 folded before Flop (didn't bet)
Seat 2: xxMich@ilxx collected (2200)
Seat 3: neebimozgi123 folded before Flop (didn't bet)
Seat 4: jcarlos.vale folded before Flop (didn't bet)
Seat 5: RCABelVedeRVerd (button) folded before Flop (didn't bet)
Seat 6: Mimishka004 (small blind) folded before Flop
Seat 7: RtoG (big blind) folded before Flop
Seat 8: Serghio2902 folded before Flop (didn't bet)
Seat 9: samax15 folded before Flop (didn't bet)



PokerStars Hand #222105864649: Tournament #3082583698, $0.98+$0.12 USD Hold'em No Limit - Level XV (350/700) - 2021/01/01 22:40:21 EET [2021/01/01 15:40:21 ET]
Table '3082583698 30' 9-max Seat #6 is the button
Seat 1: sergucci82 (13849 in chips) 
Seat 2: xxMich@ilxx (6941 in chips) 
Seat 3: neebimozgi123 (71244 in chips) 
Seat 4: jcarlos.vale (16666 in chips) 
Seat 5: RCABelVedeRVerd (10025 in chips) 
Seat 6: Mimishka004 (37768 in chips) 
Seat 7: RtoG (27501 in chips) 
Seat 8: Serghio2902 (12714 in chips) 
Seat 9: samax15 (10486 in chips) 
sergucci82: posts the ante 50
xxMich@ilxx: posts the ante 50
neebimozgi123: posts the ante 50
jcarlos.vale: posts the ante 50
RCABelVedeRVerd: posts the ante 50
Mimishka004: posts the ante 50
RtoG: posts the ante 50
Serghio2902: posts the ante 50
samax15: posts the ante 50
RtoG: posts small blind 350
Serghio2902: posts big blind 700
*** HOLE CARDS ***
Dealt to jcarlos.vale [3c 3d]
samax15 has timed out
samax15: folds 
samax15 is sitting out
sergucci82: folds 
xxMich@ilxx: folds 
neebimozgi123: folds 
jcarlos.vale: raises 1120 to 1820
samax15 has returned
RCABelVedeRVerd: calls 1820
Mimishka004: folds 
RtoG: calls 1470
Serghio2902: folds 
*** FLOP *** [2d Td 8s]
RtoG: checks 
jcarlos.vale: bets 1400
RCABelVedeRVerd: raises 6755 to 8155 and is all-in
RtoG: folds 
jcarlos.vale: folds 
Uncalled bet (6755) returned to RCABelVedeRVerd
RCABelVedeRVerd collected 9410 from pot
*** SUMMARY ***
Total pot 9410 | Rake 0 
Board [2d Td 8s]
Seat 1: sergucci82 folded before Flop (didn't bet)
Seat 2: xxMich@ilxx folded before Flop (didn't bet)
Seat 3: neebimozgi123 folded before Flop (didn't bet)
Seat 4: jcarlos.vale folded on the Flop
Seat 5: RCABelVedeRVerd collected (9410)
Seat 6: Mimishka004 (button) folded before Flop (didn't bet)
Seat 7: RtoG (small blind) folded on the Flop
Seat 8: Serghio2902 (big blind) folded before Flop
Seat 9: samax15 folded before Flop (didn't bet)



PokerStars Hand #222105914811: Tournament #3082583698, $0.98+$0.12 USD Hold'em No Limit - Level XV (350/700) - 2021/01/01 22:41:18 EET [2021/01/01 15:41:18 ET]
Table '3082583698 30' 9-max Seat #7 is the button
Seat 1: sergucci82 (13799 in chips) 
Seat 2: xxMich@ilxx (6891 in chips) 
Seat 3: neebimozgi123 (71194 in chips) 
Seat 4: jcarlos.vale (13396 in chips) 
Seat 5: RCABelVedeRVerd (16165 in chips) 
Seat 6: Mimishka004 (37718 in chips) 
Seat 7: RtoG (25631 in chips) 
Seat 8: Serghio2902 (11964 in chips) 
Seat 9: samax15 (10436 in chips) 
sergucci82: posts the ante 50
xxMich@ilxx: posts the ante 50
neebimozgi123: posts the ante 50
jcarlos.vale: posts the ante 50
RCABelVedeRVerd: posts the ante 50
Mimishka004: posts the ante 50
RtoG: posts the ante 50
Serghio2902: posts the ante 50
samax15: posts the ante 50
Serghio2902: posts small blind 350
samax15: posts big blind 700
*** HOLE CARDS ***
Dealt to jcarlos.vale [8c Kc]
sergucci82: folds 
xxMich@ilxx: raises 6141 to 6841 and is all-in
neebimozgi123: folds 
jcarlos.vale: folds 
RCABelVedeRVerd: calls 6841
Mimishka004: folds 
RtoG: folds 
Serghio2902: folds 
samax15 has timed out
samax15: folds 
samax15 is sitting out
*** FLOP *** [Qh 8h Td]
samax15 has returned
*** TURN *** [Qh 8h Td] [Js]
*** RIVER *** [Qh 8h Td Js] [9s]
*** SHOW DOWN ***
xxMich@ilxx: shows [8d 7c] (a straight, Eight to Queen)
RCABelVedeRVerd: shows [Jh As] (a straight, Eight to Queen)
xxMich@ilxx collected 7591 from pot
RCABelVedeRVerd collected 7591 from pot
*** SUMMARY ***
Total pot 15182 | Rake 0 
Board [Qh 8h Td Js 9s]
Seat 1: sergucci82 folded before Flop (didn't bet)
Seat 2: xxMich@ilxx showed [8d 7c] and won (7591) with a straight, Eight to Queen
Seat 3: neebimozgi123 folded before Flop (didn't bet)
Seat 4: jcarlos.vale folded before Flop (didn't bet)
Seat 5: RCABelVedeRVerd showed [Jh As] and won (7591) with a straight, Eight to Queen
Seat 6: Mimishka004 folded before Flop (didn't bet)
Seat 7: RtoG (button) folded before Flop (didn't bet)
Seat 8: Serghio2902 (small blind) folded before Flop
Seat 9: samax15 (big blind) folded before Flop



PokerStars Hand #222105945584: Tournament #3082583698, $0.98+$0.12 USD Hold'em No Limit - Level XV (350/700) - 2021/01/01 22:41:54 EET [2021/01/01 15:41:54 ET]
Table '3082583698 30' 9-max Seat #8 is the button
Seat 1: sergucci82 (13749 in chips) 
Seat 2: xxMich@ilxx (7591 in chips) 
Seat 3: neebimozgi123 (71144 in chips) 
Seat 4: jcarlos.vale (13346 in chips) 
Seat 5: RCABelVedeRVerd (16865 in chips) 
Seat 6: Mimishka004 (37668 in chips) 
Seat 7: RtoG (25581 in chips) 
Seat 8: Serghio2902 (11564 in chips) 
Seat 9: samax15 (9686 in chips) 
sergucci82: posts the ante 50
xxMich@ilxx: posts the ante 50
neebimozgi123: posts the ante 50
jcarlos.vale: posts the ante 50
RCABelVedeRVerd: posts the ante 50
Mimishka004: posts the ante 50
RtoG: posts the ante 50
Serghio2902: posts the ante 50
samax15: posts the ante 50
samax15: posts small blind 350
sergucci82: posts big blind 700
*** HOLE CARDS ***
Dealt to jcarlos.vale [9c 5d]
xxMich@ilxx: folds 
neebimozgi123: folds 
jcarlos.vale: folds 
RCABelVedeRVerd has timed out
RCABelVedeRVerd: folds 
RCABelVedeRVerd is sitting out
Mimishka004: folds 
RtoG: folds 
Serghio2902: folds 
RCABelVedeRVerd has returned
samax15 has timed out
samax15: folds 
samax15 is sitting out
Uncalled bet (350) returned to sergucci82
sergucci82 collected 1150 from pot
sergucci82: doesn't show hand 
*** SUMMARY ***
Total pot 1150 | Rake 0 
Seat 1: sergucci82 (big blind) collected (1150)
Seat 2: xxMich@ilxx folded before Flop (didn't bet)
Seat 3: neebimozgi123 folded before Flop (didn't bet)
Seat 4: jcarlos.vale folded before Flop (didn't bet)
Seat 5: RCABelVedeRVerd folded before Flop (didn't bet)
Seat 6: Mimishka004 folded before Flop (didn't bet)
Seat 7: RtoG folded before Flop (didn't bet)
Seat 8: Serghio2902 (button) folded before Flop (didn't bet)
Seat 9: samax15 (small blind) folded before Flop



PokerStars Hand #222105977701: Tournament #3082583698, $0.98+$0.12 USD Hold'em No Limit - Level XV (350/700) - 2021/01/01 22:42:31 EET [2021/01/01 15:42:31 ET]
Table '3082583698 30' 9-max Seat #9 is the button
Seat 1: sergucci82 (14499 in chips) 
Seat 2: xxMich@ilxx (7541 in chips) 
Seat 3: neebimozgi123 (71094 in chips) 
Seat 4: jcarlos.vale (13296 in chips) 
Seat 5: RCABelVedeRVerd (16815 in chips) 
Seat 6: Mimishka004 (37618 in chips) 
Seat 7: RtoG (25531 in chips) 
Seat 8: Serghio2902 (11514 in chips) 
Seat 9: samax15 (9286 in chips) is sitting out
sergucci82: posts the ante 50
xxMich@ilxx: posts the ante 50
neebimozgi123: posts the ante 50
jcarlos.vale: posts the ante 50
RCABelVedeRVerd: posts the ante 50
Mimishka004: posts the ante 50
RtoG: posts the ante 50
Serghio2902: posts the ante 50
samax15: posts the ante 50
sergucci82: posts small blind 350
xxMich@ilxx: posts big blind 700
*** HOLE CARDS ***
Dealt to jcarlos.vale [9c 3h]
samax15 has returned
neebimozgi123: calls 700
jcarlos.vale: folds 
RCABelVedeRVerd: calls 700
Mimishka004: calls 700
RtoG: folds 
Serghio2902: folds 
samax15 has timed out
samax15: folds 
samax15 is sitting out
samax15 has returned
sergucci82: folds 
xxMich@ilxx: checks 
*** FLOP *** [As 4c Ac]
xxMich@ilxx: checks 
neebimozgi123: bets 700
RCABelVedeRVerd: calls 700
Mimishka004: calls 700
xxMich@ilxx: folds 
*** TURN *** [As 4c Ac] [Ts]
neebimozgi123: bets 700
RCABelVedeRVerd: calls 700
Mimishka004: calls 700
*** RIVER *** [As 4c Ac Ts] [Kh]
neebimozgi123: bets 700
RCABelVedeRVerd: raises 4200 to 4900
Mimishka004: folds 
neebimozgi123: folds [Kc 6c]
Uncalled bet (4200) returned to RCABelVedeRVerd
RCABelVedeRVerd collected 9200 from pot
RCABelVedeRVerd: shows [Td Ad] (a full house, Aces full of Tens)
*** SUMMARY ***
Total pot 9200 | Rake 0 
Board [As 4c Ac Ts Kh]
Seat 1: sergucci82 (small blind) folded before Flop
Seat 2: xxMich@ilxx (big blind) folded on the Flop
Seat 3: neebimozgi123 folded on the River
Seat 4: jcarlos.vale folded before Flop (didn't bet)
Seat 5: RCABelVedeRVerd collected (9200)
Seat 6: Mimishka004 folded on the River
Seat 7: RtoG folded before Flop (didn't bet)
Seat 8: Serghio2902 folded before Flop (didn't bet)
Seat 9: samax15 (button) folded before Flop (didn't bet)



PokerStars Hand #222106074299: Tournament #3082583698, $0.98+$0.12 USD Hold'em No Limit - Level XV (350/700) - 2021/01/01 22:44:22 EET [2021/01/01 15:44:22 ET]
Table '3082583698 30' 9-max Seat #1 is the button
Seat 1: sergucci82 (14099 in chips) 
Seat 2: xxMich@ilxx (6791 in chips) 
Seat 3: neebimozgi123 (68244 in chips) 
Seat 4: jcarlos.vale (13246 in chips) 
Seat 5: RCABelVedeRVerd (23165 in chips) 
Seat 6: Mimishka004 (35468 in chips) 
Seat 7: RtoG (25481 in chips) 
Seat 8: Serghio2902 (11464 in chips) 
Seat 9: samax15 (9236 in chips) 
sergucci82: posts the ante 50
xxMich@ilxx: posts the ante 50
neebimozgi123: posts the ante 50
jcarlos.vale: posts the ante 50
RCABelVedeRVerd: posts the ante 50
Mimishka004: posts the ante 50
RtoG: posts the ante 50
Serghio2902: posts the ante 50
samax15: posts the ante 50
xxMich@ilxx: posts small blind 350
neebimozgi123: posts big blind 700
*** HOLE CARDS ***
Dealt to jcarlos.vale [6c 3d]
jcarlos.vale: folds 
RCABelVedeRVerd: folds 
Mimishka004: folds 
RtoG: folds 
Serghio2902: folds 
samax15 has timed out
samax15: folds 
samax15 is sitting out
sergucci82: folds 
samax15 has returned
xxMich@ilxx: calls 350
neebimozgi123: checks 
*** FLOP *** [4s Tc 5d]
xxMich@ilxx: checks 
neebimozgi123: checks 
*** TURN *** [4s Tc 5d] [9d]
xxMich@ilxx: bets 700
neebimozgi123: calls 700
*** RIVER *** [4s Tc 5d 9d] [6s]
xxMich@ilxx: bets 5341 and is all-in
neebimozgi123: folds 
Uncalled bet (5341) returned to xxMich@ilxx
xxMich@ilxx collected 3250 from pot
*** SUMMARY ***
Total pot 3250 | Rake 0 
Board [4s Tc 5d 9d 6s]
Seat 1: sergucci82 (button) folded before Flop (didn't bet)
Seat 2: xxMich@ilxx (small blind) collected (3250)
Seat 3: neebimozgi123 (big blind) folded on the River
Seat 4: jcarlos.vale folded before Flop (didn't bet)
Seat 5: RCABelVedeRVerd folded before Flop (didn't bet)
Seat 6: Mimishka004 folded before Flop (didn't bet)
Seat 7: RtoG folded before Flop (didn't bet)
Seat 8: Serghio2902 folded before Flop (didn't bet)
Seat 9: samax15 folded before Flop (didn't bet)



PokerStars Hand #222106143604: Tournament #3082583698, $0.98+$0.12 USD Hold'em No Limit - Level XVI (400/800) - 2021/01/01 22:45:43 EET [2021/01/01 15:45:43 ET]
Table '3082583698 30' 9-max Seat #2 is the button
Seat 1: sergucci82 (14049 in chips) 
Seat 2: xxMich@ilxx (8591 in chips) 
Seat 3: neebimozgi123 (66794 in chips) 
Seat 4: jcarlos.vale (13196 in chips) 
Seat 5: RCABelVedeRVerd (23115 in chips) 
Seat 6: Mimishka004 (35418 in chips) 
Seat 7: RtoG (25431 in chips) 
Seat 8: Serghio2902 (11414 in chips) 
Seat 9: samax15 (9186 in chips) 
sergucci82: posts the ante 65
xxMich@ilxx: posts the ante 65
neebimozgi123: posts the ante 65
jcarlos.vale: posts the ante 65
RCABelVedeRVerd: posts the ante 65
Mimishka004: posts the ante 65
RtoG: posts the ante 65
Serghio2902: posts the ante 65
samax15: posts the ante 65
neebimozgi123: posts small blind 400
jcarlos.vale: posts big blind 800
*** HOLE CARDS ***
Dealt to jcarlos.vale [Ac 9d]
RCABelVedeRVerd: folds 
Mimishka004: folds 
RtoG: folds 
Serghio2902: folds 
samax15: folds 
sergucci82: folds 
xxMich@ilxx: raises 7726 to 8526 and is all-in
neebimozgi123: folds 
jcarlos.vale: calls 7726
*** FLOP *** [9c Ks 7s]
*** TURN *** [9c Ks 7s] [Th]
*** RIVER *** [9c Ks 7s Th] [5c]
*** SHOW DOWN ***
jcarlos.vale: shows [Ac 9d] (a pair of Nines)
xxMich@ilxx: shows [5s Ad] (a pair of Fives)
jcarlos.vale collected 18037 from pot
xxMich@ilxx finished the tournament in 628th place
*** SUMMARY ***
Total pot 18037 | Rake 0 
Board [9c Ks 7s Th 5c]
Seat 1: sergucci82 folded before Flop (didn't bet)
Seat 2: xxMich@ilxx (button) showed [5s Ad] and lost with a pair of Fives
Seat 3: neebimozgi123 (small blind) folded before Flop
Seat 4: jcarlos.vale (big blind) showed [Ac 9d] and won (18037) with a pair of Nines
Seat 5: RCABelVedeRVerd folded before Flop (didn't bet)
Seat 6: Mimishka004 folded before Flop (didn't bet)
Seat 7: RtoG folded before Flop (didn't bet)
Seat 8: Serghio2902 folded before Flop (didn't bet)
Seat 9: samax15 folded before Flop (didn't bet)



PokerStars Hand #222106177770: Tournament #3082583698, $0.98+$0.12 USD Hold'em No Limit - Level XVI (400/800) - 2021/01/01 22:46:23 EET [2021/01/01 15:46:23 ET]
Table '3082583698 30' 9-max Seat #3 is the button
Seat 1: sergucci82 (13984 in chips) 
Seat 3: neebimozgi123 (66329 in chips) 
Seat 4: jcarlos.vale (22642 in chips) 
Seat 5: RCABelVedeRVerd (23050 in chips) 
Seat 6: Mimishka004 (35353 in chips) 
Seat 7: RtoG (25366 in chips) 
Seat 8: Serghio2902 (11349 in chips) 
Seat 9: samax15 (9121 in chips) 
sergucci82: posts the ante 65
neebimozgi123: posts the ante 65
jcarlos.vale: posts the ante 65
RCABelVedeRVerd: posts the ante 65
Mimishka004: posts the ante 65
RtoG: posts the ante 65
Serghio2902: posts the ante 65
samax15: posts the ante 65
jcarlos.vale: posts small blind 400
RCABelVedeRVerd: posts big blind 800
*** HOLE CARDS ***
Dealt to jcarlos.vale [9h Kh]
Mimishka004: raises 840 to 1640
RtoG: folds 
Serghio2902: folds 
samax15 has timed out
samax15: folds 
samax15 is sitting out
samax15 has returned
sergucci82: calls 1640
neebimozgi123: folds 
jcarlos.vale: folds 
RCABelVedeRVerd: folds 
*** FLOP *** [Ah Qs 9c]
Mimishka004: checks 
sergucci82: bets 12279 and is all-in
Mimishka004: calls 12279
*** TURN *** [Ah Qs 9c] [Td]
*** RIVER *** [Ah Qs 9c Td] [Ac]
*** SHOW DOWN ***
Mimishka004: shows [As Kd] (three of a kind, Aces)
sergucci82: shows [Qc Kc] (two pair, Aces and Queens)
Mimishka004 collected 29558 from pot
sergucci82 finished the tournament in 623rd place
*** SUMMARY ***
Total pot 29558 | Rake 0 
Board [Ah Qs 9c Td Ac]
Seat 1: sergucci82 showed [Qc Kc] and lost with two pair, Aces and Queens
Seat 3: neebimozgi123 (button) folded before Flop (didn't bet)
Seat 4: jcarlos.vale (small blind) folded before Flop
Seat 5: RCABelVedeRVerd (big blind) folded before Flop
Seat 6: Mimishka004 showed [As Kd] and won (29558) with three of a kind, Aces
Seat 7: RtoG folded before Flop (didn't bet)
Seat 8: Serghio2902 folded before Flop (didn't bet)
Seat 9: samax15 folded before Flop (didn't bet)



PokerStars Hand #222106237594: Tournament #3082583698, $0.98+$0.12 USD Hold'em No Limit - Level XVI (400/800) - 2021/01/01 22:47:24 EET [2021/01/01 15:47:24 ET]
Table '3082583698 30' 9-max Seat #4 is the button
Seat 1: DimaAlienKO (38975 in chips) 
Seat 2: Pisein31415 (12642 in chips) 
Seat 3: neebimozgi123 (66264 in chips) 
Seat 4: jcarlos.vale (22177 in chips) 
Seat 5: RCABelVedeRVerd (22185 in chips) 
Seat 6: Mimishka004 (50927 in chips) 
Seat 7: RtoG (25301 in chips) 
Seat 8: Serghio2902 (11284 in chips) 
Seat 9: samax15 (9056 in chips) 
DimaAlienKO: posts the ante 65
Pisein31415: posts the ante 65
neebimozgi123: posts the ante 65
jcarlos.vale: posts the ante 65
RCABelVedeRVerd: posts the ante 65
Mimishka004: posts the ante 65
RtoG: posts the ante 65
Serghio2902: posts the ante 65
samax15: posts the ante 65
RCABelVedeRVerd: posts small blind 400
Mimishka004: posts big blind 800
*** HOLE CARDS ***
Dealt to jcarlos.vale [Qc Ks]
RtoG: folds 
Serghio2902: folds 
samax15 has timed out
samax15: folds 
samax15 is sitting out
DimaAlienKO: folds 
Pisein31415: folds 
neebimozgi123: folds 
samax15 has returned
jcarlos.vale: raises 1280 to 2080
RCABelVedeRVerd: folds 
RCABelVedeRVerd is sitting out
Mimishka004: folds 
Uncalled bet (1280) returned to jcarlos.vale
jcarlos.vale collected 2585 from pot
jcarlos.vale: doesn't show hand 
*** SUMMARY ***
Total pot 2585 | Rake 0 
Seat 1: DimaAlienKO folded before Flop (didn't bet)
Seat 2: Pisein31415 folded before Flop (didn't bet)
Seat 3: neebimozgi123 folded before Flop (didn't bet)
Seat 4: jcarlos.vale (button) collected (2585)
Seat 5: RCABelVedeRVerd (small blind) folded before Flop
Seat 6: Mimishka004 (big blind) folded before Flop
Seat 7: RtoG folded before Flop (didn't bet)
Seat 8: Serghio2902 folded before Flop (didn't bet)
Seat 9: samax15 folded before Flop (didn't bet)



PokerStars Hand #222106265114: Tournament #3082583698, $0.98+$0.12 USD Hold'em No Limit - Level XVI (400/800) - 2021/01/01 22:47:56 EET [2021/01/01 15:47:56 ET]
Table '3082583698 30' 9-max Seat #5 is the button
Seat 1: DimaAlienKO (38910 in chips) 
Seat 2: Pisein31415 (12577 in chips) 
Seat 3: neebimozgi123 (66199 in chips) 
Seat 4: jcarlos.vale (23897 in chips) 
Seat 5: RCABelVedeRVerd (21720 in chips) is sitting out
Seat 6: Mimishka004 (50062 in chips) 
Seat 7: RtoG (25236 in chips) 
Seat 8: Serghio2902 (11219 in chips) 
Seat 9: samax15 (8991 in chips) 
DimaAlienKO: posts the ante 65
Pisein31415: posts the ante 65
neebimozgi123: posts the ante 65
jcarlos.vale: posts the ante 65
RCABelVedeRVerd: posts the ante 65
Mimishka004: posts the ante 65
RtoG: posts the ante 65
Serghio2902: posts the ante 65
samax15: posts the ante 65
Mimishka004: posts small blind 400
RtoG: posts big blind 800
*** HOLE CARDS ***
Dealt to jcarlos.vale [7c Ah]
Serghio2902: folds 
samax15 has timed out
samax15: folds 
samax15 is sitting out
samax15 has returned
DimaAlienKO: folds 
Pisein31415: folds 
neebimozgi123: raises 800 to 1600
jcarlos.vale: folds 
RCABelVedeRVerd: folds 
Mimishka004: raises 4000 to 5600
RtoG: folds 
neebimozgi123: folds 
Uncalled bet (4000) returned to Mimishka004
Mimishka004 collected 4585 from pot
*** SUMMARY ***
Total pot 4585 | Rake 0 
Seat 1: DimaAlienKO folded before Flop (didn't bet)
Seat 2: Pisein31415 folded before Flop (didn't bet)
Seat 3: neebimozgi123 folded before Flop
Seat 4: jcarlos.vale folded before Flop (didn't bet)
Seat 5: RCABelVedeRVerd (button) folded before Flop (didn't bet)
Seat 6: Mimishka004 (small blind) collected (4585)
Seat 7: RtoG (big blind) folded before Flop
Seat 8: Serghio2902 folded before Flop (didn't bet)
Seat 9: samax15 folded before Flop (didn't bet)



PokerStars Hand #222106315561: Tournament #3082583698, $0.98+$0.12 USD Hold'em No Limit - Level XVI (400/800) - 2021/01/01 22:48:55 EET [2021/01/01 15:48:55 ET]
Table '3082583698 30' 9-max Seat #6 is the button
Seat 1: DimaAlienKO (38845 in chips) 
Seat 2: Pisein31415 (12512 in chips) 
Seat 3: neebimozgi123 (64534 in chips) 
Seat 4: jcarlos.vale (23832 in chips) 
Seat 5: RCABelVedeRVerd (21655 in chips) is sitting out
Seat 6: Mimishka004 (52982 in chips) 
Seat 7: RtoG (24371 in chips) 
Seat 8: Serghio2902 (11154 in chips) 
Seat 9: samax15 (8926 in chips) 
DimaAlienKO: posts the ante 65
Pisein31415: posts the ante 65
neebimozgi123: posts the ante 65
jcarlos.vale: posts the ante 65
RCABelVedeRVerd: posts the ante 65
Mimishka004: posts the ante 65
RtoG: posts the ante 65
Serghio2902: posts the ante 65
samax15: posts the ante 65
RtoG: posts small blind 400
Serghio2902: posts big blind 800
*** HOLE CARDS ***
Dealt to jcarlos.vale [Js Tc]
samax15 has timed out
samax15: folds 
samax15 is sitting out
samax15 has returned
DimaAlienKO: folds 
Pisein31415: folds 
neebimozgi123: folds 
jcarlos.vale: folds 
RCABelVedeRVerd: folds 
Mimishka004: raises 840 to 1640
RtoG: folds 
Serghio2902: folds 
Uncalled bet (840) returned to Mimishka004
Mimishka004 collected 2585 from pot
*** SUMMARY ***
Total pot 2585 | Rake 0 
Seat 1: DimaAlienKO folded before Flop (didn't bet)
Seat 2: Pisein31415 folded before Flop (didn't bet)
Seat 3: neebimozgi123 folded before Flop (didn't bet)
Seat 4: jcarlos.vale folded before Flop (didn't bet)
Seat 5: RCABelVedeRVerd folded before Flop (didn't bet)
Seat 6: Mimishka004 (button) collected (2585)
Seat 7: RtoG (small blind) folded before Flop
Seat 8: Serghio2902 (big blind) folded before Flop
Seat 9: samax15 folded before Flop (didn't bet)



PokerStars Hand #222106345093: Tournament #3082583698, $0.98+$0.12 USD Hold'em No Limit - Level XVI (400/800) - 2021/01/01 22:49:30 EET [2021/01/01 15:49:30 ET]
Table '3082583698 30' 9-max Seat #7 is the button
Seat 1: DimaAlienKO (38780 in chips) 
Seat 2: Pisein31415 (12447 in chips) 
Seat 3: neebimozgi123 (64469 in chips) 
Seat 4: jcarlos.vale (23767 in chips) 
Seat 5: RCABelVedeRVerd (21590 in chips) is sitting out
Seat 6: Mimishka004 (54702 in chips) 
Seat 7: RtoG (23906 in chips) 
Seat 8: Serghio2902 (10289 in chips) 
Seat 9: samax15 (8861 in chips) 
DimaAlienKO: posts the ante 65
Pisein31415: posts the ante 65
neebimozgi123: posts the ante 65
jcarlos.vale: posts the ante 65
RCABelVedeRVerd: posts the ante 65
Mimishka004: posts the ante 65
RtoG: posts the ante 65
Serghio2902: posts the ante 65
samax15: posts the ante 65
Serghio2902: posts small blind 400
samax15: posts big blind 800
*** HOLE CARDS ***
Dealt to jcarlos.vale [7h Qh]
DimaAlienKO: raises 800 to 1600
Pisein31415: folds 
neebimozgi123: folds 
jcarlos.vale: folds 
RCABelVedeRVerd: folds 
Mimishka004: folds 
RtoG: calls 1600
Serghio2902: folds 
samax15: folds 
*** FLOP *** [4c Ks Tc]
DimaAlienKO: bets 1600
RtoG: raises 2400 to 4000
DimaAlienKO: calls 2400
*** TURN *** [4c Ks Tc] [As]
DimaAlienKO: checks 
RtoG: checks 
*** RIVER *** [4c Ks Tc As] [Td]
DimaAlienKO: checks 
RtoG: bets 5692
DimaAlienKO: calls 5692
*** SHOW DOWN ***
RtoG: shows [4h Kh] (two pair, Kings and Tens)
DimaAlienKO: shows [Kc Qc] (two pair, Kings and Tens)
DimaAlienKO collected 12185 from pot
RtoG collected 12184 from pot
*** SUMMARY ***
Total pot 24369 | Rake 0 
Board [4c Ks Tc As Td]
Seat 1: DimaAlienKO showed [Kc Qc] and won (12185) with two pair, Kings and Tens
Seat 2: Pisein31415 folded before Flop (didn't bet)
Seat 3: neebimozgi123 folded before Flop (didn't bet)
Seat 4: jcarlos.vale folded before Flop (didn't bet)
Seat 5: RCABelVedeRVerd folded before Flop (didn't bet)
Seat 6: Mimishka004 folded before Flop (didn't bet)
Seat 7: RtoG (button) showed [4h Kh] and won (12184) with two pair, Kings and Tens
Seat 8: Serghio2902 (small blind) folded before Flop
Seat 9: samax15 (big blind) folded before Flop



PokerStars Hand #222106407216: Tournament #3082583698, $0.98+$0.12 USD Hold'em No Limit - Level XVI (400/800) - 2021/01/01 22:50:44 EET [2021/01/01 15:50:44 ET]
Table '3082583698 30' 9-max Seat #8 is the button
Seat 1: DimaAlienKO (39608 in chips) 
Seat 2: Pisein31415 (12382 in chips) 
Seat 3: neebimozgi123 (64404 in chips) 
Seat 4: jcarlos.vale (23702 in chips) 
Seat 5: RCABelVedeRVerd (21525 in chips) is sitting out
Seat 6: Mimishka004 (54637 in chips) 
Seat 7: RtoG (24733 in chips) 
Seat 8: Serghio2902 (9824 in chips) 
Seat 9: samax15 (7996 in chips) 
DimaAlienKO: posts the ante 65
Pisein31415: posts the ante 65
neebimozgi123: posts the ante 65
jcarlos.vale: posts the ante 65
RCABelVedeRVerd: posts the ante 65
Mimishka004: posts the ante 65
RtoG: posts the ante 65
Serghio2902: posts the ante 65
samax15: posts the ante 65
samax15: posts small blind 400
DimaAlienKO: posts big blind 800
*** HOLE CARDS ***
Dealt to jcarlos.vale [8c 5s]
Pisein31415: folds 
neebimozgi123: folds 
jcarlos.vale: folds 
RCABelVedeRVerd: folds 
Mimishka004: folds 
RtoG: folds 
Serghio2902: folds 
samax15 has timed out
samax15: folds 
samax15 is sitting out
Uncalled bet (400) returned to DimaAlienKO
DimaAlienKO collected 1385 from pot
DimaAlienKO: doesn't show hand 
samax15 has returned
*** SUMMARY ***
Total pot 1385 | Rake 0 
Seat 1: DimaAlienKO (big blind) collected (1385)
Seat 2: Pisein31415 folded before Flop (didn't bet)
Seat 3: neebimozgi123 folded before Flop (didn't bet)
Seat 4: jcarlos.vale folded before Flop (didn't bet)
Seat 5: RCABelVedeRVerd folded before Flop (didn't bet)
Seat 6: Mimishka004 folded before Flop (didn't bet)
Seat 7: RtoG folded before Flop (didn't bet)
Seat 8: Serghio2902 (button) folded before Flop (didn't bet)
Seat 9: samax15 (small blind) folded before Flop



PokerStars Hand #222106434466: Tournament #3082583698, $0.98+$0.12 USD Hold'em No Limit - Level XVI (400/800) - 2021/01/01 22:51:16 EET [2021/01/01 15:51:16 ET]
Table '3082583698 30' 9-max Seat #9 is the button
Seat 1: DimaAlienKO (40528 in chips) 
Seat 2: Pisein31415 (12317 in chips) 
Seat 3: neebimozgi123 (64339 in chips) 
Seat 4: jcarlos.vale (23637 in chips) 
Seat 5: RCABelVedeRVerd (21460 in chips) is sitting out
Seat 6: Mimishka004 (54572 in chips) 
Seat 7: RtoG (24668 in chips) 
Seat 8: Serghio2902 (9759 in chips) 
Seat 9: samax15 (7531 in chips) 
DimaAlienKO: posts the ante 65
Pisein31415: posts the ante 65
neebimozgi123: posts the ante 65
jcarlos.vale: posts the ante 65
RCABelVedeRVerd: posts the ante 65
Mimishka004: posts the ante 65
RtoG: posts the ante 65
Serghio2902: posts the ante 65
samax15: posts the ante 65
DimaAlienKO: posts small blind 400
Pisein31415: posts big blind 800
*** HOLE CARDS ***
Dealt to jcarlos.vale [6c 8h]
neebimozgi123: folds 
jcarlos.vale has timed out
jcarlos.vale: folds 
jcarlos.vale is sitting out
RCABelVedeRVerd: folds 
Mimishka004: folds 
RtoG: folds 
Serghio2902: folds 
jcarlos.vale has returned
samax15: folds 
DimaAlienKO: calls 400
Pisein31415: raises 11452 to 12252 and is all-in
DimaAlienKO: folds 
Uncalled bet (11452) returned to Pisein31415
Pisein31415 collected 2185 from pot
Pisein31415: doesn't show hand 
*** SUMMARY ***
Total pot 2185 | Rake 0 
Seat 1: DimaAlienKO (small blind) folded before Flop
Seat 2: Pisein31415 (big blind) collected (2185)
Seat 3: neebimozgi123 folded before Flop (didn't bet)
Seat 4: jcarlos.vale folded before Flop (didn't bet)
Seat 5: RCABelVedeRVerd folded before Flop (didn't bet)
Seat 6: Mimishka004 folded before Flop (didn't bet)
Seat 7: RtoG folded before Flop (didn't bet)
Seat 8: Serghio2902 folded before Flop (didn't bet)
Seat 9: samax15 (button) folded before Flop (didn't bet)



PokerStars Hand #222106470409: Tournament #3082583698, $0.98+$0.12 USD Hold'em No Limit - Level XVI (400/800) - 2021/01/01 22:51:59 EET [2021/01/01 15:51:59 ET]
Table '3082583698 30' 9-max Seat #1 is the button
Seat 1: DimaAlienKO (39663 in chips) 
Seat 2: Pisein31415 (13637 in chips) 
Seat 3: neebimozgi123 (64274 in chips) 
Seat 4: jcarlos.vale (23572 in chips) 
Seat 5: RCABelVedeRVerd (21395 in chips) is sitting out
Seat 6: Mimishka004 (54507 in chips) 
Seat 7: RtoG (24603 in chips) 
Seat 8: Serghio2902 (9694 in chips) 
Seat 9: samax15 (7466 in chips) 
DimaAlienKO: posts the ante 65
Pisein31415: posts the ante 65
neebimozgi123: posts the ante 65
jcarlos.vale: posts the ante 65
RCABelVedeRVerd: posts the ante 65
Mimishka004: posts the ante 65
RtoG: posts the ante 65
Serghio2902: posts the ante 65
samax15: posts the ante 65
Pisein31415: posts small blind 400
neebimozgi123: posts big blind 800
*** HOLE CARDS ***
Dealt to jcarlos.vale [Qc Kc]
jcarlos.vale: raises 1280 to 2080
RCABelVedeRVerd: folds 
Mimishka004: folds 
RtoG: folds 
Serghio2902: folds 
samax15 has timed out
samax15: folds 
samax15 is sitting out
DimaAlienKO: folds 
Pisein31415: folds 
neebimozgi123: folds 
Uncalled bet (1280) returned to jcarlos.vale
samax15 has returned
jcarlos.vale collected 2585 from pot
jcarlos.vale: doesn't show hand 
*** SUMMARY ***
Total pot 2585 | Rake 0 
Seat 1: DimaAlienKO (button) folded before Flop (didn't bet)
Seat 2: Pisein31415 (small blind) folded before Flop
Seat 3: neebimozgi123 (big blind) folded before Flop
Seat 4: jcarlos.vale collected (2585)
Seat 5: RCABelVedeRVerd folded before Flop (didn't bet)
Seat 6: Mimishka004 folded before Flop (didn't bet)
Seat 7: RtoG folded before Flop (didn't bet)
Seat 8: Serghio2902 folded before Flop (didn't bet)
Seat 9: samax15 folded before Flop (didn't bet)



PokerStars Hand #222106491996: Tournament #3082583698, $0.98+$0.12 USD Hold'em No Limit - Level XVI (400/800) - 2021/01/01 22:52:24 EET [2021/01/01 15:52:24 ET]
Table '3082583698 30' 9-max Seat #2 is the button
Seat 1: DimaAlienKO (39598 in chips) 
Seat 2: Pisein31415 (13172 in chips) 
Seat 3: neebimozgi123 (63409 in chips) 
Seat 4: jcarlos.vale (25292 in chips) 
Seat 5: RCABelVedeRVerd (21330 in chips) is sitting out
Seat 6: Mimishka004 (54442 in chips) 
Seat 7: RtoG (24538 in chips) 
Seat 8: Serghio2902 (9629 in chips) 
Seat 9: samax15 (7401 in chips) 
DimaAlienKO: posts the ante 65
Pisein31415: posts the ante 65
neebimozgi123: posts the ante 65
jcarlos.vale: posts the ante 65
RCABelVedeRVerd: posts the ante 65
Mimishka004: posts the ante 65
RtoG: posts the ante 65
Serghio2902: posts the ante 65
samax15: posts the ante 65
neebimozgi123: posts small blind 400
jcarlos.vale: posts big blind 800
*** HOLE CARDS ***
Dealt to jcarlos.vale [Ts 7h]
RCABelVedeRVerd: folds 
Mimishka004: folds 
RtoG: raises 1600 to 2400
Serghio2902: folds 
samax15: folds 
DimaAlienKO: folds 
Pisein31415: raises 10707 to 13107 and is all-in
neebimozgi123: folds 
jcarlos.vale: folds 
RtoG: calls 10707
*** FLOP *** [2s 6h 9s]
*** TURN *** [2s 6h 9s] [8d]
*** RIVER *** [2s 6h 9s 8d] [Ad]
*** SHOW DOWN ***
RtoG: shows [Jh Th] (high card Ace)
Pisein31415: shows [Kc Ac] (a pair of Aces)
Pisein31415 collected 27999 from pot
*** SUMMARY ***
Total pot 27999 | Rake 0 
Board [2s 6h 9s 8d Ad]
Seat 1: DimaAlienKO folded before Flop (didn't bet)
Seat 2: Pisein31415 (button) showed [Kc Ac] and won (27999) with a pair of Aces
Seat 3: neebimozgi123 (small blind) folded before Flop
Seat 4: jcarlos.vale (big blind) folded before Flop
Seat 5: RCABelVedeRVerd folded before Flop (didn't bet)
Seat 6: Mimishka004 folded before Flop (didn't bet)
Seat 7: RtoG showed [Jh Th] and lost with high card Ace
Seat 8: Serghio2902 folded before Flop (didn't bet)
Seat 9: samax15 folded before Flop (didn't bet)



PokerStars Hand #222106527796: Tournament #3082583698, $0.98+$0.12 USD Hold'em No Limit - Level XVI (400/800) - 2021/01/01 22:53:07 EET [2021/01/01 15:53:07 ET]
Table '3082583698 30' 9-max Seat #3 is the button
Seat 1: DimaAlienKO (39533 in chips) 
Seat 2: Pisein31415 (27999 in chips) 
Seat 3: neebimozgi123 (62944 in chips) 
Seat 4: jcarlos.vale (24427 in chips) 
Seat 5: RCABelVedeRVerd (21265 in chips) is sitting out
Seat 6: Mimishka004 (54377 in chips) 
Seat 7: RtoG (11366 in chips) 
Seat 8: Serghio2902 (9564 in chips) 
Seat 9: samax15 (7336 in chips) 
DimaAlienKO: posts the ante 65
Pisein31415: posts the ante 65
neebimozgi123: posts the ante 65
jcarlos.vale: posts the ante 65
RCABelVedeRVerd: posts the ante 65
Mimishka004: posts the ante 65
RtoG: posts the ante 65
Serghio2902: posts the ante 65
samax15: posts the ante 65
jcarlos.vale: posts small blind 400
RCABelVedeRVerd: posts big blind 800
*** HOLE CARDS ***
Dealt to jcarlos.vale [6s 7c]
Mimishka004: folds 
RtoG: folds 
Serghio2902: folds 
samax15 has timed out
samax15: folds 
samax15 is sitting out
DimaAlienKO: raises 800 to 1600
Pisein31415: folds 
neebimozgi123: calls 1600
jcarlos.vale: folds 
RCABelVedeRVerd: folds 
*** FLOP *** [9d 2c 4c]
DimaAlienKO: checks 
neebimozgi123: bets 800
DimaAlienKO: calls 800
*** TURN *** [9d 2c 4c] [8d]
samax15 has returned
DimaAlienKO: checks 
neebimozgi123: checks 
*** RIVER *** [9d 2c 4c 8d] [7s]
DimaAlienKO: checks 
neebimozgi123: bets 1600
DimaAlienKO: folds 
Uncalled bet (1600) returned to neebimozgi123
neebimozgi123 collected 6585 from pot
*** SUMMARY ***
Total pot 6585 | Rake 0 
Board [9d 2c 4c 8d 7s]
Seat 1: DimaAlienKO folded on the River
Seat 2: Pisein31415 folded before Flop (didn't bet)
Seat 3: neebimozgi123 (button) collected (6585)
Seat 4: jcarlos.vale (small blind) folded before Flop
Seat 5: RCABelVedeRVerd (big blind) folded before Flop
Seat 6: Mimishka004 folded before Flop (didn't bet)
Seat 7: RtoG folded before Flop (didn't bet)
Seat 8: Serghio2902 folded before Flop (didn't bet)
Seat 9: samax15 folded before Flop (didn't bet)



PokerStars Hand #222106593113: Tournament #3082583698, $0.98+$0.12 USD Hold'em No Limit - Level XVI (400/800) - 2021/01/01 22:54:25 EET [2021/01/01 15:54:25 ET]
Table '3082583698 30' 9-max Seat #4 is the button
Seat 1: DimaAlienKO (37068 in chips) 
Seat 2: Pisein31415 (27934 in chips) 
Seat 3: neebimozgi123 (67064 in chips) 
Seat 4: jcarlos.vale (23962 in chips) 
Seat 5: RCABelVedeRVerd (20400 in chips) is sitting out
Seat 6: Mimishka004 (54312 in chips) 
Seat 7: RtoG (11301 in chips) 
Seat 8: Serghio2902 (9499 in chips) 
Seat 9: samax15 (7271 in chips) 
DimaAlienKO: posts the ante 65
Pisein31415: posts the ante 65
neebimozgi123: posts the ante 65
jcarlos.vale: posts the ante 65
RCABelVedeRVerd: posts the ante 65
Mimishka004: posts the ante 65
RtoG: posts the ante 65
Serghio2902: posts the ante 65
samax15: posts the ante 65
RCABelVedeRVerd: posts small blind 400
Mimishka004: posts big blind 800
*** HOLE CARDS ***
Dealt to jcarlos.vale [Qs Th]
RtoG: raises 800 to 1600
Serghio2902: calls 1600
samax15 has timed out
samax15: folds 
samax15 is sitting out
DimaAlienKO: folds 
Pisein31415: folds 
neebimozgi123: folds 
jcarlos.vale: folds 
RCABelVedeRVerd: folds 
samax15 has returned
Mimishka004: calls 800
*** FLOP *** [3h Kc 9c]
Mimishka004: checks 
RtoG: bets 1600
Serghio2902: folds 
Mimishka004: folds 
Uncalled bet (1600) returned to RtoG
RtoG collected 5785 from pot
RtoG: doesn't show hand 
*** SUMMARY ***
Total pot 5785 | Rake 0 
Board [3h Kc 9c]
Seat 1: DimaAlienKO folded before Flop (didn't bet)
Seat 2: Pisein31415 folded before Flop (didn't bet)
Seat 3: neebimozgi123 folded before Flop (didn't bet)
Seat 4: jcarlos.vale (button) folded before Flop (didn't bet)
Seat 5: RCABelVedeRVerd (small blind) folded before Flop
Seat 6: Mimishka004 (big blind) folded on the Flop
Seat 7: RtoG collected (5785)
Seat 8: Serghio2902 folded on the Flop
Seat 9: samax15 folded before Flop (didn't bet)



PokerStars Hand #222106832927: Tournament #3082583698, $0.98+$0.12 USD Hold'em No Limit - Level XVII (500/1000) - 2021/01/01 23:01:53 EET [2021/01/01 16:01:53 ET]
Table '3082583698 30' 9-max Seat #5 is the button
Seat 1: DimaAlienKO (37003 in chips) 
Seat 2: Pisein31415 (27869 in chips) 
Seat 3: neebimozgi123 (66999 in chips) 
Seat 4: jcarlos.vale (23897 in chips) 
Seat 5: RCABelVedeRVerd (19935 in chips) 
Seat 6: Mimishka004 (52647 in chips) 
Seat 7: RtoG (15421 in chips) 
Seat 8: Serghio2902 (7834 in chips) 
Seat 9: samax15 (7206 in chips) 
DimaAlienKO: posts the ante 75
Pisein31415: posts the ante 75
neebimozgi123: posts the ante 75
jcarlos.vale: posts the ante 75
RCABelVedeRVerd: posts the ante 75
Mimishka004: posts the ante 75
RtoG: posts the ante 75
Serghio2902: posts the ante 75
samax15: posts the ante 75
Mimishka004: posts small blind 500
RtoG: posts big blind 1000
*** HOLE CARDS ***
Dealt to jcarlos.vale [4d 7c]
neebimozgi123 has returned
Serghio2902: folds 
neebimozgi123 has returned
samax15 has timed out
samax15: folds 
samax15 is sitting out
DimaAlienKO: folds 
Pisein31415: raises 1000 to 2000
neebimozgi123: calls 2000
jcarlos.vale: folds 
RCABelVedeRVerd: folds 
Mimishka004: folds 
samax15 has returned
RtoG: calls 1000
*** FLOP *** [6c 4h 6d]
RtoG: bets 2000
Pisein31415: folds 
neebimozgi123: calls 2000
*** TURN *** [6c 4h 6d] [Qc]
RtoG: bets 3000
neebimozgi123: folds 
Uncalled bet (3000) returned to RtoG
RtoG collected 11175 from pot
RtoG: doesn't show hand 
*** SUMMARY ***
Total pot 11175 | Rake 0 
Board [6c 4h 6d Qc]
Seat 1: DimaAlienKO folded before Flop (didn't bet)
Seat 2: Pisein31415 folded on the Flop
Seat 3: neebimozgi123 folded on the Turn
Seat 4: jcarlos.vale folded before Flop (didn't bet)
Seat 5: RCABelVedeRVerd (button) folded before Flop (didn't bet)
Seat 6: Mimishka004 (small blind) folded before Flop
Seat 7: RtoG (big blind) collected (11175)
Seat 8: Serghio2902 folded before Flop (didn't bet)
Seat 9: samax15 folded before Flop (didn't bet)



PokerStars Hand #222106910501: Tournament #3082583698, $0.98+$0.12 USD Hold'em No Limit - Level XVII (500/1000) - 2021/01/01 23:03:35 EET [2021/01/01 16:03:35 ET]
Table '3082583698 30' 9-max Seat #6 is the button
Seat 1: DimaAlienKO (36928 in chips) 
Seat 2: Pisein31415 (25794 in chips) 
Seat 3: neebimozgi123 (62924 in chips) 
Seat 4: jcarlos.vale (23822 in chips) 
Seat 5: RCABelVedeRVerd (19860 in chips) 
Seat 6: Mimishka004 (52072 in chips) 
Seat 7: RtoG (22521 in chips) 
Seat 8: Serghio2902 (7759 in chips) 
Seat 9: samax15 (7131 in chips) 
DimaAlienKO: posts the ante 75
Pisein31415: posts the ante 75
neebimozgi123: posts the ante 75
jcarlos.vale: posts the ante 75
RCABelVedeRVerd: posts the ante 75
Mimishka004: posts the ante 75
RtoG: posts the ante 75
Serghio2902: posts the ante 75
samax15: posts the ante 75
RtoG: posts small blind 500
Serghio2902: posts big blind 1000
*** HOLE CARDS ***
Dealt to jcarlos.vale [Ts 8d]
samax15: folds 
DimaAlienKO: folds 
Pisein31415: folds 
neebimozgi123: folds 
neebimozgi123 is sitting out
jcarlos.vale: folds 
RCABelVedeRVerd: folds 
Mimishka004: raises 21000 to 22000
RtoG: folds 
Serghio2902: folds 
Uncalled bet (21000) returned to Mimishka004
Mimishka004 collected 3175 from pot
*** SUMMARY ***
Total pot 3175 | Rake 0 
Seat 1: DimaAlienKO folded before Flop (didn't bet)
Seat 2: Pisein31415 folded before Flop (didn't bet)
Seat 3: neebimozgi123 folded before Flop (didn't bet)
Seat 4: jcarlos.vale folded before Flop (didn't bet)
Seat 5: RCABelVedeRVerd folded before Flop (didn't bet)
Seat 6: Mimishka004 (button) collected (3175)
Seat 7: RtoG (small blind) folded before Flop
Seat 8: Serghio2902 (big blind) folded before Flop
Seat 9: samax15 folded before Flop (didn't bet)



PokerStars Hand #222106991418: Tournament #3082583698, $0.98+$0.12 USD Hold'em No Limit - Level XVII (500/1000) - 2021/01/01 23:05:08 EET [2021/01/01 16:05:08 ET]
Table '3082583698 30' 9-max Seat #7 is the button
Seat 1: DimaAlienKO (36853 in chips) 
Seat 2: Pisein31415 (25719 in chips) 
Seat 3: neebimozgi123 (62849 in chips) is sitting out
Seat 4: jcarlos.vale (23747 in chips) 
Seat 5: RCABelVedeRVerd (19785 in chips) 
Seat 6: Mimishka004 (54172 in chips) 
Seat 7: RtoG (21946 in chips) 
Seat 8: Serghio2902 (6684 in chips) 
Seat 9: samax15 (7056 in chips) 
DimaAlienKO: posts the ante 75
Pisein31415: posts the ante 75
neebimozgi123: posts the ante 75
jcarlos.vale: posts the ante 75
RCABelVedeRVerd: posts the ante 75
Mimishka004: posts the ante 75
RtoG: posts the ante 75
Serghio2902: posts the ante 75
samax15: posts the ante 75
Serghio2902: posts small blind 500
samax15: posts big blind 1000
*** HOLE CARDS ***
Dealt to jcarlos.vale [Js Qs]
DimaAlienKO: folds 
Pisein31415: folds 
neebimozgi123: folds 
jcarlos.vale: raises 1600 to 2600
RCABelVedeRVerd: folds 
Mimishka004: folds 
RtoG: folds 
Serghio2902: folds 
samax15: folds 
Uncalled bet (1600) returned to jcarlos.vale
jcarlos.vale collected 3175 from pot
jcarlos.vale: doesn't show hand 
*** SUMMARY ***
Total pot 3175 | Rake 0 
Seat 1: DimaAlienKO folded before Flop (didn't bet)
Seat 2: Pisein31415 folded before Flop (didn't bet)
Seat 3: neebimozgi123 folded before Flop (didn't bet)
Seat 4: jcarlos.vale collected (3175)
Seat 5: RCABelVedeRVerd folded before Flop (didn't bet)
Seat 6: Mimishka004 folded before Flop (didn't bet)
Seat 7: RtoG (button) folded before Flop (didn't bet)
Seat 8: Serghio2902 (small blind) folded before Flop
Seat 9: samax15 (big blind) folded before Flop



PokerStars Hand #222107023947: Tournament #3082583698, $0.98+$0.12 USD Hold'em No Limit - Level XVII (500/1000) - 2021/01/01 23:05:46 EET [2021/01/01 16:05:46 ET]
Table '3082583698 30' 9-max Seat #8 is the button
Seat 1: DimaAlienKO (36778 in chips) 
Seat 2: Pisein31415 (25644 in chips) 
Seat 3: neebimozgi123 (62774 in chips) is sitting out
Seat 4: jcarlos.vale (25847 in chips) 
Seat 5: RCABelVedeRVerd (19710 in chips) 
Seat 6: Mimishka004 (54097 in chips) 
Seat 7: RtoG (21871 in chips) 
Seat 8: Serghio2902 (6109 in chips) 
Seat 9: samax15 (5981 in chips) 
DimaAlienKO: posts the ante 75
Pisein31415: posts the ante 75
neebimozgi123: posts the ante 75
jcarlos.vale: posts the ante 75
RCABelVedeRVerd: posts the ante 75
Mimishka004: posts the ante 75
RtoG: posts the ante 75
Serghio2902: posts the ante 75
samax15: posts the ante 75
samax15: posts small blind 500
DimaAlienKO: posts big blind 1000
*** HOLE CARDS ***
Dealt to jcarlos.vale [5d 8h]
Pisein31415: folds 
neebimozgi123: folds 
jcarlos.vale: folds 
RCABelVedeRVerd: folds 
Mimishka004: folds 
RtoG: folds 
Serghio2902: folds 
samax15 has timed out
samax15: folds 
samax15 is sitting out
Uncalled bet (500) returned to DimaAlienKO
DimaAlienKO collected 1675 from pot
DimaAlienKO: doesn't show hand 
samax15 has returned
*** SUMMARY ***
Total pot 1675 | Rake 0 
Seat 1: DimaAlienKO (big blind) collected (1675)
Seat 2: Pisein31415 folded before Flop (didn't bet)
Seat 3: neebimozgi123 folded before Flop (didn't bet)
Seat 4: jcarlos.vale folded before Flop (didn't bet)
Seat 5: RCABelVedeRVerd folded before Flop (didn't bet)
Seat 6: Mimishka004 folded before Flop (didn't bet)
Seat 7: RtoG folded before Flop (didn't bet)
Seat 8: Serghio2902 (button) folded before Flop (didn't bet)
Seat 9: samax15 (small blind) folded before Flop



PokerStars Hand #222107072720: Tournament #3082583698, $0.98+$0.12 USD Hold'em No Limit - Level XVII (500/1000) - 2021/01/01 23:06:42 EET [2021/01/01 16:06:42 ET]
Table '3082583698 30' 9-max Seat #9 is the button
Seat 1: DimaAlienKO (37878 in chips) 
Seat 2: Pisein31415 (25569 in chips) 
Seat 3: neebimozgi123 (62699 in chips) is sitting out
Seat 4: jcarlos.vale (25772 in chips) 
Seat 5: RCABelVedeRVerd (19635 in chips) 
Seat 6: Mimishka004 (54022 in chips) 
Seat 7: RtoG (21796 in chips) 
Seat 8: Serghio2902 (6034 in chips) 
Seat 9: samax15 (5406 in chips) 
DimaAlienKO: posts the ante 75
Pisein31415: posts the ante 75
neebimozgi123: posts the ante 75
jcarlos.vale: posts the ante 75
RCABelVedeRVerd: posts the ante 75
Mimishka004: posts the ante 75
RtoG: posts the ante 75
Serghio2902: posts the ante 75
samax15: posts the ante 75
DimaAlienKO: posts small blind 500
Pisein31415: posts big blind 1000
*** HOLE CARDS ***
Dealt to jcarlos.vale [4h Kc]
neebimozgi123: folds 
jcarlos.vale: folds 
RCABelVedeRVerd: folds 
Mimishka004: folds 
RtoG: folds 
Serghio2902: raises 4959 to 5959 and is all-in
samax15 has timed out
samax15: folds 
samax15 is sitting out
samax15 has returned
DimaAlienKO: folds 
Pisein31415: folds 
Uncalled bet (4959) returned to Serghio2902
Serghio2902 collected 3175 from pot
*** SUMMARY ***
Total pot 3175 | Rake 0 
Seat 1: DimaAlienKO (small blind) folded before Flop
Seat 2: Pisein31415 (big blind) folded before Flop
Seat 3: neebimozgi123 folded before Flop (didn't bet)
Seat 4: jcarlos.vale folded before Flop (didn't bet)
Seat 5: RCABelVedeRVerd folded before Flop (didn't bet)
Seat 6: Mimishka004 folded before Flop (didn't bet)
Seat 7: RtoG folded before Flop (didn't bet)
Seat 8: Serghio2902 collected (3175)
Seat 9: samax15 (button) folded before Flop (didn't bet)



PokerStars Hand #222107122180: Tournament #3082583698, $0.98+$0.12 USD Hold'em No Limit - Level XVII (500/1000) - 2021/01/01 23:07:39 EET [2021/01/01 16:07:39 ET]
Table '3082583698 30' 9-max Seat #1 is the button
Seat 1: DimaAlienKO (37303 in chips) 
Seat 2: Pisein31415 (24494 in chips) 
Seat 3: neebimozgi123 (62624 in chips) is sitting out
Seat 4: jcarlos.vale (25697 in chips) 
Seat 5: RCABelVedeRVerd (19560 in chips) 
Seat 6: Mimishka004 (53947 in chips) 
Seat 7: RtoG (21721 in chips) 
Seat 8: Serghio2902 (8134 in chips) 
Seat 9: samax15 (5331 in chips) 
DimaAlienKO: posts the ante 75
Pisein31415: posts the ante 75
neebimozgi123: posts the ante 75
jcarlos.vale: posts the ante 75
RCABelVedeRVerd: posts the ante 75
Mimishka004: posts the ante 75
RtoG: posts the ante 75
Serghio2902: posts the ante 75
samax15: posts the ante 75
Pisein31415: posts small blind 500
neebimozgi123: posts big blind 1000
*** HOLE CARDS ***
Dealt to jcarlos.vale [Qc Qs]
jcarlos.vale: raises 1600 to 2600
RCABelVedeRVerd: folds 
Mimishka004: folds 
RtoG: folds 
Serghio2902: raises 5459 to 8059 and is all-in
samax15 has timed out
samax15: folds 
samax15 is sitting out
DimaAlienKO: folds 
Pisein31415: folds 
neebimozgi123: folds 
samax15 has returned
jcarlos.vale: calls 5459
*** FLOP *** [Kd 3d 9s]
*** TURN *** [Kd 3d 9s] [7c]
*** RIVER *** [Kd 3d 9s 7c] [5s]
*** SHOW DOWN ***
jcarlos.vale: shows [Qc Qs] (a pair of Queens)
Serghio2902: shows [Ac Qd] (high card Ace)
jcarlos.vale collected 18293 from pot
Serghio2902 finished the tournament in 521st place and received $1.80.
*** SUMMARY ***
Total pot 18293 | Rake 0 
Board [Kd 3d 9s 7c 5s]
Seat 1: DimaAlienKO (button) folded before Flop (didn't bet)
Seat 2: Pisein31415 (small blind) folded before Flop
Seat 3: neebimozgi123 (big blind) folded before Flop
Seat 4: jcarlos.vale showed [Qc Qs] and won (18293) with a pair of Queens
Seat 5: RCABelVedeRVerd folded before Flop (didn't bet)
Seat 6: Mimishka004 folded before Flop (didn't bet)
Seat 7: RtoG folded before Flop (didn't bet)
Seat 8: Serghio2902 showed [Ac Qd] and lost with high card Ace
Seat 9: samax15 folded before Flop (didn't bet)



PokerStars Hand #222107153769: Tournament #3082583698, $0.98+$0.12 USD Hold'em No Limit - Level XVII (500/1000) - 2021/01/01 23:08:16 EET [2021/01/01 16:08:16 ET]
Table '3082583698 30' 9-max Seat #2 is the button
Seat 1: DimaAlienKO (37228 in chips) 
Seat 2: Pisein31415 (23919 in chips) 
Seat 3: neebimozgi123 (61549 in chips) is sitting out
Seat 4: jcarlos.vale (35856 in chips) 
Seat 5: RCABelVedeRVerd (19485 in chips) 
Seat 6: Mimishka004 (53872 in chips) 
Seat 7: RtoG (21646 in chips) 
Seat 9: samax15 (5256 in chips) 
DimaAlienKO: posts the ante 75
Pisein31415: posts the ante 75
neebimozgi123: posts the ante 75
jcarlos.vale: posts the ante 75
RCABelVedeRVerd: posts the ante 75
Mimishka004: posts the ante 75
RtoG: posts the ante 75
samax15: posts the ante 75
neebimozgi123: posts small blind 500
jcarlos.vale: posts big blind 1000
*** HOLE CARDS ***
Dealt to jcarlos.vale [Tc 5d]
RCABelVedeRVerd: folds 
Mimishka004: raises 1050 to 2050
RtoG: folds 
samax15: folds 
DimaAlienKO: folds 
Pisein31415: folds 
neebimozgi123: folds 
jcarlos.vale: folds 
Uncalled bet (1050) returned to Mimishka004
Mimishka004 collected 3100 from pot
*** SUMMARY ***
Total pot 3100 | Rake 0 
Seat 1: DimaAlienKO folded before Flop (didn't bet)
Seat 2: Pisein31415 (button) folded before Flop (didn't bet)
Seat 3: neebimozgi123 (small blind) folded before Flop
Seat 4: jcarlos.vale (big blind) folded before Flop
Seat 5: RCABelVedeRVerd folded before Flop (didn't bet)
Seat 6: Mimishka004 collected (3100)
Seat 7: RtoG folded before Flop (didn't bet)
Seat 9: samax15 folded before Flop (didn't bet)



PokerStars Hand #222107180723: Tournament #3082583698, $0.98+$0.12 USD Hold'em No Limit - Level XVII (500/1000) - 2021/01/01 23:08:47 EET [2021/01/01 16:08:47 ET]
Table '3082583698 30' 9-max Seat #3 is the button
Seat 1: DimaAlienKO (37153 in chips) 
Seat 2: Pisein31415 (23844 in chips) 
Seat 3: neebimozgi123 (60974 in chips) is sitting out
Seat 4: jcarlos.vale (34781 in chips) 
Seat 5: RCABelVedeRVerd (19410 in chips) 
Seat 6: Mimishka004 (55897 in chips) 
Seat 7: RtoG (21571 in chips) 
Seat 8: calve88 (29420 in chips) 
Seat 9: samax15 (5181 in chips) 
DimaAlienKO: posts the ante 75
Pisein31415: posts the ante 75
neebimozgi123: posts the ante 75
jcarlos.vale: posts the ante 75
RCABelVedeRVerd: posts the ante 75
Mimishka004: posts the ante 75
RtoG: posts the ante 75
calve88: posts the ante 75
samax15: posts the ante 75
jcarlos.vale: posts small blind 500
RCABelVedeRVerd: posts big blind 1000
*** HOLE CARDS ***
Dealt to jcarlos.vale [Jc Ah]
Mimishka004: folds 
RtoG: folds 
calve88: folds 
samax15: folds 
DimaAlienKO: folds 
Pisein31415: folds 
neebimozgi123: folds 
jcarlos.vale: raises 1600 to 2600
RCABelVedeRVerd: calls 1600
*** FLOP *** [3s Qc Tc]
jcarlos.vale: bets 2000
RCABelVedeRVerd: calls 2000
*** TURN *** [3s Qc Tc] [8s]
jcarlos.vale: checks 
RCABelVedeRVerd: bets 14735 and is all-in
jcarlos.vale: folds 
Uncalled bet (14735) returned to RCABelVedeRVerd
RCABelVedeRVerd collected 9875 from pot
*** SUMMARY ***
Total pot 9875 | Rake 0 
Board [3s Qc Tc 8s]
Seat 1: DimaAlienKO folded before Flop (didn't bet)
Seat 2: Pisein31415 folded before Flop (didn't bet)
Seat 3: neebimozgi123 (button) folded before Flop (didn't bet)
Seat 4: jcarlos.vale (small blind) folded on the Turn
Seat 5: RCABelVedeRVerd (big blind) collected (9875)
Seat 6: Mimishka004 folded before Flop (didn't bet)
Seat 7: RtoG folded before Flop (didn't bet)
Seat 8: calve88 folded before Flop (didn't bet)
Seat 9: samax15 folded before Flop (didn't bet)



PokerStars Hand #222107238068: Tournament #3082583698, $0.98+$0.12 USD Hold'em No Limit - Level XVII (500/1000) - 2021/01/01 23:09:54 EET [2021/01/01 16:09:54 ET]
Table '3082583698 30' 9-max Seat #4 is the button
Seat 1: DimaAlienKO (37078 in chips) 
Seat 2: Pisein31415 (23769 in chips) 
Seat 3: neebimozgi123 (60899 in chips) is sitting out
Seat 4: jcarlos.vale (30106 in chips) 
Seat 5: RCABelVedeRVerd (24610 in chips) 
Seat 6: Mimishka004 (55822 in chips) 
Seat 7: RtoG (21496 in chips) 
Seat 8: calve88 (29345 in chips) 
Seat 9: samax15 (5106 in chips) 
DimaAlienKO: posts the ante 75
Pisein31415: posts the ante 75
neebimozgi123: posts the ante 75
jcarlos.vale: posts the ante 75
RCABelVedeRVerd: posts the ante 75
Mimishka004: posts the ante 75
RtoG: posts the ante 75
calve88: posts the ante 75
samax15: posts the ante 75
RCABelVedeRVerd: posts small blind 500
Mimishka004: posts big blind 1000
*** HOLE CARDS ***
Dealt to jcarlos.vale [4h 7s]
RtoG: folds 
calve88: folds 
samax15 has timed out
samax15: folds 
samax15 is sitting out
DimaAlienKO: folds 
Pisein31415: folds 
neebimozgi123: folds 
jcarlos.vale: folds 
samax15 has returned
RCABelVedeRVerd: calls 500
Mimishka004: checks 
*** FLOP *** [Kd 5h Qd]
RCABelVedeRVerd: checks 
Mimishka004: checks 
*** TURN *** [Kd 5h Qd] [5s]
RCABelVedeRVerd: bets 1000
Mimishka004: folds 
Uncalled bet (1000) returned to RCABelVedeRVerd
RCABelVedeRVerd collected 2675 from pot
*** SUMMARY ***
Total pot 2675 | Rake 0 
Board [Kd 5h Qd 5s]
Seat 1: DimaAlienKO folded before Flop (didn't bet)
Seat 2: Pisein31415 folded before Flop (didn't bet)
Seat 3: neebimozgi123 folded before Flop (didn't bet)
Seat 4: jcarlos.vale (button) folded before Flop (didn't bet)
Seat 5: RCABelVedeRVerd (small blind) collected (2675)
Seat 6: Mimishka004 (big blind) folded on the Turn
Seat 7: RtoG folded before Flop (didn't bet)
Seat 8: calve88 folded before Flop (didn't bet)
Seat 9: samax15 folded before Flop (didn't bet)



PokerStars Hand #222107268242: Tournament #3082583698, $0.98+$0.12 USD Hold'em No Limit - Level XVII (500/1000) - 2021/01/01 23:10:29 EET [2021/01/01 16:10:29 ET]
Table '3082583698 30' 9-max Seat #5 is the button
Seat 1: DimaAlienKO (37003 in chips) 
Seat 2: Pisein31415 (23694 in chips) 
Seat 3: neebimozgi123 (60824 in chips) is sitting out
Seat 4: jcarlos.vale (30031 in chips) 
Seat 5: RCABelVedeRVerd (26210 in chips) 
Seat 6: Mimishka004 (54747 in chips) 
Seat 7: RtoG (21421 in chips) 
Seat 8: calve88 (29270 in chips) 
Seat 9: samax15 (5031 in chips) 
DimaAlienKO: posts the ante 75
Pisein31415: posts the ante 75
neebimozgi123: posts the ante 75
jcarlos.vale: posts the ante 75
RCABelVedeRVerd: posts the ante 75
Mimishka004: posts the ante 75
RtoG: posts the ante 75
calve88: posts the ante 75
samax15: posts the ante 75
Mimishka004: posts small blind 500
RtoG: posts big blind 1000
*** HOLE CARDS ***
Dealt to jcarlos.vale [As 9c]
calve88: raises 2000 to 3000
samax15: folds 
DimaAlienKO: folds 
Pisein31415: folds 
neebimozgi123: folds 
jcarlos.vale: folds 
RCABelVedeRVerd: folds 
Mimishka004: folds 
neebimozgi123 has returned
RtoG: calls 2000
*** FLOP *** [6d 7s Ks]
RtoG: checks 
calve88: bets 2368
RtoG: calls 2368
*** TURN *** [6d 7s Ks] [2d]
RtoG: checks 
calve88: bets 11911
RtoG: calls 11911
*** RIVER *** [6d 7s Ks 2d] [8s]
RtoG: bets 4067 and is all-in
calve88: calls 4067
*** SHOW DOWN ***
RtoG: shows [Td 9d] (a straight, Six to Ten)
calve88: shows [Ts Tc] (a pair of Tens)
RtoG collected 43867 from pot
*** SUMMARY ***
Total pot 43867 | Rake 0 
Board [6d 7s Ks 2d 8s]
Seat 1: DimaAlienKO folded before Flop (didn't bet)
Seat 2: Pisein31415 folded before Flop (didn't bet)
Seat 3: neebimozgi123 folded before Flop (didn't bet)
Seat 4: jcarlos.vale folded before Flop (didn't bet)
Seat 5: RCABelVedeRVerd (button) folded before Flop (didn't bet)
Seat 6: Mimishka004 (small blind) folded before Flop
Seat 7: RtoG (big blind) showed [Td 9d] and won (43867) with a straight, Six to Ten
Seat 8: calve88 showed [Ts Tc] and lost with a pair of Tens
Seat 9: samax15 folded before Flop (didn't bet)



PokerStars Hand #222107320231: Tournament #3082583698, $0.98+$0.12 USD Hold'em No Limit - Level XVIII (600/1200) - 2021/01/01 23:11:29 EET [2021/01/01 16:11:29 ET]
Table '3082583698 30' 9-max Seat #6 is the button
Seat 1: DimaAlienKO (36928 in chips) 
Seat 2: Pisein31415 (23619 in chips) 
Seat 3: neebimozgi123 (60749 in chips) 
Seat 4: jcarlos.vale (29956 in chips) 
Seat 5: RCABelVedeRVerd (26135 in chips) 
Seat 6: Mimishka004 (54172 in chips) 
Seat 7: RtoG (43867 in chips) 
Seat 8: calve88 (7849 in chips) 
Seat 9: samax15 (4956 in chips) 
DimaAlienKO: posts the ante 90
Pisein31415: posts the ante 90
neebimozgi123: posts the ante 90
jcarlos.vale: posts the ante 90
RCABelVedeRVerd: posts the ante 90
Mimishka004: posts the ante 90
RtoG: posts the ante 90
calve88: posts the ante 90
samax15: posts the ante 90
RtoG: posts small blind 600
calve88: posts big blind 1200
*** HOLE CARDS ***
Dealt to jcarlos.vale [Td 9c]
samax15 has timed out
samax15: folds 
samax15 is sitting out
DimaAlienKO: folds 
samax15 has returned
Pisein31415: raises 1200 to 2400
neebimozgi123: folds 
jcarlos.vale: folds 
RCABelVedeRVerd: folds 
Mimishka004: calls 2400
RtoG: folds 
calve88: folds 
*** FLOP *** [Th 5h 9h]
Pisein31415: checks 
Mimishka004: checks 
*** TURN *** [Th 5h 9h] [Tc]
Pisein31415: bets 3600
Mimishka004: folds 
Uncalled bet (3600) returned to Pisein31415
Pisein31415 collected 7410 from pot
Pisein31415: doesn't show hand 
*** SUMMARY ***
Total pot 7410 | Rake 0 
Board [Th 5h 9h Tc]
Seat 1: DimaAlienKO folded before Flop (didn't bet)
Seat 2: Pisein31415 collected (7410)
Seat 3: neebimozgi123 folded before Flop (didn't bet)
Seat 4: jcarlos.vale folded before Flop (didn't bet)
Seat 5: RCABelVedeRVerd folded before Flop (didn't bet)
Seat 6: Mimishka004 (button) folded on the Turn
Seat 7: RtoG (small blind) folded before Flop
Seat 8: calve88 (big blind) folded before Flop
Seat 9: samax15 folded before Flop (didn't bet)



PokerStars Hand #222107355416: Tournament #3082583698, $0.98+$0.12 USD Hold'em No Limit - Level XVIII (600/1200) - 2021/01/01 23:12:09 EET [2021/01/01 16:12:09 ET]
Table '3082583698 30' 9-max Seat #7 is the button
Seat 1: DimaAlienKO (36838 in chips) 
Seat 2: Pisein31415 (28539 in chips) 
Seat 3: neebimozgi123 (60659 in chips) 
Seat 4: jcarlos.vale (29866 in chips) 
Seat 5: RCABelVedeRVerd (26045 in chips) 
Seat 6: Mimishka004 (51682 in chips) 
Seat 7: RtoG (43177 in chips) 
Seat 8: calve88 (6559 in chips) 
Seat 9: samax15 (4866 in chips) 
DimaAlienKO: posts the ante 90
Pisein31415: posts the ante 90
neebimozgi123: posts the ante 90
jcarlos.vale: posts the ante 90
RCABelVedeRVerd: posts the ante 90
Mimishka004: posts the ante 90
RtoG: posts the ante 90
calve88: posts the ante 90
samax15: posts the ante 90
calve88: posts small blind 600
samax15: posts big blind 1200
*** HOLE CARDS ***
Dealt to jcarlos.vale [5h 8c]
DimaAlienKO: raises 1200 to 2400
Pisein31415: folds 
neebimozgi123: folds 
jcarlos.vale: folds 
RCABelVedeRVerd: folds 
Mimishka004: folds 
RtoG: folds 
calve88: folds 
samax15: folds 
Uncalled bet (1200) returned to DimaAlienKO
DimaAlienKO collected 3810 from pot
DimaAlienKO: doesn't show hand 
*** SUMMARY ***
Total pot 3810 | Rake 0 
Seat 1: DimaAlienKO collected (3810)
Seat 2: Pisein31415 folded before Flop (didn't bet)
Seat 3: neebimozgi123 folded before Flop (didn't bet)
Seat 4: jcarlos.vale folded before Flop (didn't bet)
Seat 5: RCABelVedeRVerd folded before Flop (didn't bet)
Seat 6: Mimishka004 folded before Flop (didn't bet)
Seat 7: RtoG (button) folded before Flop (didn't bet)
Seat 8: calve88 (small blind) folded before Flop
Seat 9: samax15 (big blind) folded before Flop



PokerStars Hand #222107390523: Tournament #3082583698, $0.98+$0.12 USD Hold'em No Limit - Level XVIII (600/1200) - 2021/01/01 23:12:50 EET [2021/01/01 16:12:50 ET]
Table '3082583698 30' 9-max Seat #8 is the button
Seat 1: DimaAlienKO (39358 in chips) 
Seat 2: Pisein31415 (28449 in chips) 
Seat 3: neebimozgi123 (60569 in chips) 
Seat 4: jcarlos.vale (29776 in chips) 
Seat 5: RCABelVedeRVerd (25955 in chips) 
Seat 6: Mimishka004 (51592 in chips) 
Seat 7: RtoG (43087 in chips) 
Seat 8: calve88 (5869 in chips) 
Seat 9: samax15 (3576 in chips) 
DimaAlienKO: posts the ante 90
Pisein31415: posts the ante 90
neebimozgi123: posts the ante 90
jcarlos.vale: posts the ante 90
RCABelVedeRVerd: posts the ante 90
Mimishka004: posts the ante 90
RtoG: posts the ante 90
calve88: posts the ante 90
samax15: posts the ante 90
samax15: posts small blind 600
DimaAlienKO: posts big blind 1200
*** HOLE CARDS ***
Dealt to jcarlos.vale [8s 4s]
Pisein31415: folds 
neebimozgi123: folds 
neebimozgi123 is sitting out
jcarlos.vale: folds 
RCABelVedeRVerd: folds 
Mimishka004: folds 
RtoG: raises 1200 to 2400
calve88: folds 
samax15 has timed out
samax15: folds 
samax15 is sitting out
DimaAlienKO: calls 1200
*** FLOP *** [6h 2s Kd]
samax15 has returned
DimaAlienKO: checks 
RtoG: bets 3600
DimaAlienKO: calls 3600
*** TURN *** [6h 2s Kd] [9d]
DimaAlienKO: checks 
RtoG: bets 6000
DimaAlienKO: calls 6000
*** RIVER *** [6h 2s Kd 9d] [Js]
DimaAlienKO: checks 
RtoG: checks 
*** SHOW DOWN ***
DimaAlienKO: shows [Kc 8c] (a pair of Kings)
RtoG: shows [Tc Kh] (a pair of Kings - Jack+Ten kicker)
RtoG collected 25410 from pot
*** SUMMARY ***
Total pot 25410 | Rake 0 
Board [6h 2s Kd 9d Js]
Seat 1: DimaAlienKO (big blind) showed [Kc 8c] and lost with a pair of Kings
Seat 2: Pisein31415 folded before Flop (didn't bet)
Seat 3: neebimozgi123 folded before Flop (didn't bet)
Seat 4: jcarlos.vale folded before Flop (didn't bet)
Seat 5: RCABelVedeRVerd folded before Flop (didn't bet)
Seat 6: Mimishka004 folded before Flop (didn't bet)
Seat 7: RtoG showed [Tc Kh] and won (25410) with a pair of Kings
Seat 8: calve88 (button) folded before Flop (didn't bet)
Seat 9: samax15 (small blind) folded before Flop



PokerStars Hand #222107452998: Tournament #3082583698, $0.98+$0.12 USD Hold'em No Limit - Level XVIII (600/1200) - 2021/01/01 23:13:57 EET [2021/01/01 16:13:57 ET]
Table '3082583698 30' 9-max Seat #9 is the button
Seat 1: DimaAlienKO (27268 in chips) 
Seat 2: Pisein31415 (28359 in chips) 
Seat 3: neebimozgi123 (60479 in chips) is sitting out
Seat 4: jcarlos.vale (29686 in chips) 
Seat 5: RCABelVedeRVerd (25865 in chips) 
Seat 6: Mimishka004 (51502 in chips) 
Seat 7: RtoG (56407 in chips) 
Seat 8: calve88 (5779 in chips) 
Seat 9: samax15 (2886 in chips) 
DimaAlienKO: posts the ante 90
Pisein31415: posts the ante 90
neebimozgi123: posts the ante 90
jcarlos.vale: posts the ante 90
RCABelVedeRVerd: posts the ante 90
Mimishka004: posts the ante 90
RtoG: posts the ante 90
calve88: posts the ante 90
samax15: posts the ante 90
DimaAlienKO: posts small blind 600
Pisein31415: posts big blind 1200
*** HOLE CARDS ***
Dealt to jcarlos.vale [2d Th]
neebimozgi123: folds 
jcarlos.vale: folds 
RCABelVedeRVerd: folds 
Mimishka004: folds 
RtoG: folds 
calve88: raises 4489 to 5689 and is all-in
samax15: folds 
DimaAlienKO: folds 
Pisein31415: calls 4489
neebimozgi123 has returned
*** FLOP *** [Tc 3c 3d]
*** TURN *** [Tc 3c 3d] [Qs]
*** RIVER *** [Tc 3c 3d Qs] [Td]
*** SHOW DOWN ***
Pisein31415: shows [Ad Jh] (two pair, Tens and Threes)
calve88: shows [Qd 9h] (two pair, Queens and Tens)
calve88 collected 12788 from pot
*** SUMMARY ***
Total pot 12788 | Rake 0 
Board [Tc 3c 3d Qs Td]
Seat 1: DimaAlienKO (small blind) folded before Flop
Seat 2: Pisein31415 (big blind) showed [Ad Jh] and lost with two pair, Tens and Threes
Seat 3: neebimozgi123 folded before Flop (didn't bet)
Seat 4: jcarlos.vale folded before Flop (didn't bet)
Seat 5: RCABelVedeRVerd folded before Flop (didn't bet)
Seat 6: Mimishka004 folded before Flop (didn't bet)
Seat 7: RtoG folded before Flop (didn't bet)
Seat 8: calve88 showed [Qd 9h] and won (12788) with two pair, Queens and Tens
Seat 9: samax15 (button) folded before Flop (didn't bet)



PokerStars Hand #222107486710: Tournament #3082583698, $0.98+$0.12 USD Hold'em No Limit - Level XVIII (600/1200) - 2021/01/01 23:14:36 EET [2021/01/01 16:14:36 ET]
Table '3082583698 30' 9-max Seat #1 is the button
Seat 1: DimaAlienKO (26578 in chips) 
Seat 2: Pisein31415 (22580 in chips) 
Seat 3: neebimozgi123 (60389 in chips) 
Seat 4: jcarlos.vale (29596 in chips) 
Seat 5: RCABelVedeRVerd (25775 in chips) 
Seat 6: Mimishka004 (51412 in chips) 
Seat 7: RtoG (56317 in chips) 
Seat 8: calve88 (12788 in chips) 
Seat 9: samax15 (2796 in chips) 
DimaAlienKO: posts the ante 90
Pisein31415: posts the ante 90
neebimozgi123: posts the ante 90
jcarlos.vale: posts the ante 90
RCABelVedeRVerd: posts the ante 90
Mimishka004: posts the ante 90
RtoG: posts the ante 90
calve88: posts the ante 90
samax15: posts the ante 90
Pisein31415: posts small blind 600
neebimozgi123: posts big blind 1200
*** HOLE CARDS ***
Dealt to jcarlos.vale [Ac 6h]
jcarlos.vale: folds 
RCABelVedeRVerd: folds 
Mimishka004: folds 
RtoG: folds 
calve88: folds 
samax15: folds 
DimaAlienKO: folds 
Pisein31415: calls 600
neebimozgi123: checks 
*** FLOP *** [7d Ad Td]
Pisein31415: bets 1200
neebimozgi123: folds 
Uncalled bet (1200) returned to Pisein31415
Pisein31415 collected 3210 from pot
Pisein31415: doesn't show hand 
*** SUMMARY ***
Total pot 3210 | Rake 0 
Board [7d Ad Td]
Seat 1: DimaAlienKO (button) folded before Flop (didn't bet)
Seat 2: Pisein31415 (small blind) collected (3210)
Seat 3: neebimozgi123 (big blind) folded on the Flop
Seat 4: jcarlos.vale folded before Flop (didn't bet)
Seat 5: RCABelVedeRVerd folded before Flop (didn't bet)
Seat 6: Mimishka004 folded before Flop (didn't bet)
Seat 7: RtoG folded before Flop (didn't bet)
Seat 8: calve88 folded before Flop (didn't bet)
Seat 9: samax15 folded before Flop (didn't bet)



PokerStars Hand #222107538431: Tournament #3082583698, $0.98+$0.12 USD Hold'em No Limit - Level XVIII (600/1200) - 2021/01/01 23:15:35 EET [2021/01/01 16:15:35 ET]
Table '3082583698 30' 9-max Seat #2 is the button
Seat 1: DimaAlienKO (26488 in chips) 
Seat 2: Pisein31415 (24500 in chips) 
Seat 3: neebimozgi123 (59099 in chips) 
Seat 4: jcarlos.vale (29506 in chips) 
Seat 5: RCABelVedeRVerd (25685 in chips) 
Seat 6: Mimishka004 (51322 in chips) 
Seat 7: RtoG (56227 in chips) 
Seat 8: calve88 (12698 in chips) 
Seat 9: samax15 (2706 in chips) 
DimaAlienKO: posts the ante 90
Pisein31415: posts the ante 90
neebimozgi123: posts the ante 90
jcarlos.vale: posts the ante 90
RCABelVedeRVerd: posts the ante 90
Mimishka004: posts the ante 90
RtoG: posts the ante 90
calve88: posts the ante 90
samax15: posts the ante 90
neebimozgi123: posts small blind 600
jcarlos.vale: posts big blind 1200
*** HOLE CARDS ***
Dealt to jcarlos.vale [3d Kd]
RCABelVedeRVerd: folds 
Mimishka004: folds 
RtoG: raises 1200 to 2400
calve88: folds 
samax15: folds 
DimaAlienKO: folds 
Pisein31415: calls 2400
neebimozgi123: folds 
jcarlos.vale: folds 
*** FLOP *** [9d 8c 9c]
RtoG: bets 3600
Pisein31415: folds 
Uncalled bet (3600) returned to RtoG
RtoG collected 7410 from pot
RtoG: doesn't show hand 
*** SUMMARY ***
Total pot 7410 | Rake 0 
Board [9d 8c 9c]
Seat 1: DimaAlienKO folded before Flop (didn't bet)
Seat 2: Pisein31415 (button) folded on the Flop
Seat 3: neebimozgi123 (small blind) folded before Flop
Seat 4: jcarlos.vale (big blind) folded before Flop
Seat 5: RCABelVedeRVerd folded before Flop (didn't bet)
Seat 6: Mimishka004 folded before Flop (didn't bet)
Seat 7: RtoG collected (7410)
Seat 8: calve88 folded before Flop (didn't bet)
Seat 9: samax15 folded before Flop (didn't bet)



PokerStars Hand #222107594345: Tournament #3082583698, $0.98+$0.12 USD Hold'em No Limit - Level XVIII (600/1200) - 2021/01/01 23:16:37 EET [2021/01/01 16:16:37 ET]
Table '3082583698 30' 9-max Seat #3 is the button
Seat 1: DimaAlienKO (26398 in chips) 
Seat 2: Pisein31415 (22010 in chips) 
Seat 3: neebimozgi123 (58409 in chips) 
Seat 4: jcarlos.vale (28216 in chips) 
Seat 5: RCABelVedeRVerd (25595 in chips) 
Seat 6: Mimishka004 (51232 in chips) 
Seat 7: RtoG (61147 in chips) 
Seat 8: calve88 (12608 in chips) 
Seat 9: samax15 (2616 in chips) 
DimaAlienKO: posts the ante 90
Pisein31415: posts the ante 90
neebimozgi123: posts the ante 90
jcarlos.vale: posts the ante 90
RCABelVedeRVerd: posts the ante 90
Mimishka004: posts the ante 90
RtoG: posts the ante 90
calve88: posts the ante 90
samax15: posts the ante 90
jcarlos.vale: posts small blind 600
RCABelVedeRVerd: posts big blind 1200
*** HOLE CARDS ***
Dealt to jcarlos.vale [9h 7c]
Mimishka004: folds 
RtoG: folds 
calve88: raises 11318 to 12518 and is all-in
samax15 has timed out
samax15: folds 
samax15 is sitting out
DimaAlienKO: folds 
Pisein31415: folds 
neebimozgi123: folds 
jcarlos.vale: folds 
samax15 has returned
RCABelVedeRVerd: folds 
Uncalled bet (11318) returned to calve88
calve88 collected 3810 from pot
calve88: doesn't show hand 
*** SUMMARY ***
Total pot 3810 | Rake 0 
Seat 1: DimaAlienKO folded before Flop (didn't bet)
Seat 2: Pisein31415 folded before Flop (didn't bet)
Seat 3: neebimozgi123 (button) folded before Flop (didn't bet)
Seat 4: jcarlos.vale (small blind) folded before Flop
Seat 5: RCABelVedeRVerd (big blind) folded before Flop
Seat 6: Mimishka004 folded before Flop (didn't bet)
Seat 7: RtoG folded before Flop (didn't bet)
Seat 8: calve88 collected (3810)
Seat 9: samax15 folded before Flop (didn't bet)



PokerStars Hand #222107626426: Tournament #3082583698, $0.98+$0.12 USD Hold'em No Limit - Level XVIII (600/1200) - 2021/01/01 23:17:14 EET [2021/01/01 16:17:14 ET]
Table '3082583698 30' 9-max Seat #4 is the button
Seat 1: DimaAlienKO (26308 in chips) 
Seat 2: Pisein31415 (21920 in chips) 
Seat 3: neebimozgi123 (58319 in chips) 
Seat 4: jcarlos.vale (27526 in chips) 
Seat 5: RCABelVedeRVerd (24305 in chips) 
Seat 6: Mimishka004 (51142 in chips) 
Seat 7: RtoG (61057 in chips) 
Seat 8: calve88 (15128 in chips) 
Seat 9: samax15 (2526 in chips) 
DimaAlienKO: posts the ante 90
Pisein31415: posts the ante 90
neebimozgi123: posts the ante 90
jcarlos.vale: posts the ante 90
RCABelVedeRVerd: posts the ante 90
Mimishka004: posts the ante 90
RtoG: posts the ante 90
calve88: posts the ante 90
samax15: posts the ante 90
RCABelVedeRVerd: posts small blind 600
Mimishka004: posts big blind 1200
*** HOLE CARDS ***
Dealt to jcarlos.vale [9c 6s]
RtoG: folds 
calve88: folds 
samax15 has timed out
samax15: folds 
samax15 is sitting out
samax15 has returned
DimaAlienKO: raises 1200 to 2400
Pisein31415: folds 
neebimozgi123: folds 
jcarlos.vale: folds 
RCABelVedeRVerd: folds 
Mimishka004: calls 1200
*** FLOP *** [Ks As Qh]
Mimishka004: checks 
DimaAlienKO: bets 2400
Mimishka004: calls 2400
*** TURN *** [Ks As Qh] [7d]
Mimishka004: checks 
DimaAlienKO: bets 3600
Mimishka004: folds 
Uncalled bet (3600) returned to DimaAlienKO
DimaAlienKO collected 11010 from pot
DimaAlienKO: doesn't show hand 
*** SUMMARY ***
Total pot 11010 | Rake 0 
Board [Ks As Qh 7d]
Seat 1: DimaAlienKO collected (11010)
Seat 2: Pisein31415 folded before Flop (didn't bet)
Seat 3: neebimozgi123 folded before Flop (didn't bet)
Seat 4: jcarlos.vale (button) folded before Flop (didn't bet)
Seat 5: RCABelVedeRVerd (small blind) folded before Flop
Seat 6: Mimishka004 (big blind) folded on the Turn
Seat 7: RtoG folded before Flop (didn't bet)
Seat 8: calve88 folded before Flop (didn't bet)
Seat 9: samax15 folded before Flop (didn't bet)



PokerStars Hand #222107693716: Tournament #3082583698, $0.98+$0.12 USD Hold'em No Limit - Level XVIII (600/1200) - 2021/01/01 23:18:29 EET [2021/01/01 16:18:29 ET]
Table '3082583698 30' 9-max Seat #5 is the button
Seat 1: DimaAlienKO (32428 in chips) 
Seat 2: Pisein31415 (21830 in chips) 
Seat 3: neebimozgi123 (58229 in chips) 
Seat 4: jcarlos.vale (27436 in chips) 
Seat 5: RCABelVedeRVerd (23615 in chips) 
Seat 6: Mimishka004 (46252 in chips) 
Seat 7: RtoG (60967 in chips) 
Seat 8: calve88 (15038 in chips) 
Seat 9: samax15 (2436 in chips) 
DimaAlienKO: posts the ante 90
Pisein31415: posts the ante 90
neebimozgi123: posts the ante 90
jcarlos.vale: posts the ante 90
RCABelVedeRVerd: posts the ante 90
Mimishka004: posts the ante 90
RtoG: posts the ante 90
calve88: posts the ante 90
samax15: posts the ante 90
Mimishka004: posts small blind 600
RtoG: posts big blind 1200
*** HOLE CARDS ***
Dealt to jcarlos.vale [Ah 4c]
calve88: folds 
samax15 has timed out
samax15: folds 
samax15 is sitting out
DimaAlienKO: folds 
Pisein31415: folds 
neebimozgi123: folds 
samax15 has returned
jcarlos.vale has timed out
jcarlos.vale: folds 
jcarlos.vale is sitting out
RCABelVedeRVerd: folds 
Mimishka004: folds 
Uncalled bet (600) returned to RtoG
jcarlos.vale has returned
RtoG collected 2010 from pot
RtoG: doesn't show hand 
*** SUMMARY ***
Total pot 2010 | Rake 0 
Seat 1: DimaAlienKO folded before Flop (didn't bet)
Seat 2: Pisein31415 folded before Flop (didn't bet)
Seat 3: neebimozgi123 folded before Flop (didn't bet)
Seat 4: jcarlos.vale folded before Flop (didn't bet)
Seat 5: RCABelVedeRVerd (button) folded before Flop (didn't bet)
Seat 6: Mimishka004 (small blind) folded before Flop
Seat 7: RtoG (big blind) collected (2010)
Seat 8: calve88 folded before Flop (didn't bet)
Seat 9: samax15 folded before Flop (didn't bet)



PokerStars Hand #222107727858: Tournament #3082583698, $0.98+$0.12 USD Hold'em No Limit - Level XVIII (600/1200) - 2021/01/01 23:19:08 EET [2021/01/01 16:19:08 ET]
Table '3082583698 30' 9-max Seat #6 is the button
Seat 1: DimaAlienKO (32338 in chips) 
Seat 2: Pisein31415 (21740 in chips) 
Seat 3: neebimozgi123 (58139 in chips) 
Seat 4: jcarlos.vale (27346 in chips) 
Seat 5: RCABelVedeRVerd (23525 in chips) 
Seat 6: Mimishka004 (45562 in chips) 
Seat 7: RtoG (62287 in chips) 
Seat 8: calve88 (14948 in chips) 
Seat 9: samax15 (2346 in chips) 
DimaAlienKO: posts the ante 90
Pisein31415: posts the ante 90
neebimozgi123: posts the ante 90
jcarlos.vale: posts the ante 90
RCABelVedeRVerd: posts the ante 90
Mimishka004: posts the ante 90
RtoG: posts the ante 90
calve88: posts the ante 90
samax15: posts the ante 90
RtoG: posts small blind 600
calve88: posts big blind 1200
*** HOLE CARDS ***
Dealt to jcarlos.vale [6d 3h]
samax15 has timed out
samax15: folds 
samax15 is sitting out
DimaAlienKO: folds 
Pisein31415: raises 1200 to 2400
samax15 has returned
neebimozgi123: folds 
jcarlos.vale: folds 
RCABelVedeRVerd: folds 
Mimishka004: folds 
RtoG: folds 
calve88: folds 
Uncalled bet (1200) returned to Pisein31415
Pisein31415 collected 3810 from pot
Pisein31415: doesn't show hand 
*** SUMMARY ***
Total pot 3810 | Rake 0 
Seat 1: DimaAlienKO folded before Flop (didn't bet)
Seat 2: Pisein31415 collected (3810)
Seat 3: neebimozgi123 folded before Flop (didn't bet)
Seat 4: jcarlos.vale folded before Flop (didn't bet)
Seat 5: RCABelVedeRVerd folded before Flop (didn't bet)
Seat 6: Mimishka004 (button) folded before Flop (didn't bet)
Seat 7: RtoG (small blind) folded before Flop
Seat 8: calve88 (big blind) folded before Flop
Seat 9: samax15 folded before Flop (didn't bet)



PokerStars Hand #222107760387: Tournament #3082583698, $0.98+$0.12 USD Hold'em No Limit - Level XVIII (600/1200) - 2021/01/01 23:19:44 EET [2021/01/01 16:19:44 ET]
Table '3082583698 30' 9-max Seat #7 is the button
Seat 1: DimaAlienKO (32248 in chips) 
Seat 2: Pisein31415 (24260 in chips) 
Seat 3: neebimozgi123 (58049 in chips) 
Seat 4: jcarlos.vale (27256 in chips) 
Seat 5: RCABelVedeRVerd (23435 in chips) 
Seat 6: Mimishka004 (45472 in chips) 
Seat 7: RtoG (61597 in chips) 
Seat 8: calve88 (13658 in chips) 
Seat 9: samax15 (2256 in chips) 
DimaAlienKO: posts the ante 90
Pisein31415: posts the ante 90
neebimozgi123: posts the ante 90
jcarlos.vale: posts the ante 90
RCABelVedeRVerd: posts the ante 90
Mimishka004: posts the ante 90
RtoG: posts the ante 90
calve88: posts the ante 90
samax15: posts the ante 90
calve88: posts small blind 600
samax15: posts big blind 1200
*** HOLE CARDS ***
Dealt to jcarlos.vale [9d 4d]
DimaAlienKO has timed out
DimaAlienKO: folds 
DimaAlienKO is sitting out
Pisein31415: folds 
neebimozgi123: folds 
jcarlos.vale has timed out
jcarlos.vale: folds 
jcarlos.vale is sitting out
DimaAlienKO has returned
RCABelVedeRVerd: folds 
Mimishka004: folds 
jcarlos.vale has returned
RtoG: raises 2400 to 3600
calve88: folds 
samax15: calls 966 and is all-in
Uncalled bet (1434) returned to RtoG
*** FLOP *** [Ac 5d Kc]
*** TURN *** [Ac 5d Kc] [Td]
*** RIVER *** [Ac 5d Kc Td] [3s]
*** SHOW DOWN ***
samax15: shows [5c 4c] (a pair of Fives)
RtoG: shows [3d 2h] (a pair of Threes)
samax15 collected 5742 from pot
*** SUMMARY ***
Total pot 5742 | Rake 0 
Board [Ac 5d Kc Td 3s]
Seat 1: DimaAlienKO folded before Flop (didn't bet)
Seat 2: Pisein31415 folded before Flop (didn't bet)
Seat 3: neebimozgi123 folded before Flop (didn't bet)
Seat 4: jcarlos.vale folded before Flop (didn't bet)
Seat 5: RCABelVedeRVerd folded before Flop (didn't bet)
Seat 6: Mimishka004 folded before Flop (didn't bet)
Seat 7: RtoG (button) showed [3d 2h] and lost with a pair of Threes
Seat 8: calve88 (small blind) folded before Flop
Seat 9: samax15 (big blind) showed [5c 4c] and won (5742) with a pair of Fives



PokerStars Hand #222107814368: Tournament #3082583698, $0.98+$0.12 USD Hold'em No Limit - Level XVIII (600/1200) - 2021/01/01 23:20:44 EET [2021/01/01 16:20:44 ET]
Table '3082583698 30' 9-max Seat #8 is the button
Seat 1: DimaAlienKO (32158 in chips) 
Seat 2: Pisein31415 (24170 in chips) 
Seat 3: neebimozgi123 (57959 in chips) 
Seat 4: jcarlos.vale (27166 in chips) 
Seat 5: RCABelVedeRVerd (23345 in chips) 
Seat 6: Mimishka004 (45382 in chips) 
Seat 7: RtoG (59341 in chips) 
Seat 8: calve88 (12968 in chips) 
Seat 9: samax15 (5742 in chips) 
DimaAlienKO: posts the ante 90
Pisein31415: posts the ante 90
neebimozgi123: posts the ante 90
jcarlos.vale: posts the ante 90
RCABelVedeRVerd: posts the ante 90
Mimishka004: posts the ante 90
RtoG: posts the ante 90
calve88: posts the ante 90
samax15: posts the ante 90
samax15: posts small blind 600
DimaAlienKO: posts big blind 1200
*** HOLE CARDS ***
Dealt to jcarlos.vale [Qc Ah]
Pisein31415: raises 1200 to 2400
neebimozgi123: folds 
jcarlos.vale: calls 2400
RCABelVedeRVerd: folds 
Mimishka004: folds 
RtoG: folds 
calve88: folds 
samax15: folds 
DimaAlienKO: folds 
*** FLOP *** [5c 6s Ac]
Pisein31415: checks 
jcarlos.vale: bets 5558
Pisein31415: folds 
Uncalled bet (5558) returned to jcarlos.vale
jcarlos.vale collected 7410 from pot
jcarlos.vale: doesn't show hand 
*** SUMMARY ***
Total pot 7410 | Rake 0 
Board [5c 6s Ac]
Seat 1: DimaAlienKO (big blind) folded before Flop
Seat 2: Pisein31415 folded on the Flop
Seat 3: neebimozgi123 folded before Flop (didn't bet)
Seat 4: jcarlos.vale collected (7410)
Seat 5: RCABelVedeRVerd folded before Flop (didn't bet)
Seat 6: Mimishka004 folded before Flop (didn't bet)
Seat 7: RtoG folded before Flop (didn't bet)
Seat 8: calve88 (button) folded before Flop (didn't bet)
Seat 9: samax15 (small blind) folded before Flop



PokerStars Hand #222107873179: Tournament #3082583698, $0.98+$0.12 USD Hold'em No Limit - Level XIX (700/1400) - 2021/01/01 23:21:46 EET [2021/01/01 16:21:46 ET]
Table '3082583698 30' 9-max Seat #9 is the button
Seat 1: DimaAlienKO (30868 in chips) 
Seat 2: Pisein31415 (21680 in chips) 
Seat 3: neebimozgi123 (57869 in chips) 
Seat 4: jcarlos.vale (32086 in chips) 
Seat 5: RCABelVedeRVerd (23255 in chips) 
Seat 6: Mimishka004 (45292 in chips) 
Seat 7: RtoG (59251 in chips) 
Seat 8: calve88 (12878 in chips) 
Seat 9: samax15 (5052 in chips) 
DimaAlienKO: posts the ante 100
Pisein31415: posts the ante 100
neebimozgi123: posts the ante 100
jcarlos.vale: posts the ante 100
RCABelVedeRVerd: posts the ante 100
Mimishka004: posts the ante 100
RtoG: posts the ante 100
calve88: posts the ante 100
samax15: posts the ante 100
DimaAlienKO: posts small blind 700
Pisein31415: posts big blind 1400
*** HOLE CARDS ***
Dealt to jcarlos.vale [4h 3s]
neebimozgi123: calls 1400
jcarlos.vale: folds 
RCABelVedeRVerd: folds 
Mimishka004: raises 2800 to 4200
RtoG: folds 
calve88: folds 
samax15: folds 
DimaAlienKO: calls 3500
Pisein31415: folds 
neebimozgi123: calls 2800
*** FLOP *** [Ad Td Qs]
DimaAlienKO: checks 
neebimozgi123: bets 2200
Mimishka004: calls 2200
DimaAlienKO: raises 24368 to 26568 and is all-in
neebimozgi123: folds 
Mimishka004: calls 24368
*** TURN *** [Ad Td Qs] [Qc]
*** RIVER *** [Ad Td Qs Qc] [8c]
*** SHOW DOWN ***
DimaAlienKO: shows [Tc Th] (a full house, Tens full of Queens)
Mimishka004: shows [As Jd] (two pair, Aces and Queens)
DimaAlienKO collected 70236 from pot
*** SUMMARY ***
Total pot 70236 | Rake 0 
Board [Ad Td Qs Qc 8c]
Seat 1: DimaAlienKO (small blind) showed [Tc Th] and won (70236) with a full house, Tens full of Queens
Seat 2: Pisein31415 (big blind) folded before Flop
Seat 3: neebimozgi123 folded on the Flop
Seat 4: jcarlos.vale folded before Flop (didn't bet)
Seat 5: RCABelVedeRVerd folded before Flop (didn't bet)
Seat 6: Mimishka004 showed [As Jd] and lost with two pair, Aces and Queens
Seat 7: RtoG folded before Flop (didn't bet)
Seat 8: calve88 folded before Flop (didn't bet)
Seat 9: samax15 (button) folded before Flop (didn't bet)



PokerStars Hand #222107945965: Tournament #3082583698, $0.98+$0.12 USD Hold'em No Limit - Level XIX (700/1400) - 2021/01/01 23:23:07 EET [2021/01/01 16:23:07 ET]
Table '3082583698 30' 9-max Seat #1 is the button
Seat 1: DimaAlienKO (70236 in chips) 
Seat 2: Pisein31415 (20180 in chips) 
Seat 3: neebimozgi123 (51369 in chips) 
Seat 4: jcarlos.vale (31986 in chips) 
Seat 5: RCABelVedeRVerd (23155 in chips) 
Seat 6: Mimishka004 (14424 in chips) 
Seat 7: RtoG (59151 in chips) 
Seat 8: calve88 (12778 in chips) 
Seat 9: samax15 (4952 in chips) 
DimaAlienKO: posts the ante 100
Pisein31415: posts the ante 100
neebimozgi123: posts the ante 100
jcarlos.vale: posts the ante 100
RCABelVedeRVerd: posts the ante 100
Mimishka004: posts the ante 100
RtoG: posts the ante 100
calve88: posts the ante 100
samax15: posts the ante 100
Pisein31415: posts small blind 700
neebimozgi123: posts big blind 1400
*** HOLE CARDS ***
Dealt to jcarlos.vale [5s Jh]
jcarlos.vale: folds 
RCABelVedeRVerd: folds 
Mimishka004: raises 12924 to 14324 and is all-in
RtoG: folds 
calve88: folds 
samax15: folds 
DimaAlienKO: folds 
Pisein31415: folds 
neebimozgi123: folds 
Uncalled bet (12924) returned to Mimishka004
Mimishka004 collected 4400 from pot
*** SUMMARY ***
Total pot 4400 | Rake 0 
Seat 1: DimaAlienKO (button) folded before Flop (didn't bet)
Seat 2: Pisein31415 (small blind) folded before Flop
Seat 3: neebimozgi123 (big blind) folded before Flop
Seat 4: jcarlos.vale folded before Flop (didn't bet)
Seat 5: RCABelVedeRVerd folded before Flop (didn't bet)
Seat 6: Mimishka004 collected (4400)
Seat 7: RtoG folded before Flop (didn't bet)
Seat 8: calve88 folded before Flop (didn't bet)
Seat 9: samax15 folded before Flop (didn't bet)



PokerStars Hand #222107978746: Tournament #3082583698, $0.98+$0.12 USD Hold'em No Limit - Level XIX (700/1400) - 2021/01/01 23:23:44 EET [2021/01/01 16:23:44 ET]
Table '3082583698 30' 9-max Seat #2 is the button
Seat 1: DimaAlienKO (70136 in chips) 
Seat 2: Pisein31415 (19380 in chips) 
Seat 3: neebimozgi123 (49869 in chips) 
Seat 4: jcarlos.vale (31886 in chips) 
Seat 5: RCABelVedeRVerd (23055 in chips) 
Seat 6: Mimishka004 (17324 in chips) 
Seat 7: RtoG (59051 in chips) 
Seat 8: calve88 (12678 in chips) 
Seat 9: samax15 (4852 in chips) 
DimaAlienKO: posts the ante 100
Pisein31415: posts the ante 100
neebimozgi123: posts the ante 100
jcarlos.vale: posts the ante 100
RCABelVedeRVerd: posts the ante 100
Mimishka004: posts the ante 100
RtoG: posts the ante 100
calve88: posts the ante 100
samax15: posts the ante 100
neebimozgi123: posts small blind 700
jcarlos.vale: posts big blind 1400
*** HOLE CARDS ***
Dealt to jcarlos.vale [7c 5c]
RCABelVedeRVerd: folds 
Mimishka004: folds 
RtoG: folds 
calve88: folds 
samax15: folds 
DimaAlienKO: folds 
Pisein31415: raises 1400 to 2800
neebimozgi123: calls 2100
jcarlos.vale: calls 1400
*** FLOP *** [Th Qh Ts]
neebimozgi123: checks 
jcarlos.vale: checks 
Pisein31415: bets 3069
neebimozgi123: folds 
jcarlos.vale: folds 
Uncalled bet (3069) returned to Pisein31415
Pisein31415 collected 9300 from pot
Pisein31415: doesn't show hand 
*** SUMMARY ***
Total pot 9300 | Rake 0 
Board [Th Qh Ts]
Seat 1: DimaAlienKO folded before Flop (didn't bet)
Seat 2: Pisein31415 (button) collected (9300)
Seat 3: neebimozgi123 (small blind) folded on the Flop
Seat 4: jcarlos.vale (big blind) folded on the Flop
Seat 5: RCABelVedeRVerd folded before Flop (didn't bet)
Seat 6: Mimishka004 folded before Flop (didn't bet)
Seat 7: RtoG folded before Flop (didn't bet)
Seat 8: calve88 folded before Flop (didn't bet)
Seat 9: samax15 folded before Flop (didn't bet)



PokerStars Hand #222108028008: Tournament #3082583698, $0.98+$0.12 USD Hold'em No Limit - Level XIX (700/1400) - 2021/01/01 23:24:38 EET [2021/01/01 16:24:38 ET]
Table '3082583698 30' 9-max Seat #3 is the button
Seat 1: DimaAlienKO (70036 in chips) 
Seat 2: Pisein31415 (25780 in chips) 
Seat 3: neebimozgi123 (46969 in chips) 
Seat 4: jcarlos.vale (28986 in chips) 
Seat 5: RCABelVedeRVerd (22955 in chips) 
Seat 6: Mimishka004 (17224 in chips) 
Seat 7: RtoG (58951 in chips) 
Seat 8: calve88 (12578 in chips) 
Seat 9: samax15 (4752 in chips) 
DimaAlienKO: posts the ante 100
Pisein31415: posts the ante 100
neebimozgi123: posts the ante 100
jcarlos.vale: posts the ante 100
RCABelVedeRVerd: posts the ante 100
Mimishka004: posts the ante 100
RtoG: posts the ante 100
calve88: posts the ante 100
samax15: posts the ante 100
jcarlos.vale: posts small blind 700
RCABelVedeRVerd: posts big blind 1400
*** HOLE CARDS ***
Dealt to jcarlos.vale [Td 8d]
Mimishka004: raises 15724 to 17124 and is all-in
RtoG: folds 
calve88: folds 
samax15: folds 
DimaAlienKO: folds 
Pisein31415: folds 
neebimozgi123: folds 
jcarlos.vale: folds 
RCABelVedeRVerd: folds 
Uncalled bet (15724) returned to Mimishka004
Mimishka004 collected 4400 from pot
*** SUMMARY ***
Total pot 4400 | Rake 0 
Seat 1: DimaAlienKO folded before Flop (didn't bet)
Seat 2: Pisein31415 folded before Flop (didn't bet)
Seat 3: neebimozgi123 (button) folded before Flop (didn't bet)
Seat 4: jcarlos.vale (small blind) folded before Flop
Seat 5: RCABelVedeRVerd (big blind) folded before Flop
Seat 6: Mimishka004 collected (4400)
Seat 7: RtoG folded before Flop (didn't bet)
Seat 8: calve88 folded before Flop (didn't bet)
Seat 9: samax15 folded before Flop (didn't bet)



PokerStars Hand #222108061675: Tournament #3082583698, $0.98+$0.12 USD Hold'em No Limit - Level XIX (700/1400) - 2021/01/01 23:25:16 EET [2021/01/01 16:25:16 ET]
Table '3082583698 30' 9-max Seat #4 is the button
Seat 1: DimaAlienKO (69936 in chips) 
Seat 2: Pisein31415 (25680 in chips) 
Seat 3: neebimozgi123 (46869 in chips) 
Seat 4: jcarlos.vale (28186 in chips) 
Seat 5: RCABelVedeRVerd (21455 in chips) 
Seat 6: Mimishka004 (20124 in chips) 
Seat 7: RtoG (58851 in chips) 
Seat 8: calve88 (12478 in chips) 
Seat 9: samax15 (4652 in chips) 
DimaAlienKO: posts the ante 100
Pisein31415: posts the ante 100
neebimozgi123: posts the ante 100
jcarlos.vale: posts the ante 100
RCABelVedeRVerd: posts the ante 100
Mimishka004: posts the ante 100
RtoG: posts the ante 100
calve88: posts the ante 100
samax15: posts the ante 100
RCABelVedeRVerd: posts small blind 700
Mimishka004: posts big blind 1400
*** HOLE CARDS ***
Dealt to jcarlos.vale [2s Kd]
RtoG: folds 
calve88: folds 
samax15: folds 
DimaAlienKO: folds 
Pisein31415: folds 
neebimozgi123: raises 2800 to 4200
jcarlos.vale: folds 
RCABelVedeRVerd: folds 
Mimishka004: calls 2800
*** FLOP *** [6h 5s 4d]
Mimishka004: bets 15824 and is all-in
neebimozgi123: calls 15824
*** TURN *** [6h 5s 4d] [9d]
*** RIVER *** [6h 5s 4d 9d] [Jd]
*** SHOW DOWN ***
Mimishka004: shows [Ts 8s] (high card Jack)
neebimozgi123: shows [Td Qd] (a flush, Queen high)
neebimozgi123 collected 41648 from pot
Mimishka004 finished the tournament in 363rd place and received $2.50.
*** SUMMARY ***
Total pot 41648 | Rake 0 
Board [6h 5s 4d 9d Jd]
Seat 1: DimaAlienKO folded before Flop (didn't bet)
Seat 2: Pisein31415 folded before Flop (didn't bet)
Seat 3: neebimozgi123 showed [Td Qd] and won (41648) with a flush, Queen high
Seat 4: jcarlos.vale (button) folded before Flop (didn't bet)
Seat 5: RCABelVedeRVerd (small blind) folded before Flop
Seat 6: Mimishka004 (big blind) showed [Ts 8s] and lost with high card Jack
Seat 7: RtoG folded before Flop (didn't bet)
Seat 8: calve88 folded before Flop (didn't bet)
Seat 9: samax15 folded before Flop (didn't bet)



PokerStars Hand #222108127101: Tournament #3082583698, $0.98+$0.12 USD Hold'em No Limit - Level XIX (700/1400) - 2021/01/01 23:26:28 EET [2021/01/01 16:26:28 ET]
Table '3082583698 30' 9-max Seat #5 is the button
Seat 1: DimaAlienKO (69836 in chips) 
Seat 2: Pisein31415 (25580 in chips) 
Seat 3: neebimozgi123 (68393 in chips) 
Seat 4: jcarlos.vale (28086 in chips) 
Seat 5: RCABelVedeRVerd (20655 in chips) 
Seat 7: RtoG (58751 in chips) 
Seat 8: calve88 (12378 in chips) 
Seat 9: samax15 (4552 in chips) 
DimaAlienKO: posts the ante 100
Pisein31415: posts the ante 100
neebimozgi123: posts the ante 100
jcarlos.vale: posts the ante 100
RCABelVedeRVerd: posts the ante 100
RtoG: posts the ante 100
calve88: posts the ante 100
samax15: posts the ante 100
RtoG: posts small blind 700
calve88: posts big blind 1400
*** HOLE CARDS ***
Dealt to jcarlos.vale [8d 2s]
samax15 has timed out
samax15: folds 
samax15 is sitting out
DimaAlienKO: folds 
Pisein31415: folds 
neebimozgi123: folds 
jcarlos.vale: folds 
RCABelVedeRVerd: calls 1400
RtoG: raises 2800 to 4200
calve88: folds 
samax15 has returned
RCABelVedeRVerd: calls 2800
*** FLOP *** [6h 9c 4h]
RtoG: bets 4200
RCABelVedeRVerd: calls 4200
*** TURN *** [6h 9c 4h] [2d]
RtoG: checks 
RCABelVedeRVerd: bets 12155 and is all-in
RtoG: folds 
Uncalled bet (12155) returned to RCABelVedeRVerd
RCABelVedeRVerd collected 19000 from pot
*** SUMMARY ***
Total pot 19000 | Rake 0 
Board [6h 9c 4h 2d]
Seat 1: DimaAlienKO folded before Flop (didn't bet)
Seat 2: Pisein31415 folded before Flop (didn't bet)
Seat 3: neebimozgi123 folded before Flop (didn't bet)
Seat 4: jcarlos.vale folded before Flop (didn't bet)
Seat 5: RCABelVedeRVerd (button) collected (19000)
Seat 7: RtoG (small blind) folded on the Turn
Seat 8: calve88 (big blind) folded before Flop
Seat 9: samax15 folded before Flop (didn't bet)



PokerStars Hand #222108201860: Tournament #3082583698, $0.98+$0.12 USD Hold'em No Limit - Level XIX (700/1400) - 2021/01/01 23:27:51 EET [2021/01/01 16:27:51 ET]
Table '3082583698 30' 9-max Seat #7 is the button
Seat 1: DimaAlienKO (69736 in chips) 
Seat 2: Pisein31415 (25480 in chips) 
Seat 3: neebimozgi123 (68293 in chips) 
Seat 4: jcarlos.vale (27986 in chips) 
Seat 5: RCABelVedeRVerd (31155 in chips) 
Seat 6: Rariontz_1990 (17390 in chips) 
Seat 7: RtoG (50251 in chips) 
Seat 8: calve88 (10878 in chips) 
Seat 9: samax15 (4452 in chips) 
DimaAlienKO: posts the ante 100
Pisein31415: posts the ante 100
neebimozgi123: posts the ante 100
jcarlos.vale: posts the ante 100
RCABelVedeRVerd: posts the ante 100
Rariontz_1990: posts the ante 100
RtoG: posts the ante 100
calve88: posts the ante 100
samax15: posts the ante 100
calve88: posts small blind 700
samax15: posts big blind 1400
*** HOLE CARDS ***
Dealt to jcarlos.vale [Kd Th]
DimaAlienKO: folds 
Pisein31415: folds 
neebimozgi123: calls 1400
jcarlos.vale: folds 
RCABelVedeRVerd: folds 
Rariontz_1990: calls 1400
RtoG: calls 1400
calve88: calls 700
samax15 has timed out
samax15: checks 
*** FLOP *** [3d 2s Qh]
calve88: checks 
samax15: bets 2800
neebimozgi123: calls 2800
Rariontz_1990: folds 
RtoG: folds 
calve88: folds 
*** TURN *** [3d 2s Qh] [9s]
samax15: bets 152 and is all-in
neebimozgi123: calls 152
*** RIVER *** [3d 2s Qh 9s] [Ac]
*** SHOW DOWN ***
samax15: shows [6s 3s] (a pair of Threes)
neebimozgi123: shows [5h As] (a pair of Aces)
neebimozgi123 collected 13804 from pot
samax15 finished the tournament in 340th place and received $2.50.
*** SUMMARY ***
Total pot 13804 | Rake 0 
Board [3d 2s Qh 9s Ac]
Seat 1: DimaAlienKO folded before Flop (didn't bet)
Seat 2: Pisein31415 folded before Flop (didn't bet)
Seat 3: neebimozgi123 showed [5h As] and won (13804) with a pair of Aces
Seat 4: jcarlos.vale folded before Flop (didn't bet)
Seat 5: RCABelVedeRVerd folded before Flop (didn't bet)
Seat 6: Rariontz_1990 folded on the Flop
Seat 7: RtoG (button) folded on the Flop
Seat 8: calve88 (small blind) folded on the Flop
Seat 9: samax15 (big blind) showed [6s 3s] and lost with a pair of Threes



PokerStars Hand #222108283451: Tournament #3082583698, $0.98+$0.12 USD Hold'em No Limit - Level XIX (700/1400) - 2021/01/01 23:29:13 EET [2021/01/01 16:29:13 ET]
Table '3082583698 30' 9-max Seat #8 is the button
Seat 1: DimaAlienKO (69636 in chips) 
Seat 2: Pisein31415 (25380 in chips) 
Seat 3: neebimozgi123 (77645 in chips) 
Seat 4: jcarlos.vale (27886 in chips) 
Seat 5: RCABelVedeRVerd (31055 in chips) 
Seat 6: Rariontz_1990 (15890 in chips) 
Seat 7: RtoG (48751 in chips) 
Seat 8: calve88 (9378 in chips) 
DimaAlienKO: posts the ante 100
Pisein31415: posts the ante 100
neebimozgi123: posts the ante 100
jcarlos.vale: posts the ante 100
RCABelVedeRVerd: posts the ante 100
Rariontz_1990: posts the ante 100
RtoG: posts the ante 100
calve88: posts the ante 100
DimaAlienKO: posts small blind 700
Pisein31415: posts big blind 1400
*** HOLE CARDS ***
Dealt to jcarlos.vale [Kc As]
neebimozgi123: folds 
jcarlos.vale: raises 2240 to 3640
RCABelVedeRVerd: folds 
Rariontz_1990: folds 
RtoG: folds 
calve88: folds 
DimaAlienKO: folds 
Pisein31415: folds 
Uncalled bet (2240) returned to jcarlos.vale
jcarlos.vale collected 4300 from pot
jcarlos.vale: doesn't show hand 
*** SUMMARY ***
Total pot 4300 | Rake 0 
Seat 1: DimaAlienKO (small blind) folded before Flop
Seat 2: Pisein31415 (big blind) folded before Flop
Seat 3: neebimozgi123 folded before Flop (didn't bet)
Seat 4: jcarlos.vale collected (4300)
Seat 5: RCABelVedeRVerd folded before Flop (didn't bet)
Seat 6: Rariontz_1990 folded before Flop (didn't bet)
Seat 7: RtoG folded before Flop (didn't bet)
Seat 8: calve88 (button) folded before Flop (didn't bet)



PokerStars Hand #222108303223: Tournament #3082583698, $0.98+$0.12 USD Hold'em No Limit - Level XIX (700/1400) - 2021/01/01 23:29:35 EET [2021/01/01 16:29:35 ET]
Table '3082583698 30' 9-max Seat #1 is the button
Seat 1: DimaAlienKO (68836 in chips) 
Seat 2: Pisein31415 (23880 in chips) 
Seat 3: neebimozgi123 (77545 in chips) 
Seat 4: jcarlos.vale (30686 in chips) 
Seat 5: RCABelVedeRVerd (30955 in chips) 
Seat 6: Rariontz_1990 (15790 in chips) 
Seat 7: RtoG (48651 in chips) 
Seat 8: calve88 (9278 in chips) 
DimaAlienKO: posts the ante 100
Pisein31415: posts the ante 100
neebimozgi123: posts the ante 100
jcarlos.vale: posts the ante 100
RCABelVedeRVerd: posts the ante 100
Rariontz_1990: posts the ante 100
RtoG: posts the ante 100
calve88: posts the ante 100
Pisein31415: posts small blind 700
neebimozgi123: posts big blind 1400
*** HOLE CARDS ***
Dealt to jcarlos.vale [Jd Js]
jcarlos.vale: raises 2240 to 3640
RCABelVedeRVerd: calls 3640
Rariontz_1990: folds 
RtoG: folds 
calve88: folds 
DimaAlienKO: calls 3640
Pisein31415: folds 
neebimozgi123: calls 2240
*** FLOP *** [6h Th 2c]
neebimozgi123: checks 
jcarlos.vale: bets 12045
RCABelVedeRVerd: folds 
DimaAlienKO: folds 
neebimozgi123: folds 
Uncalled bet (12045) returned to jcarlos.vale
jcarlos.vale collected 16060 from pot
jcarlos.vale: doesn't show hand 
*** SUMMARY ***
Total pot 16060 | Rake 0 
Board [6h Th 2c]
Seat 1: DimaAlienKO (button) folded on the Flop
Seat 2: Pisein31415 (small blind) folded before Flop
Seat 3: neebimozgi123 (big blind) folded on the Flop
Seat 4: jcarlos.vale collected (16060)
Seat 5: RCABelVedeRVerd folded on the Flop
Seat 6: Rariontz_1990 folded before Flop (didn't bet)
Seat 7: RtoG folded before Flop (didn't bet)
Seat 8: calve88 folded before Flop (didn't bet)



PokerStars Hand #222108369154: Tournament #3082583698, $0.98+$0.12 USD Hold'em No Limit - Level XIX (700/1400) - 2021/01/01 23:30:48 EET [2021/01/01 16:30:48 ET]
Table '3082583698 30' 9-max Seat #2 is the button
Seat 1: DimaAlienKO (65096 in chips) 
Seat 2: Pisein31415 (23080 in chips) 
Seat 3: neebimozgi123 (73805 in chips) 
Seat 4: jcarlos.vale (43006 in chips) 
Seat 5: RCABelVedeRVerd (27215 in chips) 
Seat 6: Rariontz_1990 (15690 in chips) 
Seat 7: RtoG (48551 in chips) 
Seat 8: calve88 (9178 in chips) 
Seat 9: DeadManRay66 (73123 in chips) 
DimaAlienKO: posts the ante 100
Pisein31415: posts the ante 100
neebimozgi123: posts the ante 100
jcarlos.vale: posts the ante 100
RCABelVedeRVerd: posts the ante 100
Rariontz_1990: posts the ante 100
RtoG: posts the ante 100
calve88: posts the ante 100
DeadManRay66: posts the ante 100
neebimozgi123: posts small blind 700
jcarlos.vale: posts big blind 1400
*** HOLE CARDS ***
Dealt to jcarlos.vale [3d 6d]
RCABelVedeRVerd: folds 
Rariontz_1990: folds 
RtoG: folds 
calve88: folds 
DeadManRay66: folds 
DimaAlienKO: folds 
Pisein31415: folds 
neebimozgi123: raises 1400 to 2800
jcarlos.vale: folds 
Uncalled bet (1400) returned to neebimozgi123
neebimozgi123 collected 3700 from pot
*** SUMMARY ***
Total pot 3700 | Rake 0 
Seat 1: DimaAlienKO folded before Flop (didn't bet)
Seat 2: Pisein31415 (button) folded before Flop (didn't bet)
Seat 3: neebimozgi123 (small blind) collected (3700)
Seat 4: jcarlos.vale (big blind) folded before Flop
Seat 5: RCABelVedeRVerd folded before Flop (didn't bet)
Seat 6: Rariontz_1990 folded before Flop (didn't bet)
Seat 7: RtoG folded before Flop (didn't bet)
Seat 8: calve88 folded before Flop (didn't bet)
Seat 9: DeadManRay66 folded before Flop (didn't bet)



PokerStars Hand #222108405188: Tournament #3082583698, $0.98+$0.12 USD Hold'em No Limit - Level XX (800/1600) - 2021/01/01 23:31:28 EET [2021/01/01 16:31:28 ET]
Table '3082583698 30' 9-max Seat #3 is the button
Seat 1: DimaAlienKO (64996 in chips) 
Seat 2: Pisein31415 (22980 in chips) 
Seat 3: neebimozgi123 (76005 in chips) 
Seat 4: jcarlos.vale (41506 in chips) 
Seat 5: RCABelVedeRVerd (27115 in chips) 
Seat 6: Rariontz_1990 (15590 in chips) 
Seat 7: RtoG (48451 in chips) 
Seat 8: calve88 (9078 in chips) 
Seat 9: DeadManRay66 (73023 in chips) 
DimaAlienKO: posts the ante 125
Pisein31415: posts the ante 125
neebimozgi123: posts the ante 125
jcarlos.vale: posts the ante 125
RCABelVedeRVerd: posts the ante 125
Rariontz_1990: posts the ante 125
RtoG: posts the ante 125
calve88: posts the ante 125
DeadManRay66: posts the ante 125
jcarlos.vale: posts small blind 800
RCABelVedeRVerd: posts big blind 1600
*** HOLE CARDS ***
Dealt to jcarlos.vale [2d 4h]
Rariontz_1990: calls 1600
RtoG: folds 
calve88: folds 
DeadManRay66: folds 
DimaAlienKO: folds 
Pisein31415: folds 
neebimozgi123: folds 
neebimozgi123 is sitting out
jcarlos.vale: calls 800
RCABelVedeRVerd: checks 
*** FLOP *** [Th Tc 5c]
jcarlos.vale: checks 
RCABelVedeRVerd: checks 
Rariontz_1990: bets 1600
jcarlos.vale: folds 
RCABelVedeRVerd: folds 
Uncalled bet (1600) returned to Rariontz_1990
Rariontz_1990 collected 5925 from pot
Rariontz_1990: doesn't show hand 
*** SUMMARY ***
Total pot 5925 | Rake 0 
Board [Th Tc 5c]
Seat 1: DimaAlienKO folded before Flop (didn't bet)
Seat 2: Pisein31415 folded before Flop (didn't bet)
Seat 3: neebimozgi123 (button) folded before Flop (didn't bet)
Seat 4: jcarlos.vale (small blind) folded on the Flop
Seat 5: RCABelVedeRVerd (big blind) folded on the Flop
Seat 6: Rariontz_1990 collected (5925)
Seat 7: RtoG folded before Flop (didn't bet)
Seat 8: calve88 folded before Flop (didn't bet)
Seat 9: DeadManRay66 folded before Flop (didn't bet)



PokerStars Hand #222108462603: Tournament #3082583698, $0.98+$0.12 USD Hold'em No Limit - Level XX (800/1600) - 2021/01/01 23:32:32 EET [2021/01/01 16:32:32 ET]
Table '3082583698 30' 9-max Seat #4 is the button
Seat 1: DimaAlienKO (64871 in chips) 
Seat 2: Pisein31415 (22855 in chips) 
Seat 3: neebimozgi123 (75880 in chips) is sitting out
Seat 4: jcarlos.vale (39781 in chips) 
Seat 5: RCABelVedeRVerd (25390 in chips) 
Seat 6: Rariontz_1990 (19790 in chips) 
Seat 7: RtoG (48326 in chips) 
Seat 8: calve88 (8953 in chips) 
Seat 9: DeadManRay66 (72898 in chips) 
DimaAlienKO: posts the ante 125
Pisein31415: posts the ante 125
neebimozgi123: posts the ante 125
jcarlos.vale: posts the ante 125
RCABelVedeRVerd: posts the ante 125
Rariontz_1990: posts the ante 125
RtoG: posts the ante 125
calve88: posts the ante 125
DeadManRay66: posts the ante 125
RCABelVedeRVerd: posts small blind 800
Rariontz_1990: posts big blind 1600
*** HOLE CARDS ***
Dealt to jcarlos.vale [Jh 2h]
RtoG: raises 1600 to 3200
calve88: folds 
DeadManRay66: calls 3200
DimaAlienKO: folds 
Pisein31415: folds 
neebimozgi123: folds 
jcarlos.vale: folds 
RCABelVedeRVerd: folds 
Rariontz_1990: folds 
*** FLOP *** [As 5s 9h]
RtoG: bets 4800
DeadManRay66: calls 4800
*** TURN *** [As 5s 9h] [6c]
RtoG: bets 4800
DeadManRay66: calls 4800
*** RIVER *** [As 5s 9h 6c] [6h]
RtoG: bets 14562
DeadManRay66: calls 14562
*** SHOW DOWN ***
RtoG: shows [7s 6s] (three of a kind, Sixes)
DeadManRay66: mucks hand 
RtoG collected 58249 from pot
*** SUMMARY ***
Total pot 58249 | Rake 0 
Board [As 5s 9h 6c 6h]
Seat 1: DimaAlienKO folded before Flop (didn't bet)
Seat 2: Pisein31415 folded before Flop (didn't bet)
Seat 3: neebimozgi123 folded before Flop (didn't bet)
Seat 4: jcarlos.vale (button) folded before Flop (didn't bet)
Seat 5: RCABelVedeRVerd (small blind) folded before Flop
Seat 6: Rariontz_1990 (big blind) folded before Flop
Seat 7: RtoG showed [7s 6s] and won (58249) with three of a kind, Sixes
Seat 8: calve88 folded before Flop (didn't bet)
Seat 9: DeadManRay66 mucked [Th Ac]



PokerStars Hand #222108520484: Tournament #3082583698, $0.98+$0.12 USD Hold'em No Limit - Level XX (800/1600) - 2021/01/01 23:33:36 EET [2021/01/01 16:33:36 ET]
Table '3082583698 30' 9-max Seat #5 is the button
Seat 1: DimaAlienKO (64746 in chips) 
Seat 2: Pisein31415 (22730 in chips) 
Seat 3: neebimozgi123 (75755 in chips) is sitting out
Seat 4: jcarlos.vale (39656 in chips) 
Seat 5: RCABelVedeRVerd (24465 in chips) 
Seat 6: Rariontz_1990 (18065 in chips) 
Seat 7: RtoG (79088 in chips) 
Seat 8: calve88 (8828 in chips) 
Seat 9: DeadManRay66 (45411 in chips) 
DimaAlienKO: posts the ante 125
Pisein31415: posts the ante 125
neebimozgi123: posts the ante 125
jcarlos.vale: posts the ante 125
RCABelVedeRVerd: posts the ante 125
Rariontz_1990: posts the ante 125
RtoG: posts the ante 125
calve88: posts the ante 125
DeadManRay66: posts the ante 125
Rariontz_1990: posts small blind 800
RtoG: posts big blind 1600
*** HOLE CARDS ***
Dealt to jcarlos.vale [6s Th]
calve88: raises 7103 to 8703 and is all-in
DeadManRay66: folds 
DimaAlienKO: folds 
Pisein31415: calls 8703
neebimozgi123: folds 
jcarlos.vale: folds 
RCABelVedeRVerd: folds 
Rariontz_1990: folds 
RtoG: folds 
*** FLOP *** [5s Jd Tc]
*** TURN *** [5s Jd Tc] [Ac]
*** RIVER *** [5s Jd Tc Ac] [7h]
*** SHOW DOWN ***
calve88: shows [3h 3s] (a pair of Threes)
Pisein31415: shows [Kc Kd] (a pair of Kings)
Pisein31415 collected 20931 from pot
calve88 finished the tournament in 314th place and received $2.50.
*** SUMMARY ***
Total pot 20931 | Rake 0 
Board [5s Jd Tc Ac 7h]
Seat 1: DimaAlienKO folded before Flop (didn't bet)
Seat 2: Pisein31415 showed [Kc Kd] and won (20931) with a pair of Kings
Seat 3: neebimozgi123 folded before Flop (didn't bet)
Seat 4: jcarlos.vale folded before Flop (didn't bet)
Seat 5: RCABelVedeRVerd (button) folded before Flop (didn't bet)
Seat 6: Rariontz_1990 (small blind) folded before Flop
Seat 7: RtoG (big blind) folded before Flop
Seat 8: calve88 showed [3h 3s] and lost with a pair of Threes
Seat 9: DeadManRay66 folded before Flop (didn't bet)



PokerStars Hand #222108552301: Tournament #3082583698, $0.98+$0.12 USD Hold'em No Limit - Level XX (800/1600) - 2021/01/01 23:34:12 EET [2021/01/01 16:34:12 ET]
Table '3082583698 30' 9-max Seat #6 is the button
Seat 1: DimaAlienKO (64621 in chips) 
Seat 2: Pisein31415 (34833 in chips) 
Seat 3: neebimozgi123 (75630 in chips) is sitting out
Seat 4: jcarlos.vale (39531 in chips) 
Seat 5: RCABelVedeRVerd (24340 in chips) 
Seat 6: Rariontz_1990 (17140 in chips) 
Seat 7: RtoG (77363 in chips) 
Seat 9: DeadManRay66 (45286 in chips) 
DimaAlienKO: posts the ante 125
Pisein31415: posts the ante 125
neebimozgi123: posts the ante 125
jcarlos.vale: posts the ante 125
RCABelVedeRVerd: posts the ante 125
Rariontz_1990: posts the ante 125
RtoG: posts the ante 125
DeadManRay66: posts the ante 125
RtoG: posts small blind 800
DeadManRay66: posts big blind 1600
*** HOLE CARDS ***
Dealt to jcarlos.vale [Jh 6h]
DimaAlienKO: folds 
Pisein31415: folds 
neebimozgi123: folds 
jcarlos.vale: folds 
RCABelVedeRVerd: folds 
Rariontz_1990: folds 
RtoG: calls 800
DeadManRay66: checks 
*** FLOP *** [Jc 5c 5d]
RtoG: checks 
DeadManRay66: checks 
*** TURN *** [Jc 5c 5d] [5s]
RtoG: checks 
DeadManRay66: checks 
*** RIVER *** [Jc 5c 5d 5s] [7s]
RtoG: checks 
DeadManRay66: checks 
*** SHOW DOWN ***
RtoG: shows [Td 6d] (three of a kind, Fives)
DeadManRay66: shows [Kh 8s] (three of a kind, Fives - King kicker)
DeadManRay66 collected 4200 from pot
*** SUMMARY ***
Total pot 4200 | Rake 0 
Board [Jc 5c 5d 5s 7s]
Seat 1: DimaAlienKO folded before Flop (didn't bet)
Seat 2: Pisein31415 folded before Flop (didn't bet)
Seat 3: neebimozgi123 folded before Flop (didn't bet)
Seat 4: jcarlos.vale folded before Flop (didn't bet)
Seat 5: RCABelVedeRVerd folded before Flop (didn't bet)
Seat 6: Rariontz_1990 (button) folded before Flop (didn't bet)
Seat 7: RtoG (small blind) showed [Td 6d] and lost with three of a kind, Fives
Seat 9: DeadManRay66 (big blind) showed [Kh 8s] and won (4200) with three of a kind, Fives



PokerStars Hand #222108575603: Tournament #3082583698, $0.98+$0.12 USD Hold'em No Limit - Level XX (800/1600) - 2021/01/01 23:34:38 EET [2021/01/01 16:34:38 ET]
Table '3082583698 30' 9-max Seat #7 is the button
Seat 1: DimaAlienKO (64496 in chips) 
Seat 2: Pisein31415 (34708 in chips) 
Seat 3: neebimozgi123 (75505 in chips) is sitting out
Seat 4: jcarlos.vale (39406 in chips) 
Seat 5: RCABelVedeRVerd (24215 in chips) 
Seat 6: Rariontz_1990 (17015 in chips) 
Seat 7: RtoG (75638 in chips) 
Seat 9: DeadManRay66 (47761 in chips) 
DimaAlienKO: posts the ante 125
Pisein31415: posts the ante 125
neebimozgi123: posts the ante 125
jcarlos.vale: posts the ante 125
RCABelVedeRVerd: posts the ante 125
Rariontz_1990: posts the ante 125
RtoG: posts the ante 125
DeadManRay66: posts the ante 125
DeadManRay66: posts small blind 800
DimaAlienKO: posts big blind 1600
*** HOLE CARDS ***
Dealt to jcarlos.vale [3d 4d]
Pisein31415: folds 
neebimozgi123: folds 
jcarlos.vale: folds 
RCABelVedeRVerd: folds 
Rariontz_1990: raises 15290 to 16890 and is all-in
RtoG: folds 
DeadManRay66: folds 
DimaAlienKO: folds 
Uncalled bet (15290) returned to Rariontz_1990
Rariontz_1990 collected 5000 from pot
Rariontz_1990: doesn't show hand 
*** SUMMARY ***
Total pot 5000 | Rake 0 
Seat 1: DimaAlienKO (big blind) folded before Flop
Seat 2: Pisein31415 folded before Flop (didn't bet)
Seat 3: neebimozgi123 folded before Flop (didn't bet)
Seat 4: jcarlos.vale folded before Flop (didn't bet)
Seat 5: RCABelVedeRVerd folded before Flop (didn't bet)
Seat 6: Rariontz_1990 collected (5000)
Seat 7: RtoG (button) folded before Flop (didn't bet)
Seat 9: DeadManRay66 (small blind) folded before Flop



PokerStars Hand #222108597838: Tournament #3082583698, $0.98+$0.12 USD Hold'em No Limit - Level XX (800/1600) - 2021/01/01 23:35:03 EET [2021/01/01 16:35:03 ET]
Table '3082583698 30' 9-max Seat #9 is the button
Seat 1: DimaAlienKO (62771 in chips) 
Seat 2: Pisein31415 (34583 in chips) 
Seat 3: neebimozgi123 (75380 in chips) is sitting out
Seat 4: jcarlos.vale (39281 in chips) 
Seat 5: RCABelVedeRVerd (24090 in chips) 
Seat 6: Rariontz_1990 (20290 in chips) 
Seat 7: RtoG (75513 in chips) 
Seat 9: DeadManRay66 (46836 in chips) 
DimaAlienKO: posts the ante 125
Pisein31415: posts the ante 125
neebimozgi123: posts the ante 125
jcarlos.vale: posts the ante 125
RCABelVedeRVerd: posts the ante 125
Rariontz_1990: posts the ante 125
RtoG: posts the ante 125
DeadManRay66: posts the ante 125
DimaAlienKO: posts small blind 800
Pisein31415: posts big blind 1600
*** HOLE CARDS ***
Dealt to jcarlos.vale [3s 5h]
neebimozgi123: folds 
jcarlos.vale: folds 
RCABelVedeRVerd: folds 
Rariontz_1990: calls 1600
RtoG: folds 
DeadManRay66: raises 6600 to 8200
DimaAlienKO: folds 
Pisein31415: folds 
Rariontz_1990: folds 
Uncalled bet (6600) returned to DeadManRay66
DeadManRay66 collected 6600 from pot
DeadManRay66: doesn't show hand 
*** SUMMARY ***
Total pot 6600 | Rake 0 
Seat 1: DimaAlienKO (small blind) folded before Flop
Seat 2: Pisein31415 (big blind) folded before Flop
Seat 3: neebimozgi123 folded before Flop (didn't bet)
Seat 4: jcarlos.vale folded before Flop (didn't bet)
Seat 5: RCABelVedeRVerd folded before Flop (didn't bet)
Seat 6: Rariontz_1990 folded before Flop
Seat 7: RtoG folded before Flop (didn't bet)
Seat 9: DeadManRay66 (button) collected (6600)



PokerStars Hand #222108621733: Tournament #3082583698, $0.98+$0.12 USD Hold'em No Limit - Level XX (800/1600) - 2021/01/01 23:35:30 EET [2021/01/01 16:35:30 ET]
Table '3082583698 30' 9-max Seat #1 is the button
Seat 1: DimaAlienKO (61846 in chips) 
Seat 2: Pisein31415 (32858 in chips) 
Seat 3: neebimozgi123 (75255 in chips) is sitting out
Seat 4: jcarlos.vale (39156 in chips) 
Seat 5: RCABelVedeRVerd (23965 in chips) 
Seat 6: Rariontz_1990 (18565 in chips) 
Seat 7: RtoG (75388 in chips) 
Seat 8: sumatrix (97676 in chips) 
Seat 9: DeadManRay66 (51711 in chips) 
DimaAlienKO: posts the ante 125
Pisein31415: posts the ante 125
neebimozgi123: posts the ante 125
jcarlos.vale: posts the ante 125
RCABelVedeRVerd: posts the ante 125
Rariontz_1990: posts the ante 125
RtoG: posts the ante 125
sumatrix: posts the ante 125
DeadManRay66: posts the ante 125
Pisein31415: posts small blind 800
neebimozgi123: posts big blind 1600
*** HOLE CARDS ***
Dealt to jcarlos.vale [6s Kd]
jcarlos.vale: folds 
RCABelVedeRVerd: folds 
Rariontz_1990: folds 
RtoG: folds 
sumatrix: calls 1600
DeadManRay66: folds 
DimaAlienKO: folds 
Pisein31415: calls 800
neebimozgi123: folds 
*** FLOP *** [6d Kc 7d]
Pisein31415: bets 1600
sumatrix: calls 1600
*** TURN *** [6d Kc 7d] [5s]
Pisein31415: bets 5019
sumatrix: folds 
Uncalled bet (5019) returned to Pisein31415
Pisein31415 collected 9125 from pot
Pisein31415: doesn't show hand 
*** SUMMARY ***
Total pot 9125 | Rake 0 
Board [6d Kc 7d 5s]
Seat 1: DimaAlienKO (button) folded before Flop (didn't bet)
Seat 2: Pisein31415 (small blind) collected (9125)
Seat 3: neebimozgi123 (big blind) folded before Flop
Seat 4: jcarlos.vale folded before Flop (didn't bet)
Seat 5: RCABelVedeRVerd folded before Flop (didn't bet)
Seat 6: Rariontz_1990 folded before Flop (didn't bet)
Seat 7: RtoG folded before Flop (didn't bet)
Seat 8: sumatrix folded on the Turn
Seat 9: DeadManRay66 folded before Flop (didn't bet)



PokerStars Hand #222108666365: Tournament #3082583698, $0.98+$0.12 USD Hold'em No Limit - Level XX (800/1600) - 2021/01/01 23:36:20 EET [2021/01/01 16:36:20 ET]
Table '3082583698 30' 9-max Seat #2 is the button
Seat 1: DimaAlienKO (61721 in chips) 
Seat 2: Pisein31415 (38658 in chips) 
Seat 3: neebimozgi123 (73530 in chips) is sitting out
Seat 4: jcarlos.vale (39031 in chips) 
Seat 5: RCABelVedeRVerd (23840 in chips) 
Seat 6: Rariontz_1990 (18440 in chips) 
Seat 7: RtoG (75263 in chips) 
Seat 8: sumatrix (94351 in chips) 
Seat 9: DeadManRay66 (51586 in chips) 
DimaAlienKO: posts the ante 125
Pisein31415: posts the ante 125
neebimozgi123: posts the ante 125
jcarlos.vale: posts the ante 125
RCABelVedeRVerd: posts the ante 125
Rariontz_1990: posts the ante 125
RtoG: posts the ante 125
sumatrix: posts the ante 125
DeadManRay66: posts the ante 125
neebimozgi123: posts small blind 800
jcarlos.vale: posts big blind 1600
*** HOLE CARDS ***
Dealt to jcarlos.vale [4h 3h]
RCABelVedeRVerd: calls 1600
Rariontz_1990: folds 
RtoG: folds 
sumatrix: calls 1600
DeadManRay66: calls 1600
DimaAlienKO: folds 
Pisein31415: folds 
neebimozgi123: folds 
jcarlos.vale: checks 
*** FLOP *** [As Jh 9d]
jcarlos.vale: checks 
RCABelVedeRVerd: bets 1600
sumatrix: calls 1600
DeadManRay66: folds 
jcarlos.vale: folds 
*** TURN *** [As Jh 9d] [2c]
RCABelVedeRVerd: checks 
sumatrix: checks 
*** RIVER *** [As Jh 9d 2c] [Ad]
RCABelVedeRVerd: bets 5186
sumatrix: folds 
Uncalled bet (5186) returned to RCABelVedeRVerd
RCABelVedeRVerd collected 11525 from pot
*** SUMMARY ***
Total pot 11525 | Rake 0 
Board [As Jh 9d 2c Ad]
Seat 1: DimaAlienKO folded before Flop (didn't bet)
Seat 2: Pisein31415 (button) folded before Flop (didn't bet)
Seat 3: neebimozgi123 (small blind) folded before Flop
Seat 4: jcarlos.vale (big blind) folded on the Flop
Seat 5: RCABelVedeRVerd collected (11525)
Seat 6: Rariontz_1990 folded before Flop (didn't bet)
Seat 7: RtoG folded before Flop (didn't bet)
Seat 8: sumatrix folded on the River
Seat 9: DeadManRay66 folded on the Flop



PokerStars Hand #222108734632: Tournament #3082583698, $0.98+$0.12 USD Hold'em No Limit - Level XX (800/1600) - 2021/01/01 23:37:37 EET [2021/01/01 16:37:37 ET]
Table '3082583698 30' 9-max Seat #3 is the button
Seat 1: DimaAlienKO (61596 in chips) 
Seat 2: Pisein31415 (38533 in chips) 
Seat 3: neebimozgi123 (72605 in chips) is sitting out
Seat 4: jcarlos.vale (37306 in chips) 
Seat 5: RCABelVedeRVerd (32040 in chips) 
Seat 6: Rariontz_1990 (18315 in chips) 
Seat 7: RtoG (75138 in chips) 
Seat 8: sumatrix (91026 in chips) 
Seat 9: DeadManRay66 (49861 in chips) 
DimaAlienKO: posts the ante 125
Pisein31415: posts the ante 125
neebimozgi123: posts the ante 125
jcarlos.vale: posts the ante 125
RCABelVedeRVerd: posts the ante 125
Rariontz_1990: posts the ante 125
RtoG: posts the ante 125
sumatrix: posts the ante 125
DeadManRay66: posts the ante 125
jcarlos.vale: posts small blind 800
RCABelVedeRVerd: posts big blind 1600
*** HOLE CARDS ***
Dealt to jcarlos.vale [3d 9s]
Rariontz_1990 has timed out
Rariontz_1990: folds 
Rariontz_1990 is sitting out
RtoG: folds 
sumatrix: folds 
Rariontz_1990 has returned
DeadManRay66: folds 
DimaAlienKO: folds 
Pisein31415: raises 1600 to 3200
neebimozgi123: folds 
jcarlos.vale: folds 
RCABelVedeRVerd: calls 1600
*** FLOP *** [Qd Jc 3h]
RCABelVedeRVerd: checks 
Pisein31415: bets 2747
RCABelVedeRVerd: calls 2747
*** TURN *** [Qd Jc 3h] [Ts]
RCABelVedeRVerd: checks 
Pisein31415: checks 
*** RIVER *** [Qd Jc 3h Ts] [Ah]
neebimozgi123 has returned
RCABelVedeRVerd: bets 11200
Pisein31415: folds 
Uncalled bet (11200) returned to RCABelVedeRVerd
RCABelVedeRVerd collected 13819 from pot
*** SUMMARY ***
Total pot 13819 | Rake 0 
Board [Qd Jc 3h Ts Ah]
Seat 1: DimaAlienKO folded before Flop (didn't bet)
Seat 2: Pisein31415 folded on the River
Seat 3: neebimozgi123 (button) folded before Flop (didn't bet)
Seat 4: jcarlos.vale (small blind) folded before Flop
Seat 5: RCABelVedeRVerd (big blind) collected (13819)
Seat 6: Rariontz_1990 folded before Flop (didn't bet)
Seat 7: RtoG folded before Flop (didn't bet)
Seat 8: sumatrix folded before Flop (didn't bet)
Seat 9: DeadManRay66 folded before Flop (didn't bet)



PokerStars Hand #222108843352: Tournament #3082583698, $0.98+$0.12 USD Hold'em No Limit - Level XX (800/1600) - 2021/01/01 23:39:40 EET [2021/01/01 16:39:40 ET]
Table '3082583698 30' 9-max Seat #4 is the button
Seat 1: DimaAlienKO (61471 in chips) 
Seat 2: Pisein31415 (32461 in chips) 
Seat 3: neebimozgi123 (72480 in chips) 
Seat 4: jcarlos.vale (36381 in chips) 
Seat 5: RCABelVedeRVerd (39787 in chips) 
Seat 6: Rariontz_1990 (18190 in chips) 
Seat 7: RtoG (75013 in chips) 
Seat 8: sumatrix (90901 in chips) 
Seat 9: DeadManRay66 (49736 in chips) 
DimaAlienKO: posts the ante 125
Pisein31415: posts the ante 125
neebimozgi123: posts the ante 125
jcarlos.vale: posts the ante 125
RCABelVedeRVerd: posts the ante 125
Rariontz_1990: posts the ante 125
RtoG: posts the ante 125
sumatrix: posts the ante 125
DeadManRay66: posts the ante 125
RCABelVedeRVerd: posts small blind 800
Rariontz_1990: posts big blind 1600
*** HOLE CARDS ***
Dealt to jcarlos.vale [Kc 6d]
RtoG: folds 
sumatrix: folds 
DeadManRay66: folds 
DimaAlienKO: folds 
Pisein31415: raises 1600 to 3200
RCABelVedeRVerd is disconnected 
neebimozgi123: folds 
jcarlos.vale: folds 
RCABelVedeRVerd is connected 
RCABelVedeRVerd: folds 
Rariontz_1990: folds 
Uncalled bet (1600) returned to Pisein31415
Pisein31415 collected 5125 from pot
Pisein31415: doesn't show hand 
*** SUMMARY ***
Total pot 5125 | Rake 0 
Seat 1: DimaAlienKO folded before Flop (didn't bet)
Seat 2: Pisein31415 collected (5125)
Seat 3: neebimozgi123 folded before Flop (didn't bet)
Seat 4: jcarlos.vale (button) folded before Flop (didn't bet)
Seat 5: RCABelVedeRVerd (small blind) folded before Flop
Seat 6: Rariontz_1990 (big blind) folded before Flop
Seat 7: RtoG folded before Flop (didn't bet)
Seat 8: sumatrix folded before Flop (didn't bet)
Seat 9: DeadManRay66 folded before Flop (didn't bet)



PokerStars Hand #222108896323: Tournament #3082583698, $0.98+$0.12 USD Hold'em No Limit - Level XX (800/1600) - 2021/01/01 23:40:41 EET [2021/01/01 16:40:41 ET]
Table '3082583698 30' 9-max Seat #5 is the button
Seat 1: DimaAlienKO (61346 in chips) 
Seat 2: Pisein31415 (35861 in chips) 
Seat 3: neebimozgi123 (72355 in chips) 
Seat 4: jcarlos.vale (36256 in chips) 
Seat 5: RCABelVedeRVerd (38862 in chips) 
Seat 6: Rariontz_1990 (16465 in chips) 
Seat 7: RtoG (74888 in chips) 
Seat 8: sumatrix (90776 in chips) 
Seat 9: DeadManRay66 (49611 in chips) 
DimaAlienKO: posts the ante 125
Pisein31415: posts the ante 125
neebimozgi123: posts the ante 125
jcarlos.vale: posts the ante 125
RCABelVedeRVerd: posts the ante 125
Rariontz_1990: posts the ante 125
RtoG: posts the ante 125
sumatrix: posts the ante 125
DeadManRay66: posts the ante 125
Rariontz_1990: posts small blind 800
RtoG: posts big blind 1600
*** HOLE CARDS ***
Dealt to jcarlos.vale [Qc 6d]
sumatrix: folds 
DeadManRay66: folds 
DimaAlienKO: raises 1600 to 3200
Pisein31415: folds 
neebimozgi123: folds 
jcarlos.vale: folds 
RCABelVedeRVerd: folds 
Rariontz_1990: folds 
RtoG: calls 1600
*** FLOP *** [9h 5d Js]
RtoG: checks 
DimaAlienKO: bets 3200
RtoG: folds 
Uncalled bet (3200) returned to DimaAlienKO
DimaAlienKO collected 8325 from pot
DimaAlienKO: doesn't show hand 
*** SUMMARY ***
Total pot 8325 | Rake 0 
Board [9h 5d Js]
Seat 1: DimaAlienKO collected (8325)
Seat 2: Pisein31415 folded before Flop (didn't bet)
Seat 3: neebimozgi123 folded before Flop (didn't bet)
Seat 4: jcarlos.vale folded before Flop (didn't bet)
Seat 5: RCABelVedeRVerd (button) folded before Flop (didn't bet)
Seat 6: Rariontz_1990 (small blind) folded before Flop
Seat 7: RtoG (big blind) folded on the Flop
Seat 8: sumatrix folded before Flop (didn't bet)
Seat 9: DeadManRay66 folded before Flop (didn't bet)



PokerStars Hand #222108932394: Tournament #3082583698, $0.98+$0.12 USD Hold'em No Limit - Level XXI (900/1800) - 2021/01/01 23:41:22 EET [2021/01/01 16:41:22 ET]
Table '3082583698 30' 9-max Seat #6 is the button
Seat 1: DimaAlienKO (66346 in chips) 
Seat 2: Pisein31415 (35736 in chips) 
Seat 3: neebimozgi123 (72230 in chips) 
Seat 4: jcarlos.vale (36131 in chips) 
Seat 5: RCABelVedeRVerd (38737 in chips) 
Seat 6: Rariontz_1990 (15540 in chips) 
Seat 7: RtoG (71563 in chips) 
Seat 8: sumatrix (90651 in chips) 
Seat 9: DeadManRay66 (49486 in chips) 
DimaAlienKO: posts the ante 150
Pisein31415: posts the ante 150
neebimozgi123: posts the ante 150
jcarlos.vale: posts the ante 150
RCABelVedeRVerd: posts the ante 150
Rariontz_1990: posts the ante 150
RtoG: posts the ante 150
sumatrix: posts the ante 150
DeadManRay66: posts the ante 150
RtoG: posts small blind 900
sumatrix: posts big blind 1800
*** HOLE CARDS ***
Dealt to jcarlos.vale [6h Kh]
DeadManRay66: folds 
DimaAlienKO: folds 
Pisein31415: raises 1800 to 3600
neebimozgi123: folds 
jcarlos.vale: folds 
RCABelVedeRVerd: calls 3600
Rariontz_1990: folds 
RtoG: calls 2700
sumatrix: folds 
*** FLOP *** [4d Ts Jc]
RtoG: checks 
Pisein31415: checks 
RCABelVedeRVerd: bets 5400
RtoG: folds 
Pisein31415: calls 5400
*** TURN *** [4d Ts Jc] [2h]
Pisein31415: checks 
RCABelVedeRVerd: bets 11138
Pisein31415: raises 15448 to 26586 and is all-in
RCABelVedeRVerd: calls 15448
*** RIVER *** [4d Ts Jc 2h] [2s]
*** SHOW DOWN ***
Pisein31415: shows [Kc Js] (two pair, Jacks and Deuces)
RCABelVedeRVerd: shows [Ad Jd] (two pair, Jacks and Deuces - Ace kicker)
RCABelVedeRVerd collected 77922 from pot
Pisein31415 finished the tournament in 278th place and received $3.22.
*** SUMMARY ***
Total pot 77922 | Rake 0 
Board [4d Ts Jc 2h 2s]
Seat 1: DimaAlienKO folded before Flop (didn't bet)
Seat 2: Pisein31415 showed [Kc Js] and lost with two pair, Jacks and Deuces
Seat 3: neebimozgi123 folded before Flop (didn't bet)
Seat 4: jcarlos.vale folded before Flop (didn't bet)
Seat 5: RCABelVedeRVerd showed [Ad Jd] and won (77922) with two pair, Jacks and Deuces
Seat 6: Rariontz_1990 (button) folded before Flop (didn't bet)
Seat 7: RtoG (small blind) folded on the Flop
Seat 8: sumatrix (big blind) folded before Flop
Seat 9: DeadManRay66 folded before Flop (didn't bet)



PokerStars Hand #222109021948: Tournament #3082583698, $0.98+$0.12 USD Hold'em No Limit - Level XXI (900/1800) - 2021/01/01 23:43:05 EET [2021/01/01 16:43:05 ET]
Table '3082583698 30' 9-max Seat #7 is the button
Seat 1: DimaAlienKO (66196 in chips) 
Seat 3: neebimozgi123 (72080 in chips) 
Seat 4: jcarlos.vale (35981 in chips) 
Seat 5: RCABelVedeRVerd (80923 in chips) 
Seat 6: Rariontz_1990 (15390 in chips) 
Seat 7: RtoG (67813 in chips) 
Seat 8: sumatrix (88701 in chips) 
Seat 9: DeadManRay66 (49336 in chips) 
DimaAlienKO: posts the ante 150
neebimozgi123: posts the ante 150
jcarlos.vale: posts the ante 150
RCABelVedeRVerd: posts the ante 150
Rariontz_1990: posts the ante 150
RtoG: posts the ante 150
sumatrix: posts the ante 150
DeadManRay66: posts the ante 150
sumatrix: posts small blind 900
DeadManRay66: posts big blind 1800
*** HOLE CARDS ***
Dealt to jcarlos.vale [9d 7s]
DimaAlienKO: folds 
neebimozgi123: calls 1800
jcarlos.vale: folds 
RCABelVedeRVerd: folds 
Rariontz_1990: folds 
RtoG: folds 
sumatrix: calls 900
DeadManRay66: checks 
*** FLOP *** [4s Tc 5d]
sumatrix: checks 
DeadManRay66: checks 
neebimozgi123: bets 3000
sumatrix: folds 
DeadManRay66: folds 
Uncalled bet (3000) returned to neebimozgi123
neebimozgi123 collected 6600 from pot
*** SUMMARY ***
Total pot 6600 | Rake 0 
Board [4s Tc 5d]
Seat 1: DimaAlienKO folded before Flop (didn't bet)
Seat 3: neebimozgi123 collected (6600)
Seat 4: jcarlos.vale folded before Flop (didn't bet)
Seat 5: RCABelVedeRVerd folded before Flop (didn't bet)
Seat 6: Rariontz_1990 folded before Flop (didn't bet)
Seat 7: RtoG (button) folded before Flop (didn't bet)
Seat 8: sumatrix (small blind) folded on the Flop
Seat 9: DeadManRay66 (big blind) folded on the Flop



PokerStars Hand #222109066017: Tournament #3082583698, $0.98+$0.12 USD Hold'em No Limit - Level XXI (900/1800) - 2021/01/01 23:43:56 EET [2021/01/01 16:43:56 ET]
Table '3082583698 30' 9-max Seat #8 is the button
Seat 1: DimaAlienKO (66046 in chips) 
Seat 2: goszary (120183 in chips) 
Seat 3: neebimozgi123 (76730 in chips) 
Seat 4: jcarlos.vale (35831 in chips) 
Seat 5: RCABelVedeRVerd (80773 in chips) 
Seat 6: Rariontz_1990 (15240 in chips) 
Seat 7: RtoG (67663 in chips) 
Seat 8: sumatrix (86751 in chips) 
Seat 9: DeadManRay66 (47386 in chips) 
DimaAlienKO: posts the ante 150
goszary: posts the ante 150
neebimozgi123: posts the ante 150
jcarlos.vale: posts the ante 150
RCABelVedeRVerd: posts the ante 150
Rariontz_1990: posts the ante 150
RtoG: posts the ante 150
sumatrix: posts the ante 150
DeadManRay66: posts the ante 150
DeadManRay66: posts small blind 900
DimaAlienKO: posts big blind 1800
*** HOLE CARDS ***
Dealt to jcarlos.vale [5c Td]
goszary: folds 
neebimozgi123: folds 
jcarlos.vale: folds 
RCABelVedeRVerd is disconnected 
RCABelVedeRVerd has timed out while being disconnected
RCABelVedeRVerd: folds 
RCABelVedeRVerd is sitting out
Rariontz_1990: folds 
RtoG: raises 1800 to 3600
sumatrix: folds 
DeadManRay66: folds 
DimaAlienKO: calls 1800
*** FLOP *** [2s 3d 8c]
DimaAlienKO: checks 
RtoG: bets 5400
DimaAlienKO: calls 5400
*** TURN *** [2s 3d 8c] [4h]
DimaAlienKO: checks 
RtoG: checks 
*** RIVER *** [2s 3d 8c 4h] [Th]
DimaAlienKO: bets 1800
RtoG: raises 7200 to 9000
DimaAlienKO: calls 7200
*** SHOW DOWN ***
RtoG: shows [6d Kd] (high card King)
DimaAlienKO: shows [Ts Ks] (a pair of Tens)
DimaAlienKO collected 38250 from pot
*** SUMMARY ***
Total pot 38250 | Rake 0 
Board [2s 3d 8c 4h Th]
Seat 1: DimaAlienKO (big blind) showed [Ts Ks] and won (38250) with a pair of Tens
Seat 2: goszary folded before Flop (didn't bet)
Seat 3: neebimozgi123 folded before Flop (didn't bet)
Seat 4: jcarlos.vale folded before Flop (didn't bet)
Seat 5: RCABelVedeRVerd folded before Flop (didn't bet)
Seat 6: Rariontz_1990 folded before Flop (didn't bet)
Seat 7: RtoG showed [6d Kd] and lost with high card King
Seat 8: sumatrix (button) folded before Flop (didn't bet)
Seat 9: DeadManRay66 (small blind) folded before Flop



PokerStars Hand #222109141147: Tournament #3082583698, $0.98+$0.12 USD Hold'em No Limit - Level XXI (900/1800) - 2021/01/01 23:45:23 EET [2021/01/01 16:45:23 ET]
Table '3082583698 30' 9-max Seat #9 is the button
Seat 1: DimaAlienKO (86146 in chips) 
Seat 2: goszary (120033 in chips) 
Seat 3: neebimozgi123 (76580 in chips) 
Seat 4: jcarlos.vale (35681 in chips) 
Seat 5: RCABelVedeRVerd (80623 in chips) is sitting out
Seat 6: Rariontz_1990 (15090 in chips) 
Seat 7: RtoG (49513 in chips) 
Seat 8: sumatrix (86601 in chips) 
Seat 9: DeadManRay66 (46336 in chips) 
DimaAlienKO: posts the ante 150
goszary: posts the ante 150
neebimozgi123: posts the ante 150
jcarlos.vale: posts the ante 150
RCABelVedeRVerd: posts the ante 150
Rariontz_1990: posts the ante 150
RtoG: posts the ante 150
sumatrix: posts the ante 150
DeadManRay66: posts the ante 150
DimaAlienKO: posts small blind 900
goszary: posts big blind 1800
*** HOLE CARDS ***
Dealt to jcarlos.vale [3h 9c]
neebimozgi123: folds 
jcarlos.vale: folds 
RCABelVedeRVerd: folds 
Rariontz_1990 has timed out
Rariontz_1990: folds 
Rariontz_1990 is sitting out
RtoG: folds 
sumatrix: calls 1800
DeadManRay66: folds 
DimaAlienKO: calls 900
goszary: checks 
*** FLOP *** [8h Ts 8s]
DimaAlienKO: checks 
goszary: checks 
sumatrix: checks 
*** TURN *** [8h Ts 8s] [Qc]
DimaAlienKO: checks 
goszary: checks 
sumatrix: bets 3600
DimaAlienKO: folds 
goszary: folds 
Uncalled bet (3600) returned to sumatrix
sumatrix collected 6750 from pot
sumatrix: doesn't show hand 
*** SUMMARY ***
Total pot 6750 | Rake 0 
Board [8h Ts 8s Qc]
Seat 1: DimaAlienKO (small blind) folded on the Turn
Seat 2: goszary (big blind) folded on the Turn
Seat 3: neebimozgi123 folded before Flop (didn't bet)
Seat 4: jcarlos.vale folded before Flop (didn't bet)
Seat 5: RCABelVedeRVerd folded before Flop (didn't bet)
Seat 6: Rariontz_1990 folded before Flop (didn't bet)
Seat 7: RtoG folded before Flop (didn't bet)
Seat 8: sumatrix collected (6750)
Seat 9: DeadManRay66 (button) folded before Flop (didn't bet)



PokerStars Hand #222109191668: Tournament #3082583698, $0.98+$0.12 USD Hold'em No Limit - Level XXI (900/1800) - 2021/01/01 23:46:20 EET [2021/01/01 16:46:20 ET]
Table '3082583698 30' 9-max Seat #1 is the button
Seat 1: DimaAlienKO (84196 in chips) 
Seat 2: goszary (118083 in chips) 
Seat 3: neebimozgi123 (76430 in chips) 
Seat 4: jcarlos.vale (35531 in chips) 
Seat 5: RCABelVedeRVerd (80473 in chips) is sitting out
Seat 6: Rariontz_1990 (14940 in chips) is sitting out
Seat 7: RtoG (49363 in chips) 
Seat 8: sumatrix (91401 in chips) 
Seat 9: DeadManRay66 (46186 in chips) 
DimaAlienKO: posts the ante 150
goszary: posts the ante 150
neebimozgi123: posts the ante 150
jcarlos.vale: posts the ante 150
RCABelVedeRVerd: posts the ante 150
Rariontz_1990: posts the ante 150
RtoG: posts the ante 150
sumatrix: posts the ante 150
DeadManRay66: posts the ante 150
goszary: posts small blind 900
neebimozgi123: posts big blind 1800
*** HOLE CARDS ***
Dealt to jcarlos.vale [Ts 6d]
jcarlos.vale: folds 
RCABelVedeRVerd: folds 
Rariontz_1990: folds 
RtoG: folds 
sumatrix: calls 1800
DeadManRay66: folds 
DimaAlienKO: folds 
Rariontz_1990 has returned
goszary: calls 900
neebimozgi123: checks 
*** FLOP *** [As Th 9s]
goszary: checks 
neebimozgi123: bets 1800
sumatrix: calls 1800
goszary: calls 1800
*** TURN *** [As Th 9s] [Ad]
goszary: checks 
neebimozgi123: bets 1800
sumatrix: folds 
goszary: folds 
Uncalled bet (1800) returned to neebimozgi123
neebimozgi123 collected 12150 from pot
*** SUMMARY ***
Total pot 12150 | Rake 0 
Board [As Th 9s Ad]
Seat 1: DimaAlienKO (button) folded before Flop (didn't bet)
Seat 2: goszary (small blind) folded on the Turn
Seat 3: neebimozgi123 (big blind) collected (12150)
Seat 4: jcarlos.vale folded before Flop (didn't bet)
Seat 5: RCABelVedeRVerd folded before Flop (didn't bet)
Seat 6: Rariontz_1990 folded before Flop (didn't bet)
Seat 7: RtoG folded before Flop (didn't bet)
Seat 8: sumatrix folded on the Turn
Seat 9: DeadManRay66 folded before Flop (didn't bet)



PokerStars Hand #222109286904: Tournament #3082583698, $0.98+$0.12 USD Hold'em No Limit - Level XXI (900/1800) - 2021/01/01 23:48:02 EET [2021/01/01 16:48:02 ET]
Table '3082583698 187' 9-max Seat #3 is the button
Seat 1: hromos88 (17552 in chips) 
Seat 2: korol.al (70896 in chips) 
Seat 3: assaad1952 (17906 in chips) 
Seat 4: marka19 (54219 in chips) 
Seat 5: jcarlos.vale (35381 in chips) 
Seat 6: klissanchez (188400 in chips) 
Seat 7: davies/crabtree (107507 in chips) 
Seat 9: BOBO 1307 (93455 in chips) 
hromos88: posts the ante 150
korol.al: posts the ante 150
assaad1952: posts the ante 150
marka19: posts the ante 150
jcarlos.vale: posts the ante 150
klissanchez: posts the ante 150
davies/crabtree: posts the ante 150
BOBO 1307: posts the ante 150
marka19: posts small blind 900
jcarlos.vale: posts big blind 1800
*** HOLE CARDS ***
Dealt to jcarlos.vale [8c 8s]
klissanchez: folds 
davies/crabtree: raises 1800 to 3600
BOBO 1307: folds 
hromos88: folds 
korol.al: folds 
assaad1952: folds 
marka19: folds 
jcarlos.vale: calls 1800
*** FLOP *** [Ad Qh Ac]
jcarlos.vale: checks 
davies/crabtree: bets 4836
jcarlos.vale: folds 
Uncalled bet (4836) returned to davies/crabtree
davies/crabtree collected 9300 from pot
davies/crabtree: doesn't show hand 
*** SUMMARY ***
Total pot 9300 | Rake 0 
Board [Ad Qh Ac]
Seat 1: hromos88 folded before Flop (didn't bet)
Seat 2: korol.al folded before Flop (didn't bet)
Seat 3: assaad1952 (button) folded before Flop (didn't bet)
Seat 4: marka19 (small blind) folded before Flop
Seat 5: jcarlos.vale (big blind) folded on the Flop
Seat 6: klissanchez folded before Flop (didn't bet)
Seat 7: davies/crabtree collected (9300)
Seat 9: BOBO 1307 folded before Flop (didn't bet)



PokerStars Hand #222109318753: Tournament #3082583698, $0.98+$0.12 USD Hold'em No Limit - Level XXI (900/1800) - 2021/01/01 23:48:38 EET [2021/01/01 16:48:38 ET]
Table '3082583698 187' 9-max Seat #4 is the button
Seat 1: hromos88 (17402 in chips) 
Seat 2: korol.al (70746 in chips) 
Seat 3: assaad1952 (17756 in chips) 
Seat 4: marka19 (53169 in chips) 
Seat 5: jcarlos.vale (31631 in chips) 
Seat 6: klissanchez (188250 in chips) 
Seat 7: davies/crabtree (113057 in chips) 
Seat 8: avensisken (82045 in chips) 
Seat 9: BOBO 1307 (93305 in chips) 
hromos88: posts the ante 150
korol.al: posts the ante 150
assaad1952: posts the ante 150
marka19: posts the ante 150
jcarlos.vale: posts the ante 150
klissanchez: posts the ante 150
davies/crabtree: posts the ante 150
avensisken: posts the ante 150
BOBO 1307: posts the ante 150
jcarlos.vale: posts small blind 900
klissanchez: posts big blind 1800
*** HOLE CARDS ***
Dealt to jcarlos.vale [3h 9d]
davies/crabtree: folds 
avensisken: calls 1800
BOBO 1307: calls 1800
hromos88: raises 15452 to 17252 and is all-in
korol.al: folds 
assaad1952: folds 
marka19: folds 
jcarlos.vale: folds 
klissanchez: folds 
avensisken: raises 15452 to 32704
BOBO 1307: folds 
Uncalled bet (15452) returned to avensisken
*** FLOP *** [Jc 3s 3d]
*** TURN *** [Jc 3s 3d] [6s]
*** RIVER *** [Jc 3s 3d 6s] [Kd]
*** SHOW DOWN ***
avensisken: shows [Kh Ks] (a full house, Kings full of Threes)
hromos88: shows [As 7s] (a pair of Threes)
avensisken collected 40354 from pot
hromos88 finished the tournament in 245th place and received $3.22.
*** SUMMARY ***
Total pot 40354 | Rake 0 
Board [Jc 3s 3d 6s Kd]
Seat 1: hromos88 showed [As 7s] and lost with a pair of Threes
Seat 2: korol.al folded before Flop (didn't bet)
Seat 3: assaad1952 folded before Flop (didn't bet)
Seat 4: marka19 (button) folded before Flop (didn't bet)
Seat 5: jcarlos.vale (small blind) folded before Flop
Seat 6: klissanchez (big blind) folded before Flop
Seat 7: davies/crabtree folded before Flop (didn't bet)
Seat 8: avensisken showed [Kh Ks] and won (40354) with a full house, Kings full of Threes
Seat 9: BOBO 1307 folded before Flop



PokerStars Hand #222109356526: Tournament #3082583698, $0.98+$0.12 USD Hold'em No Limit - Level XXI (900/1800) - 2021/01/01 23:49:20 EET [2021/01/01 16:49:20 ET]
Table '3082583698 187' 9-max Seat #5 is the button
Seat 2: korol.al (70596 in chips) 
Seat 3: assaad1952 (17606 in chips) 
Seat 4: marka19 (53019 in chips) 
Seat 5: jcarlos.vale (30581 in chips) 
Seat 6: klissanchez (186300 in chips) 
Seat 7: davies/crabtree (112907 in chips) 
Seat 8: avensisken (104997 in chips) 
Seat 9: BOBO 1307 (91355 in chips) 
korol.al: posts the ante 150
assaad1952: posts the ante 150
marka19: posts the ante 150
jcarlos.vale: posts the ante 150
klissanchez: posts the ante 150
davies/crabtree: posts the ante 150
avensisken: posts the ante 150
BOBO 1307: posts the ante 150
klissanchez: posts small blind 900
davies/crabtree: posts big blind 1800
*** HOLE CARDS ***
Dealt to jcarlos.vale [3s 9h]
avensisken: folds 
BOBO 1307: calls 1800
korol.al: raises 3600 to 5400
assaad1952: folds 
marka19: folds 
jcarlos.vale: folds 
klissanchez: folds 
davies/crabtree: folds 
BOBO 1307: calls 3600
*** FLOP *** [4s Jc 2c]
BOBO 1307: checks 
korol.al: bets 5508
BOBO 1307: folds 
Uncalled bet (5508) returned to korol.al
korol.al collected 14700 from pot
korol.al: doesn't show hand 
*** SUMMARY ***
Total pot 14700 | Rake 0 
Board [4s Jc 2c]
Seat 2: korol.al collected (14700)
Seat 3: assaad1952 folded before Flop (didn't bet)
Seat 4: marka19 folded before Flop (didn't bet)
Seat 5: jcarlos.vale (button) folded before Flop (didn't bet)
Seat 6: klissanchez (small blind) folded before Flop
Seat 7: davies/crabtree (big blind) folded before Flop
Seat 8: avensisken folded before Flop (didn't bet)
Seat 9: BOBO 1307 folded on the Flop



PokerStars Hand #222109401380: Tournament #3082583698, $0.98+$0.12 USD Hold'em No Limit - Level XXI (900/1800) - 2021/01/01 23:50:11 EET [2021/01/01 16:50:11 ET]
Table '3082583698 187' 9-max Seat #6 is the button
Seat 1: HFQuaresma (86407 in chips) 
Seat 2: korol.al (79746 in chips) 
Seat 3: assaad1952 (17456 in chips) 
Seat 4: marka19 (52869 in chips) 
Seat 5: jcarlos.vale (30431 in chips) 
Seat 6: klissanchez (185250 in chips) 
Seat 7: davies/crabtree (110957 in chips) 
Seat 8: avensisken (104847 in chips) 
Seat 9: BOBO 1307 (85805 in chips) 
HFQuaresma: posts the ante 150
korol.al: posts the ante 150
assaad1952: posts the ante 150
marka19: posts the ante 150
jcarlos.vale: posts the ante 150
klissanchez: posts the ante 150
davies/crabtree: posts the ante 150
avensisken: posts the ante 150
BOBO 1307: posts the ante 150
davies/crabtree: posts small blind 900
avensisken: posts big blind 1800
*** HOLE CARDS ***
Dealt to jcarlos.vale [5h Kd]
BOBO 1307: folds 
HFQuaresma: folds 
korol.al: folds 
assaad1952: folds 
marka19: folds 
jcarlos.vale: folds 
klissanchez: raises 1800 to 3600
davies/crabtree: folds 
avensisken: calls 1800
*** FLOP *** [8s 2c 9h]
avensisken: checks 
klissanchez: bets 3119
avensisken: calls 3119
*** TURN *** [8s 2c 9h] [Ts]
avensisken: checks 
klissanchez: checks 
*** RIVER *** [8s 2c 9h Ts] [7s]
avensisken: checks 
klissanchez: checks 
*** SHOW DOWN ***
avensisken: shows [4d 8d] (a pair of Eights)
klissanchez: shows [9s 7d] (two pair, Nines and Sevens)
klissanchez collected 15688 from pot
*** SUMMARY ***
Total pot 15688 | Rake 0 
Board [8s 2c 9h Ts 7s]
Seat 1: HFQuaresma folded before Flop (didn't bet)
Seat 2: korol.al folded before Flop (didn't bet)
Seat 3: assaad1952 folded before Flop (didn't bet)
Seat 4: marka19 folded before Flop (didn't bet)
Seat 5: jcarlos.vale folded before Flop (didn't bet)
Seat 6: klissanchez (button) showed [9s 7d] and won (15688) with two pair, Nines and Sevens
Seat 7: davies/crabtree (small blind) folded before Flop
Seat 8: avensisken (big blind) showed [4d 8d] and lost with a pair of Eights
Seat 9: BOBO 1307 folded before Flop (didn't bet)



PokerStars Hand #222109451438: Tournament #3082583698, $0.98+$0.12 USD Hold'em No Limit - Level XXI (900/1800) - 2021/01/01 23:51:08 EET [2021/01/01 16:51:08 ET]
Table '3082583698 187' 9-max Seat #7 is the button
Seat 1: HFQuaresma (86257 in chips) 
Seat 2: korol.al (79596 in chips) 
Seat 3: assaad1952 (17306 in chips) 
Seat 4: marka19 (52719 in chips) 
Seat 5: jcarlos.vale (30281 in chips) 
Seat 6: klissanchez (194069 in chips) 
Seat 7: davies/crabtree (109907 in chips) 
Seat 8: avensisken (97978 in chips) 
Seat 9: BOBO 1307 (85655 in chips) 
HFQuaresma: posts the ante 150
korol.al: posts the ante 150
assaad1952: posts the ante 150
marka19: posts the ante 150
jcarlos.vale: posts the ante 150
klissanchez: posts the ante 150
davies/crabtree: posts the ante 150
avensisken: posts the ante 150
BOBO 1307: posts the ante 150
avensisken: posts small blind 900
BOBO 1307: posts big blind 1800
*** HOLE CARDS ***
Dealt to jcarlos.vale [As 6d]
HFQuaresma: raises 1800 to 3600
korol.al: folds 
assaad1952: folds 
marka19: folds 
jcarlos.vale: folds 
klissanchez: folds 
davies/crabtree: folds 
avensisken: folds 
BOBO 1307: calls 1800
*** FLOP *** [Th Qd 6s]
BOBO 1307: bets 1800
HFQuaresma: raises 4307 to 6107
BOBO 1307: calls 4307
*** TURN *** [Th Qd 6s] [7d]
BOBO 1307: checks 
HFQuaresma: bets 14298
BOBO 1307: calls 14298
*** RIVER *** [Th Qd 6s 7d] [Kc]
BOBO 1307: checks 
HFQuaresma: bets 33172
BOBO 1307: folds 
Uncalled bet (33172) returned to HFQuaresma
HFQuaresma collected 50260 from pot
HFQuaresma: doesn't show hand 
*** SUMMARY ***
Total pot 50260 | Rake 0 
Board [Th Qd 6s 7d Kc]
Seat 1: HFQuaresma collected (50260)
Seat 2: korol.al folded before Flop (didn't bet)
Seat 3: assaad1952 folded before Flop (didn't bet)
Seat 4: marka19 folded before Flop (didn't bet)
Seat 5: jcarlos.vale folded before Flop (didn't bet)
Seat 6: klissanchez folded before Flop (didn't bet)
Seat 7: davies/crabtree (button) folded before Flop (didn't bet)
Seat 8: avensisken (small blind) folded before Flop
Seat 9: BOBO 1307 (big blind) folded on the River



PokerStars Hand #222109509774: Tournament #3082583698, $0.98+$0.12 USD Hold'em No Limit - Level XXII (1000/2000) - 2021/01/01 23:52:14 EET [2021/01/01 16:52:14 ET]
Table '3082583698 187' 9-max Seat #8 is the button
Seat 1: HFQuaresma (112362 in chips) 
Seat 2: korol.al (79446 in chips) 
Seat 3: assaad1952 (17156 in chips) 
Seat 4: marka19 (52569 in chips) 
Seat 5: jcarlos.vale (30131 in chips) 
Seat 6: klissanchez (193919 in chips) 
Seat 7: davies/crabtree (109757 in chips) 
Seat 8: avensisken (96928 in chips) 
Seat 9: BOBO 1307 (61500 in chips) 
HFQuaresma: posts the ante 175
korol.al: posts the ante 175
assaad1952: posts the ante 175
marka19: posts the ante 175
jcarlos.vale: posts the ante 175
klissanchez: posts the ante 175
davies/crabtree: posts the ante 175
avensisken: posts the ante 175
BOBO 1307: posts the ante 175
BOBO 1307: posts small blind 1000
HFQuaresma: posts big blind 2000
*** HOLE CARDS ***
Dealt to jcarlos.vale [Qh 7d]
korol.al: folds 
assaad1952: folds 
marka19: folds 
jcarlos.vale: folds 
klissanchez: folds 
davies/crabtree: raises 2400 to 4400
avensisken: folds 
BOBO 1307: calls 3400
HFQuaresma: folds 
*** FLOP *** [4d Kc 8d]
BOBO 1307: checks 
davies/crabtree: bets 8910
BOBO 1307: folds 
Uncalled bet (8910) returned to davies/crabtree
davies/crabtree collected 12375 from pot
davies/crabtree: doesn't show hand 
*** SUMMARY ***
Total pot 12375 | Rake 0 
Board [4d Kc 8d]
Seat 1: HFQuaresma (big blind) folded before Flop
Seat 2: korol.al folded before Flop (didn't bet)
Seat 3: assaad1952 folded before Flop (didn't bet)
Seat 4: marka19 folded before Flop (didn't bet)
Seat 5: jcarlos.vale folded before Flop (didn't bet)
Seat 6: klissanchez folded before Flop (didn't bet)
Seat 7: davies/crabtree collected (12375)
Seat 8: avensisken (button) folded before Flop (didn't bet)
Seat 9: BOBO 1307 (small blind) folded on the Flop



PokerStars Hand #222109559930: Tournament #3082583698, $0.98+$0.12 USD Hold'em No Limit - Level XXII (1000/2000) - 2021/01/01 23:53:10 EET [2021/01/01 16:53:10 ET]
Table '3082583698 187' 9-max Seat #9 is the button
Seat 1: HFQuaresma (110187 in chips) 
Seat 2: korol.al (79271 in chips) 
Seat 3: assaad1952 (16981 in chips) 
Seat 4: marka19 (52394 in chips) 
Seat 5: jcarlos.vale (29956 in chips) 
Seat 6: klissanchez (193744 in chips) 
Seat 7: davies/crabtree (117557 in chips) 
Seat 8: avensisken (96753 in chips) 
Seat 9: BOBO 1307 (56925 in chips) 
HFQuaresma: posts the ante 175
korol.al: posts the ante 175
assaad1952: posts the ante 175
marka19: posts the ante 175
jcarlos.vale: posts the ante 175
klissanchez: posts the ante 175
davies/crabtree: posts the ante 175
avensisken: posts the ante 175
BOBO 1307: posts the ante 175
HFQuaresma: posts small blind 1000
korol.al: posts big blind 2000
*** HOLE CARDS ***
Dealt to jcarlos.vale [6h 3s]
assaad1952: folds 
marka19: folds 
jcarlos.vale: folds 
klissanchez: folds 
davies/crabtree: folds 
avensisken: raises 2000 to 4000
BOBO 1307: folds 
HFQuaresma: folds 
korol.al: calls 2000
*** FLOP *** [3d Kd Qd]
korol.al: checks 
avensisken: checks 
*** TURN *** [3d Kd Qd] [Qc]
korol.al: checks 
avensisken: bets 5288
korol.al: folds 
Uncalled bet (5288) returned to avensisken
avensisken collected 10575 from pot
avensisken: doesn't show hand 
*** SUMMARY ***
Total pot 10575 | Rake 0 
Board [3d Kd Qd Qc]
Seat 1: HFQuaresma (small blind) folded before Flop
Seat 2: korol.al (big blind) folded on the Turn
Seat 3: assaad1952 folded before Flop (didn't bet)
Seat 4: marka19 folded before Flop (didn't bet)
Seat 5: jcarlos.vale folded before Flop (didn't bet)
Seat 6: klissanchez folded before Flop (didn't bet)
Seat 7: davies/crabtree folded before Flop (didn't bet)
Seat 8: avensisken collected (10575)
Seat 9: BOBO 1307 (button) folded before Flop (didn't bet)



PokerStars Hand #222109612227: Tournament #3082583698, $0.98+$0.12 USD Hold'em No Limit - Level XXII (1000/2000) - 2021/01/01 23:54:09 EET [2021/01/01 16:54:09 ET]
Table '3082583698 187' 9-max Seat #1 is the button
Seat 1: HFQuaresma (109012 in chips) 
Seat 2: korol.al (75096 in chips) 
Seat 3: assaad1952 (16806 in chips) 
Seat 4: marka19 (52219 in chips) 
Seat 5: jcarlos.vale (29781 in chips) 
Seat 6: klissanchez (193569 in chips) 
Seat 7: davies/crabtree (117382 in chips) 
Seat 8: avensisken (103153 in chips) 
Seat 9: BOBO 1307 (56750 in chips) 
HFQuaresma: posts the ante 175
korol.al: posts the ante 175
assaad1952: posts the ante 175
marka19: posts the ante 175
jcarlos.vale: posts the ante 175
klissanchez: posts the ante 175
davies/crabtree: posts the ante 175
avensisken: posts the ante 175
BOBO 1307: posts the ante 175
korol.al: posts small blind 1000
assaad1952: posts big blind 2000
*** HOLE CARDS ***
Dealt to jcarlos.vale [6d 4h]
marka19: folds 
jcarlos.vale: folds 
klissanchez has timed out
klissanchez: folds 
klissanchez is sitting out
davies/crabtree: folds 
avensisken: raises 2000 to 4000
BOBO 1307: folds 
klissanchez has returned
HFQuaresma: raises 8000 to 12000
korol.al: folds 
assaad1952: folds 
avensisken: calls 8000
*** FLOP *** [Ks 9d 4c]
avensisken: checks 
HFQuaresma: bets 9430
avensisken: folds 
Uncalled bet (9430) returned to HFQuaresma
HFQuaresma collected 28575 from pot
HFQuaresma: doesn't show hand 
*** SUMMARY ***
Total pot 28575 | Rake 0 
Board [Ks 9d 4c]
Seat 1: HFQuaresma (button) collected (28575)
Seat 2: korol.al (small blind) folded before Flop
Seat 3: assaad1952 (big blind) folded before Flop
Seat 4: marka19 folded before Flop (didn't bet)
Seat 5: jcarlos.vale folded before Flop (didn't bet)
Seat 6: klissanchez folded before Flop (didn't bet)
Seat 7: davies/crabtree folded before Flop (didn't bet)
Seat 8: avensisken folded on the Flop
Seat 9: BOBO 1307 folded before Flop (didn't bet)



PokerStars Hand #222109654462: Tournament #3082583698, $0.98+$0.12 USD Hold'em No Limit - Level XXII (1000/2000) - 2021/01/01 23:54:58 EET [2021/01/01 16:54:58 ET]
Table '3082583698 187' 9-max Seat #2 is the button
Seat 1: HFQuaresma (125412 in chips) 
Seat 2: korol.al (73921 in chips) 
Seat 3: assaad1952 (14631 in chips) 
Seat 4: marka19 (52044 in chips) 
Seat 5: jcarlos.vale (29606 in chips) 
Seat 6: klissanchez (193394 in chips) 
Seat 7: davies/crabtree (117207 in chips) 
Seat 8: avensisken (90978 in chips) 
Seat 9: BOBO 1307 (56575 in chips) 
HFQuaresma: posts the ante 175
korol.al: posts the ante 175
assaad1952: posts the ante 175
marka19: posts the ante 175
jcarlos.vale: posts the ante 175
klissanchez: posts the ante 175
davies/crabtree: posts the ante 175
avensisken: posts the ante 175
BOBO 1307: posts the ante 175
assaad1952: posts small blind 1000
marka19: posts big blind 2000
*** HOLE CARDS ***
Dealt to jcarlos.vale [8d Qc]
jcarlos.vale: folds 
klissanchez: folds 
davies/crabtree: folds 
avensisken: folds 
BOBO 1307: folds 
HFQuaresma: folds 
korol.al: raises 2000 to 4000
assaad1952: folds 
marka19: calls 2000
*** FLOP *** [Kc 9s 7s]
marka19: bets 2000
korol.al: calls 2000
*** TURN *** [Kc 9s 7s] [Jh]
marka19: checks 
korol.al: checks 
*** RIVER *** [Kc 9s 7s Jh] [7c]
marka19: checks 
korol.al: bets 4360
marka19: calls 4360
*** SHOW DOWN ***
korol.al: shows [Kh Th] (two pair, Kings and Sevens)
marka19: mucks hand 
korol.al collected 23295 from pot
*** SUMMARY ***
Total pot 23295 | Rake 0 
Board [Kc 9s 7s Jh 7c]
Seat 1: HFQuaresma folded before Flop (didn't bet)
Seat 2: korol.al (button) showed [Kh Th] and won (23295) with two pair, Kings and Sevens
Seat 3: assaad1952 (small blind) folded before Flop
Seat 4: marka19 (big blind) mucked [Td Tc]
Seat 5: jcarlos.vale folded before Flop (didn't bet)
Seat 6: klissanchez folded before Flop (didn't bet)
Seat 7: davies/crabtree folded before Flop (didn't bet)
Seat 8: avensisken folded before Flop (didn't bet)
Seat 9: BOBO 1307 folded before Flop (didn't bet)



PokerStars Hand #222109877990: Tournament #3082583698, $0.98+$0.12 USD Hold'em No Limit - Level XXII (1000/2000) - 2021/01/02 0:01:27 EET [2021/01/01 17:01:27 ET]
Table '3082583698 187' 9-max Seat #3 is the button
Seat 1: HFQuaresma (125237 in chips) 
Seat 2: korol.al (86681 in chips) 
Seat 3: assaad1952 (13456 in chips) 
Seat 4: marka19 (41509 in chips) 
Seat 5: jcarlos.vale (29431 in chips) 
Seat 6: klissanchez (193219 in chips) 
Seat 7: davies/crabtree (117032 in chips) 
Seat 8: avensisken (90803 in chips) 
Seat 9: BOBO 1307 (56400 in chips) 
HFQuaresma: posts the ante 175
korol.al: posts the ante 175
assaad1952: posts the ante 175
marka19: posts the ante 175
jcarlos.vale: posts the ante 175
klissanchez: posts the ante 175
davies/crabtree: posts the ante 175
avensisken: posts the ante 175
BOBO 1307: posts the ante 175
marka19: posts small blind 1000
jcarlos.vale: posts big blind 2000
*** HOLE CARDS ***
Dealt to jcarlos.vale [3c 5s]
klissanchez: folds 
davies/crabtree: folds 
avensisken: folds 
BOBO 1307 has timed out
BOBO 1307: folds 
BOBO 1307 is sitting out
HFQuaresma: raises 2000 to 4000
korol.al: folds 
assaad1952: folds 
marka19: calls 3000
jcarlos.vale: folds 
*** FLOP *** [Qh 8d 6c]
marka19: bets 2000
HFQuaresma: calls 2000
*** TURN *** [Qh 8d 6c] [6d]
marka19 is disconnected 
marka19 is connected 
marka19 has timed out
marka19: checks 
HFQuaresma: checks 
*** RIVER *** [Qh 8d 6c 6d] [6h]
marka19: bets 2000
HFQuaresma: calls 2000
*** SHOW DOWN ***
marka19: shows [9c Qc] (a full house, Sixes full of Queens)
HFQuaresma: mucks hand 
marka19 collected 19575 from pot
*** SUMMARY ***
Total pot 19575 | Rake 0 
Board [Qh 8d 6c 6d 6h]
Seat 1: HFQuaresma mucked [Kc Jc]
Seat 2: korol.al folded before Flop (didn't bet)
Seat 3: assaad1952 (button) folded before Flop (didn't bet)
Seat 4: marka19 (small blind) showed [9c Qc] and won (19575) with a full house, Sixes full of Queens
Seat 5: jcarlos.vale (big blind) folded before Flop
Seat 6: klissanchez folded before Flop (didn't bet)
Seat 7: davies/crabtree folded before Flop (didn't bet)
Seat 8: avensisken folded before Flop (didn't bet)
Seat 9: BOBO 1307 folded before Flop (didn't bet)



PokerStars Hand #222109974056: Tournament #3082583698, $0.98+$0.12 USD Hold'em No Limit - Level XXII (1000/2000) - 2021/01/02 0:03:25 EET [2021/01/01 17:03:25 ET]
Table '3082583698 187' 9-max Seat #4 is the button
Seat 1: HFQuaresma (117062 in chips) 
Seat 2: korol.al (86506 in chips) 
Seat 3: assaad1952 (13281 in chips) 
Seat 4: marka19 (52909 in chips) 
Seat 5: jcarlos.vale (27256 in chips) 
Seat 6: klissanchez (193044 in chips) 
Seat 7: davies/crabtree (116857 in chips) 
Seat 8: avensisken (90628 in chips) 
Seat 9: BOBO 1307 (56225 in chips) is sitting out
HFQuaresma: posts the ante 175
korol.al: posts the ante 175
assaad1952: posts the ante 175
marka19: posts the ante 175
jcarlos.vale: posts the ante 175
klissanchez: posts the ante 175
davies/crabtree: posts the ante 175
avensisken: posts the ante 175
BOBO 1307: posts the ante 175
jcarlos.vale: posts small blind 1000
klissanchez: posts big blind 2000
*** HOLE CARDS ***
Dealt to jcarlos.vale [Ad 7c]
davies/crabtree: folds 
avensisken: folds 
BOBO 1307: folds 
HFQuaresma: folds 
korol.al: folds 
assaad1952: folds 
marka19: folds 
jcarlos.vale: raises 25081 to 27081 and is all-in
klissanchez: calls 25081
*** FLOP *** [As 8c 3c]
*** TURN *** [As 8c 3c] [4d]
*** RIVER *** [As 8c 3c 4d] [Kh]
*** SHOW DOWN ***
jcarlos.vale: shows [Ad 7c] (a pair of Aces)
klissanchez: shows [Ac Qs] (a pair of Aces - King+Queen kicker)
klissanchez collected 55737 from pot
jcarlos.vale finished the tournament in 229th place and received $3.22.
*** SUMMARY ***
Total pot 55737 | Rake 0 
Board [As 8c 3c 4d Kh]
Seat 1: HFQuaresma folded before Flop (didn't bet)
Seat 2: korol.al folded before Flop (didn't bet)
Seat 3: assaad1952 folded before Flop (didn't bet)
Seat 4: marka19 (button) folded before Flop (didn't bet)
Seat 5: jcarlos.vale (small blind) showed [Ad 7c] and lost with a pair of Aces
Seat 6: klissanchez (big blind) showed [Ac Qs] and won (55737) with a pair of Aces
Seat 7: davies/crabtree folded before Flop (didn't bet)
Seat 8: avensisken folded before Flop (didn't bet)
Seat 9: BOBO 1307 folded before Flop (didn't bet)



