PokerStars Hand #221898922270: Tournament #3082657132, $0.98+$0.12 USD Hold'em No Limit - Level I (15/30) - 2020/12/27 16:15:07 EET [2020/12/27 9:15:07 ET]
Table '3082657132 62' 9-max Seat #1 is the button
Seat 1: Nevs996 (3000 in chips) 
Seat 2: blind9090 (3000 in chips) 
Seat 3: GrandoGui (3000 in chips) is sitting out
Seat 4: jcarlos.vale (3000 in chips) 
Seat 5: borussenalex (3000 in chips) 
Seat 6: Jek8235 (3000 in chips) 
Seat 7: thunder402 (3000 in chips) 
Seat 8: sebatju (3000 in chips) 
Seat 9: vasiliki34 (3000 in chips) 
Nevs996: posts the ante 4
blind9090: posts the ante 4
GrandoGui: posts the ante 4
jcarlos.vale: posts the ante 4
borussenalex: posts the ante 4
Jek8235: posts the ante 4
thunder402: posts the ante 4
sebatju: posts the ante 4
vasiliki34: posts the ante 4
blind9090: posts small blind 15
GrandoGui: posts big blind 30
*** HOLE CARDS ***
Dealt to jcarlos.vale [Td 2s]
jcarlos.vale: folds 
borussenalex: folds 
Jek8235: folds 
thunder402: calls 30
sebatju: raises 36 to 66
vasiliki34: folds 
Nevs996: folds 
blind9090: calls 51
GrandoGui: folds 
thunder402: calls 36
*** FLOP *** [5h 3h 4c]
blind9090: checks 
thunder402: checks 
sebatju: bets 79
blind9090: folds 
thunder402: folds 
Uncalled bet (79) returned to sebatju
sebatju collected 264 from pot
sebatju: doesn't show handDTO
*** SUMMARY ***
Total pot 264 | Rake 0 
Board [5h 3h 4c]
Seat 1: Nevs996 (button) folded before Flop (didn't bet)
Seat 2: blind9090 (small blind) folded on the Flop
Seat 3: GrandoGui (big blind) folded before Flop
Seat 4: jcarlos.vale folded before Flop (didn't bet)
Seat 5: borussenalex folded before Flop (didn't bet)
Seat 6: Jek8235 folded before Flop (didn't bet)
Seat 7: thunder402 folded on the Flop
Seat 8: sebatju collected (264)
Seat 9: vasiliki34 folded before Flop (didn't bet)



PokerStars Hand #221898947981: Tournament #3082657132, $0.98+$0.12 USD Hold'em No Limit - Level I (15/30) - 2020/12/27 16:15:55 EET [2020/12/27 9:15:55 ET]
Table '3082657132 62' 9-max Seat #2 is the button
Seat 1: Nevs996 (2996 in chips) 
Seat 2: blind9090 (2930 in chips) 
Seat 3: GrandoGui (2966 in chips) is sitting out
Seat 4: jcarlos.vale (2996 in chips) 
Seat 5: borussenalex (2996 in chips) 
Seat 6: Jek8235 (2996 in chips) 
Seat 7: thunder402 (2930 in chips) 
Seat 8: sebatju (3194 in chips) 
Seat 9: vasiliki34 (2996 in chips) 
Nevs996: posts the ante 4
blind9090: posts the ante 4
GrandoGui: posts the ante 4
jcarlos.vale: posts the ante 4
borussenalex: posts the ante 4
Jek8235: posts the ante 4
thunder402: posts the ante 4
sebatju: posts the ante 4
vasiliki34: posts the ante 4
GrandoGui: posts small blind 15
jcarlos.vale: posts big blind 30
*** HOLE CARDS ***
Dealt to jcarlos.vale [7s Qd]
borussenalex: folds 
Jek8235: raises 30 to 60
thunder402: calls 60
sebatju: folds 
vasiliki34: folds 
Nevs996: calls 60
blind9090: folds 
GrandoGui: folds 
jcarlos.vale: folds 
*** FLOP *** [Kd Ah Kc]
Jek8235: checks 
thunder402: checks 
Nevs996: bets 144
Jek8235: folds 
thunder402: raises 275 to 419
Nevs996: folds 
Uncalled bet (275) returned to thunder402
thunder402 collected 549 from pot
thunder402: doesn't show handDTO
*** SUMMARY ***
Total pot 549 | Rake 0 
Board [Kd Ah Kc]
Seat 1: Nevs996 folded on the Flop
Seat 2: blind9090 (button) folded before Flop (didn't bet)
Seat 3: GrandoGui (small blind) folded before Flop
Seat 4: jcarlos.vale (big blind) folded before Flop
Seat 5: borussenalex folded before Flop (didn't bet)
Seat 6: Jek8235 folded on the Flop
Seat 7: thunder402 collected (549)
Seat 8: sebatju folded before Flop (didn't bet)
Seat 9: vasiliki34 folded before Flop (didn't bet)



PokerStars Hand #221898992373: Tournament #3082657132, $0.98+$0.12 USD Hold'em No Limit - Level I (15/30) - 2020/12/27 16:17:01 EET [2020/12/27 9:17:01 ET]
Table '3082657132 62' 9-max Seat #3 is the button
Seat 1: Nevs996 (2788 in chips) 
Seat 2: blind9090 (2926 in chips) 
Seat 3: GrandoGui (2947 in chips) is sitting out
Seat 4: jcarlos.vale (2962 in chips) 
Seat 5: borussenalex (2992 in chips) 
Seat 6: Jek8235 (2932 in chips) 
Seat 7: thunder402 (3271 in chips) 
Seat 8: sebatju (3190 in chips) 
Seat 9: vasiliki34 (2992 in chips) 
Nevs996: posts the ante 4
blind9090: posts the ante 4
GrandoGui: posts the ante 4
jcarlos.vale: posts the ante 4
borussenalex: posts the ante 4
Jek8235: posts the ante 4
thunder402: posts the ante 4
sebatju: posts the ante 4
vasiliki34: posts the ante 4
jcarlos.vale: posts small blind 15
borussenalex: posts big blind 30
*** HOLE CARDS ***
Dealt to jcarlos.vale [Qs 4s]
Jek8235: folds 
thunder402: folds 
sebatju: folds 
vasiliki34: folds 
Nevs996: folds 
blind9090: folds 
GrandoGui: folds 
jcarlos.vale: folds 
Uncalled bet (15) returned to borussenalex
borussenalex collected 66 from pot
borussenalex: doesn't show handDTO
*** SUMMARY ***
Total pot 66 | Rake 0 
Seat 1: Nevs996 folded before Flop (didn't bet)
Seat 2: blind9090 folded before Flop (didn't bet)
Seat 3: GrandoGui (button) folded before Flop (didn't bet)
Seat 4: jcarlos.vale (small blind) folded before Flop
Seat 5: borussenalex (big blind) collected (66)
Seat 6: Jek8235 folded before Flop (didn't bet)
Seat 7: thunder402 folded before Flop (didn't bet)
Seat 8: sebatju folded before Flop (didn't bet)
Seat 9: vasiliki34 folded before Flop (didn't bet)



PokerStars Hand #221899002516: Tournament #3082657132, $0.98+$0.12 USD Hold'em No Limit - Level I (15/30) - 2020/12/27 16:17:20 EET [2020/12/27 9:17:20 ET]
Table '3082657132 62' 9-max Seat #4 is the button
Seat 1: Nevs996 (2784 in chips) 
Seat 2: blind9090 (2922 in chips) 
Seat 3: GrandoGui (2943 in chips) is sitting out
Seat 4: jcarlos.vale (2943 in chips) 
Seat 5: borussenalex (3039 in chips) 
Seat 6: Jek8235 (2928 in chips) 
Seat 7: thunder402 (3267 in chips) 
Seat 8: sebatju (3186 in chips) 
Nevs996: posts the ante 4
blind9090: posts the ante 4
GrandoGui: posts the ante 4
jcarlos.vale: posts the ante 4
borussenalex: posts the ante 4
Jek8235: posts the ante 4
thunder402: posts the ante 4
sebatju: posts the ante 4
borussenalex: posts small blind 15
Jek8235: posts big blind 30
*** HOLE CARDS ***
Dealt to jcarlos.vale [2s Jh]
thunder402: calls 30
sebatju: folds 
Nevs996: folds 
blind9090: folds 
GrandoGui: folds 
jcarlos.vale: folds 
borussenalex: folds 
Jek8235: checks 
*** FLOP *** [Qh 4h Ac]
Jek8235: checks 
thunder402: bets 60
Jek8235: folds 
Uncalled bet (60) returned to thunder402
thunder402 collected 107 from pot
thunder402: doesn't show handDTO
*** SUMMARY ***
Total pot 107 | Rake 0 
Board [Qh 4h Ac]
Seat 1: Nevs996 folded before Flop (didn't bet)
Seat 2: blind9090 folded before Flop (didn't bet)
Seat 3: GrandoGui folded before Flop (didn't bet)
Seat 4: jcarlos.vale (button) folded before Flop (didn't bet)
Seat 5: borussenalex (small blind) folded before Flop
Seat 6: Jek8235 (big blind) folded on the Flop
Seat 7: thunder402 collected (107)
Seat 8: sebatju folded before Flop (didn't bet)



PokerStars Hand #221899021872: Tournament #3082657132, $0.98+$0.12 USD Hold'em No Limit - Level I (15/30) - 2020/12/27 16:17:56 EET [2020/12/27 9:17:56 ET]
Table '3082657132 62' 9-max Seat #5 is the button
Seat 1: Nevs996 (2780 in chips) 
Seat 2: blind9090 (2918 in chips) 
Seat 3: GrandoGui (2939 in chips) is sitting out
Seat 4: jcarlos.vale (2939 in chips) 
Seat 5: borussenalex (3020 in chips) 
Seat 6: Jek8235 (2894 in chips) 
Seat 7: thunder402 (3340 in chips) 
Seat 8: sebatju (3182 in chips) 
Seat 9: billikarl (3000 in chips) 
Nevs996: posts the ante 4
blind9090: posts the ante 4
GrandoGui: posts the ante 4
jcarlos.vale: posts the ante 4
borussenalex: posts the ante 4
Jek8235: posts the ante 4
thunder402: posts the ante 4
sebatju: posts the ante 4
billikarl: posts the ante 4
Jek8235: posts small blind 15
thunder402: posts big blind 30
*** HOLE CARDS ***
Dealt to jcarlos.vale [2h 6s]
GrandoGui has returned
sebatju: folds 
billikarl: calls 30
Nevs996: folds 
blind9090: folds 
GrandoGui: folds 
jcarlos.vale: folds 
borussenalex: folds 
Jek8235: folds 
thunder402: checks 
*** FLOP *** [8s 9s 2d]
thunder402: checks 
billikarl: checks 
*** TURN *** [8s 9s 2d] [7d]
thunder402: bets 30
billikarl: raises 171 to 201
thunder402: calls 171
*** RIVER *** [8s 9s 2d 7d] [4h]
thunder402: checks 
billikarl: bets 513
thunder402: folds 
Uncalled bet (513) returned to billikarl
billikarl collected 513 from pot
billikarl: doesn't show handDTO
*** SUMMARY ***
Total pot 513 | Rake 0 
Board [8s 9s 2d 7d 4h]
Seat 1: Nevs996 folded before Flop (didn't bet)
Seat 2: blind9090 folded before Flop (didn't bet)
Seat 3: GrandoGui folded before Flop (didn't bet)
Seat 4: jcarlos.vale folded before Flop (didn't bet)
Seat 5: borussenalex (button) folded before Flop (didn't bet)
Seat 6: Jek8235 (small blind) folded before Flop
Seat 7: thunder402 (big blind) folded on the River
Seat 8: sebatju folded before Flop (didn't bet)
Seat 9: billikarl collected (513)



PokerStars Hand #221899067017: Tournament #3082657132, $0.98+$0.12 USD Hold'em No Limit - Level I (15/30) - 2020/12/27 16:19:19 EET [2020/12/27 9:19:19 ET]
Table '3082657132 62' 9-max Seat #6 is the button
Seat 1: Nevs996 (2776 in chips) 
Seat 2: blind9090 (2914 in chips) 
Seat 3: GrandoGui (2935 in chips) 
Seat 4: jcarlos.vale (2935 in chips) 
Seat 5: borussenalex (3016 in chips) 
Seat 6: Jek8235 (2875 in chips) 
Seat 7: thunder402 (3105 in chips) 
Seat 9: billikarl (3278 in chips) 
Nevs996: posts the ante 4
blind9090: posts the ante 4
GrandoGui: posts the ante 4
jcarlos.vale: posts the ante 4
borussenalex: posts the ante 4
Jek8235: posts the ante 4
thunder402: posts the ante 4
billikarl: posts the ante 4
thunder402: posts small blind 15
billikarl: posts big blind 30
*** HOLE CARDS ***
Dealt to jcarlos.vale [Td 3h]
Nevs996: folds 
blind9090: folds 
GrandoGui: folds 
jcarlos.vale: folds 
borussenalex: folds 
Jek8235: raises 30 to 60
thunder402: calls 45
billikarl: calls 30
*** FLOP *** [Jd 2h 7s]
thunder402: checks 
billikarl: checks 
Jek8235: bets 75
thunder402: calls 75
billikarl: calls 75
*** TURN *** [Jd 2h 7s] [Jc]
thunder402: checks 
billikarl: checks 
Jek8235: checks 
*** RIVER *** [Jd 2h 7s Jc] [Jh]
thunder402: checks 
billikarl: checks 
Jek8235: checks 
*** SHOW DOWN ***
thunder402: shows [Ah 4h] (three of a kind, Jacks)
billikarl: shows [7d 6h] (a full house, Jacks full of Sevens)
Jek8235: mucks handDTO
billikarl collected 437 from pot
*** SUMMARY ***
Total pot 437 | Rake 0 
Board [Jd 2h 7s Jc Jh]
Seat 1: Nevs996 folded before Flop (didn't bet)
Seat 2: blind9090 folded before Flop (didn't bet)
Seat 3: GrandoGui folded before Flop (didn't bet)
Seat 4: jcarlos.vale folded before Flop (didn't bet)
Seat 5: borussenalex folded before Flop (didn't bet)
Seat 6: Jek8235 (button) mucked [Qc Ac]
Seat 7: thunder402 (small blind) showed [Ah 4h] and lost with three of a kind, Jacks
Seat 9: billikarl (big blind) showed [7d 6h] and won (437) with a full house, Jacks full of Sevens



PokerStars Hand #221899123996: Tournament #3082657132, $0.98+$0.12 USD Hold'em No Limit - Level I (15/30) - 2020/12/27 16:21:04 EET [2020/12/27 9:21:04 ET]
Table '3082657132 62' 9-max Seat #7 is the button
Seat 1: Nevs996 (2772 in chips) 
Seat 2: blind9090 (2910 in chips) 
Seat 3: GrandoGui (2931 in chips) 
Seat 4: jcarlos.vale (2931 in chips) 
Seat 5: borussenalex (3012 in chips) 
Seat 6: Jek8235 (2736 in chips) 
Seat 7: thunder402 (2966 in chips) 
Seat 8: ToNutss (3000 in chips) out of handDTO (moved from another table into small blind)
Seat 9: billikarl (3576 in chips) 
ToNutss will be allowed to play after the button
Nevs996: posts the ante 4
blind9090: posts the ante 4
GrandoGui: posts the ante 4
jcarlos.vale: posts the ante 4
borussenalex: posts the ante 4
Jek8235: posts the ante 4
thunder402: posts the ante 4
billikarl: posts the ante 4
billikarl: posts small blind 15
Nevs996: posts big blind 30
*** HOLE CARDS ***
Dealt to jcarlos.vale [Jd 7c]
blind9090: raises 30 to 60
GrandoGui: folds 
jcarlos.vale: folds 
borussenalex: folds 
Jek8235: folds 
thunder402: calls 60
billikarl: folds 
Nevs996: calls 30
*** FLOP *** [4h 9s Ks]
Nevs996: checks 
blind9090: bets 90
thunder402: folds 
Nevs996: calls 90
*** TURN *** [4h 9s Ks] [6h]
Nevs996: checks 
blind9090: bets 150
Nevs996: calls 150
*** RIVER *** [4h 9s Ks 6h] [Qs]
Nevs996: bets 570
blind9090: folds 
Uncalled bet (570) returned to Nevs996
Nevs996 collected 707 from pot
Nevs996: doesn't show handDTO
*** SUMMARY ***
Total pot 707 | Rake 0 
Board [4h 9s Ks 6h Qs]
Seat 1: Nevs996 (big blind) collected (707)
Seat 2: blind9090 folded on the River
Seat 3: GrandoGui folded before Flop (didn't bet)
Seat 4: jcarlos.vale folded before Flop (didn't bet)
Seat 5: borussenalex folded before Flop (didn't bet)
Seat 6: Jek8235 folded before Flop (didn't bet)
Seat 7: thunder402 (button) folded on the Flop
Seat 9: billikarl (small blind) folded before Flop



PokerStars Hand #221899173818: Tournament #3082657132, $0.98+$0.12 USD Hold'em No Limit - Level I (15/30) - 2020/12/27 16:22:37 EET [2020/12/27 9:22:37 ET]
Table '3082657132 62' 9-max Seat #9 is the button
Seat 1: Nevs996 (3175 in chips) 
Seat 2: blind9090 (2606 in chips) 
Seat 3: GrandoGui (2927 in chips) 
Seat 4: jcarlos.vale (2927 in chips) 
Seat 5: borussenalex (3008 in chips) 
Seat 6: Jek8235 (2732 in chips) 
Seat 7: thunder402 (2902 in chips) 
Seat 8: ToNutss (3000 in chips) 
Seat 9: billikarl (3557 in chips) 
Nevs996: posts the ante 4
blind9090: posts the ante 4
GrandoGui: posts the ante 4
jcarlos.vale: posts the ante 4
borussenalex: posts the ante 4
Jek8235: posts the ante 4
thunder402: posts the ante 4
ToNutss: posts the ante 4
billikarl: posts the ante 4
Nevs996: posts small blind 15
blind9090: posts big blind 30
*** HOLE CARDS ***
Dealt to jcarlos.vale [3h Ts]
GrandoGui: folds 
jcarlos.vale: folds 
borussenalex: folds 
Jek8235: folds 
thunder402: folds 
ToNutss: raises 30 to 60
billikarl: folds 
Nevs996: folds 
blind9090: calls 30
*** FLOP *** [Qs Ad 3c]
blind9090: checks 
ToNutss: bets 77
blind9090: folds 
Uncalled bet (77) returned to ToNutss
ToNutss collected 171 from pot
ToNutss: doesn't show handDTO
*** SUMMARY ***
Total pot 171 | Rake 0 
Board [Qs Ad 3c]
Seat 1: Nevs996 (small blind) folded before Flop
Seat 2: blind9090 (big blind) folded on the Flop
Seat 3: GrandoGui folded before Flop (didn't bet)
Seat 4: jcarlos.vale folded before Flop (didn't bet)
Seat 5: borussenalex folded before Flop (didn't bet)
Seat 6: Jek8235 folded before Flop (didn't bet)
Seat 7: thunder402 folded before Flop (didn't bet)
Seat 8: ToNutss collected (171)
Seat 9: billikarl (button) folded before Flop (didn't bet)



PokerStars Hand #221899206202: Tournament #3082657132, $0.98+$0.12 USD Hold'em No Limit - Level I (15/30) - 2020/12/27 16:23:36 EET [2020/12/27 9:23:36 ET]
Table '3082657132 62' 9-max Seat #1 is the button
Seat 1: Nevs996 (3156 in chips) 
Seat 2: blind9090 (2542 in chips) 
Seat 3: GrandoGui (2923 in chips) 
Seat 4: jcarlos.vale (2923 in chips) 
Seat 6: Jek8235 (2728 in chips) 
Seat 7: thunder402 (2898 in chips) 
Seat 8: ToNutss (3107 in chips) 
Seat 9: billikarl (3553 in chips) 
Nevs996: posts the ante 4
blind9090: posts the ante 4
GrandoGui: posts the ante 4
jcarlos.vale: posts the ante 4
Jek8235: posts the ante 4
thunder402: posts the ante 4
ToNutss: posts the ante 4
billikarl: posts the ante 4
blind9090: posts small blind 15
GrandoGui: posts big blind 30
*** HOLE CARDS ***
Dealt to jcarlos.vale [6s 5s]
jcarlos.vale: raises 48 to 78
Jek8235: folds 
thunder402: raises 48 to 126
ToNutss: folds 
billikarl has timed out
billikarl: folds 
billikarl is sitting out
billikarl has returned
Nevs996: calls 126
blind9090: folds 
GrandoGui: folds 
jcarlos.vale: folds 
*** FLOP *** [7c 3s As]
thunder402: bets 120
Nevs996: calls 120
*** TURN *** [7c 3s As] [8c]
thunder402: bets 323
Nevs996: calls 323
*** RIVER *** [7c 3s As 8c] [Qs]
thunder402: bets 646
Nevs996: raises 1937 to 2583 and is all-in
thunder402: calls 1679 and is all-in
Uncalled bet (258) returned to Nevs996
*** SHOW DOWN ***
Nevs996: shows [9h Jh] (high pairOfCards Ace)
thunder402: shows [Ah 3d] (two pair, Aces and Threes)
thunder402 collected 5943 from pot
*** SUMMARY ***
Total pot 5943 | Rake 0 
Board [7c 3s As 8c Qs]
Seat 1: Nevs996 (button) showed [9h Jh] and lost with high pairOfCards Ace
Seat 2: blind9090 (small blind) folded before Flop
Seat 3: GrandoGui (big blind) folded before Flop
Seat 4: jcarlos.vale folded before Flop
Seat 6: Jek8235 folded before Flop (didn't bet)
Seat 7: thunder402 showed [Ah 3d] and won (5943) with two pair, Aces and Threes
Seat 8: ToNutss folded before Flop (didn't bet)
Seat 9: billikarl folded before Flop (didn't bet)



PokerStars Hand #221899265823: Tournament #3082657132, $0.98+$0.12 USD Hold'em No Limit - Level II (20/40) - 2020/12/27 16:25:25 EET [2020/12/27 9:25:25 ET]
Table '3082657132 62' 9-max Seat #2 is the button
Seat 1: Nevs996 (258 in chips) 
Seat 2: blind9090 (2523 in chips) 
Seat 3: GrandoGui (2889 in chips) 
Seat 4: jcarlos.vale (2841 in chips) 
Seat 5: W - Diose (3000 in chips) 
Seat 6: Jek8235 (2724 in chips) 
Seat 7: thunder402 (5943 in chips) 
Seat 8: ToNutss (3103 in chips) 
Seat 9: billikarl (3549 in chips) 
Nevs996: posts the ante 5
blind9090: posts the ante 5
GrandoGui: posts the ante 5
jcarlos.vale: posts the ante 5
W - Diose: posts the ante 5
Jek8235: posts the ante 5
thunder402: posts the ante 5
ToNutss: posts the ante 5
billikarl: posts the ante 5
GrandoGui: posts small blind 20
jcarlos.vale: posts big blind 40
*** HOLE CARDS ***
Dealt to jcarlos.vale [Jh 5s]
W - Diose: folds 
Jek8235: folds 
thunder402: folds 
ToNutss: folds 
billikarl: calls 40
Nevs996: folds 
blind9090: raises 120 to 160
GrandoGui: calls 140
jcarlos.vale: folds 
billikarl: calls 120
*** FLOP *** [2d Td Jc]
GrandoGui: checks 
billikarl: bets 40
blind9090: calls 40
GrandoGui: calls 40
*** TURN *** [2d Td Jc] [8d]
GrandoGui: checks 
billikarl: bets 40
blind9090: raises 320 to 360
GrandoGui: folds 
billikarl: calls 320
*** RIVER *** [2d Td Jc 8d] [Tc]
billikarl: checks 
blind9090: bets 480
billikarl: calls 480
*** SHOW DOWN ***
blind9090: shows [Ad 9c] (a pair of Tens)
billikarl: shows [7s Ts] (three of a kind, Tens)
billikarl collected 2365 from pot
*** SUMMARY ***
Total pot 2365 | Rake 0 
Board [2d Td Jc 8d Tc]
Seat 1: Nevs996 folded before Flop (didn't bet)
Seat 2: blind9090 (button) showed [Ad 9c] and lost with a pair of Tens
Seat 3: GrandoGui (small blind) folded on the Turn
Seat 4: jcarlos.vale (big blind) folded before Flop
Seat 5: W - Diose folded before Flop (didn't bet)
Seat 6: Jek8235 folded before Flop (didn't bet)
Seat 7: thunder402 folded before Flop (didn't bet)
Seat 8: ToNutss folded before Flop (didn't bet)
Seat 9: billikarl showed [7s Ts] and won (2365) with three of a kind, Tens



PokerStars Hand #221899332684: Tournament #3082657132, $0.98+$0.12 USD Hold'em No Limit - Level II (20/40) - 2020/12/27 16:27:27 EET [2020/12/27 9:27:27 ET]
Table '3082657132 62' 9-max Seat #3 is the button
Seat 1: Nevs996 (253 in chips) 
Seat 2: blind9090 (1478 in chips) 
Seat 3: GrandoGui (2684 in chips) 
Seat 4: jcarlos.vale (2796 in chips) 
Seat 6: Jek8235 (2719 in chips) 
Seat 7: thunder402 (5938 in chips) 
Seat 8: ToNutss (3098 in chips) 
Seat 9: billikarl (4869 in chips) 
Nevs996: posts the ante 5
blind9090: posts the ante 5
GrandoGui: posts the ante 5
jcarlos.vale: posts the ante 5
Jek8235: posts the ante 5
thunder402: posts the ante 5
ToNutss: posts the ante 5
billikarl: posts the ante 5
jcarlos.vale: posts small blind 20
Jek8235: posts big blind 40
*** HOLE CARDS ***
Dealt to jcarlos.vale [Ac 4c]
thunder402: calls 40
ToNutss: folds 
billikarl: raises 40 to 80
Nevs996: folds 
blind9090: folds 
GrandoGui: calls 80
jcarlos.vale: folds 
Jek8235: calls 40
thunder402: calls 40
*** FLOP *** [6s Jd 2d]
Jek8235: checks 
thunder402: checks 
billikarl: bets 380
GrandoGui: folds 
Jek8235: calls 380
thunder402: folds 
*** TURN *** [6s Jd 2d] [Tc]
Jek8235: checks 
billikarl: bets 40
Jek8235: calls 40
*** RIVER *** [6s Jd 2d Tc] [3s]
Jek8235: checks 
billikarl: bets 40
Jek8235: calls 40
*** SHOW DOWN ***
billikarl: shows [7c 7s] (a pair of Sevens)
Jek8235: shows [Ad Td] (a pair of Tens)
Jek8235 collected 1300 from pot
*** SUMMARY ***
Total pot 1300 | Rake 0 
Board [6s Jd 2d Tc 3s]
Seat 1: Nevs996 folded before Flop (didn't bet)
Seat 2: blind9090 folded before Flop (didn't bet)
Seat 3: GrandoGui (button) folded on the Flop
Seat 4: jcarlos.vale (small blind) folded before Flop
Seat 6: Jek8235 (big blind) showed [Ad Td] and won (1300) with a pair of Tens
Seat 7: thunder402 folded on the Flop
Seat 8: ToNutss folded before Flop (didn't bet)
Seat 9: billikarl showed [7c 7s] and lost with a pair of Sevens



PokerStars Hand #221899376221: Tournament #3082657132, $0.98+$0.12 USD Hold'em No Limit - Level II (20/40) - 2020/12/27 16:28:46 EET [2020/12/27 9:28:46 ET]
Table '3082657132 62' 9-max Seat #4 is the button
Seat 1: Nevs996 (248 in chips) 
Seat 2: blind9090 (1473 in chips) 
Seat 3: GrandoGui (2599 in chips) 
Seat 4: jcarlos.vale (2771 in chips) 
Seat 5: NikoILAI4 (3000 in chips) out of handDTO (moved from another table into small blind)
Seat 6: Jek8235 (3474 in chips) 
Seat 7: thunder402 (5853 in chips) 
Seat 8: ToNutss (3093 in chips) 
Seat 9: billikarl (4324 in chips) 
NikoILAI4 will be allowed to play after the button
Nevs996: posts the ante 5
blind9090: posts the ante 5
GrandoGui: posts the ante 5
jcarlos.vale: posts the ante 5
Jek8235: posts the ante 5
thunder402: posts the ante 5
ToNutss: posts the ante 5
billikarl: posts the ante 5
Jek8235: posts small blind 20
thunder402: posts big blind 40
*** HOLE CARDS ***
Dealt to jcarlos.vale [4d 2s]
ToNutss: raises 40 to 80
billikarl: raises 40 to 120
Nevs996: raises 123 to 243 and is all-in
blind9090: folds 
GrandoGui: folds 
jcarlos.vale: folds 
Jek8235: folds 
thunder402: folds 
ToNutss: calls 163
billikarl: calls 123
*** FLOP *** [6d Qc 6h]
ToNutss: checks 
billikarl: checks 
*** TURN *** [6d Qc 6h] [8d]
ToNutss: checks 
billikarl: checks 
*** RIVER *** [6d Qc 6h 8d] [6c]
ToNutss: checks 
billikarl: checks 
*** SHOW DOWN ***
ToNutss: shows [Ah Jc] (three of a kind, Sixes)
billikarl: shows [9h Ad] (three of a kind, Sixes)
Nevs996: shows [4c Ac] (three of a kind, Sixes)
ToNutss collected 277 from pot
billikarl collected 276 from pot
Nevs996 collected 276 from pot
*** SUMMARY ***
Total pot 829 | Rake 0 
Board [6d Qc 6h 8d 6c]
Seat 1: Nevs996 showed [4c Ac] and won (276) with three of a kind, Sixes
Seat 2: blind9090 folded before Flop (didn't bet)
Seat 3: GrandoGui folded before Flop (didn't bet)
Seat 4: jcarlos.vale (button) folded before Flop (didn't bet)
Seat 6: Jek8235 (small blind) folded before Flop
Seat 7: thunder402 (big blind) folded before Flop
Seat 8: ToNutss showed [Ah Jc] and won (277) with three of a kind, Sixes
Seat 9: billikarl showed [9h Ad] and won (276) with three of a kind, Sixes



PokerStars Hand #221899403559: Tournament #3082657132, $0.98+$0.12 USD Hold'em No Limit - Level II (20/40) - 2020/12/27 16:29:36 EET [2020/12/27 9:29:36 ET]
Table '3082657132 62' 9-max Seat #6 is the button
Seat 1: Nevs996 (276 in chips) 
Seat 2: blind9090 (1468 in chips) 
Seat 3: GrandoGui (2594 in chips) 
Seat 4: jcarlos.vale (2766 in chips) 
Seat 5: NikoILAI4 (3000 in chips) 
Seat 6: Jek8235 (3449 in chips) 
Seat 7: thunder402 (5808 in chips) 
Seat 8: ToNutss (3122 in chips) 
Seat 9: billikarl (4352 in chips) 
Nevs996: posts the ante 5
blind9090: posts the ante 5
GrandoGui: posts the ante 5
jcarlos.vale: posts the ante 5
NikoILAI4: posts the ante 5
Jek8235: posts the ante 5
thunder402: posts the ante 5
ToNutss: posts the ante 5
billikarl: posts the ante 5
thunder402: posts small blind 20
ToNutss: posts big blind 40
*** HOLE CARDS ***
Dealt to jcarlos.vale [3h 4c]
billikarl: folds 
Nevs996: raises 231 to 271 and is all-in
blind9090: folds 
GrandoGui: folds 
jcarlos.vale: folds 
NikoILAI4: folds 
Jek8235: calls 271
thunder402: folds 
ToNutss: folds 
*** FLOP *** [2d Ks Kd]
*** TURN *** [2d Ks Kd] [6h]
*** RIVER *** [2d Ks Kd 6h] [Th]
*** SHOW DOWN ***
Nevs996: shows [Jh 9s] (a pair of Kings)
Jek8235: shows [7s As] (a pair of Kings - Ace kicker)
Jek8235 collected 647 from pot
Nevs996 finished the tournament
*** SUMMARY ***
Total pot 647 | Rake 0 
Board [2d Ks Kd 6h Th]
Seat 1: Nevs996 showed [Jh 9s] and lost with a pair of Kings
Seat 2: blind9090 folded before Flop (didn't bet)
Seat 3: GrandoGui folded before Flop (didn't bet)
Seat 4: jcarlos.vale folded before Flop (didn't bet)
Seat 5: NikoILAI4 folded before Flop (didn't bet)
Seat 6: Jek8235 (button) showed [7s As] and won (647) with a pair of Kings
Seat 7: thunder402 (small blind) folded before Flop
Seat 8: ToNutss (big blind) folded before Flop
Seat 9: billikarl folded before Flop (didn't bet)



PokerStars Hand #221899425941: Tournament #3082657132, $0.98+$0.12 USD Hold'em No Limit - Level II (20/40) - 2020/12/27 16:30:16 EET [2020/12/27 9:30:16 ET]
Table '3082657132 62' 9-max Seat #7 is the button
Seat 2: blind9090 (1463 in chips) 
Seat 3: GrandoGui (2589 in chips) 
Seat 4: jcarlos.vale (2761 in chips) 
Seat 5: NikoILAI4 (2995 in chips) 
Seat 6: Jek8235 (3820 in chips) 
Seat 7: thunder402 (5783 in chips) 
Seat 8: ToNutss (3077 in chips) 
Seat 9: billikarl (4347 in chips) 
blind9090: posts the ante 5
GrandoGui: posts the ante 5
jcarlos.vale: posts the ante 5
NikoILAI4: posts the ante 5
Jek8235: posts the ante 5
thunder402: posts the ante 5
ToNutss: posts the ante 5
billikarl: posts the ante 5
ToNutss: posts small blind 20
billikarl: posts big blind 40
*** HOLE CARDS ***
Dealt to jcarlos.vale [9s Js]
blind9090: folds 
GrandoGui: raises 40 to 80
jcarlos.vale: folds 
NikoILAI4: calls 80
Jek8235: folds 
thunder402: calls 80
ToNutss: calls 60
billikarl: calls 40
*** FLOP *** [8h 4s Qc]
ToNutss: checks 
billikarl: bets 40
GrandoGui: calls 40
NikoILAI4: folds 
thunder402: calls 40
ToNutss: folds 
*** TURN *** [8h 4s Qc] [4h]
billikarl: bets 40
GrandoGui: calls 40
thunder402: calls 40
*** RIVER *** [8h 4s Qc 4h] [7s]
billikarl: bets 40
GrandoGui: folds 
thunder402: calls 40
*** SHOW DOWN ***
billikarl: shows [Qd 3d] (two pair, Queens and Fours)
thunder402: shows [Qs Jd] (two pair, Queens and Fours - Jack kicker)
thunder402 collected 760 from pot
*** SUMMARY ***
Total pot 760 | Rake 0 
Board [8h 4s Qc 4h 7s]
Seat 2: blind9090 folded before Flop (didn't bet)
Seat 3: GrandoGui folded on the River
Seat 4: jcarlos.vale folded before Flop (didn't bet)
Seat 5: NikoILAI4 folded on the Flop
Seat 6: Jek8235 folded before Flop (didn't bet)
Seat 7: thunder402 (button) showed [Qs Jd] and won (760) with two pair, Queens and Fours
Seat 8: ToNutss (small blind) folded on the Flop
Seat 9: billikarl (big blind) showed [Qd 3d] and lost with two pair, Queens and Fours



PokerStars Hand #221899502557: Tournament #3082657132, $0.98+$0.12 USD Hold'em No Limit - Level II (20/40) - 2020/12/27 16:32:34 EET [2020/12/27 9:32:34 ET]
Table '3082657132 62' 9-max Seat #8 is the button
Seat 1: sserberuss (3000 in chips) 
Seat 2: blind9090 (1458 in chips) 
Seat 3: GrandoGui (2424 in chips) 
Seat 4: jcarlos.vale (2756 in chips) 
Seat 5: NikoILAI4 (2910 in chips) 
Seat 6: Jek8235 (3815 in chips) 
Seat 7: thunder402 (6338 in chips) 
Seat 8: ToNutss (2992 in chips) 
Seat 9: billikarl (4142 in chips) 
sserberuss: posts the ante 5
blind9090: posts the ante 5
GrandoGui: posts the ante 5
jcarlos.vale: posts the ante 5
NikoILAI4: posts the ante 5
Jek8235: posts the ante 5
thunder402: posts the ante 5
ToNutss: posts the ante 5
billikarl: posts the ante 5
billikarl: posts small blind 20
sserberuss: posts big blind 40
*** HOLE CARDS ***
Dealt to jcarlos.vale [2c Ks]
blind9090: folds 
GrandoGui: folds 
jcarlos.vale: folds 
NikoILAI4: raises 40 to 80
Jek8235: folds 
thunder402: folds 
ToNutss: folds 
billikarl: calls 60
sserberuss has timed out while disconnected
sserberuss: folds 
sserberuss is sitting out
*** FLOP *** [Qd 7d Ah]
billikarl: checks 
NikoILAI4: bets 122
billikarl: folds 
Uncalled bet (122) returned to NikoILAI4
NikoILAI4 collected 245 from pot
NikoILAI4: doesn't show handDTO
*** SUMMARY ***
Total pot 245 | Rake 0 
Board [Qd 7d Ah]
Seat 1: sserberuss (big blind) folded before Flop
Seat 2: blind9090 folded before Flop (didn't bet)
Seat 3: GrandoGui folded before Flop (didn't bet)
Seat 4: jcarlos.vale folded before Flop (didn't bet)
Seat 5: NikoILAI4 collected (245)
Seat 6: Jek8235 folded before Flop (didn't bet)
Seat 7: thunder402 folded before Flop (didn't bet)
Seat 8: ToNutss (button) folded before Flop (didn't bet)
Seat 9: billikarl (small blind) folded on the Flop



PokerStars Hand #221899528797: Tournament #3082657132, $0.98+$0.12 USD Hold'em No Limit - Level II (20/40) - 2020/12/27 16:33:21 EET [2020/12/27 9:33:21 ET]
Table '3082657132 62' 9-max Seat #9 is the button
Seat 1: sserberuss (2955 in chips) is sitting out
Seat 2: blind9090 (1453 in chips) 
Seat 3: GrandoGui (2419 in chips) 
Seat 4: jcarlos.vale (2751 in chips) 
Seat 5: NikoILAI4 (3070 in chips) 
Seat 6: Jek8235 (3810 in chips) 
Seat 7: thunder402 (6333 in chips) 
Seat 8: ToNutss (2987 in chips) 
Seat 9: billikarl (4057 in chips) 
sserberuss: posts the ante 5
blind9090: posts the ante 5
GrandoGui: posts the ante 5
jcarlos.vale: posts the ante 5
NikoILAI4: posts the ante 5
Jek8235: posts the ante 5
thunder402: posts the ante 5
ToNutss: posts the ante 5
billikarl: posts the ante 5
sserberuss: posts small blind 20
blind9090: posts big blind 40
*** HOLE CARDS ***
Dealt to jcarlos.vale [3s Kh]
GrandoGui: folds 
jcarlos.vale: folds 
NikoILAI4: folds 
Jek8235: raises 40 to 80
thunder402: raises 40 to 120
ToNutss: folds 
billikarl: folds 
sserberuss: folds 
blind9090: calls 80
Jek8235: calls 40
*** FLOP *** [4c Kd 6h]
blind9090: checks 
Jek8235: checks 
thunder402: bets 240
blind9090: folds 
Jek8235: folds 
Uncalled bet (240) returned to thunder402
thunder402 collected 425 from pot
thunder402: doesn't show handDTO
*** SUMMARY ***
Total pot 425 | Rake 0 
Board [4c Kd 6h]
Seat 1: sserberuss (small blind) folded before Flop
Seat 2: blind9090 (big blind) folded on the Flop
Seat 3: GrandoGui folded before Flop (didn't bet)
Seat 4: jcarlos.vale folded before Flop (didn't bet)
Seat 5: NikoILAI4 folded before Flop (didn't bet)
Seat 6: Jek8235 folded on the Flop
Seat 7: thunder402 collected (425)
Seat 8: ToNutss folded before Flop (didn't bet)
Seat 9: billikarl (button) folded before Flop (didn't bet)



PokerStars Hand #221899559561: Tournament #3082657132, $0.98+$0.12 USD Hold'em No Limit - Level II (20/40) - 2020/12/27 16:34:17 EET [2020/12/27 9:34:17 ET]
Table '3082657132 62' 9-max Seat #1 is the button
Seat 1: sserberuss (2930 in chips) is sitting out
Seat 2: blind9090 (1328 in chips) 
Seat 3: GrandoGui (2414 in chips) 
Seat 4: jcarlos.vale (2746 in chips) 
Seat 5: NikoILAI4 (3065 in chips) 
Seat 6: Jek8235 (3685 in chips) 
Seat 7: thunder402 (6633 in chips) 
Seat 8: ToNutss (2982 in chips) 
Seat 9: billikarl (4052 in chips) 
sserberuss: posts the ante 5
blind9090: posts the ante 5
GrandoGui: posts the ante 5
jcarlos.vale: posts the ante 5
NikoILAI4: posts the ante 5
Jek8235: posts the ante 5
thunder402: posts the ante 5
ToNutss: posts the ante 5
billikarl: posts the ante 5
blind9090: posts small blind 20
GrandoGui: posts big blind 40
*** HOLE CARDS ***
Dealt to jcarlos.vale [6s 3s]
jcarlos.vale: folds 
NikoILAI4: raises 40 to 80
Jek8235: folds 
thunder402: folds 
ToNutss: folds 
billikarl: calls 80
sserberuss: folds 
blind9090: folds 
GrandoGui: calls 40
*** FLOP *** [Tc 8s 5d]
GrandoGui: checks 
NikoILAI4: checks 
billikarl: bets 40
GrandoGui: calls 40
NikoILAI4: calls 40
*** TURN *** [Tc 8s 5d] [As]
GrandoGui: checks 
NikoILAI4: checks 
billikarl: bets 40
GrandoGui: calls 40
NikoILAI4: folds 
*** RIVER *** [Tc 8s 5d As] [Td]
GrandoGui: checks 
billikarl: checks 
*** SHOW DOWN ***
GrandoGui: shows [Jd Th] (three of a kind, Tens)
billikarl: mucks handDTO
GrandoGui collected 505 from pot
*** SUMMARY ***
Total pot 505 | Rake 0 
Board [Tc 8s 5d As Td]
Seat 1: sserberuss (button) folded before Flop (didn't bet)
Seat 2: blind9090 (small blind) folded before Flop
Seat 3: GrandoGui (big blind) showed [Jd Th] and won (505) with three of a kind, Tens
Seat 4: jcarlos.vale folded before Flop (didn't bet)
Seat 5: NikoILAI4 folded on the Turn
Seat 6: Jek8235 folded before Flop (didn't bet)
Seat 7: thunder402 folded before Flop (didn't bet)
Seat 8: ToNutss folded before Flop (didn't bet)
Seat 9: billikarl mucked [8c 9d]



PokerStars Hand #221899608455: Tournament #3082657132, $0.98+$0.12 USD Hold'em No Limit - Level III (25/50) - 2020/12/27 16:35:45 EET [2020/12/27 9:35:45 ET]
Table '3082657132 62' 9-max Seat #2 is the button
Seat 1: sserberuss (2925 in chips) is sitting out
Seat 2: blind9090 (1303 in chips) 
Seat 3: GrandoGui (2754 in chips) 
Seat 4: jcarlos.vale (2741 in chips) 
Seat 5: NikoILAI4 (2940 in chips) 
Seat 6: Jek8235 (3680 in chips) 
Seat 7: thunder402 (6628 in chips) 
Seat 8: ToNutss (2977 in chips) 
Seat 9: billikarl (3887 in chips) 
sserberuss: posts the ante 6
blind9090: posts the ante 6
GrandoGui: posts the ante 6
jcarlos.vale: posts the ante 6
NikoILAI4: posts the ante 6
Jek8235: posts the ante 6
thunder402: posts the ante 6
ToNutss: posts the ante 6
billikarl: posts the ante 6
GrandoGui: posts small blind 25
jcarlos.vale: posts big blind 50
*** HOLE CARDS ***
Dealt to jcarlos.vale [Qh 6c]
NikoILAI4: folds 
Jek8235: folds 
thunder402: calls 50
ToNutss: folds 
billikarl: folds 
sserberuss: folds 
blind9090: folds 
sserberuss has returned
GrandoGui: calls 25
jcarlos.vale: checks 
*** FLOP *** [8d 2h 2s]
GrandoGui: checks 
jcarlos.vale: checks 
thunder402: checks 
*** TURN *** [8d 2h 2s] [Td]
GrandoGui: checks 
jcarlos.vale: checks 
thunder402: checks 
*** RIVER *** [8d 2h 2s Td] [4c]
GrandoGui: checks 
jcarlos.vale: checks 
thunder402: checks 
*** SHOW DOWN ***
GrandoGui: shows [6d 3c] (a pair of Deuces)
jcarlos.vale: shows [Qh 6c] (a pair of Deuces - Queen kicker)
thunder402: shows [9s Ks] (a pair of Deuces - King kicker)
thunder402 collected 204 from pot
*** SUMMARY ***
Total pot 204 | Rake 0 
Board [8d 2h 2s Td 4c]
Seat 1: sserberuss folded before Flop (didn't bet)
Seat 2: blind9090 (button) folded before Flop (didn't bet)
Seat 3: GrandoGui (small blind) showed [6d 3c] and lost with a pair of Deuces
Seat 4: jcarlos.vale (big blind) showed [Qh 6c] and lost with a pair of Deuces
Seat 5: NikoILAI4 folded before Flop (didn't bet)
Seat 6: Jek8235 folded before Flop (didn't bet)
Seat 7: thunder402 showed [9s Ks] and won (204) with a pair of Deuces
Seat 8: ToNutss folded before Flop (didn't bet)
Seat 9: billikarl folded before Flop (didn't bet)



PokerStars Hand #221899665764: Tournament #3082657132, $0.98+$0.12 USD Hold'em No Limit - Level III (25/50) - 2020/12/27 16:37:27 EET [2020/12/27 9:37:27 ET]
Table '3082657132 62' 9-max Seat #3 is the button
Seat 1: sserberuss (2919 in chips) 
Seat 2: blind9090 (1297 in chips) 
Seat 3: GrandoGui (2698 in chips) 
Seat 4: jcarlos.vale (2685 in chips) 
Seat 5: NikoILAI4 (2934 in chips) 
Seat 6: Jek8235 (3674 in chips) 
Seat 7: thunder402 (6776 in chips) 
Seat 8: ToNutss (2971 in chips) 
Seat 9: billikarl (3881 in chips) 
sserberuss: posts the ante 6
blind9090: posts the ante 6
GrandoGui: posts the ante 6
jcarlos.vale: posts the ante 6
NikoILAI4: posts the ante 6
Jek8235: posts the ante 6
thunder402: posts the ante 6
ToNutss: posts the ante 6
billikarl: posts the ante 6
jcarlos.vale: posts small blind 25
NikoILAI4: posts big blind 50
*** HOLE CARDS ***
Dealt to jcarlos.vale [7c Tc]
Jek8235: folds 
thunder402: raises 100 to 150
ToNutss: folds 
billikarl: folds 
sserberuss: folds 
blind9090: folds 
GrandoGui: folds 
jcarlos.vale: folds 
NikoILAI4: folds 
Uncalled bet (100) returned to thunder402
thunder402 collected 179 from pot
thunder402: doesn't show handDTO
*** SUMMARY ***
Total pot 179 | Rake 0 
Seat 1: sserberuss folded before Flop (didn't bet)
Seat 2: blind9090 folded before Flop (didn't bet)
Seat 3: GrandoGui (button) folded before Flop (didn't bet)
Seat 4: jcarlos.vale (small blind) folded before Flop
Seat 5: NikoILAI4 (big blind) folded before Flop
Seat 6: Jek8235 folded before Flop (didn't bet)
Seat 7: thunder402 collected (179)
Seat 8: ToNutss folded before Flop (didn't bet)
Seat 9: billikarl folded before Flop (didn't bet)



PokerStars Hand #221899697213: Tournament #3082657132, $0.98+$0.12 USD Hold'em No Limit - Level III (25/50) - 2020/12/27 16:38:23 EET [2020/12/27 9:38:23 ET]
Table '3082657132 62' 9-max Seat #4 is the button
Seat 1: sserberuss (2913 in chips) 
Seat 2: blind9090 (1291 in chips) 
Seat 3: GrandoGui (2692 in chips) 
Seat 4: jcarlos.vale (2654 in chips) 
Seat 5: NikoILAI4 (2878 in chips) 
Seat 6: Jek8235 (3668 in chips) 
Seat 7: thunder402 (6899 in chips) 
Seat 8: ToNutss (2965 in chips) 
Seat 9: billikarl (3875 in chips) 
sserberuss: posts the ante 6
blind9090: posts the ante 6
GrandoGui: posts the ante 6
jcarlos.vale: posts the ante 6
NikoILAI4: posts the ante 6
Jek8235: posts the ante 6
thunder402: posts the ante 6
ToNutss: posts the ante 6
billikarl: posts the ante 6
NikoILAI4: posts small blind 25
Jek8235: posts big blind 50
*** HOLE CARDS ***
Dealt to jcarlos.vale [8s As]
thunder402: calls 50
ToNutss: folds 
billikarl: folds 
sserberuss: folds 
blind9090: folds 
GrandoGui: folds 
jcarlos.vale: raises 80 to 130
NikoILAI4: calls 105
Jek8235: raises 320 to 450
thunder402: folds 
jcarlos.vale: folds 
NikoILAI4: calls 320
*** FLOP *** [Ts 6d Jc]
NikoILAI4: checks 
Jek8235: bets 425
NikoILAI4: calls 425
*** TURN *** [Ts 6d Jc] [Jh]
NikoILAI4: checks 
Jek8235: checks 
*** RIVER *** [Ts 6d Jc Jh] [7d]
NikoILAI4: checks 
Jek8235: checks 
*** SHOW DOWN ***
NikoILAI4: shows [Qs Ks] (a pair of Jacks)
Jek8235: shows [Qc Ac] (a pair of Jacks - Ace kicker)
Jek8235 collected 1984 from pot
*** SUMMARY ***
Total pot 1984 | Rake 0 
Board [Ts 6d Jc Jh 7d]
Seat 1: sserberuss folded before Flop (didn't bet)
Seat 2: blind9090 folded before Flop (didn't bet)
Seat 3: GrandoGui folded before Flop (didn't bet)
Seat 4: jcarlos.vale (button) folded before Flop
Seat 5: NikoILAI4 (small blind) showed [Qs Ks] and lost with a pair of Jacks
Seat 6: Jek8235 (big blind) showed [Qc Ac] and won (1984) with a pair of Jacks
Seat 7: thunder402 folded before Flop
Seat 8: ToNutss folded before Flop (didn't bet)
Seat 9: billikarl folded before Flop (didn't bet)



PokerStars Hand #221899736934: Tournament #3082657132, $0.98+$0.12 USD Hold'em No Limit - Level III (25/50) - 2020/12/27 16:39:33 EET [2020/12/27 9:39:33 ET]
Table '3082657132 62' 9-max Seat #5 is the button
Seat 1: sserberuss (2907 in chips) 
Seat 2: blind9090 (1285 in chips) 
Seat 3: GrandoGui (2686 in chips) 
Seat 4: jcarlos.vale (2518 in chips) 
Seat 5: NikoILAI4 (1997 in chips) 
Seat 6: Jek8235 (4771 in chips) 
Seat 7: thunder402 (6843 in chips) 
Seat 8: ToNutss (2959 in chips) 
Seat 9: billikarl (3869 in chips) 
sserberuss: posts the ante 6
blind9090: posts the ante 6
GrandoGui: posts the ante 6
jcarlos.vale: posts the ante 6
NikoILAI4: posts the ante 6
Jek8235: posts the ante 6
thunder402: posts the ante 6
ToNutss: posts the ante 6
billikarl: posts the ante 6
Jek8235: posts small blind 25
thunder402: posts big blind 50
*** HOLE CARDS ***
Dealt to jcarlos.vale [Ad 8h]
ToNutss: folds 
billikarl: calls 50
sserberuss: folds 
blind9090: folds 
GrandoGui: folds 
jcarlos.vale: folds 
NikoILAI4: calls 50
Jek8235: raises 250 to 300
thunder402: folds 
billikarl: calls 250
NikoILAI4: calls 250
*** FLOP *** [Ac 9s 5h]
Jek8235: bets 375
billikarl: folds 
NikoILAI4: folds 
Uncalled bet (375) returned to Jek8235
Jek8235 collected 1004 from pot
Jek8235: doesn't show handDTO
*** SUMMARY ***
Total pot 1004 | Rake 0 
Board [Ac 9s 5h]
Seat 1: sserberuss folded before Flop (didn't bet)
Seat 2: blind9090 folded before Flop (didn't bet)
Seat 3: GrandoGui folded before Flop (didn't bet)
Seat 4: jcarlos.vale folded before Flop (didn't bet)
Seat 5: NikoILAI4 (button) folded on the Flop
Seat 6: Jek8235 (small blind) collected (1004)
Seat 7: thunder402 (big blind) folded before Flop
Seat 8: ToNutss folded before Flop (didn't bet)
Seat 9: billikarl folded on the Flop



PokerStars Hand #221899775511: Tournament #3082657132, $0.98+$0.12 USD Hold'em No Limit - Level III (25/50) - 2020/12/27 16:40:41 EET [2020/12/27 9:40:41 ET]
Table '3082657132 62' 9-max Seat #6 is the button
Seat 1: sserberuss (2901 in chips) 
Seat 3: GrandoGui (2680 in chips) 
Seat 4: jcarlos.vale (2512 in chips) 
Seat 5: NikoILAI4 (1691 in chips) 
Seat 6: Jek8235 (5469 in chips) 
Seat 7: thunder402 (6787 in chips) 
Seat 8: ToNutss (2953 in chips) 
Seat 9: billikarl (3563 in chips) 
sserberuss: posts the ante 6
GrandoGui: posts the ante 6
jcarlos.vale: posts the ante 6
NikoILAI4: posts the ante 6
Jek8235: posts the ante 6
thunder402: posts the ante 6
ToNutss: posts the ante 6
billikarl: posts the ante 6
thunder402: posts small blind 25
ToNutss: posts big blind 50
*** HOLE CARDS ***
Dealt to jcarlos.vale [Ks Td]
billikarl: calls 50
sserberuss: calls 50
GrandoGui: folds 
jcarlos.vale: folds 
NikoILAI4: folds 
Jek8235: folds 
thunder402: calls 25
ToNutss: raises 200 to 250
billikarl: calls 200
sserberuss: calls 200
thunder402: folds 
*** FLOP *** [Kh Jd 5d]
ToNutss: bets 382
billikarl: folds 
sserberuss: raises 418 to 800
ToNutss: raises 1897 to 2697 and is all-in
sserberuss: calls 1845 and is all-in
Uncalled bet (52) returned to ToNutss
*** TURN *** [Kh Jd 5d] [6d]
*** RIVER *** [Kh Jd 5d 6d] [8c]
*** SHOW DOWN ***
ToNutss: shows [As Ad] (a pair of Aces)
sserberuss: shows [5h 5c] (three of a kind, Fives)
sserberuss collected 6138 from pot
*** SUMMARY ***
Total pot 6138 | Rake 0 
Board [Kh Jd 5d 6d 8c]
Seat 1: sserberuss showed [5h 5c] and won (6138) with three of a kind, Fives
Seat 3: GrandoGui folded before Flop (didn't bet)
Seat 4: jcarlos.vale folded before Flop (didn't bet)
Seat 5: NikoILAI4 folded before Flop (didn't bet)
Seat 6: Jek8235 (button) folded before Flop (didn't bet)
Seat 7: thunder402 (small blind) folded before Flop
Seat 8: ToNutss (big blind) showed [As Ad] and lost with a pair of Aces
Seat 9: billikarl folded on the Flop



PokerStars Hand #221899816396: Tournament #3082657132, $0.98+$0.12 USD Hold'em No Limit - Level III (25/50) - 2020/12/27 16:41:53 EET [2020/12/27 9:41:53 ET]
Table '3082657132 62' 9-max Seat #7 is the button
Seat 1: sserberuss (6138 in chips) 
Seat 2: culpi2707 (3000 in chips) 
Seat 3: GrandoGui (2674 in chips) 
Seat 4: jcarlos.vale (2506 in chips) 
Seat 5: NikoILAI4 (1685 in chips) 
Seat 6: Jek8235 (5463 in chips) 
Seat 7: thunder402 (6731 in chips) 
Seat 8: ToNutss (52 in chips) 
Seat 9: billikarl (3307 in chips) 
sserberuss: posts the ante 6
culpi2707: posts the ante 6
GrandoGui: posts the ante 6
jcarlos.vale: posts the ante 6
NikoILAI4: posts the ante 6
Jek8235: posts the ante 6
thunder402: posts the ante 6
ToNutss: posts the ante 6
billikarl: posts the ante 6
ToNutss: posts small blind 25
billikarl: posts big blind 50
*** HOLE CARDS ***
Dealt to jcarlos.vale [4c 4s]
sserberuss: folds 
culpi2707: folds 
GrandoGui: folds 
jcarlos.vale: raises 80 to 130
NikoILAI4: calls 130
Jek8235: folds 
thunder402: folds 
ToNutss: calls 21 and is all-in
billikarl: folds 
*** FLOP *** [5h 8d 8h]
jcarlos.vale: checks 
NikoILAI4: checks 
*** TURN *** [5h 8d 8h] [Ac]
jcarlos.vale: checks 
NikoILAI4: checks 
*** RIVER *** [5h 8d 8h Ac] [Qd]
jcarlos.vale: checks 
NikoILAI4: checks 
*** SHOW DOWN ***
jcarlos.vale: shows [4c 4s] (two pair, Eights and Fours)
NikoILAI4: mucks handDTO
jcarlos.vale collected 172 from side pot
ToNutss: mucks handDTO
jcarlos.vale collected 238 from main pot
ToNutss finished the tournament
*** SUMMARY ***
Total pot 410 Main pot 238. Side pot 172. | Rake 0 
Board [5h 8d 8h Ac Qd]
Seat 1: sserberuss folded before Flop (didn't bet)
Seat 2: culpi2707 folded before Flop (didn't bet)
Seat 3: GrandoGui folded before Flop (didn't bet)
Seat 4: jcarlos.vale showed [4c 4s] and won (410) with two pair, Eights and Fours
Seat 5: NikoILAI4 mucked [Td 9s]
Seat 6: Jek8235 folded before Flop (didn't bet)
Seat 7: thunder402 (button) folded before Flop (didn't bet)
Seat 8: ToNutss (small blind) mucked [Kc 2s]
Seat 9: billikarl (big blind) folded before Flop



PokerStars Hand #221899842168: Tournament #3082657132, $0.98+$0.12 USD Hold'em No Limit - Level III (25/50) - 2020/12/27 16:42:38 EET [2020/12/27 9:42:38 ET]
Table '3082657132 62' 9-max Seat #9 is the button
Seat 1: sserberuss (6132 in chips) 
Seat 2: culpi2707 (2994 in chips) 
Seat 3: GrandoGui (2668 in chips) 
Seat 4: jcarlos.vale (2780 in chips) 
Seat 5: NikoILAI4 (1549 in chips) 
Seat 6: Jek8235 (5457 in chips) 
Seat 7: thunder402 (6725 in chips) 
Seat 9: billikarl (3251 in chips) 
sserberuss: posts the ante 6
culpi2707: posts the ante 6
GrandoGui: posts the ante 6
jcarlos.vale: posts the ante 6
NikoILAI4: posts the ante 6
Jek8235: posts the ante 6
thunder402: posts the ante 6
billikarl: posts the ante 6
sserberuss: posts small blind 25
culpi2707: posts big blind 50
*** HOLE CARDS ***
Dealt to jcarlos.vale [4h 5d]
GrandoGui: folds 
jcarlos.vale: folds 
NikoILAI4: calls 50
Jek8235: calls 50
thunder402: folds 
billikarl: calls 50
sserberuss: calls 25
culpi2707: checks 
*** FLOP *** [2h 7c 9d]
sserberuss: checks 
culpi2707: checks 
NikoILAI4: checks 
Jek8235: bets 150
billikarl: folds 
sserberuss: folds 
culpi2707: folds 
NikoILAI4: folds 
Uncalled bet (150) returned to Jek8235
Jek8235 collected 298 from pot
Jek8235: doesn't show handDTO
*** SUMMARY ***
Total pot 298 | Rake 0 
Board [2h 7c 9d]
Seat 1: sserberuss (small blind) folded on the Flop
Seat 2: culpi2707 (big blind) folded on the Flop
Seat 3: GrandoGui folded before Flop (didn't bet)
Seat 4: jcarlos.vale folded before Flop (didn't bet)
Seat 5: NikoILAI4 folded on the Flop
Seat 6: Jek8235 collected (298)
Seat 7: thunder402 folded before Flop (didn't bet)
Seat 9: billikarl (button) folded on the Flop



PokerStars Hand #221899871393: Tournament #3082657132, $0.98+$0.12 USD Hold'em No Limit - Level III (25/50) - 2020/12/27 16:43:28 EET [2020/12/27 9:43:28 ET]
Table '3082657132 62' 9-max Seat #1 is the button
Seat 1: sserberuss (6076 in chips) 
Seat 2: culpi2707 (2938 in chips) 
Seat 3: GrandoGui (2662 in chips) 
Seat 4: jcarlos.vale (2774 in chips) 
Seat 6: Jek8235 (5699 in chips) 
Seat 7: thunder402 (6719 in chips) 
Seat 8: Tima 190787 (3000 in chips) 
Seat 9: billikarl (3195 in chips) 
sserberuss: posts the ante 6
culpi2707: posts the ante 6
GrandoGui: posts the ante 6
jcarlos.vale: posts the ante 6
Jek8235: posts the ante 6
thunder402: posts the ante 6
Tima 190787: posts the ante 6
billikarl: posts the ante 6
culpi2707: posts small blind 25
GrandoGui: posts big blind 50
*** HOLE CARDS ***
Dealt to jcarlos.vale [Js 2s]
jcarlos.vale: folds 
Jek8235: folds 
thunder402: folds 
Tima 190787: folds 
billikarl: calls 50
sserberuss: folds 
culpi2707: raises 175 to 225
GrandoGui: folds 
billikarl: calls 175
*** FLOP *** [Th 5d 6s]
culpi2707: bets 170
billikarl: calls 170
*** TURN *** [Th 5d 6s] [2d]
culpi2707: checks 
billikarl: checks 
*** RIVER *** [Th 5d 6s 2d] [Jh]
culpi2707: bets 750
billikarl: folds 
Uncalled bet (750) returned to culpi2707
culpi2707 collected 888 from pot
culpi2707: doesn't show handDTO
*** SUMMARY ***
Total pot 888 | Rake 0 
Board [Th 5d 6s 2d Jh]
Seat 1: sserberuss (button) folded before Flop (didn't bet)
Seat 2: culpi2707 (small blind) collected (888)
Seat 3: GrandoGui (big blind) folded before Flop
Seat 4: jcarlos.vale folded before Flop (didn't bet)
Seat 6: Jek8235 folded before Flop (didn't bet)
Seat 7: thunder402 folded before Flop (didn't bet)
Seat 8: Tima 190787 folded before Flop (didn't bet)
Seat 9: billikarl folded on the River



PokerStars Hand #221899898000: Tournament #3082657132, $0.98+$0.12 USD Hold'em No Limit - Level III (25/50) - 2020/12/27 16:44:15 EET [2020/12/27 9:44:15 ET]
Table '3082657132 62' 9-max Seat #2 is the button
Seat 1: sserberuss (6070 in chips) 
Seat 2: culpi2707 (3425 in chips) 
Seat 3: GrandoGui (2606 in chips) 
Seat 4: jcarlos.vale (2768 in chips) 
Seat 5: kensui (3000 in chips) 
Seat 6: Jek8235 (5693 in chips) 
Seat 7: thunder402 (6713 in chips) 
Seat 8: Tima 190787 (2994 in chips) 
Seat 9: billikarl (2794 in chips) 
sserberuss: posts the ante 6
culpi2707: posts the ante 6
GrandoGui: posts the ante 6
jcarlos.vale: posts the ante 6
kensui: posts the ante 6
Jek8235: posts the ante 6
thunder402: posts the ante 6
Tima 190787: posts the ante 6
billikarl: posts the ante 6
GrandoGui: posts small blind 25
jcarlos.vale: posts big blind 50
*** HOLE CARDS ***
Dealt to jcarlos.vale [2c 8c]
kensui: raises 100 to 150
Jek8235: folds 
thunder402: raises 100 to 250
Tima 190787: folds 
billikarl: folds 
sserberuss: folds 
culpi2707: folds 
GrandoGui: folds 
jcarlos.vale: folds 
kensui: raises 2744 to 2994 and is all-in
thunder402: folds 
Uncalled bet (2744) returned to kensui
kensui collected 629 from pot
kensui: doesn't show handDTO
*** SUMMARY ***
Total pot 629 | Rake 0 
Seat 1: sserberuss folded before Flop (didn't bet)
Seat 2: culpi2707 (button) folded before Flop (didn't bet)
Seat 3: GrandoGui (small blind) folded before Flop
Seat 4: jcarlos.vale (big blind) folded before Flop
Seat 5: kensui collected (629)
Seat 6: Jek8235 folded before Flop (didn't bet)
Seat 7: thunder402 folded before Flop
Seat 8: Tima 190787 folded before Flop (didn't bet)
Seat 9: billikarl folded before Flop (didn't bet)



PokerStars Hand #221899925103: Tournament #3082657132, $0.98+$0.12 USD Hold'em No Limit - Level III (25/50) - 2020/12/27 16:45:01 EET [2020/12/27 9:45:01 ET]
Table '3082657132 62' 9-max Seat #3 is the button
Seat 1: sserberuss (6064 in chips) 
Seat 2: culpi2707 (3419 in chips) 
Seat 3: GrandoGui (2575 in chips) 
Seat 4: jcarlos.vale (2712 in chips) 
Seat 5: kensui (3373 in chips) 
Seat 6: Jek8235 (5687 in chips) 
Seat 7: thunder402 (6457 in chips) 
Seat 8: Tima 190787 (2988 in chips) 
Seat 9: billikarl (2788 in chips) 
sserberuss: posts the ante 6
culpi2707: posts the ante 6
GrandoGui: posts the ante 6
jcarlos.vale: posts the ante 6
kensui: posts the ante 6
Jek8235: posts the ante 6
thunder402: posts the ante 6
Tima 190787: posts the ante 6
billikarl: posts the ante 6
jcarlos.vale: posts small blind 25
kensui: posts big blind 50
*** HOLE CARDS ***
Dealt to jcarlos.vale [Ks 7d]
Jek8235: raises 50 to 100
thunder402: folds 
Tima 190787: folds 
billikarl: folds 
sserberuss: folds 
culpi2707: folds 
GrandoGui: folds 
jcarlos.vale: folds 
kensui: calls 50
*** FLOP *** [As 3s Js]
kensui: checks 
Jek8235: bets 100
kensui: folds 
Uncalled bet (100) returned to Jek8235
Jek8235 collected 279 from pot
Jek8235: doesn't show handDTO
*** SUMMARY ***
Total pot 279 | Rake 0 
Board [As 3s Js]
Seat 1: sserberuss folded before Flop (didn't bet)
Seat 2: culpi2707 folded before Flop (didn't bet)
Seat 3: GrandoGui (button) folded before Flop (didn't bet)
Seat 4: jcarlos.vale (small blind) folded before Flop
Seat 5: kensui (big blind) folded on the Flop
Seat 6: Jek8235 collected (279)
Seat 7: thunder402 folded before Flop (didn't bet)
Seat 8: Tima 190787 folded before Flop (didn't bet)
Seat 9: billikarl folded before Flop (didn't bet)



PokerStars Hand #221899960888: Tournament #3082657132, $0.98+$0.12 USD Hold'em No Limit - Level IV (30/60) - 2020/12/27 16:46:03 EET [2020/12/27 9:46:03 ET]
Table '3082657132 62' 9-max Seat #4 is the button
Seat 1: sserberuss (6058 in chips) 
Seat 2: culpi2707 (3413 in chips) 
Seat 3: GrandoGui (2569 in chips) 
Seat 4: jcarlos.vale (2681 in chips) 
Seat 5: kensui (3267 in chips) 
Seat 6: Jek8235 (5860 in chips) 
Seat 7: thunder402 (6451 in chips) 
Seat 8: Tima 190787 (2982 in chips) 
Seat 9: billikarl (2782 in chips) 
sserberuss: posts the ante 7
culpi2707: posts the ante 7
GrandoGui: posts the ante 7
jcarlos.vale: posts the ante 7
kensui: posts the ante 7
Jek8235: posts the ante 7
thunder402: posts the ante 7
Tima 190787: posts the ante 7
billikarl: posts the ante 7
kensui: posts small blind 30
Jek8235: posts big blind 60
*** HOLE CARDS ***
Dealt to jcarlos.vale [Ad 9d]
thunder402: raises 180 to 240
Tima 190787: folds 
billikarl: folds 
sserberuss: folds 
culpi2707: folds 
GrandoGui: folds 
jcarlos.vale: folds 
kensui: folds 
Jek8235: folds 
Uncalled bet (180) returned to thunder402
thunder402 collected 213 from pot
thunder402: doesn't show handDTO
*** SUMMARY ***
Total pot 213 | Rake 0 
Seat 1: sserberuss folded before Flop (didn't bet)
Seat 2: culpi2707 folded before Flop (didn't bet)
Seat 3: GrandoGui folded before Flop (didn't bet)
Seat 4: jcarlos.vale (button) folded before Flop (didn't bet)
Seat 5: kensui (small blind) folded before Flop
Seat 6: Jek8235 (big blind) folded before Flop
Seat 7: thunder402 collected (213)
Seat 8: Tima 190787 folded before Flop (didn't bet)
Seat 9: billikarl folded before Flop (didn't bet)



PokerStars Hand #221899980889: Tournament #3082657132, $0.98+$0.12 USD Hold'em No Limit - Level IV (30/60) - 2020/12/27 16:46:38 EET [2020/12/27 9:46:38 ET]
Table '3082657132 62' 9-max Seat #5 is the button
Seat 1: sserberuss (6051 in chips) 
Seat 2: culpi2707 (3406 in chips) 
Seat 3: GrandoGui (2562 in chips) 
Seat 4: jcarlos.vale (2674 in chips) 
Seat 5: kensui (3230 in chips) 
Seat 6: Jek8235 (5793 in chips) 
Seat 7: thunder402 (6597 in chips) 
Seat 8: Tima 190787 (2975 in chips) 
Seat 9: billikarl (2775 in chips) 
sserberuss: posts the ante 7
culpi2707: posts the ante 7
GrandoGui: posts the ante 7
jcarlos.vale: posts the ante 7
kensui: posts the ante 7
Jek8235: posts the ante 7
thunder402: posts the ante 7
Tima 190787: posts the ante 7
billikarl: posts the ante 7
Jek8235: posts small blind 30
thunder402: posts big blind 60
*** HOLE CARDS ***
Dealt to jcarlos.vale [Ad 8c]
Tima 190787: folds 
billikarl: calls 60
sserberuss: folds 
culpi2707: folds 
GrandoGui: folds 
jcarlos.vale: calls 60
kensui: calls 60
Jek8235: folds 
thunder402: checks 
*** FLOP *** [6c Jh 3c]
thunder402: checks 
billikarl: checks 
jcarlos.vale: bets 120
kensui: calls 120
thunder402: calls 120
billikarl: calls 120
*** TURN *** [6c Jh 3c] [9h]
thunder402: checks 
billikarl: checks 
jcarlos.vale: checks 
kensui: bets 300
thunder402: folds 
billikarl: calls 300
jcarlos.vale: folds 
*** RIVER *** [6c Jh 3c 9h] [8d]
billikarl: checks 
kensui: checks 
*** SHOW DOWN ***
billikarl: shows [9c 5c] (a pair of Nines)
kensui: shows [Jd Ac] (a pair of Jacks)
kensui collected 1413 from pot
*** SUMMARY ***
Total pot 1413 | Rake 0 
Board [6c Jh 3c 9h 8d]
Seat 1: sserberuss folded before Flop (didn't bet)
Seat 2: culpi2707 folded before Flop (didn't bet)
Seat 3: GrandoGui folded before Flop (didn't bet)
Seat 4: jcarlos.vale folded on the Turn
Seat 5: kensui (button) showed [Jd Ac] and won (1413) with a pair of Jacks
Seat 6: Jek8235 (small blind) folded before Flop
Seat 7: thunder402 (big blind) folded on the Turn
Seat 8: Tima 190787 folded before Flop (didn't bet)
Seat 9: billikarl showed [9c 5c] and lost with a pair of Nines



PokerStars Hand #221900031360: Tournament #3082657132, $0.98+$0.12 USD Hold'em No Limit - Level IV (30/60) - 2020/12/27 16:48:06 EET [2020/12/27 9:48:06 ET]
Table '3082657132 62' 9-max Seat #6 is the button
Seat 1: sserberuss (6044 in chips) 
Seat 2: culpi2707 (3399 in chips) 
Seat 3: GrandoGui (2555 in chips) 
Seat 4: jcarlos.vale (2487 in chips) 
Seat 5: kensui (4156 in chips) 
Seat 6: Jek8235 (5756 in chips) 
Seat 7: thunder402 (6410 in chips) 
Seat 8: Tima 190787 (2968 in chips) 
Seat 9: billikarl (2288 in chips) 
sserberuss: posts the ante 7
culpi2707: posts the ante 7
GrandoGui: posts the ante 7
jcarlos.vale: posts the ante 7
kensui: posts the ante 7
Jek8235: posts the ante 7
thunder402: posts the ante 7
Tima 190787: posts the ante 7
billikarl: posts the ante 7
thunder402: posts small blind 30
Tima 190787: posts big blind 60
*** HOLE CARDS ***
Dealt to jcarlos.vale [8c 2c]
billikarl: calls 60
sserberuss: folds 
culpi2707: folds 
GrandoGui: folds 
jcarlos.vale: folds 
kensui: calls 60
Jek8235: folds 
thunder402: calls 30
Tima 190787: checks 
*** FLOP *** [2s 3s 8s]
thunder402: checks 
Tima 190787: checks 
billikarl: checks 
kensui: checks 
*** TURN *** [2s 3s 8s] [4d]
thunder402: checks 
Tima 190787: checks 
billikarl: checks 
kensui: checks 
*** RIVER *** [2s 3s 8s 4d] [Qs]
thunder402: checks 
Tima 190787: checks 
billikarl: checks 
kensui: bets 60
thunder402: raises 212 to 272
Tima 190787: folds 
billikarl: folds 
kensui: calls 212
*** SHOW DOWN ***
thunder402: shows [Qd Js] (a flush, Queen high)
kensui: mucks handDTO
thunder402 collected 847 from pot
*** SUMMARY ***
Total pot 847 | Rake 0 
Board [2s 3s 8s 4d Qs]
Seat 1: sserberuss folded before Flop (didn't bet)
Seat 2: culpi2707 folded before Flop (didn't bet)
Seat 3: GrandoGui folded before Flop (didn't bet)
Seat 4: jcarlos.vale folded before Flop (didn't bet)
Seat 5: kensui mucked [Ts 9h]
Seat 6: Jek8235 (button) folded before Flop (didn't bet)
Seat 7: thunder402 (small blind) showed [Qd Js] and won (847) with a flush, Queen high
Seat 8: Tima 190787 (big blind) folded on the River
Seat 9: billikarl folded on the River



PokerStars Hand #221900079957: Tournament #3082657132, $0.98+$0.12 USD Hold'em No Limit - Level IV (30/60) - 2020/12/27 16:49:30 EET [2020/12/27 9:49:30 ET]
Table '3082657132 62' 9-max Seat #7 is the button
Seat 1: sserberuss (6037 in chips) 
Seat 2: culpi2707 (3392 in chips) 
Seat 3: GrandoGui (2548 in chips) 
Seat 4: jcarlos.vale (2480 in chips) 
Seat 5: kensui (3817 in chips) 
Seat 6: Jek8235 (5749 in chips) 
Seat 7: thunder402 (6918 in chips) 
Seat 8: Tima 190787 (2901 in chips) 
Seat 9: billikarl (2221 in chips) 
sserberuss: posts the ante 7
culpi2707: posts the ante 7
GrandoGui: posts the ante 7
jcarlos.vale: posts the ante 7
kensui: posts the ante 7
Jek8235: posts the ante 7
thunder402: posts the ante 7
Tima 190787: posts the ante 7
billikarl: posts the ante 7
Tima 190787: posts small blind 30
billikarl: posts big blind 60
*** HOLE CARDS ***
Dealt to jcarlos.vale [7s Kc]
sserberuss: folds 
culpi2707: folds 
GrandoGui: folds 
jcarlos.vale: folds 
kensui: raises 69 to 129
Jek8235: calls 129
thunder402: calls 129
Tima 190787: folds 
billikarl: folds 
*** FLOP *** [8h 8d Ks]
kensui: bets 405
Jek8235: folds 
thunder402: folds 
Uncalled bet (405) returned to kensui
kensui collected 540 from pot
kensui: doesn't show handDTO
*** SUMMARY ***
Total pot 540 | Rake 0 
Board [8h 8d Ks]
Seat 1: sserberuss folded before Flop (didn't bet)
Seat 2: culpi2707 folded before Flop (didn't bet)
Seat 3: GrandoGui folded before Flop (didn't bet)
Seat 4: jcarlos.vale folded before Flop (didn't bet)
Seat 5: kensui collected (540)
Seat 6: Jek8235 folded on the Flop
Seat 7: thunder402 (button) folded on the Flop
Seat 8: Tima 190787 (small blind) folded before Flop
Seat 9: billikarl (big blind) folded before Flop



PokerStars Hand #221900104952: Tournament #3082657132, $0.98+$0.12 USD Hold'em No Limit - Level IV (30/60) - 2020/12/27 16:50:13 EET [2020/12/27 9:50:13 ET]
Table '3082657132 62' 9-max Seat #8 is the button
Seat 1: sserberuss (6030 in chips) 
Seat 2: culpi2707 (3385 in chips) 
Seat 3: GrandoGui (2541 in chips) 
Seat 4: jcarlos.vale (2473 in chips) 
Seat 5: kensui (4221 in chips) 
Seat 6: Jek8235 (5613 in chips) 
Seat 7: thunder402 (6782 in chips) 
Seat 8: Tima 190787 (2864 in chips) 
Seat 9: billikarl (2154 in chips) 
sserberuss: posts the ante 7
culpi2707: posts the ante 7
GrandoGui: posts the ante 7
jcarlos.vale: posts the ante 7
kensui: posts the ante 7
Jek8235: posts the ante 7
thunder402: posts the ante 7
Tima 190787: posts the ante 7
billikarl: posts the ante 7
billikarl: posts small blind 30
sserberuss: posts big blind 60
*** HOLE CARDS ***
Dealt to jcarlos.vale [6d 9h]
culpi2707: folds 
GrandoGui: folds 
jcarlos.vale: folds 
kensui: calls 60
Jek8235: folds 
thunder402: raises 60 to 120
Tima 190787: folds 
billikarl: calls 90
sserberuss: raises 300 to 420
kensui: raises 3794 to 4214 and is all-in
thunder402: folds 
billikarl: calls 2027 and is all-in
sserberuss: calls 3794
*** FLOP *** [4d 6h 9s]
*** TURN *** [4d 6h 9s] [5c]
*** RIVER *** [4d 6h 9s 5c] [As]
*** SHOW DOWN ***
sserberuss: shows [Jc Jd] (a pair of Jacks)
kensui: shows [Kh Kc] (a pair of Kings)
kensui collected 4134 from side pot
billikarl: shows [Kd Ts] (high pairOfCards Ace)
kensui collected 6624 from main pot
billikarl finished the tournament
*** SUMMARY ***
Total pot 10758 Main pot 6624. Side pot 4134. | Rake 0 
Board [4d 6h 9s 5c As]
Seat 1: sserberuss (big blind) showed [Jc Jd] and lost with a pair of Jacks
Seat 2: culpi2707 folded before Flop (didn't bet)
Seat 3: GrandoGui folded before Flop (didn't bet)
Seat 4: jcarlos.vale folded before Flop (didn't bet)
Seat 5: kensui showed [Kh Kc] and won (10758) with a pair of Kings
Seat 6: Jek8235 folded before Flop (didn't bet)
Seat 7: thunder402 folded before Flop
Seat 8: Tima 190787 (button) folded before Flop (didn't bet)
Seat 9: billikarl (small blind) showed [Kd Ts] and lost with high pairOfCards Ace



PokerStars Hand #221900139257: Tournament #3082657132, $0.98+$0.12 USD Hold'em No Limit - Level IV (30/60) - 2020/12/27 16:51:12 EET [2020/12/27 9:51:12 ET]
Table '3082657132 62' 9-max Seat #1 is the button
Seat 1: sserberuss (1809 in chips) 
Seat 2: culpi2707 (3378 in chips) 
Seat 3: GrandoGui (2534 in chips) 
Seat 4: jcarlos.vale (2466 in chips) 
Seat 5: kensui (10758 in chips) 
Seat 6: Jek8235 (5606 in chips) 
Seat 7: thunder402 (6655 in chips) 
Seat 8: Tima 190787 (2857 in chips) 
sserberuss: posts the ante 7
culpi2707: posts the ante 7
GrandoGui: posts the ante 7
jcarlos.vale: posts the ante 7
kensui: posts the ante 7
Jek8235: posts the ante 7
thunder402: posts the ante 7
Tima 190787: posts the ante 7
culpi2707: posts small blind 30
GrandoGui: posts big blind 60
*** HOLE CARDS ***
Dealt to jcarlos.vale [7c 4c]
jcarlos.vale: folds 
kensui: raises 69 to 129
Jek8235: folds 
thunder402: folds 
Tima 190787: raises 404 to 533
sserberuss: folds 
culpi2707: folds 
GrandoGui: folds 
kensui: calls 404
*** FLOP *** [Ah Ac 6c]
kensui: checks 
Tima 190787: bets 606
kensui: raises 9612 to 10218 and is all-in
Tima 190787: calls 1711 and is all-in
Uncalled bet (7901) returned to kensui
*** TURN *** [Ah Ac 6c] [9h]
*** RIVER *** [Ah Ac 6c 9h] [Kd]
*** SHOW DOWN ***
kensui: shows [As Qd] (three of a kind, Aces)
Tima 190787: shows [Jh Ad] (three of a kind, Aces - lower kicker)
kensui collected 5846 from pot
Tima 190787 finished the tournament
*** SUMMARY ***
Total pot 5846 | Rake 0 
Board [Ah Ac 6c 9h Kd]
Seat 1: sserberuss (button) folded before Flop (didn't bet)
Seat 2: culpi2707 (small blind) folded before Flop
Seat 3: GrandoGui (big blind) folded before Flop
Seat 4: jcarlos.vale folded before Flop (didn't bet)
Seat 5: kensui showed [As Qd] and won (5846) with three of a kind, Aces
Seat 6: Jek8235 folded before Flop (didn't bet)
Seat 7: thunder402 folded before Flop (didn't bet)
Seat 8: Tima 190787 showed [Jh Ad] and lost with three of a kind, Aces



PokerStars Hand #221900164607: Tournament #3082657132, $0.98+$0.12 USD Hold'em No Limit - Level IV (30/60) - 2020/12/27 16:51:56 EET [2020/12/27 9:51:56 ET]
Table '3082657132 62' 9-max Seat #2 is the button
Seat 1: sserberuss (1802 in chips) 
Seat 2: culpi2707 (3341 in chips) 
Seat 3: GrandoGui (2467 in chips) 
Seat 4: jcarlos.vale (2459 in chips) 
Seat 5: kensui (13747 in chips) 
Seat 6: Jek8235 (5599 in chips) 
Seat 7: thunder402 (6648 in chips) 
Seat 9: Bobby Akselrod (3000 in chips) 
sserberuss: posts the ante 7
culpi2707: posts the ante 7
GrandoGui: posts the ante 7
jcarlos.vale: posts the ante 7
kensui: posts the ante 7
Jek8235: posts the ante 7
thunder402: posts the ante 7
Bobby Akselrod: posts the ante 7
GrandoGui: posts small blind 30
jcarlos.vale: posts big blind 60
*** HOLE CARDS ***
Dealt to jcarlos.vale [9s 4h]
kensui: raises 69 to 129
Jek8235: folds 
thunder402: raises 69 to 198
Bobby Akselrod: folds 
sserberuss: folds 
culpi2707: folds 
GrandoGui: folds 
jcarlos.vale: folds 
kensui: calls 69
*** FLOP *** [3h 7d Jh]
kensui: checks 
thunder402: checks 
*** TURN *** [3h 7d Jh] [Qh]
kensui: checks 
thunder402: checks 
*** RIVER *** [3h 7d Jh Qh] [6h]
kensui: checks 
thunder402: checks 
*** SHOW DOWN ***
kensui: shows [Jc Qc] (two pair, Queens and Jacks)
thunder402: mucks handDTO
kensui collected 542 from pot
*** SUMMARY ***
Total pot 542 | Rake 0 
Board [3h 7d Jh Qh 6h]
Seat 1: sserberuss folded before Flop (didn't bet)
Seat 2: culpi2707 (button) folded before Flop (didn't bet)
Seat 3: GrandoGui (small blind) folded before Flop
Seat 4: jcarlos.vale (big blind) folded before Flop
Seat 5: kensui showed [Jc Qc] and won (542) with two pair, Queens and Jacks
Seat 6: Jek8235 folded before Flop (didn't bet)
Seat 7: thunder402 mucked [2s 2d]
Seat 9: Bobby Akselrod folded before Flop (didn't bet)



PokerStars Hand #221900186952: Tournament #3082657132, $0.98+$0.12 USD Hold'em No Limit - Level IV (30/60) - 2020/12/27 16:52:35 EET [2020/12/27 9:52:35 ET]
Table '3082657132 62' 9-max Seat #3 is the button
Seat 1: sserberuss (1795 in chips) 
Seat 2: culpi2707 (3334 in chips) 
Seat 3: GrandoGui (2430 in chips) 
Seat 4: jcarlos.vale (2392 in chips) 
Seat 5: kensui (14084 in chips) 
Seat 6: Jek8235 (5592 in chips) 
Seat 7: thunder402 (6443 in chips) 
Seat 8: MaHoMaX 3554 (3000 in chips) 
Seat 9: Bobby Akselrod (2993 in chips) 
sserberuss: posts the ante 7
culpi2707: posts the ante 7
GrandoGui: posts the ante 7
jcarlos.vale: posts the ante 7
kensui: posts the ante 7
Jek8235: posts the ante 7
thunder402: posts the ante 7
MaHoMaX 3554: posts the ante 7
Bobby Akselrod: posts the ante 7
jcarlos.vale: posts small blind 30
kensui: posts big blind 60
*** HOLE CARDS ***
Dealt to jcarlos.vale [Qh Ad]
Jek8235: folds 
thunder402: calls 60
MaHoMaX 3554: raises 120 to 180
Bobby Akselrod: folds 
sserberuss: folds 
culpi2707: folds 
GrandoGui: folds 
jcarlos.vale: calls 150
kensui: calls 120
thunder402: calls 120
*** FLOP *** [Qc 7h 4h]
jcarlos.vale: bets 587
kensui: folds 
thunder402: folds 
MaHoMaX 3554: calls 587
*** TURN *** [Qc 7h 4h] [3s]
jcarlos.vale: bets 1468
MaHoMaX 3554: raises 758 to 2226 and is all-in
jcarlos.vale: calls 150 and is all-in
Uncalled bet (608) returned to MaHoMaX 3554
*** RIVER *** [Qc 7h 4h 3s] [5d]
*** SHOW DOWN ***
jcarlos.vale: shows [Qh Ad] (a pair of Queens)
MaHoMaX 3554: shows [Jc Jd] (a pair of Jacks)
jcarlos.vale collected 5193 from pot
*** SUMMARY ***
Total pot 5193 | Rake 0 
Board [Qc 7h 4h 3s 5d]
Seat 1: sserberuss folded before Flop (didn't bet)
Seat 2: culpi2707 folded before Flop (didn't bet)
Seat 3: GrandoGui (button) folded before Flop (didn't bet)
Seat 4: jcarlos.vale (small blind) showed [Qh Ad] and won (5193) with a pair of Queens
Seat 5: kensui (big blind) folded on the Flop
Seat 6: Jek8235 folded before Flop (didn't bet)
Seat 7: thunder402 folded on the Flop
Seat 8: MaHoMaX 3554 showed [Jc Jd] and lost with a pair of Jacks
Seat 9: Bobby Akselrod folded before Flop (didn't bet)



PokerStars Hand #221900219536: Tournament #3082657132, $0.98+$0.12 USD Hold'em No Limit - Level IV (30/60) - 2020/12/27 16:53:32 EET [2020/12/27 9:53:32 ET]
Table '3082657132 62' 9-max Seat #4 is the button
Seat 1: sserberuss (1788 in chips) 
Seat 2: culpi2707 (3327 in chips) 
Seat 3: GrandoGui (2423 in chips) 
Seat 4: jcarlos.vale (5193 in chips) 
Seat 5: kensui (13897 in chips) 
Seat 6: Jek8235 (5585 in chips) 
Seat 7: thunder402 (6256 in chips) 
Seat 8: MaHoMaX 3554 (608 in chips) 
Seat 9: Bobby Akselrod (2986 in chips) 
sserberuss: posts the ante 7
culpi2707: posts the ante 7
GrandoGui: posts the ante 7
jcarlos.vale: posts the ante 7
kensui: posts the ante 7
Jek8235: posts the ante 7
thunder402: posts the ante 7
MaHoMaX 3554: posts the ante 7
Bobby Akselrod: posts the ante 7
kensui: posts small blind 30
Jek8235: posts big blind 60
*** HOLE CARDS ***
Dealt to jcarlos.vale [Kh 2d]
thunder402: raises 60 to 120
MaHoMaX 3554: raises 481 to 601 and is all-in
Bobby Akselrod: folds 
sserberuss: folds 
culpi2707: folds 
GrandoGui: folds 
jcarlos.vale: folds 
kensui: calls 571
Jek8235: folds 
thunder402: calls 481
*** FLOP *** [9c Jd 6d]
kensui: checks 
thunder402: bets 963
kensui: calls 963
*** TURN *** [9c Jd 6d] [Ts]
kensui: checks 
thunder402: bets 900
kensui: calls 900
*** RIVER *** [9c Jd 6d Ts] [Tc]
kensui: checks 
thunder402: bets 1020
kensui: folds 
Uncalled bet (1020) returned to thunder402
*** SHOW DOWN ***
thunder402: shows [Ac 9h] (two pair, Tens and Nines)
thunder402 collected 3726 from side pot
MaHoMaX 3554: shows [Qh Jc] (two pair, Jacks and Tens)
MaHoMaX 3554 collected 1926 from main pot
*** SUMMARY ***
Total pot 5652 Main pot 1926. Side pot 3726. | Rake 0 
Board [9c Jd 6d Ts Tc]
Seat 1: sserberuss folded before Flop (didn't bet)
Seat 2: culpi2707 folded before Flop (didn't bet)
Seat 3: GrandoGui folded before Flop (didn't bet)
Seat 4: jcarlos.vale (button) folded before Flop (didn't bet)
Seat 5: kensui (small blind) folded on the River
Seat 6: Jek8235 (big blind) folded before Flop
Seat 7: thunder402 showed [Ac 9h] and won (3726) with two pair, Tens and Nines
Seat 8: MaHoMaX 3554 showed [Qh Jc] and won (1926) with two pair, Jacks and Tens
Seat 9: Bobby Akselrod folded before Flop (didn't bet)



PokerStars Hand #221900262170: Tournament #3082657132, $0.98+$0.12 USD Hold'em No Limit - Level IV (30/60) - 2020/12/27 16:54:46 EET [2020/12/27 9:54:46 ET]
Table '3082657132 62' 9-max Seat #5 is the button
Seat 1: sserberuss (1781 in chips) 
Seat 2: culpi2707 (3320 in chips) 
Seat 3: GrandoGui (2416 in chips) 
Seat 4: jcarlos.vale (5186 in chips) 
Seat 5: kensui (11426 in chips) 
Seat 6: Jek8235 (5518 in chips) 
Seat 7: thunder402 (7511 in chips) 
Seat 8: MaHoMaX 3554 (1926 in chips) 
Seat 9: Bobby Akselrod (2979 in chips) 
sserberuss: posts the ante 7
culpi2707: posts the ante 7
GrandoGui: posts the ante 7
jcarlos.vale: posts the ante 7
kensui: posts the ante 7
Jek8235: posts the ante 7
thunder402: posts the ante 7
MaHoMaX 3554: posts the ante 7
Bobby Akselrod: posts the ante 7
Jek8235: posts small blind 30
thunder402: posts big blind 60
*** HOLE CARDS ***
Dealt to jcarlos.vale [Ah Td]
MaHoMaX 3554: folds 
Bobby Akselrod: folds 
sserberuss: raises 60 to 120
culpi2707: folds 
GrandoGui: folds 
jcarlos.vale: calls 120
kensui: folds 
Jek8235: folds 
thunder402: calls 60
*** FLOP *** [5c 7h Ac]
thunder402: bets 60
sserberuss: folds 
jcarlos.vale: raises 120 to 180
thunder402: calls 120
*** TURN *** [5c 7h Ac] [Kh]
thunder402: bets 60
jcarlos.vale: raises 120 to 180
thunder402: calls 120
*** RIVER *** [5c 7h Ac Kh] [Qc]
thunder402: checks 
jcarlos.vale: checks 
*** SHOW DOWN ***
thunder402: shows [7c 3h] (a pair of Sevens)
jcarlos.vale: shows [Ah Td] (a pair of Aces)
jcarlos.vale collected 1173 from pot
*** SUMMARY ***
Total pot 1173 | Rake 0 
Board [5c 7h Ac Kh Qc]
Seat 1: sserberuss folded on the Flop
Seat 2: culpi2707 folded before Flop (didn't bet)
Seat 3: GrandoGui folded before Flop (didn't bet)
Seat 4: jcarlos.vale showed [Ah Td] and won (1173) with a pair of Aces
Seat 5: kensui (button) folded before Flop (didn't bet)
Seat 6: Jek8235 (small blind) folded before Flop
Seat 7: thunder402 (big blind) showed [7c 3h] and lost with a pair of Sevens
Seat 8: MaHoMaX 3554 folded before Flop (didn't bet)
Seat 9: Bobby Akselrod folded before Flop (didn't bet)



PokerStars Hand #221900477857: Tournament #3082657132, $0.98+$0.12 USD Hold'em No Limit - Level V (40/80) - 2020/12/27 17:02:20 EET [2020/12/27 10:02:20 ET]
Table '3082657132 62' 9-max Seat #6 is the button
Seat 1: LRSANDIM (3000 in chips) 
Seat 2: culpi2707 (3313 in chips) 
Seat 3: GrandoGui (2409 in chips) 
Seat 4: jcarlos.vale (5872 in chips) 
Seat 5: kensui (11419 in chips) 
Seat 6: Jek8235 (5481 in chips) 
Seat 7: thunder402 (7024 in chips) 
Seat 8: MaHoMaX 3554 (1919 in chips) 
Seat 9: Bobby Akselrod (2972 in chips) 
LRSANDIM: posts the ante 10
culpi2707: posts the ante 10
GrandoGui: posts the ante 10
jcarlos.vale: posts the ante 10
kensui: posts the ante 10
Jek8235: posts the ante 10
thunder402: posts the ante 10
MaHoMaX 3554: posts the ante 10
Bobby Akselrod: posts the ante 10
thunder402: posts small blind 40
MaHoMaX 3554: posts big blind 80
*** HOLE CARDS ***
Dealt to jcarlos.vale [4s 2h]
Bobby Akselrod: raises 120 to 200
LRSANDIM: folds 
culpi2707: folds 
GrandoGui: folds 
jcarlos.vale: folds 
kensui: calls 200
Jek8235: folds 
thunder402: raises 120 to 320
MaHoMaX 3554: calls 240
Bobby Akselrod: calls 120
kensui: calls 120
*** FLOP *** [6d 6s 3c]
thunder402: bets 685
MaHoMaX 3554: folds 
Bobby Akselrod: folds 
kensui: folds 
Uncalled bet (685) returned to thunder402
thunder402 collected 1370 from pot
thunder402: doesn't show handDTO
*** SUMMARY ***
Total pot 1370 | Rake 0 
Board [6d 6s 3c]
Seat 1: LRSANDIM folded before Flop (didn't bet)
Seat 2: culpi2707 folded before Flop (didn't bet)
Seat 3: GrandoGui folded before Flop (didn't bet)
Seat 4: jcarlos.vale folded before Flop (didn't bet)
Seat 5: kensui folded on the Flop
Seat 6: Jek8235 (button) folded before Flop (didn't bet)
Seat 7: thunder402 (small blind) collected (1370)
Seat 8: MaHoMaX 3554 (big blind) folded on the Flop
Seat 9: Bobby Akselrod folded on the Flop



PokerStars Hand #221900517298: Tournament #3082657132, $0.98+$0.12 USD Hold'em No Limit - Level V (40/80) - 2020/12/27 17:03:20 EET [2020/12/27 10:03:20 ET]
Table '3082657132 62' 9-max Seat #7 is the button
Seat 1: LRSANDIM (2990 in chips) 
Seat 2: culpi2707 (3303 in chips) 
Seat 3: GrandoGui (2399 in chips) 
Seat 4: jcarlos.vale (5862 in chips) 
Seat 5: kensui (11089 in chips) 
Seat 6: Jek8235 (5471 in chips) 
Seat 7: thunder402 (8064 in chips) 
Seat 8: MaHoMaX 3554 (1589 in chips) 
Seat 9: Bobby Akselrod (2642 in chips) 
LRSANDIM: posts the ante 10
culpi2707: posts the ante 10
GrandoGui: posts the ante 10
jcarlos.vale: posts the ante 10
kensui: posts the ante 10
Jek8235: posts the ante 10
thunder402: posts the ante 10
MaHoMaX 3554: posts the ante 10
Bobby Akselrod: posts the ante 10
MaHoMaX 3554: posts small blind 40
Bobby Akselrod: posts big blind 80
*** HOLE CARDS ***
Dealt to jcarlos.vale [Jh 7d]
LRSANDIM: folds 
culpi2707: folds 
GrandoGui: folds 
jcarlos.vale: folds 
kensui: folds 
Jek8235: folds 
thunder402: calls 80
MaHoMaX 3554: raises 330 to 410
Bobby Akselrod: folds 
thunder402: folds 
Uncalled bet (330) returned to MaHoMaX 3554
MaHoMaX 3554 collected 330 from pot
MaHoMaX 3554: doesn't show handDTO
*** SUMMARY ***
Total pot 330 | Rake 0 
Seat 1: LRSANDIM folded before Flop (didn't bet)
Seat 2: culpi2707 folded before Flop (didn't bet)
Seat 3: GrandoGui folded before Flop (didn't bet)
Seat 4: jcarlos.vale folded before Flop (didn't bet)
Seat 5: kensui folded before Flop (didn't bet)
Seat 6: Jek8235 folded before Flop (didn't bet)
Seat 7: thunder402 (button) folded before Flop
Seat 8: MaHoMaX 3554 (small blind) collected (330)
Seat 9: Bobby Akselrod (big blind) folded before Flop



PokerStars Hand #221900533909: Tournament #3082657132, $0.98+$0.12 USD Hold'em No Limit - Level V (40/80) - 2020/12/27 17:03:49 EET [2020/12/27 10:03:49 ET]
Table '3082657132 62' 9-max Seat #8 is the button
Seat 1: LRSANDIM (2980 in chips) 
Seat 2: culpi2707 (3293 in chips) 
Seat 3: GrandoGui (2389 in chips) 
Seat 4: jcarlos.vale (5852 in chips) 
Seat 5: kensui (11079 in chips) 
Seat 6: Jek8235 (5461 in chips) 
Seat 7: thunder402 (7974 in chips) 
Seat 8: MaHoMaX 3554 (1829 in chips) 
Seat 9: Bobby Akselrod (2552 in chips) 
LRSANDIM: posts the ante 10
culpi2707: posts the ante 10
GrandoGui: posts the ante 10
jcarlos.vale: posts the ante 10
kensui: posts the ante 10
Jek8235: posts the ante 10
thunder402: posts the ante 10
MaHoMaX 3554: posts the ante 10
Bobby Akselrod: posts the ante 10
Bobby Akselrod: posts small blind 40
LRSANDIM: posts big blind 80
*** HOLE CARDS ***
Dealt to jcarlos.vale [Ah Qd]
culpi2707: folds 
GrandoGui: folds 
jcarlos.vale: raises 160 to 240
kensui: folds 
Jek8235: folds 
thunder402: calls 240
MaHoMaX 3554: calls 240
Bobby Akselrod: folds 
LRSANDIM: calls 160
*** FLOP *** [5s Ad 6c]
LRSANDIM: checks 
jcarlos.vale: bets 818
thunder402: folds 
MaHoMaX 3554: folds 
LRSANDIM: folds 
Uncalled bet (818) returned to jcarlos.vale
jcarlos.vale collected 1090 from pot
jcarlos.vale: doesn't show handDTO
*** SUMMARY ***
Total pot 1090 | Rake 0 
Board [5s Ad 6c]
Seat 1: LRSANDIM (big blind) folded on the Flop
Seat 2: culpi2707 folded before Flop (didn't bet)
Seat 3: GrandoGui folded before Flop (didn't bet)
Seat 4: jcarlos.vale collected (1090)
Seat 5: kensui folded before Flop (didn't bet)
Seat 6: Jek8235 folded before Flop (didn't bet)
Seat 7: thunder402 folded on the Flop
Seat 8: MaHoMaX 3554 (button) folded on the Flop
Seat 9: Bobby Akselrod (small blind) folded before Flop



PokerStars Hand #221900572197: Tournament #3082657132, $0.98+$0.12 USD Hold'em No Limit - Level V (40/80) - 2020/12/27 17:04:53 EET [2020/12/27 10:04:53 ET]
Table '3082657132 62' 9-max Seat #9 is the button
Seat 1: LRSANDIM (2730 in chips) 
Seat 2: culpi2707 (3283 in chips) 
Seat 4: jcarlos.vale (6692 in chips) 
Seat 5: kensui (11069 in chips) 
Seat 6: Jek8235 (5451 in chips) 
Seat 7: thunder402 (7724 in chips) 
Seat 8: MaHoMaX 3554 (1579 in chips) 
Seat 9: Bobby Akselrod (2502 in chips) 
LRSANDIM: posts the ante 10
culpi2707: posts the ante 10
jcarlos.vale: posts the ante 10
kensui: posts the ante 10
Jek8235: posts the ante 10
thunder402: posts the ante 10
MaHoMaX 3554: posts the ante 10
Bobby Akselrod: posts the ante 10
LRSANDIM: posts small blind 40
culpi2707: posts big blind 80
*** HOLE CARDS ***
Dealt to jcarlos.vale [Ah 7s]
jcarlos.vale: raises 128 to 208
kensui: folds 
Jek8235: calls 208
thunder402: calls 208
MaHoMaX 3554: folds 
Bobby Akselrod: calls 208
LRSANDIM: folds 
culpi2707: raises 3065 to 3273 and is all-in
jcarlos.vale: folds 
Jek8235: folds 
thunder402: folds 
Bobby Akselrod: folds 
Uncalled bet (3065) returned to culpi2707
culpi2707 collected 1160 from pot
culpi2707: doesn't show handDTO
*** SUMMARY ***
Total pot 1160 | Rake 0 
Seat 1: LRSANDIM (small blind) folded before Flop
Seat 2: culpi2707 (big blind) collected (1160)
Seat 4: jcarlos.vale folded before Flop
Seat 5: kensui folded before Flop (didn't bet)
Seat 6: Jek8235 folded before Flop
Seat 7: thunder402 folded before Flop
Seat 8: MaHoMaX 3554 folded before Flop (didn't bet)
Seat 9: Bobby Akselrod (button) folded before Flop



PokerStars Hand #221900602463: Tournament #3082657132, $0.98+$0.12 USD Hold'em No Limit - Level V (40/80) - 2020/12/27 17:05:45 EET [2020/12/27 10:05:45 ET]
Table '3082657132 62' 9-max Seat #1 is the button
Seat 1: LRSANDIM (2680 in chips) 
Seat 2: culpi2707 (4225 in chips) 
Seat 3: hsiqueira14 (3000 in chips) 
Seat 4: jcarlos.vale (6474 in chips) 
Seat 5: kensui (11059 in chips) 
Seat 6: Jek8235 (5233 in chips) 
Seat 7: thunder402 (7506 in chips) 
Seat 8: MaHoMaX 3554 (1569 in chips) 
Seat 9: Bobby Akselrod (2284 in chips) 
LRSANDIM: posts the ante 10
culpi2707: posts the ante 10
hsiqueira14: posts the ante 10
jcarlos.vale: posts the ante 10
kensui: posts the ante 10
Jek8235: posts the ante 10
thunder402: posts the ante 10
MaHoMaX 3554: posts the ante 10
Bobby Akselrod: posts the ante 10
culpi2707: posts small blind 40
hsiqueira14: posts big blind 80
*** HOLE CARDS ***
Dealt to jcarlos.vale [As 2h]
jcarlos.vale: folds 
kensui: folds 
Jek8235: raises 80 to 160
thunder402: raises 80 to 240
MaHoMaX 3554: raises 1319 to 1559 and is all-in
Bobby Akselrod: folds 
LRSANDIM: folds 
culpi2707: folds 
hsiqueira14: raises 1431 to 2990 and is all-in
Jek8235: folds 
thunder402: folds 
Uncalled bet (1431) returned to hsiqueira14
*** FLOP *** [Jh Js 7c]
*** TURN *** [Jh Js 7c] [Th]
*** RIVER *** [Jh Js 7c Th] [8d]
*** SHOW DOWN ***
hsiqueira14: shows [Kd Ac] (a pair of Jacks)
MaHoMaX 3554: shows [4d 4h] (two pair, Jacks and Fours)
MaHoMaX 3554 collected 3648 from pot
*** SUMMARY ***
Total pot 3648 | Rake 0 
Board [Jh Js 7c Th 8d]
Seat 1: LRSANDIM (button) folded before Flop (didn't bet)
Seat 2: culpi2707 (small blind) folded before Flop
Seat 3: hsiqueira14 (big blind) showed [Kd Ac] and lost with a pair of Jacks
Seat 4: jcarlos.vale folded before Flop (didn't bet)
Seat 5: kensui folded before Flop (didn't bet)
Seat 6: Jek8235 folded before Flop
Seat 7: thunder402 folded before Flop
Seat 8: MaHoMaX 3554 showed [4d 4h] and won (3648) with two pair, Jacks and Fours
Seat 9: Bobby Akselrod folded before Flop (didn't bet)



PokerStars Hand #221900630428: Tournament #3082657132, $0.98+$0.12 USD Hold'em No Limit - Level V (40/80) - 2020/12/27 17:06:32 EET [2020/12/27 10:06:32 ET]
Table '3082657132 62' 9-max Seat #2 is the button
Seat 1: LRSANDIM (2670 in chips) 
Seat 2: culpi2707 (4175 in chips) 
Seat 3: hsiqueira14 (1431 in chips) 
Seat 4: jcarlos.vale (6464 in chips) 
Seat 5: kensui (11049 in chips) 
Seat 6: Jek8235 (5063 in chips) 
Seat 7: thunder402 (7256 in chips) 
Seat 8: MaHoMaX 3554 (3648 in chips) 
Seat 9: Bobby Akselrod (2274 in chips) 
LRSANDIM: posts the ante 10
culpi2707: posts the ante 10
hsiqueira14: posts the ante 10
jcarlos.vale: posts the ante 10
kensui: posts the ante 10
Jek8235: posts the ante 10
thunder402: posts the ante 10
MaHoMaX 3554: posts the ante 10
Bobby Akselrod: posts the ante 10
hsiqueira14: posts small blind 40
jcarlos.vale: posts big blind 80
*** HOLE CARDS ***
Dealt to jcarlos.vale [Qd Ts]
kensui: folds 
Jek8235: folds 
thunder402: calls 80
MaHoMaX 3554: calls 80
Bobby Akselrod: folds 
LRSANDIM: folds 
culpi2707: folds 
hsiqueira14: raises 320 to 400
jcarlos.vale: folds 
thunder402: folds 
MaHoMaX 3554: raises 3238 to 3638 and is all-in
hsiqueira14: calls 1021 and is all-in
Uncalled bet (2217) returned to MaHoMaX 3554
*** FLOP *** [8s 6s Js]
*** TURN *** [8s 6s Js] [4d]
*** RIVER *** [8s 6s Js 4d] [3s]
*** SHOW DOWN ***
hsiqueira14: shows [Ah Kc] (high pairOfCards Ace)
MaHoMaX 3554: shows [Ac 9s] (a flush, Jack high)
MaHoMaX 3554 collected 3092 from pot
hsiqueira14 finished the tournament
*** SUMMARY ***
Total pot 3092 | Rake 0 
Board [8s 6s Js 4d 3s]
Seat 1: LRSANDIM folded before Flop (didn't bet)
Seat 2: culpi2707 (button) folded before Flop (didn't bet)
Seat 3: hsiqueira14 (small blind) showed [Ah Kc] and lost with high pairOfCards Ace
Seat 4: jcarlos.vale (big blind) folded before Flop
Seat 5: kensui folded before Flop (didn't bet)
Seat 6: Jek8235 folded before Flop (didn't bet)
Seat 7: thunder402 folded before Flop
Seat 8: MaHoMaX 3554 showed [Ac 9s] and won (3092) with a flush, Jack high
Seat 9: Bobby Akselrod folded before Flop (didn't bet)



PokerStars Hand #221900655647: Tournament #3082657132, $0.98+$0.12 USD Hold'em No Limit - Level V (40/80) - 2020/12/27 17:07:14 EET [2020/12/27 10:07:14 ET]
Table '3082657132 62' 9-max Seat #4 is the button
Seat 1: LRSANDIM (2660 in chips) 
Seat 2: culpi2707 (4165 in chips) 
Seat 4: jcarlos.vale (6374 in chips) 
Seat 5: kensui (11039 in chips) 
Seat 6: Jek8235 (5053 in chips) 
Seat 7: thunder402 (7166 in chips) 
Seat 8: MaHoMaX 3554 (5309 in chips) 
Seat 9: Bobby Akselrod (2264 in chips) 
LRSANDIM: posts the ante 10
culpi2707: posts the ante 10
jcarlos.vale: posts the ante 10
kensui: posts the ante 10
Jek8235: posts the ante 10
thunder402: posts the ante 10
MaHoMaX 3554: posts the ante 10
Bobby Akselrod: posts the ante 10
kensui: posts small blind 40
Jek8235: posts big blind 80
*** HOLE CARDS ***
Dealt to jcarlos.vale [Ac 6s]
thunder402: calls 80
MaHoMaX 3554: raises 80 to 160
Bobby Akselrod: folds 
LRSANDIM: raises 320 to 480
culpi2707: folds 
jcarlos.vale: folds 
kensui: folds 
Jek8235: folds 
thunder402: calls 400
MaHoMaX 3554: calls 320
*** FLOP *** [Ts As Jc]
thunder402: checks 
MaHoMaX 3554: checks 
LRSANDIM: bets 2170 and is all-in
thunder402: folds 
MaHoMaX 3554: calls 2170
*** TURN *** [Ts As Jc] [4h]
*** RIVER *** [Ts As Jc 4h] [Qc]
*** SHOW DOWN ***
MaHoMaX 3554: shows [6h Th] (a pair of Tens)
LRSANDIM: shows [Kh Ad] (a straight, Ten to Ace)
LRSANDIM collected 5980 from pot
*** SUMMARY ***
Total pot 5980 | Rake 0 
Board [Ts As Jc 4h Qc]
Seat 1: LRSANDIM showed [Kh Ad] and won (5980) with a straight, Ten to Ace
Seat 2: culpi2707 folded before Flop (didn't bet)
Seat 4: jcarlos.vale (button) folded before Flop (didn't bet)
Seat 5: kensui (small blind) folded before Flop
Seat 6: Jek8235 (big blind) folded before Flop
Seat 7: thunder402 folded on the Flop
Seat 8: MaHoMaX 3554 showed [6h Th] and lost with a pair of Tens
Seat 9: Bobby Akselrod folded before Flop (didn't bet)



PokerStars Hand #221900691982: Tournament #3082657132, $0.98+$0.12 USD Hold'em No Limit - Level V (40/80) - 2020/12/27 17:08:16 EET [2020/12/27 10:08:16 ET]
Table '3082657132 62' 9-max Seat #5 is the button
Seat 1: LRSANDIM (5980 in chips) 
Seat 2: culpi2707 (4155 in chips) 
Seat 3: Paguéga (3000 in chips) 
Seat 4: jcarlos.vale (6364 in chips) 
Seat 5: kensui (10989 in chips) 
Seat 6: Jek8235 (4963 in chips) 
Seat 7: thunder402 (6676 in chips) 
Seat 8: MaHoMaX 3554 (2649 in chips) 
Seat 9: Bobby Akselrod (2254 in chips) 
LRSANDIM: posts the ante 10
culpi2707: posts the ante 10
Paguéga: posts the ante 10
jcarlos.vale: posts the ante 10
kensui: posts the ante 10
Jek8235: posts the ante 10
thunder402: posts the ante 10
MaHoMaX 3554: posts the ante 10
Bobby Akselrod: posts the ante 10
Jek8235: posts small blind 40
thunder402: posts big blind 80
*** HOLE CARDS ***
Dealt to jcarlos.vale [9d Qh]
MaHoMaX 3554: raises 2559 to 2639 and is all-in
Bobby Akselrod: folds 
LRSANDIM: folds 
culpi2707: folds 
Paguéga: folds 
jcarlos.vale: folds 
kensui: folds 
Jek8235: folds 
thunder402: calls 2559
*** FLOP *** [Qd Tc Jd]
*** TURN *** [Qd Tc Jd] [6d]
*** RIVER *** [Qd Tc Jd 6d] [Kd]
*** SHOW DOWN ***
thunder402: shows [Ks Kc] (three of a kind, Kings)
MaHoMaX 3554: shows [Ac Qc] (a straight, Ten to Ace)
MaHoMaX 3554 collected 5408 from pot
*** SUMMARY ***
Total pot 5408 | Rake 0 
Board [Qd Tc Jd 6d Kd]
Seat 1: LRSANDIM folded before Flop (didn't bet)
Seat 2: culpi2707 folded before Flop (didn't bet)
Seat 3: Paguéga folded before Flop (didn't bet)
Seat 4: jcarlos.vale folded before Flop (didn't bet)
Seat 5: kensui (button) folded before Flop (didn't bet)
Seat 6: Jek8235 (small blind) folded before Flop
Seat 7: thunder402 (big blind) showed [Ks Kc] and lost with three of a kind, Kings
Seat 8: MaHoMaX 3554 showed [Ac Qc] and won (5408) with a straight, Ten to Ace
Seat 9: Bobby Akselrod folded before Flop (didn't bet)



PokerStars Hand #221900713841: Tournament #3082657132, $0.98+$0.12 USD Hold'em No Limit - Level V (40/80) - 2020/12/27 17:08:53 EET [2020/12/27 10:08:53 ET]
Table '3082657132 62' 9-max Seat #6 is the button
Seat 1: LRSANDIM (5970 in chips) 
Seat 2: culpi2707 (4145 in chips) 
Seat 3: Paguéga (2990 in chips) 
Seat 4: jcarlos.vale (6354 in chips) 
Seat 5: kensui (10979 in chips) 
Seat 6: Jek8235 (4913 in chips) 
Seat 7: thunder402 (4027 in chips) 
Seat 8: MaHoMaX 3554 (5408 in chips) 
Seat 9: Bobby Akselrod (2244 in chips) 
LRSANDIM: posts the ante 10
culpi2707: posts the ante 10
Paguéga: posts the ante 10
jcarlos.vale: posts the ante 10
kensui: posts the ante 10
Jek8235: posts the ante 10
thunder402: posts the ante 10
MaHoMaX 3554: posts the ante 10
Bobby Akselrod: posts the ante 10
thunder402: posts small blind 40
MaHoMaX 3554: posts big blind 80
*** HOLE CARDS ***
Dealt to jcarlos.vale [3h 7h]
Bobby Akselrod: folds 
LRSANDIM: raises 104 to 184
culpi2707: folds 
Paguéga: folds 
jcarlos.vale: folds 
kensui: folds 
Jek8235: calls 184
thunder402: calls 144
MaHoMaX 3554: folds 
*** FLOP *** [Th Kc 6s]
thunder402: bets 80
LRSANDIM: folds 
Jek8235: raises 760 to 840
thunder402: calls 760
*** TURN *** [Th Kc 6s] [Jd]
thunder402: checks 
Jek8235: bets 3879 and is all-in
thunder402: calls 2993 and is all-in
Uncalled bet (886) returned to Jek8235
*** RIVER *** [Th Kc 6s Jd] [4h]
*** SHOW DOWN ***
thunder402: shows [Qs Td] (a pair of Tens)
Jek8235: shows [Ah Ks] (a pair of Kings)
Jek8235 collected 8388 from pot
thunder402 finished the tournament
*** SUMMARY ***
Total pot 8388 | Rake 0 
Board [Th Kc 6s Jd 4h]
Seat 1: LRSANDIM folded on the Flop
Seat 2: culpi2707 folded before Flop (didn't bet)
Seat 3: Paguéga folded before Flop (didn't bet)
Seat 4: jcarlos.vale folded before Flop (didn't bet)
Seat 5: kensui folded before Flop (didn't bet)
Seat 6: Jek8235 (button) showed [Ah Ks] and won (8388) with a pair of Kings
Seat 7: thunder402 (small blind) showed [Qs Td] and lost with a pair of Tens
Seat 8: MaHoMaX 3554 (big blind) folded before Flop
Seat 9: Bobby Akselrod folded before Flop (didn't bet)



PokerStars Hand #221900778212: Tournament #3082657132, $0.98+$0.12 USD Hold'em No Limit - Level V (40/80) - 2020/12/27 17:10:41 EET [2020/12/27 10:10:41 ET]
Table '3082657132 62' 9-max Seat #8 is the button
Seat 1: LRSANDIM (5776 in chips) 
Seat 2: culpi2707 (4135 in chips) 
Seat 3: Paguéga (2980 in chips) 
Seat 4: jcarlos.vale (6344 in chips) 
Seat 5: kensui (10969 in chips) 
Seat 6: Jek8235 (9274 in chips) 
Seat 8: MaHoMaX 3554 (5318 in chips) 
Seat 9: Bobby Akselrod (2234 in chips) 
LRSANDIM: posts the ante 10
culpi2707: posts the ante 10
Paguéga: posts the ante 10
jcarlos.vale: posts the ante 10
kensui: posts the ante 10
Jek8235: posts the ante 10
MaHoMaX 3554: posts the ante 10
Bobby Akselrod: posts the ante 10
Bobby Akselrod: posts small blind 40
LRSANDIM: posts big blind 80
*** HOLE CARDS ***
Dealt to jcarlos.vale [2c Qd]
culpi2707: folds 
Paguéga: folds 
jcarlos.vale: folds 
kensui: folds 
Jek8235: raises 80 to 160
MaHoMaX 3554: folds 
Bobby Akselrod: folds 
LRSANDIM: folds 
Uncalled bet (80) returned to Jek8235
Jek8235 collected 280 from pot
Jek8235: doesn't show handDTO
*** SUMMARY ***
Total pot 280 | Rake 0 
Seat 1: LRSANDIM (big blind) folded before Flop
Seat 2: culpi2707 folded before Flop (didn't bet)
Seat 3: Paguéga folded before Flop (didn't bet)
Seat 4: jcarlos.vale folded before Flop (didn't bet)
Seat 5: kensui folded before Flop (didn't bet)
Seat 6: Jek8235 collected (280)
Seat 8: MaHoMaX 3554 (button) folded before Flop (didn't bet)
Seat 9: Bobby Akselrod (small blind) folded before Flop



PokerStars Hand #221900810787: Tournament #3082657132, $0.98+$0.12 USD Hold'em No Limit - Level V (40/80) - 2020/12/27 17:11:35 EET [2020/12/27 10:11:35 ET]
Table '3082657132 62' 9-max Seat #9 is the button
Seat 1: LRSANDIM (5686 in chips) 
Seat 2: culpi2707 (4125 in chips) 
Seat 3: Paguéga (2970 in chips) 
Seat 4: jcarlos.vale (6334 in chips) 
Seat 5: kensui (10959 in chips) 
Seat 6: Jek8235 (9464 in chips) 
Seat 8: MaHoMaX 3554 (5308 in chips) 
Seat 9: Bobby Akselrod (2184 in chips) 
LRSANDIM: posts the ante 10
culpi2707: posts the ante 10
Paguéga: posts the ante 10
jcarlos.vale: posts the ante 10
kensui: posts the ante 10
Jek8235: posts the ante 10
MaHoMaX 3554: posts the ante 10
Bobby Akselrod: posts the ante 10
LRSANDIM: posts small blind 40
culpi2707: posts big blind 80
*** HOLE CARDS ***
Dealt to jcarlos.vale [5s 2d]
Paguéga: folds 
jcarlos.vale: folds 
kensui: folds 
Jek8235: raises 80 to 160
MaHoMaX 3554: folds 
Bobby Akselrod: folds 
LRSANDIM: folds 
culpi2707: calls 80
*** FLOP *** [7d 3d 3h]
culpi2707: checks 
Jek8235: bets 238
culpi2707: folds 
Uncalled bet (238) returned to Jek8235
Jek8235 collected 440 from pot
Jek8235: doesn't show handDTO
*** SUMMARY ***
Total pot 440 | Rake 0 
Board [7d 3d 3h]
Seat 1: LRSANDIM (small blind) folded before Flop
Seat 2: culpi2707 (big blind) folded on the Flop
Seat 3: Paguéga folded before Flop (didn't bet)
Seat 4: jcarlos.vale folded before Flop (didn't bet)
Seat 5: kensui folded before Flop (didn't bet)
Seat 6: Jek8235 collected (440)
Seat 8: MaHoMaX 3554 folded before Flop (didn't bet)
Seat 9: Bobby Akselrod (button) folded before Flop (didn't bet)



PokerStars Hand #221900849733: Tournament #3082657132, $0.98+$0.12 USD Hold'em No Limit - Level VI (50/100) - 2020/12/27 17:12:40 EET [2020/12/27 10:12:40 ET]
Table '3082657132 62' 9-max Seat #1 is the button
Seat 1: LRSANDIM (5636 in chips) 
Seat 2: culpi2707 (3955 in chips) 
Seat 3: Paguéga (2960 in chips) 
Seat 4: jcarlos.vale (6324 in chips) 
Seat 5: kensui (10949 in chips) 
Seat 6: Jek8235 (9734 in chips) 
Seat 7: Kickstand122 (3000 in chips) 
Seat 8: MaHoMaX 3554 (5298 in chips) 
Seat 9: Bobby Akselrod (2174 in chips) 
LRSANDIM: posts the ante 12
culpi2707: posts the ante 12
Paguéga: posts the ante 12
jcarlos.vale: posts the ante 12
kensui: posts the ante 12
Jek8235: posts the ante 12
Kickstand122: posts the ante 12
MaHoMaX 3554: posts the ante 12
Bobby Akselrod: posts the ante 12
culpi2707: posts small blind 50
Paguéga: posts big blind 100
*** HOLE CARDS ***
Dealt to jcarlos.vale [4d 9h]
jcarlos.vale: folds 
kensui: folds 
Jek8235: folds 
Kickstand122: calls 100
MaHoMaX 3554: folds 
Bobby Akselrod: folds 
LRSANDIM: folds 
culpi2707: folds 
Paguéga: raises 2848 to 2948 and is all-in
Kickstand122: folds 
Uncalled bet (2848) returned to Paguéga
Paguéga collected 358 from pot
Paguéga: doesn't show handDTO
*** SUMMARY ***
Total pot 358 | Rake 0 
Seat 1: LRSANDIM (button) folded before Flop (didn't bet)
Seat 2: culpi2707 (small blind) folded before Flop
Seat 3: Paguéga (big blind) collected (358)
Seat 4: jcarlos.vale folded before Flop (didn't bet)
Seat 5: kensui folded before Flop (didn't bet)
Seat 6: Jek8235 folded before Flop (didn't bet)
Seat 7: Kickstand122 folded before Flop
Seat 8: MaHoMaX 3554 folded before Flop (didn't bet)
Seat 9: Bobby Akselrod folded before Flop (didn't bet)



PokerStars Hand #221900863905: Tournament #3082657132, $0.98+$0.12 USD Hold'em No Limit - Level VI (50/100) - 2020/12/27 17:13:04 EET [2020/12/27 10:13:04 ET]
Table '3082657132 62' 9-max Seat #2 is the button
Seat 1: LRSANDIM (5624 in chips) 
Seat 2: culpi2707 (3893 in chips) 
Seat 3: Paguéga (3206 in chips) 
Seat 4: jcarlos.vale (6312 in chips) 
Seat 5: kensui (10937 in chips) 
Seat 6: Jek8235 (9722 in chips) 
Seat 7: Kickstand122 (2888 in chips) 
Seat 8: MaHoMaX 3554 (5286 in chips) 
Seat 9: Bobby Akselrod (2162 in chips) 
LRSANDIM: posts the ante 12
culpi2707: posts the ante 12
Paguéga: posts the ante 12
jcarlos.vale: posts the ante 12
kensui: posts the ante 12
Jek8235: posts the ante 12
Kickstand122: posts the ante 12
MaHoMaX 3554: posts the ante 12
Bobby Akselrod: posts the ante 12
Paguéga: posts small blind 50
jcarlos.vale: posts big blind 100
*** HOLE CARDS ***
Dealt to jcarlos.vale [Ks 4d]
kensui: raises 116 to 216
Jek8235: raises 434 to 650
Kickstand122: folds 
MaHoMaX 3554: folds 
Bobby Akselrod: folds 
LRSANDIM: folds 
culpi2707: folds 
Paguéga: folds 
jcarlos.vale: folds 
kensui: calls 434
*** FLOP *** [7c 4h 5h]
kensui: checks 
Jek8235: bets 514
kensui: calls 514
*** TURN *** [7c 4h 5h] [8h]
kensui: checks 
Jek8235: checks 
*** RIVER *** [7c 4h 5h 8h] [6c]
kensui: checks 
Jek8235: checks 
*** SHOW DOWN ***
kensui: shows [7d 6d] (a straight, Four to Eight)
Jek8235: shows [As Jd] (a straight, Four to Eight)
kensui collected 1293 from pot
Jek8235 collected 1293 from pot
*** SUMMARY ***
Total pot 2586 | Rake 0 
Board [7c 4h 5h 8h 6c]
Seat 1: LRSANDIM folded before Flop (didn't bet)
Seat 2: culpi2707 (button) folded before Flop (didn't bet)
Seat 3: Paguéga (small blind) folded before Flop
Seat 4: jcarlos.vale (big blind) folded before Flop
Seat 5: kensui showed [7d 6d] and won (1293) with a straight, Four to Eight
Seat 6: Jek8235 showed [As Jd] and won (1293) with a straight, Four to Eight
Seat 7: Kickstand122 folded before Flop (didn't bet)
Seat 8: MaHoMaX 3554 folded before Flop (didn't bet)
Seat 9: Bobby Akselrod folded before Flop (didn't bet)



PokerStars Hand #221900896624: Tournament #3082657132, $0.98+$0.12 USD Hold'em No Limit - Level VI (50/100) - 2020/12/27 17:13:58 EET [2020/12/27 10:13:58 ET]
Table '3082657132 62' 9-max Seat #3 is the button
Seat 1: LRSANDIM (5612 in chips) 
Seat 2: culpi2707 (3881 in chips) 
Seat 3: Paguéga (3144 in chips) 
Seat 4: jcarlos.vale (6200 in chips) 
Seat 5: kensui (11054 in chips) 
Seat 6: Jek8235 (9839 in chips) 
Seat 7: Kickstand122 (2876 in chips) 
Seat 8: MaHoMaX 3554 (5274 in chips) 
Seat 9: Bobby Akselrod (2150 in chips) 
LRSANDIM: posts the ante 12
culpi2707: posts the ante 12
Paguéga: posts the ante 12
jcarlos.vale: posts the ante 12
kensui: posts the ante 12
Jek8235: posts the ante 12
Kickstand122: posts the ante 12
MaHoMaX 3554: posts the ante 12
Bobby Akselrod: posts the ante 12
jcarlos.vale: posts small blind 50
kensui: posts big blind 100
*** HOLE CARDS ***
Dealt to jcarlos.vale [6d 6h]
Jek8235: raises 100 to 200
Kickstand122: folds 
MaHoMaX 3554: raises 658 to 858
Bobby Akselrod: folds 
LRSANDIM: folds 
culpi2707: folds 
Paguéga: folds 
jcarlos.vale: folds 
kensui: folds 
Jek8235: folds 
Uncalled bet (658) returned to MaHoMaX 3554
MaHoMaX 3554 collected 658 from pot
MaHoMaX 3554: doesn't show handDTO
*** SUMMARY ***
Total pot 658 | Rake 0 
Seat 1: LRSANDIM folded before Flop (didn't bet)
Seat 2: culpi2707 folded before Flop (didn't bet)
Seat 3: Paguéga (button) folded before Flop (didn't bet)
Seat 4: jcarlos.vale (small blind) folded before Flop
Seat 5: kensui (big blind) folded before Flop
Seat 6: Jek8235 folded before Flop
Seat 7: Kickstand122 folded before Flop (didn't bet)
Seat 8: MaHoMaX 3554 collected (658)
Seat 9: Bobby Akselrod folded before Flop (didn't bet)



PokerStars Hand #221900912987: Tournament #3082657132, $0.98+$0.12 USD Hold'em No Limit - Level VI (50/100) - 2020/12/27 17:14:26 EET [2020/12/27 10:14:26 ET]
Table '3082657132 62' 9-max Seat #4 is the button
Seat 1: LRSANDIM (5600 in chips) 
Seat 2: culpi2707 (3869 in chips) 
Seat 3: Paguéga (3132 in chips) 
Seat 4: jcarlos.vale (6138 in chips) 
Seat 5: kensui (10942 in chips) 
Seat 6: Jek8235 (9627 in chips) 
Seat 7: Kickstand122 (2864 in chips) 
Seat 8: MaHoMaX 3554 (5720 in chips) 
Seat 9: Bobby Akselrod (2138 in chips) 
LRSANDIM: posts the ante 12
culpi2707: posts the ante 12
Paguéga: posts the ante 12
jcarlos.vale: posts the ante 12
kensui: posts the ante 12
Jek8235: posts the ante 12
Kickstand122: posts the ante 12
MaHoMaX 3554: posts the ante 12
Bobby Akselrod: posts the ante 12
kensui: posts small blind 50
Jek8235: posts big blind 100
*** HOLE CARDS ***
Dealt to jcarlos.vale [8d 4h]
Kickstand122: folds 
MaHoMaX 3554: folds 
Bobby Akselrod: folds 
LRSANDIM: folds 
culpi2707: folds 
Paguéga: raises 100 to 200
jcarlos.vale: folds 
kensui: folds 
Jek8235: calls 100
*** FLOP *** [5s 5d Qc]
Jek8235: checks 
Paguéga: bets 184
Jek8235: folds 
Uncalled bet (184) returned to Paguéga
Paguéga collected 558 from pot
Paguéga: doesn't show handDTO
*** SUMMARY ***
Total pot 558 | Rake 0 
Board [5s 5d Qc]
Seat 1: LRSANDIM folded before Flop (didn't bet)
Seat 2: culpi2707 folded before Flop (didn't bet)
Seat 3: Paguéga collected (558)
Seat 4: jcarlos.vale (button) folded before Flop (didn't bet)
Seat 5: kensui (small blind) folded before Flop
Seat 6: Jek8235 (big blind) folded on the Flop
Seat 7: Kickstand122 folded before Flop (didn't bet)
Seat 8: MaHoMaX 3554 folded before Flop (didn't bet)
Seat 9: Bobby Akselrod folded before Flop (didn't bet)



PokerStars Hand #221900930549: Tournament #3082657132, $0.98+$0.12 USD Hold'em No Limit - Level VI (50/100) - 2020/12/27 17:14:55 EET [2020/12/27 10:14:55 ET]
Table '3082657132 62' 9-max Seat #5 is the button
Seat 1: LRSANDIM (5588 in chips) 
Seat 2: culpi2707 (3857 in chips) 
Seat 3: Paguéga (3478 in chips) 
Seat 4: jcarlos.vale (6126 in chips) 
Seat 5: kensui (10880 in chips) 
Seat 6: Jek8235 (9415 in chips) 
Seat 7: Kickstand122 (2852 in chips) 
Seat 8: MaHoMaX 3554 (5708 in chips) 
Seat 9: Bobby Akselrod (2126 in chips) 
LRSANDIM: posts the ante 12
culpi2707: posts the ante 12
Paguéga: posts the ante 12
jcarlos.vale: posts the ante 12
kensui: posts the ante 12
Jek8235: posts the ante 12
Kickstand122: posts the ante 12
MaHoMaX 3554: posts the ante 12
Bobby Akselrod: posts the ante 12
Jek8235: posts small blind 50
Kickstand122: posts big blind 100
*** HOLE CARDS ***
Dealt to jcarlos.vale [Qc Ks]
MaHoMaX 3554: raises 100 to 200
Bobby Akselrod: folds 
LRSANDIM: folds 
culpi2707: folds 
Paguéga: folds 
jcarlos.vale: calls 200
kensui: folds 
Jek8235: folds 
Kickstand122: calls 100
*** FLOP *** [3c Qh 3d]
Kickstand122: checks 
MaHoMaX 3554: bets 200
jcarlos.vale: raises 300 to 500
Kickstand122: folds 
MaHoMaX 3554: folds 
Uncalled bet (300) returned to jcarlos.vale
jcarlos.vale collected 1158 from pot
jcarlos.vale: doesn't show handDTO
*** SUMMARY ***
Total pot 1158 | Rake 0 
Board [3c Qh 3d]
Seat 1: LRSANDIM folded before Flop (didn't bet)
Seat 2: culpi2707 folded before Flop (didn't bet)
Seat 3: Paguéga folded before Flop (didn't bet)
Seat 4: jcarlos.vale collected (1158)
Seat 5: kensui (button) folded before Flop (didn't bet)
Seat 6: Jek8235 (small blind) folded before Flop
Seat 7: Kickstand122 (big blind) folded on the Flop
Seat 8: MaHoMaX 3554 folded on the Flop
Seat 9: Bobby Akselrod folded before Flop (didn't bet)



PokerStars Hand #221900962490: Tournament #3082657132, $0.98+$0.12 USD Hold'em No Limit - Level VI (50/100) - 2020/12/27 17:15:47 EET [2020/12/27 10:15:47 ET]
Table '3082657132 62' 9-max Seat #6 is the button
Seat 1: LRSANDIM (5576 in chips) 
Seat 2: culpi2707 (3845 in chips) 
Seat 3: Paguéga (3466 in chips) 
Seat 4: jcarlos.vale (6872 in chips) 
Seat 5: kensui (10868 in chips) 
Seat 6: Jek8235 (9353 in chips) 
Seat 7: Kickstand122 (2640 in chips) 
Seat 8: MaHoMaX 3554 (5296 in chips) 
Seat 9: Bobby Akselrod (2114 in chips) 
LRSANDIM: posts the ante 12
culpi2707: posts the ante 12
Paguéga: posts the ante 12
jcarlos.vale: posts the ante 12
kensui: posts the ante 12
Jek8235: posts the ante 12
Kickstand122: posts the ante 12
MaHoMaX 3554: posts the ante 12
Bobby Akselrod: posts the ante 12
Kickstand122: posts small blind 50
MaHoMaX 3554: posts big blind 100
*** HOLE CARDS ***
Dealt to jcarlos.vale [As 6c]
Bobby Akselrod: folds 
LRSANDIM: folds 
culpi2707: folds 
Paguéga: folds 
jcarlos.vale: folds 
kensui: raises 116 to 216
Jek8235: folds 
Kickstand122: folds 
MaHoMaX 3554: calls 116
*** FLOP *** [Kc 2s 3d]
MaHoMaX 3554: bets 100
kensui: calls 100
*** TURN *** [Kc 2s 3d] [4s]
MaHoMaX 3554: bets 395
kensui: raises 395 to 790
MaHoMaX 3554: calls 395
*** RIVER *** [Kc 2s 3d 4s] [3h]
MaHoMaX 3554: checks 
kensui: bets 900
MaHoMaX 3554: calls 900
*** SHOW DOWN ***
kensui: shows [5d Ad] (a straight, Ace to Five)
MaHoMaX 3554: mucks handDTO
kensui collected 4170 from pot
*** SUMMARY ***
Total pot 4170 | Rake 0 
Board [Kc 2s 3d 4s 3h]
Seat 1: LRSANDIM folded before Flop (didn't bet)
Seat 2: culpi2707 folded before Flop (didn't bet)
Seat 3: Paguéga folded before Flop (didn't bet)
Seat 4: jcarlos.vale folded before Flop (didn't bet)
Seat 5: kensui showed [5d Ad] and won (4170) with a straight, Ace to Five
Seat 6: Jek8235 (button) folded before Flop (didn't bet)
Seat 7: Kickstand122 (small blind) folded before Flop
Seat 8: MaHoMaX 3554 (big blind) mucked [4h 6d]
Seat 9: Bobby Akselrod folded before Flop (didn't bet)



PokerStars Hand #221901010337: Tournament #3082657132, $0.98+$0.12 USD Hold'em No Limit - Level VI (50/100) - 2020/12/27 17:17:06 EET [2020/12/27 10:17:06 ET]
Table '3082657132 62' 9-max Seat #7 is the button
Seat 1: LRSANDIM (5564 in chips) 
Seat 2: culpi2707 (3833 in chips) 
Seat 3: Paguéga (3454 in chips) 
Seat 4: jcarlos.vale (6860 in chips) 
Seat 5: kensui (13020 in chips) 
Seat 6: Jek8235 (9341 in chips) 
Seat 7: Kickstand122 (2578 in chips) 
Seat 8: MaHoMaX 3554 (3278 in chips) 
Seat 9: Bobby Akselrod (2102 in chips) 
LRSANDIM: posts the ante 12
culpi2707: posts the ante 12
Paguéga: posts the ante 12
jcarlos.vale: posts the ante 12
kensui: posts the ante 12
Jek8235: posts the ante 12
Kickstand122: posts the ante 12
MaHoMaX 3554: posts the ante 12
Bobby Akselrod: posts the ante 12
MaHoMaX 3554: posts small blind 50
Bobby Akselrod: posts big blind 100
*** HOLE CARDS ***
Dealt to jcarlos.vale [Qs 7s]
LRSANDIM: folds 
culpi2707: folds 
Paguéga: folds 
jcarlos.vale: folds 
kensui: folds 
Jek8235: folds 
Kickstand122: raises 100 to 200
MaHoMaX 3554: calls 150
Bobby Akselrod: calls 100
*** FLOP *** [Tc 9c Qd]
MaHoMaX 3554: checks 
Bobby Akselrod: checks 
Kickstand122: bets 300
MaHoMaX 3554: calls 300
Bobby Akselrod: folds 
*** TURN *** [Tc 9c Qd] [Qc]
MaHoMaX 3554: bets 500
Kickstand122: raises 1566 to 2066 and is all-in
MaHoMaX 3554: calls 1566
*** RIVER *** [Tc 9c Qd Qc] [Jh]
*** SHOW DOWN ***
MaHoMaX 3554: shows [Ts 8s] (a straight, Eight to Queen)
Kickstand122: shows [8c Js] (a straight, Eight to Queen)
MaHoMaX 3554 collected 2720 from pot
Kickstand122 collected 2720 from pot
*** SUMMARY ***
Total pot 5440 | Rake 0 
Board [Tc 9c Qd Qc Jh]
Seat 1: LRSANDIM folded before Flop (didn't bet)
Seat 2: culpi2707 folded before Flop (didn't bet)
Seat 3: Paguéga folded before Flop (didn't bet)
Seat 4: jcarlos.vale folded before Flop (didn't bet)
Seat 5: kensui folded before Flop (didn't bet)
Seat 6: Jek8235 folded before Flop (didn't bet)
Seat 7: Kickstand122 (button) showed [8c Js] and won (2720) with a straight, Eight to Queen
Seat 8: MaHoMaX 3554 (small blind) showed [Ts 8s] and won (2720) with a straight, Eight to Queen
Seat 9: Bobby Akselrod (big blind) folded on the Flop



PokerStars Hand #221901070466: Tournament #3082657132, $0.98+$0.12 USD Hold'em No Limit - Level VI (50/100) - 2020/12/27 17:18:44 EET [2020/12/27 10:18:44 ET]
Table '3082657132 62' 9-max Seat #8 is the button
Seat 1: LRSANDIM (5552 in chips) 
Seat 2: culpi2707 (3821 in chips) 
Seat 3: Paguéga (3442 in chips) 
Seat 4: jcarlos.vale (6848 in chips) 
Seat 5: kensui (13008 in chips) 
Seat 6: Jek8235 (9329 in chips) 
Seat 7: Kickstand122 (2720 in chips) 
Seat 8: MaHoMaX 3554 (3420 in chips) 
Seat 9: Bobby Akselrod (1890 in chips) 
LRSANDIM: posts the ante 12
culpi2707: posts the ante 12
Paguéga: posts the ante 12
jcarlos.vale: posts the ante 12
kensui: posts the ante 12
Jek8235: posts the ante 12
Kickstand122: posts the ante 12
MaHoMaX 3554: posts the ante 12
Bobby Akselrod: posts the ante 12
Bobby Akselrod: posts small blind 50
LRSANDIM: posts big blind 100
*** HOLE CARDS ***
Dealt to jcarlos.vale [Qh 5s]
culpi2707: folds 
Paguéga: folds 
jcarlos.vale: folds 
kensui: raises 116 to 216
Jek8235: folds 
Kickstand122: folds 
MaHoMaX 3554: folds 
Bobby Akselrod: folds 
LRSANDIM: folds 
Uncalled bet (116) returned to kensui
kensui collected 358 from pot
kensui: doesn't show handDTO
*** SUMMARY ***
Total pot 358 | Rake 0 
Seat 1: LRSANDIM (big blind) folded before Flop
Seat 2: culpi2707 folded before Flop (didn't bet)
Seat 3: Paguéga folded before Flop (didn't bet)
Seat 4: jcarlos.vale folded before Flop (didn't bet)
Seat 5: kensui collected (358)
Seat 6: Jek8235 folded before Flop (didn't bet)
Seat 7: Kickstand122 folded before Flop (didn't bet)
Seat 8: MaHoMaX 3554 (button) folded before Flop (didn't bet)
Seat 9: Bobby Akselrod (small blind) folded before Flop



PokerStars Hand #221901086362: Tournament #3082657132, $0.98+$0.12 USD Hold'em No Limit - Level VI (50/100) - 2020/12/27 17:19:10 EET [2020/12/27 10:19:10 ET]
Table '3082657132 62' 9-max Seat #9 is the button
Seat 1: LRSANDIM (5440 in chips) 
Seat 2: culpi2707 (3809 in chips) 
Seat 3: Paguéga (3430 in chips) 
Seat 4: jcarlos.vale (6836 in chips) 
Seat 5: kensui (13254 in chips) 
Seat 6: Jek8235 (9317 in chips) 
Seat 7: Kickstand122 (2708 in chips) 
Seat 8: MaHoMaX 3554 (3408 in chips) 
Seat 9: Bobby Akselrod (1828 in chips) 
LRSANDIM: posts the ante 12
culpi2707: posts the ante 12
Paguéga: posts the ante 12
jcarlos.vale: posts the ante 12
kensui: posts the ante 12
Jek8235: posts the ante 12
Kickstand122: posts the ante 12
MaHoMaX 3554: posts the ante 12
Bobby Akselrod: posts the ante 12
LRSANDIM: posts small blind 50
culpi2707: posts big blind 100
*** HOLE CARDS ***
Dealt to jcarlos.vale [Ad Tc]
Paguéga: folds 
jcarlos.vale: raises 160 to 260
kensui: folds 
Jek8235: folds 
Kickstand122: folds 
MaHoMaX 3554: calls 260
Bobby Akselrod: folds 
LRSANDIM: folds 
culpi2707: calls 160
*** FLOP *** [6c Th 7s]
culpi2707: checks 
jcarlos.vale: bets 704
MaHoMaX 3554: calls 704
culpi2707: raises 2833 to 3537 and is all-in
jcarlos.vale: raises 3027 to 6564 and is all-in
MaHoMaX 3554: folds 
Uncalled bet (3027) returned to jcarlos.vale
*** TURN *** [6c Th 7s] [6s]
*** RIVER *** [6c Th 7s 6s] [Ac]
*** SHOW DOWN ***
culpi2707: shows [Jh Td] (two pair, Tens and Sixes)
jcarlos.vale: shows [Ad Tc] (two pair, Aces and Tens)
jcarlos.vale collected 8716 from pot
culpi2707 finished the tournament
*** SUMMARY ***
Total pot 8716 | Rake 0 
Board [6c Th 7s 6s Ac]
Seat 1: LRSANDIM (small blind) folded before Flop
Seat 2: culpi2707 (big blind) showed [Jh Td] and lost with two pair, Tens and Sixes
Seat 3: Paguéga folded before Flop (didn't bet)
Seat 4: jcarlos.vale showed [Ad Tc] and won (8716) with two pair, Aces and Tens
Seat 5: kensui folded before Flop (didn't bet)
Seat 6: Jek8235 folded before Flop (didn't bet)
Seat 7: Kickstand122 folded before Flop (didn't bet)
Seat 8: MaHoMaX 3554 folded on the Flop
Seat 9: Bobby Akselrod (button) folded before Flop (didn't bet)



PokerStars Hand #221901150455: Tournament #3082657132, $0.98+$0.12 USD Hold'em No Limit - Level VI (50/100) - 2020/12/27 17:20:39 EET [2020/12/27 10:20:39 ET]
Table '3082657132 62' 9-max Seat #1 is the button
Seat 1: LRSANDIM (5378 in chips) 
Seat 3: Paguéga (3418 in chips) 
Seat 4: jcarlos.vale (11743 in chips) 
Seat 5: kensui (13242 in chips) 
Seat 6: Jek8235 (9305 in chips) 
Seat 7: Kickstand122 (2696 in chips) 
Seat 8: MaHoMaX 3554 (2432 in chips) 
Seat 9: Bobby Akselrod (1816 in chips) 
LRSANDIM: posts the ante 12
Paguéga: posts the ante 12
jcarlos.vale: posts the ante 12
kensui: posts the ante 12
Jek8235: posts the ante 12
Kickstand122: posts the ante 12
MaHoMaX 3554: posts the ante 12
Bobby Akselrod: posts the ante 12
Paguéga: posts small blind 50
jcarlos.vale: posts big blind 100
*** HOLE CARDS ***
Dealt to jcarlos.vale [Kc Jd]
kensui: folds 
Jek8235: folds 
Kickstand122: folds 
MaHoMaX 3554: folds 
Bobby Akselrod: folds 
LRSANDIM: raises 130 to 230
Paguéga: folds 
jcarlos.vale: calls 130
*** FLOP *** [9s 5s 2d]
jcarlos.vale: checks 
LRSANDIM: bets 200
jcarlos.vale: folds 
Uncalled bet (200) returned to LRSANDIM
LRSANDIM collected 606 from pot
*** SUMMARY ***
Total pot 606 | Rake 0 
Board [9s 5s 2d]
Seat 1: LRSANDIM (button) collected (606)
Seat 3: Paguéga (small blind) folded before Flop
Seat 4: jcarlos.vale (big blind) folded on the Flop
Seat 5: kensui folded before Flop (didn't bet)
Seat 6: Jek8235 folded before Flop (didn't bet)
Seat 7: Kickstand122 folded before Flop (didn't bet)
Seat 8: MaHoMaX 3554 folded before Flop (didn't bet)
Seat 9: Bobby Akselrod folded before Flop (didn't bet)



PokerStars Hand #221901176029: Tournament #3082657132, $0.98+$0.12 USD Hold'em No Limit - Level VI (50/100) - 2020/12/27 17:21:21 EET [2020/12/27 10:21:21 ET]
Table '3082657132 62' 9-max Seat #3 is the button
Seat 1: LRSANDIM (5742 in chips) 
Seat 2: Pieman203 (3000 in chips) 
Seat 3: Paguéga (3356 in chips) 
Seat 4: jcarlos.vale (11501 in chips) 
Seat 5: kensui (13230 in chips) 
Seat 6: Jek8235 (9293 in chips) 
Seat 7: Kickstand122 (2684 in chips) 
Seat 8: MaHoMaX 3554 (2420 in chips) 
Seat 9: Bobby Akselrod (1804 in chips) 
LRSANDIM: posts the ante 12
Pieman203: posts the ante 12
Paguéga: posts the ante 12
jcarlos.vale: posts the ante 12
kensui: posts the ante 12
Jek8235: posts the ante 12
Kickstand122: posts the ante 12
MaHoMaX 3554: posts the ante 12
Bobby Akselrod: posts the ante 12
jcarlos.vale: posts small blind 50
kensui: posts big blind 100
*** HOLE CARDS ***
Dealt to jcarlos.vale [8d 2h]
Jek8235: folds 
Kickstand122: raises 100 to 200
MaHoMaX 3554: folds 
Bobby Akselrod: folds 
LRSANDIM: folds 
Pieman203: calls 200
Paguéga: folds 
jcarlos.vale: folds 
kensui: calls 100
*** FLOP *** [3c 8c Qs]
kensui: checks 
Kickstand122: checks 
Pieman203: checks 
*** TURN *** [3c 8c Qs] [7h]
kensui: checks 
Kickstand122: bets 379
Pieman203: folds 
kensui: folds 
Uncalled bet (379) returned to Kickstand122
Kickstand122 collected 758 from pot
*** SUMMARY ***
Total pot 758 | Rake 0 
Board [3c 8c Qs 7h]
Seat 1: LRSANDIM folded before Flop (didn't bet)
Seat 2: Pieman203 folded on the Turn
Seat 3: Paguéga (button) folded before Flop (didn't bet)
Seat 4: jcarlos.vale (small blind) folded before Flop
Seat 5: kensui (big blind) folded on the Turn
Seat 6: Jek8235 folded before Flop (didn't bet)
Seat 7: Kickstand122 collected (758)
Seat 8: MaHoMaX 3554 folded before Flop (didn't bet)
Seat 9: Bobby Akselrod folded before Flop (didn't bet)



PokerStars Hand #221901213974: Tournament #3082657132, $0.98+$0.12 USD Hold'em No Limit - Level VII (60/120) - 2020/12/27 17:22:23 EET [2020/12/27 10:22:23 ET]
Table '3082657132 62' 9-max Seat #4 is the button
Seat 1: LRSANDIM (5730 in chips) 
Seat 2: Pieman203 (2788 in chips) 
Seat 3: Paguéga (3344 in chips) 
Seat 4: jcarlos.vale (11439 in chips) 
Seat 5: kensui (13018 in chips) 
Seat 6: Jek8235 (9281 in chips) 
Seat 7: Kickstand122 (3230 in chips) 
Seat 8: MaHoMaX 3554 (2408 in chips) 
Seat 9: Bobby Akselrod (1792 in chips) 
LRSANDIM: posts the ante 15
Pieman203: posts the ante 15
Paguéga: posts the ante 15
jcarlos.vale: posts the ante 15
kensui: posts the ante 15
Jek8235: posts the ante 15
Kickstand122: posts the ante 15
MaHoMaX 3554: posts the ante 15
Bobby Akselrod: posts the ante 15
kensui: posts small blind 60
Jek8235: posts big blind 120
*** HOLE CARDS ***
Dealt to jcarlos.vale [Jh As]
Kickstand122: folds 
MaHoMaX 3554: raises 120 to 240
Bobby Akselrod: folds 
LRSANDIM: folds 
Pieman203: calls 240
Paguéga: folds 
jcarlos.vale: calls 240
kensui: folds 
Jek8235: calls 120
*** FLOP *** [5s 7s Kc]
Jek8235: checks 
MaHoMaX 3554: bets 240
Pieman203: calls 240
jcarlos.vale: folds 
Jek8235: folds 
*** TURN *** [5s 7s Kc] [Ad]
MaHoMaX 3554: bets 360
Pieman203: calls 360
*** RIVER *** [5s 7s Kc Ad] [Tc]
MaHoMaX 3554: bets 1553 and is all-in
Pieman203: calls 1553
*** SHOW DOWN ***
MaHoMaX 3554: shows [Kd Td] (two pair, Kings and Tens)
Pieman203: shows [Qs Ah] (a pair of Aces)
MaHoMaX 3554 collected 5461 from pot
*** SUMMARY ***
Total pot 5461 | Rake 0 
Board [5s 7s Kc Ad Tc]
Seat 1: LRSANDIM folded before Flop (didn't bet)
Seat 2: Pieman203 showed [Qs Ah] and lost with a pair of Aces
Seat 3: Paguéga folded before Flop (didn't bet)
Seat 4: jcarlos.vale (button) folded on the Flop
Seat 5: kensui (small blind) folded before Flop
Seat 6: Jek8235 (big blind) folded on the Flop
Seat 7: Kickstand122 folded before Flop (didn't bet)
Seat 8: MaHoMaX 3554 showed [Kd Td] and won (5461) with two pair, Kings and Tens
Seat 9: Bobby Akselrod folded before Flop (didn't bet)



PokerStars Hand #221901260671: Tournament #3082657132, $0.98+$0.12 USD Hold'em No Limit - Level VII (60/120) - 2020/12/27 17:23:39 EET [2020/12/27 10:23:39 ET]
Table '3082657132 62' 9-max Seat #5 is the button
Seat 1: LRSANDIM (5715 in chips) 
Seat 2: Pieman203 (380 in chips) 
Seat 3: Paguéga (3329 in chips) 
Seat 4: jcarlos.vale (11184 in chips) 
Seat 5: kensui (12943 in chips) 
Seat 6: Jek8235 (9026 in chips) 
Seat 7: Kickstand122 (3215 in chips) 
Seat 8: MaHoMaX 3554 (5461 in chips) 
Seat 9: Bobby Akselrod (1777 in chips) 
LRSANDIM: posts the ante 15
Pieman203: posts the ante 15
Paguéga: posts the ante 15
jcarlos.vale: posts the ante 15
kensui: posts the ante 15
Jek8235: posts the ante 15
Kickstand122: posts the ante 15
MaHoMaX 3554: posts the ante 15
Bobby Akselrod: posts the ante 15
Jek8235: posts small blind 60
Kickstand122: posts big blind 120
*** HOLE CARDS ***
Dealt to jcarlos.vale [7s 5d]
MaHoMaX 3554: raises 120 to 240
Bobby Akselrod: folds 
LRSANDIM: folds 
Pieman203: raises 125 to 365 and is all-in
Paguéga: folds 
jcarlos.vale: folds 
kensui: folds 
Jek8235: folds 
Kickstand122: calls 245
MaHoMaX 3554: calls 125
*** FLOP *** [Js 8c Td]
Kickstand122: checks 
MaHoMaX 3554: bets 120
Kickstand122: calls 120
*** TURN *** [Js 8c Td] [6d]
Kickstand122: checks 
MaHoMaX 3554: checks 
*** RIVER *** [Js 8c Td 6d] [4s]
Kickstand122: bets 765
MaHoMaX 3554: folds 
Uncalled bet (765) returned to Kickstand122
*** SHOW DOWN ***
Kickstand122: shows [As 5s] (high pairOfCards Ace)
Kickstand122 collected 240 from side pot
Pieman203: shows [Jd 8s] (two pair, Jacks and Eights)
Pieman203 collected 1290 from main pot
*** SUMMARY ***
Total pot 1530 Main pot 1290. Side pot 240. | Rake 0 
Board [Js 8c Td 6d 4s]
Seat 1: LRSANDIM folded before Flop (didn't bet)
Seat 2: Pieman203 showed [Jd 8s] and won (1290) with two pair, Jacks and Eights
Seat 3: Paguéga folded before Flop (didn't bet)
Seat 4: jcarlos.vale folded before Flop (didn't bet)
Seat 5: kensui (button) folded before Flop (didn't bet)
Seat 6: Jek8235 (small blind) folded before Flop
Seat 7: Kickstand122 (big blind) showed [As 5s] and won (240) with high pairOfCards Ace
Seat 8: MaHoMaX 3554 folded on the River
Seat 9: Bobby Akselrod folded before Flop (didn't bet)



PokerStars Hand #221901304631: Tournament #3082657132, $0.98+$0.12 USD Hold'em No Limit - Level VII (60/120) - 2020/12/27 17:24:50 EET [2020/12/27 10:24:50 ET]
Table '3082657132 62' 9-max Seat #6 is the button
Seat 1: LRSANDIM (5700 in chips) 
Seat 2: Pieman203 (1290 in chips) 
Seat 3: Paguéga (3314 in chips) 
Seat 4: jcarlos.vale (11169 in chips) 
Seat 5: kensui (12928 in chips) 
Seat 6: Jek8235 (8951 in chips) 
Seat 7: Kickstand122 (2955 in chips) 
Seat 8: MaHoMaX 3554 (4961 in chips) 
Seat 9: Bobby Akselrod (1762 in chips) 
LRSANDIM: posts the ante 15
Pieman203: posts the ante 15
Paguéga: posts the ante 15
jcarlos.vale: posts the ante 15
kensui: posts the ante 15
Jek8235: posts the ante 15
Kickstand122: posts the ante 15
MaHoMaX 3554: posts the ante 15
Bobby Akselrod: posts the ante 15
Kickstand122: posts small blind 60
MaHoMaX 3554: posts big blind 120
*** HOLE CARDS ***
Dealt to jcarlos.vale [6h Qh]
Bobby Akselrod: raises 144 to 264
LRSANDIM: folds 
Pieman203: folds 
Paguéga: folds 
jcarlos.vale: folds 
kensui: folds 
Jek8235: folds 
Kickstand122: calls 204
MaHoMaX 3554: calls 144
*** FLOP *** [Ah 5s Js]
Kickstand122: checks 
MaHoMaX 3554: bets 120
Bobby Akselrod: calls 120
Kickstand122: calls 120
*** TURN *** [Ah 5s Js] [7d]
Kickstand122: checks 
MaHoMaX 3554: bets 480
Bobby Akselrod: calls 480
Kickstand122: folds 
*** RIVER *** [Ah 5s Js 7d] [9s]
MaHoMaX 3554: checks 
Bobby Akselrod: checks 
*** SHOW DOWN ***
MaHoMaX 3554: shows [Td 5d] (a pair of Fives)
Bobby Akselrod: shows [Qc Jc] (a pair of Jacks)
Bobby Akselrod collected 2247 from pot
*** SUMMARY ***
Total pot 2247 | Rake 0 
Board [Ah 5s Js 7d 9s]
Seat 1: LRSANDIM folded before Flop (didn't bet)
Seat 2: Pieman203 folded before Flop (didn't bet)
Seat 3: Paguéga folded before Flop (didn't bet)
Seat 4: jcarlos.vale folded before Flop (didn't bet)
Seat 5: kensui folded before Flop (didn't bet)
Seat 6: Jek8235 (button) folded before Flop (didn't bet)
Seat 7: Kickstand122 (small blind) folded on the Turn
Seat 8: MaHoMaX 3554 (big blind) showed [Td 5d] and lost with a pair of Fives
Seat 9: Bobby Akselrod showed [Qc Jc] and won (2247) with a pair of Jacks



PokerStars Hand #221901349979: Tournament #3082657132, $0.98+$0.12 USD Hold'em No Limit - Level VII (60/120) - 2020/12/27 17:26:04 EET [2020/12/27 10:26:04 ET]
Table '3082657132 62' 9-max Seat #7 is the button
Seat 1: LRSANDIM (5685 in chips) 
Seat 2: Pieman203 (1275 in chips) 
Seat 3: Paguéga (3299 in chips) 
Seat 4: jcarlos.vale (11154 in chips) 
Seat 5: kensui (12913 in chips) 
Seat 6: Jek8235 (8936 in chips) 
Seat 7: Kickstand122 (2556 in chips) 
Seat 8: MaHoMaX 3554 (4082 in chips) 
Seat 9: Bobby Akselrod (3130 in chips) 
LRSANDIM: posts the ante 15
Pieman203: posts the ante 15
Paguéga: posts the ante 15
jcarlos.vale: posts the ante 15
kensui: posts the ante 15
Jek8235: posts the ante 15
Kickstand122: posts the ante 15
MaHoMaX 3554: posts the ante 15
Bobby Akselrod: posts the ante 15
MaHoMaX 3554: posts small blind 60
Bobby Akselrod: posts big blind 120
*** HOLE CARDS ***
Dealt to jcarlos.vale [9d Js]
LRSANDIM: raises 156 to 276
Pieman203: folds 
Paguéga: folds 
jcarlos.vale: folds 
kensui: folds 
Jek8235: folds 
Kickstand122: calls 276
MaHoMaX 3554: folds 
Bobby Akselrod: folds 
*** FLOP *** [4c 9c 6d]
LRSANDIM: bets 286
Kickstand122: calls 286
*** TURN *** [4c 9c 6d] [2c]
LRSANDIM: bets 950
Kickstand122: folds 
Uncalled bet (950) returned to LRSANDIM
LRSANDIM collected 1439 from pot
*** SUMMARY ***
Total pot 1439 | Rake 0 
Board [4c 9c 6d 2c]
Seat 1: LRSANDIM collected (1439)
Seat 2: Pieman203 folded before Flop (didn't bet)
Seat 3: Paguéga folded before Flop (didn't bet)
Seat 4: jcarlos.vale folded before Flop (didn't bet)
Seat 5: kensui folded before Flop (didn't bet)
Seat 6: Jek8235 folded before Flop (didn't bet)
Seat 7: Kickstand122 (button) folded on the Turn
Seat 8: MaHoMaX 3554 (small blind) folded before Flop
Seat 9: Bobby Akselrod (big blind) folded before Flop



PokerStars Hand #221901377656: Tournament #3082657132, $0.98+$0.12 USD Hold'em No Limit - Level VII (60/120) - 2020/12/27 17:26:50 EET [2020/12/27 10:26:50 ET]
Table '3082657132 62' 9-max Seat #8 is the button
Seat 1: LRSANDIM (6547 in chips) 
Seat 2: Pieman203 (1260 in chips) 
Seat 3: Paguéga (3284 in chips) 
Seat 4: jcarlos.vale (11139 in chips) 
Seat 5: kensui (12898 in chips) 
Seat 6: Jek8235 (8921 in chips) 
Seat 7: Kickstand122 (1979 in chips) 
Seat 8: MaHoMaX 3554 (4007 in chips) 
Seat 9: Bobby Akselrod (2995 in chips) 
LRSANDIM: posts the ante 15
Pieman203: posts the ante 15
Paguéga: posts the ante 15
jcarlos.vale: posts the ante 15
kensui: posts the ante 15
Jek8235: posts the ante 15
Kickstand122: posts the ante 15
MaHoMaX 3554: posts the ante 15
Bobby Akselrod: posts the ante 15
Bobby Akselrod: posts small blind 60
LRSANDIM: posts big blind 120
*** HOLE CARDS ***
Dealt to jcarlos.vale [Js Ks]
Pieman203: folds 
Paguéga: folds 
jcarlos.vale: raises 192 to 312
kensui: folds 
Jek8235: folds 
Kickstand122: calls 312
MaHoMaX 3554: raises 1251 to 1563
Bobby Akselrod: folds 
LRSANDIM: folds 
jcarlos.vale: folds 
Kickstand122: calls 1251
*** FLOP *** [Qc 9c 6s]
Kickstand122: checks 
MaHoMaX 3554: bets 2429 and is all-in
Kickstand122: calls 401 and is all-in
Uncalled bet (2028) returned to MaHoMaX 3554
*** TURN *** [Qc 9c 6s] [9s]
*** RIVER *** [Qc 9c 6s 9s] [7s]
*** SHOW DOWN ***
Kickstand122: shows [Qd 9h] (a full house, Nines full of Queens)
MaHoMaX 3554: shows [Ah Jc] (a pair of Nines)
Kickstand122 collected 4555 from pot
*** SUMMARY ***
Total pot 4555 | Rake 0 
Board [Qc 9c 6s 9s 7s]
Seat 1: LRSANDIM (big blind) folded before Flop
Seat 2: Pieman203 folded before Flop (didn't bet)
Seat 3: Paguéga folded before Flop (didn't bet)
Seat 4: jcarlos.vale folded before Flop
Seat 5: kensui folded before Flop (didn't bet)
Seat 6: Jek8235 folded before Flop (didn't bet)
Seat 7: Kickstand122 showed [Qd 9h] and won (4555) with a full house, Nines full of Queens
Seat 8: MaHoMaX 3554 (button) showed [Ah Jc] and lost with a pair of Nines
Seat 9: Bobby Akselrod (small blind) folded before Flop



PokerStars Hand #221901424424: Tournament #3082657132, $0.98+$0.12 USD Hold'em No Limit - Level VII (60/120) - 2020/12/27 17:27:55 EET [2020/12/27 10:27:55 ET]
Table '3082657132 62' 9-max Seat #9 is the button
Seat 1: LRSANDIM (6412 in chips) 
Seat 2: Pieman203 (1245 in chips) 
Seat 3: Paguéga (3269 in chips) 
Seat 4: jcarlos.vale (10812 in chips) 
Seat 5: kensui (12883 in chips) 
Seat 6: Jek8235 (8906 in chips) 
Seat 7: Kickstand122 (4555 in chips) 
Seat 8: MaHoMaX 3554 (2028 in chips) 
Seat 9: Bobby Akselrod (2920 in chips) 
LRSANDIM: posts the ante 15
Pieman203: posts the ante 15
Paguéga: posts the ante 15
jcarlos.vale: posts the ante 15
kensui: posts the ante 15
Jek8235: posts the ante 15
Kickstand122: posts the ante 15
MaHoMaX 3554: posts the ante 15
Bobby Akselrod: posts the ante 15
LRSANDIM: posts small blind 60
Pieman203: posts big blind 120
*** HOLE CARDS ***
Dealt to jcarlos.vale [7d 3s]
Paguéga: folds 
jcarlos.vale: folds 
kensui: folds 
Jek8235: folds 
Kickstand122: folds 
MaHoMaX 3554: raises 120 to 240
Bobby Akselrod: folds 
LRSANDIM: folds 
Pieman203: raises 120 to 360
MaHoMaX 3554: calls 120
*** FLOP *** [6c 3d Js]
Pieman203: bets 870 and is all-in
MaHoMaX 3554: calls 870
*** TURN *** [6c 3d Js] [Th]
*** RIVER *** [6c 3d Js Th] [3h]
*** SHOW DOWN ***
Pieman203: shows [Ac Kc] (a pair of Threes)
MaHoMaX 3554: shows [9d 6d] (two pair, Sixes and Threes)
MaHoMaX 3554 collected 2655 from pot
Pieman203 finished the tournament
*** SUMMARY ***
Total pot 2655 | Rake 0 
Board [6c 3d Js Th 3h]
Seat 1: LRSANDIM (small blind) folded before Flop
Seat 2: Pieman203 (big blind) showed [Ac Kc] and lost with a pair of Threes
Seat 3: Paguéga folded before Flop (didn't bet)
Seat 4: jcarlos.vale folded before Flop (didn't bet)
Seat 5: kensui folded before Flop (didn't bet)
Seat 6: Jek8235 folded before Flop (didn't bet)
Seat 7: Kickstand122 folded before Flop (didn't bet)
Seat 8: MaHoMaX 3554 showed [9d 6d] and won (2655) with two pair, Sixes and Threes
Seat 9: Bobby Akselrod (button) folded before Flop (didn't bet)



PokerStars Hand #221901454803: Tournament #3082657132, $0.98+$0.12 USD Hold'em No Limit - Level VII (60/120) - 2020/12/27 17:28:45 EET [2020/12/27 10:28:45 ET]
Table '3082657132 62' 9-max Seat #1 is the button
Seat 1: LRSANDIM (6337 in chips) 
Seat 3: Paguéga (3254 in chips) 
Seat 4: jcarlos.vale (10797 in chips) 
Seat 5: kensui (12868 in chips) 
Seat 6: Jek8235 (8891 in chips) 
Seat 7: Kickstand122 (4540 in chips) 
Seat 8: MaHoMaX 3554 (3438 in chips) 
Seat 9: Bobby Akselrod (2905 in chips) 
LRSANDIM: posts the ante 15
Paguéga: posts the ante 15
jcarlos.vale: posts the ante 15
kensui: posts the ante 15
Jek8235: posts the ante 15
Kickstand122: posts the ante 15
MaHoMaX 3554: posts the ante 15
Bobby Akselrod: posts the ante 15
Paguéga: posts small blind 60
jcarlos.vale: posts big blind 120
*** HOLE CARDS ***
Dealt to jcarlos.vale [9c 9s]
kensui: raises 139 to 259
Jek8235: folds 
Kickstand122: folds 
MaHoMaX 3554: folds 
Bobby Akselrod: folds 
LRSANDIM: folds 
Paguéga: folds 
jcarlos.vale: calls 139
*** FLOP *** [5c 7c Ah]
jcarlos.vale: bets 240
kensui: calls 240
*** TURN *** [5c 7c Ah] [7d]
jcarlos.vale: checks 
kensui: checks 
*** RIVER *** [5c 7c Ah 7d] [3c]
jcarlos.vale: checks 
kensui: checks 
*** SHOW DOWN ***
jcarlos.vale: shows [9c 9s] (two pair, Nines and Sevens)
kensui: shows [Jd Js] (two pair, Jacks and Sevens)
kensui collected 1178 from pot
*** SUMMARY ***
Total pot 1178 | Rake 0 
Board [5c 7c Ah 7d 3c]
Seat 1: LRSANDIM (button) folded before Flop (didn't bet)
Seat 3: Paguéga (small blind) folded before Flop
Seat 4: jcarlos.vale (big blind) showed [9c 9s] and lost with two pair, Nines and Sevens
Seat 5: kensui showed [Jd Js] and won (1178) with two pair, Jacks and Sevens
Seat 6: Jek8235 folded before Flop (didn't bet)
Seat 7: Kickstand122 folded before Flop (didn't bet)
Seat 8: MaHoMaX 3554 folded before Flop (didn't bet)
Seat 9: Bobby Akselrod folded before Flop (didn't bet)



PokerStars Hand #221901475776: Tournament #3082657132, $0.98+$0.12 USD Hold'em No Limit - Level VII (60/120) - 2020/12/27 17:29:19 EET [2020/12/27 10:29:19 ET]
Table '3082657132 62' 9-max Seat #3 is the button
Seat 1: LRSANDIM (6322 in chips) 
Seat 2: BARS236 (3000 in chips) 
Seat 3: Paguéga (3179 in chips) 
Seat 4: jcarlos.vale (10283 in chips) 
Seat 5: kensui (13532 in chips) 
Seat 6: Jek8235 (8876 in chips) 
Seat 7: Kickstand122 (4525 in chips) 
Seat 8: MaHoMaX 3554 (3423 in chips) 
Seat 9: Bobby Akselrod (2890 in chips) 
LRSANDIM: posts the ante 15
BARS236: posts the ante 15
Paguéga: posts the ante 15
jcarlos.vale: posts the ante 15
kensui: posts the ante 15
Jek8235: posts the ante 15
Kickstand122: posts the ante 15
MaHoMaX 3554: posts the ante 15
Bobby Akselrod: posts the ante 15
jcarlos.vale: posts small blind 60
kensui: posts big blind 120
*** HOLE CARDS ***
Dealt to jcarlos.vale [Qh Ad]
Jek8235: raises 120 to 240
Kickstand122: folds 
MaHoMaX 3554: folds 
Bobby Akselrod: folds 
LRSANDIM: folds 
BARS236: raises 795 to 1035
Paguéga: folds 
jcarlos.vale: folds 
kensui: folds 
Jek8235: folds 
Uncalled bet (795) returned to BARS236
BARS236 collected 795 from pot
*** SUMMARY ***
Total pot 795 | Rake 0 
Seat 1: LRSANDIM folded before Flop (didn't bet)
Seat 2: BARS236 collected (795)
Seat 3: Paguéga (button) folded before Flop (didn't bet)
Seat 4: jcarlos.vale (small blind) folded before Flop
Seat 5: kensui (big blind) folded before Flop
Seat 6: Jek8235 folded before Flop
Seat 7: Kickstand122 folded before Flop (didn't bet)
Seat 8: MaHoMaX 3554 folded before Flop (didn't bet)
Seat 9: Bobby Akselrod folded before Flop (didn't bet)



PokerStars Hand #221901495282: Tournament #3082657132, $0.98+$0.12 USD Hold'em No Limit - Level VII (60/120) - 2020/12/27 17:29:51 EET [2020/12/27 10:29:51 ET]
Table '3082657132 62' 9-max Seat #4 is the button
Seat 1: LRSANDIM (6307 in chips) 
Seat 2: BARS236 (3540 in chips) 
Seat 3: Paguéga (3164 in chips) 
Seat 4: jcarlos.vale (10208 in chips) 
Seat 5: kensui (13397 in chips) 
Seat 6: Jek8235 (8621 in chips) 
Seat 7: Kickstand122 (4510 in chips) 
Seat 8: MaHoMaX 3554 (3408 in chips) 
Seat 9: Bobby Akselrod (2875 in chips) 
LRSANDIM: posts the ante 15
BARS236: posts the ante 15
Paguéga: posts the ante 15
jcarlos.vale: posts the ante 15
kensui: posts the ante 15
Jek8235: posts the ante 15
Kickstand122: posts the ante 15
MaHoMaX 3554: posts the ante 15
Bobby Akselrod: posts the ante 15
kensui: posts small blind 60
Jek8235: posts big blind 120
*** HOLE CARDS ***
Dealt to jcarlos.vale [Qh Kc]
Kickstand122: folds 
MaHoMaX 3554: folds 
Bobby Akselrod: folds 
LRSANDIM: folds 
BARS236: calls 120
Paguéga: raises 120 to 240
jcarlos.vale: calls 240
kensui: calls 180
Jek8235: folds 
BARS236: calls 120
*** FLOP *** [5h 2h 7c]
kensui: checks 
BARS236: checks 
Paguéga: checks 
jcarlos.vale: checks 
*** TURN *** [5h 2h 7c] [6s]
kensui: checks 
BARS236: checks 
Paguéga: checks 
jcarlos.vale: checks 
*** RIVER *** [5h 2h 7c 6s] [8c]
kensui: checks 
BARS236: checks 
Paguéga: checks 
jcarlos.vale: checks 
*** SHOW DOWN ***
kensui: shows [Qc Th] (high pairOfCards Queen)
BARS236: shows [Ad 6d] (a pair of Sixes)
Paguéga: mucks handDTO
jcarlos.vale: mucks handDTO
BARS236 collected 1215 from pot
*** SUMMARY ***
Total pot 1215 | Rake 0 
Board [5h 2h 7c 6s 8c]
Seat 1: LRSANDIM folded before Flop (didn't bet)
Seat 2: BARS236 showed [Ad 6d] and won (1215) with a pair of Sixes
Seat 3: Paguéga mucked [Jc Ah]
Seat 4: jcarlos.vale (button) mucked [Qh Kc]
Seat 5: kensui (small blind) showed [Qc Th] and lost with high pairOfCards Queen
Seat 6: Jek8235 (big blind) folded before Flop
Seat 7: Kickstand122 folded before Flop (didn't bet)
Seat 8: MaHoMaX 3554 folded before Flop (didn't bet)
Seat 9: Bobby Akselrod folded before Flop (didn't bet)



PokerStars Hand #221901531532: Tournament #3082657132, $0.98+$0.12 USD Hold'em No Limit - Level VII (60/120) - 2020/12/27 17:30:50 EET [2020/12/27 10:30:50 ET]
Table '3082657132 62' 9-max Seat #5 is the button
Seat 1: LRSANDIM (6292 in chips) 
Seat 2: BARS236 (4500 in chips) 
Seat 3: Paguéga (2909 in chips) 
Seat 4: jcarlos.vale (9953 in chips) 
Seat 5: kensui (13142 in chips) 
Seat 6: Jek8235 (8486 in chips) 
Seat 7: Kickstand122 (4495 in chips) 
Seat 8: MaHoMaX 3554 (3393 in chips) 
Seat 9: Bobby Akselrod (2860 in chips) 
LRSANDIM: posts the ante 15
BARS236: posts the ante 15
Paguéga: posts the ante 15
jcarlos.vale: posts the ante 15
kensui: posts the ante 15
Jek8235: posts the ante 15
Kickstand122: posts the ante 15
MaHoMaX 3554: posts the ante 15
Bobby Akselrod: posts the ante 15
Jek8235: posts small blind 60
Kickstand122: posts big blind 120
*** HOLE CARDS ***
Dealt to jcarlos.vale [Jc 8s]
MaHoMaX 3554: folds 
Bobby Akselrod: folds 
LRSANDIM: folds 
BARS236: folds 
Paguéga: raises 120 to 240
jcarlos.vale: folds 
kensui: calls 240
Jek8235: calls 180
Kickstand122: calls 120
*** FLOP *** [Qc Qh Ah]
Jek8235: checks 
Kickstand122: checks 
Paguéga: bets 361
kensui: folds 
Jek8235: calls 361
Kickstand122: folds 
*** TURN *** [Qc Qh Ah] [3s]
Jek8235: checks 
Paguéga: checks 
*** RIVER *** [Qc Qh Ah 3s] [2s]
Jek8235: bets 981
Paguéga: calls 981
*** SHOW DOWN ***
Jek8235: shows [9d Qd] (three of a kind, Queens)
Paguéga: mucks handDTO
Jek8235 collected 3779 from pot
*** SUMMARY ***
Total pot 3779 | Rake 0 
Board [Qc Qh Ah 3s 2s]
Seat 1: LRSANDIM folded before Flop (didn't bet)
Seat 2: BARS236 folded before Flop (didn't bet)
Seat 3: Paguéga mucked [Ad Th]
Seat 4: jcarlos.vale folded before Flop (didn't bet)
Seat 5: kensui (button) folded on the Flop
Seat 6: Jek8235 (small blind) showed [9d Qd] and won (3779) with three of a kind, Queens
Seat 7: Kickstand122 (big blind) folded on the Flop
Seat 8: MaHoMaX 3554 folded before Flop (didn't bet)
Seat 9: Bobby Akselrod folded before Flop (didn't bet)



PokerStars Hand #221901565670: Tournament #3082657132, $0.98+$0.12 USD Hold'em No Limit - Level VII (60/120) - 2020/12/27 17:31:46 EET [2020/12/27 10:31:46 ET]
Table '3082657132 62' 9-max Seat #6 is the button
Seat 1: LRSANDIM (6277 in chips) 
Seat 2: BARS236 (4485 in chips) 
Seat 3: Paguéga (1312 in chips) 
Seat 4: jcarlos.vale (9938 in chips) 
Seat 5: kensui (12887 in chips) 
Seat 6: Jek8235 (10668 in chips) 
Seat 7: Kickstand122 (4240 in chips) 
Seat 8: MaHoMaX 3554 (3378 in chips) 
Seat 9: Bobby Akselrod (2845 in chips) 
LRSANDIM: posts the ante 15
BARS236: posts the ante 15
Paguéga: posts the ante 15
jcarlos.vale: posts the ante 15
kensui: posts the ante 15
Jek8235: posts the ante 15
Kickstand122: posts the ante 15
MaHoMaX 3554: posts the ante 15
Bobby Akselrod: posts the ante 15
Kickstand122: posts small blind 60
MaHoMaX 3554: posts big blind 120
*** HOLE CARDS ***
Dealt to jcarlos.vale [Ks 2s]
Bobby Akselrod: raises 144 to 264
LRSANDIM: folds 
BARS236: calls 264
Paguéga: calls 264
jcarlos.vale: folds 
kensui: folds 
Jek8235: folds 
Kickstand122: folds 
MaHoMaX 3554: folds 
*** FLOP *** [4h 8s 2c]
Bobby Akselrod: bets 2566 and is all-in
BARS236: folds 
Paguéga: folds 
Uncalled bet (2566) returned to Bobby Akselrod
Bobby Akselrod collected 1107 from pot
Bobby Akselrod: doesn't show handDTO
*** SUMMARY ***
Total pot 1107 | Rake 0 
Board [4h 8s 2c]
Seat 1: LRSANDIM folded before Flop (didn't bet)
Seat 2: BARS236 folded on the Flop
Seat 3: Paguéga folded on the Flop
Seat 4: jcarlos.vale folded before Flop (didn't bet)
Seat 5: kensui folded before Flop (didn't bet)
Seat 6: Jek8235 (button) folded before Flop (didn't bet)
Seat 7: Kickstand122 (small blind) folded before Flop
Seat 8: MaHoMaX 3554 (big blind) folded before Flop
Seat 9: Bobby Akselrod collected (1107)



PokerStars Hand #221901590330: Tournament #3082657132, $0.98+$0.12 USD Hold'em No Limit - Level VIII (75/150) - 2020/12/27 17:32:26 EET [2020/12/27 10:32:26 ET]
Table '3082657132 62' 9-max Seat #7 is the button
Seat 1: LRSANDIM (6262 in chips) 
Seat 2: BARS236 (4206 in chips) 
Seat 3: Paguéga (1033 in chips) 
Seat 4: jcarlos.vale (9923 in chips) 
Seat 5: kensui (12872 in chips) 
Seat 6: Jek8235 (10653 in chips) 
Seat 7: Kickstand122 (4165 in chips) 
Seat 8: MaHoMaX 3554 (3243 in chips) 
Seat 9: Bobby Akselrod (3673 in chips) 
LRSANDIM: posts the ante 20
BARS236: posts the ante 20
Paguéga: posts the ante 20
jcarlos.vale: posts the ante 20
kensui: posts the ante 20
Jek8235: posts the ante 20
Kickstand122: posts the ante 20
MaHoMaX 3554: posts the ante 20
Bobby Akselrod: posts the ante 20
MaHoMaX 3554: posts small blind 75
Bobby Akselrod: posts big blind 150
*** HOLE CARDS ***
Dealt to jcarlos.vale [Kd 5c]
LRSANDIM: folds 
BARS236: raises 555 to 705
Paguéga: folds 
jcarlos.vale: folds 
kensui: folds 
Jek8235: folds 
Kickstand122: folds 
MaHoMaX 3554: raises 1740 to 2445
Bobby Akselrod: folds 
BARS236: calls 1740
*** FLOP *** [4d 5d 3s]
MaHoMaX 3554: bets 778 and is all-in
BARS236: calls 778
*** TURN *** [4d 5d 3s] [Ac]
*** RIVER *** [4d 5d 3s Ac] [Tc]
*** SHOW DOWN ***
MaHoMaX 3554: shows [Ks Kh] (a pair of Kings)
BARS236: shows [4s 8s] (a pair of Fours)
MaHoMaX 3554 collected 6776 from pot
*** SUMMARY ***
Total pot 6776 | Rake 0 
Board [4d 5d 3s Ac Tc]
Seat 1: LRSANDIM folded before Flop (didn't bet)
Seat 2: BARS236 showed [4s 8s] and lost with a pair of Fours
Seat 3: Paguéga folded before Flop (didn't bet)
Seat 4: jcarlos.vale folded before Flop (didn't bet)
Seat 5: kensui folded before Flop (didn't bet)
Seat 6: Jek8235 folded before Flop (didn't bet)
Seat 7: Kickstand122 (button) folded before Flop (didn't bet)
Seat 8: MaHoMaX 3554 (small blind) showed [Ks Kh] and won (6776) with a pair of Kings
Seat 9: Bobby Akselrod (big blind) folded before Flop



PokerStars Hand #221901617333: Tournament #3082657132, $0.98+$0.12 USD Hold'em No Limit - Level VIII (75/150) - 2020/12/27 17:33:10 EET [2020/12/27 10:33:10 ET]
Table '3082657132 62' 9-max Seat #8 is the button
Seat 1: LRSANDIM (6242 in chips) 
Seat 2: BARS236 (963 in chips) 
Seat 3: Paguéga (1013 in chips) 
Seat 4: jcarlos.vale (9903 in chips) 
Seat 5: kensui (12852 in chips) 
Seat 6: Jek8235 (10633 in chips) 
Seat 7: Kickstand122 (4145 in chips) 
Seat 8: MaHoMaX 3554 (6776 in chips) 
Seat 9: Bobby Akselrod (3503 in chips) 
LRSANDIM: posts the ante 20
BARS236: posts the ante 20
Paguéga: posts the ante 20
jcarlos.vale: posts the ante 20
kensui: posts the ante 20
Jek8235: posts the ante 20
Kickstand122: posts the ante 20
MaHoMaX 3554: posts the ante 20
Bobby Akselrod: posts the ante 20
Bobby Akselrod: posts small blind 75
LRSANDIM: posts big blind 150
*** HOLE CARDS ***
Dealt to jcarlos.vale [6d 9d]
BARS236: raises 793 to 943 and is all-in
Paguéga: folds 
jcarlos.vale: folds 
kensui: folds 
Jek8235: folds 
Kickstand122: folds 
MaHoMaX 3554: folds 
Bobby Akselrod: folds 
LRSANDIM: calls 793
*** FLOP *** [Ac 4h 9c]
*** TURN *** [Ac 4h 9c] [Kh]
*** RIVER *** [Ac 4h 9c Kh] [Ad]
*** SHOW DOWN ***
LRSANDIM: shows [Kd Jc] (two pair, Aces and Kings)
BARS236: shows [2d 2h] (two pair, Aces and Deuces)
LRSANDIM collected 2141 from pot
BARS236 finished the tournament
*** SUMMARY ***
Total pot 2141 | Rake 0 
Board [Ac 4h 9c Kh Ad]
Seat 1: LRSANDIM (big blind) showed [Kd Jc] and won (2141) with two pair, Aces and Kings
Seat 2: BARS236 showed [2d 2h] and lost with two pair, Aces and Deuces
Seat 3: Paguéga folded before Flop (didn't bet)
Seat 4: jcarlos.vale folded before Flop (didn't bet)
Seat 5: kensui folded before Flop (didn't bet)
Seat 6: Jek8235 folded before Flop (didn't bet)
Seat 7: Kickstand122 folded before Flop (didn't bet)
Seat 8: MaHoMaX 3554 (button) folded before Flop (didn't bet)
Seat 9: Bobby Akselrod (small blind) folded before Flop



PokerStars Hand #221901642122: Tournament #3082657132, $0.98+$0.12 USD Hold'em No Limit - Level VIII (75/150) - 2020/12/27 17:33:51 EET [2020/12/27 10:33:51 ET]
Table '3082657132 62' 9-max Seat #9 is the button
Seat 1: LRSANDIM (7420 in chips) 
Seat 3: Paguéga (993 in chips) 
Seat 4: jcarlos.vale (9883 in chips) 
Seat 5: kensui (12832 in chips) 
Seat 6: Jek8235 (10613 in chips) 
Seat 7: Kickstand122 (4125 in chips) 
Seat 8: MaHoMaX 3554 (6756 in chips) 
Seat 9: Bobby Akselrod (3408 in chips) 
LRSANDIM: posts the ante 20
Paguéga: posts the ante 20
jcarlos.vale: posts the ante 20
kensui: posts the ante 20
Jek8235: posts the ante 20
Kickstand122: posts the ante 20
MaHoMaX 3554: posts the ante 20
Bobby Akselrod: posts the ante 20
LRSANDIM: posts small blind 75
Paguéga: posts big blind 150
*** HOLE CARDS ***
Dealt to jcarlos.vale [As Kc]
jcarlos.vale: raises 240 to 390
kensui: folds 
Jek8235: folds 
Kickstand122: folds 
MaHoMaX 3554: folds 
Bobby Akselrod: folds 
LRSANDIM: folds 
Paguéga: folds 
Uncalled bet (240) returned to jcarlos.vale
jcarlos.vale collected 535 from pot
jcarlos.vale: doesn't show handDTO
*** SUMMARY ***
Total pot 535 | Rake 0 
Seat 1: LRSANDIM (small blind) folded before Flop
Seat 3: Paguéga (big blind) folded before Flop
Seat 4: jcarlos.vale collected (535)
Seat 5: kensui folded before Flop (didn't bet)
Seat 6: Jek8235 folded before Flop (didn't bet)
Seat 7: Kickstand122 folded before Flop (didn't bet)
Seat 8: MaHoMaX 3554 folded before Flop (didn't bet)
Seat 9: Bobby Akselrod (button) folded before Flop (didn't bet)



PokerStars Hand #221901656365: Tournament #3082657132, $0.98+$0.12 USD Hold'em No Limit - Level VIII (75/150) - 2020/12/27 17:34:14 EET [2020/12/27 10:34:14 ET]
Table '3082657132 62' 9-max Seat #1 is the button
Seat 1: LRSANDIM (7325 in chips) 
Seat 3: Paguéga (823 in chips) 
Seat 4: jcarlos.vale (10248 in chips) 
Seat 5: kensui (12812 in chips) 
Seat 6: Jek8235 (10593 in chips) 
Seat 7: Kickstand122 (4105 in chips) 
Seat 8: MaHoMaX 3554 (6736 in chips) 
Seat 9: Bobby Akselrod (3388 in chips) 
LRSANDIM: posts the ante 20
Paguéga: posts the ante 20
jcarlos.vale: posts the ante 20
kensui: posts the ante 20
Jek8235: posts the ante 20
Kickstand122: posts the ante 20
MaHoMaX 3554: posts the ante 20
Bobby Akselrod: posts the ante 20
Paguéga: posts small blind 75
jcarlos.vale: posts big blind 150
*** HOLE CARDS ***
Dealt to jcarlos.vale [2h Kd]
kensui: raises 174 to 324
Jek8235: folds 
Kickstand122: folds 
MaHoMaX 3554: raises 1033 to 1357
Bobby Akselrod: raises 2011 to 3368 and is all-in
LRSANDIM: folds 
Paguéga: folds 
jcarlos.vale: folds 
kensui: folds 
MaHoMaX 3554: calls 2011
*** FLOP *** [Jd Qc 3s]
*** TURN *** [Jd Qc 3s] [Tc]
*** RIVER *** [Jd Qc 3s Tc] [5s]
*** SHOW DOWN ***
MaHoMaX 3554: shows [As Qd] (a pair of Queens)
Bobby Akselrod: shows [Ad Ks] (a straight, Ten to Ace)
Bobby Akselrod collected 7445 from pot
*** SUMMARY ***
Total pot 7445 | Rake 0 
Board [Jd Qc 3s Tc 5s]
Seat 1: LRSANDIM (button) folded before Flop (didn't bet)
Seat 3: Paguéga (small blind) folded before Flop
Seat 4: jcarlos.vale (big blind) folded before Flop
Seat 5: kensui folded before Flop
Seat 6: Jek8235 folded before Flop (didn't bet)
Seat 7: Kickstand122 folded before Flop (didn't bet)
Seat 8: MaHoMaX 3554 showed [As Qd] and lost with a pair of Queens
Seat 9: Bobby Akselrod showed [Ad Ks] and won (7445) with a straight, Ten to Ace



PokerStars Hand #221901684523: Tournament #3082657132, $0.98+$0.12 USD Hold'em No Limit - Level VIII (75/150) - 2020/12/27 17:35:00 EET [2020/12/27 10:35:00 ET]
Table '3082657132 62' 9-max Seat #3 is the button
Seat 1: LRSANDIM (7305 in chips) 
Seat 2: valouuu_cut (3000 in chips) 
Seat 3: Paguéga (728 in chips) 
Seat 4: jcarlos.vale (10078 in chips) 
Seat 5: kensui (12468 in chips) 
Seat 6: Jek8235 (10573 in chips) 
Seat 7: Kickstand122 (4085 in chips) 
Seat 8: MaHoMaX 3554 (3348 in chips) 
Seat 9: Bobby Akselrod (7445 in chips) 
LRSANDIM: posts the ante 20
valouuu_cut: posts the ante 20
Paguéga: posts the ante 20
jcarlos.vale: posts the ante 20
kensui: posts the ante 20
Jek8235: posts the ante 20
Kickstand122: posts the ante 20
MaHoMaX 3554: posts the ante 20
Bobby Akselrod: posts the ante 20
jcarlos.vale: posts small blind 75
kensui: posts big blind 150
*** HOLE CARDS ***
Dealt to jcarlos.vale [4s 4c]
Jek8235: folds 
Kickstand122: folds 
MaHoMaX 3554: raises 150 to 300
Bobby Akselrod: folds 
LRSANDIM: folds 
valouuu_cut: folds 
Paguéga: raises 408 to 708 and is all-in
jcarlos.vale: folds 
kensui: folds 
MaHoMaX 3554: calls 408
*** FLOP *** [Jd 8d 5s]
*** TURN *** [Jd 8d 5s] [Js]
*** RIVER *** [Jd 8d 5s Js] [7c]
*** SHOW DOWN ***
MaHoMaX 3554: shows [4d Ah] (a pair of Jacks)
Paguéga: shows [Kd Td] (a pair of Jacks - lower kicker)
MaHoMaX 3554 collected 1821 from pot
Paguéga finished the tournament
*** SUMMARY ***
Total pot 1821 | Rake 0 
Board [Jd 8d 5s Js 7c]
Seat 1: LRSANDIM folded before Flop (didn't bet)
Seat 2: valouuu_cut folded before Flop (didn't bet)
Seat 3: Paguéga (button) showed [Kd Td] and lost with a pair of Jacks
Seat 4: jcarlos.vale (small blind) folded before Flop
Seat 5: kensui (big blind) folded before Flop
Seat 6: Jek8235 folded before Flop (didn't bet)
Seat 7: Kickstand122 folded before Flop (didn't bet)
Seat 8: MaHoMaX 3554 showed [4d Ah] and won (1821) with a pair of Jacks
Seat 9: Bobby Akselrod folded before Flop (didn't bet)



PokerStars Hand #221901713703: Tournament #3082657132, $0.98+$0.12 USD Hold'em No Limit - Level VIII (75/150) - 2020/12/27 17:35:47 EET [2020/12/27 10:35:47 ET]
Table '3082657132 62' 9-max Seat #4 is the button
Seat 1: LRSANDIM (7285 in chips) 
Seat 2: valouuu_cut (2980 in chips) 
Seat 4: jcarlos.vale (9983 in chips) 
Seat 5: kensui (12298 in chips) 
Seat 6: Jek8235 (10553 in chips) 
Seat 7: Kickstand122 (4065 in chips) 
Seat 8: MaHoMaX 3554 (4441 in chips) 
Seat 9: Bobby Akselrod (7425 in chips) 
LRSANDIM: posts the ante 20
valouuu_cut: posts the ante 20
jcarlos.vale: posts the ante 20
kensui: posts the ante 20
Jek8235: posts the ante 20
Kickstand122: posts the ante 20
MaHoMaX 3554: posts the ante 20
Bobby Akselrod: posts the ante 20
kensui: posts small blind 75
Jek8235: posts big blind 150
*** HOLE CARDS ***
Dealt to jcarlos.vale [7d Qc]
Kickstand122: raises 150 to 300
MaHoMaX 3554: folds 
Bobby Akselrod: folds 
LRSANDIM: folds 
valouuu_cut: folds 
jcarlos.vale: folds 
kensui: folds 
Jek8235: folds 
Uncalled bet (150) returned to Kickstand122
Kickstand122 collected 535 from pot
*** SUMMARY ***
Total pot 535 | Rake 0 
Seat 1: LRSANDIM folded before Flop (didn't bet)
Seat 2: valouuu_cut folded before Flop (didn't bet)
Seat 4: jcarlos.vale (button) folded before Flop (didn't bet)
Seat 5: kensui (small blind) folded before Flop
Seat 6: Jek8235 (big blind) folded before Flop
Seat 7: Kickstand122 collected (535)
Seat 8: MaHoMaX 3554 folded before Flop (didn't bet)
Seat 9: Bobby Akselrod folded before Flop (didn't bet)



PokerStars Hand #221901730122: Tournament #3082657132, $0.98+$0.12 USD Hold'em No Limit - Level VIII (75/150) - 2020/12/27 17:36:14 EET [2020/12/27 10:36:14 ET]
Table '3082657132 62' 9-max Seat #5 is the button
Seat 1: LRSANDIM (7265 in chips) 
Seat 2: valouuu_cut (2960 in chips) 
Seat 3: Pringels24 (3000 in chips) 
Seat 4: jcarlos.vale (9963 in chips) 
Seat 5: kensui (12203 in chips) 
Seat 6: Jek8235 (10383 in chips) 
Seat 7: Kickstand122 (4430 in chips) 
Seat 8: MaHoMaX 3554 (4421 in chips) 
Seat 9: Bobby Akselrod (7405 in chips) 
LRSANDIM: posts the ante 20
valouuu_cut: posts the ante 20
Pringels24: posts the ante 20
jcarlos.vale: posts the ante 20
kensui: posts the ante 20
Jek8235: posts the ante 20
Kickstand122: posts the ante 20
MaHoMaX 3554: posts the ante 20
Bobby Akselrod: posts the ante 20
Jek8235: posts small blind 75
Kickstand122: posts big blind 150
*** HOLE CARDS ***
Dealt to jcarlos.vale [Jh 9s]
MaHoMaX 3554: folds 
Bobby Akselrod: folds 
LRSANDIM: folds 
valouuu_cut: raises 150 to 300
Pringels24: folds 
jcarlos.vale: folds 
kensui: calls 300
Jek8235: folds 
Kickstand122: calls 150
*** FLOP *** [6h 3s 8h]
Kickstand122: checks 
valouuu_cut: bets 381
kensui: folds 
Kickstand122: calls 381
*** TURN *** [6h 3s 8h] [9c]
Kickstand122: checks 
valouuu_cut: checks 
*** RIVER *** [6h 3s 8h 9c] [6c]
Kickstand122: checks 
valouuu_cut: checks 
*** SHOW DOWN ***
Kickstand122: shows [As Td] (a pair of Sixes)
valouuu_cut: shows [Ad Qh] (a pair of Sixes - Ace+Queen kicker)
valouuu_cut collected 1917 from pot
*** SUMMARY ***
Total pot 1917 | Rake 0 
Board [6h 3s 8h 9c 6c]
Seat 1: LRSANDIM folded before Flop (didn't bet)
Seat 2: valouuu_cut showed [Ad Qh] and won (1917) with a pair of Sixes
Seat 3: Pringels24 folded before Flop (didn't bet)
Seat 4: jcarlos.vale folded before Flop (didn't bet)
Seat 5: kensui (button) folded on the Flop
Seat 6: Jek8235 (small blind) folded before Flop
Seat 7: Kickstand122 (big blind) showed [As Td] and lost with a pair of Sixes
Seat 8: MaHoMaX 3554 folded before Flop (didn't bet)
Seat 9: Bobby Akselrod folded before Flop (didn't bet)



PokerStars Hand #221901760837: Tournament #3082657132, $0.98+$0.12 USD Hold'em No Limit - Level VIII (75/150) - 2020/12/27 17:37:04 EET [2020/12/27 10:37:04 ET]
Table '3082657132 62' 9-max Seat #6 is the button
Seat 1: LRSANDIM (7245 in chips) 
Seat 2: valouuu_cut (4176 in chips) 
Seat 3: Pringels24 (2980 in chips) 
Seat 4: jcarlos.vale (9943 in chips) 
Seat 5: kensui (11883 in chips) 
Seat 6: Jek8235 (10288 in chips) 
Seat 7: Kickstand122 (3729 in chips) 
Seat 8: MaHoMaX 3554 (4401 in chips) 
Seat 9: Bobby Akselrod (7385 in chips) 
LRSANDIM: posts the ante 20
valouuu_cut: posts the ante 20
Pringels24: posts the ante 20
jcarlos.vale: posts the ante 20
kensui: posts the ante 20
Jek8235: posts the ante 20
Kickstand122: posts the ante 20
MaHoMaX 3554: posts the ante 20
Bobby Akselrod: posts the ante 20
Kickstand122: posts small blind 75
MaHoMaX 3554: posts big blind 150
*** HOLE CARDS ***
Dealt to jcarlos.vale [4s Qc]
Bobby Akselrod: folds 
LRSANDIM: folds 
valouuu_cut: folds 
Pringels24: folds 
jcarlos.vale: folds 
kensui: folds 
Jek8235: folds 
Kickstand122: raises 150 to 300
MaHoMaX 3554: calls 150
*** FLOP *** [Th 5c 4c]
Kickstand122: bets 390
MaHoMaX 3554: calls 390
*** TURN *** [Th 5c 4c] [Td]
Kickstand122: bets 780
MaHoMaX 3554: raises 780 to 1560
Kickstand122: raises 1459 to 3019 and is all-in
MaHoMaX 3554: folds 
Uncalled bet (1459) returned to Kickstand122
Kickstand122 collected 4680 from pot
*** SUMMARY ***
Total pot 4680 | Rake 0 
Board [Th 5c 4c Td]
Seat 1: LRSANDIM folded before Flop (didn't bet)
Seat 2: valouuu_cut folded before Flop (didn't bet)
Seat 3: Pringels24 folded before Flop (didn't bet)
Seat 4: jcarlos.vale folded before Flop (didn't bet)
Seat 5: kensui folded before Flop (didn't bet)
Seat 6: Jek8235 (button) folded before Flop (didn't bet)
Seat 7: Kickstand122 (small blind) collected (4680)
Seat 8: MaHoMaX 3554 (big blind) folded on the Turn
Seat 9: Bobby Akselrod folded before Flop (didn't bet)



PokerStars Hand #221901790590: Tournament #3082657132, $0.98+$0.12 USD Hold'em No Limit - Level VIII (75/150) - 2020/12/27 17:37:51 EET [2020/12/27 10:37:51 ET]
Table '3082657132 62' 9-max Seat #7 is the button
Seat 1: LRSANDIM (7225 in chips) 
Seat 2: valouuu_cut (4156 in chips) 
Seat 3: Pringels24 (2960 in chips) 
Seat 4: jcarlos.vale (9923 in chips) 
Seat 5: kensui (11863 in chips) 
Seat 6: Jek8235 (10268 in chips) 
Seat 7: Kickstand122 (6139 in chips) 
Seat 8: MaHoMaX 3554 (2131 in chips) 
Seat 9: Bobby Akselrod (7365 in chips) 
LRSANDIM: posts the ante 20
valouuu_cut: posts the ante 20
Pringels24: posts the ante 20
jcarlos.vale: posts the ante 20
kensui: posts the ante 20
Jek8235: posts the ante 20
Kickstand122: posts the ante 20
MaHoMaX 3554: posts the ante 20
Bobby Akselrod: posts the ante 20
MaHoMaX 3554: posts small blind 75
Bobby Akselrod: posts big blind 150
*** HOLE CARDS ***
Dealt to jcarlos.vale [6c Jc]
LRSANDIM: folds 
valouuu_cut: folds 
Pringels24: folds 
jcarlos.vale: folds 
kensui: folds 
Jek8235: folds 
Kickstand122: raises 300 to 450
MaHoMaX 3554: folds 
Bobby Akselrod: raises 6895 to 7345 and is all-in
Kickstand122: folds 
Uncalled bet (6895) returned to Bobby Akselrod
Bobby Akselrod collected 1155 from pot
Bobby Akselrod: doesn't show handDTO
*** SUMMARY ***
Total pot 1155 | Rake 0 
Seat 1: LRSANDIM folded before Flop (didn't bet)
Seat 2: valouuu_cut folded before Flop (didn't bet)
Seat 3: Pringels24 folded before Flop (didn't bet)
Seat 4: jcarlos.vale folded before Flop (didn't bet)
Seat 5: kensui folded before Flop (didn't bet)
Seat 6: Jek8235 folded before Flop (didn't bet)
Seat 7: Kickstand122 (button) folded before Flop
Seat 8: MaHoMaX 3554 (small blind) folded before Flop
Seat 9: Bobby Akselrod (big blind) collected (1155)



PokerStars Hand #221901820132: Tournament #3082657132, $0.98+$0.12 USD Hold'em No Limit - Level VIII (75/150) - 2020/12/27 17:38:38 EET [2020/12/27 10:38:38 ET]
Table '3082657132 62' 9-max Seat #8 is the button
Seat 1: LRSANDIM (7205 in chips) 
Seat 2: valouuu_cut (4136 in chips) 
Seat 3: Pringels24 (2940 in chips) 
Seat 4: jcarlos.vale (9903 in chips) 
Seat 5: kensui (11843 in chips) 
Seat 6: Jek8235 (10248 in chips) 
Seat 7: Kickstand122 (5669 in chips) 
Seat 8: MaHoMaX 3554 (2036 in chips) 
Seat 9: Bobby Akselrod (8050 in chips) 
LRSANDIM: posts the ante 20
valouuu_cut: posts the ante 20
Pringels24: posts the ante 20
jcarlos.vale: posts the ante 20
kensui: posts the ante 20
Jek8235: posts the ante 20
Kickstand122: posts the ante 20
MaHoMaX 3554: posts the ante 20
Bobby Akselrod: posts the ante 20
Bobby Akselrod: posts small blind 75
LRSANDIM: posts big blind 150
*** HOLE CARDS ***
Dealt to jcarlos.vale [Jd 8s]
valouuu_cut: folds 
Pringels24: calls 150
jcarlos.vale: folds 
kensui: folds 
Jek8235: folds 
Kickstand122: folds 
MaHoMaX 3554: folds 
Bobby Akselrod: folds 
LRSANDIM: raises 750 to 900
Pringels24: calls 750
*** FLOP *** [Ac 7c Td]
LRSANDIM: checks 
Pringels24: checks 
*** TURN *** [Ac 7c Td] [Kd]
LRSANDIM: checks 
Pringels24: bets 150
LRSANDIM: calls 150
*** RIVER *** [Ac 7c Td Kd] [4d]
LRSANDIM: checks 
Pringels24: checks 
*** SHOW DOWN ***
LRSANDIM: shows [Qd Qs] (a pair of Queens)
Pringels24: shows [Ad 6s] (a pair of Aces)
Pringels24 collected 2355 from pot
*** SUMMARY ***
Total pot 2355 | Rake 0 
Board [Ac 7c Td Kd 4d]
Seat 1: LRSANDIM (big blind) showed [Qd Qs] and lost with a pair of Queens
Seat 2: valouuu_cut folded before Flop (didn't bet)
Seat 3: Pringels24 showed [Ad 6s] and won (2355) with a pair of Aces
Seat 4: jcarlos.vale folded before Flop (didn't bet)
Seat 5: kensui folded before Flop (didn't bet)
Seat 6: Jek8235 folded before Flop (didn't bet)
Seat 7: Kickstand122 folded before Flop (didn't bet)
Seat 8: MaHoMaX 3554 (button) folded before Flop (didn't bet)
Seat 9: Bobby Akselrod (small blind) folded before Flop



PokerStars Hand #221901864093: Tournament #3082657132, $0.98+$0.12 USD Hold'em No Limit - Level VIII (75/150) - 2020/12/27 17:39:49 EET [2020/12/27 10:39:49 ET]
Table '3082657132 62' 9-max Seat #9 is the button
Seat 1: LRSANDIM (6135 in chips) 
Seat 2: valouuu_cut (4116 in chips) 
Seat 3: Pringels24 (4225 in chips) 
Seat 4: jcarlos.vale (9883 in chips) 
Seat 5: kensui (11823 in chips) 
Seat 6: Jek8235 (10228 in chips) 
Seat 7: Kickstand122 (5649 in chips) 
Seat 8: MaHoMaX 3554 (2016 in chips) 
Seat 9: Bobby Akselrod (7955 in chips) 
LRSANDIM: posts the ante 20
valouuu_cut: posts the ante 20
Pringels24: posts the ante 20
jcarlos.vale: posts the ante 20
kensui: posts the ante 20
Jek8235: posts the ante 20
Kickstand122: posts the ante 20
MaHoMaX 3554: posts the ante 20
Bobby Akselrod: posts the ante 20
LRSANDIM: posts small blind 75
valouuu_cut: posts big blind 150
*** HOLE CARDS ***
Dealt to jcarlos.vale [8h 2c]
Pringels24: calls 150
jcarlos.vale: folds 
kensui: folds 
Jek8235: folds 
Kickstand122: raises 150 to 300
MaHoMaX 3554: folds 
Bobby Akselrod: folds 
LRSANDIM: folds 
valouuu_cut: calls 150
Pringels24: raises 3905 to 4205 and is all-in
Kickstand122: folds 
valouuu_cut: folds 
Uncalled bet (3905) returned to Pringels24
Pringels24 collected 1155 from pot
Pringels24: doesn't show handDTO
*** SUMMARY ***
Total pot 1155 | Rake 0 
Seat 1: LRSANDIM (small blind) folded before Flop
Seat 2: valouuu_cut (big blind) folded before Flop
Seat 3: Pringels24 collected (1155)
Seat 4: jcarlos.vale folded before Flop (didn't bet)
Seat 5: kensui folded before Flop (didn't bet)
Seat 6: Jek8235 folded before Flop (didn't bet)
Seat 7: Kickstand122 folded before Flop
Seat 8: MaHoMaX 3554 folded before Flop (didn't bet)
Seat 9: Bobby Akselrod (button) folded before Flop (didn't bet)



PokerStars Hand #221901900738: Tournament #3082657132, $0.98+$0.12 USD Hold'em No Limit - Level VIII (75/150) - 2020/12/27 17:40:48 EET [2020/12/27 10:40:48 ET]
Table '3082657132 62' 9-max Seat #1 is the button
Seat 1: LRSANDIM (6040 in chips) 
Seat 2: valouuu_cut (3796 in chips) 
Seat 3: Pringels24 (5060 in chips) 
Seat 4: jcarlos.vale (9863 in chips) 
Seat 5: kensui (11803 in chips) 
Seat 6: Jek8235 (10208 in chips) 
Seat 7: Kickstand122 (5329 in chips) 
Seat 8: MaHoMaX 3554 (1996 in chips) 
Seat 9: Bobby Akselrod (7935 in chips) 
LRSANDIM: posts the ante 20
valouuu_cut: posts the ante 20
Pringels24: posts the ante 20
jcarlos.vale: posts the ante 20
kensui: posts the ante 20
Jek8235: posts the ante 20
Kickstand122: posts the ante 20
MaHoMaX 3554: posts the ante 20
Bobby Akselrod: posts the ante 20
valouuu_cut: posts small blind 75
Pringels24: posts big blind 150
*** HOLE CARDS ***
Dealt to jcarlos.vale [7h Ah]
valouuu_cut said, "AA"
jcarlos.vale: folds 
kensui: raises 174 to 324
Jek8235: folds 
Kickstand122: folds 
MaHoMaX 3554: folds 
Bobby Akselrod: folds 
LRSANDIM: folds 
valouuu_cut said, "easy read"
valouuu_cut: folds 
Pringels24: calls 174
*** FLOP *** [9d Jh 7s]
Pringels24: checks 
kensui: checks 
*** TURN *** [9d Jh 7s] [Th]
Pringels24: bets 450
kensui: calls 450
*** RIVER *** [9d Jh 7s Th] [2d]
Pringels24: checks 
kensui: checks 
*** SHOW DOWN ***
Pringels24: shows [7c Jc] (two pair, Jacks and Sevens)
kensui: mucks handDTO
Pringels24 collected 1803 from pot
*** SUMMARY ***
Total pot 1803 | Rake 0 
Board [9d Jh 7s Th 2d]
Seat 1: LRSANDIM (button) folded before Flop (didn't bet)
Seat 2: valouuu_cut (small blind) folded before Flop
Seat 3: Pringels24 (big blind) showed [7c Jc] and won (1803) with two pair, Jacks and Sevens
Seat 4: jcarlos.vale folded before Flop (didn't bet)
Seat 5: kensui mucked [Ac Qh]
Seat 6: Jek8235 folded before Flop (didn't bet)
Seat 7: Kickstand122 folded before Flop (didn't bet)
Seat 8: MaHoMaX 3554 folded before Flop (didn't bet)
Seat 9: Bobby Akselrod folded before Flop (didn't bet)



PokerStars Hand #221901921349: Tournament #3082657132, $0.98+$0.12 USD Hold'em No Limit - Level VIII (75/150) - 2020/12/27 17:41:20 EET [2020/12/27 10:41:20 ET]
Table '3082657132 62' 9-max Seat #2 is the button
Seat 1: LRSANDIM (6020 in chips) 
Seat 2: valouuu_cut (3701 in chips) 
Seat 3: Pringels24 (6069 in chips) 
Seat 4: jcarlos.vale (9843 in chips) 
Seat 5: kensui (11009 in chips) 
Seat 6: Jek8235 (10188 in chips) 
Seat 7: Kickstand122 (5309 in chips) 
Seat 8: MaHoMaX 3554 (1976 in chips) 
Seat 9: Bobby Akselrod (7915 in chips) 
LRSANDIM: posts the ante 20
valouuu_cut: posts the ante 20
Pringels24: posts the ante 20
jcarlos.vale: posts the ante 20
kensui: posts the ante 20
Jek8235: posts the ante 20
Kickstand122: posts the ante 20
MaHoMaX 3554: posts the ante 20
Bobby Akselrod: posts the ante 20
Pringels24: posts small blind 75
jcarlos.vale: posts big blind 150
*** HOLE CARDS ***
Dealt to jcarlos.vale [Jc 8d]
kensui: folds 
Jek8235: folds 
Kickstand122: folds 
MaHoMaX 3554: folds 
Bobby Akselrod: folds 
LRSANDIM: folds 
valouuu_cut: raises 180 to 330
Pringels24: calls 255
jcarlos.vale: folds 
*** FLOP *** [Ah 5d 9h]
Pringels24: checks 
valouuu_cut: checks 
*** TURN *** [Ah 5d 9h] [2d]
Pringels24: bets 600
valouuu_cut: raises 2751 to 3351 and is all-in
Pringels24: calls 2751
*** RIVER *** [Ah 5d 9h 2d] [7c]
*** SHOW DOWN ***
Pringels24: shows [As Th] (a pair of Aces)
valouuu_cut: shows [9s Qs] (a pair of Nines)
Pringels24 collected 7692 from pot
valouuu_cut finished the tournament
*** SUMMARY ***
Total pot 7692 | Rake 0 
Board [Ah 5d 9h 2d 7c]
Seat 1: LRSANDIM folded before Flop (didn't bet)
Seat 2: valouuu_cut (button) showed [9s Qs] and lost with a pair of Nines
Seat 3: Pringels24 (small blind) showed [As Th] and won (7692) with a pair of Aces
Seat 4: jcarlos.vale (big blind) folded before Flop
Seat 5: kensui folded before Flop (didn't bet)
Seat 6: Jek8235 folded before Flop (didn't bet)
Seat 7: Kickstand122 folded before Flop (didn't bet)
Seat 8: MaHoMaX 3554 folded before Flop (didn't bet)
Seat 9: Bobby Akselrod folded before Flop (didn't bet)



PokerStars Hand #221901948368: Tournament #3082657132, $0.98+$0.12 USD Hold'em No Limit - Level VIII (75/150) - 2020/12/27 17:42:03 EET [2020/12/27 10:42:03 ET]
Table '3082657132 62' 9-max Seat #3 is the button
Seat 1: LRSANDIM (6000 in chips) 
Seat 3: Pringels24 (10060 in chips) 
Seat 4: jcarlos.vale (9673 in chips) 
Seat 5: kensui (10989 in chips) 
Seat 6: Jek8235 (10168 in chips) 
Seat 7: Kickstand122 (5289 in chips) 
Seat 8: MaHoMaX 3554 (1956 in chips) 
Seat 9: Bobby Akselrod (7895 in chips) 
LRSANDIM: posts the ante 20
Pringels24: posts the ante 20
jcarlos.vale: posts the ante 20
kensui: posts the ante 20
Jek8235: posts the ante 20
Kickstand122: posts the ante 20
MaHoMaX 3554: posts the ante 20
Bobby Akselrod: posts the ante 20
jcarlos.vale: posts small blind 75
kensui: posts big blind 150
*** HOLE CARDS ***
Dealt to jcarlos.vale [9c 8c]
Jek8235: folds 
Kickstand122: folds 
MaHoMaX 3554: folds 
Bobby Akselrod: folds 
LRSANDIM: raises 195 to 345
Pringels24: calls 345
jcarlos.vale: calls 270
kensui: calls 195
*** FLOP *** [4d Tc Jh]
jcarlos.vale: bets 300
kensui: folds 
LRSANDIM: calls 300
Pringels24: raises 9395 to 9695 and is all-in
jcarlos.vale: folds 
LRSANDIM: folds 
Uncalled bet (9395) returned to Pringels24
Pringels24 collected 2440 from pot
Pringels24: doesn't show handDTO
*** SUMMARY ***
Total pot 2440 | Rake 0 
Board [4d Tc Jh]
Seat 1: LRSANDIM folded on the Flop
Seat 3: Pringels24 (button) collected (2440)
Seat 4: jcarlos.vale (small blind) folded on the Flop
Seat 5: kensui (big blind) folded on the Flop
Seat 6: Jek8235 folded before Flop (didn't bet)
Seat 7: Kickstand122 folded before Flop (didn't bet)
Seat 8: MaHoMaX 3554 folded before Flop (didn't bet)
Seat 9: Bobby Akselrod folded before Flop (didn't bet)



PokerStars Hand #221901991218: Tournament #3082657132, $0.98+$0.12 USD Hold'em No Limit - Level IX (100/200) - 2020/12/27 17:43:12 EET [2020/12/27 10:43:12 ET]
Table '3082657132 62' 9-max Seat #4 is the button
Seat 1: LRSANDIM (5335 in chips) 
Seat 2: feeynico (3000 in chips) 
Seat 3: Pringels24 (11835 in chips) 
Seat 4: jcarlos.vale (9008 in chips) 
Seat 5: kensui (10624 in chips) 
Seat 6: Jek8235 (10148 in chips) 
Seat 7: Kickstand122 (5269 in chips) 
Seat 8: MaHoMaX 3554 (1936 in chips) 
Seat 9: Bobby Akselrod (7875 in chips) 
LRSANDIM: posts the ante 25
feeynico: posts the ante 25
Pringels24: posts the ante 25
jcarlos.vale: posts the ante 25
kensui: posts the ante 25
Jek8235: posts the ante 25
Kickstand122: posts the ante 25
MaHoMaX 3554: posts the ante 25
Bobby Akselrod: posts the ante 25
kensui: posts small blind 100
Jek8235: posts big blind 200
*** HOLE CARDS ***
Dealt to jcarlos.vale [Ks Jd]
Kickstand122: folds 
MaHoMaX 3554: raises 1711 to 1911 and is all-in
Bobby Akselrod: folds 
LRSANDIM: folds 
feeynico: folds 
Pringels24: folds 
jcarlos.vale: folds 
kensui: folds 
Jek8235: folds 
Uncalled bet (1711) returned to MaHoMaX 3554
MaHoMaX 3554 collected 725 from pot
MaHoMaX 3554: doesn't show handDTO
*** SUMMARY ***
Total pot 725 | Rake 0 
Seat 1: LRSANDIM folded before Flop (didn't bet)
Seat 2: feeynico folded before Flop (didn't bet)
Seat 3: Pringels24 folded before Flop (didn't bet)
Seat 4: jcarlos.vale (button) folded before Flop (didn't bet)
Seat 5: kensui (small blind) folded before Flop
Seat 6: Jek8235 (big blind) folded before Flop
Seat 7: Kickstand122 folded before Flop (didn't bet)
Seat 8: MaHoMaX 3554 collected (725)
Seat 9: Bobby Akselrod folded before Flop (didn't bet)



PokerStars Hand #221902007649: Tournament #3082657132, $0.98+$0.12 USD Hold'em No Limit - Level IX (100/200) - 2020/12/27 17:43:38 EET [2020/12/27 10:43:38 ET]
Table '3082657132 62' 9-max Seat #5 is the button
Seat 1: LRSANDIM (5310 in chips) 
Seat 2: feeynico (2975 in chips) 
Seat 3: Pringels24 (11810 in chips) 
Seat 4: jcarlos.vale (8983 in chips) 
Seat 5: kensui (10499 in chips) 
Seat 6: Jek8235 (9923 in chips) 
Seat 7: Kickstand122 (5244 in chips) 
Seat 8: MaHoMaX 3554 (2436 in chips) 
Seat 9: Bobby Akselrod (7850 in chips) 
LRSANDIM: posts the ante 25
feeynico: posts the ante 25
Pringels24: posts the ante 25
jcarlos.vale: posts the ante 25
kensui: posts the ante 25
Jek8235: posts the ante 25
Kickstand122: posts the ante 25
MaHoMaX 3554: posts the ante 25
Bobby Akselrod: posts the ante 25
Jek8235: posts small blind 100
Kickstand122: posts big blind 200
*** HOLE CARDS ***
Dealt to jcarlos.vale [5h 5c]
MaHoMaX 3554: folds 
Bobby Akselrod: folds 
LRSANDIM: folds 
feeynico: folds 
Pringels24: folds 
jcarlos.vale: raises 320 to 520
kensui: calls 520
Jek8235: folds 
Kickstand122: folds 
*** FLOP *** [8d 5d Ac]
jcarlos.vale: bets 1174
kensui: folds 
Uncalled bet (1174) returned to jcarlos.vale
jcarlos.vale collected 1565 from pot
jcarlos.vale: doesn't show handDTO
*** SUMMARY ***
Total pot 1565 | Rake 0 
Board [8d 5d Ac]
Seat 1: LRSANDIM folded before Flop (didn't bet)
Seat 2: feeynico folded before Flop (didn't bet)
Seat 3: Pringels24 folded before Flop (didn't bet)
Seat 4: jcarlos.vale collected (1565)
Seat 5: kensui (button) folded on the Flop
Seat 6: Jek8235 (small blind) folded before Flop
Seat 7: Kickstand122 (big blind) folded before Flop
Seat 8: MaHoMaX 3554 folded before Flop (didn't bet)
Seat 9: Bobby Akselrod folded before Flop (didn't bet)



PokerStars Hand #221902030596: Tournament #3082657132, $0.98+$0.12 USD Hold'em No Limit - Level IX (100/200) - 2020/12/27 17:44:14 EET [2020/12/27 10:44:14 ET]
Table '3082657132 62' 9-max Seat #6 is the button
Seat 1: LRSANDIM (5285 in chips) 
Seat 2: feeynico (2950 in chips) 
Seat 3: Pringels24 (11785 in chips) 
Seat 4: jcarlos.vale (10003 in chips) 
Seat 5: kensui (9954 in chips) 
Seat 6: Jek8235 (9798 in chips) 
Seat 7: Kickstand122 (5019 in chips) 
Seat 8: MaHoMaX 3554 (2411 in chips) 
Seat 9: Bobby Akselrod (7825 in chips) 
LRSANDIM: posts the ante 25
feeynico: posts the ante 25
Pringels24: posts the ante 25
jcarlos.vale: posts the ante 25
kensui: posts the ante 25
Jek8235: posts the ante 25
Kickstand122: posts the ante 25
MaHoMaX 3554: posts the ante 25
Bobby Akselrod: posts the ante 25
Kickstand122: posts small blind 100
MaHoMaX 3554: posts big blind 200
*** HOLE CARDS ***
Dealt to jcarlos.vale [Qc Js]
Bobby Akselrod: folds 
LRSANDIM: folds 
feeynico: folds 
Pringels24: raises 200 to 400
jcarlos.vale: folds 
kensui: folds 
Jek8235: folds 
Kickstand122: calls 300
MaHoMaX 3554: raises 1986 to 2386 and is all-in
Pringels24: calls 1986
Kickstand122: folds 
*** FLOP *** [6s Kh 5h]
*** TURN *** [6s Kh 5h] [Jd]
*** RIVER *** [6s Kh 5h Jd] [5d]
*** SHOW DOWN ***
MaHoMaX 3554: shows [As 2c] (a pair of Fives)
Pringels24: shows [9c Ac] (a pair of Fives)
MaHoMaX 3554 collected 2699 from pot
Pringels24 collected 2698 from pot
*** SUMMARY ***
Total pot 5397 | Rake 0 
Board [6s Kh 5h Jd 5d]
Seat 1: LRSANDIM folded before Flop (didn't bet)
Seat 2: feeynico folded before Flop (didn't bet)
Seat 3: Pringels24 showed [9c Ac] and won (2698) with a pair of Fives
Seat 4: jcarlos.vale folded before Flop (didn't bet)
Seat 5: kensui folded before Flop (didn't bet)
Seat 6: Jek8235 (button) folded before Flop (didn't bet)
Seat 7: Kickstand122 (small blind) folded before Flop
Seat 8: MaHoMaX 3554 (big blind) showed [As 2c] and won (2699) with a pair of Fives
Seat 9: Bobby Akselrod folded before Flop (didn't bet)



PokerStars Hand #221902058227: Tournament #3082657132, $0.98+$0.12 USD Hold'em No Limit - Level IX (100/200) - 2020/12/27 17:44:58 EET [2020/12/27 10:44:58 ET]
Table '3082657132 62' 9-max Seat #7 is the button
Seat 1: LRSANDIM (5260 in chips) 
Seat 2: feeynico (2925 in chips) 
Seat 3: Pringels24 (12072 in chips) 
Seat 4: jcarlos.vale (9978 in chips) 
Seat 5: kensui (9929 in chips) 
Seat 6: Jek8235 (9773 in chips) 
Seat 7: Kickstand122 (4594 in chips) 
Seat 8: MaHoMaX 3554 (2699 in chips) 
Seat 9: Bobby Akselrod (7800 in chips) 
LRSANDIM: posts the ante 25
feeynico: posts the ante 25
Pringels24: posts the ante 25
jcarlos.vale: posts the ante 25
kensui: posts the ante 25
Jek8235: posts the ante 25
Kickstand122: posts the ante 25
MaHoMaX 3554: posts the ante 25
Bobby Akselrod: posts the ante 25
MaHoMaX 3554: posts small blind 100
Bobby Akselrod: posts big blind 200
*** HOLE CARDS ***
Dealt to jcarlos.vale [3h Kc]
LRSANDIM: folds 
feeynico: folds 
Pringels24: folds 
jcarlos.vale: folds 
kensui: folds 
Jek8235: raises 200 to 400
Kickstand122: folds 
MaHoMaX 3554: raises 2274 to 2674 and is all-in
Bobby Akselrod: folds 
Jek8235: calls 2274
*** FLOP *** [2d Th Ks]
*** TURN *** [2d Th Ks] [Kh]
*** RIVER *** [2d Th Ks Kh] [7h]
*** SHOW DOWN ***
MaHoMaX 3554: shows [9h As] (a pair of Kings)
Jek8235: shows [Qh Jc] (a pair of Kings - lower kicker)
MaHoMaX 3554 collected 5773 from pot
*** SUMMARY ***
Total pot 5773 | Rake 0 
Board [2d Th Ks Kh 7h]
Seat 1: LRSANDIM folded before Flop (didn't bet)
Seat 2: feeynico folded before Flop (didn't bet)
Seat 3: Pringels24 folded before Flop (didn't bet)
Seat 4: jcarlos.vale folded before Flop (didn't bet)
Seat 5: kensui folded before Flop (didn't bet)
Seat 6: Jek8235 showed [Qh Jc] and lost with a pair of Kings
Seat 7: Kickstand122 (button) folded before Flop (didn't bet)
Seat 8: MaHoMaX 3554 (small blind) showed [9h As] and won (5773) with a pair of Kings
Seat 9: Bobby Akselrod (big blind) folded before Flop



PokerStars Hand #221902079082: Tournament #3082657132, $0.98+$0.12 USD Hold'em No Limit - Level IX (100/200) - 2020/12/27 17:45:31 EET [2020/12/27 10:45:31 ET]
Table '3082657132 62' 9-max Seat #8 is the button
Seat 1: LRSANDIM (5235 in chips) 
Seat 2: feeynico (2900 in chips) 
Seat 3: Pringels24 (12047 in chips) 
Seat 4: jcarlos.vale (9953 in chips) 
Seat 5: kensui (9904 in chips) 
Seat 6: Jek8235 (7074 in chips) 
Seat 7: Kickstand122 (4569 in chips) 
Seat 8: MaHoMaX 3554 (5773 in chips) 
Seat 9: Bobby Akselrod (7575 in chips) 
LRSANDIM: posts the ante 25
feeynico: posts the ante 25
Pringels24: posts the ante 25
jcarlos.vale: posts the ante 25
kensui: posts the ante 25
Jek8235: posts the ante 25
Kickstand122: posts the ante 25
MaHoMaX 3554: posts the ante 25
Bobby Akselrod: posts the ante 25
Bobby Akselrod: posts small blind 100
LRSANDIM: posts big blind 200
*** HOLE CARDS ***
Dealt to jcarlos.vale [Kc 3c]
feeynico: folds 
Pringels24: calls 200
jcarlos.vale: folds 
kensui: calls 200
Jek8235: folds 
Kickstand122: folds 
MaHoMaX 3554: folds 
Bobby Akselrod: raises 400 to 600
LRSANDIM: folds 
Pringels24: calls 400
kensui: calls 400
*** FLOP *** [Jd 4h 2h]
Bobby Akselrod: checks 
Pringels24: bets 200
kensui: folds 
Bobby Akselrod: raises 1313 to 1513
Pringels24: calls 1313
*** TURN *** [Jd 4h 2h] [Qs]
Bobby Akselrod: checks 
Pringels24: checks 
*** RIVER *** [Jd 4h 2h Qs] [5d]
Bobby Akselrod: bets 2626
Pringels24: folds 
Uncalled bet (2626) returned to Bobby Akselrod
Bobby Akselrod collected 5251 from pot
Bobby Akselrod: doesn't show handDTO
*** SUMMARY ***
Total pot 5251 | Rake 0 
Board [Jd 4h 2h Qs 5d]
Seat 1: LRSANDIM (big blind) folded before Flop
Seat 2: feeynico folded before Flop (didn't bet)
Seat 3: Pringels24 folded on the River
Seat 4: jcarlos.vale folded before Flop (didn't bet)
Seat 5: kensui folded on the Flop
Seat 6: Jek8235 folded before Flop (didn't bet)
Seat 7: Kickstand122 folded before Flop (didn't bet)
Seat 8: MaHoMaX 3554 (button) folded before Flop (didn't bet)
Seat 9: Bobby Akselrod (small blind) collected (5251)



PokerStars Hand #221902134837: Tournament #3082657132, $0.98+$0.12 USD Hold'em No Limit - Level IX (100/200) - 2020/12/27 17:46:59 EET [2020/12/27 10:46:59 ET]
Table '3082657132 62' 9-max Seat #9 is the button
Seat 1: LRSANDIM (5010 in chips) 
Seat 2: feeynico (2875 in chips) 
Seat 3: Pringels24 (9909 in chips) 
Seat 4: jcarlos.vale (9928 in chips) 
Seat 5: kensui (9279 in chips) 
Seat 6: Jek8235 (7049 in chips) 
Seat 7: Kickstand122 (4544 in chips) 
Seat 8: MaHoMaX 3554 (5748 in chips) 
Seat 9: Bobby Akselrod (10688 in chips) 
LRSANDIM: posts the ante 25
feeynico: posts the ante 25
Pringels24: posts the ante 25
jcarlos.vale: posts the ante 25
kensui: posts the ante 25
Jek8235: posts the ante 25
Kickstand122: posts the ante 25
MaHoMaX 3554: posts the ante 25
Bobby Akselrod: posts the ante 25
LRSANDIM: posts small blind 100
feeynico: posts big blind 200
*** HOLE CARDS ***
Dealt to jcarlos.vale [9h Ah]
Pringels24: calls 200
jcarlos.vale: calls 200
kensui: folds 
Jek8235: folds 
Kickstand122: folds 
MaHoMaX 3554: folds 
Bobby Akselrod: raises 400 to 600
LRSANDIM: folds 
feeynico: folds 
Pringels24: calls 400
jcarlos.vale: folds 
*** FLOP *** [As Ac Jd]
Pringels24: checks 
Bobby Akselrod: bets 481
Pringels24: folds 
Uncalled bet (481) returned to Bobby Akselrod
Bobby Akselrod collected 1925 from pot
Bobby Akselrod: doesn't show handDTO
*** SUMMARY ***
Total pot 1925 | Rake 0 
Board [As Ac Jd]
Seat 1: LRSANDIM (small blind) folded before Flop
Seat 2: feeynico (big blind) folded before Flop
Seat 3: Pringels24 folded on the Flop
Seat 4: jcarlos.vale folded before Flop
Seat 5: kensui folded before Flop (didn't bet)
Seat 6: Jek8235 folded before Flop (didn't bet)
Seat 7: Kickstand122 folded before Flop (didn't bet)
Seat 8: MaHoMaX 3554 folded before Flop (didn't bet)
Seat 9: Bobby Akselrod (button) collected (1925)



PokerStars Hand #221902168462: Tournament #3082657132, $0.98+$0.12 USD Hold'em No Limit - Level IX (100/200) - 2020/12/27 17:47:51 EET [2020/12/27 10:47:51 ET]
Table '3082657132 62' 9-max Seat #1 is the button
Seat 1: LRSANDIM (4885 in chips) 
Seat 2: feeynico (2650 in chips) 
Seat 3: Pringels24 (9284 in chips) 
Seat 4: jcarlos.vale (9703 in chips) 
Seat 5: kensui (9254 in chips) 
Seat 6: Jek8235 (7024 in chips) 
Seat 7: Kickstand122 (4519 in chips) 
Seat 8: MaHoMaX 3554 (5723 in chips) 
Seat 9: Bobby Akselrod (11988 in chips) 
LRSANDIM: posts the ante 25
feeynico: posts the ante 25
Pringels24: posts the ante 25
jcarlos.vale: posts the ante 25
kensui: posts the ante 25
Jek8235: posts the ante 25
Kickstand122: posts the ante 25
MaHoMaX 3554: posts the ante 25
Bobby Akselrod: posts the ante 25
feeynico: posts small blind 100
Pringels24: posts big blind 200
*** HOLE CARDS ***
Dealt to jcarlos.vale [Kh 5h]
jcarlos.vale: folds 
kensui: folds 
Jek8235: folds 
Kickstand122: folds 
MaHoMaX 3554: folds 
Bobby Akselrod: folds 
LRSANDIM: raises 200 to 400
feeynico: calls 300
Pringels24: calls 200
*** FLOP *** [Td 2h Ts]
feeynico: checks 
Pringels24: bets 400
LRSANDIM: calls 400
feeynico: calls 400
*** TURN *** [Td 2h Ts] [Qd]
feeynico: checks 
Pringels24: checks 
LRSANDIM: checks 
*** RIVER *** [Td 2h Ts Qd] [6s]
feeynico: bets 940
Pringels24: calls 940
LRSANDIM: folds 
*** SHOW DOWN ***
feeynico: shows [Tc 9h] (three of a kind, Tens)
Pringels24: mucks handDTO
feeynico collected 4505 from pot
*** SUMMARY ***
Total pot 4505 | Rake 0 
Board [Td 2h Ts Qd 6s]
Seat 1: LRSANDIM (button) folded on the River
Seat 2: feeynico (small blind) showed [Tc 9h] and won (4505) with three of a kind, Tens
Seat 3: Pringels24 (big blind) mucked [6c Js]
Seat 4: jcarlos.vale folded before Flop (didn't bet)
Seat 5: kensui folded before Flop (didn't bet)
Seat 6: Jek8235 folded before Flop (didn't bet)
Seat 7: Kickstand122 folded before Flop (didn't bet)
Seat 8: MaHoMaX 3554 folded before Flop (didn't bet)
Seat 9: Bobby Akselrod folded before Flop (didn't bet)



PokerStars Hand #221902223450: Tournament #3082657132, $0.98+$0.12 USD Hold'em No Limit - Level IX (100/200) - 2020/12/27 17:49:18 EET [2020/12/27 10:49:18 ET]
Table '3082657132 62' 9-max Seat #2 is the button
Seat 1: LRSANDIM (4060 in chips) 
Seat 2: feeynico (5390 in chips) 
Seat 3: Pringels24 (7519 in chips) 
Seat 4: jcarlos.vale (9678 in chips) 
Seat 5: kensui (9229 in chips) 
Seat 6: Jek8235 (6999 in chips) 
Seat 7: Kickstand122 (4494 in chips) 
Seat 8: MaHoMaX 3554 (5698 in chips) 
Seat 9: Bobby Akselrod (11963 in chips) 
LRSANDIM: posts the ante 25
feeynico: posts the ante 25
Pringels24: posts the ante 25
jcarlos.vale: posts the ante 25
kensui: posts the ante 25
Jek8235: posts the ante 25
Kickstand122: posts the ante 25
MaHoMaX 3554: posts the ante 25
Bobby Akselrod: posts the ante 25
Pringels24: posts small blind 100
jcarlos.vale: posts big blind 200
*** HOLE CARDS ***
Dealt to jcarlos.vale [7c Qh]
kensui: folds 
Jek8235: folds 
Kickstand122: folds 
MaHoMaX 3554: folds 
Bobby Akselrod: folds 
LRSANDIM: folds 
feeynico: calls 200
Pringels24: calls 100
jcarlos.vale: checks 
*** FLOP *** [Td 4c 5h]
Pringels24: checks 
jcarlos.vale: checks 
feeynico: checks 
*** TURN *** [Td 4c 5h] [4h]
Pringels24: checks 
jcarlos.vale: checks 
feeynico: bets 223
Pringels24: folds 
jcarlos.vale: folds 
Uncalled bet (223) returned to feeynico
feeynico collected 825 from pot
feeynico: doesn't show handDTO
*** SUMMARY ***
Total pot 825 | Rake 0 
Board [Td 4c 5h 4h]
Seat 1: LRSANDIM folded before Flop (didn't bet)
Seat 2: feeynico (button) collected (825)
Seat 3: Pringels24 (small blind) folded on the Turn
Seat 4: jcarlos.vale (big blind) folded on the Turn
Seat 5: kensui folded before Flop (didn't bet)
Seat 6: Jek8235 folded before Flop (didn't bet)
Seat 7: Kickstand122 folded before Flop (didn't bet)
Seat 8: MaHoMaX 3554 folded before Flop (didn't bet)
Seat 9: Bobby Akselrod folded before Flop (didn't bet)



PokerStars Hand #221902259604: Tournament #3082657132, $0.98+$0.12 USD Hold'em No Limit - Level IX (100/200) - 2020/12/27 17:50:15 EET [2020/12/27 10:50:15 ET]
Table '3082657132 62' 9-max Seat #3 is the button
Seat 1: LRSANDIM (4035 in chips) 
Seat 3: Pringels24 (7294 in chips) 
Seat 4: jcarlos.vale (9453 in chips) 
Seat 5: kensui (9204 in chips) 
Seat 6: Jek8235 (6974 in chips) 
Seat 7: Kickstand122 (4469 in chips) 
Seat 8: MaHoMaX 3554 (5673 in chips) 
Seat 9: Bobby Akselrod (11938 in chips) 
LRSANDIM: posts the ante 25
Pringels24: posts the ante 25
jcarlos.vale: posts the ante 25
kensui: posts the ante 25
Jek8235: posts the ante 25
Kickstand122: posts the ante 25
MaHoMaX 3554: posts the ante 25
Bobby Akselrod: posts the ante 25
jcarlos.vale: posts small blind 100
kensui: posts big blind 200
*** HOLE CARDS ***
Dealt to jcarlos.vale [6c Qh]
Jek8235: folds 
Kickstand122: raises 4244 to 4444 and is all-in
MaHoMaX 3554: folds 
Bobby Akselrod: raises 7469 to 11913 and is all-in
LRSANDIM: folds 
Pringels24: folds 
jcarlos.vale: folds 
kensui: folds 
Uncalled bet (7469) returned to Bobby Akselrod
*** FLOP *** [6d 5s 4c]
*** TURN *** [6d 5s 4c] [2h]
*** RIVER *** [6d 5s 4c 2h] [8s]
*** SHOW DOWN ***
Kickstand122: shows [Td As] (high pairOfCards Ace)
Bobby Akselrod: shows [Qc Qd] (a pair of Queens)
Bobby Akselrod collected 9388 from pot
Kickstand122 finished the tournament
*** SUMMARY ***
Total pot 9388 | Rake 0 
Board [6d 5s 4c 2h 8s]
Seat 1: LRSANDIM folded before Flop (didn't bet)
Seat 3: Pringels24 (button) folded before Flop (didn't bet)
Seat 4: jcarlos.vale (small blind) folded before Flop
Seat 5: kensui (big blind) folded before Flop
Seat 6: Jek8235 folded before Flop (didn't bet)
Seat 7: Kickstand122 showed [Td As] and lost with high pairOfCards Ace
Seat 8: MaHoMaX 3554 folded before Flop (didn't bet)
Seat 9: Bobby Akselrod showed [Qc Qd] and won (9388) with a pair of Queens



PokerStars Hand #221902284116: Tournament #3082657132, $0.98+$0.12 USD Hold'em No Limit - Level IX (100/200) - 2020/12/27 17:50:54 EET [2020/12/27 10:50:54 ET]
Table '3082657132 62' 9-max Seat #4 is the button
Seat 1: LRSANDIM (4010 in chips) 
Seat 2: Ewen101 (3000 in chips) 
Seat 3: Pringels24 (7269 in chips) 
Seat 4: jcarlos.vale (9328 in chips) 
Seat 5: kensui (8979 in chips) 
Seat 6: Jek8235 (6949 in chips) 
Seat 8: MaHoMaX 3554 (5648 in chips) 
Seat 9: Bobby Akselrod (16857 in chips) 
LRSANDIM: posts the ante 25
Ewen101: posts the ante 25
Pringels24: posts the ante 25
jcarlos.vale: posts the ante 25
kensui: posts the ante 25
Jek8235: posts the ante 25
MaHoMaX 3554: posts the ante 25
Bobby Akselrod: posts the ante 25
kensui: posts small blind 100
Jek8235: posts big blind 200
*** HOLE CARDS ***
Dealt to jcarlos.vale [7d 5h]
MaHoMaX 3554: raises 200 to 400
Bobby Akselrod: calls 400
LRSANDIM: folds 
Ewen101: folds 
Pringels24: folds 
jcarlos.vale: folds 
kensui: folds 
Jek8235: folds 
*** FLOP *** [7c Ks 6c]
MaHoMaX 3554: checks 
Bobby Akselrod: bets 650
MaHoMaX 3554: calls 650
*** TURN *** [7c Ks 6c] [3s]
MaHoMaX 3554: checks 
Bobby Akselrod: bets 4600
MaHoMaX 3554: calls 4573 and is all-in
Uncalled bet (27) returned to Bobby Akselrod
*** RIVER *** [7c Ks 6c 3s] [8c]
*** SHOW DOWN ***
MaHoMaX 3554: shows [Kc 5s] (a pair of Kings)
Bobby Akselrod: shows [7s 7h] (three of a kind, Sevens)
Bobby Akselrod collected 11746 from pot
MaHoMaX 3554 finished the tournament
*** SUMMARY ***
Total pot 11746 | Rake 0 
Board [7c Ks 6c 3s 8c]
Seat 1: LRSANDIM folded before Flop (didn't bet)
Seat 2: Ewen101 folded before Flop (didn't bet)
Seat 3: Pringels24 folded before Flop (didn't bet)
Seat 4: jcarlos.vale (button) folded before Flop (didn't bet)
Seat 5: kensui (small blind) folded before Flop
Seat 6: Jek8235 (big blind) folded before Flop
Seat 8: MaHoMaX 3554 showed [Kc 5s] and lost with a pair of Kings
Seat 9: Bobby Akselrod showed [7s 7h] and won (11746) with three of a kind, Sevens



PokerStars Hand #221902324592: Tournament #3082657132, $0.98+$0.12 USD Hold'em No Limit - Level IX (100/200) - 2020/12/27 17:51:57 EET [2020/12/27 10:51:57 ET]
Table '3082657132 62' 9-max Seat #5 is the button
Seat 1: LRSANDIM (3985 in chips) 
Seat 2: Ewen101 (2975 in chips) 
Seat 3: Pringels24 (7244 in chips) 
Seat 4: jcarlos.vale (9303 in chips) 
Seat 5: kensui (8854 in chips) 
Seat 6: Jek8235 (6724 in chips) 
Seat 7: Moggel23 (8150 in chips) 
Seat 9: Bobby Akselrod (22955 in chips) 
LRSANDIM: posts the ante 25
Ewen101: posts the ante 25
Pringels24: posts the ante 25
jcarlos.vale: posts the ante 25
kensui: posts the ante 25
Jek8235: posts the ante 25
Moggel23: posts the ante 25
Bobby Akselrod: posts the ante 25
Jek8235: posts small blind 100
Moggel23: posts big blind 200
*** HOLE CARDS ***
Dealt to jcarlos.vale [Ac 5c]
Bobby Akselrod: folds 
LRSANDIM: folds 
Ewen101: raises 200 to 400
Pringels24: folds 
jcarlos.vale: calls 400
kensui: calls 400
Jek8235: folds 
Moggel23: folds 
*** FLOP *** [3s 5h Ad]
Ewen101: bets 2550 and is all-in
jcarlos.vale: calls 2550
kensui: folds 
*** TURN *** [3s 5h Ad] [3c]
*** RIVER *** [3s 5h Ad 3c] [2d]
*** SHOW DOWN ***
Ewen101: shows [Qc Kc] (a pair of Threes)
jcarlos.vale: shows [Ac 5c] (two pair, Aces and Fives)
jcarlos.vale collected 6800 from pot
Ewen101 finished the tournament
*** SUMMARY ***
Total pot 6800 | Rake 0 
Board [3s 5h Ad 3c 2d]
Seat 1: LRSANDIM folded before Flop (didn't bet)
Seat 2: Ewen101 showed [Qc Kc] and lost with a pair of Threes
Seat 3: Pringels24 folded before Flop (didn't bet)
Seat 4: jcarlos.vale showed [Ac 5c] and won (6800) with two pair, Aces and Fives
Seat 5: kensui (button) folded on the Flop
Seat 6: Jek8235 (small blind) folded before Flop
Seat 7: Moggel23 (big blind) folded before Flop
Seat 9: Bobby Akselrod folded before Flop (didn't bet)



PokerStars Hand #221902350134: Tournament #3082657132, $0.98+$0.12 USD Hold'em No Limit - Level X (125/250) - 2020/12/27 17:52:38 EET [2020/12/27 10:52:38 ET]
Table '3082657132 62' 9-max Seat #6 is the button
Seat 1: LRSANDIM (3960 in chips) 
Seat 2: Sativa Spades12 (3000 in chips) 
Seat 3: Pringels24 (7219 in chips) 
Seat 4: jcarlos.vale (13128 in chips) 
Seat 5: kensui (8429 in chips) 
Seat 6: Jek8235 (6599 in chips) 
Seat 7: Moggel23 (7925 in chips) 
Seat 9: Bobby Akselrod (22930 in chips) 
LRSANDIM: posts the ante 30
Sativa Spades12: posts the ante 30
Pringels24: posts the ante 30
jcarlos.vale: posts the ante 30
kensui: posts the ante 30
Jek8235: posts the ante 30
Moggel23: posts the ante 30
Bobby Akselrod: posts the ante 30
Moggel23: posts small blind 125
Bobby Akselrod: posts big blind 250
*** HOLE CARDS ***
Dealt to jcarlos.vale [Kd Ad]
LRSANDIM: folds 
Sativa Spades12: folds 
Pringels24: raises 250 to 500
jcarlos.vale: calls 500
kensui: folds 
Jek8235: folds 
Moggel23: folds 
Bobby Akselrod: folds 
*** FLOP *** [9d Jh 9s]
Pringels24: checks 
jcarlos.vale: checks 
*** TURN *** [9d Jh 9s] [5c]
Pringels24: bets 500
jcarlos.vale: folds 
Uncalled bet (500) returned to Pringels24
Pringels24 collected 1615 from pot
Pringels24: doesn't show handDTO
*** SUMMARY ***
Total pot 1615 | Rake 0 
Board [9d Jh 9s 5c]
Seat 1: LRSANDIM folded before Flop (didn't bet)
Seat 2: Sativa Spades12 folded before Flop (didn't bet)
Seat 3: Pringels24 collected (1615)
Seat 4: jcarlos.vale folded on the Turn
Seat 5: kensui folded before Flop (didn't bet)
Seat 6: Jek8235 (button) folded before Flop (didn't bet)
Seat 7: Moggel23 (small blind) folded before Flop
Seat 9: Bobby Akselrod (big blind) folded before Flop



PokerStars Hand #221902383008: Tournament #3082657132, $0.98+$0.12 USD Hold'em No Limit - Level X (125/250) - 2020/12/27 17:53:29 EET [2020/12/27 10:53:29 ET]
Table '3082657132 62' 9-max Seat #7 is the button
Seat 1: LRSANDIM (3930 in chips) 
Seat 2: Sativa Spades12 (2970 in chips) 
Seat 3: Pringels24 (8304 in chips) 
Seat 4: jcarlos.vale (12598 in chips) 
Seat 5: kensui (8399 in chips) 
Seat 6: Jek8235 (6569 in chips) 
Seat 7: Moggel23 (7770 in chips) 
Seat 8: leightonmcfc (3000 in chips) out of handDTO (moved from another table into small blind)
Seat 9: Bobby Akselrod (22650 in chips) 
leightonmcfc will be allowed to play after the button
LRSANDIM: posts the ante 30
Sativa Spades12: posts the ante 30
Pringels24: posts the ante 30
jcarlos.vale: posts the ante 30
kensui: posts the ante 30
Jek8235: posts the ante 30
Moggel23: posts the ante 30
Bobby Akselrod: posts the ante 30
Bobby Akselrod: posts small blind 125
LRSANDIM: posts big blind 250
*** HOLE CARDS ***
Dealt to jcarlos.vale [3s Th]
Sativa Spades12: raises 250 to 500
Pringels24: calls 500
jcarlos.vale: folds 
kensui: folds 
Jek8235: raises 6039 to 6539 and is all-in
Moggel23: folds 
Bobby Akselrod: folds 
LRSANDIM: folds 
Sativa Spades12: calls 2440 and is all-in
Pringels24: folds 
Uncalled bet (3599) returned to Jek8235
*** FLOP *** [Jd 4d 5h]
*** TURN *** [Jd 4d 5h] [Td]
*** RIVER *** [Jd 4d 5h Td] [Kh]
*** SHOW DOWN ***
Sativa Spades12: shows [Jh Ks] (two pair, Kings and Jacks)
Jek8235: shows [Qd As] (a straight, Ten to Ace)
Jek8235 collected 6995 from pot
Sativa Spades12 finished the tournament
*** SUMMARY ***
Total pot 6995 | Rake 0 
Board [Jd 4d 5h Td Kh]
Seat 1: LRSANDIM (big blind) folded before Flop
Seat 2: Sativa Spades12 showed [Jh Ks] and lost with two pair, Kings and Jacks
Seat 3: Pringels24 folded before Flop
Seat 4: jcarlos.vale folded before Flop (didn't bet)
Seat 5: kensui folded before Flop (didn't bet)
Seat 6: Jek8235 showed [Qd As] and won (6995) with a straight, Ten to Ace
Seat 7: Moggel23 (button) folded before Flop (didn't bet)
Seat 9: Bobby Akselrod (small blind) folded before Flop



PokerStars Hand #221902408611: Tournament #3082657132, $0.98+$0.12 USD Hold'em No Limit - Level X (125/250) - 2020/12/27 17:54:10 EET [2020/12/27 10:54:10 ET]
Table '3082657132 62' 9-max Seat #9 is the button
Seat 1: LRSANDIM (3650 in chips) 
Seat 3: Pringels24 (7774 in chips) 
Seat 4: jcarlos.vale (12568 in chips) 
Seat 5: kensui (8369 in chips) 
Seat 6: Jek8235 (10594 in chips) 
Seat 7: Moggel23 (7740 in chips) 
Seat 8: leightonmcfc (3000 in chips) 
Seat 9: Bobby Akselrod (22495 in chips) 
LRSANDIM: posts the ante 30
Pringels24: posts the ante 30
jcarlos.vale: posts the ante 30
kensui: posts the ante 30
Jek8235: posts the ante 30
Moggel23: posts the ante 30
leightonmcfc: posts the ante 30
Bobby Akselrod: posts the ante 30
LRSANDIM: posts small blind 125
Pringels24: posts big blind 250
*** HOLE CARDS ***
Dealt to jcarlos.vale [Kd 2h]
jcarlos.vale: folds 
kensui: raises 290 to 540
Jek8235: folds 
Moggel23: calls 540
leightonmcfc: calls 540
Bobby Akselrod: folds 
LRSANDIM: folds 
Pringels24: calls 290
*** FLOP *** [Td 7s Qh]
Pringels24: checks 
kensui: checks 
Moggel23: checks 
leightonmcfc: checks 
*** TURN *** [Td 7s Qh] [8h]
Pringels24: bets 750
kensui: calls 750
Moggel23: calls 750
leightonmcfc: calls 750
*** RIVER *** [Td 7s Qh 8h] [6c]
Pringels24: checks 
kensui: checks 
Moggel23: bets 5525
leightonmcfc: folds 
Pringels24: folds 
kensui: folds 
Uncalled bet (5525) returned to Moggel23
Moggel23 collected 5525 from pot
Moggel23: doesn't show handDTO
*** SUMMARY ***
Total pot 5525 | Rake 0 
Board [Td 7s Qh 8h 6c]
Seat 1: LRSANDIM (small blind) folded before Flop
Seat 3: Pringels24 (big blind) folded on the River
Seat 4: jcarlos.vale folded before Flop (didn't bet)
Seat 5: kensui folded on the River
Seat 6: Jek8235 folded before Flop (didn't bet)
Seat 7: Moggel23 collected (5525)
Seat 8: leightonmcfc folded on the River
Seat 9: Bobby Akselrod (button) folded before Flop (didn't bet)



PokerStars Hand #221902654362: Tournament #3082657132, $0.98+$0.12 USD Hold'em No Limit - Level X (125/250) - 2020/12/27 18:01:44 EET [2020/12/27 11:01:44 ET]
Table '3082657132 62' 9-max Seat #1 is the button
Seat 1: LRSANDIM (3495 in chips) 
Seat 2: flying waffles (3000 in chips) out of handDTO (moved from another table into small blind)
Seat 3: Pringels24 (6454 in chips) 
Seat 4: jcarlos.vale (12538 in chips) 
Seat 5: kensui (7049 in chips) 
Seat 6: Jek8235 (10564 in chips) 
Seat 7: Moggel23 (11945 in chips) 
Seat 8: leightonmcfc (1680 in chips) 
Seat 9: Bobby Akselrod (22465 in chips) 
flying waffles will be allowed to play after the button
LRSANDIM: posts the ante 30
Pringels24: posts the ante 30
jcarlos.vale: posts the ante 30
kensui: posts the ante 30
Jek8235: posts the ante 30
Moggel23: posts the ante 30
leightonmcfc: posts the ante 30
Bobby Akselrod: posts the ante 30
Pringels24: posts small blind 125
jcarlos.vale: posts big blind 250
*** HOLE CARDS ***
Dealt to jcarlos.vale [Js Ah]
kensui: folds 
Jek8235: folds 
Moggel23: folds 
leightonmcfc: folds 
Bobby Akselrod: folds 
LRSANDIM: raises 3215 to 3465 and is all-in
Pringels24: folds 
jcarlos.vale: calls 3215
*** FLOP *** [3s 9s 6c]
*** TURN *** [3s 9s 6c] [7s]
*** RIVER *** [3s 9s 6c 7s] [5h]
*** SHOW DOWN ***
jcarlos.vale: shows [Js Ah] (high pairOfCards Ace)
LRSANDIM: shows [Jh Th] (high pairOfCards Jack)
jcarlos.vale collected 7295 from pot
LRSANDIM finished the tournament in 1204th place
*** SUMMARY ***
Total pot 7295 | Rake 0 
Board [3s 9s 6c 7s 5h]
Seat 1: LRSANDIM (button) showed [Jh Th] and lost with high pairOfCards Jack
Seat 3: Pringels24 (small blind) folded before Flop
Seat 4: jcarlos.vale (big blind) showed [Js Ah] and won (7295) with high pairOfCards Ace
Seat 5: kensui folded before Flop (didn't bet)
Seat 6: Jek8235 folded before Flop (didn't bet)
Seat 7: Moggel23 folded before Flop (didn't bet)
Seat 8: leightonmcfc folded before Flop (didn't bet)
Seat 9: Bobby Akselrod folded before Flop (didn't bet)



PokerStars Hand #221902690393: Tournament #3082657132, $0.98+$0.12 USD Hold'em No Limit - Level X (125/250) - 2020/12/27 18:02:41 EET [2020/12/27 11:02:41 ET]
Table '3082657132 62' 9-max Seat #3 is the button
Seat 2: flying waffles (3000 in chips) 
Seat 3: Pringels24 (6299 in chips) 
Seat 4: jcarlos.vale (16338 in chips) 
Seat 5: kensui (7019 in chips) 
Seat 6: Jek8235 (10534 in chips) 
Seat 7: Moggel23 (11915 in chips) 
Seat 8: leightonmcfc (1650 in chips) 
Seat 9: Bobby Akselrod (22435 in chips) 
flying waffles: posts the ante 30
Pringels24: posts the ante 30
jcarlos.vale: posts the ante 30
kensui: posts the ante 30
Jek8235: posts the ante 30
Moggel23: posts the ante 30
leightonmcfc: posts the ante 30
Bobby Akselrod: posts the ante 30
jcarlos.vale: posts small blind 125
kensui: posts big blind 250
*** HOLE CARDS ***
Dealt to jcarlos.vale [Kc Ts]
Jek8235: folds 
Moggel23: calls 250
leightonmcfc: folds 
Bobby Akselrod: folds 
flying waffles: folds 
Pringels24: folds 
jcarlos.vale: calls 125
kensui: checks 
*** FLOP *** [4d 4c 8c]
jcarlos.vale: checks 
kensui: bets 495
Moggel23: folds 
jcarlos.vale: folds 
Uncalled bet (495) returned to kensui
kensui collected 990 from pot
kensui: doesn't show handDTO
*** SUMMARY ***
Total pot 990 | Rake 0 
Board [4d 4c 8c]
Seat 2: flying waffles folded before Flop (didn't bet)
Seat 3: Pringels24 (button) folded before Flop (didn't bet)
Seat 4: jcarlos.vale (small blind) folded on the Flop
Seat 5: kensui (big blind) collected (990)
Seat 6: Jek8235 folded before Flop (didn't bet)
Seat 7: Moggel23 folded on the Flop
Seat 8: leightonmcfc folded before Flop (didn't bet)
Seat 9: Bobby Akselrod folded before Flop (didn't bet)



PokerStars Hand #221902721477: Tournament #3082657132, $0.98+$0.12 USD Hold'em No Limit - Level X (125/250) - 2020/12/27 18:03:30 EET [2020/12/27 11:03:30 ET]
Table '3082657132 62' 9-max Seat #4 is the button
Seat 1: devrikis (3155 in chips) 
Seat 2: flying waffles (2970 in chips) 
Seat 3: Pringels24 (6269 in chips) 
Seat 4: jcarlos.vale (16058 in chips) 
Seat 5: kensui (7729 in chips) 
Seat 6: Jek8235 (10504 in chips) 
Seat 7: Moggel23 (11635 in chips) 
Seat 8: leightonmcfc (1620 in chips) 
Seat 9: Bobby Akselrod (22405 in chips) 
devrikis: posts the ante 30
flying waffles: posts the ante 30
Pringels24: posts the ante 30
jcarlos.vale: posts the ante 30
kensui: posts the ante 30
Jek8235: posts the ante 30
Moggel23: posts the ante 30
leightonmcfc: posts the ante 30
Bobby Akselrod: posts the ante 30
kensui: posts small blind 125
Jek8235: posts big blind 250
*** HOLE CARDS ***
Dealt to jcarlos.vale [Th 4c]
Moggel23: folds 
leightonmcfc: folds 
Bobby Akselrod: folds 
devrikis: folds 
flying waffles: folds 
Pringels24: folds 
jcarlos.vale: folds 
kensui: folds 
Uncalled bet (125) returned to Jek8235
Jek8235 collected 520 from pot
Jek8235: doesn't show handDTO
*** SUMMARY ***
Total pot 520 | Rake 0 
Seat 1: devrikis folded before Flop (didn't bet)
Seat 2: flying waffles folded before Flop (didn't bet)
Seat 3: Pringels24 folded before Flop (didn't bet)
Seat 4: jcarlos.vale (button) folded before Flop (didn't bet)
Seat 5: kensui (small blind) folded before Flop
Seat 6: Jek8235 (big blind) collected (520)
Seat 7: Moggel23 folded before Flop (didn't bet)
Seat 8: leightonmcfc folded before Flop (didn't bet)
Seat 9: Bobby Akselrod folded before Flop (didn't bet)



PokerStars Hand #221902739791: Tournament #3082657132, $0.98+$0.12 USD Hold'em No Limit - Level X (125/250) - 2020/12/27 18:03:58 EET [2020/12/27 11:03:58 ET]
Table '3082657132 62' 9-max Seat #5 is the button
Seat 1: devrikis (3125 in chips) 
Seat 2: flying waffles (2940 in chips) 
Seat 3: Pringels24 (6239 in chips) 
Seat 4: jcarlos.vale (16028 in chips) 
Seat 5: kensui (7574 in chips) 
Seat 6: Jek8235 (10869 in chips) 
Seat 7: Moggel23 (11605 in chips) 
Seat 8: leightonmcfc (1590 in chips) 
Seat 9: Bobby Akselrod (22375 in chips) 
devrikis: posts the ante 30
flying waffles: posts the ante 30
Pringels24: posts the ante 30
jcarlos.vale: posts the ante 30
kensui: posts the ante 30
Jek8235: posts the ante 30
Moggel23: posts the ante 30
leightonmcfc: posts the ante 30
Bobby Akselrod: posts the ante 30
Jek8235: posts small blind 125
Moggel23: posts big blind 250
*** HOLE CARDS ***
Dealt to jcarlos.vale [7d Jh]
leightonmcfc: raises 1310 to 1560 and is all-in
Bobby Akselrod: folds 
devrikis: folds 
flying waffles: folds 
Pringels24: folds 
jcarlos.vale: folds 
kensui: folds 
Jek8235: folds 
Moggel23: folds 
Uncalled bet (1310) returned to leightonmcfc
leightonmcfc collected 895 from pot
leightonmcfc: doesn't show handDTO
*** SUMMARY ***
Total pot 895 | Rake 0 
Seat 1: devrikis folded before Flop (didn't bet)
Seat 2: flying waffles folded before Flop (didn't bet)
Seat 3: Pringels24 folded before Flop (didn't bet)
Seat 4: jcarlos.vale folded before Flop (didn't bet)
Seat 5: kensui (button) folded before Flop (didn't bet)
Seat 6: Jek8235 (small blind) folded before Flop
Seat 7: Moggel23 (big blind) folded before Flop
Seat 8: leightonmcfc collected (895)
Seat 9: Bobby Akselrod folded before Flop (didn't bet)



PokerStars Hand #221902773799: Tournament #3082657132, $0.98+$0.12 USD Hold'em No Limit - Level X (125/250) - 2020/12/27 18:04:51 EET [2020/12/27 11:04:51 ET]
Table '3082657132 62' 9-max Seat #6 is the button
Seat 1: devrikis (3095 in chips) 
Seat 2: flying waffles (2910 in chips) 
Seat 3: Pringels24 (6209 in chips) 
Seat 4: jcarlos.vale (15998 in chips) 
Seat 5: kensui (7544 in chips) 
Seat 6: Jek8235 (10714 in chips) 
Seat 7: Moggel23 (11325 in chips) 
Seat 8: leightonmcfc (2205 in chips) 
Seat 9: Bobby Akselrod (22345 in chips) 
devrikis: posts the ante 30
flying waffles: posts the ante 30
Pringels24: posts the ante 30
jcarlos.vale: posts the ante 30
kensui: posts the ante 30
Jek8235: posts the ante 30
Moggel23: posts the ante 30
leightonmcfc: posts the ante 30
Bobby Akselrod: posts the ante 30
Moggel23: posts small blind 125
leightonmcfc: posts big blind 250
*** HOLE CARDS ***
Dealt to jcarlos.vale [Td 6h]
Bobby Akselrod: folds 
devrikis: folds 
flying waffles: folds 
Pringels24: folds 
jcarlos.vale: folds 
kensui: folds 
Jek8235: raises 250 to 500
Moggel23: folds 
leightonmcfc: calls 250
*** FLOP *** [3c Jh 3s]
leightonmcfc: checks 
Jek8235: bets 10184 and is all-in
leightonmcfc: folds 
Uncalled bet (10184) returned to Jek8235
Jek8235 collected 1395 from pot
Jek8235: doesn't show handDTO
*** SUMMARY ***
Total pot 1395 | Rake 0 
Board [3c Jh 3s]
Seat 1: devrikis folded before Flop (didn't bet)
Seat 2: flying waffles folded before Flop (didn't bet)
Seat 3: Pringels24 folded before Flop (didn't bet)
Seat 4: jcarlos.vale folded before Flop (didn't bet)
Seat 5: kensui folded before Flop (didn't bet)
Seat 6: Jek8235 (button) collected (1395)
Seat 7: Moggel23 (small blind) folded before Flop
Seat 8: leightonmcfc (big blind) folded on the Flop
Seat 9: Bobby Akselrod folded before Flop (didn't bet)



PokerStars Hand #221902817012: Tournament #3082657132, $0.98+$0.12 USD Hold'em No Limit - Level X (125/250) - 2020/12/27 18:05:53 EET [2020/12/27 11:05:53 ET]
Table '3082657132 62' 9-max Seat #7 is the button
Seat 1: devrikis (3065 in chips) 
Seat 2: flying waffles (2880 in chips) 
Seat 3: Pringels24 (6179 in chips) 
Seat 4: jcarlos.vale (15968 in chips) 
Seat 5: kensui (7514 in chips) 
Seat 6: Jek8235 (11579 in chips) 
Seat 7: Moggel23 (11170 in chips) 
Seat 8: leightonmcfc (1675 in chips) 
Seat 9: Bobby Akselrod (22315 in chips) 
devrikis: posts the ante 30
flying waffles: posts the ante 30
Pringels24: posts the ante 30
jcarlos.vale: posts the ante 30
kensui: posts the ante 30
Jek8235: posts the ante 30
Moggel23: posts the ante 30
leightonmcfc: posts the ante 30
Bobby Akselrod: posts the ante 30
leightonmcfc: posts small blind 125
Bobby Akselrod: posts big blind 250
*** HOLE CARDS ***
Dealt to jcarlos.vale [Qd 7c]
devrikis: folds 
flying waffles: calls 250
Pringels24: folds 
jcarlos.vale: folds 
kensui: folds 
Jek8235: folds 
Moggel23: folds 
leightonmcfc: calls 125
Bobby Akselrod: raises 22035 to 22285 and is all-in
flying waffles: folds 
leightonmcfc: calls 1395 and is all-in
Uncalled bet (20640) returned to Bobby Akselrod
*** FLOP *** [3d 6d 6h]
*** TURN *** [3d 6d 6h] [7h]
*** RIVER *** [3d 6d 6h 7h] [4d]
*** SHOW DOWN ***
leightonmcfc: shows [5h Kc] (a straight, Three to Seven)
Bobby Akselrod: shows [Ts Ks] (a pair of Sixes)
leightonmcfc collected 3810 from pot
*** SUMMARY ***
Total pot 3810 | Rake 0 
Board [3d 6d 6h 7h 4d]
Seat 1: devrikis folded before Flop (didn't bet)
Seat 2: flying waffles folded before Flop
Seat 3: Pringels24 folded before Flop (didn't bet)
Seat 4: jcarlos.vale folded before Flop (didn't bet)
Seat 5: kensui folded before Flop (didn't bet)
Seat 6: Jek8235 folded before Flop (didn't bet)
Seat 7: Moggel23 (button) folded before Flop (didn't bet)
Seat 8: leightonmcfc (small blind) showed [5h Kc] and won (3810) with a straight, Three to Seven
Seat 9: Bobby Akselrod (big blind) showed [Ts Ks] and lost with a pair of Sixes



PokerStars Hand #221902858605: Tournament #3082657132, $0.98+$0.12 USD Hold'em No Limit - Level X (125/250) - 2020/12/27 18:06:52 EET [2020/12/27 11:06:52 ET]
Table '3082657132 62' 9-max Seat #8 is the button
Seat 1: devrikis (3035 in chips) 
Seat 2: flying waffles (2600 in chips) 
Seat 3: Pringels24 (6149 in chips) 
Seat 4: jcarlos.vale (15938 in chips) 
Seat 5: kensui (7484 in chips) 
Seat 6: Jek8235 (11549 in chips) 
Seat 7: Moggel23 (11140 in chips) 
Seat 8: leightonmcfc (3810 in chips) 
Seat 9: Bobby Akselrod (20640 in chips) 
devrikis: posts the ante 30
flying waffles: posts the ante 30
Pringels24: posts the ante 30
jcarlos.vale: posts the ante 30
kensui: posts the ante 30
Jek8235: posts the ante 30
Moggel23: posts the ante 30
leightonmcfc: posts the ante 30
Bobby Akselrod: posts the ante 30
Bobby Akselrod: posts small blind 125
devrikis: posts big blind 250
*** HOLE CARDS ***
Dealt to jcarlos.vale [6h 4s]
flying waffles: folds 
Pringels24: calls 250
jcarlos.vale: folds 
kensui: calls 250
Jek8235: folds 
Moggel23: folds 
leightonmcfc: raises 3530 to 3780 and is all-in
Bobby Akselrod: folds 
devrikis: folds 
Pringels24: folds 
kensui: folds 
Uncalled bet (3530) returned to leightonmcfc
leightonmcfc collected 1395 from pot
leightonmcfc: doesn't show handDTO
*** SUMMARY ***
Total pot 1395 | Rake 0 
Seat 1: devrikis (big blind) folded before Flop
Seat 2: flying waffles folded before Flop (didn't bet)
Seat 3: Pringels24 folded before Flop
Seat 4: jcarlos.vale folded before Flop (didn't bet)
Seat 5: kensui folded before Flop
Seat 6: Jek8235 folded before Flop (didn't bet)
Seat 7: Moggel23 folded before Flop (didn't bet)
Seat 8: leightonmcfc (button) collected (1395)
Seat 9: Bobby Akselrod (small blind) folded before Flop



PokerStars Hand #221902898018: Tournament #3082657132, $0.98+$0.12 USD Hold'em No Limit - Level X (125/250) - 2020/12/27 18:07:48 EET [2020/12/27 11:07:48 ET]
Table '3082657132 62' 9-max Seat #9 is the button
Seat 1: devrikis (2755 in chips) 
Seat 2: flying waffles (2570 in chips) 
Seat 3: Pringels24 (5869 in chips) 
Seat 4: jcarlos.vale (15908 in chips) 
Seat 5: kensui (7204 in chips) 
Seat 6: Jek8235 (11519 in chips) 
Seat 7: Moggel23 (11110 in chips) 
Seat 8: leightonmcfc (4925 in chips) 
Seat 9: Bobby Akselrod (20485 in chips) 
devrikis: posts the ante 30
flying waffles: posts the ante 30
Pringels24: posts the ante 30
jcarlos.vale: posts the ante 30
kensui: posts the ante 30
Jek8235: posts the ante 30
Moggel23: posts the ante 30
leightonmcfc: posts the ante 30
Bobby Akselrod: posts the ante 30
devrikis: posts small blind 125
flying waffles: posts big blind 250
*** HOLE CARDS ***
Dealt to jcarlos.vale [5h 9d]
Pringels24: folds 
jcarlos.vale: folds 
kensui: folds 
Jek8235: folds 
Moggel23: calls 250
leightonmcfc: calls 250
Bobby Akselrod: raises 750 to 1000
devrikis: folds 
flying waffles: folds 
Moggel23: folds 
leightonmcfc: raises 3895 to 4895 and is all-in
Bobby Akselrod: folds 
Uncalled bet (3895) returned to leightonmcfc
leightonmcfc collected 2895 from pot
leightonmcfc: doesn't show handDTO
*** SUMMARY ***
Total pot 2895 | Rake 0 
Seat 1: devrikis (small blind) folded before Flop
Seat 2: flying waffles (big blind) folded before Flop
Seat 3: Pringels24 folded before Flop (didn't bet)
Seat 4: jcarlos.vale folded before Flop (didn't bet)
Seat 5: kensui folded before Flop (didn't bet)
Seat 6: Jek8235 folded before Flop (didn't bet)
Seat 7: Moggel23 folded before Flop
Seat 8: leightonmcfc collected (2895)
Seat 9: Bobby Akselrod (button) folded before Flop



PokerStars Hand #221902935586: Tournament #3082657132, $0.98+$0.12 USD Hold'em No Limit - Level X (125/250) - 2020/12/27 18:08:41 EET [2020/12/27 11:08:41 ET]
Table '3082657132 62' 9-max Seat #1 is the button
Seat 1: devrikis (2600 in chips) 
Seat 2: flying waffles (2290 in chips) 
Seat 3: Pringels24 (5839 in chips) 
Seat 4: jcarlos.vale (15878 in chips) 
Seat 5: kensui (7174 in chips) 
Seat 6: Jek8235 (11489 in chips) 
Seat 7: Moggel23 (10830 in chips) 
Seat 8: leightonmcfc (6790 in chips) 
Seat 9: Bobby Akselrod (19455 in chips) 
devrikis: posts the ante 30
flying waffles: posts the ante 30
Pringels24: posts the ante 30
jcarlos.vale: posts the ante 30
kensui: posts the ante 30
Jek8235: posts the ante 30
Moggel23: posts the ante 30
leightonmcfc: posts the ante 30
Bobby Akselrod: posts the ante 30
flying waffles: posts small blind 125
Pringels24: posts big blind 250
*** HOLE CARDS ***
Dealt to jcarlos.vale [9h 9c]
jcarlos.vale: raises 400 to 650
kensui: folds 
Jek8235: folds 
Moggel23: folds 
leightonmcfc: folds 
Bobby Akselrod: folds 
devrikis: folds 
flying waffles: folds 
Pringels24: calls 400
*** FLOP *** [5h As Td]
Pringels24: checks 
jcarlos.vale: bets 500
Pringels24: calls 500
*** TURN *** [5h As Td] [Jc]
Pringels24: checks 
jcarlos.vale: checks 
*** RIVER *** [5h As Td Jc] [6s]
Pringels24: checks 
jcarlos.vale: checks 
*** SHOW DOWN ***
Pringels24: shows [Ts 9d] (a pair of Tens)
jcarlos.vale: mucks handDTO
Pringels24 collected 2695 from pot
*** SUMMARY ***
Total pot 2695 | Rake 0 
Board [5h As Td Jc 6s]
Seat 1: devrikis (button) folded before Flop (didn't bet)
Seat 2: flying waffles (small blind) folded before Flop
Seat 3: Pringels24 (big blind) showed [Ts 9d] and won (2695) with a pair of Tens
Seat 4: jcarlos.vale mucked [9h 9c]
Seat 5: kensui folded before Flop (didn't bet)
Seat 6: Jek8235 folded before Flop (didn't bet)
Seat 7: Moggel23 folded before Flop (didn't bet)
Seat 8: leightonmcfc folded before Flop (didn't bet)
Seat 9: Bobby Akselrod folded before Flop (didn't bet)



PokerStars Hand #221902987180: Tournament #3082657132, $0.98+$0.12 USD Hold'em No Limit - Level XI (150/300) - 2020/12/27 18:09:54 EET [2020/12/27 11:09:54 ET]
Table '3082657132 62' 9-max Seat #2 is the button
Seat 1: devrikis (2570 in chips) 
Seat 2: flying waffles (2135 in chips) 
Seat 3: Pringels24 (7354 in chips) 
Seat 4: jcarlos.vale (14698 in chips) 
Seat 5: kensui (7144 in chips) 
Seat 6: Jek8235 (11459 in chips) 
Seat 7: Moggel23 (10800 in chips) 
Seat 8: leightonmcfc (6760 in chips) 
Seat 9: Bobby Akselrod (19425 in chips) 
devrikis: posts the ante 40
flying waffles: posts the ante 40
Pringels24: posts the ante 40
jcarlos.vale: posts the ante 40
kensui: posts the ante 40
Jek8235: posts the ante 40
Moggel23: posts the ante 40
leightonmcfc: posts the ante 40
Bobby Akselrod: posts the ante 40
Pringels24: posts small blind 150
jcarlos.vale: posts big blind 300
*** HOLE CARDS ***
Dealt to jcarlos.vale [Tc 2c]
kensui: folds 
Jek8235: folds 
Moggel23: folds 
leightonmcfc: raises 600 to 900
Bobby Akselrod: folds 
devrikis: folds 
flying waffles: folds 
Pringels24: folds 
jcarlos.vale: folds 
Uncalled bet (600) returned to leightonmcfc
leightonmcfc collected 1110 from pot
leightonmcfc: doesn't show handDTO
*** SUMMARY ***
Total pot 1110 | Rake 0 
Seat 1: devrikis folded before Flop (didn't bet)
Seat 2: flying waffles (button) folded before Flop (didn't bet)
Seat 3: Pringels24 (small blind) folded before Flop
Seat 4: jcarlos.vale (big blind) folded before Flop
Seat 5: kensui folded before Flop (didn't bet)
Seat 6: Jek8235 folded before Flop (didn't bet)
Seat 7: Moggel23 folded before Flop (didn't bet)
Seat 8: leightonmcfc collected (1110)
Seat 9: Bobby Akselrod folded before Flop (didn't bet)



PokerStars Hand #221903011965: Tournament #3082657132, $0.98+$0.12 USD Hold'em No Limit - Level XI (150/300) - 2020/12/27 18:10:28 EET [2020/12/27 11:10:28 ET]
Table '3082657132 62' 9-max Seat #3 is the button
Seat 1: devrikis (2530 in chips) 
Seat 2: flying waffles (2095 in chips) 
Seat 3: Pringels24 (7164 in chips) 
Seat 4: jcarlos.vale (14358 in chips) 
Seat 5: kensui (7104 in chips) 
Seat 6: Jek8235 (11419 in chips) 
Seat 7: Moggel23 (10760 in chips) 
Seat 8: leightonmcfc (7530 in chips) 
Seat 9: Bobby Akselrod (19385 in chips) 
devrikis: posts the ante 40
flying waffles: posts the ante 40
Pringels24: posts the ante 40
jcarlos.vale: posts the ante 40
kensui: posts the ante 40
Jek8235: posts the ante 40
Moggel23: posts the ante 40
leightonmcfc: posts the ante 40
Bobby Akselrod: posts the ante 40
jcarlos.vale: posts small blind 150
kensui: posts big blind 300
*** HOLE CARDS ***
Dealt to jcarlos.vale [Kc 4h]
Jek8235: folds 
Moggel23: calls 300
leightonmcfc: folds 
Bobby Akselrod: folds 
devrikis: folds 
flying waffles: calls 300
Pringels24: folds 
jcarlos.vale: calls 150
kensui: checks 
*** FLOP *** [Td Jd Qs]
jcarlos.vale: checks 
kensui: checks 
Moggel23: checks 
flying waffles: checks 
*** TURN *** [Td Jd Qs] [8h]
jcarlos.vale: checks 
kensui: bets 780
Moggel23: folds 
flying waffles: folds 
jcarlos.vale: folds 
Uncalled bet (780) returned to kensui
kensui collected 1560 from pot
kensui: doesn't show handDTO
*** SUMMARY ***
Total pot 1560 | Rake 0 
Board [Td Jd Qs 8h]
Seat 1: devrikis folded before Flop (didn't bet)
Seat 2: flying waffles folded on the Turn
Seat 3: Pringels24 (button) folded before Flop (didn't bet)
Seat 4: jcarlos.vale (small blind) folded on the Turn
Seat 5: kensui (big blind) collected (1560)
Seat 6: Jek8235 folded before Flop (didn't bet)
Seat 7: Moggel23 folded on the Turn
Seat 8: leightonmcfc folded before Flop (didn't bet)
Seat 9: Bobby Akselrod folded before Flop (didn't bet)



PokerStars Hand #221903067283: Tournament #3082657132, $0.98+$0.12 USD Hold'em No Limit - Level XI (150/300) - 2020/12/27 18:11:46 EET [2020/12/27 11:11:46 ET]
Table '3082657132 62' 9-max Seat #4 is the button
Seat 1: devrikis (2490 in chips) 
Seat 2: flying waffles (1755 in chips) 
Seat 3: Pringels24 (7124 in chips) 
Seat 4: jcarlos.vale (14018 in chips) 
Seat 5: kensui (8324 in chips) 
Seat 6: Jek8235 (11379 in chips) 
Seat 7: Moggel23 (10420 in chips) 
Seat 8: leightonmcfc (7490 in chips) 
Seat 9: Bobby Akselrod (19345 in chips) 
devrikis: posts the ante 40
flying waffles: posts the ante 40
Pringels24: posts the ante 40
jcarlos.vale: posts the ante 40
kensui: posts the ante 40
Jek8235: posts the ante 40
Moggel23: posts the ante 40
leightonmcfc: posts the ante 40
Bobby Akselrod: posts the ante 40
kensui: posts small blind 150
Jek8235: posts big blind 300
*** HOLE CARDS ***
Dealt to jcarlos.vale [2h 9h]
leightonmcfc is disconnected 
Moggel23: folds 
leightonmcfc: folds 
Bobby Akselrod: folds 
devrikis: folds 
flying waffles: calls 300
Pringels24: calls 300
jcarlos.vale: folds 
kensui: calls 150
Jek8235: checks 
*** FLOP *** [9d 3h 7h]
kensui: checks 
Jek8235: checks 
flying waffles: checks 
Pringels24: checks 
*** TURN *** [9d 3h 7h] [6h]
kensui: checks 
Jek8235: checks 
flying waffles: checks 
Pringels24: checks 
*** RIVER *** [9d 3h 7h 6h] [8s]
kensui: checks 
Jek8235: bets 450
flying waffles: folds 
Pringels24: folds 
kensui: calls 450
*** SHOW DOWN ***
Jek8235: shows [Jh 5d] (a straight, Five to Nine)
kensui: shows [Ts Kh] (a straight, Six to Ten)
kensui collected 2460 from pot
*** SUMMARY ***
Total pot 2460 | Rake 0 
Board [9d 3h 7h 6h 8s]
Seat 1: devrikis folded before Flop (didn't bet)
Seat 2: flying waffles folded on the River
Seat 3: Pringels24 folded on the River
Seat 4: jcarlos.vale (button) folded before Flop (didn't bet)
Seat 5: kensui (small blind) showed [Ts Kh] and won (2460) with a straight, Six to Ten
Seat 6: Jek8235 (big blind) showed [Jh 5d] and lost with a straight, Five to Nine
Seat 7: Moggel23 folded before Flop (didn't bet)
Seat 8: leightonmcfc folded before Flop (didn't bet)
Seat 9: Bobby Akselrod folded before Flop (didn't bet)



PokerStars Hand #221903122888: Tournament #3082657132, $0.98+$0.12 USD Hold'em No Limit - Level XI (150/300) - 2020/12/27 18:13:04 EET [2020/12/27 11:13:04 ET]
Table '3082657132 62' 9-max Seat #5 is the button
Seat 1: devrikis (2450 in chips) 
Seat 2: flying waffles (1415 in chips) 
Seat 3: Pringels24 (6784 in chips) 
Seat 4: jcarlos.vale (13978 in chips) 
Seat 5: kensui (9994 in chips) 
Seat 6: Jek8235 (10589 in chips) 
Seat 7: Moggel23 (10380 in chips) 
Seat 8: leightonmcfc (7450 in chips) 
Seat 9: Bobby Akselrod (19305 in chips) 
devrikis: posts the ante 40
flying waffles: posts the ante 40
Pringels24: posts the ante 40
jcarlos.vale: posts the ante 40
kensui: posts the ante 40
Jek8235: posts the ante 40
Moggel23: posts the ante 40
leightonmcfc: posts the ante 40
Bobby Akselrod: posts the ante 40
Jek8235: posts small blind 150
Moggel23: posts big blind 300
*** HOLE CARDS ***
Dealt to jcarlos.vale [8s Jd]
leightonmcfc: calls 300
Bobby Akselrod: folds 
devrikis: folds 
flying waffles: folds 
Pringels24: folds 
jcarlos.vale: folds 
kensui: calls 300
Jek8235: calls 150
Moggel23: checks 
*** FLOP *** [Td 8d 2h]
Jek8235: bets 600
Moggel23: folds 
leightonmcfc: folds 
kensui: folds 
Uncalled bet (600) returned to Jek8235
Jek8235 collected 1560 from pot
Jek8235: doesn't show handDTO
*** SUMMARY ***
Total pot 1560 | Rake 0 
Board [Td 8d 2h]
Seat 1: devrikis folded before Flop (didn't bet)
Seat 2: flying waffles folded before Flop (didn't bet)
Seat 3: Pringels24 folded before Flop (didn't bet)
Seat 4: jcarlos.vale folded before Flop (didn't bet)
Seat 5: kensui (button) folded on the Flop
Seat 6: Jek8235 (small blind) collected (1560)
Seat 7: Moggel23 (big blind) folded on the Flop
Seat 8: leightonmcfc folded on the Flop
Seat 9: Bobby Akselrod folded before Flop (didn't bet)



PokerStars Hand #221903152160: Tournament #3082657132, $0.98+$0.12 USD Hold'em No Limit - Level XI (150/300) - 2020/12/27 18:13:45 EET [2020/12/27 11:13:45 ET]
Table '3082657132 62' 9-max Seat #6 is the button
Seat 1: devrikis (2410 in chips) 
Seat 2: flying waffles (1375 in chips) 
Seat 3: Pringels24 (6744 in chips) 
Seat 4: jcarlos.vale (13938 in chips) 
Seat 5: kensui (9654 in chips) 
Seat 6: Jek8235 (11809 in chips) 
Seat 7: Moggel23 (10040 in chips) 
Seat 8: leightonmcfc (7110 in chips) 
Seat 9: Bobby Akselrod (19265 in chips) 
devrikis: posts the ante 40
flying waffles: posts the ante 40
Pringels24: posts the ante 40
jcarlos.vale: posts the ante 40
kensui: posts the ante 40
Jek8235: posts the ante 40
Moggel23: posts the ante 40
leightonmcfc: posts the ante 40
Bobby Akselrod: posts the ante 40
Moggel23: posts small blind 150
leightonmcfc: posts big blind 300
*** HOLE CARDS ***
Dealt to jcarlos.vale [Ad Ah]
Bobby Akselrod: folds 
devrikis: folds 
flying waffles: folds 
Pringels24: folds 
jcarlos.vale: raises 600 to 900
kensui: folds 
Jek8235: calls 900
Moggel23: folds 
leightonmcfc: calls 600
*** FLOP *** [3c 6s Kc]
leightonmcfc: checks 
jcarlos.vale: bets 2408
Jek8235: folds 
leightonmcfc: raises 3762 to 6170 and is all-in
jcarlos.vale: calls 3762
*** TURN *** [3c 6s Kc] [Ts]
*** RIVER *** [3c 6s Kc Ts] [4d]
*** SHOW DOWN ***
leightonmcfc: shows [5s Ks] (a pair of Kings)
jcarlos.vale: shows [Ad Ah] (a pair of Aces)
jcarlos.vale collected 15550 from pot
leightonmcfc finished the tournament in 880th place
*** SUMMARY ***
Total pot 15550 | Rake 0 
Board [3c 6s Kc Ts 4d]
Seat 1: devrikis folded before Flop (didn't bet)
Seat 2: flying waffles folded before Flop (didn't bet)
Seat 3: Pringels24 folded before Flop (didn't bet)
Seat 4: jcarlos.vale showed [Ad Ah] and won (15550) with a pair of Aces
Seat 5: kensui folded before Flop (didn't bet)
Seat 6: Jek8235 (button) folded on the Flop
Seat 7: Moggel23 (small blind) folded before Flop
Seat 8: leightonmcfc (big blind) showed [5s Ks] and lost with a pair of Kings
Seat 9: Bobby Akselrod folded before Flop (didn't bet)



PokerStars Hand #221903200424: Tournament #3082657132, $0.98+$0.12 USD Hold'em No Limit - Level XI (150/300) - 2020/12/27 18:14:53 EET [2020/12/27 11:14:53 ET]
Table '3082657132 62' 9-max Seat #7 is the button
Seat 1: devrikis (2370 in chips) 
Seat 2: flying waffles (1335 in chips) 
Seat 3: Pringels24 (6704 in chips) 
Seat 4: jcarlos.vale (22378 in chips) 
Seat 5: kensui (9614 in chips) 
Seat 6: Jek8235 (10869 in chips) 
Seat 7: Moggel23 (9850 in chips) 
Seat 9: Bobby Akselrod (19225 in chips) 
devrikis: posts the ante 40
flying waffles: posts the ante 40
Pringels24: posts the ante 40
jcarlos.vale: posts the ante 40
kensui: posts the ante 40
Jek8235: posts the ante 40
Moggel23: posts the ante 40
Bobby Akselrod: posts the ante 40
Bobby Akselrod: posts small blind 150
devrikis: posts big blind 300
*** HOLE CARDS ***
Dealt to jcarlos.vale [9d 6h]
flying waffles: calls 300
Pringels24: folds 
jcarlos.vale: folds 
kensui: folds 
Jek8235: folds 
Moggel23: folds 
Bobby Akselrod: raises 1200 to 1500
devrikis: raises 830 to 2330 and is all-in
flying waffles: calls 995 and is all-in
Bobby Akselrod: calls 830
*** FLOP *** [Ks Td 9s]
*** TURN *** [Ks Td 9s] [Tc]
*** RIVER *** [Ks Td 9s Tc] [Kd]
*** SHOW DOWN ***
Bobby Akselrod: shows [Kc As] (a full house, Kings full of Tens)
devrikis: shows [Ah Ac] (two pair, Aces and Kings)
Bobby Akselrod collected 2070 from side pot
flying waffles: shows [3s Js] (two pair, Kings and Tens)
Bobby Akselrod collected 4205 from main pot
devrikis finished the tournament in 860th place
flying waffles finished the tournament in 861st place
*** SUMMARY ***
Total pot 6275 Main pot 4205. Side pot 2070. | Rake 0 
Board [Ks Td 9s Tc Kd]
Seat 1: devrikis (big blind) showed [Ah Ac] and lost with two pair, Aces and Kings
Seat 2: flying waffles showed [3s Js] and lost with two pair, Kings and Tens
Seat 3: Pringels24 folded before Flop (didn't bet)
Seat 4: jcarlos.vale folded before Flop (didn't bet)
Seat 5: kensui folded before Flop (didn't bet)
Seat 6: Jek8235 folded before Flop (didn't bet)
Seat 7: Moggel23 (button) folded before Flop (didn't bet)
Seat 9: Bobby Akselrod (small blind) showed [Kc As] and won (6275) with a full house, Kings full of Tens



PokerStars Hand #221903238866: Tournament #3082657132, $0.98+$0.12 USD Hold'em No Limit - Level XI (150/300) - 2020/12/27 18:15:47 EET [2020/12/27 11:15:47 ET]
Table '3082657132 62' 9-max Seat #9 is the button
Seat 1: Ruslan5795 (20629 in chips) out of handDTO (moved from another table into small blind)
Seat 3: Pringels24 (6664 in chips) 
Seat 4: jcarlos.vale (22338 in chips) 
Seat 5: kensui (9574 in chips) 
Seat 6: Jek8235 (10829 in chips) 
Seat 7: Moggel23 (9810 in chips) 
Seat 8: Matzen10 (10012 in chips) 
Seat 9: Bobby Akselrod (23130 in chips) 
Ruslan5795 will be allowed to play after the button
Pringels24: posts the ante 40
jcarlos.vale: posts the ante 40
kensui: posts the ante 40
Jek8235: posts the ante 40
Moggel23: posts the ante 40
Matzen10: posts the ante 40
Bobby Akselrod: posts the ante 40
Pringels24: posts small blind 150
jcarlos.vale: posts big blind 300
*** HOLE CARDS ***
Dealt to jcarlos.vale [5h 8c]
kensui: folds 
Jek8235: folds 
Moggel23: folds 
Matzen10: folds 
Bobby Akselrod: raises 450 to 750
Pringels24: raises 5874 to 6624 and is all-in
jcarlos.vale: folds 
Bobby Akselrod: folds 
Uncalled bet (5874) returned to Pringels24
Pringels24 collected 2080 from pot
Pringels24: doesn't show handDTO
*** SUMMARY ***
Total pot 2080 | Rake 0 
Seat 3: Pringels24 (small blind) collected (2080)
Seat 4: jcarlos.vale (big blind) folded before Flop
Seat 5: kensui folded before Flop (didn't bet)
Seat 6: Jek8235 folded before Flop (didn't bet)
Seat 7: Moggel23 folded before Flop (didn't bet)
Seat 8: Matzen10 folded before Flop (didn't bet)
Seat 9: Bobby Akselrod (button) folded before Flop



PokerStars Hand #221903262684: Tournament #3082657132, $0.98+$0.12 USD Hold'em No Limit - Level XI (150/300) - 2020/12/27 18:16:20 EET [2020/12/27 11:16:20 ET]
Table '3082657132 62' 9-max Seat #3 is the button
Seat 1: Ruslan5795 (20629 in chips) 
Seat 2: liy731 (9347 in chips) 
Seat 3: Pringels24 (7954 in chips) 
Seat 4: jcarlos.vale (21998 in chips) 
Seat 5: kensui (9534 in chips) 
Seat 6: Jek8235 (10789 in chips) 
Seat 7: Moggel23 (9770 in chips) 
Seat 8: Matzen10 (9972 in chips) 
Seat 9: Bobby Akselrod (22340 in chips) 
Ruslan5795: posts the ante 40
liy731: posts the ante 40
Pringels24: posts the ante 40
jcarlos.vale: posts the ante 40
kensui: posts the ante 40
Jek8235: posts the ante 40
Moggel23: posts the ante 40
Matzen10: posts the ante 40
Bobby Akselrod: posts the ante 40
jcarlos.vale: posts small blind 150
kensui: posts big blind 300
*** HOLE CARDS ***
Dealt to jcarlos.vale [4h 7h]
Jek8235: raises 300 to 600
Moggel23: calls 600
Matzen10: folds 
Bobby Akselrod: calls 600
Ruslan5795: folds 
liy731: folds 
Pringels24: calls 600
jcarlos.vale: folds 
kensui: calls 300
*** FLOP *** [5h As Ts]
kensui: checks 
Jek8235: checks 
Moggel23: checks 
Bobby Akselrod: checks 
Pringels24: checks 
*** TURN *** [5h As Ts] [3c]
kensui: checks 
Jek8235: checks 
Moggel23: checks 
Bobby Akselrod: checks 
Pringels24: checks 
*** RIVER *** [5h As Ts 3c] [6d]
kensui: checks 
Jek8235: checks 
Moggel23: checks 
Bobby Akselrod: checks 
Pringels24: bets 2100
kensui: folds 
Jek8235: folds 
Moggel23: folds 
Bobby Akselrod: folds 
Uncalled bet (2100) returned to Pringels24
Pringels24 collected 3510 from pot
Pringels24: doesn't show handDTO
*** SUMMARY ***
Total pot 3510 | Rake 0 
Board [5h As Ts 3c 6d]
Seat 1: Ruslan5795 folded before Flop (didn't bet)
Seat 2: liy731 folded before Flop (didn't bet)
Seat 3: Pringels24 (button) collected (3510)
Seat 4: jcarlos.vale (small blind) folded before Flop
Seat 5: kensui (big blind) folded on the River
Seat 6: Jek8235 folded on the River
Seat 7: Moggel23 folded on the River
Seat 8: Matzen10 folded before Flop (didn't bet)
Seat 9: Bobby Akselrod folded on the River



PokerStars Hand #221903330772: Tournament #3082657132, $0.98+$0.12 USD Hold'em No Limit - Level XI (150/300) - 2020/12/27 18:17:54 EET [2020/12/27 11:17:54 ET]
Table '3082657132 62' 9-max Seat #4 is the button
Seat 1: Ruslan5795 (20589 in chips) 
Seat 2: liy731 (9307 in chips) 
Seat 3: Pringels24 (10824 in chips) 
Seat 4: jcarlos.vale (21808 in chips) 
Seat 5: kensui (8894 in chips) 
Seat 6: Jek8235 (10149 in chips) 
Seat 7: Moggel23 (9130 in chips) 
Seat 8: Matzen10 (9932 in chips) 
Seat 9: Bobby Akselrod (21700 in chips) 
Ruslan5795: posts the ante 40
liy731: posts the ante 40
Pringels24: posts the ante 40
jcarlos.vale: posts the ante 40
kensui: posts the ante 40
Jek8235: posts the ante 40
Moggel23: posts the ante 40
Matzen10: posts the ante 40
Bobby Akselrod: posts the ante 40
kensui: posts small blind 150
Jek8235: posts big blind 300
*** HOLE CARDS ***
Dealt to jcarlos.vale [5c 3h]
Moggel23: folds 
Matzen10: folds 
Bobby Akselrod: folds 
Ruslan5795: calls 300
liy731: folds 
Pringels24: folds 
jcarlos.vale: folds 
kensui: folds 
Jek8235: checks 
*** FLOP *** [9c 3c Kd]
Jek8235: checks 
Ruslan5795: checks 
*** TURN *** [9c 3c Kd] [7h]
Jek8235: bets 600
Ruslan5795: calls 600
*** RIVER *** [9c 3c Kd 7h] [Ad]
Jek8235: checks 
Ruslan5795: bets 2400
Jek8235: folds 
Uncalled bet (2400) returned to Ruslan5795
Ruslan5795 collected 2310 from pot
*** SUMMARY ***
Total pot 2310 | Rake 0 
Board [9c 3c Kd 7h Ad]
Seat 1: Ruslan5795 collected (2310)
Seat 2: liy731 folded before Flop (didn't bet)
Seat 3: Pringels24 folded before Flop (didn't bet)
Seat 4: jcarlos.vale (button) folded before Flop (didn't bet)
Seat 5: kensui (small blind) folded before Flop
Seat 6: Jek8235 (big blind) folded on the River
Seat 7: Moggel23 folded before Flop (didn't bet)
Seat 8: Matzen10 folded before Flop (didn't bet)
Seat 9: Bobby Akselrod folded before Flop (didn't bet)



PokerStars Hand #221903383701: Tournament #3082657132, $0.98+$0.12 USD Hold'em No Limit - Level XII (200/400) - 2020/12/27 18:19:07 EET [2020/12/27 11:19:07 ET]
Table '3082657132 62' 9-max Seat #5 is the button
Seat 1: Ruslan5795 (21959 in chips) 
Seat 2: liy731 (9267 in chips) 
Seat 3: Pringels24 (10784 in chips) 
Seat 4: jcarlos.vale (21768 in chips) 
Seat 5: kensui (8704 in chips) 
Seat 6: Jek8235 (9209 in chips) 
Seat 7: Moggel23 (9090 in chips) 
Seat 8: Matzen10 (9892 in chips) 
Seat 9: Bobby Akselrod (21660 in chips) 
Ruslan5795: posts the ante 50
liy731: posts the ante 50
Pringels24: posts the ante 50
jcarlos.vale: posts the ante 50
kensui: posts the ante 50
Jek8235: posts the ante 50
Moggel23: posts the ante 50
Matzen10: posts the ante 50
Bobby Akselrod: posts the ante 50
Jek8235: posts small blind 200
Moggel23: posts big blind 400
*** HOLE CARDS ***
Dealt to jcarlos.vale [6d 3h]
Matzen10: folds 
Bobby Akselrod: folds 
Ruslan5795: folds 
liy731: raises 600 to 1000
Pringels24: folds 
jcarlos.vale: folds 
kensui: folds 
Jek8235: folds 
Moggel23: folds 
Uncalled bet (600) returned to liy731
liy731 collected 1450 from pot
liy731: doesn't show handDTO
*** SUMMARY ***
Total pot 1450 | Rake 0 
Seat 1: Ruslan5795 folded before Flop (didn't bet)
Seat 2: liy731 collected (1450)
Seat 3: Pringels24 folded before Flop (didn't bet)
Seat 4: jcarlos.vale folded before Flop (didn't bet)
Seat 5: kensui (button) folded before Flop (didn't bet)
Seat 6: Jek8235 (small blind) folded before Flop
Seat 7: Moggel23 (big blind) folded before Flop
Seat 8: Matzen10 folded before Flop (didn't bet)
Seat 9: Bobby Akselrod folded before Flop (didn't bet)



PokerStars Hand #221903404858: Tournament #3082657132, $0.98+$0.12 USD Hold'em No Limit - Level XII (200/400) - 2020/12/27 18:19:36 EET [2020/12/27 11:19:36 ET]
Table '3082657132 62' 9-max Seat #6 is the button
Seat 1: Ruslan5795 (21909 in chips) 
Seat 2: liy731 (10267 in chips) 
Seat 3: Pringels24 (10734 in chips) 
Seat 4: jcarlos.vale (21718 in chips) 
Seat 5: kensui (8654 in chips) 
Seat 6: Jek8235 (8959 in chips) 
Seat 7: Moggel23 (8640 in chips) 
Seat 8: Matzen10 (9842 in chips) 
Seat 9: Bobby Akselrod (21610 in chips) 
Ruslan5795: posts the ante 50
liy731: posts the ante 50
Pringels24: posts the ante 50
jcarlos.vale: posts the ante 50
kensui: posts the ante 50
Jek8235: posts the ante 50
Moggel23: posts the ante 50
Matzen10: posts the ante 50
Bobby Akselrod: posts the ante 50
Moggel23: posts small blind 200
Matzen10: posts big blind 400
*** HOLE CARDS ***
Dealt to jcarlos.vale [4s Kh]
Bobby Akselrod: raises 800 to 1200
Ruslan5795 has timed out
Ruslan5795: folds 
Ruslan5795 is sitting out
liy731: folds 
Pringels24: calls 1200
jcarlos.vale: folds 
kensui: folds 
Ruslan5795 has returned
Jek8235: folds 
Moggel23: folds 
Matzen10: folds 
*** FLOP *** [2h 5c Ac]
Bobby Akselrod: bets 1725
Pringels24: calls 1725
*** TURN *** [2h 5c Ac] [2c]
Bobby Akselrod: checks 
Pringels24: checks 
*** RIVER *** [2h 5c Ac 2c] [5s]
Bobby Akselrod: bets 7800
Pringels24: calls 7759 and is all-in
Uncalled bet (41) returned to Bobby Akselrod
*** SHOW DOWN ***
Bobby Akselrod: shows [As Ah] (a full house, Aces full of Fives)
Pringels24: shows [9h 9s] (two pair, Nines and Fives)
Bobby Akselrod collected 22418 from pot
Pringels24 finished the tournament in 790th place
*** SUMMARY ***
Total pot 22418 | Rake 0 
Board [2h 5c Ac 2c 5s]
Seat 1: Ruslan5795 folded before Flop (didn't bet)
Seat 2: liy731 folded before Flop (didn't bet)
Seat 3: Pringels24 showed [9h 9s] and lost with two pair, Nines and Fives
Seat 4: jcarlos.vale folded before Flop (didn't bet)
Seat 5: kensui folded before Flop (didn't bet)
Seat 6: Jek8235 (button) folded before Flop (didn't bet)
Seat 7: Moggel23 (small blind) folded before Flop
Seat 8: Matzen10 (big blind) folded before Flop
Seat 9: Bobby Akselrod showed [As Ah] and won (22418) with a full house, Aces full of Fives



PokerStars Hand #221903446199: Tournament #3082657132, $0.98+$0.12 USD Hold'em No Limit - Level XII (200/400) - 2020/12/27 18:20:32 EET [2020/12/27 11:20:32 ET]
Table '3082657132 62' 9-max Seat #7 is the button
Seat 1: Ruslan5795 (21859 in chips) 
Seat 2: liy731 (10217 in chips) 
Seat 4: jcarlos.vale (21668 in chips) 
Seat 5: kensui (8604 in chips) 
Seat 6: Jek8235 (8909 in chips) 
Seat 7: Moggel23 (8390 in chips) 
Seat 8: Matzen10 (9392 in chips) 
Seat 9: Bobby Akselrod (33294 in chips) 
Ruslan5795: posts the ante 50
liy731: posts the ante 50
jcarlos.vale: posts the ante 50
kensui: posts the ante 50
Jek8235: posts the ante 50
Moggel23: posts the ante 50
Matzen10: posts the ante 50
Bobby Akselrod: posts the ante 50
Matzen10: posts small blind 200
Bobby Akselrod: posts big blind 400
*** HOLE CARDS ***
Dealt to jcarlos.vale [9s 2c]
Ruslan5795 has timed out
Ruslan5795: folds 
Ruslan5795 is sitting out
liy731: folds 
Ruslan5795 has returned
jcarlos.vale: folds 
kensui: folds 
Jek8235: folds 
Moggel23: folds 
Matzen10: calls 200
Bobby Akselrod: raises 800 to 1200
Matzen10: calls 800
*** FLOP *** [5s 7s 9c]
Matzen10: checks 
Bobby Akselrod: bets 700
Matzen10: calls 700
*** TURN *** [5s 7s 9c] [3h]
Matzen10: checks 
Bobby Akselrod: bets 1050
Matzen10: calls 1050
*** RIVER *** [5s 7s 9c 3h] [Jh]
Matzen10: checks 
Bobby Akselrod: checks 
*** SHOW DOWN ***
Matzen10: shows [9h Qh] (a pair of Nines)
Bobby Akselrod: mucks handDTO
Matzen10 collected 6300 from pot
*** SUMMARY ***
Total pot 6300 | Rake 0 
Board [5s 7s 9c 3h Jh]
Seat 1: Ruslan5795 folded before Flop (didn't bet)
Seat 2: liy731 folded before Flop (didn't bet)
Seat 4: jcarlos.vale folded before Flop (didn't bet)
Seat 5: kensui folded before Flop (didn't bet)
Seat 6: Jek8235 folded before Flop (didn't bet)
Seat 7: Moggel23 (button) folded before Flop (didn't bet)
Seat 8: Matzen10 (small blind) showed [9h Qh] and won (6300) with a pair of Nines
Seat 9: Bobby Akselrod (big blind) mucked [4h 5h]



PokerStars Hand #221903504614: Tournament #3082657132, $0.98+$0.12 USD Hold'em No Limit - Level XII (200/400) - 2020/12/27 18:21:52 EET [2020/12/27 11:21:52 ET]
Table '3082657132 62' 9-max Seat #8 is the button
Seat 1: Ruslan5795 (21809 in chips) 
Seat 2: liy731 (10167 in chips) 
Seat 3: Avmatos88 (6635 in chips) 
Seat 4: jcarlos.vale (21618 in chips) 
Seat 5: kensui (8554 in chips) 
Seat 6: Jek8235 (8859 in chips) 
Seat 7: Moggel23 (8340 in chips) 
Seat 8: Matzen10 (12692 in chips) 
Seat 9: Bobby Akselrod (30294 in chips) 
Ruslan5795: posts the ante 50
liy731: posts the ante 50
Avmatos88: posts the ante 50
jcarlos.vale: posts the ante 50
kensui: posts the ante 50
Jek8235: posts the ante 50
Moggel23: posts the ante 50
Matzen10: posts the ante 50
Bobby Akselrod: posts the ante 50
Bobby Akselrod: posts small blind 200
Ruslan5795: posts big blind 400
*** HOLE CARDS ***
Dealt to jcarlos.vale [5s 8d]
liy731: folds 
Avmatos88: folds 
jcarlos.vale: folds 
kensui: folds 
Jek8235: folds 
Moggel23: raises 1450 to 1850
Matzen10: folds 
Bobby Akselrod: folds 
Ruslan5795: calls 1450
*** FLOP *** [3h 7h Js]
Ruslan5795: checks 
Moggel23: bets 6440 and is all-in
Ruslan5795: folds 
Uncalled bet (6440) returned to Moggel23
Moggel23 collected 4350 from pot
Moggel23: doesn't show handDTO
*** SUMMARY ***
Total pot 4350 | Rake 0 
Board [3h 7h Js]
Seat 1: Ruslan5795 (big blind) folded on the Flop
Seat 2: liy731 folded before Flop (didn't bet)
Seat 3: Avmatos88 folded before Flop (didn't bet)
Seat 4: jcarlos.vale folded before Flop (didn't bet)
Seat 5: kensui folded before Flop (didn't bet)
Seat 6: Jek8235 folded before Flop (didn't bet)
Seat 7: Moggel23 collected (4350)
Seat 8: Matzen10 (button) folded before Flop (didn't bet)
Seat 9: Bobby Akselrod (small blind) folded before Flop



PokerStars Hand #221903542486: Tournament #3082657132, $0.98+$0.12 USD Hold'em No Limit - Level XII (200/400) - 2020/12/27 18:22:44 EET [2020/12/27 11:22:44 ET]
Table '3082657132 62' 9-max Seat #9 is the button
Seat 1: Ruslan5795 (19909 in chips) 
Seat 2: liy731 (10117 in chips) 
Seat 3: Avmatos88 (6585 in chips) 
Seat 4: jcarlos.vale (21568 in chips) 
Seat 5: kensui (8504 in chips) 
Seat 6: Jek8235 (8809 in chips) 
Seat 7: Moggel23 (10790 in chips) 
Seat 8: Matzen10 (12642 in chips) 
Seat 9: Bobby Akselrod (30044 in chips) 
Ruslan5795: posts the ante 50
liy731: posts the ante 50
Avmatos88: posts the ante 50
jcarlos.vale: posts the ante 50
kensui: posts the ante 50
Jek8235: posts the ante 50
Moggel23: posts the ante 50
Matzen10: posts the ante 50
Bobby Akselrod: posts the ante 50
Ruslan5795: posts small blind 200
liy731: posts big blind 400
*** HOLE CARDS ***
Dealt to jcarlos.vale [8h 7d]
Avmatos88: folds 
jcarlos.vale: folds 
kensui: folds 
Jek8235: folds 
Moggel23: raises 1450 to 1850
Matzen10: folds 
Bobby Akselrod: folds 
Ruslan5795: folds 
liy731: calls 1450
*** FLOP *** [9c Qh As]
liy731: checks 
Moggel23: bets 8890 and is all-in
liy731: folds 
Uncalled bet (8890) returned to Moggel23
Moggel23 collected 4350 from pot
Moggel23: doesn't show handDTO
*** SUMMARY ***
Total pot 4350 | Rake 0 
Board [9c Qh As]
Seat 1: Ruslan5795 (small blind) folded before Flop
Seat 2: liy731 (big blind) folded on the Flop
Seat 3: Avmatos88 folded before Flop (didn't bet)
Seat 4: jcarlos.vale folded before Flop (didn't bet)
Seat 5: kensui folded before Flop (didn't bet)
Seat 6: Jek8235 folded before Flop (didn't bet)
Seat 7: Moggel23 collected (4350)
Seat 8: Matzen10 folded before Flop (didn't bet)
Seat 9: Bobby Akselrod (button) folded before Flop (didn't bet)



PokerStars Hand #221903578329: Tournament #3082657132, $0.98+$0.12 USD Hold'em No Limit - Level XII (200/400) - 2020/12/27 18:23:33 EET [2020/12/27 11:23:33 ET]
Table '3082657132 62' 9-max Seat #1 is the button
Seat 1: Ruslan5795 (19659 in chips) 
Seat 2: liy731 (8217 in chips) 
Seat 3: Avmatos88 (6535 in chips) 
Seat 4: jcarlos.vale (21518 in chips) 
Seat 5: kensui (8454 in chips) 
Seat 7: Moggel23 (13240 in chips) 
Seat 8: Matzen10 (12592 in chips) 
Seat 9: Bobby Akselrod (29994 in chips) 
Ruslan5795: posts the ante 50
liy731: posts the ante 50
Avmatos88: posts the ante 50
jcarlos.vale: posts the ante 50
kensui: posts the ante 50
Moggel23: posts the ante 50
Matzen10: posts the ante 50
Bobby Akselrod: posts the ante 50
liy731: posts small blind 200
Avmatos88: posts big blind 400
*** HOLE CARDS ***
Dealt to jcarlos.vale [6s Qs]
jcarlos.vale: folds 
kensui: folds 
Moggel23: folds 
Matzen10: raises 400 to 800
Bobby Akselrod: folds 
Ruslan5795: folds 
liy731: folds 
Avmatos88: raises 5685 to 6485 and is all-in
Matzen10: folds 
Uncalled bet (5685) returned to Avmatos88
Avmatos88 collected 2200 from pot
Avmatos88: doesn't show handDTO
*** SUMMARY ***
Total pot 2200 | Rake 0 
Seat 1: Ruslan5795 (button) folded before Flop (didn't bet)
Seat 2: liy731 (small blind) folded before Flop
Seat 3: Avmatos88 (big blind) collected (2200)
Seat 4: jcarlos.vale folded before Flop (didn't bet)
Seat 5: kensui folded before Flop (didn't bet)
Seat 7: Moggel23 folded before Flop (didn't bet)
Seat 8: Matzen10 folded before Flop
Seat 9: Bobby Akselrod folded before Flop (didn't bet)



PokerStars Hand #221903600292: Tournament #3082657132, $0.98+$0.12 USD Hold'em No Limit - Level XII (200/400) - 2020/12/27 18:24:03 EET [2020/12/27 11:24:03 ET]
Table '3082657132 62' 9-max Seat #2 is the button
Seat 1: Ruslan5795 (19609 in chips) 
Seat 2: liy731 (7967 in chips) 
Seat 3: Avmatos88 (7885 in chips) 
Seat 4: jcarlos.vale (21468 in chips) 
Seat 5: kensui (8404 in chips) 
Seat 6: tusko8 (13798 in chips) 
Seat 7: Moggel23 (13190 in chips) 
Seat 8: Matzen10 (11742 in chips) 
Seat 9: Bobby Akselrod (29944 in chips) 
Ruslan5795: posts the ante 50
liy731: posts the ante 50
Avmatos88: posts the ante 50
jcarlos.vale: posts the ante 50
kensui: posts the ante 50
tusko8: posts the ante 50
Moggel23: posts the ante 50
Matzen10: posts the ante 50
Bobby Akselrod: posts the ante 50
Avmatos88: posts small blind 200
jcarlos.vale: posts big blind 400
*** HOLE CARDS ***
Dealt to jcarlos.vale [Kh Kd]
kensui: folds 
tusko8: folds 
Moggel23: calls 400
Matzen10: calls 400
Bobby Akselrod: folds 
Ruslan5795: folds 
liy731: folds 
Avmatos88: folds 
jcarlos.vale: raises 1200 to 1600
Moggel23: calls 1200
Matzen10: folds 
*** FLOP *** [4h As 9c]
jcarlos.vale: bets 1200
Moggel23: folds 
Uncalled bet (1200) returned to jcarlos.vale
jcarlos.vale collected 4250 from pot
jcarlos.vale: doesn't show handDTO
*** SUMMARY ***
Total pot 4250 | Rake 0 
Board [4h As 9c]
Seat 1: Ruslan5795 folded before Flop (didn't bet)
Seat 2: liy731 (button) folded before Flop (didn't bet)
Seat 3: Avmatos88 (small blind) folded before Flop
Seat 4: jcarlos.vale (big blind) collected (4250)
Seat 5: kensui folded before Flop (didn't bet)
Seat 6: tusko8 folded before Flop (didn't bet)
Seat 7: Moggel23 folded on the Flop
Seat 8: Matzen10 folded before Flop
Seat 9: Bobby Akselrod folded before Flop (didn't bet)



PokerStars Hand #221903643331: Tournament #3082657132, $0.98+$0.12 USD Hold'em No Limit - Level XII (200/400) - 2020/12/27 18:24:58 EET [2020/12/27 11:24:58 ET]
Table '3082657132 62' 9-max Seat #3 is the button
Seat 1: Ruslan5795 (19559 in chips) 
Seat 2: liy731 (7917 in chips) 
Seat 3: Avmatos88 (7635 in chips) 
Seat 4: jcarlos.vale (24068 in chips) 
Seat 5: kensui (8354 in chips) 
Seat 6: tusko8 (13748 in chips) 
Seat 7: Moggel23 (11540 in chips) 
Seat 8: Matzen10 (11292 in chips) 
Seat 9: Bobby Akselrod (29894 in chips) 
Ruslan5795: posts the ante 50
liy731: posts the ante 50
Avmatos88: posts the ante 50
jcarlos.vale: posts the ante 50
kensui: posts the ante 50
tusko8: posts the ante 50
Moggel23: posts the ante 50
Matzen10: posts the ante 50
Bobby Akselrod: posts the ante 50
jcarlos.vale: posts small blind 200
kensui: posts big blind 400
*** HOLE CARDS ***
Dealt to jcarlos.vale [Ts 5c]
tusko8: folds 
Moggel23: folds 
Matzen10: folds 
Bobby Akselrod: folds 
Ruslan5795 has timed out
Ruslan5795: folds 
Ruslan5795 is sitting out
liy731: folds 
Ruslan5795 has returned
Avmatos88: folds 
jcarlos.vale: folds 
Uncalled bet (200) returned to kensui
kensui collected 850 from pot
kensui: doesn't show handDTO
*** SUMMARY ***
Total pot 850 | Rake 0 
Seat 1: Ruslan5795 folded before Flop (didn't bet)
Seat 2: liy731 folded before Flop (didn't bet)
Seat 3: Avmatos88 (button) folded before Flop (didn't bet)
Seat 4: jcarlos.vale (small blind) folded before Flop
Seat 5: kensui (big blind) collected (850)
Seat 6: tusko8 folded before Flop (didn't bet)
Seat 7: Moggel23 folded before Flop (didn't bet)
Seat 8: Matzen10 folded before Flop (didn't bet)
Seat 9: Bobby Akselrod folded before Flop (didn't bet)



PokerStars Hand #221903667586: Tournament #3082657132, $0.98+$0.12 USD Hold'em No Limit - Level XII (200/400) - 2020/12/27 18:25:31 EET [2020/12/27 11:25:31 ET]
Table '3082657132 62' 9-max Seat #4 is the button
Seat 1: Ruslan5795 (19509 in chips) 
Seat 2: liy731 (7867 in chips) 
Seat 3: Avmatos88 (7585 in chips) 
Seat 4: jcarlos.vale (23818 in chips) 
Seat 5: kensui (8954 in chips) 
Seat 6: tusko8 (13698 in chips) 
Seat 7: Moggel23 (11490 in chips) 
Seat 8: Matzen10 (11242 in chips) 
Seat 9: Bobby Akselrod (29844 in chips) 
Ruslan5795: posts the ante 50
liy731: posts the ante 50
Avmatos88: posts the ante 50
jcarlos.vale: posts the ante 50
kensui: posts the ante 50
tusko8: posts the ante 50
Moggel23: posts the ante 50
Matzen10: posts the ante 50
Bobby Akselrod: posts the ante 50
kensui: posts small blind 200
tusko8: posts big blind 400
*** HOLE CARDS ***
Dealt to jcarlos.vale [9d Ts]
Moggel23: folds 
Matzen10: folds 
Bobby Akselrod: folds 
Ruslan5795: calls 400
liy731: calls 400
Avmatos88: folds 
jcarlos.vale: folds 
kensui: calls 200
tusko8: checks 
*** FLOP *** [8c 9c 4c]
kensui: checks 
tusko8: checks 
Ruslan5795: checks 
liy731: bets 1025
kensui: folds 
tusko8: folds 
Ruslan5795: calls 1025
*** TURN *** [8c 9c 4c] [5c]
Ruslan5795: checks 
liy731: bets 1600
Ruslan5795: calls 1600
*** RIVER *** [8c 9c 4c 5c] [4d]
Ruslan5795: checks 
liy731: checks 
*** SHOW DOWN ***
Ruslan5795: shows [6s 6c] (a flush, Nine high)
liy731: mucks handDTO
Ruslan5795 collected 7300 from pot
*** SUMMARY ***
Total pot 7300 | Rake 0 
Board [8c 9c 4c 5c 4d]
Seat 1: Ruslan5795 showed [6s 6c] and won (7300) with a flush, Nine high
Seat 2: liy731 mucked [7h 6h]
Seat 3: Avmatos88 folded before Flop (didn't bet)
Seat 4: jcarlos.vale (button) folded before Flop (didn't bet)
Seat 5: kensui (small blind) folded on the Flop
Seat 6: tusko8 (big blind) folded on the Flop
Seat 7: Moggel23 folded before Flop (didn't bet)
Seat 8: Matzen10 folded before Flop (didn't bet)
Seat 9: Bobby Akselrod folded before Flop (didn't bet)



PokerStars Hand #221903726292: Tournament #3082657132, $0.98+$0.12 USD Hold'em No Limit - Level XII (200/400) - 2020/12/27 18:26:52 EET [2020/12/27 11:26:52 ET]
Table '3082657132 62' 9-max Seat #5 is the button
Seat 1: Ruslan5795 (23734 in chips) 
Seat 2: liy731 (4792 in chips) 
Seat 3: Avmatos88 (7535 in chips) 
Seat 4: jcarlos.vale (23768 in chips) 
Seat 5: kensui (8504 in chips) 
Seat 6: tusko8 (13248 in chips) 
Seat 7: Moggel23 (11440 in chips) 
Seat 8: Matzen10 (11192 in chips) 
Seat 9: Bobby Akselrod (29794 in chips) 
Ruslan5795: posts the ante 50
liy731: posts the ante 50
Avmatos88: posts the ante 50
jcarlos.vale: posts the ante 50
kensui: posts the ante 50
tusko8: posts the ante 50
Moggel23: posts the ante 50
Matzen10: posts the ante 50
Bobby Akselrod: posts the ante 50
tusko8: posts small blind 200
Moggel23: posts big blind 400
*** HOLE CARDS ***
Dealt to jcarlos.vale [Ts 9d]
Matzen10: folds 
Bobby Akselrod: folds 
Ruslan5795: calls 400
liy731: folds 
Avmatos88: folds 
jcarlos.vale: folds 
kensui: folds 
tusko8: calls 200
Moggel23: checks 
*** FLOP *** [6h Qh Jc]
tusko8: checks 
Moggel23: checks 
Ruslan5795: checks 
*** TURN *** [6h Qh Jc] [Ks]
tusko8: bets 400
Moggel23: calls 400
Ruslan5795: calls 400
*** RIVER *** [6h Qh Jc Ks] [2s]
tusko8: checks 
Moggel23: checks 
Ruslan5795: checks 
*** SHOW DOWN ***
tusko8: shows [8s 5s] (high pairOfCards King)
Moggel23: shows [Jh 5d] (a pair of Jacks)
Ruslan5795: shows [2d Qd] (two pair, Queens and Deuces)
Ruslan5795 collected 2850 from pot
*** SUMMARY ***
Total pot 2850 | Rake 0 
Board [6h Qh Jc Ks 2s]
Seat 1: Ruslan5795 showed [2d Qd] and won (2850) with two pair, Queens and Deuces
Seat 2: liy731 folded before Flop (didn't bet)
Seat 3: Avmatos88 folded before Flop (didn't bet)
Seat 4: jcarlos.vale folded before Flop (didn't bet)
Seat 5: kensui (button) folded before Flop (didn't bet)
Seat 6: tusko8 (small blind) showed [8s 5s] and lost with high pairOfCards King
Seat 7: Moggel23 (big blind) showed [Jh 5d] and lost with a pair of Jacks
Seat 8: Matzen10 folded before Flop (didn't bet)
Seat 9: Bobby Akselrod folded before Flop (didn't bet)



PokerStars Hand #221903773232: Tournament #3082657132, $0.98+$0.12 USD Hold'em No Limit - Level XII (200/400) - 2020/12/27 18:27:57 EET [2020/12/27 11:27:57 ET]
Table '3082657132 62' 9-max Seat #6 is the button
Seat 1: Ruslan5795 (25734 in chips) 
Seat 2: liy731 (4742 in chips) 
Seat 3: Avmatos88 (7485 in chips) 
Seat 4: jcarlos.vale (23718 in chips) 
Seat 5: kensui (8454 in chips) 
Seat 6: tusko8 (12398 in chips) 
Seat 7: Moggel23 (10590 in chips) 
Seat 8: Matzen10 (11142 in chips) 
Seat 9: Bobby Akselrod (29744 in chips) 
Ruslan5795: posts the ante 50
liy731: posts the ante 50
Avmatos88: posts the ante 50
jcarlos.vale: posts the ante 50
kensui: posts the ante 50
tusko8: posts the ante 50
Moggel23: posts the ante 50
Matzen10: posts the ante 50
Bobby Akselrod: posts the ante 50
Moggel23: posts small blind 200
Matzen10: posts big blind 400
*** HOLE CARDS ***
Dealt to jcarlos.vale [Qc Ah]
Bobby Akselrod: folds 
Ruslan5795 has timed out
Ruslan5795: folds 
Ruslan5795 is sitting out
liy731: folds 
Avmatos88: folds 
Ruslan5795 has returned
jcarlos.vale: raises 640 to 1040
kensui: folds 
tusko8: calls 1040
Moggel23: folds 
Matzen10: calls 640
*** FLOP *** [9s Kh Jd]
Matzen10: checks 
jcarlos.vale: checks 
tusko8: checks 
*** TURN *** [9s Kh Jd] [As]
Matzen10: checks 
jcarlos.vale: bets 1885
tusko8: folds 
Matzen10: folds 
Uncalled bet (1885) returned to jcarlos.vale
jcarlos.vale collected 3770 from pot
jcarlos.vale: doesn't show handDTO
*** SUMMARY ***
Total pot 3770 | Rake 0 
Board [9s Kh Jd As]
Seat 1: Ruslan5795 folded before Flop (didn't bet)
Seat 2: liy731 folded before Flop (didn't bet)
Seat 3: Avmatos88 folded before Flop (didn't bet)
Seat 4: jcarlos.vale collected (3770)
Seat 5: kensui folded before Flop (didn't bet)
Seat 6: tusko8 (button) folded on the Turn
Seat 7: Moggel23 (small blind) folded before Flop
Seat 8: Matzen10 (big blind) folded on the Turn
Seat 9: Bobby Akselrod folded before Flop (didn't bet)



PokerStars Hand #221903820821: Tournament #3082657132, $0.98+$0.12 USD Hold'em No Limit - Level XIII (250/500) - 2020/12/27 18:29:03 EET [2020/12/27 11:29:03 ET]
Table '3082657132 62' 9-max Seat #7 is the button
Seat 1: Ruslan5795 (25684 in chips) 
Seat 2: liy731 (4692 in chips) 
Seat 3: Avmatos88 (7435 in chips) 
Seat 4: jcarlos.vale (26398 in chips) 
Seat 5: kensui (8404 in chips) 
Seat 6: tusko8 (11308 in chips) 
Seat 7: Moggel23 (10340 in chips) 
Seat 8: Matzen10 (10052 in chips) 
Seat 9: Bobby Akselrod (29694 in chips) 
Ruslan5795: posts the ante 60
liy731: posts the ante 60
Avmatos88: posts the ante 60
jcarlos.vale: posts the ante 60
kensui: posts the ante 60
tusko8: posts the ante 60
Moggel23: posts the ante 60
Matzen10: posts the ante 60
Bobby Akselrod: posts the ante 60
Matzen10: posts small blind 250
Bobby Akselrod: posts big blind 500
*** HOLE CARDS ***
Dealt to jcarlos.vale [6d Td]
Ruslan5795: calls 500
liy731: folds 
Avmatos88: raises 6875 to 7375 and is all-in
jcarlos.vale: folds 
kensui: folds 
tusko8: folds 
Moggel23: folds 
Matzen10: folds 
Bobby Akselrod: folds 
Ruslan5795: folds 
Uncalled bet (6875) returned to Avmatos88
Avmatos88 collected 2290 from pot
Avmatos88: doesn't show handDTO
*** SUMMARY ***
Total pot 2290 | Rake 0 
Seat 1: Ruslan5795 folded before Flop
Seat 2: liy731 folded before Flop (didn't bet)
Seat 3: Avmatos88 collected (2290)
Seat 4: jcarlos.vale folded before Flop (didn't bet)
Seat 5: kensui folded before Flop (didn't bet)
Seat 6: tusko8 folded before Flop (didn't bet)
Seat 7: Moggel23 (button) folded before Flop (didn't bet)
Seat 8: Matzen10 (small blind) folded before Flop
Seat 9: Bobby Akselrod (big blind) folded before Flop



PokerStars Hand #221903859660: Tournament #3082657132, $0.98+$0.12 USD Hold'em No Limit - Level XIII (250/500) - 2020/12/27 18:29:57 EET [2020/12/27 11:29:57 ET]
Table '3082657132 62' 9-max Seat #8 is the button
Seat 1: Ruslan5795 (25124 in chips) 
Seat 2: liy731 (4632 in chips) 
Seat 3: Avmatos88 (9165 in chips) 
Seat 4: jcarlos.vale (26338 in chips) 
Seat 5: kensui (8344 in chips) 
Seat 6: tusko8 (11248 in chips) 
Seat 7: Moggel23 (10280 in chips) 
Seat 8: Matzen10 (9742 in chips) 
Seat 9: Bobby Akselrod (29134 in chips) 
Ruslan5795: posts the ante 60
liy731: posts the ante 60
Avmatos88: posts the ante 60
jcarlos.vale: posts the ante 60
kensui: posts the ante 60
tusko8: posts the ante 60
Moggel23: posts the ante 60
Matzen10: posts the ante 60
Bobby Akselrod: posts the ante 60
Bobby Akselrod: posts small blind 250
Ruslan5795: posts big blind 500
*** HOLE CARDS ***
Dealt to jcarlos.vale [3c Qd]
liy731: folds 
Avmatos88: folds 
jcarlos.vale: folds 
kensui: folds 
tusko8: folds 
Moggel23: folds 
Matzen10: raises 500 to 1000
Bobby Akselrod: folds 
Ruslan5795: folds 
Uncalled bet (500) returned to Matzen10
Matzen10 collected 1790 from pot
Matzen10: doesn't show handDTO
*** SUMMARY ***
Total pot 1790 | Rake 0 
Seat 1: Ruslan5795 (big blind) folded before Flop
Seat 2: liy731 folded before Flop (didn't bet)
Seat 3: Avmatos88 folded before Flop (didn't bet)
Seat 4: jcarlos.vale folded before Flop (didn't bet)
Seat 5: kensui folded before Flop (didn't bet)
Seat 6: tusko8 folded before Flop (didn't bet)
Seat 7: Moggel23 folded before Flop (didn't bet)
Seat 8: Matzen10 (button) collected (1790)
Seat 9: Bobby Akselrod (small blind) folded before Flop



PokerStars Hand #221903893517: Tournament #3082657132, $0.98+$0.12 USD Hold'em No Limit - Level XIII (250/500) - 2020/12/27 18:30:42 EET [2020/12/27 11:30:42 ET]
Table '3082657132 62' 9-max Seat #9 is the button
Seat 1: Ruslan5795 (24564 in chips) 
Seat 2: liy731 (4572 in chips) 
Seat 3: Avmatos88 (9105 in chips) 
Seat 4: jcarlos.vale (26278 in chips) 
Seat 5: kensui (8284 in chips) 
Seat 6: tusko8 (11188 in chips) 
Seat 7: Moggel23 (10220 in chips) 
Seat 8: Matzen10 (10972 in chips) 
Seat 9: Bobby Akselrod (28824 in chips) 
Ruslan5795: posts the ante 60
liy731: posts the ante 60
Avmatos88: posts the ante 60
jcarlos.vale: posts the ante 60
kensui: posts the ante 60
tusko8: posts the ante 60
Moggel23: posts the ante 60
Matzen10: posts the ante 60
Bobby Akselrod: posts the ante 60
Ruslan5795: posts small blind 250
liy731: posts big blind 500
*** HOLE CARDS ***
Dealt to jcarlos.vale [5s Qc]
Avmatos88: folds 
jcarlos.vale: folds 
kensui: folds 
tusko8: raises 1000 to 1500
Moggel23: calls 1500
Matzen10: folds 
Bobby Akselrod: folds 
Ruslan5795: folds 
liy731: folds 
*** FLOP *** [6c 4d 3c]
tusko8: bets 5500
Moggel23: folds 
Uncalled bet (5500) returned to tusko8
tusko8 collected 4290 from pot
tusko8: doesn't show handDTO
*** SUMMARY ***
Total pot 4290 | Rake 0 
Board [6c 4d 3c]
Seat 1: Ruslan5795 (small blind) folded before Flop
Seat 2: liy731 (big blind) folded before Flop
Seat 3: Avmatos88 folded before Flop (didn't bet)
Seat 4: jcarlos.vale folded before Flop (didn't bet)
Seat 5: kensui folded before Flop (didn't bet)
Seat 6: tusko8 collected (4290)
Seat 7: Moggel23 folded on the Flop
Seat 8: Matzen10 folded before Flop (didn't bet)
Seat 9: Bobby Akselrod (button) folded before Flop (didn't bet)



PokerStars Hand #221903942563: Tournament #3082657132, $0.98+$0.12 USD Hold'em No Limit - Level XIII (250/500) - 2020/12/27 18:31:49 EET [2020/12/27 11:31:49 ET]
Table '3082657132 62' 9-max Seat #1 is the button
Seat 1: Ruslan5795 (24254 in chips) 
Seat 2: liy731 (4012 in chips) 
Seat 3: Avmatos88 (9045 in chips) 
Seat 4: jcarlos.vale (26218 in chips) 
Seat 5: kensui (8224 in chips) 
Seat 6: tusko8 (13918 in chips) 
Seat 7: Moggel23 (8660 in chips) 
Seat 8: Matzen10 (10912 in chips) 
Seat 9: Bobby Akselrod (28764 in chips) 
Ruslan5795: posts the ante 60
liy731: posts the ante 60
Avmatos88: posts the ante 60
jcarlos.vale: posts the ante 60
kensui: posts the ante 60
tusko8: posts the ante 60
Moggel23: posts the ante 60
Matzen10: posts the ante 60
Bobby Akselrod: posts the ante 60
liy731: posts small blind 250
Avmatos88: posts big blind 500
*** HOLE CARDS ***
Dealt to jcarlos.vale [4s 6s]
jcarlos.vale: folds 
kensui: folds 
tusko8: raises 500 to 1000
Moggel23: raises 7600 to 8600 and is all-in
Matzen10: folds 
Bobby Akselrod: folds 
Ruslan5795: folds 
liy731: folds 
Avmatos88: folds 
tusko8: folds 
Uncalled bet (7600) returned to Moggel23
Moggel23 collected 3290 from pot
Moggel23: doesn't show handDTO
*** SUMMARY ***
Total pot 3290 | Rake 0 
Seat 1: Ruslan5795 (button) folded before Flop (didn't bet)
Seat 2: liy731 (small blind) folded before Flop
Seat 3: Avmatos88 (big blind) folded before Flop
Seat 4: jcarlos.vale folded before Flop (didn't bet)
Seat 5: kensui folded before Flop (didn't bet)
Seat 6: tusko8 folded before Flop
Seat 7: Moggel23 collected (3290)
Seat 8: Matzen10 folded before Flop (didn't bet)
Seat 9: Bobby Akselrod folded before Flop (didn't bet)



PokerStars Hand #221903968703: Tournament #3082657132, $0.98+$0.12 USD Hold'em No Limit - Level XIII (250/500) - 2020/12/27 18:32:24 EET [2020/12/27 11:32:24 ET]
Table '3082657132 62' 9-max Seat #2 is the button
Seat 1: Ruslan5795 (24194 in chips) 
Seat 2: liy731 (3702 in chips) 
Seat 3: Avmatos88 (8485 in chips) 
Seat 4: jcarlos.vale (26158 in chips) 
Seat 5: kensui (8164 in chips) 
Seat 6: tusko8 (12858 in chips) 
Seat 7: Moggel23 (10890 in chips) 
Seat 8: Matzen10 (10852 in chips) 
Seat 9: Bobby Akselrod (28704 in chips) 
Ruslan5795: posts the ante 60
liy731: posts the ante 60
Avmatos88: posts the ante 60
jcarlos.vale: posts the ante 60
kensui: posts the ante 60
tusko8: posts the ante 60
Moggel23: posts the ante 60
Matzen10: posts the ante 60
Bobby Akselrod: posts the ante 60
Avmatos88: posts small blind 250
jcarlos.vale: posts big blind 500
*** HOLE CARDS ***
Dealt to jcarlos.vale [Th 2c]
kensui: folds 
tusko8: calls 500
Moggel23: folds 
Matzen10: calls 500
Bobby Akselrod: folds 
Ruslan5795: folds 
liy731: folds 
Avmatos88: folds 
jcarlos.vale: checks 
*** FLOP *** [Qc Jh 3h]
jcarlos.vale: checks 
tusko8: bets 500
Matzen10: calls 500
jcarlos.vale: folds 
*** TURN *** [Qc Jh 3h] [5h]
tusko8: checks 
Matzen10: checks 
*** RIVER *** [Qc Jh 3h 5h] [7c]
tusko8: checks 
Matzen10: bets 3250
tusko8: folds 
Uncalled bet (3250) returned to Matzen10
Matzen10 collected 3290 from pot
Matzen10: doesn't show handDTO
*** SUMMARY ***
Total pot 3290 | Rake 0 
Board [Qc Jh 3h 5h 7c]
Seat 1: Ruslan5795 folded before Flop (didn't bet)
Seat 2: liy731 (button) folded before Flop (didn't bet)
Seat 3: Avmatos88 (small blind) folded before Flop
Seat 4: jcarlos.vale (big blind) folded on the Flop
Seat 5: kensui folded before Flop (didn't bet)
Seat 6: tusko8 folded on the River
Seat 7: Moggel23 folded before Flop (didn't bet)
Seat 8: Matzen10 collected (3290)
Seat 9: Bobby Akselrod folded before Flop (didn't bet)



PokerStars Hand #221904040454: Tournament #3082657132, $0.98+$0.12 USD Hold'em No Limit - Level XIII (250/500) - 2020/12/27 18:34:02 EET [2020/12/27 11:34:02 ET]
Table '3082657132 62' 9-max Seat #3 is the button
Seat 1: Ruslan5795 (24134 in chips) 
Seat 2: liy731 (3642 in chips) 
Seat 3: Avmatos88 (8175 in chips) 
Seat 4: jcarlos.vale (25598 in chips) 
Seat 5: kensui (8104 in chips) 
Seat 6: tusko8 (11798 in chips) 
Seat 7: Moggel23 (10830 in chips) 
Seat 8: Matzen10 (13082 in chips) 
Seat 9: Bobby Akselrod (28644 in chips) 
Ruslan5795: posts the ante 60
liy731: posts the ante 60
Avmatos88: posts the ante 60
jcarlos.vale: posts the ante 60
kensui: posts the ante 60
tusko8: posts the ante 60
Moggel23: posts the ante 60
Matzen10: posts the ante 60
Bobby Akselrod: posts the ante 60
jcarlos.vale: posts small blind 250
kensui: posts big blind 500
*** HOLE CARDS ***
Dealt to jcarlos.vale [5d 6c]
tusko8: folds 
Moggel23: folds 
Matzen10: raises 500 to 1000
Bobby Akselrod: folds 
Ruslan5795: calls 1000
liy731: folds 
Avmatos88: folds 
jcarlos.vale: folds 
kensui has timed out
kensui: folds 
kensui is sitting out
*** FLOP *** [4s Kh 9s]
Matzen10: checks 
Ruslan5795: checks 
*** TURN *** [4s Kh 9s] [2s]
Matzen10: checks 
Ruslan5795: checks 
*** RIVER *** [4s Kh 9s 2s] [Tc]
Matzen10: checks 
Ruslan5795: checks 
*** SHOW DOWN ***
Matzen10: shows [6h 5h] (high pairOfCards King)
Ruslan5795: shows [Ac 4c] (a pair of Fours)
Ruslan5795 collected 3290 from pot
*** SUMMARY ***
Total pot 3290 | Rake 0 
Board [4s Kh 9s 2s Tc]
Seat 1: Ruslan5795 showed [Ac 4c] and won (3290) with a pair of Fours
Seat 2: liy731 folded before Flop (didn't bet)
Seat 3: Avmatos88 (button) folded before Flop (didn't bet)
Seat 4: jcarlos.vale (small blind) folded before Flop
Seat 5: kensui (big blind) folded before Flop
Seat 6: tusko8 folded before Flop (didn't bet)
Seat 7: Moggel23 folded before Flop (didn't bet)
Seat 8: Matzen10 showed [6h 5h] and lost with high pairOfCards King
Seat 9: Bobby Akselrod folded before Flop (didn't bet)



PokerStars Hand #221904119030: Tournament #3082657132, $0.98+$0.12 USD Hold'em No Limit - Level XIII (250/500) - 2020/12/27 18:35:49 EET [2020/12/27 11:35:49 ET]
Table '3082657132 62' 9-max Seat #4 is the button
Seat 1: Ruslan5795 (26364 in chips) 
Seat 2: liy731 (3582 in chips) 
Seat 3: Avmatos88 (8115 in chips) 
Seat 4: jcarlos.vale (25288 in chips) 
Seat 5: kensui (7544 in chips) is sitting out
Seat 6: tusko8 (11738 in chips) 
Seat 7: Moggel23 (10770 in chips) 
Seat 8: Matzen10 (12022 in chips) 
Seat 9: Bobby Akselrod (28584 in chips) 
Ruslan5795: posts the ante 60
liy731: posts the ante 60
Avmatos88: posts the ante 60
jcarlos.vale: posts the ante 60
kensui: posts the ante 60
tusko8: posts the ante 60
Moggel23: posts the ante 60
Matzen10: posts the ante 60
Bobby Akselrod: posts the ante 60
kensui: posts small blind 250
tusko8: posts big blind 500
*** HOLE CARDS ***
Dealt to jcarlos.vale [5c 8c]
kensui has returned
Moggel23: folds 
Matzen10: folds 
Bobby Akselrod: raises 1000 to 1500
Ruslan5795: folds 
liy731: folds 
Avmatos88: folds 
jcarlos.vale: folds 
kensui: raises 5984 to 7484 and is all-in
tusko8: folds 
Bobby Akselrod: calls 5984
*** FLOP *** [2s Td 8d]
*** TURN *** [2s Td 8d] [9s]
*** RIVER *** [2s Td 8d 9s] [As]
*** SHOW DOWN ***
kensui: shows [Ad Ah] (three of a kind, Aces)
Bobby Akselrod: shows [Qc Ac] (a pair of Aces)
kensui collected 16008 from pot
*** SUMMARY ***
Total pot 16008 | Rake 0 
Board [2s Td 8d 9s As]
Seat 1: Ruslan5795 folded before Flop (didn't bet)
Seat 2: liy731 folded before Flop (didn't bet)
Seat 3: Avmatos88 folded before Flop (didn't bet)
Seat 4: jcarlos.vale (button) folded before Flop (didn't bet)
Seat 5: kensui (small blind) showed [Ad Ah] and won (16008) with three of a kind, Aces
Seat 6: tusko8 (big blind) folded before Flop
Seat 7: Moggel23 folded before Flop (didn't bet)
Seat 8: Matzen10 folded before Flop (didn't bet)
Seat 9: Bobby Akselrod showed [Qc Ac] and lost with a pair of Aces



PokerStars Hand #221904147020: Tournament #3082657132, $0.98+$0.12 USD Hold'em No Limit - Level XIII (250/500) - 2020/12/27 18:36:27 EET [2020/12/27 11:36:27 ET]
Table '3082657132 62' 9-max Seat #5 is the button
Seat 1: Ruslan5795 (26304 in chips) 
Seat 2: liy731 (3522 in chips) 
Seat 3: Avmatos88 (8055 in chips) 
Seat 4: jcarlos.vale (25228 in chips) 
Seat 5: kensui (16008 in chips) 
Seat 6: tusko8 (11178 in chips) 
Seat 7: Moggel23 (10710 in chips) 
Seat 8: Matzen10 (11962 in chips) 
Seat 9: Bobby Akselrod (21040 in chips) 
Ruslan5795: posts the ante 60
liy731: posts the ante 60
Avmatos88: posts the ante 60
jcarlos.vale: posts the ante 60
kensui: posts the ante 60
tusko8: posts the ante 60
Moggel23: posts the ante 60
Matzen10: posts the ante 60
Bobby Akselrod: posts the ante 60
tusko8: posts small blind 250
Moggel23: posts big blind 500
*** HOLE CARDS ***
Dealt to jcarlos.vale [Ks Kc]
Matzen10: folds 
Bobby Akselrod: folds 
Ruslan5795: calls 500
liy731: folds 
Avmatos88: folds 
jcarlos.vale: raises 1000 to 1500
kensui: folds 
tusko8: calls 1250
Moggel23: folds 
Ruslan5795 has timed out
Ruslan5795: folds 
Ruslan5795 is sitting out
*** FLOP *** [Kd 8d 9d]
Ruslan5795 has returned
tusko8: checks 
jcarlos.vale: bets 3500
tusko8: folds 
Uncalled bet (3500) returned to jcarlos.vale
jcarlos.vale collected 4540 from pot
jcarlos.vale: doesn't show handDTO
*** SUMMARY ***
Total pot 4540 | Rake 0 
Board [Kd 8d 9d]
Seat 1: Ruslan5795 folded before Flop
Seat 2: liy731 folded before Flop (didn't bet)
Seat 3: Avmatos88 folded before Flop (didn't bet)
Seat 4: jcarlos.vale collected (4540)
Seat 5: kensui (button) folded before Flop (didn't bet)
Seat 6: tusko8 (small blind) folded on the Flop
Seat 7: Moggel23 (big blind) folded before Flop
Seat 8: Matzen10 folded before Flop (didn't bet)
Seat 9: Bobby Akselrod folded before Flop (didn't bet)



PokerStars Hand #221904186977: Tournament #3082657132, $0.98+$0.12 USD Hold'em No Limit - Level XIII (250/500) - 2020/12/27 18:37:21 EET [2020/12/27 11:37:21 ET]
Table '3082657132 62' 9-max Seat #6 is the button
Seat 1: Ruslan5795 (25744 in chips) 
Seat 2: liy731 (3462 in chips) 
Seat 3: Avmatos88 (7995 in chips) 
Seat 4: jcarlos.vale (28208 in chips) 
Seat 5: kensui (15948 in chips) 
Seat 6: tusko8 (9618 in chips) 
Seat 7: Moggel23 (10150 in chips) 
Seat 8: Matzen10 (11902 in chips) 
Seat 9: Bobby Akselrod (20980 in chips) 
Ruslan5795: posts the ante 60
liy731: posts the ante 60
Avmatos88: posts the ante 60
jcarlos.vale: posts the ante 60
kensui: posts the ante 60
tusko8: posts the ante 60
Moggel23: posts the ante 60
Matzen10: posts the ante 60
Bobby Akselrod: posts the ante 60
Moggel23: posts small blind 250
Matzen10: posts big blind 500
*** HOLE CARDS ***
Dealt to jcarlos.vale [7c 2c]
Bobby Akselrod: folds 
Ruslan5795: calls 500
liy731: folds 
Avmatos88: raises 7435 to 7935 and is all-in
jcarlos.vale: folds 
kensui: folds 
tusko8: raises 1623 to 9558 and is all-in
Moggel23: folds 
Matzen10: folds 
Ruslan5795: folds 
Uncalled bet (1623) returned to tusko8
*** FLOP *** [6c 2h 9d]
*** TURN *** [6c 2h 9d] [8d]
*** RIVER *** [6c 2h 9d 8d] [7s]
*** SHOW DOWN ***
Avmatos88: shows [Ks Qh] (high pairOfCards King)
tusko8: shows [As Qd] (high pairOfCards Ace)
tusko8 collected 17660 from pot
Avmatos88 finished the tournament in 562nd place
*** SUMMARY ***
Total pot 17660 | Rake 0 
Board [6c 2h 9d 8d 7s]
Seat 1: Ruslan5795 folded before Flop
Seat 2: liy731 folded before Flop (didn't bet)
Seat 3: Avmatos88 showed [Ks Qh] and lost with high pairOfCards King
Seat 4: jcarlos.vale folded before Flop (didn't bet)
Seat 5: kensui folded before Flop (didn't bet)
Seat 6: tusko8 (button) showed [As Qd] and won (17660) with high pairOfCards Ace
Seat 7: Moggel23 (small blind) folded before Flop
Seat 8: Matzen10 (big blind) folded before Flop
Seat 9: Bobby Akselrod folded before Flop (didn't bet)



PokerStars Hand #221904224982: Tournament #3082657132, $0.98+$0.12 USD Hold'em No Limit - Level XIII (250/500) - 2020/12/27 18:38:08 EET [2020/12/27 11:38:08 ET]
Table '3082657132 62' 9-max Seat #7 is the button
Seat 1: Ruslan5795 (25184 in chips) 
Seat 2: liy731 (3402 in chips) 
Seat 4: jcarlos.vale (28148 in chips) 
Seat 5: kensui (15888 in chips) 
Seat 6: tusko8 (19283 in chips) 
Seat 7: Moggel23 (9840 in chips) 
Seat 8: Matzen10 (11342 in chips) 
Seat 9: Bobby Akselrod (20920 in chips) 
Ruslan5795: posts the ante 60
liy731: posts the ante 60
jcarlos.vale: posts the ante 60
kensui: posts the ante 60
tusko8: posts the ante 60
Moggel23: posts the ante 60
Matzen10: posts the ante 60
Bobby Akselrod: posts the ante 60
Matzen10: posts small blind 250
Bobby Akselrod: posts big blind 500
*** HOLE CARDS ***
Dealt to jcarlos.vale [8c 6c]
Ruslan5795: calls 500
liy731: folds 
jcarlos.vale: folds 
kensui: folds 
tusko8: folds 
Moggel23: folds 
Matzen10: folds 
Bobby Akselrod: raises 1500 to 2000
Ruslan5795: calls 1500
*** FLOP *** [As Kd Kh]
Bobby Akselrod: checks 
Ruslan5795: checks 
*** TURN *** [As Kd Kh] [Ad]
Bobby Akselrod: checks 
Ruslan5795: checks 
*** RIVER *** [As Kd Kh Ad] [5h]
Bobby Akselrod: checks 
Ruslan5795: checks 
*** SHOW DOWN ***
Bobby Akselrod: shows [9c 9s] (two pair, Aces and Kings)
Ruslan5795: mucks handDTO
Bobby Akselrod collected 4730 from pot
*** SUMMARY ***
Total pot 4730 | Rake 0 
Board [As Kd Kh Ad 5h]
Seat 1: Ruslan5795 mucked [4h 4c]
Seat 2: liy731 folded before Flop (didn't bet)
Seat 4: jcarlos.vale folded before Flop (didn't bet)
Seat 5: kensui folded before Flop (didn't bet)
Seat 6: tusko8 folded before Flop (didn't bet)
Seat 7: Moggel23 (button) folded before Flop (didn't bet)
Seat 8: Matzen10 (small blind) folded before Flop
Seat 9: Bobby Akselrod (big blind) showed [9c 9s] and won (4730) with two pair, Aces and Kings



PokerStars Hand #221904328104: Tournament #3082657132, $0.98+$0.12 USD Hold'em No Limit - Level XIV (300/600) - 2020/12/27 18:40:28 EET [2020/12/27 11:40:28 ET]
Table '3082657132 62' 9-max Seat #8 is the button
Seat 1: Ruslan5795 (23124 in chips) 
Seat 2: liy731 (3342 in chips) 
Seat 3: dim@n.89liza (68360 in chips) 
Seat 4: jcarlos.vale (28088 in chips) 
Seat 5: kensui (15828 in chips) 
Seat 6: tusko8 (19223 in chips) 
Seat 7: Moggel23 (9780 in chips) 
Seat 8: Matzen10 (11032 in chips) 
Seat 9: Bobby Akselrod (23590 in chips) 
Ruslan5795: posts the ante 70
liy731: posts the ante 70
dim@n.89liza: posts the ante 70
jcarlos.vale: posts the ante 70
kensui: posts the ante 70
tusko8: posts the ante 70
Moggel23: posts the ante 70
Matzen10: posts the ante 70
Bobby Akselrod: posts the ante 70
Bobby Akselrod: posts small blind 300
Ruslan5795: posts big blind 600
*** HOLE CARDS ***
Dealt to jcarlos.vale [4c 3d]
liy731: folds 
dim@n.89liza: folds 
jcarlos.vale: folds 
kensui: folds 
tusko8: raises 600 to 1200
Moggel23: folds 
Matzen10: folds 
Bobby Akselrod: folds 
Ruslan5795: calls 600
*** FLOP *** [9c Kh Qd]
Ruslan5795: checks 
tusko8: bets 1200
Ruslan5795: calls 1200
*** TURN *** [9c Kh Qd] [7c]
Ruslan5795: checks 
tusko8: checks 
*** RIVER *** [9c Kh Qd 7c] [5c]
Ruslan5795: checks 
tusko8: checks 
*** SHOW DOWN ***
Ruslan5795: shows [As 3h] (high pairOfCards Ace)
tusko8: shows [Ts Qs] (a pair of Queens)
tusko8 collected 5730 from pot
*** SUMMARY ***
Total pot 5730 | Rake 0 
Board [9c Kh Qd 7c 5c]
Seat 1: Ruslan5795 (big blind) showed [As 3h] and lost with high pairOfCards Ace
Seat 2: liy731 folded before Flop (didn't bet)
Seat 3: dim@n.89liza folded before Flop (didn't bet)
Seat 4: jcarlos.vale folded before Flop (didn't bet)
Seat 5: kensui folded before Flop (didn't bet)
Seat 6: tusko8 showed [Ts Qs] and won (5730) with a pair of Queens
Seat 7: Moggel23 folded before Flop (didn't bet)
Seat 8: Matzen10 (button) folded before Flop (didn't bet)
Seat 9: Bobby Akselrod (small blind) folded before Flop



PokerStars Hand #221904374657: Tournament #3082657132, $0.98+$0.12 USD Hold'em No Limit - Level XIV (300/600) - 2020/12/27 18:41:30 EET [2020/12/27 11:41:30 ET]
Table '3082657132 62' 9-max Seat #9 is the button
Seat 1: Ruslan5795 (20654 in chips) 
Seat 2: liy731 (3272 in chips) 
Seat 3: dim@n.89liza (68290 in chips) 
Seat 4: jcarlos.vale (28018 in chips) 
Seat 5: kensui (15758 in chips) 
Seat 6: tusko8 (22483 in chips) 
Seat 7: Moggel23 (9710 in chips) 
Seat 8: Matzen10 (10962 in chips) 
Seat 9: Bobby Akselrod (23220 in chips) 
Ruslan5795: posts the ante 70
liy731: posts the ante 70
dim@n.89liza: posts the ante 70
jcarlos.vale: posts the ante 70
kensui: posts the ante 70
tusko8: posts the ante 70
Moggel23: posts the ante 70
Matzen10: posts the ante 70
Bobby Akselrod: posts the ante 70
Ruslan5795: posts small blind 300
liy731: posts big blind 600
*** HOLE CARDS ***
Dealt to jcarlos.vale [7c Jc]
dim@n.89liza: raises 1200 to 1800
jcarlos.vale: folds 
kensui: folds 
tusko8: folds 
Moggel23: folds 
Matzen10: folds 
Bobby Akselrod: calls 1800
Ruslan5795: folds 
liy731: raises 1402 to 3202 and is all-in
dim@n.89liza: raises 65018 to 68220 and is all-in
Bobby Akselrod: folds 
Uncalled bet (65018) returned to dim@n.89liza
*** FLOP *** [Td Ah 3s]
*** TURN *** [Td Ah 3s] [8h]
*** RIVER *** [Td Ah 3s 8h] [2s]
*** SHOW DOWN ***
liy731: shows [8d 8s] (three of a kind, Eights)
dim@n.89liza: shows [Ts Th] (three of a kind, Tens)
dim@n.89liza collected 9134 from pot
liy731 finished the tournament in 533rd place and received $1.70.
*** SUMMARY ***
Total pot 9134 | Rake 0 
Board [Td Ah 3s 8h 2s]
Seat 1: Ruslan5795 (small blind) folded before Flop
Seat 2: liy731 (big blind) showed [8d 8s] and lost with three of a kind, Eights
Seat 3: dim@n.89liza showed [Ts Th] and won (9134) with three of a kind, Tens
Seat 4: jcarlos.vale folded before Flop (didn't bet)
Seat 5: kensui folded before Flop (didn't bet)
Seat 6: tusko8 folded before Flop (didn't bet)
Seat 7: Moggel23 folded before Flop (didn't bet)
Seat 8: Matzen10 folded before Flop (didn't bet)
Seat 9: Bobby Akselrod (button) folded before Flop



PokerStars Hand #221904407113: Tournament #3082657132, $0.98+$0.12 USD Hold'em No Limit - Level XIV (300/600) - 2020/12/27 18:42:14 EET [2020/12/27 11:42:14 ET]
Table '3082657132 62' 9-max Seat #1 is the button
Seat 1: Ruslan5795 (20284 in chips) 
Seat 3: dim@n.89liza (74152 in chips) 
Seat 4: jcarlos.vale (27948 in chips) 
Seat 5: kensui (15688 in chips) 
Seat 6: tusko8 (22413 in chips) 
Seat 7: Moggel23 (9640 in chips) 
Seat 8: Matzen10 (10892 in chips) 
Seat 9: Bobby Akselrod (21350 in chips) 
Ruslan5795: posts the ante 70
dim@n.89liza: posts the ante 70
jcarlos.vale: posts the ante 70
kensui: posts the ante 70
tusko8: posts the ante 70
Moggel23: posts the ante 70
Matzen10: posts the ante 70
Bobby Akselrod: posts the ante 70
dim@n.89liza: posts small blind 300
jcarlos.vale: posts big blind 600
*** HOLE CARDS ***
Dealt to jcarlos.vale [Kd 4h]
kensui: folds 
tusko8: folds 
Moggel23: folds 
Matzen10: folds 
Bobby Akselrod: folds 
Ruslan5795: folds 
dim@n.89liza: raises 1200 to 1800
jcarlos.vale: folds 
Uncalled bet (1200) returned to dim@n.89liza
dim@n.89liza collected 1760 from pot
dim@n.89liza: doesn't show handDTO
*** SUMMARY ***
Total pot 1760 | Rake 0 
Seat 1: Ruslan5795 (button) folded before Flop (didn't bet)
Seat 3: dim@n.89liza (small blind) collected (1760)
Seat 4: jcarlos.vale (big blind) folded before Flop
Seat 5: kensui folded before Flop (didn't bet)
Seat 6: tusko8 folded before Flop (didn't bet)
Seat 7: Moggel23 folded before Flop (didn't bet)
Seat 8: Matzen10 folded before Flop (didn't bet)
Seat 9: Bobby Akselrod folded before Flop (didn't bet)



PokerStars Hand #221904425736: Tournament #3082657132, $0.98+$0.12 USD Hold'em No Limit - Level XIV (300/600) - 2020/12/27 18:42:39 EET [2020/12/27 11:42:39 ET]
Table '3082657132 62' 9-max Seat #3 is the button
Seat 1: Ruslan5795 (20214 in chips) 
Seat 2: rato6408 (29865 in chips) 
Seat 3: dim@n.89liza (75242 in chips) 
Seat 4: jcarlos.vale (27278 in chips) 
Seat 5: kensui (15618 in chips) 
Seat 6: tusko8 (22343 in chips) 
Seat 7: Moggel23 (9570 in chips) 
Seat 8: Matzen10 (10822 in chips) 
Seat 9: Bobby Akselrod (21280 in chips) 
Ruslan5795: posts the ante 70
rato6408: posts the ante 70
dim@n.89liza: posts the ante 70
jcarlos.vale: posts the ante 70
kensui: posts the ante 70
tusko8: posts the ante 70
Moggel23: posts the ante 70
Matzen10: posts the ante 70
Bobby Akselrod: posts the ante 70
jcarlos.vale: posts small blind 300
kensui: posts big blind 600
*** HOLE CARDS ***
Dealt to jcarlos.vale [7h Qc]
tusko8: folds 
Moggel23: calls 600
Matzen10: raises 1500 to 2100
Bobby Akselrod: folds 
Ruslan5795: folds 
rato6408: folds 
dim@n.89liza: folds 
jcarlos.vale: folds 
kensui: folds 
Moggel23: raises 7400 to 9500 and is all-in
Matzen10: calls 7400
*** FLOP *** [2h 6c 8s]
*** TURN *** [2h 6c 8s] [9d]
*** RIVER *** [2h 6c 8s 9d] [5s]
*** SHOW DOWN ***
Moggel23: shows [Kc Ks] (a pair of Kings)
Matzen10: shows [As Ac] (a pair of Aces)
Matzen10 collected 20530 from pot
Moggel23 finished the tournament in 511th place and received $1.70.
*** SUMMARY ***
Total pot 20530 | Rake 0 
Board [2h 6c 8s 9d 5s]
Seat 1: Ruslan5795 folded before Flop (didn't bet)
Seat 2: rato6408 folded before Flop (didn't bet)
Seat 3: dim@n.89liza (button) folded before Flop (didn't bet)
Seat 4: jcarlos.vale (small blind) folded before Flop
Seat 5: kensui (big blind) folded before Flop
Seat 6: tusko8 folded before Flop (didn't bet)
Seat 7: Moggel23 showed [Kc Ks] and lost with a pair of Kings
Seat 8: Matzen10 showed [As Ac] and won (20530) with a pair of Aces
Seat 9: Bobby Akselrod folded before Flop (didn't bet)



PokerStars Hand #221904480498: Tournament #3082657132, $0.98+$0.12 USD Hold'em No Limit - Level XIV (300/600) - 2020/12/27 18:43:45 EET [2020/12/27 11:43:45 ET]
Table '3082657132 62' 9-max Seat #4 is the button
Seat 1: Ruslan5795 (20144 in chips) 
Seat 2: rato6408 (29795 in chips) 
Seat 3: dim@n.89liza (75172 in chips) 
Seat 4: jcarlos.vale (26908 in chips) 
Seat 5: kensui (14948 in chips) 
Seat 6: tusko8 (22273 in chips) 
Seat 8: Matzen10 (21782 in chips) 
Seat 9: Bobby Akselrod (21210 in chips) 
Ruslan5795: posts the ante 70
rato6408: posts the ante 70
dim@n.89liza: posts the ante 70
jcarlos.vale: posts the ante 70
kensui: posts the ante 70
tusko8: posts the ante 70
Matzen10: posts the ante 70
Bobby Akselrod: posts the ante 70
kensui: posts small blind 300
tusko8: posts big blind 600
*** HOLE CARDS ***
Dealt to jcarlos.vale [2s 8c]
Matzen10: folds 
Bobby Akselrod: folds 
Ruslan5795: folds 
rato6408: folds 
dim@n.89liza: raises 1200 to 1800
jcarlos.vale: folds 
kensui: folds 
tusko8: folds 
Uncalled bet (1200) returned to dim@n.89liza
dim@n.89liza collected 2060 from pot
dim@n.89liza: doesn't show handDTO
*** SUMMARY ***
Total pot 2060 | Rake 0 
Seat 1: Ruslan5795 folded before Flop (didn't bet)
Seat 2: rato6408 folded before Flop (didn't bet)
Seat 3: dim@n.89liza collected (2060)
Seat 4: jcarlos.vale (button) folded before Flop (didn't bet)
Seat 5: kensui (small blind) folded before Flop
Seat 6: tusko8 (big blind) folded before Flop
Seat 8: Matzen10 folded before Flop (didn't bet)
Seat 9: Bobby Akselrod folded before Flop (didn't bet)



PokerStars Hand #221904497393: Tournament #3082657132, $0.98+$0.12 USD Hold'em No Limit - Level XIV (300/600) - 2020/12/27 18:44:07 EET [2020/12/27 11:44:07 ET]
Table '3082657132 62' 9-max Seat #5 is the button
Seat 1: Ruslan5795 (20074 in chips) 
Seat 2: rato6408 (29725 in chips) 
Seat 3: dim@n.89liza (76562 in chips) 
Seat 4: jcarlos.vale (26838 in chips) 
Seat 5: kensui (14578 in chips) 
Seat 6: tusko8 (21603 in chips) 
Seat 8: Matzen10 (21712 in chips) 
Seat 9: Bobby Akselrod (21140 in chips) 
Ruslan5795: posts the ante 70
rato6408: posts the ante 70
dim@n.89liza: posts the ante 70
jcarlos.vale: posts the ante 70
kensui: posts the ante 70
tusko8: posts the ante 70
Matzen10: posts the ante 70
Bobby Akselrod: posts the ante 70
tusko8: posts small blind 300
Matzen10: posts big blind 600
*** HOLE CARDS ***
Dealt to jcarlos.vale [6c 8c]
Bobby Akselrod: folds 
Ruslan5795: calls 600
rato6408: folds 
dim@n.89liza: folds 
jcarlos.vale: calls 600
kensui: calls 600
tusko8: calls 300
Matzen10: checks 
*** FLOP *** [8s 3s Td]
tusko8: checks 
Matzen10: checks 
Ruslan5795: checks 
jcarlos.vale: bets 1200
kensui: folds 
tusko8: folds 
Matzen10: folds 
Ruslan5795: calls 1200
*** TURN *** [8s 3s Td] [Jh]
Ruslan5795: checks 
jcarlos.vale: checks 
*** RIVER *** [8s 3s Td Jh] [Jc]
Ruslan5795: checks 
jcarlos.vale: checks 
*** SHOW DOWN ***
Ruslan5795: shows [Ks Qs] (a pair of Jacks)
jcarlos.vale: shows [6c 8c] (two pair, Jacks and Eights)
jcarlos.vale collected 5960 from pot
*** SUMMARY ***
Total pot 5960 | Rake 0 
Board [8s 3s Td Jh Jc]
Seat 1: Ruslan5795 showed [Ks Qs] and lost with a pair of Jacks
Seat 2: rato6408 folded before Flop (didn't bet)
Seat 3: dim@n.89liza folded before Flop (didn't bet)
Seat 4: jcarlos.vale showed [6c 8c] and won (5960) with two pair, Jacks and Eights
Seat 5: kensui (button) folded on the Flop
Seat 6: tusko8 (small blind) folded on the Flop
Seat 8: Matzen10 (big blind) folded on the Flop
Seat 9: Bobby Akselrod folded before Flop (didn't bet)



PokerStars Hand #221904549339: Tournament #3082657132, $0.98+$0.12 USD Hold'em No Limit - Level XIV (300/600) - 2020/12/27 18:45:18 EET [2020/12/27 11:45:18 ET]
Table '3082657132 62' 9-max Seat #6 is the button
Seat 1: Ruslan5795 (18204 in chips) 
Seat 2: rato6408 (29655 in chips) 
Seat 3: dim@n.89liza (76492 in chips) 
Seat 4: jcarlos.vale (30928 in chips) 
Seat 5: kensui (13908 in chips) 
Seat 6: tusko8 (20933 in chips) 
Seat 7: nikitka3000 (27005 in chips) out of handDTO (moved from another table into small blind)
Seat 8: Matzen10 (21042 in chips) 
Seat 9: Bobby Akselrod (21070 in chips) 
nikitka3000 will be allowed to play after the button
Ruslan5795: posts the ante 70
rato6408: posts the ante 70
dim@n.89liza: posts the ante 70
jcarlos.vale: posts the ante 70
kensui: posts the ante 70
tusko8: posts the ante 70
Matzen10: posts the ante 70
Bobby Akselrod: posts the ante 70
Matzen10: posts small blind 300
Bobby Akselrod: posts big blind 600
*** HOLE CARDS ***
Dealt to jcarlos.vale [Qh Ks]
Ruslan5795: calls 600
rato6408: folds 
dim@n.89liza: folds 
jcarlos.vale: raises 960 to 1560
kensui: folds 
tusko8: folds 
Matzen10: folds 
Bobby Akselrod has timed out
Bobby Akselrod: folds 
Bobby Akselrod is sitting out
Bobby Akselrod has returned
Ruslan5795: calls 960
*** FLOP *** [Ad 6c Jd]
Ruslan5795: checks 
jcarlos.vale: checks 
*** TURN *** [Ad 6c Jd] [Kd]
Ruslan5795: checks 
jcarlos.vale: checks 
*** RIVER *** [Ad 6c Jd Kd] [5h]
Ruslan5795: checks 
jcarlos.vale: checks 
*** SHOW DOWN ***
Ruslan5795: shows [Qc 4s] (high pairOfCards Ace)
jcarlos.vale: shows [Qh Ks] (a pair of Kings)
jcarlos.vale collected 4580 from pot
*** SUMMARY ***
Total pot 4580 | Rake 0 
Board [Ad 6c Jd Kd 5h]
Seat 1: Ruslan5795 showed [Qc 4s] and lost with high pairOfCards Ace
Seat 2: rato6408 folded before Flop (didn't bet)
Seat 3: dim@n.89liza folded before Flop (didn't bet)
Seat 4: jcarlos.vale showed [Qh Ks] and won (4580) with a pair of Kings
Seat 5: kensui folded before Flop (didn't bet)
Seat 6: tusko8 (button) folded before Flop (didn't bet)
Seat 8: Matzen10 (small blind) folded before Flop
Seat 9: Bobby Akselrod (big blind) folded before Flop



PokerStars Hand #221904605213: Tournament #3082657132, $0.98+$0.12 USD Hold'em No Limit - Level XIV (300/600) - 2020/12/27 18:46:33 EET [2020/12/27 11:46:33 ET]
Table '3082657132 62' 9-max Seat #8 is the button
Seat 1: Ruslan5795 (16574 in chips) 
Seat 2: rato6408 (29585 in chips) 
Seat 3: dim@n.89liza (76422 in chips) 
Seat 4: jcarlos.vale (33878 in chips) 
Seat 5: kensui (13838 in chips) 
Seat 6: tusko8 (20863 in chips) 
Seat 7: nikitka3000 (27005 in chips) 
Seat 8: Matzen10 (20672 in chips) 
Seat 9: Bobby Akselrod (20400 in chips) 
Ruslan5795: posts the ante 70
rato6408: posts the ante 70
dim@n.89liza: posts the ante 70
jcarlos.vale: posts the ante 70
kensui: posts the ante 70
tusko8: posts the ante 70
nikitka3000: posts the ante 70
Matzen10: posts the ante 70
Bobby Akselrod: posts the ante 70
Bobby Akselrod: posts small blind 300
Ruslan5795: posts big blind 600
*** HOLE CARDS ***
Dealt to jcarlos.vale [Kh Tc]
rato6408: folds 
dim@n.89liza: folds 
jcarlos.vale: calls 600
kensui: calls 600
tusko8: folds 
nikitka3000: calls 600
Matzen10: calls 600
Bobby Akselrod: folds 
Ruslan5795: checks 
*** FLOP *** [Qh 9c 2c]
Ruslan5795: checks 
jcarlos.vale: checks 
kensui: checks 
nikitka3000: checks 
Matzen10: checks 
*** TURN *** [Qh 9c 2c] [Ac]
Ruslan5795: checks 
jcarlos.vale: checks 
kensui: checks 
nikitka3000: checks 
Matzen10: checks 
*** RIVER *** [Qh 9c 2c Ac] [9h]
Ruslan5795: checks 
jcarlos.vale: checks 
kensui: checks 
nikitka3000: checks 
Matzen10: bets 1200
Ruslan5795: folds 
jcarlos.vale: folds 
kensui: calls 1200
nikitka3000: folds 
*** SHOW DOWN ***
Matzen10: shows [8h Ah] (two pair, Aces and Nines)
kensui: shows [Jh As] (two pair, Aces and Nines)
kensui collected 3165 from pot
Matzen10 collected 3165 from pot
*** SUMMARY ***
Total pot 6330 | Rake 0 
Board [Qh 9c 2c Ac 9h]
Seat 1: Ruslan5795 (big blind) folded on the River
Seat 2: rato6408 folded before Flop (didn't bet)
Seat 3: dim@n.89liza folded before Flop (didn't bet)
Seat 4: jcarlos.vale folded on the River
Seat 5: kensui showed [Jh As] and won (3165) with two pair, Aces and Nines
Seat 6: tusko8 folded before Flop (didn't bet)
Seat 7: nikitka3000 folded on the River
Seat 8: Matzen10 (button) showed [8h Ah] and won (3165) with two pair, Aces and Nines
Seat 9: Bobby Akselrod (small blind) folded before Flop



PokerStars Hand #221904703089: Tournament #3082657132, $0.98+$0.12 USD Hold'em No Limit - Level XIV (300/600) - 2020/12/27 18:48:37 EET [2020/12/27 11:48:37 ET]
Table '3082657132 62' 9-max Seat #9 is the button
Seat 1: Ruslan5795 (15904 in chips) 
Seat 2: rato6408 (29515 in chips) 
Seat 3: dim@n.89liza (76352 in chips) 
Seat 4: jcarlos.vale (33208 in chips) 
Seat 5: kensui (15133 in chips) 
Seat 6: tusko8 (20793 in chips) 
Seat 7: nikitka3000 (26335 in chips) 
Seat 8: Matzen10 (21967 in chips) 
Seat 9: Bobby Akselrod (20030 in chips) 
Ruslan5795: posts the ante 70
rato6408: posts the ante 70
dim@n.89liza: posts the ante 70
jcarlos.vale: posts the ante 70
kensui: posts the ante 70
tusko8: posts the ante 70
nikitka3000: posts the ante 70
Matzen10: posts the ante 70
Bobby Akselrod: posts the ante 70
Ruslan5795: posts small blind 300
rato6408: posts big blind 600
*** HOLE CARDS ***
Dealt to jcarlos.vale [2c Jd]
dim@n.89liza: folds 
jcarlos.vale: folds 
kensui: folds 
tusko8: folds 
nikitka3000: folds 
Matzen10: raises 600 to 1200
Bobby Akselrod: folds 
Ruslan5795: calls 900
rato6408: folds 
*** FLOP *** [Th Qh 7c]
Ruslan5795: checks 
Matzen10: checks 
*** TURN *** [Th Qh 7c] [6d]
Ruslan5795: checks 
Matzen10: checks 
*** RIVER *** [Th Qh 7c 6d] [9c]
Ruslan5795: checks 
Matzen10: checks 
*** SHOW DOWN ***
Ruslan5795: shows [Ad Kc] (high pairOfCards Ace)
Matzen10: shows [3c 3d] (a pair of Threes)
Matzen10 collected 3630 from pot
*** SUMMARY ***
Total pot 3630 | Rake 0 
Board [Th Qh 7c 6d 9c]
Seat 1: Ruslan5795 (small blind) showed [Ad Kc] and lost with high pairOfCards Ace
Seat 2: rato6408 (big blind) folded before Flop
Seat 3: dim@n.89liza folded before Flop (didn't bet)
Seat 4: jcarlos.vale folded before Flop (didn't bet)
Seat 5: kensui folded before Flop (didn't bet)
Seat 6: tusko8 folded before Flop (didn't bet)
Seat 7: nikitka3000 folded before Flop (didn't bet)
Seat 8: Matzen10 showed [3c 3d] and won (3630) with a pair of Threes
Seat 9: Bobby Akselrod (button) folded before Flop (didn't bet)



PokerStars Hand #221904741650: Tournament #3082657132, $0.98+$0.12 USD Hold'em No Limit - Level XV (350/700) - 2020/12/27 18:49:29 EET [2020/12/27 11:49:29 ET]
Table '3082657132 62' 9-max Seat #1 is the button
Seat 1: Ruslan5795 (14634 in chips) 
Seat 2: rato6408 (28845 in chips) 
Seat 3: dim@n.89liza (76282 in chips) 
Seat 4: jcarlos.vale (33138 in chips) 
Seat 5: kensui (15063 in chips) 
Seat 6: tusko8 (20723 in chips) 
Seat 7: nikitka3000 (26265 in chips) 
Seat 8: Matzen10 (24327 in chips) 
Seat 9: Bobby Akselrod (19960 in chips) 
Ruslan5795: posts the ante 85
rato6408: posts the ante 85
dim@n.89liza: posts the ante 85
jcarlos.vale: posts the ante 85
kensui: posts the ante 85
tusko8: posts the ante 85
nikitka3000: posts the ante 85
Matzen10: posts the ante 85
Bobby Akselrod: posts the ante 85
rato6408: posts small blind 350
dim@n.89liza: posts big blind 700
*** HOLE CARDS ***
Dealt to jcarlos.vale [Ks 8c]
jcarlos.vale: folds 
kensui: folds 
tusko8: folds 
nikitka3000: folds 
Matzen10: raises 700 to 1400
Bobby Akselrod: folds 
Ruslan5795: calls 1400
rato6408: folds 
dim@n.89liza: calls 700
*** FLOP *** [8s Kc 4d]
dim@n.89liza: checks 
Matzen10: checks 
Ruslan5795: checks 
*** TURN *** [8s Kc 4d] [Kd]
dim@n.89liza: bets 1050
Matzen10: folds 
Ruslan5795: calls 1050
*** RIVER *** [8s Kc 4d Kd] [5c]
dim@n.89liza: bets 3150
Ruslan5795: calls 3150
*** SHOW DOWN ***
dim@n.89liza: shows [2c Ad] (a pair of Kings)
Ruslan5795: shows [As Qs] (a pair of Kings - Ace+Queen kicker)
Ruslan5795 collected 13715 from pot
*** SUMMARY ***
Total pot 13715 | Rake 0 
Board [8s Kc 4d Kd 5c]
Seat 1: Ruslan5795 (button) showed [As Qs] and won (13715) with a pair of Kings
Seat 2: rato6408 (small blind) folded before Flop
Seat 3: dim@n.89liza (big blind) showed [2c Ad] and lost with a pair of Kings
Seat 4: jcarlos.vale folded before Flop (didn't bet)
Seat 5: kensui folded before Flop (didn't bet)
Seat 6: tusko8 folded before Flop (didn't bet)
Seat 7: nikitka3000 folded before Flop (didn't bet)
Seat 8: Matzen10 folded on the Turn
Seat 9: Bobby Akselrod folded before Flop (didn't bet)



PokerStars Hand #221904791404: Tournament #3082657132, $0.98+$0.12 USD Hold'em No Limit - Level XV (350/700) - 2020/12/27 18:50:37 EET [2020/12/27 11:50:37 ET]
Table '3082657132 62' 9-max Seat #2 is the button
Seat 1: Ruslan5795 (22664 in chips) 
Seat 2: rato6408 (28410 in chips) 
Seat 3: dim@n.89liza (70597 in chips) 
Seat 4: jcarlos.vale (33053 in chips) 
Seat 5: kensui (14978 in chips) 
Seat 6: tusko8 (20638 in chips) 
Seat 7: nikitka3000 (26180 in chips) 
Seat 8: Matzen10 (22842 in chips) 
Seat 9: Bobby Akselrod (19875 in chips) 
Ruslan5795: posts the ante 85
rato6408: posts the ante 85
dim@n.89liza: posts the ante 85
jcarlos.vale: posts the ante 85
kensui: posts the ante 85
tusko8: posts the ante 85
nikitka3000: posts the ante 85
Matzen10: posts the ante 85
Bobby Akselrod: posts the ante 85
dim@n.89liza: posts small blind 350
jcarlos.vale: posts big blind 700
*** HOLE CARDS ***
Dealt to jcarlos.vale [5s 8c]
kensui: raises 812 to 1512
tusko8: folds 
nikitka3000: folds 
Matzen10: folds 
Bobby Akselrod: folds 
Ruslan5795: calls 1512
rato6408: folds 
dim@n.89liza: calls 1162
jcarlos.vale: folds 
*** FLOP *** [2c 5h 3s]
dim@n.89liza: checks 
kensui: checks 
Ruslan5795: checks 
*** TURN *** [2c 5h 3s] [Kd]
dim@n.89liza: bets 2800
kensui: folds 
Ruslan5795: calls 2800
*** RIVER *** [2c 5h 3s Kd] [8d]
dim@n.89liza: checks 
Ruslan5795: checks 
*** SHOW DOWN ***
dim@n.89liza: shows [6h 2h] (a pair of Deuces)
Ruslan5795: mucks handDTO
dim@n.89liza collected 11601 from pot
*** SUMMARY ***
Total pot 11601 | Rake 0 
Board [2c 5h 3s Kd 8d]
Seat 1: Ruslan5795 mucked [Qd Th]
Seat 2: rato6408 (button) folded before Flop (didn't bet)
Seat 3: dim@n.89liza (small blind) showed [6h 2h] and won (11601) with a pair of Deuces
Seat 4: jcarlos.vale (big blind) folded before Flop
Seat 5: kensui folded on the Turn
Seat 6: tusko8 folded before Flop (didn't bet)
Seat 7: nikitka3000 folded before Flop (didn't bet)
Seat 8: Matzen10 folded before Flop (didn't bet)
Seat 9: Bobby Akselrod folded before Flop (didn't bet)



PokerStars Hand #221904836502: Tournament #3082657132, $0.98+$0.12 USD Hold'em No Limit - Level XV (350/700) - 2020/12/27 18:51:38 EET [2020/12/27 11:51:38 ET]
Table '3082657132 62' 9-max Seat #3 is the button
Seat 1: Ruslan5795 (18267 in chips) 
Seat 2: rato6408 (28325 in chips) 
Seat 3: dim@n.89liza (77801 in chips) 
Seat 4: jcarlos.vale (32268 in chips) 
Seat 5: kensui (13381 in chips) 
Seat 6: tusko8 (20553 in chips) 
Seat 7: nikitka3000 (26095 in chips) 
Seat 8: Matzen10 (22757 in chips) 
Seat 9: Bobby Akselrod (19790 in chips) 
Ruslan5795: posts the ante 85
rato6408: posts the ante 85
dim@n.89liza: posts the ante 85
jcarlos.vale: posts the ante 85
kensui: posts the ante 85
tusko8: posts the ante 85
nikitka3000: posts the ante 85
Matzen10: posts the ante 85
Bobby Akselrod: posts the ante 85
jcarlos.vale: posts small blind 350
kensui: posts big blind 700
*** HOLE CARDS ***
Dealt to jcarlos.vale [Kc 4c]
tusko8: folds 
nikitka3000: raises 700 to 1400
Matzen10: folds 
Bobby Akselrod: raises 18305 to 19705 and is all-in
Ruslan5795: folds 
rato6408: folds 
dim@n.89liza: folds 
jcarlos.vale: folds 
kensui: calls 12596 and is all-in
nikitka3000: folds 
Uncalled bet (6409) returned to Bobby Akselrod
*** FLOP *** [Ks Qs 3c]
*** TURN *** [Ks Qs 3c] [2d]
*** RIVER *** [Ks Qs 3c 2d] [7h]
*** SHOW DOWN ***
kensui: shows [Qc Ah] (a pair of Queens)
Bobby Akselrod: shows [Jh Jc] (a pair of Jacks)
kensui collected 29107 from pot
*** SUMMARY ***
Total pot 29107 | Rake 0 
Board [Ks Qs 3c 2d 7h]
Seat 1: Ruslan5795 folded before Flop (didn't bet)
Seat 2: rato6408 folded before Flop (didn't bet)
Seat 3: dim@n.89liza (button) folded before Flop (didn't bet)
Seat 4: jcarlos.vale (small blind) folded before Flop
Seat 5: kensui (big blind) showed [Qc Ah] and won (29107) with a pair of Queens
Seat 6: tusko8 folded before Flop (didn't bet)
Seat 7: nikitka3000 folded before Flop
Seat 8: Matzen10 folded before Flop (didn't bet)
Seat 9: Bobby Akselrod showed [Jh Jc] and lost with a pair of Jacks



PokerStars Hand #221904887348: Tournament #3082657132, $0.98+$0.12 USD Hold'em No Limit - Level XV (350/700) - 2020/12/27 18:52:48 EET [2020/12/27 11:52:48 ET]
Table '3082657132 62' 9-max Seat #4 is the button
Seat 1: Ruslan5795 (18182 in chips) 
Seat 2: rato6408 (28240 in chips) 
Seat 3: dim@n.89liza (77716 in chips) 
Seat 4: jcarlos.vale (31833 in chips) 
Seat 5: kensui (29107 in chips) 
Seat 6: tusko8 (20468 in chips) 
Seat 7: nikitka3000 (24610 in chips) 
Seat 8: Matzen10 (22672 in chips) 
Seat 9: Bobby Akselrod (6409 in chips) 
Ruslan5795: posts the ante 85
rato6408: posts the ante 85
dim@n.89liza: posts the ante 85
jcarlos.vale: posts the ante 85
kensui: posts the ante 85
tusko8: posts the ante 85
nikitka3000: posts the ante 85
Matzen10: posts the ante 85
Bobby Akselrod: posts the ante 85
kensui: posts small blind 350
tusko8: posts big blind 700
*** HOLE CARDS ***
Dealt to jcarlos.vale [Qc 2c]
nikitka3000: folds 
Matzen10: folds 
Bobby Akselrod: folds 
Ruslan5795: folds 
rato6408: folds 
dim@n.89liza: folds 
jcarlos.vale: folds 
kensui: raises 812 to 1512
tusko8: raises 18871 to 20383 and is all-in
kensui has timed out
kensui: folds 
kensui is sitting out
Uncalled bet (18871) returned to tusko8
tusko8 collected 3789 from pot
*** SUMMARY ***
Total pot 3789 | Rake 0 
Seat 1: Ruslan5795 folded before Flop (didn't bet)
Seat 2: rato6408 folded before Flop (didn't bet)
Seat 3: dim@n.89liza folded before Flop (didn't bet)
Seat 4: jcarlos.vale (button) folded before Flop (didn't bet)
Seat 5: kensui (small blind) folded before Flop
Seat 6: tusko8 (big blind) collected (3789)
Seat 7: nikitka3000 folded before Flop (didn't bet)
Seat 8: Matzen10 folded before Flop (didn't bet)
Seat 9: Bobby Akselrod folded before Flop (didn't bet)



PokerStars Hand #221904924525: Tournament #3082657132, $0.98+$0.12 USD Hold'em No Limit - Level XV (350/700) - 2020/12/27 18:53:38 EET [2020/12/27 11:53:38 ET]
Table '3082657132 62' 9-max Seat #5 is the button
Seat 1: Ruslan5795 (18097 in chips) 
Seat 2: rato6408 (28155 in chips) 
Seat 3: dim@n.89liza (77631 in chips) 
Seat 4: jcarlos.vale (31748 in chips) 
Seat 5: kensui (27510 in chips) is sitting out
Seat 6: tusko8 (22660 in chips) 
Seat 7: nikitka3000 (24525 in chips) 
Seat 8: Matzen10 (22587 in chips) 
Seat 9: Bobby Akselrod (6324 in chips) 
Ruslan5795: posts the ante 85
rato6408: posts the ante 85
dim@n.89liza: posts the ante 85
jcarlos.vale: posts the ante 85
kensui: posts the ante 85
tusko8: posts the ante 85
nikitka3000: posts the ante 85
Matzen10: posts the ante 85
Bobby Akselrod: posts the ante 85
tusko8: posts small blind 350
nikitka3000: posts big blind 700
*** HOLE CARDS ***
Dealt to jcarlos.vale [3h 6h]
kensui has returned
Matzen10: folds 
Bobby Akselrod: folds 
Ruslan5795: folds 
rato6408: folds 
dim@n.89liza: folds 
jcarlos.vale: folds 
kensui: folds 
tusko8: raises 700 to 1400
nikitka3000: calls 700
*** FLOP *** [Kd 6d Js]
tusko8: bets 700
nikitka3000: calls 700
*** TURN *** [Kd 6d Js] [8s]
tusko8: bets 4900
nikitka3000: folds 
Uncalled bet (4900) returned to tusko8
tusko8 collected 4965 from pot
tusko8: doesn't show handDTO
*** SUMMARY ***
Total pot 4965 | Rake 0 
Board [Kd 6d Js 8s]
Seat 1: Ruslan5795 folded before Flop (didn't bet)
Seat 2: rato6408 folded before Flop (didn't bet)
Seat 3: dim@n.89liza folded before Flop (didn't bet)
Seat 4: jcarlos.vale folded before Flop (didn't bet)
Seat 5: kensui (button) folded before Flop (didn't bet)
Seat 6: tusko8 (small blind) collected (4965)
Seat 7: nikitka3000 (big blind) folded on the Turn
Seat 8: Matzen10 folded before Flop (didn't bet)
Seat 9: Bobby Akselrod folded before Flop (didn't bet)



PokerStars Hand #221904970758: Tournament #3082657132, $0.98+$0.12 USD Hold'em No Limit - Level XV (350/700) - 2020/12/27 18:54:41 EET [2020/12/27 11:54:41 ET]
Table '3082657132 62' 9-max Seat #6 is the button
Seat 1: Ruslan5795 (18012 in chips) 
Seat 2: rato6408 (28070 in chips) 
Seat 3: dim@n.89liza (77546 in chips) 
Seat 4: jcarlos.vale (31663 in chips) 
Seat 5: kensui (27425 in chips) 
Seat 6: tusko8 (25440 in chips) 
Seat 7: nikitka3000 (22340 in chips) 
Seat 8: Matzen10 (22502 in chips) 
Seat 9: Bobby Akselrod (6239 in chips) 
Ruslan5795: posts the ante 85
rato6408: posts the ante 85
dim@n.89liza: posts the ante 85
jcarlos.vale: posts the ante 85
kensui: posts the ante 85
tusko8: posts the ante 85
nikitka3000: posts the ante 85
Matzen10: posts the ante 85
Bobby Akselrod: posts the ante 85
nikitka3000: posts small blind 350
Matzen10: posts big blind 700
*** HOLE CARDS ***
Dealt to jcarlos.vale [3c Ad]
Bobby Akselrod: folds 
Ruslan5795: calls 700
rato6408: folds 
dim@n.89liza: raises 1750 to 2450
jcarlos.vale: folds 
kensui: folds 
tusko8: folds 
nikitka3000: folds 
Matzen10: calls 1750
Ruslan5795: calls 1750
*** FLOP *** [Th 6s 6d]
Matzen10: checks 
Ruslan5795: checks 
dim@n.89liza: bets 1750
Matzen10: folds 
Ruslan5795: calls 1750
*** TURN *** [Th 6s 6d] [7c]
Ruslan5795: checks 
dim@n.89liza: checks 
*** RIVER *** [Th 6s 6d 7c] [As]
Ruslan5795: bets 11965
dim@n.89liza: folds 
Uncalled bet (11965) returned to Ruslan5795
Ruslan5795 collected 11965 from pot
*** SUMMARY ***
Total pot 11965 | Rake 0 
Board [Th 6s 6d 7c As]
Seat 1: Ruslan5795 collected (11965)
Seat 2: rato6408 folded before Flop (didn't bet)
Seat 3: dim@n.89liza folded on the River
Seat 4: jcarlos.vale folded before Flop (didn't bet)
Seat 5: kensui folded before Flop (didn't bet)
Seat 6: tusko8 (button) folded before Flop (didn't bet)
Seat 7: nikitka3000 (small blind) folded before Flop
Seat 8: Matzen10 (big blind) folded on the Flop
Seat 9: Bobby Akselrod folded before Flop (didn't bet)



PokerStars Hand #221905188830: Tournament #3082657132, $0.98+$0.12 USD Hold'em No Limit - Level XV (350/700) - 2020/12/27 19:01:23 EET [2020/12/27 12:01:23 ET]
Table '3082657132 62' 9-max Seat #7 is the button
Seat 1: Ruslan5795 (25692 in chips) 
Seat 2: rato6408 (27985 in chips) 
Seat 3: dim@n.89liza (73261 in chips) 
Seat 4: jcarlos.vale (31578 in chips) 
Seat 5: kensui (27340 in chips) 
Seat 6: tusko8 (25355 in chips) 
Seat 7: nikitka3000 (21905 in chips) 
Seat 8: Matzen10 (19967 in chips) 
Seat 9: Bobby Akselrod (6154 in chips) 
Ruslan5795: posts the ante 85
rato6408: posts the ante 85
dim@n.89liza: posts the ante 85
jcarlos.vale: posts the ante 85
kensui: posts the ante 85
tusko8: posts the ante 85
nikitka3000: posts the ante 85
Matzen10: posts the ante 85
Bobby Akselrod: posts the ante 85
Matzen10: posts small blind 350
Bobby Akselrod: posts big blind 700
*** HOLE CARDS ***
Dealt to jcarlos.vale [5h Jh]
Ruslan5795: folds 
rato6408: folds 
dim@n.89liza: raises 1400 to 2100
jcarlos.vale: folds 
kensui: folds 
tusko8: folds 
nikitka3000: raises 3500 to 5600
Matzen10: folds 
Bobby Akselrod: folds 
dim@n.89liza: raises 67576 to 73176 and is all-in
nikitka3000: calls 16220 and is all-in
Uncalled bet (51356) returned to dim@n.89liza
*** FLOP *** [Jc 3d 4h]
*** TURN *** [Jc 3d 4h] [8c]
*** RIVER *** [Jc 3d 4h 8c] [9d]
*** SHOW DOWN ***
dim@n.89liza: shows [Th Tc] (a pair of Tens)
nikitka3000: shows [Qc Qs] (a pair of Queens)
nikitka3000 collected 45455 from pot
*** SUMMARY ***
Total pot 45455 | Rake 0 
Board [Jc 3d 4h 8c 9d]
Seat 1: Ruslan5795 folded before Flop (didn't bet)
Seat 2: rato6408 folded before Flop (didn't bet)
Seat 3: dim@n.89liza showed [Th Tc] and lost with a pair of Tens
Seat 4: jcarlos.vale folded before Flop (didn't bet)
Seat 5: kensui folded before Flop (didn't bet)
Seat 6: tusko8 folded before Flop (didn't bet)
Seat 7: nikitka3000 (button) showed [Qc Qs] and won (45455) with a pair of Queens
Seat 8: Matzen10 (small blind) folded before Flop
Seat 9: Bobby Akselrod (big blind) folded before Flop



PokerStars Hand #221905222123: Tournament #3082657132, $0.98+$0.12 USD Hold'em No Limit - Level XV (350/700) - 2020/12/27 19:02:13 EET [2020/12/27 12:02:13 ET]
Table '3082657132 62' 9-max Seat #8 is the button
Seat 1: Ruslan5795 (25607 in chips) 
Seat 2: rato6408 (27900 in chips) 
Seat 3: dim@n.89liza (51356 in chips) 
Seat 4: jcarlos.vale (31493 in chips) 
Seat 5: kensui (27255 in chips) 
Seat 6: tusko8 (25270 in chips) 
Seat 7: nikitka3000 (45455 in chips) 
Seat 8: Matzen10 (19532 in chips) 
Seat 9: Bobby Akselrod (5369 in chips) 
Ruslan5795: posts the ante 85
rato6408: posts the ante 85
dim@n.89liza: posts the ante 85
jcarlos.vale: posts the ante 85
kensui: posts the ante 85
tusko8: posts the ante 85
nikitka3000: posts the ante 85
Matzen10: posts the ante 85
Bobby Akselrod: posts the ante 85
Bobby Akselrod: posts small blind 350
Ruslan5795: posts big blind 700
*** HOLE CARDS ***
Dealt to jcarlos.vale [5h 6d]
rato6408: raises 840 to 1540
dim@n.89liza: folds 
jcarlos.vale: folds 
kensui: folds 
tusko8: folds 
nikitka3000: folds 
Matzen10: folds 
Bobby Akselrod: folds 
Ruslan5795: calls 840
*** FLOP *** [3h 2h Jd]
Ruslan5795: checks 
rato6408: bets 2098
Ruslan5795: calls 2098
*** TURN *** [3h 2h Jd] [2d]
Ruslan5795: checks 
rato6408: checks 
*** RIVER *** [3h 2h Jd 2d] [Kd]
Ruslan5795: checks 
rato6408: checks 
*** SHOW DOWN ***
Ruslan5795: shows [Ah 4c] (a pair of Deuces)
rato6408: shows [9s 9c] (two pair, Nines and Deuces)
rato6408 collected 8391 from pot
*** SUMMARY ***
Total pot 8391 | Rake 0 
Board [3h 2h Jd 2d Kd]
Seat 1: Ruslan5795 (big blind) showed [Ah 4c] and lost with a pair of Deuces
Seat 2: rato6408 showed [9s 9c] and won (8391) with two pair, Nines and Deuces
Seat 3: dim@n.89liza folded before Flop (didn't bet)
Seat 4: jcarlos.vale folded before Flop (didn't bet)
Seat 5: kensui folded before Flop (didn't bet)
Seat 6: tusko8 folded before Flop (didn't bet)
Seat 7: nikitka3000 folded before Flop (didn't bet)
Seat 8: Matzen10 (button) folded before Flop (didn't bet)
Seat 9: Bobby Akselrod (small blind) folded before Flop



PokerStars Hand #221905260683: Tournament #3082657132, $0.98+$0.12 USD Hold'em No Limit - Level XV (350/700) - 2020/12/27 19:03:06 EET [2020/12/27 12:03:06 ET]
Table '3082657132 62' 9-max Seat #9 is the button
Seat 1: Ruslan5795 (21884 in chips) 
Seat 2: rato6408 (32568 in chips) 
Seat 3: dim@n.89liza (51271 in chips) 
Seat 4: jcarlos.vale (31408 in chips) 
Seat 5: kensui (27170 in chips) 
Seat 6: tusko8 (25185 in chips) 
Seat 7: nikitka3000 (45370 in chips) 
Seat 8: Matzen10 (19447 in chips) 
Seat 9: Bobby Akselrod (4934 in chips) 
Ruslan5795: posts the ante 85
rato6408: posts the ante 85
dim@n.89liza: posts the ante 85
jcarlos.vale: posts the ante 85
kensui: posts the ante 85
tusko8: posts the ante 85
nikitka3000: posts the ante 85
Matzen10: posts the ante 85
Bobby Akselrod: posts the ante 85
Ruslan5795: posts small blind 350
rato6408: posts big blind 700
*** HOLE CARDS ***
Dealt to jcarlos.vale [4s 2s]
dim@n.89liza: raises 1400 to 2100
jcarlos.vale: folds 
kensui: folds 
tusko8: folds 
nikitka3000: folds 
Matzen10: raises 3850 to 5950
Bobby Akselrod: folds 
Ruslan5795: folds 
rato6408: folds 
dim@n.89liza: raises 45236 to 51186 and is all-in
Matzen10: calls 13412 and is all-in
Uncalled bet (31824) returned to dim@n.89liza
*** FLOP *** [6h Jc 4d]
*** TURN *** [6h Jc 4d] [2c]
*** RIVER *** [6h Jc 4d 2c] [6d]
*** SHOW DOWN ***
dim@n.89liza: shows [8d 9d] (a pair of Sixes)
Matzen10: shows [As Ac] (two pair, Aces and Sixes)
Matzen10 collected 40539 from pot
*** SUMMARY ***
Total pot 40539 | Rake 0 
Board [6h Jc 4d 2c 6d]
Seat 1: Ruslan5795 (small blind) folded before Flop
Seat 2: rato6408 (big blind) folded before Flop
Seat 3: dim@n.89liza showed [8d 9d] and lost with a pair of Sixes
Seat 4: jcarlos.vale folded before Flop (didn't bet)
Seat 5: kensui folded before Flop (didn't bet)
Seat 6: tusko8 folded before Flop (didn't bet)
Seat 7: nikitka3000 folded before Flop (didn't bet)
Seat 8: Matzen10 showed [As Ac] and won (40539) with two pair, Aces and Sixes
Seat 9: Bobby Akselrod (button) folded before Flop (didn't bet)



PokerStars Hand #221905291196: Tournament #3082657132, $0.98+$0.12 USD Hold'em No Limit - Level XV (350/700) - 2020/12/27 19:03:48 EET [2020/12/27 12:03:48 ET]
Table '3082657132 62' 9-max Seat #1 is the button
Seat 1: Ruslan5795 (21449 in chips) 
Seat 2: rato6408 (31783 in chips) 
Seat 3: dim@n.89liza (31824 in chips) 
Seat 4: jcarlos.vale (31323 in chips) 
Seat 5: kensui (27085 in chips) 
Seat 6: tusko8 (25100 in chips) 
Seat 7: nikitka3000 (45285 in chips) 
Seat 8: Matzen10 (40539 in chips) 
Seat 9: Bobby Akselrod (4849 in chips) 
Ruslan5795: posts the ante 85
rato6408: posts the ante 85
dim@n.89liza: posts the ante 85
jcarlos.vale: posts the ante 85
kensui: posts the ante 85
tusko8: posts the ante 85
nikitka3000: posts the ante 85
Matzen10: posts the ante 85
Bobby Akselrod: posts the ante 85
rato6408: posts small blind 350
dim@n.89liza: posts big blind 700
*** HOLE CARDS ***
Dealt to jcarlos.vale [6s 8s]
jcarlos.vale: folds 
kensui: folds 
tusko8: folds 
nikitka3000: raises 700 to 1400
Matzen10: folds 
Bobby Akselrod: folds 
Ruslan5795: folds 
rato6408: folds 
dim@n.89liza: folds 
Uncalled bet (700) returned to nikitka3000
nikitka3000 collected 2515 from pot
*** SUMMARY ***
Total pot 2515 | Rake 0 
Seat 1: Ruslan5795 (button) folded before Flop (didn't bet)
Seat 2: rato6408 (small blind) folded before Flop
Seat 3: dim@n.89liza (big blind) folded before Flop
Seat 4: jcarlos.vale folded before Flop (didn't bet)
Seat 5: kensui folded before Flop (didn't bet)
Seat 6: tusko8 folded before Flop (didn't bet)
Seat 7: nikitka3000 collected (2515)
Seat 8: Matzen10 folded before Flop (didn't bet)
Seat 9: Bobby Akselrod folded before Flop (didn't bet)



PokerStars Hand #221905318067: Tournament #3082657132, $0.98+$0.12 USD Hold'em No Limit - Level XV (350/700) - 2020/12/27 19:04:24 EET [2020/12/27 12:04:24 ET]
Table '3082657132 62' 9-max Seat #2 is the button
Seat 1: Ruslan5795 (21364 in chips) 
Seat 2: rato6408 (31348 in chips) 
Seat 3: dim@n.89liza (31039 in chips) 
Seat 4: jcarlos.vale (31238 in chips) 
Seat 5: kensui (27000 in chips) 
Seat 6: tusko8 (25015 in chips) 
Seat 7: nikitka3000 (47015 in chips) 
Seat 8: Matzen10 (40454 in chips) 
Seat 9: Bobby Akselrod (4764 in chips) 
Ruslan5795: posts the ante 85
rato6408: posts the ante 85
dim@n.89liza: posts the ante 85
jcarlos.vale: posts the ante 85
kensui: posts the ante 85
tusko8: posts the ante 85
nikitka3000: posts the ante 85
Matzen10: posts the ante 85
Bobby Akselrod: posts the ante 85
dim@n.89liza: posts small blind 350
jcarlos.vale: posts big blind 700
*** HOLE CARDS ***
Dealt to jcarlos.vale [6c 8s]
kensui: raises 812 to 1512
tusko8: folds 
nikitka3000: calls 1512
Matzen10: folds 
Bobby Akselrod: folds 
Ruslan5795: folds 
rato6408: folds 
dim@n.89liza: folds 
jcarlos.vale: folds 
*** FLOP *** [Ks 9c Qd]
kensui: bets 2420
nikitka3000: folds 
Uncalled bet (2420) returned to kensui
kensui collected 4839 from pot
kensui: doesn't show handDTO
*** SUMMARY ***
Total pot 4839 | Rake 0 
Board [Ks 9c Qd]
Seat 1: Ruslan5795 folded before Flop (didn't bet)
Seat 2: rato6408 (button) folded before Flop (didn't bet)
Seat 3: dim@n.89liza (small blind) folded before Flop
Seat 4: jcarlos.vale (big blind) folded before Flop
Seat 5: kensui collected (4839)
Seat 6: tusko8 folded before Flop (didn't bet)
Seat 7: nikitka3000 folded on the Flop
Seat 8: Matzen10 folded before Flop (didn't bet)
Seat 9: Bobby Akselrod folded before Flop (didn't bet)



PokerStars Hand #221905358716: Tournament #3082657132, $0.98+$0.12 USD Hold'em No Limit - Level XVI (400/800) - 2020/12/27 19:05:19 EET [2020/12/27 12:05:19 ET]
Table '3082657132 62' 9-max Seat #3 is the button
Seat 1: Ruslan5795 (21279 in chips) 
Seat 2: rato6408 (31263 in chips) 
Seat 3: dim@n.89liza (30604 in chips) 
Seat 4: jcarlos.vale (30453 in chips) 
Seat 5: kensui (30242 in chips) 
Seat 6: tusko8 (24930 in chips) 
Seat 7: nikitka3000 (45418 in chips) 
Seat 8: Matzen10 (40369 in chips) 
Seat 9: Bobby Akselrod (4679 in chips) 
Ruslan5795: posts the ante 100
rato6408: posts the ante 100
dim@n.89liza: posts the ante 100
jcarlos.vale: posts the ante 100
kensui: posts the ante 100
tusko8: posts the ante 100
nikitka3000: posts the ante 100
Matzen10: posts the ante 100
Bobby Akselrod: posts the ante 100
jcarlos.vale: posts small blind 400
kensui: posts big blind 800
*** HOLE CARDS ***
Dealt to jcarlos.vale [Qh 9h]
tusko8: folds 
nikitka3000: folds 
Matzen10: folds 
Bobby Akselrod: folds 
Ruslan5795 has timed out
Ruslan5795: folds 
Ruslan5795 is sitting out
rato6408: raises 960 to 1760
Ruslan5795 has returned
dim@n.89liza: raises 4640 to 6400
jcarlos.vale: folds 
kensui: folds 
rato6408: calls 4640
*** FLOP *** [3d 5h Ad]
rato6408: checks 
dim@n.89liza: bets 24104 and is all-in
rato6408: folds 
Uncalled bet (24104) returned to dim@n.89liza
dim@n.89liza collected 14900 from pot
dim@n.89liza: doesn't show handDTO
*** SUMMARY ***
Total pot 14900 | Rake 0 
Board [3d 5h Ad]
Seat 1: Ruslan5795 folded before Flop (didn't bet)
Seat 2: rato6408 folded on the Flop
Seat 3: dim@n.89liza (button) collected (14900)
Seat 4: jcarlos.vale (small blind) folded before Flop
Seat 5: kensui (big blind) folded before Flop
Seat 6: tusko8 folded before Flop (didn't bet)
Seat 7: nikitka3000 folded before Flop (didn't bet)
Seat 8: Matzen10 folded before Flop (didn't bet)
Seat 9: Bobby Akselrod folded before Flop (didn't bet)



PokerStars Hand #221905400280: Tournament #3082657132, $0.98+$0.12 USD Hold'em No Limit - Level XVI (400/800) - 2020/12/27 19:06:14 EET [2020/12/27 12:06:14 ET]
Table '3082657132 62' 9-max Seat #4 is the button
Seat 1: Ruslan5795 (21179 in chips) 
Seat 2: rato6408 (24763 in chips) 
Seat 3: dim@n.89liza (39004 in chips) 
Seat 4: jcarlos.vale (29953 in chips) 
Seat 5: kensui (29342 in chips) 
Seat 6: tusko8 (24830 in chips) 
Seat 7: nikitka3000 (45318 in chips) 
Seat 8: Matzen10 (40269 in chips) 
Seat 9: Bobby Akselrod (4579 in chips) 
Ruslan5795: posts the ante 100
rato6408: posts the ante 100
dim@n.89liza: posts the ante 100
jcarlos.vale: posts the ante 100
kensui: posts the ante 100
tusko8: posts the ante 100
nikitka3000: posts the ante 100
Matzen10: posts the ante 100
Bobby Akselrod: posts the ante 100
kensui: posts small blind 400
tusko8: posts big blind 800
*** HOLE CARDS ***
Dealt to jcarlos.vale [6s 8h]
nikitka3000: folds 
Matzen10: raises 800 to 1600
Bobby Akselrod: folds 
Ruslan5795: folds 
rato6408: raises 4000 to 5600
dim@n.89liza: folds 
jcarlos.vale: folds 
kensui: folds 
tusko8: folds 
Matzen10: folds 
Uncalled bet (4000) returned to rato6408
rato6408 collected 5300 from pot
rato6408: doesn't show handDTO
*** SUMMARY ***
Total pot 5300 | Rake 0 
Seat 1: Ruslan5795 folded before Flop (didn't bet)
Seat 2: rato6408 collected (5300)
Seat 3: dim@n.89liza folded before Flop (didn't bet)
Seat 4: jcarlos.vale (button) folded before Flop (didn't bet)
Seat 5: kensui (small blind) folded before Flop
Seat 6: tusko8 (big blind) folded before Flop
Seat 7: nikitka3000 folded before Flop (didn't bet)
Seat 8: Matzen10 folded before Flop
Seat 9: Bobby Akselrod folded before Flop (didn't bet)



PokerStars Hand #221905429732: Tournament #3082657132, $0.98+$0.12 USD Hold'em No Limit - Level XVI (400/800) - 2020/12/27 19:06:54 EET [2020/12/27 12:06:54 ET]
Table '3082657132 62' 9-max Seat #5 is the button
Seat 1: Ruslan5795 (21079 in chips) 
Seat 2: rato6408 (28363 in chips) 
Seat 3: dim@n.89liza (38904 in chips) 
Seat 4: jcarlos.vale (29853 in chips) 
Seat 5: kensui (28842 in chips) 
Seat 6: tusko8 (23930 in chips) 
Seat 7: nikitka3000 (45218 in chips) 
Seat 8: Matzen10 (38569 in chips) 
Seat 9: Bobby Akselrod (4479 in chips) 
Ruslan5795: posts the ante 100
rato6408: posts the ante 100
dim@n.89liza: posts the ante 100
jcarlos.vale: posts the ante 100
kensui: posts the ante 100
tusko8: posts the ante 100
nikitka3000: posts the ante 100
Matzen10: posts the ante 100
Bobby Akselrod: posts the ante 100
tusko8: posts small blind 400
nikitka3000: posts big blind 800
*** HOLE CARDS ***
Dealt to jcarlos.vale [2s 4s]
Matzen10: folds 
Bobby Akselrod: folds 
Ruslan5795: folds 
rato6408: folds 
dim@n.89liza: raises 1600 to 2400
jcarlos.vale: folds 
kensui: folds 
tusko8: folds 
nikitka3000: calls 1600
*** FLOP *** [9s 9d 5s]
nikitka3000: checks 
dim@n.89liza: bets 3200
nikitka3000: folds 
Uncalled bet (3200) returned to dim@n.89liza
dim@n.89liza collected 6100 from pot
dim@n.89liza: doesn't show handDTO
*** SUMMARY ***
Total pot 6100 | Rake 0 
Board [9s 9d 5s]
Seat 1: Ruslan5795 folded before Flop (didn't bet)
Seat 2: rato6408 folded before Flop (didn't bet)
Seat 3: dim@n.89liza collected (6100)
Seat 4: jcarlos.vale folded before Flop (didn't bet)
Seat 5: kensui (button) folded before Flop (didn't bet)
Seat 6: tusko8 (small blind) folded before Flop
Seat 7: nikitka3000 (big blind) folded on the Flop
Seat 8: Matzen10 folded before Flop (didn't bet)
Seat 9: Bobby Akselrod folded before Flop (didn't bet)



PokerStars Hand #221905472016: Tournament #3082657132, $0.98+$0.12 USD Hold'em No Limit - Level XVI (400/800) - 2020/12/27 19:07:50 EET [2020/12/27 12:07:50 ET]
Table '3082657132 62' 9-max Seat #6 is the button
Seat 1: Ruslan5795 (20979 in chips) 
Seat 2: rato6408 (28263 in chips) 
Seat 3: dim@n.89liza (42504 in chips) 
Seat 4: jcarlos.vale (29753 in chips) 
Seat 5: kensui (28742 in chips) 
Seat 6: tusko8 (23430 in chips) 
Seat 7: nikitka3000 (42718 in chips) 
Seat 8: Matzen10 (38469 in chips) 
Seat 9: Bobby Akselrod (4379 in chips) 
Ruslan5795: posts the ante 100
rato6408: posts the ante 100
dim@n.89liza: posts the ante 100
jcarlos.vale: posts the ante 100
kensui: posts the ante 100
tusko8: posts the ante 100
nikitka3000: posts the ante 100
Matzen10: posts the ante 100
Bobby Akselrod: posts the ante 100
nikitka3000: posts small blind 400
Matzen10: posts big blind 800
*** HOLE CARDS ***
Dealt to jcarlos.vale [As 5d]
Bobby Akselrod: folds 
Ruslan5795: calls 800
rato6408: folds 
dim@n.89liza: folds 
jcarlos.vale: folds 
kensui: folds 
tusko8: folds 
nikitka3000: calls 400
Matzen10: checks 
*** FLOP *** [9s 3d 4s]
nikitka3000: checks 
Matzen10: checks 
Ruslan5795: bets 800
nikitka3000: folds 
Matzen10: calls 800
*** TURN *** [9s 3d 4s] [3c]
Matzen10: checks 
Ruslan5795: bets 800
Matzen10: calls 800
*** RIVER *** [9s 3d 4s 3c] [Ts]
Matzen10: checks 
Ruslan5795: bets 6500
Matzen10: folds 
Uncalled bet (6500) returned to Ruslan5795
Ruslan5795 collected 6500 from pot
*** SUMMARY ***
Total pot 6500 | Rake 0 
Board [9s 3d 4s 3c Ts]
Seat 1: Ruslan5795 collected (6500)
Seat 2: rato6408 folded before Flop (didn't bet)
Seat 3: dim@n.89liza folded before Flop (didn't bet)
Seat 4: jcarlos.vale folded before Flop (didn't bet)
Seat 5: kensui folded before Flop (didn't bet)
Seat 6: tusko8 (button) folded before Flop (didn't bet)
Seat 7: nikitka3000 (small blind) folded on the Flop
Seat 8: Matzen10 (big blind) folded on the River
Seat 9: Bobby Akselrod folded before Flop (didn't bet)



PokerStars Hand #221905519840: Tournament #3082657132, $0.98+$0.12 USD Hold'em No Limit - Level XVI (400/800) - 2020/12/27 19:08:54 EET [2020/12/27 12:08:54 ET]
Table '3082657132 62' 9-max Seat #7 is the button
Seat 1: Ruslan5795 (24979 in chips) 
Seat 2: rato6408 (28163 in chips) 
Seat 3: dim@n.89liza (42404 in chips) 
Seat 4: jcarlos.vale (29653 in chips) 
Seat 5: kensui (28642 in chips) 
Seat 6: tusko8 (23330 in chips) 
Seat 7: nikitka3000 (41818 in chips) 
Seat 8: Matzen10 (35969 in chips) 
Seat 9: Bobby Akselrod (4279 in chips) 
Ruslan5795: posts the ante 100
rato6408: posts the ante 100
dim@n.89liza: posts the ante 100
jcarlos.vale: posts the ante 100
kensui: posts the ante 100
tusko8: posts the ante 100
nikitka3000: posts the ante 100
Matzen10: posts the ante 100
Bobby Akselrod: posts the ante 100
Matzen10: posts small blind 400
Bobby Akselrod: posts big blind 800
*** HOLE CARDS ***
Dealt to jcarlos.vale [Jd 4d]
Ruslan5795: calls 800
rato6408: folds 
dim@n.89liza: folds 
jcarlos.vale: folds 
kensui: folds 
tusko8: raises 22430 to 23230 and is all-in
nikitka3000: folds 
Matzen10: folds 
Bobby Akselrod: folds 
Ruslan5795: calls 22430
*** FLOP *** [Ac 8c 6d]
*** TURN *** [Ac 8c 6d] [Qs]
*** RIVER *** [Ac 8c 6d Qs] [Qd]
*** SHOW DOWN ***
Ruslan5795: shows [Jc Jh] (two pair, Queens and Jacks)
tusko8: shows [Ah Qc] (a full house, Queens full of Aces)
tusko8 collected 48560 from pot
*** SUMMARY ***
Total pot 48560 | Rake 0 
Board [Ac 8c 6d Qs Qd]
Seat 1: Ruslan5795 showed [Jc Jh] and lost with two pair, Queens and Jacks
Seat 2: rato6408 folded before Flop (didn't bet)
Seat 3: dim@n.89liza folded before Flop (didn't bet)
Seat 4: jcarlos.vale folded before Flop (didn't bet)
Seat 5: kensui folded before Flop (didn't bet)
Seat 6: tusko8 showed [Ah Qc] and won (48560) with a full house, Queens full of Aces
Seat 7: nikitka3000 (button) folded before Flop (didn't bet)
Seat 8: Matzen10 (small blind) folded before Flop
Seat 9: Bobby Akselrod (big blind) folded before Flop



PokerStars Hand #221905556065: Tournament #3082657132, $0.98+$0.12 USD Hold'em No Limit - Level XVI (400/800) - 2020/12/27 19:09:36 EET [2020/12/27 12:09:36 ET]
Table '3082657132 62' 9-max Seat #8 is the button
Seat 1: Ruslan5795 (1649 in chips) 
Seat 2: rato6408 (28063 in chips) 
Seat 3: dim@n.89liza (42304 in chips) 
Seat 4: jcarlos.vale (29553 in chips) 
Seat 5: kensui (28542 in chips) 
Seat 6: tusko8 (48560 in chips) 
Seat 7: nikitka3000 (41718 in chips) 
Seat 8: Matzen10 (35469 in chips) 
Seat 9: Bobby Akselrod (3379 in chips) 
Ruslan5795: posts the ante 100
rato6408: posts the ante 100
dim@n.89liza: posts the ante 100
jcarlos.vale: posts the ante 100
kensui: posts the ante 100
tusko8: posts the ante 100
nikitka3000: posts the ante 100
Matzen10: posts the ante 100
Bobby Akselrod: posts the ante 100
Bobby Akselrod: posts small blind 400
Ruslan5795: posts big blind 800
*** HOLE CARDS ***
Dealt to jcarlos.vale [Td Jd]
rato6408: folds 
dim@n.89liza: raises 1600 to 2400
jcarlos.vale: folds 
kensui: folds 
tusko8: calls 2400
nikitka3000: folds 
Matzen10: folds 
Bobby Akselrod: folds 
Ruslan5795: folds 
*** FLOP *** [5s Kc 2h]
dim@n.89liza: bets 3600
tusko8: folds 
Uncalled bet (3600) returned to dim@n.89liza
dim@n.89liza collected 6900 from pot
dim@n.89liza: doesn't show handDTO
*** SUMMARY ***
Total pot 6900 | Rake 0 
Board [5s Kc 2h]
Seat 1: Ruslan5795 (big blind) folded before Flop
Seat 2: rato6408 folded before Flop (didn't bet)
Seat 3: dim@n.89liza collected (6900)
Seat 4: jcarlos.vale folded before Flop (didn't bet)
Seat 5: kensui folded before Flop (didn't bet)
Seat 6: tusko8 folded on the Flop
Seat 7: nikitka3000 folded before Flop (didn't bet)
Seat 8: Matzen10 (button) folded before Flop (didn't bet)
Seat 9: Bobby Akselrod (small blind) folded before Flop



PokerStars Hand #221905587932: Tournament #3082657132, $0.98+$0.12 USD Hold'em No Limit - Level XVI (400/800) - 2020/12/27 19:10:18 EET [2020/12/27 12:10:18 ET]
Table '3082657132 62' 9-max Seat #9 is the button
Seat 1: Ruslan5795 (749 in chips) 
Seat 2: rato6408 (27963 in chips) 
Seat 3: dim@n.89liza (46704 in chips) 
Seat 4: jcarlos.vale (29453 in chips) 
Seat 5: kensui (28442 in chips) 
Seat 6: tusko8 (46060 in chips) 
Seat 7: nikitka3000 (41618 in chips) 
Seat 8: Matzen10 (35369 in chips) 
Seat 9: Bobby Akselrod (2879 in chips) 
Ruslan5795: posts the ante 100
rato6408: posts the ante 100
dim@n.89liza: posts the ante 100
jcarlos.vale: posts the ante 100
kensui: posts the ante 100
tusko8: posts the ante 100
nikitka3000: posts the ante 100
Matzen10: posts the ante 100
Bobby Akselrod: posts the ante 100
Ruslan5795: posts small blind 400
rato6408: posts big blind 800
*** HOLE CARDS ***
Dealt to jcarlos.vale [7h Qc]
dim@n.89liza: folds 
jcarlos.vale: folds 
kensui: folds 
tusko8: folds 
nikitka3000: raises 920 to 1720
Matzen10: folds 
Bobby Akselrod: folds 
Ruslan5795: calls 249 and is all-in
rato6408: folds 
Uncalled bet (920) returned to nikitka3000
*** FLOP *** [3d 9h Kd]
*** TURN *** [3d 9h Kd] [4c]
*** RIVER *** [3d 9h Kd 4c] [6s]
*** SHOW DOWN ***
nikitka3000: shows [Ah 8c] (high pairOfCards Ace)
nikitka3000 collected 302 from side pot
Ruslan5795: shows [Qh Jc] (high pairOfCards King)
nikitka3000 collected 2847 from main pot
Ruslan5795 finished the tournament in 344th place and received $2.37.
*** SUMMARY ***
Total pot 3149 Main pot 2847. Side pot 302. | Rake 0 
Board [3d 9h Kd 4c 6s]
Seat 1: Ruslan5795 (small blind) showed [Qh Jc] and lost with high pairOfCards King
Seat 2: rato6408 (big blind) folded before Flop
Seat 3: dim@n.89liza folded before Flop (didn't bet)
Seat 4: jcarlos.vale folded before Flop (didn't bet)
Seat 5: kensui folded before Flop (didn't bet)
Seat 6: tusko8 folded before Flop (didn't bet)
Seat 7: nikitka3000 showed [Ah 8c] and won (3149) with high pairOfCards Ace
Seat 8: Matzen10 folded before Flop (didn't bet)
Seat 9: Bobby Akselrod (button) folded before Flop (didn't bet)



PokerStars Hand #221905617782: Tournament #3082657132, $0.98+$0.12 USD Hold'em No Limit - Level XVI (400/800) - 2020/12/27 19:10:58 EET [2020/12/27 12:10:58 ET]
Table '3082657132 62' 9-max Seat #2 is the button
Seat 2: rato6408 (27063 in chips) 
Seat 3: dim@n.89liza (46604 in chips) 
Seat 4: jcarlos.vale (29353 in chips) 
Seat 5: kensui (28342 in chips) 
Seat 6: tusko8 (45960 in chips) 
Seat 7: nikitka3000 (43867 in chips) 
Seat 8: Matzen10 (35269 in chips) 
Seat 9: Bobby Akselrod (2779 in chips) 
rato6408: posts the ante 100
dim@n.89liza: posts the ante 100
jcarlos.vale: posts the ante 100
kensui: posts the ante 100
tusko8: posts the ante 100
nikitka3000: posts the ante 100
Matzen10: posts the ante 100
Bobby Akselrod: posts the ante 100
dim@n.89liza: posts small blind 400
jcarlos.vale: posts big blind 800
*** HOLE CARDS ***
Dealt to jcarlos.vale [Ac 2d]
kensui: folds 
tusko8: folds 
nikitka3000: raises 920 to 1720
Matzen10: folds 
Bobby Akselrod: folds 
rato6408: calls 1720
dim@n.89liza: calls 1320
jcarlos.vale: folds 
*** FLOP *** [Ts Th 7h]
dim@n.89liza: checks 
nikitka3000: bets 2040
rato6408: folds 
dim@n.89liza: folds 
Uncalled bet (2040) returned to nikitka3000
nikitka3000 collected 6760 from pot
*** SUMMARY ***
Total pot 6760 | Rake 0 
Board [Ts Th 7h]
Seat 2: rato6408 (button) folded on the Flop
Seat 3: dim@n.89liza (small blind) folded on the Flop
Seat 4: jcarlos.vale (big blind) folded before Flop
Seat 5: kensui folded before Flop (didn't bet)
Seat 6: tusko8 folded before Flop (didn't bet)
Seat 7: nikitka3000 collected (6760)
Seat 8: Matzen10 folded before Flop (didn't bet)
Seat 9: Bobby Akselrod folded before Flop (didn't bet)



PokerStars Hand #221905652295: Tournament #3082657132, $0.98+$0.12 USD Hold'em No Limit - Level XVI (400/800) - 2020/12/27 19:11:44 EET [2020/12/27 12:11:44 ET]
Table '3082657132 62' 9-max Seat #3 is the button
Seat 1: ivan 30011985 (44299 in chips) 
Seat 2: rato6408 (25243 in chips) 
Seat 3: dim@n.89liza (44784 in chips) 
Seat 4: jcarlos.vale (28453 in chips) 
Seat 5: kensui (28242 in chips) 
Seat 6: tusko8 (45860 in chips) 
Seat 7: nikitka3000 (48807 in chips) 
Seat 8: Matzen10 (35169 in chips) 
Seat 9: Bobby Akselrod (2679 in chips) 
ivan 30011985: posts the ante 100
rato6408: posts the ante 100
dim@n.89liza: posts the ante 100
jcarlos.vale: posts the ante 100
kensui: posts the ante 100
tusko8: posts the ante 100
nikitka3000: posts the ante 100
Matzen10: posts the ante 100
Bobby Akselrod: posts the ante 100
jcarlos.vale: posts small blind 400
kensui: posts big blind 800
*** HOLE CARDS ***
Dealt to jcarlos.vale [6c 4s]
tusko8: folds 
nikitka3000: folds 
Matzen10: folds 
Bobby Akselrod: folds 
ivan 30011985: raises 2400 to 3200
rato6408: folds 
dim@n.89liza: folds 
jcarlos.vale: folds 
kensui: folds 
Uncalled bet (2400) returned to ivan 30011985
ivan 30011985 collected 2900 from pot
ivan 30011985: doesn't show handDTO
*** SUMMARY ***
Total pot 2900 | Rake 0 
Seat 1: ivan 30011985 collected (2900)
Seat 2: rato6408 folded before Flop (didn't bet)
Seat 3: dim@n.89liza (button) folded before Flop (didn't bet)
Seat 4: jcarlos.vale (small blind) folded before Flop
Seat 5: kensui (big blind) folded before Flop
Seat 6: tusko8 folded before Flop (didn't bet)
Seat 7: nikitka3000 folded before Flop (didn't bet)
Seat 8: Matzen10 folded before Flop (didn't bet)
Seat 9: Bobby Akselrod folded before Flop (didn't bet)



PokerStars Hand #221905684257: Tournament #3082657132, $0.98+$0.12 USD Hold'em No Limit - Level XVI (400/800) - 2020/12/27 19:12:26 EET [2020/12/27 12:12:26 ET]
Table '3082657132 62' 9-max Seat #4 is the button
Seat 1: ivan 30011985 (46299 in chips) 
Seat 2: rato6408 (25143 in chips) 
Seat 3: dim@n.89liza (44684 in chips) 
Seat 4: jcarlos.vale (27953 in chips) 
Seat 5: kensui (27342 in chips) 
Seat 6: tusko8 (45760 in chips) 
Seat 7: nikitka3000 (48707 in chips) 
Seat 8: Matzen10 (35069 in chips) 
Seat 9: Bobby Akselrod (2579 in chips) 
ivan 30011985: posts the ante 100
rato6408: posts the ante 100
dim@n.89liza: posts the ante 100
jcarlos.vale: posts the ante 100
kensui: posts the ante 100
tusko8: posts the ante 100
nikitka3000: posts the ante 100
Matzen10: posts the ante 100
Bobby Akselrod: posts the ante 100
kensui: posts small blind 400
tusko8: posts big blind 800
*** HOLE CARDS ***
Dealt to jcarlos.vale [4h Td]
nikitka3000: folds 
Matzen10: folds 
Bobby Akselrod: folds 
ivan 30011985: folds 
rato6408: folds 
dim@n.89liza: folds 
jcarlos.vale: folds 
kensui: folds 
Uncalled bet (400) returned to tusko8
tusko8 collected 1700 from pot
tusko8: doesn't show handDTO
*** SUMMARY ***
Total pot 1700 | Rake 0 
Seat 1: ivan 30011985 folded before Flop (didn't bet)
Seat 2: rato6408 folded before Flop (didn't bet)
Seat 3: dim@n.89liza folded before Flop (didn't bet)
Seat 4: jcarlos.vale (button) folded before Flop (didn't bet)
Seat 5: kensui (small blind) folded before Flop
Seat 6: tusko8 (big blind) collected (1700)
Seat 7: nikitka3000 folded before Flop (didn't bet)
Seat 8: Matzen10 folded before Flop (didn't bet)
Seat 9: Bobby Akselrod folded before Flop (didn't bet)



PokerStars Hand #221905711877: Tournament #3082657132, $0.98+$0.12 USD Hold'em No Limit - Level XVI (400/800) - 2020/12/27 19:13:03 EET [2020/12/27 12:13:03 ET]
Table '3082657132 62' 9-max Seat #5 is the button
Seat 1: ivan 30011985 (46199 in chips) 
Seat 2: rato6408 (25043 in chips) 
Seat 3: dim@n.89liza (44584 in chips) 
Seat 4: jcarlos.vale (27853 in chips) 
Seat 5: kensui (26842 in chips) 
Seat 6: tusko8 (46960 in chips) 
Seat 7: nikitka3000 (48607 in chips) 
Seat 8: Matzen10 (34969 in chips) 
Seat 9: Bobby Akselrod (2479 in chips) 
ivan 30011985: posts the ante 100
rato6408: posts the ante 100
dim@n.89liza: posts the ante 100
jcarlos.vale: posts the ante 100
kensui: posts the ante 100
tusko8: posts the ante 100
nikitka3000: posts the ante 100
Matzen10: posts the ante 100
Bobby Akselrod: posts the ante 100
tusko8: posts small blind 400
nikitka3000: posts big blind 800
*** HOLE CARDS ***
Dealt to jcarlos.vale [3h 7h]
Matzen10: folds 
Bobby Akselrod: folds 
ivan 30011985: calls 800
rato6408: folds 
dim@n.89liza: folds 
jcarlos.vale: folds 
kensui: folds 
tusko8: calls 400
nikitka3000: checks 
*** FLOP *** [8s 4c 6c]
tusko8: bets 1600
nikitka3000: calls 1600
ivan 30011985: folds 
*** TURN *** [8s 4c 6c] [Kh]
tusko8: checks 
nikitka3000: bets 1950
tusko8: folds 
Uncalled bet (1950) returned to nikitka3000
nikitka3000 collected 6500 from pot
*** SUMMARY ***
Total pot 6500 | Rake 0 
Board [8s 4c 6c Kh]
Seat 1: ivan 30011985 folded on the Flop
Seat 2: rato6408 folded before Flop (didn't bet)
Seat 3: dim@n.89liza folded before Flop (didn't bet)
Seat 4: jcarlos.vale folded before Flop (didn't bet)
Seat 5: kensui (button) folded before Flop (didn't bet)
Seat 6: tusko8 (small blind) folded on the Turn
Seat 7: nikitka3000 (big blind) collected (6500)
Seat 8: Matzen10 folded before Flop (didn't bet)
Seat 9: Bobby Akselrod folded before Flop (didn't bet)



PokerStars Hand #221905772280: Tournament #3082657132, $0.98+$0.12 USD Hold'em No Limit - Level XVI (400/800) - 2020/12/27 19:14:22 EET [2020/12/27 12:14:22 ET]
Table '3082657132 62' 9-max Seat #6 is the button
Seat 1: ivan 30011985 (45299 in chips) 
Seat 2: rato6408 (24943 in chips) 
Seat 3: dim@n.89liza (44484 in chips) 
Seat 4: jcarlos.vale (27753 in chips) 
Seat 5: kensui (26742 in chips) 
Seat 6: tusko8 (44460 in chips) 
Seat 7: nikitka3000 (52607 in chips) 
Seat 8: Matzen10 (34869 in chips) 
Seat 9: Bobby Akselrod (2379 in chips) 
ivan 30011985: posts the ante 100
rato6408: posts the ante 100
dim@n.89liza: posts the ante 100
jcarlos.vale: posts the ante 100
kensui: posts the ante 100
tusko8: posts the ante 100
nikitka3000: posts the ante 100
Matzen10: posts the ante 100
Bobby Akselrod: posts the ante 100
nikitka3000: posts small blind 400
Matzen10: posts big blind 800
*** HOLE CARDS ***
Dealt to jcarlos.vale [Qc 9d]
Bobby Akselrod: raises 1479 to 2279 and is all-in
ivan 30011985: calls 2279
rato6408: folds 
dim@n.89liza: raises 42105 to 44384 and is all-in
jcarlos.vale: folds 
kensui: folds 
tusko8: calls 44360 and is all-in
nikitka3000: folds 
Matzen10: folds 
ivan 30011985: folds 
Uncalled bet (24) returned to dim@n.89liza
*** FLOP *** [Kh Th 3d]
*** TURN *** [Kh Th 3d] [7h]
*** RIVER *** [Kh Th 3d 7h] [Ks]
*** SHOW DOWN ***
dim@n.89liza: shows [Js Jc] (two pair, Kings and Jacks)
tusko8: shows [6d 6s] (two pair, Kings and Sixes)
dim@n.89liza collected 84162 from side pot
Bobby Akselrod: shows [As Ac] (two pair, Aces and Kings)
Bobby Akselrod collected 11216 from main pot
tusko8 finished the tournament in 313th place and received $2.37.
*** SUMMARY ***
Total pot 95378 Main pot 11216. Side pot 84162. | Rake 0 
Board [Kh Th 3d 7h Ks]
Seat 1: ivan 30011985 folded before Flop
Seat 2: rato6408 folded before Flop (didn't bet)
Seat 3: dim@n.89liza showed [Js Jc] and won (84162) with two pair, Kings and Jacks
Seat 4: jcarlos.vale folded before Flop (didn't bet)
Seat 5: kensui folded before Flop (didn't bet)
Seat 6: tusko8 (button) showed [6d 6s] and lost with two pair, Kings and Sixes
Seat 7: nikitka3000 (small blind) folded before Flop
Seat 8: Matzen10 (big blind) folded before Flop
Seat 9: Bobby Akselrod showed [As Ac] and won (11216) with two pair, Aces and Kings



PokerStars Hand #221905826793: Tournament #3082657132, $0.98+$0.12 USD Hold'em No Limit - Level XVII (500/1000) - 2020/12/27 19:15:34 EET [2020/12/27 12:15:34 ET]
Table '3082657132 62' 9-max Seat #7 is the button
Seat 1: ivan 30011985 (42920 in chips) 
Seat 2: rato6408 (24843 in chips) 
Seat 3: dim@n.89liza (84186 in chips) 
Seat 4: jcarlos.vale (27653 in chips) 
Seat 5: kensui (26642 in chips) 
Seat 7: nikitka3000 (52107 in chips) 
Seat 8: Matzen10 (33969 in chips) 
Seat 9: Bobby Akselrod (11216 in chips) 
ivan 30011985: posts the ante 125
rato6408: posts the ante 125
dim@n.89liza: posts the ante 125
jcarlos.vale: posts the ante 125
kensui: posts the ante 125
nikitka3000: posts the ante 125
Matzen10: posts the ante 125
Bobby Akselrod: posts the ante 125
Matzen10: posts small blind 500
Bobby Akselrod: posts big blind 1000
*** HOLE CARDS ***
Dealt to jcarlos.vale [2c 6h]
ivan 30011985: calls 1000
rato6408: raises 2200 to 3200
dim@n.89liza: folds 
jcarlos.vale: folds 
kensui: folds 
nikitka3000: folds 
Matzen10: folds 
Bobby Akselrod: folds 
ivan 30011985: raises 39595 to 42795 and is all-in
rato6408: folds 
Uncalled bet (39595) returned to ivan 30011985
ivan 30011985 collected 8900 from pot
ivan 30011985: doesn't show handDTO
*** SUMMARY ***
Total pot 8900 | Rake 0 
Seat 1: ivan 30011985 collected (8900)
Seat 2: rato6408 folded before Flop
Seat 3: dim@n.89liza folded before Flop (didn't bet)
Seat 4: jcarlos.vale folded before Flop (didn't bet)
Seat 5: kensui folded before Flop (didn't bet)
Seat 7: nikitka3000 (button) folded before Flop (didn't bet)
Seat 8: Matzen10 (small blind) folded before Flop
Seat 9: Bobby Akselrod (big blind) folded before Flop



PokerStars Hand #221905853215: Tournament #3082657132, $0.98+$0.12 USD Hold'em No Limit - Level XVII (500/1000) - 2020/12/27 19:16:08 EET [2020/12/27 12:16:08 ET]
Table '3082657132 62' 9-max Seat #8 is the button
Seat 1: ivan 30011985 (48495 in chips) 
Seat 2: rato6408 (21518 in chips) 
Seat 3: dim@n.89liza (84061 in chips) 
Seat 4: jcarlos.vale (27528 in chips) 
Seat 5: kensui (26517 in chips) 
Seat 7: nikitka3000 (51982 in chips) 
Seat 8: Matzen10 (33344 in chips) 
Seat 9: Bobby Akselrod (10091 in chips) 
ivan 30011985: posts the ante 125
rato6408: posts the ante 125
dim@n.89liza: posts the ante 125
jcarlos.vale: posts the ante 125
kensui: posts the ante 125
nikitka3000: posts the ante 125
Matzen10: posts the ante 125
Bobby Akselrod: posts the ante 125
Bobby Akselrod: posts small blind 500
ivan 30011985: posts big blind 1000
*** HOLE CARDS ***
Dealt to jcarlos.vale [7s 6s]
rato6408: folds 
dim@n.89liza: folds 
jcarlos.vale: raises 1600 to 2600
kensui: folds 
nikitka3000: folds 
Matzen10: calls 2600
Bobby Akselrod: folds 
ivan 30011985: calls 1600
*** FLOP *** [7c As 8h]
ivan 30011985: checks 
jcarlos.vale: bets 2000
Matzen10: calls 2000
ivan 30011985: calls 2000
*** TURN *** [7c As 8h] [Jc]
ivan 30011985: checks 
jcarlos.vale: checks 
Matzen10: checks 
*** RIVER *** [7c As 8h Jc] [4c]
ivan 30011985: bets 7650
jcarlos.vale: folds 
Matzen10: folds 
Uncalled bet (7650) returned to ivan 30011985
ivan 30011985 collected 15300 from pot
ivan 30011985: doesn't show handDTO
*** SUMMARY ***
Total pot 15300 | Rake 0 
Board [7c As 8h Jc 4c]
Seat 1: ivan 30011985 (big blind) collected (15300)
Seat 2: rato6408 folded before Flop (didn't bet)
Seat 3: dim@n.89liza folded before Flop (didn't bet)
Seat 4: jcarlos.vale folded on the River
Seat 5: kensui folded before Flop (didn't bet)
Seat 7: nikitka3000 folded before Flop (didn't bet)
Seat 8: Matzen10 (button) folded on the River
Seat 9: Bobby Akselrod (small blind) folded before Flop



PokerStars Hand #221905901524: Tournament #3082657132, $0.98+$0.12 USD Hold'em No Limit - Level XVII (500/1000) - 2020/12/27 19:17:12 EET [2020/12/27 12:17:12 ET]
Table '3082657132 62' 9-max Seat #9 is the button
Seat 1: ivan 30011985 (59070 in chips) 
Seat 2: rato6408 (21393 in chips) 
Seat 3: dim@n.89liza (83936 in chips) 
Seat 4: jcarlos.vale (22803 in chips) 
Seat 5: kensui (26392 in chips) 
Seat 6: Ajax2530 (72498 in chips) 
Seat 7: nikitka3000 (51857 in chips) 
Seat 8: Matzen10 (28619 in chips) 
Seat 9: Bobby Akselrod (9466 in chips) 
ivan 30011985: posts the ante 125
rato6408: posts the ante 125
dim@n.89liza: posts the ante 125
jcarlos.vale: posts the ante 125
kensui: posts the ante 125
Ajax2530: posts the ante 125
nikitka3000: posts the ante 125
Matzen10: posts the ante 125
Bobby Akselrod: posts the ante 125
ivan 30011985: posts small blind 500
rato6408: posts big blind 1000
*** HOLE CARDS ***
Dealt to jcarlos.vale [Kd 2s]
dim@n.89liza: raises 2000 to 3000
jcarlos.vale: folds 
kensui: folds 
Ajax2530: folds 
nikitka3000: folds 
Matzen10: folds 
Bobby Akselrod: raises 6341 to 9341 and is all-in
ivan 30011985: folds 
rato6408: folds 
dim@n.89liza: calls 6341
*** FLOP *** [Jh 5c 3s]
*** TURN *** [Jh 5c 3s] [Qs]
*** RIVER *** [Jh 5c 3s Qs] [2h]
*** SHOW DOWN ***
dim@n.89liza: shows [Jc Ac] (a pair of Jacks)
Bobby Akselrod: shows [7c 7s] (a pair of Sevens)
dim@n.89liza collected 21307 from pot
Bobby Akselrod finished the tournament in 299th place and received $2.37.
*** SUMMARY ***
Total pot 21307 | Rake 0 
Board [Jh 5c 3s Qs 2h]
Seat 1: ivan 30011985 (small blind) folded before Flop
Seat 2: rato6408 (big blind) folded before Flop
Seat 3: dim@n.89liza showed [Jc Ac] and won (21307) with a pair of Jacks
Seat 4: jcarlos.vale folded before Flop (didn't bet)
Seat 5: kensui folded before Flop (didn't bet)
Seat 6: Ajax2530 folded before Flop (didn't bet)
Seat 7: nikitka3000 folded before Flop (didn't bet)
Seat 8: Matzen10 folded before Flop (didn't bet)
Seat 9: Bobby Akselrod (button) showed [7c 7s] and lost with a pair of Sevens



PokerStars Hand #221905930918: Tournament #3082657132, $0.98+$0.12 USD Hold'em No Limit - Level XVII (500/1000) - 2020/12/27 19:17:51 EET [2020/12/27 12:17:51 ET]
Table '3082657132 62' 9-max Seat #1 is the button
Seat 1: ivan 30011985 (58445 in chips) 
Seat 2: rato6408 (20268 in chips) 
Seat 3: dim@n.89liza (95777 in chips) 
Seat 4: jcarlos.vale (22678 in chips) 
Seat 5: kensui (26267 in chips) 
Seat 6: Ajax2530 (72373 in chips) 
Seat 7: nikitka3000 (51732 in chips) 
Seat 8: Matzen10 (28494 in chips) 
ivan 30011985: posts the ante 125
rato6408: posts the ante 125
dim@n.89liza: posts the ante 125
jcarlos.vale: posts the ante 125
kensui: posts the ante 125
Ajax2530: posts the ante 125
nikitka3000: posts the ante 125
Matzen10: posts the ante 125
rato6408: posts small blind 500
dim@n.89liza: posts big blind 1000
*** HOLE CARDS ***
Dealt to jcarlos.vale [3d 8c]
jcarlos.vale: folds 
kensui: folds 
Ajax2530: folds 
nikitka3000: folds 
Matzen10: raises 1000 to 2000
ivan 30011985: folds 
rato6408: folds 
dim@n.89liza: raises 93652 to 95652 and is all-in
Matzen10: folds 
Uncalled bet (93652) returned to dim@n.89liza
dim@n.89liza collected 5500 from pot
dim@n.89liza: doesn't show handDTO
*** SUMMARY ***
Total pot 5500 | Rake 0 
Seat 1: ivan 30011985 (button) folded before Flop (didn't bet)
Seat 2: rato6408 (small blind) folded before Flop
Seat 3: dim@n.89liza (big blind) collected (5500)
Seat 4: jcarlos.vale folded before Flop (didn't bet)
Seat 5: kensui folded before Flop (didn't bet)
Seat 6: Ajax2530 folded before Flop (didn't bet)
Seat 7: nikitka3000 folded before Flop (didn't bet)
Seat 8: Matzen10 folded before Flop



PokerStars Hand #221905955667: Tournament #3082657132, $0.98+$0.12 USD Hold'em No Limit - Level XVII (500/1000) - 2020/12/27 19:18:23 EET [2020/12/27 12:18:23 ET]
Table '3082657132 62' 9-max Seat #2 is the button
Seat 1: ivan 30011985 (58320 in chips) 
Seat 2: rato6408 (19643 in chips) 
Seat 3: dim@n.89liza (99152 in chips) 
Seat 4: jcarlos.vale (22553 in chips) 
Seat 5: kensui (26142 in chips) 
Seat 6: Ajax2530 (72248 in chips) 
Seat 7: nikitka3000 (51607 in chips) 
Seat 8: Matzen10 (26369 in chips) 
Seat 9: roddypra (50613 in chips) 
ivan 30011985: posts the ante 125
rato6408: posts the ante 125
dim@n.89liza: posts the ante 125
jcarlos.vale: posts the ante 125
kensui: posts the ante 125
Ajax2530: posts the ante 125
nikitka3000: posts the ante 125
Matzen10: posts the ante 125
roddypra: posts the ante 125
dim@n.89liza: posts small blind 500
jcarlos.vale: posts big blind 1000
*** HOLE CARDS ***
Dealt to jcarlos.vale [7s Ah]
kensui: folds 
Ajax2530: raises 1330 to 2330
nikitka3000: folds 
Matzen10: folds 
roddypra: folds 
ivan 30011985: folds 
rato6408: folds 
dim@n.89liza: folds 
jcarlos.vale: calls 1330
*** FLOP *** [As 4s 6d]
jcarlos.vale: bets 4714
Ajax2530: folds 
Uncalled bet (4714) returned to jcarlos.vale
jcarlos.vale collected 6285 from pot
jcarlos.vale: doesn't show handDTO
*** SUMMARY ***
Total pot 6285 | Rake 0 
Board [As 4s 6d]
Seat 1: ivan 30011985 folded before Flop (didn't bet)
Seat 2: rato6408 (button) folded before Flop (didn't bet)
Seat 3: dim@n.89liza (small blind) folded before Flop
Seat 4: jcarlos.vale (big blind) collected (6285)
Seat 5: kensui folded before Flop (didn't bet)
Seat 6: Ajax2530 folded on the Flop
Seat 7: nikitka3000 folded before Flop (didn't bet)
Seat 8: Matzen10 folded before Flop (didn't bet)
Seat 9: roddypra folded before Flop (didn't bet)



PokerStars Hand #221905979764: Tournament #3082657132, $0.98+$0.12 USD Hold'em No Limit - Level XVII (500/1000) - 2020/12/27 19:18:55 EET [2020/12/27 12:18:55 ET]
Table '3082657132 62' 9-max Seat #3 is the button
Seat 1: ivan 30011985 (58195 in chips) 
Seat 2: rato6408 (19518 in chips) 
Seat 3: dim@n.89liza (98527 in chips) 
Seat 4: jcarlos.vale (26383 in chips) 
Seat 5: kensui (26017 in chips) 
Seat 6: Ajax2530 (69793 in chips) 
Seat 7: nikitka3000 (51482 in chips) 
Seat 8: Matzen10 (26244 in chips) 
Seat 9: roddypra (50488 in chips) 
ivan 30011985: posts the ante 125
rato6408: posts the ante 125
dim@n.89liza: posts the ante 125
jcarlos.vale: posts the ante 125
kensui: posts the ante 125
Ajax2530: posts the ante 125
nikitka3000: posts the ante 125
Matzen10: posts the ante 125
roddypra: posts the ante 125
jcarlos.vale: posts small blind 500
kensui: posts big blind 1000
*** HOLE CARDS ***
Dealt to jcarlos.vale [Td Tc]
Ajax2530: folds 
nikitka3000: folds 
Matzen10: folds 
roddypra: folds 
ivan 30011985: calls 1000
rato6408: folds 
dim@n.89liza: folds 
jcarlos.vale: raises 2000 to 3000
kensui: folds 
ivan 30011985: calls 2000
*** FLOP *** [4c 6h 3d]
jcarlos.vale: bets 6094
ivan 30011985: calls 6094
*** TURN *** [4c 6h 3d] [9c]
jcarlos.vale: bets 17164 and is all-in
ivan 30011985: calls 17164
*** RIVER *** [4c 6h 3d 9c] [7d]
*** SHOW DOWN ***
jcarlos.vale: shows [Td Tc] (a pair of Tens)
ivan 30011985: shows [8c 8s] (a pair of Eights)
jcarlos.vale collected 54641 from pot
*** SUMMARY ***
Total pot 54641 | Rake 0 
Board [4c 6h 3d 9c 7d]
Seat 1: ivan 30011985 showed [8c 8s] and lost with a pair of Eights
Seat 2: rato6408 folded before Flop (didn't bet)
Seat 3: dim@n.89liza (button) folded before Flop (didn't bet)
Seat 4: jcarlos.vale (small blind) showed [Td Tc] and won (54641) with a pair of Tens
Seat 5: kensui (big blind) folded before Flop
Seat 6: Ajax2530 folded before Flop (didn't bet)
Seat 7: nikitka3000 folded before Flop (didn't bet)
Seat 8: Matzen10 folded before Flop (didn't bet)
Seat 9: roddypra folded before Flop (didn't bet)



PokerStars Hand #221906042598: Tournament #3082657132, $0.98+$0.12 USD Hold'em No Limit - Level XVII (500/1000) - 2020/12/27 19:20:18 EET [2020/12/27 12:20:18 ET]
Table '3082657132 62' 9-max Seat #4 is the button
Seat 1: ivan 30011985 (31812 in chips) 
Seat 2: rato6408 (19393 in chips) 
Seat 3: dim@n.89liza (98402 in chips) 
Seat 4: jcarlos.vale (54641 in chips) 
Seat 5: kensui (24892 in chips) 
Seat 6: Ajax2530 (69668 in chips) 
Seat 7: nikitka3000 (51357 in chips) 
Seat 8: Matzen10 (26119 in chips) 
Seat 9: roddypra (50363 in chips) 
ivan 30011985: posts the ante 125
rato6408: posts the ante 125
dim@n.89liza: posts the ante 125
jcarlos.vale: posts the ante 125
kensui: posts the ante 125
Ajax2530: posts the ante 125
nikitka3000: posts the ante 125
Matzen10: posts the ante 125
roddypra: posts the ante 125
kensui: posts small blind 500
Ajax2530: posts big blind 1000
*** HOLE CARDS ***
Dealt to jcarlos.vale [4h 9d]
nikitka3000: folds 
Matzen10: folds 
roddypra: folds 
ivan 30011985: folds 
rato6408: folds 
dim@n.89liza: folds 
jcarlos.vale: folds 
kensui: calls 500
Ajax2530: checks 
*** FLOP *** [Tc 6s 8h]
kensui: checks 
Ajax2530: checks 
*** TURN *** [Tc 6s 8h] [2c]
kensui: checks 
Ajax2530: checks 
*** RIVER *** [Tc 6s 8h 2c] [Kc]
kensui: checks 
Ajax2530: bets 2100
kensui: folds 
Uncalled bet (2100) returned to Ajax2530
Ajax2530 collected 3125 from pot
*** SUMMARY ***
Total pot 3125 | Rake 0 
Board [Tc 6s 8h 2c Kc]
Seat 1: ivan 30011985 folded before Flop (didn't bet)
Seat 2: rato6408 folded before Flop (didn't bet)
Seat 3: dim@n.89liza folded before Flop (didn't bet)
Seat 4: jcarlos.vale (button) folded before Flop (didn't bet)
Seat 5: kensui (small blind) folded on the River
Seat 6: Ajax2530 (big blind) collected (3125)
Seat 7: nikitka3000 folded before Flop (didn't bet)
Seat 8: Matzen10 folded before Flop (didn't bet)
Seat 9: roddypra folded before Flop (didn't bet)



PokerStars Hand #221906075310: Tournament #3082657132, $0.98+$0.12 USD Hold'em No Limit - Level XVII (500/1000) - 2020/12/27 19:21:02 EET [2020/12/27 12:21:02 ET]
Table '3082657132 62' 9-max Seat #5 is the button
Seat 1: ivan 30011985 (31687 in chips) 
Seat 2: rato6408 (19268 in chips) 
Seat 3: dim@n.89liza (98277 in chips) 
Seat 4: jcarlos.vale (54516 in chips) 
Seat 5: kensui (23767 in chips) 
Seat 6: Ajax2530 (71668 in chips) 
Seat 7: nikitka3000 (51232 in chips) 
Seat 8: Matzen10 (25994 in chips) 
Seat 9: roddypra (50238 in chips) 
ivan 30011985: posts the ante 125
rato6408: posts the ante 125
dim@n.89liza: posts the ante 125
jcarlos.vale: posts the ante 125
kensui: posts the ante 125
Ajax2530: posts the ante 125
nikitka3000: posts the ante 125
Matzen10: posts the ante 125
roddypra: posts the ante 125
Ajax2530: posts small blind 500
nikitka3000: posts big blind 1000
*** HOLE CARDS ***
Dealt to jcarlos.vale [3s 4s]
Matzen10: folds 
roddypra: folds 
ivan 30011985: calls 1000
rato6408: folds 
dim@n.89liza: folds 
jcarlos.vale: calls 1000
kensui: folds 
Ajax2530: calls 500
nikitka3000: checks 
*** FLOP *** [6s Qh Kc]
Ajax2530: checks 
nikitka3000: checks 
ivan 30011985: checks 
jcarlos.vale: checks 
*** TURN *** [6s Qh Kc] [5c]
Ajax2530: checks 
nikitka3000: checks 
ivan 30011985: bets 2000
jcarlos.vale: calls 2000
Ajax2530: folds 
nikitka3000: folds 
*** RIVER *** [6s Qh Kc 5c] [Jc]
ivan 30011985: bets 4562
jcarlos.vale: folds 
Uncalled bet (4562) returned to ivan 30011985
ivan 30011985 collected 9125 from pot
ivan 30011985: doesn't show handDTO
*** SUMMARY ***
Total pot 9125 | Rake 0 
Board [6s Qh Kc 5c Jc]
Seat 1: ivan 30011985 collected (9125)
Seat 2: rato6408 folded before Flop (didn't bet)
Seat 3: dim@n.89liza folded before Flop (didn't bet)
Seat 4: jcarlos.vale folded on the River
Seat 5: kensui (button) folded before Flop (didn't bet)
Seat 6: Ajax2530 (small blind) folded on the Turn
Seat 7: nikitka3000 (big blind) folded on the Turn
Seat 8: Matzen10 folded before Flop (didn't bet)
Seat 9: roddypra folded before Flop (didn't bet)



PokerStars Hand #221906143926: Tournament #3082657132, $0.98+$0.12 USD Hold'em No Limit - Level XVII (500/1000) - 2020/12/27 19:22:32 EET [2020/12/27 12:22:32 ET]
Table '3082657132 62' 9-max Seat #6 is the button
Seat 1: ivan 30011985 (37687 in chips) 
Seat 2: rato6408 (19143 in chips) 
Seat 3: dim@n.89liza (98152 in chips) 
Seat 4: jcarlos.vale (51391 in chips) 
Seat 5: kensui (23642 in chips) 
Seat 6: Ajax2530 (70543 in chips) 
Seat 7: nikitka3000 (50107 in chips) 
Seat 8: Matzen10 (25869 in chips) 
Seat 9: roddypra (50113 in chips) 
ivan 30011985: posts the ante 125
rato6408: posts the ante 125
dim@n.89liza: posts the ante 125
jcarlos.vale: posts the ante 125
kensui: posts the ante 125
Ajax2530: posts the ante 125
nikitka3000: posts the ante 125
Matzen10: posts the ante 125
roddypra: posts the ante 125
nikitka3000: posts small blind 500
Matzen10: posts big blind 1000
*** HOLE CARDS ***
Dealt to jcarlos.vale [Ts 9c]
roddypra: raises 1000 to 2000
ivan 30011985: folds 
rato6408: folds 
dim@n.89liza: folds 
jcarlos.vale: folds 
kensui: calls 2000
Ajax2530: folds 
nikitka3000: folds 
Matzen10: folds 
*** FLOP *** [9h Th 8d]
roddypra: checks 
kensui: checks 
*** TURN *** [9h Th 8d] [Ad]
roddypra: bets 3000
kensui: calls 3000
*** RIVER *** [9h Th 8d Ad] [Tc]
roddypra: bets 44988 and is all-in
kensui: folds 
Uncalled bet (44988) returned to roddypra
roddypra collected 12625 from pot
*** SUMMARY ***
Total pot 12625 | Rake 0 
Board [9h Th 8d Ad Tc]
Seat 1: ivan 30011985 folded before Flop (didn't bet)
Seat 2: rato6408 folded before Flop (didn't bet)
Seat 3: dim@n.89liza folded before Flop (didn't bet)
Seat 4: jcarlos.vale folded before Flop (didn't bet)
Seat 5: kensui folded on the River
Seat 6: Ajax2530 (button) folded before Flop (didn't bet)
Seat 7: nikitka3000 (small blind) folded before Flop
Seat 8: Matzen10 (big blind) folded before Flop
Seat 9: roddypra collected (12625)



PokerStars Hand #221906198690: Tournament #3082657132, $0.98+$0.12 USD Hold'em No Limit - Level XVII (500/1000) - 2020/12/27 19:23:44 EET [2020/12/27 12:23:44 ET]
Table '3082657132 62' 9-max Seat #7 is the button
Seat 1: ivan 30011985 (37562 in chips) 
Seat 2: rato6408 (19018 in chips) 
Seat 3: dim@n.89liza (98027 in chips) 
Seat 4: jcarlos.vale (51266 in chips) 
Seat 5: kensui (18517 in chips) 
Seat 6: Ajax2530 (70418 in chips) 
Seat 7: nikitka3000 (49482 in chips) 
Seat 8: Matzen10 (24744 in chips) 
Seat 9: roddypra (57613 in chips) 
ivan 30011985: posts the ante 125
rato6408: posts the ante 125
dim@n.89liza: posts the ante 125
jcarlos.vale: posts the ante 125
kensui: posts the ante 125
Ajax2530: posts the ante 125
nikitka3000: posts the ante 125
Matzen10: posts the ante 125
roddypra: posts the ante 125
Matzen10: posts small blind 500
roddypra: posts big blind 1000
*** HOLE CARDS ***
Dealt to jcarlos.vale [5c 2h]
ivan 30011985: folds 
rato6408: folds 
dim@n.89liza: folds 
jcarlos.vale: folds 
kensui: folds 
Ajax2530: raises 1330 to 2330
nikitka3000: folds 
Matzen10: folds 
roddypra: folds 
Uncalled bet (1330) returned to Ajax2530
Ajax2530 collected 3625 from pot
Ajax2530: doesn't show handDTO
*** SUMMARY ***
Total pot 3625 | Rake 0 
Seat 1: ivan 30011985 folded before Flop (didn't bet)
Seat 2: rato6408 folded before Flop (didn't bet)
Seat 3: dim@n.89liza folded before Flop (didn't bet)
Seat 4: jcarlos.vale folded before Flop (didn't bet)
Seat 5: kensui folded before Flop (didn't bet)
Seat 6: Ajax2530 collected (3625)
Seat 7: nikitka3000 (button) folded before Flop (didn't bet)
Seat 8: Matzen10 (small blind) folded before Flop
Seat 9: roddypra (big blind) folded before Flop



PokerStars Hand #221906221271: Tournament #3082657132, $0.98+$0.12 USD Hold'em No Limit - Level XVII (500/1000) - 2020/12/27 19:24:13 EET [2020/12/27 12:24:13 ET]
Table '3082657132 62' 9-max Seat #8 is the button
Seat 1: ivan 30011985 (37437 in chips) 
Seat 2: rato6408 (18893 in chips) 
Seat 3: dim@n.89liza (97902 in chips) 
Seat 4: jcarlos.vale (51141 in chips) 
Seat 5: kensui (18392 in chips) 
Seat 6: Ajax2530 (72918 in chips) 
Seat 7: nikitka3000 (49357 in chips) 
Seat 8: Matzen10 (24119 in chips) 
Seat 9: roddypra (56488 in chips) 
ivan 30011985: posts the ante 125
rato6408: posts the ante 125
dim@n.89liza: posts the ante 125
jcarlos.vale: posts the ante 125
kensui: posts the ante 125
Ajax2530: posts the ante 125
nikitka3000: posts the ante 125
Matzen10: posts the ante 125
roddypra: posts the ante 125
roddypra: posts small blind 500
ivan 30011985: posts big blind 1000
*** HOLE CARDS ***
Dealt to jcarlos.vale [9h 7c]
rato6408: folds 
dim@n.89liza: folds 
jcarlos.vale: folds 
kensui: raises 1160 to 2160
Ajax2530: folds 
nikitka3000 has timed out
nikitka3000: folds 
nikitka3000 is sitting out
Matzen10: folds 
roddypra: folds 
nikitka3000 has returned
ivan 30011985: calls 1160
*** FLOP *** [4c 8d 3d]
ivan 30011985: checks 
kensui: checks 
*** TURN *** [4c 8d 3d] [Ts]
ivan 30011985: bets 1000
kensui: calls 1000
*** RIVER *** [4c 8d 3d Ts] [Qs]
ivan 30011985: checks 
kensui: checks 
*** SHOW DOWN ***
ivan 30011985: shows [9c 8h] (a pair of Eights)
kensui: mucks handDTO
ivan 30011985 collected 7945 from pot
*** SUMMARY ***
Total pot 7945 | Rake 0 
Board [4c 8d 3d Ts Qs]
Seat 1: ivan 30011985 (big blind) showed [9c 8h] and won (7945) with a pair of Eights
Seat 2: rato6408 folded before Flop (didn't bet)
Seat 3: dim@n.89liza folded before Flop (didn't bet)
Seat 4: jcarlos.vale folded before Flop (didn't bet)
Seat 5: kensui mucked [As 9s]
Seat 6: Ajax2530 folded before Flop (didn't bet)
Seat 7: nikitka3000 folded before Flop (didn't bet)
Seat 8: Matzen10 (button) folded before Flop (didn't bet)
Seat 9: roddypra (small blind) folded before Flop



PokerStars Hand #221906269604: Tournament #3082657132, $0.98+$0.12 USD Hold'em No Limit - Level XVIII (600/1200) - 2020/12/27 19:25:07 EET [2020/12/27 12:25:07 ET]
Table '3082657132 62' 9-max Seat #9 is the button
Seat 1: ivan 30011985 (42097 in chips) 
Seat 2: rato6408 (18768 in chips) 
Seat 3: dim@n.89liza (97777 in chips) 
Seat 4: jcarlos.vale (51016 in chips) 
Seat 5: kensui (15107 in chips) 
Seat 6: Ajax2530 (72793 in chips) 
Seat 7: nikitka3000 (49232 in chips) 
Seat 8: Matzen10 (23994 in chips) 
Seat 9: roddypra (55863 in chips) 
ivan 30011985: posts the ante 150
rato6408: posts the ante 150
dim@n.89liza: posts the ante 150
jcarlos.vale: posts the ante 150
kensui: posts the ante 150
Ajax2530: posts the ante 150
nikitka3000: posts the ante 150
Matzen10: posts the ante 150
roddypra: posts the ante 150
ivan 30011985: posts small blind 600
rato6408: posts big blind 1200
*** HOLE CARDS ***
Dealt to jcarlos.vale [8h 5d]
dim@n.89liza: folds 
jcarlos.vale: folds 
kensui: folds 
Ajax2530: folds 
nikitka3000: folds 
Matzen10: folds 
roddypra: raises 1200 to 2400
ivan 30011985 has timed out
ivan 30011985: folds 
ivan 30011985 is sitting out
ivan 30011985 has returned
rato6408: folds 
Uncalled bet (1200) returned to roddypra
roddypra collected 4350 from pot
*** SUMMARY ***
Total pot 4350 | Rake 0 
Seat 1: ivan 30011985 (small blind) folded before Flop
Seat 2: rato6408 (big blind) folded before Flop
Seat 3: dim@n.89liza folded before Flop (didn't bet)
Seat 4: jcarlos.vale folded before Flop (didn't bet)
Seat 5: kensui folded before Flop (didn't bet)
Seat 6: Ajax2530 folded before Flop (didn't bet)
Seat 7: nikitka3000 folded before Flop (didn't bet)
Seat 8: Matzen10 folded before Flop (didn't bet)
Seat 9: roddypra (button) collected (4350)



PokerStars Hand #221906297416: Tournament #3082657132, $0.98+$0.12 USD Hold'em No Limit - Level XVIII (600/1200) - 2020/12/27 19:25:42 EET [2020/12/27 12:25:42 ET]
Table '3082657132 62' 9-max Seat #1 is the button
Seat 1: ivan 30011985 (41347 in chips) 
Seat 2: rato6408 (17418 in chips) 
Seat 3: dim@n.89liza (97627 in chips) 
Seat 4: jcarlos.vale (50866 in chips) 
Seat 5: kensui (14957 in chips) 
Seat 6: Ajax2530 (72643 in chips) 
Seat 7: nikitka3000 (49082 in chips) 
Seat 8: Matzen10 (23844 in chips) 
Seat 9: roddypra (58863 in chips) 
ivan 30011985: posts the ante 150
rato6408: posts the ante 150
dim@n.89liza: posts the ante 150
jcarlos.vale: posts the ante 150
kensui: posts the ante 150
Ajax2530: posts the ante 150
nikitka3000: posts the ante 150
Matzen10: posts the ante 150
roddypra: posts the ante 150
rato6408: posts small blind 600
dim@n.89liza: posts big blind 1200
*** HOLE CARDS ***
Dealt to jcarlos.vale [9c Ah]
jcarlos.vale: raises 1920 to 3120
kensui: folds 
Ajax2530: folds 
nikitka3000: folds 
Matzen10: folds 
roddypra: folds 
ivan 30011985: calls 3120
rato6408: folds 
dim@n.89liza: folds 
*** FLOP *** [4d 9d 5c]
jcarlos.vale: bets 4695
ivan 30011985: calls 4695
*** TURN *** [4d 9d 5c] [9h]
jcarlos.vale: bets 9390
ivan 30011985: folds 
Uncalled bet (9390) returned to jcarlos.vale
jcarlos.vale collected 18780 from pot
jcarlos.vale: doesn't show handDTO
*** SUMMARY ***
Total pot 18780 | Rake 0 
Board [4d 9d 5c 9h]
Seat 1: ivan 30011985 (button) folded on the Turn
Seat 2: rato6408 (small blind) folded before Flop
Seat 3: dim@n.89liza (big blind) folded before Flop
Seat 4: jcarlos.vale collected (18780)
Seat 5: kensui folded before Flop (didn't bet)
Seat 6: Ajax2530 folded before Flop (didn't bet)
Seat 7: nikitka3000 folded before Flop (didn't bet)
Seat 8: Matzen10 folded before Flop (didn't bet)
Seat 9: roddypra folded before Flop (didn't bet)



PokerStars Hand #221906333301: Tournament #3082657132, $0.98+$0.12 USD Hold'em No Limit - Level XVIII (600/1200) - 2020/12/27 19:26:28 EET [2020/12/27 12:26:28 ET]
Table '3082657132 62' 9-max Seat #2 is the button
Seat 1: ivan 30011985 (33382 in chips) 
Seat 2: rato6408 (16668 in chips) 
Seat 3: dim@n.89liza (96277 in chips) 
Seat 4: jcarlos.vale (61681 in chips) 
Seat 5: kensui (14807 in chips) 
Seat 6: Ajax2530 (72493 in chips) 
Seat 7: nikitka3000 (48932 in chips) 
Seat 8: Matzen10 (23694 in chips) 
Seat 9: roddypra (58713 in chips) 
ivan 30011985: posts the ante 150
rato6408: posts the ante 150
dim@n.89liza: posts the ante 150
jcarlos.vale: posts the ante 150
kensui: posts the ante 150
Ajax2530: posts the ante 150
nikitka3000: posts the ante 150
Matzen10: posts the ante 150
roddypra: posts the ante 150
dim@n.89liza: posts small blind 600
jcarlos.vale: posts big blind 1200
*** HOLE CARDS ***
Dealt to jcarlos.vale [Ah Ad]
kensui: folds 
Ajax2530: folds 
nikitka3000: folds 
Matzen10: folds 
roddypra: raises 1200 to 2400
ivan 30011985: folds 
rato6408: folds 
dim@n.89liza: folds 
jcarlos.vale: raises 2400 to 4800
roddypra: calls 2400
*** FLOP *** [Qs Ks 8h]
jcarlos.vale: bets 8663
roddypra: calls 8663
*** TURN *** [Qs Ks 8h] [7h]
jcarlos.vale: bets 21657
roddypra: folds 
Uncalled bet (21657) returned to jcarlos.vale
jcarlos.vale collected 28876 from pot
jcarlos.vale: doesn't show handDTO
*** SUMMARY ***
Total pot 28876 | Rake 0 
Board [Qs Ks 8h 7h]
Seat 1: ivan 30011985 folded before Flop (didn't bet)
Seat 2: rato6408 (button) folded before Flop (didn't bet)
Seat 3: dim@n.89liza (small blind) folded before Flop
Seat 4: jcarlos.vale (big blind) collected (28876)
Seat 5: kensui folded before Flop (didn't bet)
Seat 6: Ajax2530 folded before Flop (didn't bet)
Seat 7: nikitka3000 folded before Flop (didn't bet)
Seat 8: Matzen10 folded before Flop (didn't bet)
Seat 9: roddypra folded on the Turn



PokerStars Hand #221906380352: Tournament #3082657132, $0.98+$0.12 USD Hold'em No Limit - Level XVIII (600/1200) - 2020/12/27 19:27:28 EET [2020/12/27 12:27:28 ET]
Table '3082657132 62' 9-max Seat #3 is the button
Seat 1: ivan 30011985 (33232 in chips) 
Seat 2: rato6408 (16518 in chips) 
Seat 3: dim@n.89liza (95527 in chips) 
Seat 4: jcarlos.vale (76944 in chips) 
Seat 5: kensui (14657 in chips) 
Seat 6: Ajax2530 (72343 in chips) 
Seat 7: nikitka3000 (48782 in chips) 
Seat 8: Matzen10 (23544 in chips) 
Seat 9: roddypra (45100 in chips) 
ivan 30011985: posts the ante 150
rato6408: posts the ante 150
dim@n.89liza: posts the ante 150
jcarlos.vale: posts the ante 150
kensui: posts the ante 150
Ajax2530: posts the ante 150
nikitka3000: posts the ante 150
Matzen10: posts the ante 150
roddypra: posts the ante 150
jcarlos.vale: posts small blind 600
kensui: posts big blind 1200
*** HOLE CARDS ***
Dealt to jcarlos.vale [4d 9d]
Ajax2530: folds 
nikitka3000: folds 
Matzen10: raises 1200 to 2400
roddypra: folds 
ivan 30011985 has timed out
ivan 30011985: folds 
ivan 30011985 is sitting out
rato6408: folds 
dim@n.89liza: calls 2400
jcarlos.vale: folds 
ivan 30011985 has returned
kensui: folds 
*** FLOP *** [As Jd 7h]
Matzen10: checks 
dim@n.89liza: bets 3600
Matzen10: raises 6000 to 9600
dim@n.89liza: folds 
Uncalled bet (6000) returned to Matzen10
Matzen10 collected 15150 from pot
Matzen10: doesn't show handDTO
*** SUMMARY ***
Total pot 15150 | Rake 0 
Board [As Jd 7h]
Seat 1: ivan 30011985 folded before Flop (didn't bet)
Seat 2: rato6408 folded before Flop (didn't bet)
Seat 3: dim@n.89liza (button) folded on the Flop
Seat 4: jcarlos.vale (small blind) folded before Flop
Seat 5: kensui (big blind) folded before Flop
Seat 6: Ajax2530 folded before Flop (didn't bet)
Seat 7: nikitka3000 folded before Flop (didn't bet)
Seat 8: Matzen10 collected (15150)
Seat 9: roddypra folded before Flop (didn't bet)



PokerStars Hand #221906435819: Tournament #3082657132, $0.98+$0.12 USD Hold'em No Limit - Level XVIII (600/1200) - 2020/12/27 19:28:39 EET [2020/12/27 12:28:39 ET]
Table '3082657132 62' 9-max Seat #4 is the button
Seat 1: ivan 30011985 (33082 in chips) 
Seat 2: rato6408 (16368 in chips) 
Seat 3: dim@n.89liza (89377 in chips) 
Seat 4: jcarlos.vale (76194 in chips) 
Seat 5: kensui (13307 in chips) 
Seat 6: Ajax2530 (72193 in chips) 
Seat 7: nikitka3000 (48632 in chips) 
Seat 8: Matzen10 (32544 in chips) 
Seat 9: roddypra (44950 in chips) 
ivan 30011985: posts the ante 150
rato6408: posts the ante 150
dim@n.89liza: posts the ante 150
jcarlos.vale: posts the ante 150
kensui: posts the ante 150
Ajax2530: posts the ante 150
nikitka3000: posts the ante 150
Matzen10: posts the ante 150
roddypra: posts the ante 150
kensui: posts small blind 600
Ajax2530: posts big blind 1200
*** HOLE CARDS ***
Dealt to jcarlos.vale [5h 3h]
nikitka3000: folds 
Matzen10: folds 
roddypra: folds 
ivan 30011985: folds 
rato6408: folds 
dim@n.89liza: folds 
jcarlos.vale: raises 1920 to 3120
kensui: folds 
Ajax2530: raises 6930 to 10050
jcarlos.vale: folds 
Uncalled bet (6930) returned to Ajax2530
Ajax2530 collected 8190 from pot
Ajax2530: doesn't show handDTO
*** SUMMARY ***
Total pot 8190 | Rake 0 
Seat 1: ivan 30011985 folded before Flop (didn't bet)
Seat 2: rato6408 folded before Flop (didn't bet)
Seat 3: dim@n.89liza folded before Flop (didn't bet)
Seat 4: jcarlos.vale (button) folded before Flop
Seat 5: kensui (small blind) folded before Flop
Seat 6: Ajax2530 (big blind) collected (8190)
Seat 7: nikitka3000 folded before Flop (didn't bet)
Seat 8: Matzen10 folded before Flop (didn't bet)
Seat 9: roddypra folded before Flop (didn't bet)



PokerStars Hand #221906471228: Tournament #3082657132, $0.98+$0.12 USD Hold'em No Limit - Level XVIII (600/1200) - 2020/12/27 19:29:24 EET [2020/12/27 12:29:24 ET]
Table '3082657132 62' 9-max Seat #5 is the button
Seat 1: ivan 30011985 (32932 in chips) 
Seat 2: rato6408 (16218 in chips) 
Seat 3: dim@n.89liza (89227 in chips) 
Seat 4: jcarlos.vale (72924 in chips) 
Seat 5: kensui (12557 in chips) 
Seat 6: Ajax2530 (77113 in chips) 
Seat 7: nikitka3000 (48482 in chips) 
Seat 8: Matzen10 (32394 in chips) 
Seat 9: roddypra (44800 in chips) 
ivan 30011985: posts the ante 150
rato6408: posts the ante 150
dim@n.89liza: posts the ante 150
jcarlos.vale: posts the ante 150
kensui: posts the ante 150
Ajax2530: posts the ante 150
nikitka3000: posts the ante 150
Matzen10: posts the ante 150
roddypra: posts the ante 150
Ajax2530: posts small blind 600
nikitka3000: posts big blind 1200
*** HOLE CARDS ***
Dealt to jcarlos.vale [9d Ad]
Matzen10: folds 
roddypra: folds 
ivan 30011985 has timed out
ivan 30011985: folds 
ivan 30011985 is sitting out
rato6408: folds 
ivan 30011985 has returned
dim@n.89liza: folds 
jcarlos.vale: raises 1920 to 3120
kensui: folds 
Ajax2530: raises 6930 to 10050
nikitka3000: folds 
jcarlos.vale: folds 
Uncalled bet (6930) returned to Ajax2530
Ajax2530 collected 8790 from pot
Ajax2530: doesn't show handDTO
*** SUMMARY ***
Total pot 8790 | Rake 0 
Seat 1: ivan 30011985 folded before Flop (didn't bet)
Seat 2: rato6408 folded before Flop (didn't bet)
Seat 3: dim@n.89liza folded before Flop (didn't bet)
Seat 4: jcarlos.vale folded before Flop
Seat 5: kensui (button) folded before Flop (didn't bet)
Seat 6: Ajax2530 (small blind) collected (8790)
Seat 7: nikitka3000 (big blind) folded before Flop
Seat 8: Matzen10 folded before Flop (didn't bet)
Seat 9: roddypra folded before Flop (didn't bet)



PokerStars Hand #221906519457: Tournament #3082657132, $0.98+$0.12 USD Hold'em No Limit - Level XVIII (600/1200) - 2020/12/27 19:30:24 EET [2020/12/27 12:30:24 ET]
Table '3082657132 62' 9-max Seat #6 is the button
Seat 1: ivan 30011985 (32782 in chips) 
Seat 2: rato6408 (16068 in chips) 
Seat 3: dim@n.89liza (89077 in chips) 
Seat 4: jcarlos.vale (69654 in chips) 
Seat 5: kensui (12407 in chips) 
Seat 6: Ajax2530 (82633 in chips) 
Seat 7: nikitka3000 (47132 in chips) 
Seat 8: Matzen10 (32244 in chips) 
Seat 9: roddypra (44650 in chips) 
ivan 30011985: posts the ante 150
rato6408: posts the ante 150
dim@n.89liza: posts the ante 150
jcarlos.vale: posts the ante 150
kensui: posts the ante 150
Ajax2530: posts the ante 150
nikitka3000: posts the ante 150
Matzen10: posts the ante 150
roddypra: posts the ante 150
nikitka3000: posts small blind 600
Matzen10: posts big blind 1200
*** HOLE CARDS ***
Dealt to jcarlos.vale [8h 5s]
roddypra: folds 
ivan 30011985: folds 
rato6408: folds 
dim@n.89liza: folds 
jcarlos.vale: folds 
kensui: folds 
Ajax2530: raises 1680 to 2880
nikitka3000: folds 
Matzen10: calls 1680
*** FLOP *** [Kd Qd Ts]
Matzen10: checks 
Ajax2530: bets 2440
Matzen10: folds 
Uncalled bet (2440) returned to Ajax2530
Ajax2530 collected 7710 from pot
*** SUMMARY ***
Total pot 7710 | Rake 0 
Board [Kd Qd Ts]
Seat 1: ivan 30011985 folded before Flop (didn't bet)
Seat 2: rato6408 folded before Flop (didn't bet)
Seat 3: dim@n.89liza folded before Flop (didn't bet)
Seat 4: jcarlos.vale folded before Flop (didn't bet)
Seat 5: kensui folded before Flop (didn't bet)
Seat 6: Ajax2530 (button) collected (7710)
Seat 7: nikitka3000 (small blind) folded before Flop
Seat 8: Matzen10 (big blind) folded on the Flop
Seat 9: roddypra folded before Flop (didn't bet)



PokerStars Hand #221906556802: Tournament #3082657132, $0.98+$0.12 USD Hold'em No Limit - Level XVIII (600/1200) - 2020/12/27 19:31:11 EET [2020/12/27 12:31:11 ET]
Table '3082657132 62' 9-max Seat #7 is the button
Seat 1: ivan 30011985 (32632 in chips) 
Seat 2: rato6408 (15918 in chips) 
Seat 3: dim@n.89liza (88927 in chips) 
Seat 4: jcarlos.vale (69504 in chips) 
Seat 5: kensui (12257 in chips) 
Seat 6: Ajax2530 (87313 in chips) 
Seat 7: nikitka3000 (46382 in chips) 
Seat 8: Matzen10 (29214 in chips) 
Seat 9: roddypra (44500 in chips) 
ivan 30011985: posts the ante 150
rato6408: posts the ante 150
dim@n.89liza: posts the ante 150
jcarlos.vale: posts the ante 150
kensui: posts the ante 150
Ajax2530: posts the ante 150
nikitka3000: posts the ante 150
Matzen10: posts the ante 150
roddypra: posts the ante 150
Matzen10: posts small blind 600
roddypra: posts big blind 1200
*** HOLE CARDS ***
Dealt to jcarlos.vale [Qc 5h]
ivan 30011985 has timed out
ivan 30011985: folds 
ivan 30011985 is sitting out
rato6408: folds 
ivan 30011985 has returned
dim@n.89liza: raises 2400 to 3600
jcarlos.vale: folds 
kensui: folds 
Ajax2530: folds 
nikitka3000: folds 
Matzen10: folds 
roddypra: folds 
Uncalled bet (2400) returned to dim@n.89liza
dim@n.89liza collected 4350 from pot
dim@n.89liza: doesn't show handDTO
*** SUMMARY ***
Total pot 4350 | Rake 0 
Seat 1: ivan 30011985 folded before Flop (didn't bet)
Seat 2: rato6408 folded before Flop (didn't bet)
Seat 3: dim@n.89liza collected (4350)
Seat 4: jcarlos.vale folded before Flop (didn't bet)
Seat 5: kensui folded before Flop (didn't bet)
Seat 6: Ajax2530 folded before Flop (didn't bet)
Seat 7: nikitka3000 (button) folded before Flop (didn't bet)
Seat 8: Matzen10 (small blind) folded before Flop
Seat 9: roddypra (big blind) folded before Flop



PokerStars Hand #221906582130: Tournament #3082657132, $0.98+$0.12 USD Hold'em No Limit - Level XVIII (600/1200) - 2020/12/27 19:31:43 EET [2020/12/27 12:31:43 ET]
Table '3082657132 62' 9-max Seat #8 is the button
Seat 1: ivan 30011985 (32482 in chips) 
Seat 2: rato6408 (15768 in chips) 
Seat 3: dim@n.89liza (91927 in chips) 
Seat 4: jcarlos.vale (69354 in chips) 
Seat 5: kensui (12107 in chips) 
Seat 6: Ajax2530 (87163 in chips) 
Seat 7: nikitka3000 (46232 in chips) 
Seat 8: Matzen10 (28464 in chips) 
Seat 9: roddypra (43150 in chips) 
ivan 30011985: posts the ante 150
rato6408: posts the ante 150
dim@n.89liza: posts the ante 150
jcarlos.vale: posts the ante 150
kensui: posts the ante 150
Ajax2530: posts the ante 150
nikitka3000: posts the ante 150
Matzen10: posts the ante 150
roddypra: posts the ante 150
roddypra: posts small blind 600
ivan 30011985: posts big blind 1200
*** HOLE CARDS ***
Dealt to jcarlos.vale [5h Qd]
rato6408: folds 
dim@n.89liza: folds 
jcarlos.vale: folds 
kensui: folds 
Ajax2530: folds 
nikitka3000: folds 
Matzen10: folds 
roddypra: raises 1200 to 2400
ivan 30011985: calls 1200
*** FLOP *** [Qc Ts Kh]
roddypra: bets 2400
ivan 30011985 has timed out
ivan 30011985: folds 
ivan 30011985 is sitting out
Uncalled bet (2400) returned to roddypra
roddypra collected 6150 from pot
*** SUMMARY ***
Total pot 6150 | Rake 0 
Board [Qc Ts Kh]
Seat 1: ivan 30011985 (big blind) folded on the Flop
Seat 2: rato6408 folded before Flop (didn't bet)
Seat 3: dim@n.89liza folded before Flop (didn't bet)
Seat 4: jcarlos.vale folded before Flop (didn't bet)
Seat 5: kensui folded before Flop (didn't bet)
Seat 6: Ajax2530 folded before Flop (didn't bet)
Seat 7: nikitka3000 folded before Flop (didn't bet)
Seat 8: Matzen10 (button) folded before Flop (didn't bet)
Seat 9: roddypra (small blind) collected (6150)



PokerStars Hand #221906631177: Tournament #3082657132, $0.98+$0.12 USD Hold'em No Limit - Level XVIII (600/1200) - 2020/12/27 19:32:44 EET [2020/12/27 12:32:44 ET]
Table '3082657132 62' 9-max Seat #9 is the button
Seat 1: ivan 30011985 (29932 in chips) is sitting out
Seat 2: rato6408 (15618 in chips) 
Seat 3: dim@n.89liza (91777 in chips) 
Seat 4: jcarlos.vale (69204 in chips) 
Seat 5: kensui (11957 in chips) 
Seat 6: Ajax2530 (87013 in chips) 
Seat 7: nikitka3000 (46082 in chips) 
Seat 8: Matzen10 (28314 in chips) 
Seat 9: roddypra (46750 in chips) 
ivan 30011985: posts the ante 150
rato6408: posts the ante 150
dim@n.89liza: posts the ante 150
jcarlos.vale: posts the ante 150
kensui: posts the ante 150
Ajax2530: posts the ante 150
nikitka3000: posts the ante 150
Matzen10: posts the ante 150
roddypra: posts the ante 150
ivan 30011985: posts small blind 600
rato6408: posts big blind 1200
*** HOLE CARDS ***
Dealt to jcarlos.vale [Ad 7s]
dim@n.89liza: folds 
jcarlos.vale: folds 
kensui: folds 
Ajax2530: folds 
ivan 30011985 has returned
nikitka3000: folds 
Matzen10: folds 
roddypra: raises 1200 to 2400
ivan 30011985 has timed out
ivan 30011985: folds 
ivan 30011985 is sitting out
rato6408: folds 
Uncalled bet (1200) returned to roddypra
roddypra collected 4350 from pot
*** SUMMARY ***
Total pot 4350 | Rake 0 
Seat 1: ivan 30011985 (small blind) folded before Flop
Seat 2: rato6408 (big blind) folded before Flop
Seat 3: dim@n.89liza folded before Flop (didn't bet)
Seat 4: jcarlos.vale folded before Flop (didn't bet)
Seat 5: kensui folded before Flop (didn't bet)
Seat 6: Ajax2530 folded before Flop (didn't bet)
Seat 7: nikitka3000 folded before Flop (didn't bet)
Seat 8: Matzen10 folded before Flop (didn't bet)
Seat 9: roddypra (button) collected (4350)



PokerStars Hand #221906659785: Tournament #3082657132, $0.98+$0.12 USD Hold'em No Limit - Level XVIII (600/1200) - 2020/12/27 19:33:20 EET [2020/12/27 12:33:20 ET]
Table '3082657132 62' 9-max Seat #1 is the button
Seat 1: ivan 30011985 (29182 in chips) is sitting out
Seat 2: rato6408 (14268 in chips) 
Seat 3: dim@n.89liza (91627 in chips) 
Seat 4: jcarlos.vale (69054 in chips) 
Seat 5: kensui (11807 in chips) 
Seat 6: Ajax2530 (86863 in chips) 
Seat 7: nikitka3000 (45932 in chips) 
Seat 8: Matzen10 (28164 in chips) 
Seat 9: roddypra (49750 in chips) 
ivan 30011985: posts the ante 150
rato6408: posts the ante 150
dim@n.89liza: posts the ante 150
jcarlos.vale: posts the ante 150
kensui: posts the ante 150
Ajax2530: posts the ante 150
nikitka3000: posts the ante 150
Matzen10: posts the ante 150
roddypra: posts the ante 150
rato6408: posts small blind 600
dim@n.89liza: posts big blind 1200
*** HOLE CARDS ***
Dealt to jcarlos.vale [Tc Kc]
jcarlos.vale: calls 1200
kensui: folds 
Ajax2530: folds 
nikitka3000: folds 
Matzen10: folds 
roddypra: folds 
ivan 30011985: folds 
rato6408: calls 600
dim@n.89liza: checks 
*** FLOP *** [Kd Th Ah]
rato6408: checks 
dim@n.89liza: checks 
jcarlos.vale: bets 3713
rato6408: folds 
dim@n.89liza: folds 
Uncalled bet (3713) returned to jcarlos.vale
jcarlos.vale collected 4950 from pot
jcarlos.vale: doesn't show handDTO
*** SUMMARY ***
Total pot 4950 | Rake 0 
Board [Kd Th Ah]
Seat 1: ivan 30011985 (button) folded before Flop (didn't bet)
Seat 2: rato6408 (small blind) folded on the Flop
Seat 3: dim@n.89liza (big blind) folded on the Flop
Seat 4: jcarlos.vale collected (4950)
Seat 5: kensui folded before Flop (didn't bet)
Seat 6: Ajax2530 folded before Flop (didn't bet)
Seat 7: nikitka3000 folded before Flop (didn't bet)
Seat 8: Matzen10 folded before Flop (didn't bet)
Seat 9: roddypra folded before Flop (didn't bet)



PokerStars Hand #221906710351: Tournament #3082657132, $0.98+$0.12 USD Hold'em No Limit - Level XVIII (600/1200) - 2020/12/27 19:34:22 EET [2020/12/27 12:34:22 ET]
Table '3082657132 62' 9-max Seat #2 is the button
Seat 1: ivan 30011985 (29032 in chips) is sitting out
Seat 2: rato6408 (12918 in chips) 
Seat 3: dim@n.89liza (90277 in chips) 
Seat 4: jcarlos.vale (72654 in chips) 
Seat 5: kensui (11657 in chips) 
Seat 6: Ajax2530 (86713 in chips) 
Seat 7: nikitka3000 (45782 in chips) 
Seat 8: Matzen10 (28014 in chips) 
Seat 9: roddypra (49600 in chips) 
ivan 30011985: posts the ante 150
rato6408: posts the ante 150
dim@n.89liza: posts the ante 150
jcarlos.vale: posts the ante 150
kensui: posts the ante 150
Ajax2530: posts the ante 150
nikitka3000: posts the ante 150
Matzen10: posts the ante 150
roddypra: posts the ante 150
dim@n.89liza: posts small blind 600
jcarlos.vale: posts big blind 1200
*** HOLE CARDS ***
Dealt to jcarlos.vale [5d 8s]
kensui: raises 10307 to 11507 and is all-in
Ajax2530: folds 
nikitka3000: folds 
Matzen10: folds 
roddypra: folds 
ivan 30011985: folds 
rato6408: folds 
ivan 30011985 has returned
dim@n.89liza: folds 
jcarlos.vale: folds 
Uncalled bet (10307) returned to kensui
kensui collected 4350 from pot
kensui: doesn't show handDTO
*** SUMMARY ***
Total pot 4350 | Rake 0 
Seat 1: ivan 30011985 folded before Flop (didn't bet)
Seat 2: rato6408 (button) folded before Flop (didn't bet)
Seat 3: dim@n.89liza (small blind) folded before Flop
Seat 4: jcarlos.vale (big blind) folded before Flop
Seat 5: kensui collected (4350)
Seat 6: Ajax2530 folded before Flop (didn't bet)
Seat 7: nikitka3000 folded before Flop (didn't bet)
Seat 8: Matzen10 folded before Flop (didn't bet)
Seat 9: roddypra folded before Flop (didn't bet)



PokerStars Hand #221906730665: Tournament #3082657132, $0.98+$0.12 USD Hold'em No Limit - Level XVIII (600/1200) - 2020/12/27 19:34:48 EET [2020/12/27 12:34:48 ET]
Table '3082657132 62' 9-max Seat #3 is the button
Seat 1: ivan 30011985 (28882 in chips) 
Seat 2: rato6408 (12768 in chips) 
Seat 3: dim@n.89liza (89527 in chips) 
Seat 4: jcarlos.vale (71304 in chips) 
Seat 5: kensui (14657 in chips) 
Seat 6: Ajax2530 (86563 in chips) 
Seat 7: nikitka3000 (45632 in chips) 
Seat 8: Matzen10 (27864 in chips) 
Seat 9: roddypra (49450 in chips) 
ivan 30011985: posts the ante 150
rato6408: posts the ante 150
dim@n.89liza: posts the ante 150
jcarlos.vale: posts the ante 150
kensui: posts the ante 150
Ajax2530: posts the ante 150
nikitka3000: posts the ante 150
Matzen10: posts the ante 150
roddypra: posts the ante 150
jcarlos.vale: posts small blind 600
kensui: posts big blind 1200
*** HOLE CARDS ***
Dealt to jcarlos.vale [Jd 7h]
Ajax2530: folds 
nikitka3000: folds 
Matzen10: folds 
roddypra: folds 
ivan 30011985: calls 1200
rato6408: raises 11418 to 12618 and is all-in
dim@n.89liza: calls 12618
jcarlos.vale: folds 
kensui: raises 1889 to 14507 and is all-in
ivan 30011985: folds 
dim@n.89liza: calls 1889
*** FLOP *** [7c Td 2s]
*** TURN *** [7c Td 2s] [Kc]
*** RIVER *** [7c Td 2s Kc] [Kd]
*** SHOW DOWN ***
kensui: shows [Ac Kh] (three of a kind, Kings)
dim@n.89liza: shows [Tc Ad] (two pair, Kings and Tens)
kensui collected 3778 from side pot
rato6408: shows [As Qh] (a pair of Kings)
kensui collected 41004 from main pot
rato6408 finished the tournament in 228th place and received $3.04.
*** SUMMARY ***
Total pot 44782 Main pot 41004. Side pot 3778. | Rake 0 
Board [7c Td 2s Kc Kd]
Seat 1: ivan 30011985 folded before Flop
Seat 2: rato6408 showed [As Qh] and lost with a pair of Kings
Seat 3: dim@n.89liza (button) showed [Tc Ad] and lost with two pair, Kings and Tens
Seat 4: jcarlos.vale (small blind) folded before Flop
Seat 5: kensui (big blind) showed [Ac Kh] and won (44782) with three of a kind, Kings
Seat 6: Ajax2530 folded before Flop (didn't bet)
Seat 7: nikitka3000 folded before Flop (didn't bet)
Seat 8: Matzen10 folded before Flop (didn't bet)
Seat 9: roddypra folded before Flop (didn't bet)



PokerStars Hand #221906774439: Tournament #3082657132, $0.98+$0.12 USD Hold'em No Limit - Level XIX (700/1400) - 2020/12/27 19:35:42 EET [2020/12/27 12:35:42 ET]
Table '3082657132 62' 9-max Seat #4 is the button
Seat 1: ivan 30011985 (27532 in chips) 
Seat 3: dim@n.89liza (74870 in chips) 
Seat 4: jcarlos.vale (70554 in chips) 
Seat 5: kensui (44782 in chips) 
Seat 6: Ajax2530 (86413 in chips) 
Seat 7: nikitka3000 (45482 in chips) 
Seat 8: Matzen10 (27714 in chips) 
Seat 9: roddypra (49300 in chips) 
ivan 30011985: posts the ante 175
dim@n.89liza: posts the ante 175
jcarlos.vale: posts the ante 175
kensui: posts the ante 175
Ajax2530: posts the ante 175
nikitka3000: posts the ante 175
Matzen10: posts the ante 175
roddypra: posts the ante 175
kensui: posts small blind 700
Ajax2530: posts big blind 1400
*** HOLE CARDS ***
Dealt to jcarlos.vale [Ad 7h]
nikitka3000: folds 
Matzen10: folds 
roddypra: folds 
ivan 30011985: folds 
dim@n.89liza: raises 2800 to 4200
jcarlos.vale: folds 
kensui: folds 
Ajax2530: folds 
Uncalled bet (2800) returned to dim@n.89liza
dim@n.89liza collected 4900 from pot
dim@n.89liza: doesn't show handDTO
*** SUMMARY ***
Total pot 4900 | Rake 0 
Seat 1: ivan 30011985 folded before Flop (didn't bet)
Seat 3: dim@n.89liza collected (4900)
Seat 4: jcarlos.vale (button) folded before Flop (didn't bet)
Seat 5: kensui (small blind) folded before Flop
Seat 6: Ajax2530 (big blind) folded before Flop
Seat 7: nikitka3000 folded before Flop (didn't bet)
Seat 8: Matzen10 folded before Flop (didn't bet)
Seat 9: roddypra folded before Flop (didn't bet)



PokerStars Hand #221906797698: Tournament #3082657132, $0.98+$0.12 USD Hold'em No Limit - Level XIX (700/1400) - 2020/12/27 19:36:11 EET [2020/12/27 12:36:11 ET]
Table '3082657132 62' 9-max Seat #5 is the button
Seat 1: ivan 30011985 (27357 in chips) 
Seat 3: dim@n.89liza (78195 in chips) 
Seat 4: jcarlos.vale (70379 in chips) 
Seat 5: kensui (43907 in chips) 
Seat 6: Ajax2530 (84838 in chips) 
Seat 7: nikitka3000 (45307 in chips) 
Seat 8: Matzen10 (27539 in chips) 
Seat 9: roddypra (49125 in chips) 
ivan 30011985: posts the ante 175
dim@n.89liza: posts the ante 175
jcarlos.vale: posts the ante 175
kensui: posts the ante 175
Ajax2530: posts the ante 175
nikitka3000: posts the ante 175
Matzen10: posts the ante 175
roddypra: posts the ante 175
Ajax2530: posts small blind 700
nikitka3000: posts big blind 1400
*** HOLE CARDS ***
Dealt to jcarlos.vale [2d 5c]
Matzen10: folds 
roddypra: folds 
ivan 30011985: folds 
dim@n.89liza: raises 2800 to 4200
jcarlos.vale: folds 
kensui: folds 
Ajax2530: folds 
nikitka3000: folds 
Uncalled bet (2800) returned to dim@n.89liza
dim@n.89liza collected 4900 from pot
dim@n.89liza: doesn't show handDTO
*** SUMMARY ***
Total pot 4900 | Rake 0 
Seat 1: ivan 30011985 folded before Flop (didn't bet)
Seat 3: dim@n.89liza collected (4900)
Seat 4: jcarlos.vale folded before Flop (didn't bet)
Seat 5: kensui (button) folded before Flop (didn't bet)
Seat 6: Ajax2530 (small blind) folded before Flop
Seat 7: nikitka3000 (big blind) folded before Flop
Seat 8: Matzen10 folded before Flop (didn't bet)
Seat 9: roddypra folded before Flop (didn't bet)



PokerStars Hand #221906823158: Tournament #3082657132, $0.98+$0.12 USD Hold'em No Limit - Level XIX (700/1400) - 2020/12/27 19:36:43 EET [2020/12/27 12:36:43 ET]
Table '3082657132 62' 9-max Seat #6 is the button
Seat 1: ivan 30011985 (27182 in chips) 
Seat 2: TRENDLINEOKI (29357 in chips) 
Seat 3: dim@n.89liza (81520 in chips) 
Seat 4: jcarlos.vale (70204 in chips) 
Seat 5: kensui (43732 in chips) 
Seat 6: Ajax2530 (83963 in chips) 
Seat 7: nikitka3000 (43732 in chips) 
Seat 8: Matzen10 (27364 in chips) 
Seat 9: roddypra (48950 in chips) 
ivan 30011985: posts the ante 175
TRENDLINEOKI: posts the ante 175
dim@n.89liza: posts the ante 175
jcarlos.vale: posts the ante 175
kensui: posts the ante 175
Ajax2530: posts the ante 175
nikitka3000: posts the ante 175
Matzen10: posts the ante 175
roddypra: posts the ante 175
nikitka3000: posts small blind 700
Matzen10: posts big blind 1400
*** HOLE CARDS ***
Dealt to jcarlos.vale [As 8d]
roddypra: folds 
ivan 30011985: folds 
TRENDLINEOKI: raises 1680 to 3080
dim@n.89liza: folds 
jcarlos.vale: folds 
kensui: folds 
Ajax2530: folds 
nikitka3000: folds 
Matzen10: folds 
Uncalled bet (1680) returned to TRENDLINEOKI
TRENDLINEOKI collected 5075 from pot
TRENDLINEOKI: doesn't show handDTO
*** SUMMARY ***
Total pot 5075 | Rake 0 
Seat 1: ivan 30011985 folded before Flop (didn't bet)
Seat 2: TRENDLINEOKI collected (5075)
Seat 3: dim@n.89liza folded before Flop (didn't bet)
Seat 4: jcarlos.vale folded before Flop (didn't bet)
Seat 5: kensui folded before Flop (didn't bet)
Seat 6: Ajax2530 (button) folded before Flop (didn't bet)
Seat 7: nikitka3000 (small blind) folded before Flop
Seat 8: Matzen10 (big blind) folded before Flop
Seat 9: roddypra folded before Flop (didn't bet)



PokerStars Hand #221906842172: Tournament #3082657132, $0.98+$0.12 USD Hold'em No Limit - Level XIX (700/1400) - 2020/12/27 19:37:07 EET [2020/12/27 12:37:07 ET]
Table '3082657132 62' 9-max Seat #7 is the button
Seat 1: ivan 30011985 (27007 in chips) 
Seat 2: TRENDLINEOKI (32857 in chips) 
Seat 3: dim@n.89liza (81345 in chips) 
Seat 4: jcarlos.vale (70029 in chips) 
Seat 5: kensui (43557 in chips) 
Seat 6: Ajax2530 (83788 in chips) 
Seat 7: nikitka3000 (42857 in chips) 
Seat 8: Matzen10 (25789 in chips) 
Seat 9: roddypra (48775 in chips) 
ivan 30011985: posts the ante 175
TRENDLINEOKI: posts the ante 175
dim@n.89liza: posts the ante 175
jcarlos.vale: posts the ante 175
kensui: posts the ante 175
Ajax2530: posts the ante 175
nikitka3000: posts the ante 175
Matzen10: posts the ante 175
roddypra: posts the ante 175
Matzen10: posts small blind 700
roddypra: posts big blind 1400
*** HOLE CARDS ***
Dealt to jcarlos.vale [Qc Qd]
ivan 30011985: raises 1400 to 2800
TRENDLINEOKI: folds 
dim@n.89liza: folds 
jcarlos.vale: raises 4200 to 7000
kensui: folds 
Ajax2530: folds 
nikitka3000: folds 
Matzen10: folds 
roddypra: folds 
ivan 30011985: calls 4200
*** FLOP *** [Ad 7h Ac]
ivan 30011985: checks 
jcarlos.vale: bets 7000
ivan 30011985: raises 7000 to 14000
jcarlos.vale: raises 48854 to 62854 and is all-in
ivan 30011985: calls 5832 and is all-in
Uncalled bet (43022) returned to jcarlos.vale
*** TURN *** [Ad 7h Ac] [Td]
*** RIVER *** [Ad 7h Ac Td] [Ks]
*** SHOW DOWN ***
ivan 30011985: shows [Th As] (a full house, Aces full of Tens)
jcarlos.vale: shows [Qc Qd] (two pair, Aces and Queens)
ivan 30011985 collected 57339 from pot
*** SUMMARY ***
Total pot 57339 | Rake 0 
Board [Ad 7h Ac Td Ks]
Seat 1: ivan 30011985 showed [Th As] and won (57339) with a full house, Aces full of Tens
Seat 2: TRENDLINEOKI folded before Flop (didn't bet)
Seat 3: dim@n.89liza folded before Flop (didn't bet)
Seat 4: jcarlos.vale showed [Qc Qd] and lost with two pair, Aces and Queens
Seat 5: kensui folded before Flop (didn't bet)
Seat 6: Ajax2530 folded before Flop (didn't bet)
Seat 7: nikitka3000 (button) folded before Flop (didn't bet)
Seat 8: Matzen10 (small blind) folded before Flop
Seat 9: roddypra (big blind) folded before Flop



PokerStars Hand #221906872730: Tournament #3082657132, $0.98+$0.12 USD Hold'em No Limit - Level XIX (700/1400) - 2020/12/27 19:37:45 EET [2020/12/27 12:37:45 ET]
Table '3082657132 62' 9-max Seat #8 is the button
Seat 1: ivan 30011985 (57339 in chips) 
Seat 2: TRENDLINEOKI (32682 in chips) 
Seat 3: dim@n.89liza (81170 in chips) 
Seat 4: jcarlos.vale (43022 in chips) 
Seat 5: kensui (43382 in chips) 
Seat 6: Ajax2530 (83613 in chips) 
Seat 7: nikitka3000 (42682 in chips) 
Seat 8: Matzen10 (24914 in chips) 
Seat 9: roddypra (47200 in chips) 
ivan 30011985: posts the ante 175
TRENDLINEOKI: posts the ante 175
dim@n.89liza: posts the ante 175
jcarlos.vale: posts the ante 175
kensui: posts the ante 175
Ajax2530: posts the ante 175
nikitka3000: posts the ante 175
Matzen10: posts the ante 175
roddypra: posts the ante 175
roddypra: posts small blind 700
ivan 30011985: posts big blind 1400
*** HOLE CARDS ***
Dealt to jcarlos.vale [5s 3d]
TRENDLINEOKI: folds 
dim@n.89liza: folds 
jcarlos.vale: folds 
kensui: folds 
Ajax2530: raises 1720 to 3120
nikitka3000: folds 
Matzen10: folds 
roddypra: folds 
ivan 30011985: folds 
Uncalled bet (1720) returned to Ajax2530
Ajax2530 collected 5075 from pot
Ajax2530: doesn't show handDTO
*** SUMMARY ***
Total pot 5075 | Rake 0 
Seat 1: ivan 30011985 (big blind) folded before Flop
Seat 2: TRENDLINEOKI folded before Flop (didn't bet)
Seat 3: dim@n.89liza folded before Flop (didn't bet)
Seat 4: jcarlos.vale folded before Flop (didn't bet)
Seat 5: kensui folded before Flop (didn't bet)
Seat 6: Ajax2530 collected (5075)
Seat 7: nikitka3000 folded before Flop (didn't bet)
Seat 8: Matzen10 (button) folded before Flop (didn't bet)
Seat 9: roddypra (small blind) folded before Flop



PokerStars Hand #221906904217: Tournament #3082657132, $0.98+$0.12 USD Hold'em No Limit - Level XIX (700/1400) - 2020/12/27 19:38:24 EET [2020/12/27 12:38:24 ET]
Table '3082657132 62' 9-max Seat #9 is the button
Seat 1: ivan 30011985 (55764 in chips) 
Seat 2: TRENDLINEOKI (32507 in chips) 
Seat 3: dim@n.89liza (80995 in chips) 
Seat 4: jcarlos.vale (42847 in chips) 
Seat 5: kensui (43207 in chips) 
Seat 6: Ajax2530 (87113 in chips) 
Seat 7: nikitka3000 (42507 in chips) 
Seat 8: Matzen10 (24739 in chips) 
Seat 9: roddypra (46325 in chips) 
ivan 30011985: posts the ante 175
TRENDLINEOKI: posts the ante 175
dim@n.89liza: posts the ante 175
jcarlos.vale: posts the ante 175
kensui: posts the ante 175
Ajax2530: posts the ante 175
nikitka3000: posts the ante 175
Matzen10: posts the ante 175
roddypra: posts the ante 175
ivan 30011985: posts small blind 700
TRENDLINEOKI: posts big blind 1400
*** HOLE CARDS ***
Dealt to jcarlos.vale [Qc 5s]
dim@n.89liza: folds 
jcarlos.vale: folds 
kensui: folds 
Ajax2530: raises 1720 to 3120
nikitka3000: folds 
Matzen10: folds 
roddypra: folds 
ivan 30011985: folds 
TRENDLINEOKI: folds 
Uncalled bet (1720) returned to Ajax2530
Ajax2530 collected 5075 from pot
Ajax2530: doesn't show handDTO
*** SUMMARY ***
Total pot 5075 | Rake 0 
Seat 1: ivan 30011985 (small blind) folded before Flop
Seat 2: TRENDLINEOKI (big blind) folded before Flop
Seat 3: dim@n.89liza folded before Flop (didn't bet)
Seat 4: jcarlos.vale folded before Flop (didn't bet)
Seat 5: kensui folded before Flop (didn't bet)
Seat 6: Ajax2530 collected (5075)
Seat 7: nikitka3000 folded before Flop (didn't bet)
Seat 8: Matzen10 folded before Flop (didn't bet)
Seat 9: roddypra (button) folded before Flop (didn't bet)



PokerStars Hand #221906943217: Tournament #3082657132, $0.98+$0.12 USD Hold'em No Limit - Level XIX (700/1400) - 2020/12/27 19:39:12 EET [2020/12/27 12:39:12 ET]
Table '3082657132 62' 9-max Seat #1 is the button
Seat 1: ivan 30011985 (54889 in chips) 
Seat 2: TRENDLINEOKI (30932 in chips) 
Seat 3: dim@n.89liza (80820 in chips) 
Seat 4: jcarlos.vale (42672 in chips) 
Seat 5: kensui (43032 in chips) 
Seat 6: Ajax2530 (90613 in chips) 
Seat 7: nikitka3000 (42332 in chips) 
Seat 8: Matzen10 (24564 in chips) 
Seat 9: roddypra (46150 in chips) 
ivan 30011985: posts the ante 175
TRENDLINEOKI: posts the ante 175
dim@n.89liza: posts the ante 175
jcarlos.vale: posts the ante 175
kensui: posts the ante 175
Ajax2530: posts the ante 175
nikitka3000: posts the ante 175
Matzen10: posts the ante 175
roddypra: posts the ante 175
TRENDLINEOKI: posts small blind 700
dim@n.89liza: posts big blind 1400
*** HOLE CARDS ***
Dealt to jcarlos.vale [9d 2h]
jcarlos.vale: folds 
kensui: folds 
Ajax2530: folds 
nikitka3000: folds 
Matzen10: folds 
roddypra: folds 
ivan 30011985: raises 4200 to 5600
TRENDLINEOKI: folds 
dim@n.89liza: calls 4200
*** FLOP *** [Tc 6c 2s]
dim@n.89liza: checks 
ivan 30011985: checks 
*** TURN *** [Tc 6c 2s] [8c]
dim@n.89liza: checks 
ivan 30011985: bets 2800
dim@n.89liza: calls 2800
*** RIVER *** [Tc 6c 2s 8c] [Ts]
dim@n.89liza: checks 
ivan 30011985: bets 1400
dim@n.89liza: calls 1400
*** SHOW DOWN ***
ivan 30011985: shows [Th Td] (four of a kind, Tens)
dim@n.89liza: mucks handDTO
ivan 30011985 collected 21875 from pot
*** SUMMARY ***
Total pot 21875 | Rake 0 
Board [Tc 6c 2s 8c Ts]
Seat 1: ivan 30011985 (button) showed [Th Td] and won (21875) with four of a kind, Tens
Seat 2: TRENDLINEOKI (small blind) folded before Flop
Seat 3: dim@n.89liza (big blind) mucked [8s 9s]
Seat 4: jcarlos.vale folded before Flop (didn't bet)
Seat 5: kensui folded before Flop (didn't bet)
Seat 6: Ajax2530 folded before Flop (didn't bet)
Seat 7: nikitka3000 folded before Flop (didn't bet)
Seat 8: Matzen10 folded before Flop (didn't bet)
Seat 9: roddypra folded before Flop (didn't bet)



PokerStars Hand #221906983527: Tournament #3082657132, $0.98+$0.12 USD Hold'em No Limit - Level XIX (700/1400) - 2020/12/27 19:40:03 EET [2020/12/27 12:40:03 ET]
Table '3082657132 62' 9-max Seat #2 is the button
Seat 1: ivan 30011985 (66789 in chips) 
Seat 2: TRENDLINEOKI (30057 in chips) 
Seat 3: dim@n.89liza (70845 in chips) 
Seat 4: jcarlos.vale (42497 in chips) 
Seat 5: kensui (42857 in chips) 
Seat 6: Ajax2530 (90438 in chips) 
Seat 7: nikitka3000 (42157 in chips) 
Seat 8: Matzen10 (24389 in chips) 
Seat 9: roddypra (45975 in chips) 
ivan 30011985: posts the ante 175
TRENDLINEOKI: posts the ante 175
dim@n.89liza: posts the ante 175
jcarlos.vale: posts the ante 175
kensui: posts the ante 175
Ajax2530: posts the ante 175
nikitka3000: posts the ante 175
Matzen10: posts the ante 175
roddypra: posts the ante 175
dim@n.89liza: posts small blind 700
jcarlos.vale: posts big blind 1400
*** HOLE CARDS ***
Dealt to jcarlos.vale [8c Ks]
kensui: raises 1624 to 3024
Ajax2530: calls 3024
nikitka3000: folds 
Matzen10: calls 3024
roddypra: folds 
ivan 30011985: folds 
TRENDLINEOKI: folds 
dim@n.89liza: calls 2324
jcarlos.vale: folds 
*** FLOP *** [6h Js Qd]
dim@n.89liza: checks 
kensui: checks 
Ajax2530: checks 
Matzen10: checks 
*** TURN *** [6h Js Qd] [5s]
dim@n.89liza: checks 
kensui: checks 
Ajax2530: checks 
Matzen10: checks 
*** RIVER *** [6h Js Qd 5s] [3d]
dim@n.89liza: checks 
kensui: checks 
Ajax2530: checks 
Matzen10: checks 
*** SHOW DOWN ***
dim@n.89liza: shows [Ac 2d] (high pairOfCards Ace)
kensui: shows [Ad Td] (high pairOfCards Ace - Queen+Jack+Ten kicker)
Ajax2530: shows [4h 4s] (a pair of Fours)
Matzen10: shows [8s 8d] (a pair of Eights)
Matzen10 collected 15071 from pot
*** SUMMARY ***
Total pot 15071 | Rake 0 
Board [6h Js Qd 5s 3d]
Seat 1: ivan 30011985 folded before Flop (didn't bet)
Seat 2: TRENDLINEOKI (button) folded before Flop (didn't bet)
Seat 3: dim@n.89liza (small blind) showed [Ac 2d] and lost with high pairOfCards Ace
Seat 4: jcarlos.vale (big blind) folded before Flop
Seat 5: kensui showed [Ad Td] and lost with high pairOfCards Ace
Seat 6: Ajax2530 showed [4h 4s] and lost with a pair of Fours
Seat 7: nikitka3000 folded before Flop (didn't bet)
Seat 8: Matzen10 showed [8s 8d] and won (15071) with a pair of Eights
Seat 9: roddypra folded before Flop (didn't bet)



PokerStars Hand #221907048219: Tournament #3082657132, $0.98+$0.12 USD Hold'em No Limit - Level XIX (700/1400) - 2020/12/27 19:41:23 EET [2020/12/27 12:41:23 ET]
Table '3082657132 62' 9-max Seat #3 is the button
Seat 1: ivan 30011985 (66614 in chips) 
Seat 2: TRENDLINEOKI (29882 in chips) 
Seat 3: dim@n.89liza (67646 in chips) 
Seat 4: jcarlos.vale (40922 in chips) 
Seat 5: kensui (39658 in chips) 
Seat 6: Ajax2530 (87239 in chips) 
Seat 7: nikitka3000 (41982 in chips) 
Seat 8: Matzen10 (36261 in chips) 
Seat 9: roddypra (45800 in chips) 
ivan 30011985: posts the ante 175
TRENDLINEOKI: posts the ante 175
dim@n.89liza: posts the ante 175
jcarlos.vale: posts the ante 175
kensui: posts the ante 175
Ajax2530: posts the ante 175
nikitka3000: posts the ante 175
Matzen10: posts the ante 175
roddypra: posts the ante 175
jcarlos.vale: posts small blind 700
kensui: posts big blind 1400
*** HOLE CARDS ***
Dealt to jcarlos.vale [6d Td]
Ajax2530: folds 
nikitka3000: folds 
Matzen10: folds 
roddypra: folds 
ivan 30011985: calls 1400
TRENDLINEOKI: folds 
dim@n.89liza: raises 5600 to 7000
jcarlos.vale: folds 
kensui: folds 
ivan 30011985: folds 
Uncalled bet (5600) returned to dim@n.89liza
dim@n.89liza collected 6475 from pot
dim@n.89liza: doesn't show handDTO
*** SUMMARY ***
Total pot 6475 | Rake 0 
Seat 1: ivan 30011985 folded before Flop
Seat 2: TRENDLINEOKI folded before Flop (didn't bet)
Seat 3: dim@n.89liza (button) collected (6475)
Seat 4: jcarlos.vale (small blind) folded before Flop
Seat 5: kensui (big blind) folded before Flop
Seat 6: Ajax2530 folded before Flop (didn't bet)
Seat 7: nikitka3000 folded before Flop (didn't bet)
Seat 8: Matzen10 folded before Flop (didn't bet)
Seat 9: roddypra folded before Flop (didn't bet)



PokerStars Hand #221907071916: Tournament #3082657132, $0.98+$0.12 USD Hold'em No Limit - Level XIX (700/1400) - 2020/12/27 19:41:53 EET [2020/12/27 12:41:53 ET]
Table '3082657132 62' 9-max Seat #4 is the button
Seat 1: ivan 30011985 (65039 in chips) 
Seat 2: TRENDLINEOKI (29707 in chips) 
Seat 3: dim@n.89liza (72546 in chips) 
Seat 4: jcarlos.vale (40047 in chips) 
Seat 5: kensui (38083 in chips) 
Seat 6: Ajax2530 (87064 in chips) 
Seat 7: nikitka3000 (41807 in chips) 
Seat 8: Matzen10 (36086 in chips) 
Seat 9: roddypra (45625 in chips) 
ivan 30011985: posts the ante 175
TRENDLINEOKI: posts the ante 175
dim@n.89liza: posts the ante 175
jcarlos.vale: posts the ante 175
kensui: posts the ante 175
Ajax2530: posts the ante 175
nikitka3000: posts the ante 175
Matzen10: posts the ante 175
roddypra: posts the ante 175
kensui: posts small blind 700
Ajax2530: posts big blind 1400
*** HOLE CARDS ***
Dealt to jcarlos.vale [9s Jd]
nikitka3000: folds 
Matzen10: folds 
roddypra: folds 
ivan 30011985: folds 
TRENDLINEOKI: folds 
dim@n.89liza: raises 2800 to 4200
jcarlos.vale: folds 
kensui: folds 
Ajax2530: folds 
Uncalled bet (2800) returned to dim@n.89liza
dim@n.89liza collected 5075 from pot
dim@n.89liza: doesn't show handDTO
*** SUMMARY ***
Total pot 5075 | Rake 0 
Seat 1: ivan 30011985 folded before Flop (didn't bet)
Seat 2: TRENDLINEOKI folded before Flop (didn't bet)
Seat 3: dim@n.89liza collected (5075)
Seat 4: jcarlos.vale (button) folded before Flop (didn't bet)
Seat 5: kensui (small blind) folded before Flop
Seat 6: Ajax2530 (big blind) folded before Flop
Seat 7: nikitka3000 folded before Flop (didn't bet)
Seat 8: Matzen10 folded before Flop (didn't bet)
Seat 9: roddypra folded before Flop (didn't bet)



PokerStars Hand #221907091828: Tournament #3082657132, $0.98+$0.12 USD Hold'em No Limit - Level XIX (700/1400) - 2020/12/27 19:42:18 EET [2020/12/27 12:42:18 ET]
Table '3082657132 62' 9-max Seat #5 is the button
Seat 1: ivan 30011985 (64864 in chips) 
Seat 2: TRENDLINEOKI (29532 in chips) 
Seat 3: dim@n.89liza (76046 in chips) 
Seat 4: jcarlos.vale (39872 in chips) 
Seat 5: kensui (37208 in chips) 
Seat 6: Ajax2530 (85489 in chips) 
Seat 7: nikitka3000 (41632 in chips) 
Seat 8: Matzen10 (35911 in chips) 
Seat 9: roddypra (45450 in chips) 
ivan 30011985: posts the ante 175
TRENDLINEOKI: posts the ante 175
dim@n.89liza: posts the ante 175
jcarlos.vale: posts the ante 175
kensui: posts the ante 175
Ajax2530: posts the ante 175
nikitka3000: posts the ante 175
Matzen10: posts the ante 175
roddypra: posts the ante 175
Ajax2530: posts small blind 700
nikitka3000: posts big blind 1400
*** HOLE CARDS ***
Dealt to jcarlos.vale [6h Ts]
Matzen10: folds 
roddypra: raises 1400 to 2800
ivan 30011985 has timed out
ivan 30011985: folds 
ivan 30011985 is sitting out
TRENDLINEOKI: folds 
dim@n.89liza: folds 
jcarlos.vale: folds 
ivan 30011985 has returned
kensui: calls 2800
Ajax2530: folds 
nikitka3000: calls 1400
*** FLOP *** [Jc Th 7s]
nikitka3000: checks 
roddypra: checks 
kensui: checks 
*** TURN *** [Jc Th 7s] [2h]
nikitka3000: checks 
roddypra: bets 4200
kensui: calls 4200
nikitka3000: folds 
*** RIVER *** [Jc Th 7s 2h] [Kd]
roddypra: bets 9800
kensui: raises 9800 to 19600
roddypra: raises 9800 to 29400
kensui: raises 633 to 30033 and is all-in
roddypra: calls 633
*** SHOW DOWN ***
kensui: shows [Ac Qd] (a straight, Ten to Ace)
roddypra: shows [Qs Ad] (a straight, Ten to Ace)
roddypra collected 39571 from pot
kensui collected 39570 from pot
*** SUMMARY ***
Total pot 79141 | Rake 0 
Board [Jc Th 7s 2h Kd]
Seat 1: ivan 30011985 folded before Flop (didn't bet)
Seat 2: TRENDLINEOKI folded before Flop (didn't bet)
Seat 3: dim@n.89liza folded before Flop (didn't bet)
Seat 4: jcarlos.vale folded before Flop (didn't bet)
Seat 5: kensui (button) showed [Ac Qd] and won (39570) with a straight, Ten to Ace
Seat 6: Ajax2530 (small blind) folded before Flop
Seat 7: nikitka3000 (big blind) folded on the Turn
Seat 8: Matzen10 folded before Flop (didn't bet)
Seat 9: roddypra showed [Qs Ad] and won (39571) with a straight, Ten to Ace



PokerStars Hand #221907190312: Tournament #3082657132, $0.98+$0.12 USD Hold'em No Limit - Level XIX (700/1400) - 2020/12/27 19:44:14 EET [2020/12/27 12:44:14 ET]
Table '3082657132 62' 9-max Seat #6 is the button
Seat 1: ivan 30011985 (64689 in chips) 
Seat 2: TRENDLINEOKI (29357 in chips) 
Seat 3: dim@n.89liza (75871 in chips) 
Seat 4: jcarlos.vale (39697 in chips) 
Seat 5: kensui (39570 in chips) 
Seat 6: Ajax2530 (84614 in chips) 
Seat 7: nikitka3000 (38657 in chips) 
Seat 8: Matzen10 (35736 in chips) 
Seat 9: roddypra (47813 in chips) 
ivan 30011985: posts the ante 175
TRENDLINEOKI: posts the ante 175
dim@n.89liza: posts the ante 175
jcarlos.vale: posts the ante 175
kensui: posts the ante 175
Ajax2530: posts the ante 175
nikitka3000: posts the ante 175
Matzen10: posts the ante 175
roddypra: posts the ante 175
nikitka3000: posts small blind 700
Matzen10: posts big blind 1400
*** HOLE CARDS ***
Dealt to jcarlos.vale [2d Ks]
roddypra: folds 
ivan 30011985: folds 
TRENDLINEOKI: folds 
dim@n.89liza: raises 2800 to 4200
jcarlos.vale: folds 
kensui: folds 
Ajax2530: folds 
nikitka3000: folds 
Matzen10: folds 
Uncalled bet (2800) returned to dim@n.89liza
dim@n.89liza collected 5075 from pot
dim@n.89liza: doesn't show handDTO
*** SUMMARY ***
Total pot 5075 | Rake 0 
Seat 1: ivan 30011985 folded before Flop (didn't bet)
Seat 2: TRENDLINEOKI folded before Flop (didn't bet)
Seat 3: dim@n.89liza collected (5075)
Seat 4: jcarlos.vale folded before Flop (didn't bet)
Seat 5: kensui folded before Flop (didn't bet)
Seat 6: Ajax2530 (button) folded before Flop (didn't bet)
Seat 7: nikitka3000 (small blind) folded before Flop
Seat 8: Matzen10 (big blind) folded before Flop
Seat 9: roddypra folded before Flop (didn't bet)



PokerStars Hand #221907208520: Tournament #3082657132, $0.98+$0.12 USD Hold'em No Limit - Level XIX (700/1400) - 2020/12/27 19:44:37 EET [2020/12/27 12:44:37 ET]
Table '3082657132 62' 9-max Seat #7 is the button
Seat 1: ivan 30011985 (64514 in chips) 
Seat 2: TRENDLINEOKI (29182 in chips) 
Seat 3: dim@n.89liza (79371 in chips) 
Seat 4: jcarlos.vale (39522 in chips) 
Seat 5: kensui (39395 in chips) 
Seat 6: Ajax2530 (84439 in chips) 
Seat 7: nikitka3000 (37782 in chips) 
Seat 8: Matzen10 (34161 in chips) 
Seat 9: roddypra (47638 in chips) 
ivan 30011985: posts the ante 175
TRENDLINEOKI: posts the ante 175
dim@n.89liza: posts the ante 175
jcarlos.vale: posts the ante 175
kensui: posts the ante 175
Ajax2530: posts the ante 175
nikitka3000: posts the ante 175
Matzen10: posts the ante 175
roddypra: posts the ante 175
Matzen10: posts small blind 700
roddypra: posts big blind 1400
*** HOLE CARDS ***
Dealt to jcarlos.vale [Qh 5c]
ivan 30011985: calls 1400
TRENDLINEOKI: folds 
dim@n.89liza: folds 
jcarlos.vale: folds 
kensui: folds 
Ajax2530: folds 
nikitka3000: folds 
Matzen10: folds 
roddypra: checks 
*** FLOP *** [Js 5s Qc]
roddypra: checks 
ivan 30011985: bets 1400
roddypra: folds 
Uncalled bet (1400) returned to ivan 30011985
ivan 30011985 collected 5075 from pot
ivan 30011985: doesn't show handDTO
*** SUMMARY ***
Total pot 5075 | Rake 0 
Board [Js 5s Qc]
Seat 1: ivan 30011985 collected (5075)
Seat 2: TRENDLINEOKI folded before Flop (didn't bet)
Seat 3: dim@n.89liza folded before Flop (didn't bet)
Seat 4: jcarlos.vale folded before Flop (didn't bet)
Seat 5: kensui folded before Flop (didn't bet)
Seat 6: Ajax2530 folded before Flop (didn't bet)
Seat 7: nikitka3000 (button) folded before Flop (didn't bet)
Seat 8: Matzen10 (small blind) folded before Flop
Seat 9: roddypra (big blind) folded on the Flop



PokerStars Hand #221907232487: Tournament #3082657132, $0.98+$0.12 USD Hold'em No Limit - Level XX (800/1600) - 2020/12/27 19:45:08 EET [2020/12/27 12:45:08 ET]
Table '3082657132 62' 9-max Seat #8 is the button
Seat 1: ivan 30011985 (68014 in chips) 
Seat 2: TRENDLINEOKI (29007 in chips) 
Seat 3: dim@n.89liza (79196 in chips) 
Seat 4: jcarlos.vale (39347 in chips) 
Seat 5: kensui (39220 in chips) 
Seat 6: Ajax2530 (84264 in chips) 
Seat 7: nikitka3000 (37607 in chips) 
Seat 8: Matzen10 (33286 in chips) 
Seat 9: roddypra (46063 in chips) 
ivan 30011985: posts the ante 200
TRENDLINEOKI: posts the ante 200
dim@n.89liza: posts the ante 200
jcarlos.vale: posts the ante 200
kensui: posts the ante 200
Ajax2530: posts the ante 200
nikitka3000: posts the ante 200
Matzen10: posts the ante 200
roddypra: posts the ante 200
roddypra: posts small blind 800
ivan 30011985: posts big blind 1600
*** HOLE CARDS ***
Dealt to jcarlos.vale [Qc Ac]
TRENDLINEOKI: folds 
dim@n.89liza: folds 
jcarlos.vale: raises 2560 to 4160
kensui: folds 
Ajax2530: folds 
nikitka3000: folds 
Matzen10: folds 
roddypra: folds 
ivan 30011985: calls 2560
*** FLOP *** [Jh 5d 2h]
ivan 30011985: checks 
jcarlos.vale: bets 3200
ivan 30011985: calls 3200
*** TURN *** [Jh 5d 2h] [9s]
ivan 30011985: checks 
jcarlos.vale: checks 
*** RIVER *** [Jh 5d 2h 9s] [Qs]
ivan 30011985: checks 
jcarlos.vale: bets 4800
ivan 30011985 has timed out
ivan 30011985: folds 
ivan 30011985 is sitting out
Uncalled bet (4800) returned to jcarlos.vale
jcarlos.vale collected 17320 from pot
jcarlos.vale: doesn't show handDTO
ivan 30011985 has returned
*** SUMMARY ***
Total pot 17320 | Rake 0 
Board [Jh 5d 2h 9s Qs]
Seat 1: ivan 30011985 (big blind) folded on the River
Seat 2: TRENDLINEOKI folded before Flop (didn't bet)
Seat 3: dim@n.89liza folded before Flop (didn't bet)
Seat 4: jcarlos.vale collected (17320)
Seat 5: kensui folded before Flop (didn't bet)
Seat 6: Ajax2530 folded before Flop (didn't bet)
Seat 7: nikitka3000 folded before Flop (didn't bet)
Seat 8: Matzen10 (button) folded before Flop (didn't bet)
Seat 9: roddypra (small blind) folded before Flop



PokerStars Hand #221907284799: Tournament #3082657132, $0.98+$0.12 USD Hold'em No Limit - Level XX (800/1600) - 2020/12/27 19:46:13 EET [2020/12/27 12:46:13 ET]
Table '3082657132 62' 9-max Seat #9 is the button
Seat 1: ivan 30011985 (60454 in chips) 
Seat 2: TRENDLINEOKI (28807 in chips) 
Seat 3: dim@n.89liza (78996 in chips) 
Seat 4: jcarlos.vale (49107 in chips) 
Seat 5: kensui (39020 in chips) 
Seat 6: Ajax2530 (84064 in chips) 
Seat 7: nikitka3000 (37407 in chips) 
Seat 8: Matzen10 (33086 in chips) 
Seat 9: roddypra (45063 in chips) 
ivan 30011985: posts the ante 200
TRENDLINEOKI: posts the ante 200
dim@n.89liza: posts the ante 200
jcarlos.vale: posts the ante 200
kensui: posts the ante 200
Ajax2530: posts the ante 200
nikitka3000: posts the ante 200
Matzen10: posts the ante 200
roddypra: posts the ante 200
ivan 30011985: posts small blind 800
TRENDLINEOKI: posts big blind 1600
*** HOLE CARDS ***
Dealt to jcarlos.vale [Qc 3c]
dim@n.89liza: folds 
jcarlos.vale: folds 
kensui: folds 
Ajax2530: folds 
nikitka3000: folds 
Matzen10: raises 1600 to 3200
roddypra: folds 
ivan 30011985: calls 2400
TRENDLINEOKI: folds 
*** FLOP *** [Ac Kh 2c]
ivan 30011985: checks 
Matzen10: bets 2450
ivan 30011985: calls 2450
*** TURN *** [Ac Kh 2c] [7s]
ivan 30011985: checks 
Matzen10: checks 
*** RIVER *** [Ac Kh 2c 7s] [Jd]
ivan 30011985: bets 3200
Matzen10: raises 14400 to 17600
ivan 30011985: calls 14400
*** SHOW DOWN ***
Matzen10: shows [Qs Th] (a straight, Ten to Ace)
ivan 30011985: mucks handDTO
Matzen10 collected 49900 from pot
*** SUMMARY ***
Total pot 49900 | Rake 0 
Board [Ac Kh 2c 7s Jd]
Seat 1: ivan 30011985 (small blind) mucked [Ad Ah]
Seat 2: TRENDLINEOKI (big blind) folded before Flop
Seat 3: dim@n.89liza folded before Flop (didn't bet)
Seat 4: jcarlos.vale folded before Flop (didn't bet)
Seat 5: kensui folded before Flop (didn't bet)
Seat 6: Ajax2530 folded before Flop (didn't bet)
Seat 7: nikitka3000 folded before Flop (didn't bet)
Seat 8: Matzen10 showed [Qs Th] and won (49900) with a straight, Ten to Ace
Seat 9: roddypra (button) folded before Flop (didn't bet)



PokerStars Hand #221907351606: Tournament #3082657132, $0.98+$0.12 USD Hold'em No Limit - Level XX (800/1600) - 2020/12/27 19:47:37 EET [2020/12/27 12:47:37 ET]
Table '3082657132 62' 9-max Seat #1 is the button
Seat 1: ivan 30011985 (37004 in chips) 
Seat 2: TRENDLINEOKI (27007 in chips) 
Seat 3: dim@n.89liza (78796 in chips) 
Seat 4: jcarlos.vale (48907 in chips) 
Seat 5: kensui (38820 in chips) 
Seat 6: Ajax2530 (83864 in chips) 
Seat 7: nikitka3000 (37207 in chips) 
Seat 8: Matzen10 (59536 in chips) 
Seat 9: roddypra (44863 in chips) 
ivan 30011985: posts the ante 200
TRENDLINEOKI: posts the ante 200
dim@n.89liza: posts the ante 200
jcarlos.vale: posts the ante 200
kensui: posts the ante 200
Ajax2530: posts the ante 200
nikitka3000: posts the ante 200
Matzen10: posts the ante 200
roddypra: posts the ante 200
TRENDLINEOKI: posts small blind 800
dim@n.89liza: posts big blind 1600
*** HOLE CARDS ***
Dealt to jcarlos.vale [8h 7c]
jcarlos.vale: folds 
kensui: folds 
Ajax2530: folds 
nikitka3000: folds 
Matzen10: folds 
roddypra: folds 
ivan 30011985: folds 
TRENDLINEOKI: folds 
Uncalled bet (800) returned to dim@n.89liza
dim@n.89liza collected 3400 from pot
dim@n.89liza: doesn't show handDTO
*** SUMMARY ***
Total pot 3400 | Rake 0 
Seat 1: ivan 30011985 (button) folded before Flop (didn't bet)
Seat 2: TRENDLINEOKI (small blind) folded before Flop
Seat 3: dim@n.89liza (big blind) collected (3400)
Seat 4: jcarlos.vale folded before Flop (didn't bet)
Seat 5: kensui folded before Flop (didn't bet)
Seat 6: Ajax2530 folded before Flop (didn't bet)
Seat 7: nikitka3000 folded before Flop (didn't bet)
Seat 8: Matzen10 folded before Flop (didn't bet)
Seat 9: roddypra folded before Flop (didn't bet)



PokerStars Hand #221907366532: Tournament #3082657132, $0.98+$0.12 USD Hold'em No Limit - Level XX (800/1600) - 2020/12/27 19:47:55 EET [2020/12/27 12:47:55 ET]
Table '3082657132 62' 9-max Seat #2 is the button
Seat 1: ivan 30011985 (36804 in chips) 
Seat 2: TRENDLINEOKI (26007 in chips) 
Seat 3: dim@n.89liza (81196 in chips) 
Seat 4: jcarlos.vale (48707 in chips) 
Seat 5: kensui (38620 in chips) 
Seat 6: Ajax2530 (83664 in chips) 
Seat 7: nikitka3000 (37007 in chips) 
Seat 8: Matzen10 (59336 in chips) 
Seat 9: roddypra (44663 in chips) 
ivan 30011985: posts the ante 200
TRENDLINEOKI: posts the ante 200
dim@n.89liza: posts the ante 200
jcarlos.vale: posts the ante 200
kensui: posts the ante 200
Ajax2530: posts the ante 200
nikitka3000: posts the ante 200
Matzen10: posts the ante 200
roddypra: posts the ante 200
dim@n.89liza: posts small blind 800
jcarlos.vale: posts big blind 1600
*** HOLE CARDS ***
Dealt to jcarlos.vale [Th Ac]
kensui: folds 
Ajax2530: folds 
nikitka3000: raises 1600 to 3200
Matzen10: folds 
roddypra: folds 
ivan 30011985: calls 3200
TRENDLINEOKI: folds 
dim@n.89liza: raises 77796 to 80996 and is all-in
jcarlos.vale: folds 
nikitka3000: folds 
ivan 30011985: calls 33404 and is all-in
Uncalled bet (44392) returned to dim@n.89liza
*** FLOP *** [6d 6c 4s]
*** TURN *** [6d 6c 4s] [Jd]
*** RIVER *** [6d 6c 4s Jd] [9d]
*** SHOW DOWN ***
dim@n.89liza: shows [As 9s] (two pair, Nines and Sixes)
ivan 30011985: shows [Ah Qs] (a pair of Sixes)
dim@n.89liza collected 79808 from pot
ivan 30011985 finished the tournament in 176th place and received $3.75.
*** SUMMARY ***
Total pot 79808 | Rake 0 
Board [6d 6c 4s Jd 9d]
Seat 1: ivan 30011985 showed [Ah Qs] and lost with a pair of Sixes
Seat 2: TRENDLINEOKI (button) folded before Flop (didn't bet)
Seat 3: dim@n.89liza (small blind) showed [As 9s] and won (79808) with two pair, Nines and Sixes
Seat 4: jcarlos.vale (big blind) folded before Flop
Seat 5: kensui folded before Flop (didn't bet)
Seat 6: Ajax2530 folded before Flop (didn't bet)
Seat 7: nikitka3000 folded before Flop
Seat 8: Matzen10 folded before Flop (didn't bet)
Seat 9: roddypra folded before Flop (didn't bet)



PokerStars Hand #221907417986: Tournament #3082657132, $0.98+$0.12 USD Hold'em No Limit - Level XX (800/1600) - 2020/12/27 19:48:48 EET [2020/12/27 12:48:48 ET]
Table '3082657132 62' 9-max Seat #3 is the button
Seat 2: TRENDLINEOKI (25807 in chips) 
Seat 3: dim@n.89liza (124200 in chips) 
Seat 4: jcarlos.vale (46907 in chips) 
Seat 5: kensui (38420 in chips) 
Seat 6: Ajax2530 (83464 in chips) 
Seat 7: nikitka3000 (33607 in chips) 
Seat 8: Matzen10 (59136 in chips) 
Seat 9: roddypra (44463 in chips) 
TRENDLINEOKI: posts the ante 200
dim@n.89liza: posts the ante 200
jcarlos.vale: posts the ante 200
kensui: posts the ante 200
Ajax2530: posts the ante 200
nikitka3000: posts the ante 200
Matzen10: posts the ante 200
roddypra: posts the ante 200
jcarlos.vale: posts small blind 800
kensui: posts big blind 1600
*** HOLE CARDS ***
Dealt to jcarlos.vale [4h 9c]
Ajax2530: folds 
nikitka3000: folds 
Matzen10: folds 
roddypra: folds 
TRENDLINEOKI: folds 
dim@n.89liza: folds 
jcarlos.vale: folds 
Uncalled bet (800) returned to kensui
kensui collected 3200 from pot
kensui: doesn't show handDTO
*** SUMMARY ***
Total pot 3200 | Rake 0 
Seat 2: TRENDLINEOKI folded before Flop (didn't bet)
Seat 3: dim@n.89liza (button) folded before Flop (didn't bet)
Seat 4: jcarlos.vale (small blind) folded before Flop
Seat 5: kensui (big blind) collected (3200)
Seat 6: Ajax2530 folded before Flop (didn't bet)
Seat 7: nikitka3000 folded before Flop (didn't bet)
Seat 8: Matzen10 folded before Flop (didn't bet)
Seat 9: roddypra folded before Flop (didn't bet)



PokerStars Hand #221907456568: Tournament #3082657132, $0.98+$0.12 USD Hold'em No Limit - Level XX (800/1600) - 2020/12/27 19:49:37 EET [2020/12/27 12:49:37 ET]
Table '3082657132 62' 9-max Seat #4 is the button
Seat 2: TRENDLINEOKI (25607 in chips) 
Seat 3: dim@n.89liza (124000 in chips) 
Seat 4: jcarlos.vale (45907 in chips) 
Seat 5: kensui (40620 in chips) 
Seat 6: Ajax2530 (83264 in chips) 
Seat 7: nikitka3000 (33407 in chips) 
Seat 8: Matzen10 (58936 in chips) 
Seat 9: roddypra (44263 in chips) 
TRENDLINEOKI: posts the ante 200
dim@n.89liza: posts the ante 200
jcarlos.vale: posts the ante 200
kensui: posts the ante 200
Ajax2530: posts the ante 200
nikitka3000: posts the ante 200
Matzen10: posts the ante 200
roddypra: posts the ante 200
kensui: posts small blind 800
Ajax2530: posts big blind 1600
*** HOLE CARDS ***
Dealt to jcarlos.vale [4s 6d]
nikitka3000: folds 
Matzen10: raises 1600 to 3200
roddypra: folds 
TRENDLINEOKI: folds 
dim@n.89liza: folds 
jcarlos.vale: folds 
kensui: folds 
Ajax2530: calls 1600
*** FLOP *** [7h 2h 4h]
Ajax2530: checks 
Matzen10: checks 
*** TURN *** [7h 2h 4h] [2s]
Ajax2530: bets 3330
Matzen10: folds 
Uncalled bet (3330) returned to Ajax2530
Ajax2530 collected 8800 from pot
Ajax2530: doesn't show handDTO
*** SUMMARY ***
Total pot 8800 | Rake 0 
Board [7h 2h 4h 2s]
Seat 2: TRENDLINEOKI folded before Flop (didn't bet)
Seat 3: dim@n.89liza folded before Flop (didn't bet)
Seat 4: jcarlos.vale (button) folded before Flop (didn't bet)
Seat 5: kensui (small blind) folded before Flop
Seat 6: Ajax2530 (big blind) collected (8800)
Seat 7: nikitka3000 folded before Flop (didn't bet)
Seat 8: Matzen10 folded on the Turn
Seat 9: roddypra folded before Flop (didn't bet)



PokerStars Hand #221907497356: Tournament #3082657132, $0.98+$0.12 USD Hold'em No Limit - Level XX (800/1600) - 2020/12/27 19:50:28 EET [2020/12/27 12:50:28 ET]
Table '3082657132 62' 9-max Seat #5 is the button
Seat 1: Bigmag2011 (35025 in chips) 
Seat 2: TRENDLINEOKI (25407 in chips) 
Seat 3: dim@n.89liza (123800 in chips) 
Seat 4: jcarlos.vale (45707 in chips) 
Seat 5: kensui (39620 in chips) 
Seat 6: Ajax2530 (88664 in chips) 
Seat 7: nikitka3000 (33207 in chips) 
Seat 8: Matzen10 (55536 in chips) 
Seat 9: roddypra (44063 in chips) 
Bigmag2011: posts the ante 200
TRENDLINEOKI: posts the ante 200
dim@n.89liza: posts the ante 200
jcarlos.vale: posts the ante 200
kensui: posts the ante 200
Ajax2530: posts the ante 200
nikitka3000: posts the ante 200
Matzen10: posts the ante 200
roddypra: posts the ante 200
Ajax2530: posts small blind 800
nikitka3000: posts big blind 1600
*** HOLE CARDS ***
Dealt to jcarlos.vale [9d Jd]
Matzen10: folds 
roddypra: folds 
Bigmag2011: folds 
TRENDLINEOKI: raises 23607 to 25207 and is all-in
dim@n.89liza: folds 
jcarlos.vale: folds 
kensui: folds 
Ajax2530: folds 
nikitka3000: folds 
Uncalled bet (23607) returned to TRENDLINEOKI
TRENDLINEOKI collected 5800 from pot
TRENDLINEOKI: doesn't show handDTO
*** SUMMARY ***
Total pot 5800 | Rake 0 
Seat 1: Bigmag2011 folded before Flop (didn't bet)
Seat 2: TRENDLINEOKI collected (5800)
Seat 3: dim@n.89liza folded before Flop (didn't bet)
Seat 4: jcarlos.vale folded before Flop (didn't bet)
Seat 5: kensui (button) folded before Flop (didn't bet)
Seat 6: Ajax2530 (small blind) folded before Flop
Seat 7: nikitka3000 (big blind) folded before Flop
Seat 8: Matzen10 folded before Flop (didn't bet)
Seat 9: roddypra folded before Flop (didn't bet)



PokerStars Hand #221907515386: Tournament #3082657132, $0.98+$0.12 USD Hold'em No Limit - Level XX (800/1600) - 2020/12/27 19:50:50 EET [2020/12/27 12:50:50 ET]
Table '3082657132 62' 9-max Seat #6 is the button
Seat 1: Bigmag2011 (34825 in chips) 
Seat 2: TRENDLINEOKI (29407 in chips) 
Seat 3: dim@n.89liza (123600 in chips) 
Seat 4: jcarlos.vale (45507 in chips) 
Seat 5: kensui (39420 in chips) 
Seat 6: Ajax2530 (87664 in chips) 
Seat 7: nikitka3000 (31407 in chips) 
Seat 8: Matzen10 (55336 in chips) 
Seat 9: roddypra (43863 in chips) 
Bigmag2011: posts the ante 200
TRENDLINEOKI: posts the ante 200
dim@n.89liza: posts the ante 200
jcarlos.vale: posts the ante 200
kensui: posts the ante 200
Ajax2530: posts the ante 200
nikitka3000: posts the ante 200
Matzen10: posts the ante 200
roddypra: posts the ante 200
nikitka3000: posts small blind 800
Matzen10: posts big blind 1600
*** HOLE CARDS ***
Dealt to jcarlos.vale [3s 2d]
roddypra: folds 
Bigmag2011: folds 
TRENDLINEOKI: calls 1600
dim@n.89liza: folds 
jcarlos.vale: folds 
kensui: folds 
Ajax2530: folds 
nikitka3000: folds 
Matzen10: checks 
*** FLOP *** [2s 8d Kd]
Matzen10: checks 
TRENDLINEOKI: bets 1914
Matzen10: folds 
Uncalled bet (1914) returned to TRENDLINEOKI
TRENDLINEOKI collected 5800 from pot
TRENDLINEOKI: doesn't show handDTO
*** SUMMARY ***
Total pot 5800 | Rake 0 
Board [2s 8d Kd]
Seat 1: Bigmag2011 folded before Flop (didn't bet)
Seat 2: TRENDLINEOKI collected (5800)
Seat 3: dim@n.89liza folded before Flop (didn't bet)
Seat 4: jcarlos.vale folded before Flop (didn't bet)
Seat 5: kensui folded before Flop (didn't bet)
Seat 6: Ajax2530 (button) folded before Flop (didn't bet)
Seat 7: nikitka3000 (small blind) folded before Flop
Seat 8: Matzen10 (big blind) folded on the Flop
Seat 9: roddypra folded before Flop (didn't bet)



PokerStars Hand #221907551958: Tournament #3082657132, $0.98+$0.12 USD Hold'em No Limit - Level XX (800/1600) - 2020/12/27 19:51:36 EET [2020/12/27 12:51:36 ET]
Table '3082657132 62' 9-max Seat #7 is the button
Seat 1: Bigmag2011 (34625 in chips) 
Seat 2: TRENDLINEOKI (33407 in chips) 
Seat 3: dim@n.89liza (123400 in chips) 
Seat 4: jcarlos.vale (45307 in chips) 
Seat 5: kensui (39220 in chips) 
Seat 6: Ajax2530 (87464 in chips) 
Seat 7: nikitka3000 (30407 in chips) 
Seat 8: Matzen10 (53536 in chips) 
Seat 9: roddypra (43663 in chips) 
Bigmag2011: posts the ante 200
TRENDLINEOKI: posts the ante 200
dim@n.89liza: posts the ante 200
jcarlos.vale: posts the ante 200
kensui: posts the ante 200
Ajax2530: posts the ante 200
nikitka3000: posts the ante 200
Matzen10: posts the ante 200
roddypra: posts the ante 200
Matzen10: posts small blind 800
roddypra: posts big blind 1600
*** HOLE CARDS ***
Dealt to jcarlos.vale [6s Kc]
Bigmag2011: folds 
TRENDLINEOKI: folds 
dim@n.89liza: raises 3200 to 4800
jcarlos.vale: folds 
kensui: folds 
Ajax2530: folds 
nikitka3000: raises 25407 to 30207 and is all-in
Matzen10: folds 
roddypra: folds 
dim@n.89liza: calls 25407
*** FLOP *** [3d Qh 8h]
*** TURN *** [3d Qh 8h] [Jh]
*** RIVER *** [3d Qh 8h Jh] [4s]
*** SHOW DOWN ***
dim@n.89liza: shows [3h 3c] (three of a kind, Threes)
nikitka3000: shows [7c 7d] (a pair of Sevens)
dim@n.89liza collected 64614 from pot
nikitka3000 finished the tournament in 170th place and received $3.75.
*** SUMMARY ***
Total pot 64614 | Rake 0 
Board [3d Qh 8h Jh 4s]
Seat 1: Bigmag2011 folded before Flop (didn't bet)
Seat 2: TRENDLINEOKI folded before Flop (didn't bet)
Seat 3: dim@n.89liza showed [3h 3c] and won (64614) with three of a kind, Threes
Seat 4: jcarlos.vale folded before Flop (didn't bet)
Seat 5: kensui folded before Flop (didn't bet)
Seat 6: Ajax2530 folded before Flop (didn't bet)
Seat 7: nikitka3000 (button) showed [7c 7d] and lost with a pair of Sevens
Seat 8: Matzen10 (small blind) folded before Flop
Seat 9: roddypra (big blind) folded before Flop



PokerStars Hand #221907581470: Tournament #3082657132, $0.98+$0.12 USD Hold'em No Limit - Level XX (800/1600) - 2020/12/27 19:52:13 EET [2020/12/27 12:52:13 ET]
Table '3082657132 62' 9-max Seat #8 is the button
Seat 1: Bigmag2011 (34425 in chips) 
Seat 2: TRENDLINEOKI (33207 in chips) 
Seat 3: dim@n.89liza (157607 in chips) 
Seat 4: jcarlos.vale (45107 in chips) 
Seat 5: kensui (39020 in chips) 
Seat 6: Ajax2530 (87264 in chips) 
Seat 8: Matzen10 (52536 in chips) 
Seat 9: roddypra (41863 in chips) 
Bigmag2011: posts the ante 200
TRENDLINEOKI: posts the ante 200
dim@n.89liza: posts the ante 200
jcarlos.vale: posts the ante 200
kensui: posts the ante 200
Ajax2530: posts the ante 200
Matzen10: posts the ante 200
roddypra: posts the ante 200
roddypra: posts small blind 800
Bigmag2011: posts big blind 1600
*** HOLE CARDS ***
Dealt to jcarlos.vale [9s Th]
TRENDLINEOKI: folds 
dim@n.89liza: folds 
jcarlos.vale: folds 
kensui: folds 
Ajax2530: raises 2060 to 3660
Matzen10: folds 
roddypra: calls 2860
Bigmag2011: calls 2060
*** FLOP *** [6c 4c Ad]
roddypra: checks 
Bigmag2011: checks 
Ajax2530: bets 4220
roddypra: folds 
Bigmag2011: folds 
Uncalled bet (4220) returned to Ajax2530
Ajax2530 collected 12580 from pot
Ajax2530: doesn't show handDTO
*** SUMMARY ***
Total pot 12580 | Rake 0 
Board [6c 4c Ad]
Seat 1: Bigmag2011 (big blind) folded on the Flop
Seat 2: TRENDLINEOKI folded before Flop (didn't bet)
Seat 3: dim@n.89liza folded before Flop (didn't bet)
Seat 4: jcarlos.vale folded before Flop (didn't bet)
Seat 5: kensui folded before Flop (didn't bet)
Seat 6: Ajax2530 collected (12580)
Seat 8: Matzen10 (button) folded before Flop (didn't bet)
Seat 9: roddypra (small blind) folded on the Flop



PokerStars Hand #221907621933: Tournament #3082657132, $0.98+$0.12 USD Hold'em No Limit - Level XX (800/1600) - 2020/12/27 19:53:04 EET [2020/12/27 12:53:04 ET]
Table '3082657132 62' 9-max Seat #9 is the button
Seat 1: Bigmag2011 (30565 in chips) 
Seat 2: TRENDLINEOKI (33007 in chips) 
Seat 3: dim@n.89liza (157407 in chips) 
Seat 4: jcarlos.vale (44907 in chips) 
Seat 5: kensui (38820 in chips) 
Seat 6: Ajax2530 (95984 in chips) 
Seat 8: Matzen10 (52336 in chips) 
Seat 9: roddypra (38003 in chips) 
Bigmag2011: posts the ante 200
TRENDLINEOKI: posts the ante 200
dim@n.89liza: posts the ante 200
jcarlos.vale: posts the ante 200
kensui: posts the ante 200
Ajax2530: posts the ante 200
Matzen10: posts the ante 200
roddypra: posts the ante 200
Bigmag2011: posts small blind 800
TRENDLINEOKI: posts big blind 1600
*** HOLE CARDS ***
Dealt to jcarlos.vale [3h Qh]
dim@n.89liza: folds 
jcarlos.vale: folds 
kensui: folds 
Ajax2530: folds 
Matzen10: raises 1600 to 3200
roddypra: folds 
Bigmag2011: folds 
TRENDLINEOKI: calls 1600
*** FLOP *** [Jd Kc Jh]
TRENDLINEOKI: checks 
Matzen10: bets 2200
TRENDLINEOKI: folds 
Uncalled bet (2200) returned to Matzen10
Matzen10 collected 8800 from pot
Matzen10: doesn't show handDTO
*** SUMMARY ***
Total pot 8800 | Rake 0 
Board [Jd Kc Jh]
Seat 1: Bigmag2011 (small blind) folded before Flop
Seat 2: TRENDLINEOKI (big blind) folded on the Flop
Seat 3: dim@n.89liza folded before Flop (didn't bet)
Seat 4: jcarlos.vale folded before Flop (didn't bet)
Seat 5: kensui folded before Flop (didn't bet)
Seat 6: Ajax2530 folded before Flop (didn't bet)
Seat 8: Matzen10 collected (8800)
Seat 9: roddypra (button) folded before Flop (didn't bet)



PokerStars Hand #221907664280: Tournament #3082657132, $0.98+$0.12 USD Hold'em No Limit - Level XX (800/1600) - 2020/12/27 19:53:58 EET [2020/12/27 12:53:58 ET]
Table '3082657132 62' 9-max Seat #1 is the button
Seat 1: Bigmag2011 (29565 in chips) 
Seat 2: TRENDLINEOKI (29607 in chips) 
Seat 3: dim@n.89liza (157207 in chips) 
Seat 4: jcarlos.vale (44707 in chips) 
Seat 5: kensui (38620 in chips) 
Seat 6: Ajax2530 (95784 in chips) 
Seat 8: Matzen10 (57736 in chips) 
Seat 9: roddypra (37803 in chips) 
Bigmag2011: posts the ante 200
TRENDLINEOKI: posts the ante 200
dim@n.89liza: posts the ante 200
jcarlos.vale: posts the ante 200
kensui: posts the ante 200
Ajax2530: posts the ante 200
Matzen10: posts the ante 200
roddypra: posts the ante 200
TRENDLINEOKI: posts small blind 800
dim@n.89liza: posts big blind 1600
*** HOLE CARDS ***
Dealt to jcarlos.vale [4h 2d]
jcarlos.vale: folds 
kensui: raises 1856 to 3456
Ajax2530: folds 
Matzen10: folds 
roddypra: folds 
Bigmag2011: folds 
TRENDLINEOKI: folds 
dim@n.89liza: folds 
Uncalled bet (1856) returned to kensui
kensui collected 5600 from pot
kensui: doesn't show handDTO
*** SUMMARY ***
Total pot 5600 | Rake 0 
Seat 1: Bigmag2011 (button) folded before Flop (didn't bet)
Seat 2: TRENDLINEOKI (small blind) folded before Flop
Seat 3: dim@n.89liza (big blind) folded before Flop
Seat 4: jcarlos.vale folded before Flop (didn't bet)
Seat 5: kensui collected (5600)
Seat 6: Ajax2530 folded before Flop (didn't bet)
Seat 8: Matzen10 folded before Flop (didn't bet)
Seat 9: roddypra folded before Flop (didn't bet)



PokerStars Hand #221907678761: Tournament #3082657132, $0.98+$0.12 USD Hold'em No Limit - Level XX (800/1600) - 2020/12/27 19:54:16 EET [2020/12/27 12:54:16 ET]
Table '3082657132 62' 9-max Seat #2 is the button
Seat 1: Bigmag2011 (29365 in chips) 
Seat 2: TRENDLINEOKI (28607 in chips) 
Seat 3: dim@n.89liza (155407 in chips) 
Seat 4: jcarlos.vale (44507 in chips) 
Seat 5: kensui (42420 in chips) 
Seat 6: Ajax2530 (95584 in chips) 
Seat 8: Matzen10 (57536 in chips) 
Seat 9: roddypra (37603 in chips) 
Bigmag2011: posts the ante 200
TRENDLINEOKI: posts the ante 200
dim@n.89liza: posts the ante 200
jcarlos.vale: posts the ante 200
kensui: posts the ante 200
Ajax2530: posts the ante 200
Matzen10: posts the ante 200
roddypra: posts the ante 200
dim@n.89liza: posts small blind 800
jcarlos.vale: posts big blind 1600
*** HOLE CARDS ***
Dealt to jcarlos.vale [2c 2h]
kensui: folds 
Ajax2530: folds 
Matzen10: folds 
roddypra: folds 
Bigmag2011 has timed out
Bigmag2011: folds 
Bigmag2011 is sitting out
Bigmag2011 has returned
TRENDLINEOKI: raises 1920 to 3520
dim@n.89liza has timed out
dim@n.89liza: folds 
dim@n.89liza is sitting out
jcarlos.vale: calls 1920
*** FLOP *** [8c Jc Tc]
jcarlos.vale: checks 
TRENDLINEOKI: bets 1600
jcarlos.vale: calls 1600
*** TURN *** [8c Jc Tc] [6d]
jcarlos.vale: checks 
TRENDLINEOKI: checks 
*** RIVER *** [8c Jc Tc 6d] [Ts]
jcarlos.vale: bets 3200
TRENDLINEOKI: folds 
Uncalled bet (3200) returned to jcarlos.vale
jcarlos.vale collected 12640 from pot
jcarlos.vale: doesn't show handDTO
*** SUMMARY ***
Total pot 12640 | Rake 0 
Board [8c Jc Tc 6d Ts]
Seat 1: Bigmag2011 folded before Flop (didn't bet)
Seat 2: TRENDLINEOKI (button) folded on the River
Seat 3: dim@n.89liza (small blind) folded before Flop
Seat 4: jcarlos.vale (big blind) collected (12640)
Seat 5: kensui folded before Flop (didn't bet)
Seat 6: Ajax2530 folded before Flop (didn't bet)
Seat 8: Matzen10 folded before Flop (didn't bet)
Seat 9: roddypra folded before Flop (didn't bet)



PokerStars Hand #221907941089: Tournament #3082657132, $0.98+$0.12 USD Hold'em No Limit - Level XXI (900/1800) - 2020/12/27 20:01:31 EET [2020/12/27 13:01:31 ET]
Table '3082657132 62' 9-max Seat #3 is the button
Seat 1: Bigmag2011 (29165 in chips) 
Seat 2: TRENDLINEOKI (23287 in chips) 
Seat 3: dim@n.89liza (154407 in chips) is sitting out
Seat 4: jcarlos.vale (51827 in chips) 
Seat 5: kensui (42220 in chips) 
Seat 6: Ajax2530 (95384 in chips) 
Seat 7: Ermuun_34b (81693 in chips) 
Seat 8: Matzen10 (57336 in chips) 
Seat 9: roddypra (37403 in chips) 
Bigmag2011: posts the ante 225
TRENDLINEOKI: posts the ante 225
dim@n.89liza: posts the ante 225
jcarlos.vale: posts the ante 225
kensui: posts the ante 225
Ajax2530: posts the ante 225
Ermuun_34b: posts the ante 225
Matzen10: posts the ante 225
roddypra: posts the ante 225
jcarlos.vale: posts small blind 900
kensui: posts big blind 1800
*** HOLE CARDS ***
Dealt to jcarlos.vale [Kd 3d]
dim@n.89liza has returned
Ajax2530 has timed out
Ajax2530: folds 
Ajax2530 is sitting out
Ermuun_34b: folds 
Matzen10: folds 
roddypra: folds 
Bigmag2011: folds 
Ajax2530 has returned
TRENDLINEOKI: calls 1800
dim@n.89liza: folds 
jcarlos.vale: calls 900
kensui: checks 
*** FLOP *** [Td 4h Ts]
jcarlos.vale: checks 
kensui: checks 
TRENDLINEOKI: checks 
*** TURN *** [Td 4h Ts] [Qh]
jcarlos.vale: checks 
kensui: checks 
TRENDLINEOKI: bets 3564
jcarlos.vale: folds 
kensui: calls 3564
*** RIVER *** [Td 4h Ts Qh] [3s]
kensui: checks 
TRENDLINEOKI: bets 6985
kensui: folds 
Uncalled bet (6985) returned to TRENDLINEOKI
TRENDLINEOKI collected 14553 from pot
TRENDLINEOKI: doesn't show handDTO
*** SUMMARY ***
Total pot 14553 | Rake 0 
Board [Td 4h Ts Qh 3s]
Seat 1: Bigmag2011 folded before Flop (didn't bet)
Seat 2: TRENDLINEOKI collected (14553)
Seat 3: dim@n.89liza (button) folded before Flop (didn't bet)
Seat 4: jcarlos.vale (small blind) folded on the Turn
Seat 5: kensui (big blind) folded on the River
Seat 6: Ajax2530 folded before Flop (didn't bet)
Seat 7: Ermuun_34b folded before Flop (didn't bet)
Seat 8: Matzen10 folded before Flop (didn't bet)
Seat 9: roddypra folded before Flop (didn't bet)



PokerStars Hand #221908049141: Tournament #3082657132, $0.98+$0.12 USD Hold'em No Limit - Level XXI (900/1800) - 2020/12/27 20:03:38 EET [2020/12/27 13:03:38 ET]
Table '3082657132 62' 9-max Seat #4 is the button
Seat 1: Bigmag2011 (28940 in chips) 
Seat 2: TRENDLINEOKI (32251 in chips) 
Seat 3: dim@n.89liza (154182 in chips) 
Seat 4: jcarlos.vale (49802 in chips) 
Seat 5: kensui (36631 in chips) 
Seat 6: Ajax2530 (95159 in chips) 
Seat 7: Ermuun_34b (81468 in chips) 
Seat 8: Matzen10 (57111 in chips) 
Seat 9: roddypra (37178 in chips) 
Bigmag2011: posts the ante 225
TRENDLINEOKI: posts the ante 225
dim@n.89liza: posts the ante 225
jcarlos.vale: posts the ante 225
kensui: posts the ante 225
Ajax2530: posts the ante 225
Ermuun_34b: posts the ante 225
Matzen10: posts the ante 225
roddypra: posts the ante 225
kensui: posts small blind 900
Ajax2530: posts big blind 1800
*** HOLE CARDS ***
Dealt to jcarlos.vale [Jh 9s]
Ermuun_34b: calls 1800
Matzen10: raises 4320 to 6120
roddypra: folds 
Bigmag2011: folds 
TRENDLINEOKI: folds 
dim@n.89liza: folds 
jcarlos.vale: folds 
kensui: folds 
Ajax2530: folds 
Ermuun_34b: folds 
Uncalled bet (4320) returned to Matzen10
Matzen10 collected 8325 from pot
Matzen10: doesn't show handDTO
*** SUMMARY ***
Total pot 8325 | Rake 0 
Seat 1: Bigmag2011 folded before Flop (didn't bet)
Seat 2: TRENDLINEOKI folded before Flop (didn't bet)
Seat 3: dim@n.89liza folded before Flop (didn't bet)
Seat 4: jcarlos.vale (button) folded before Flop (didn't bet)
Seat 5: kensui (small blind) folded before Flop
Seat 6: Ajax2530 (big blind) folded before Flop
Seat 7: Ermuun_34b folded before Flop
Seat 8: Matzen10 collected (8325)
Seat 9: roddypra folded before Flop (didn't bet)



PokerStars Hand #221908086190: Tournament #3082657132, $0.98+$0.12 USD Hold'em No Limit - Level XXI (900/1800) - 2020/12/27 20:04:21 EET [2020/12/27 13:04:21 ET]
Table '3082657132 62' 9-max Seat #5 is the button
Seat 1: Bigmag2011 (28715 in chips) 
Seat 2: TRENDLINEOKI (32026 in chips) 
Seat 3: dim@n.89liza (153957 in chips) 
Seat 4: jcarlos.vale (49577 in chips) 
Seat 5: kensui (35506 in chips) 
Seat 6: Ajax2530 (93134 in chips) 
Seat 7: Ermuun_34b (79443 in chips) 
Seat 8: Matzen10 (63411 in chips) 
Seat 9: roddypra (36953 in chips) 
Bigmag2011: posts the ante 225
TRENDLINEOKI: posts the ante 225
dim@n.89liza: posts the ante 225
jcarlos.vale: posts the ante 225
kensui: posts the ante 225
Ajax2530: posts the ante 225
Ermuun_34b: posts the ante 225
Matzen10: posts the ante 225
roddypra: posts the ante 225
Ajax2530: posts small blind 900
Ermuun_34b: posts big blind 1800
*** HOLE CARDS ***
Dealt to jcarlos.vale [7c Jd]
Matzen10: folds 
roddypra: folds 
Bigmag2011: folds 
TRENDLINEOKI: folds 
dim@n.89liza: folds 
jcarlos.vale: folds 
kensui: folds 
Ajax2530 has timed out
Ajax2530: folds 
Ajax2530 is sitting out
Uncalled bet (900) returned to Ermuun_34b
Ermuun_34b collected 3825 from pot
Ermuun_34b: doesn't show handDTO
*** SUMMARY ***
Total pot 3825 | Rake 0 
Seat 1: Bigmag2011 folded before Flop (didn't bet)
Seat 2: TRENDLINEOKI folded before Flop (didn't bet)
Seat 3: dim@n.89liza folded before Flop (didn't bet)
Seat 4: jcarlos.vale folded before Flop (didn't bet)
Seat 5: kensui (button) folded before Flop (didn't bet)
Seat 6: Ajax2530 (small blind) folded before Flop
Seat 7: Ermuun_34b (big blind) collected (3825)
Seat 8: Matzen10 folded before Flop (didn't bet)
Seat 9: roddypra folded before Flop (didn't bet)



PokerStars Hand #221908113137: Tournament #3082657132, $0.98+$0.12 USD Hold'em No Limit - Level XXI (900/1800) - 2020/12/27 20:04:51 EET [2020/12/27 13:04:51 ET]
Table '3082657132 62' 9-max Seat #6 is the button
Seat 1: Bigmag2011 (28490 in chips) 
Seat 2: TRENDLINEOKI (31801 in chips) 
Seat 3: dim@n.89liza (153732 in chips) 
Seat 4: jcarlos.vale (49352 in chips) 
Seat 5: kensui (35281 in chips) 
Seat 6: Ajax2530 (92009 in chips) is sitting out
Seat 7: Ermuun_34b (82143 in chips) 
Seat 8: Matzen10 (63186 in chips) 
Seat 9: roddypra (36728 in chips) 
Bigmag2011: posts the ante 225
TRENDLINEOKI: posts the ante 225
dim@n.89liza: posts the ante 225
jcarlos.vale: posts the ante 225
kensui: posts the ante 225
Ajax2530: posts the ante 225
Ermuun_34b: posts the ante 225
Matzen10: posts the ante 225
roddypra: posts the ante 225
Ermuun_34b: posts small blind 900
Matzen10: posts big blind 1800
*** HOLE CARDS ***
Dealt to jcarlos.vale [As Js]
Ajax2530 has returned
roddypra: folds 
Bigmag2011: folds 
TRENDLINEOKI: folds 
dim@n.89liza: folds 
jcarlos.vale: raises 2880 to 4680
kensui: folds 
Ajax2530: folds 
Ermuun_34b: folds 
Matzen10: folds 
Uncalled bet (2880) returned to jcarlos.vale
jcarlos.vale collected 6525 from pot
jcarlos.vale: doesn't show handDTO
*** SUMMARY ***
Total pot 6525 | Rake 0 
Seat 1: Bigmag2011 folded before Flop (didn't bet)
Seat 2: TRENDLINEOKI folded before Flop (didn't bet)
Seat 3: dim@n.89liza folded before Flop (didn't bet)
Seat 4: jcarlos.vale collected (6525)
Seat 5: kensui folded before Flop (didn't bet)
Seat 6: Ajax2530 (button) folded before Flop (didn't bet)
Seat 7: Ermuun_34b (small blind) folded before Flop
Seat 8: Matzen10 (big blind) folded before Flop
Seat 9: roddypra folded before Flop (didn't bet)



PokerStars Hand #221908135316: Tournament #3082657132, $0.98+$0.12 USD Hold'em No Limit - Level XXI (900/1800) - 2020/12/27 20:05:15 EET [2020/12/27 13:05:15 ET]
Table '3082657132 62' 9-max Seat #7 is the button
Seat 1: Bigmag2011 (28265 in chips) 
Seat 2: TRENDLINEOKI (31576 in chips) 
Seat 3: dim@n.89liza (153507 in chips) 
Seat 4: jcarlos.vale (53852 in chips) 
Seat 5: kensui (35056 in chips) 
Seat 6: Ajax2530 (91784 in chips) 
Seat 7: Ermuun_34b (81018 in chips) 
Seat 8: Matzen10 (61161 in chips) 
Seat 9: roddypra (36503 in chips) 
Bigmag2011: posts the ante 225
TRENDLINEOKI: posts the ante 225
dim@n.89liza: posts the ante 225
jcarlos.vale: posts the ante 225
kensui: posts the ante 225
Ajax2530: posts the ante 225
Ermuun_34b: posts the ante 225
Matzen10: posts the ante 225
roddypra: posts the ante 225
Matzen10: posts small blind 900
roddypra: posts big blind 1800
*** HOLE CARDS ***
Dealt to jcarlos.vale [9d Js]
Bigmag2011: folds 
TRENDLINEOKI: folds 
dim@n.89liza: folds 
jcarlos.vale: folds 
kensui: folds 
Ajax2530: raises 2080 to 3880
Ermuun_34b: folds 
Matzen10: folds 
roddypra: folds 
Uncalled bet (2080) returned to Ajax2530
Ajax2530 collected 6525 from pot
*** SUMMARY ***
Total pot 6525 | Rake 0 
Seat 1: Bigmag2011 folded before Flop (didn't bet)
Seat 2: TRENDLINEOKI folded before Flop (didn't bet)
Seat 3: dim@n.89liza folded before Flop (didn't bet)
Seat 4: jcarlos.vale folded before Flop (didn't bet)
Seat 5: kensui folded before Flop (didn't bet)
Seat 6: Ajax2530 collected (6525)
Seat 7: Ermuun_34b (button) folded before Flop (didn't bet)
Seat 8: Matzen10 (small blind) folded before Flop
Seat 9: roddypra (big blind) folded before Flop



PokerStars Hand #221908161729: Tournament #3082657132, $0.98+$0.12 USD Hold'em No Limit - Level XXI (900/1800) - 2020/12/27 20:05:44 EET [2020/12/27 13:05:44 ET]
Table '3082657132 62' 9-max Seat #8 is the button
Seat 1: Bigmag2011 (28040 in chips) 
Seat 2: TRENDLINEOKI (31351 in chips) 
Seat 3: dim@n.89liza (153282 in chips) 
Seat 4: jcarlos.vale (53627 in chips) 
Seat 5: kensui (34831 in chips) 
Seat 6: Ajax2530 (96284 in chips) 
Seat 7: Ermuun_34b (80793 in chips) 
Seat 8: Matzen10 (60036 in chips) 
Seat 9: roddypra (34478 in chips) 
Bigmag2011: posts the ante 225
TRENDLINEOKI: posts the ante 225
dim@n.89liza: posts the ante 225
jcarlos.vale: posts the ante 225
kensui: posts the ante 225
Ajax2530: posts the ante 225
Ermuun_34b: posts the ante 225
Matzen10: posts the ante 225
roddypra: posts the ante 225
roddypra: posts small blind 900
Bigmag2011: posts big blind 1800
*** HOLE CARDS ***
Dealt to jcarlos.vale [Js 2s]
TRENDLINEOKI: folds 
dim@n.89liza: folds 
jcarlos.vale: folds 
kensui: folds 
Ajax2530: folds 
Ermuun_34b: folds 
Matzen10: folds 
roddypra: raises 1800 to 3600
Bigmag2011: calls 1800
*** FLOP *** [7d 8s Qs]
roddypra: checks 
Bigmag2011: checks 
*** TURN *** [7d 8s Qs] [Ac]
roddypra: bets 4059
Bigmag2011: calls 4059
*** RIVER *** [7d 8s Qs Ac] [4s]
roddypra: checks 
Bigmag2011: bets 5203
roddypra: folds 
Uncalled bet (5203) returned to Bigmag2011
Bigmag2011 collected 17343 from pot
Bigmag2011: doesn't show handDTO
*** SUMMARY ***
Total pot 17343 | Rake 0 
Board [7d 8s Qs Ac 4s]
Seat 1: Bigmag2011 (big blind) collected (17343)
Seat 2: TRENDLINEOKI folded before Flop (didn't bet)
Seat 3: dim@n.89liza folded before Flop (didn't bet)
Seat 4: jcarlos.vale folded before Flop (didn't bet)
Seat 5: kensui folded before Flop (didn't bet)
Seat 6: Ajax2530 folded before Flop (didn't bet)
Seat 7: Ermuun_34b folded before Flop (didn't bet)
Seat 8: Matzen10 (button) folded before Flop (didn't bet)
Seat 9: roddypra (small blind) folded on the River



PokerStars Hand #221908231804: Tournament #3082657132, $0.98+$0.12 USD Hold'em No Limit - Level XXI (900/1800) - 2020/12/27 20:07:01 EET [2020/12/27 13:07:01 ET]
Table '3082657132 62' 9-max Seat #9 is the button
Seat 1: Bigmag2011 (37499 in chips) 
Seat 2: TRENDLINEOKI (31126 in chips) 
Seat 3: dim@n.89liza (153057 in chips) 
Seat 4: jcarlos.vale (53402 in chips) 
Seat 5: kensui (34606 in chips) 
Seat 6: Ajax2530 (96059 in chips) 
Seat 7: Ermuun_34b (80568 in chips) 
Seat 8: Matzen10 (59811 in chips) 
Seat 9: roddypra (26594 in chips) 
Bigmag2011: posts the ante 225
TRENDLINEOKI: posts the ante 225
dim@n.89liza: posts the ante 225
jcarlos.vale: posts the ante 225
kensui: posts the ante 225
Ajax2530: posts the ante 225
Ermuun_34b: posts the ante 225
Matzen10: posts the ante 225
roddypra: posts the ante 225
Bigmag2011: posts small blind 900
TRENDLINEOKI: posts big blind 1800
*** HOLE CARDS ***
Dealt to jcarlos.vale [3c 3h]
dim@n.89liza: folds 
jcarlos.vale: raises 2880 to 4680
kensui: folds 
Ajax2530: folds 
Ermuun_34b: folds 
Matzen10: folds 
roddypra: raises 21689 to 26369 and is all-in
Bigmag2011: folds 
TRENDLINEOKI: folds 
jcarlos.vale: folds 
Uncalled bet (21689) returned to roddypra
roddypra collected 14085 from pot
*** SUMMARY ***
Total pot 14085 | Rake 0 
Seat 1: Bigmag2011 (small blind) folded before Flop
Seat 2: TRENDLINEOKI (big blind) folded before Flop
Seat 3: dim@n.89liza folded before Flop (didn't bet)
Seat 4: jcarlos.vale folded before Flop
Seat 5: kensui folded before Flop (didn't bet)
Seat 6: Ajax2530 folded before Flop (didn't bet)
Seat 7: Ermuun_34b folded before Flop (didn't bet)
Seat 8: Matzen10 folded before Flop (didn't bet)
Seat 9: roddypra (button) collected (14085)



PokerStars Hand #221908252632: Tournament #3082657132, $0.98+$0.12 USD Hold'em No Limit - Level XXI (900/1800) - 2020/12/27 20:07:24 EET [2020/12/27 13:07:24 ET]
Table '3082657132 62' 9-max Seat #1 is the button
Seat 1: Bigmag2011 (36374 in chips) 
Seat 2: TRENDLINEOKI (29101 in chips) 
Seat 3: dim@n.89liza (152832 in chips) 
Seat 4: jcarlos.vale (48497 in chips) 
Seat 5: kensui (34381 in chips) 
Seat 6: Ajax2530 (95834 in chips) 
Seat 7: Ermuun_34b (80343 in chips) 
Seat 8: Matzen10 (59586 in chips) 
Seat 9: roddypra (35774 in chips) 
Bigmag2011: posts the ante 225
TRENDLINEOKI: posts the ante 225
dim@n.89liza: posts the ante 225
jcarlos.vale: posts the ante 225
kensui: posts the ante 225
Ajax2530: posts the ante 225
Ermuun_34b: posts the ante 225
Matzen10: posts the ante 225
roddypra: posts the ante 225
TRENDLINEOKI: posts small blind 900
dim@n.89liza: posts big blind 1800
*** HOLE CARDS ***
Dealt to jcarlos.vale [5c 6d]
jcarlos.vale: folds 
kensui: folds 
Ajax2530: folds 
Ermuun_34b: folds 
Matzen10: folds 
roddypra: raises 1800 to 3600
Bigmag2011: folds 
TRENDLINEOKI: raises 3600 to 7200
dim@n.89liza: folds 
roddypra: calls 3600
*** FLOP *** [2c 4s 8d]
TRENDLINEOKI: checks 
roddypra: checks 
*** TURN *** [2c 4s 8d] [8c]
TRENDLINEOKI: bets 3600
roddypra: folds 
Uncalled bet (3600) returned to TRENDLINEOKI
TRENDLINEOKI collected 18225 from pot
TRENDLINEOKI: doesn't show handDTO
*** SUMMARY ***
Total pot 18225 | Rake 0 
Board [2c 4s 8d 8c]
Seat 1: Bigmag2011 (button) folded before Flop (didn't bet)
Seat 2: TRENDLINEOKI (small blind) collected (18225)
Seat 3: dim@n.89liza (big blind) folded before Flop
Seat 4: jcarlos.vale folded before Flop (didn't bet)
Seat 5: kensui folded before Flop (didn't bet)
Seat 6: Ajax2530 folded before Flop (didn't bet)
Seat 7: Ermuun_34b folded before Flop (didn't bet)
Seat 8: Matzen10 folded before Flop (didn't bet)
Seat 9: roddypra folded on the Turn



PokerStars Hand #221908291370: Tournament #3082657132, $0.98+$0.12 USD Hold'em No Limit - Level XXI (900/1800) - 2020/12/27 20:08:07 EET [2020/12/27 13:08:07 ET]
Table '3082657132 62' 9-max Seat #2 is the button
Seat 1: Bigmag2011 (36149 in chips) 
Seat 2: TRENDLINEOKI (39901 in chips) 
Seat 3: dim@n.89liza (150807 in chips) 
Seat 4: jcarlos.vale (48272 in chips) 
Seat 5: kensui (34156 in chips) 
Seat 6: Ajax2530 (95609 in chips) 
Seat 7: Ermuun_34b (80118 in chips) 
Seat 8: Matzen10 (59361 in chips) 
Seat 9: roddypra (28349 in chips) 
Bigmag2011: posts the ante 225
TRENDLINEOKI: posts the ante 225
dim@n.89liza: posts the ante 225
jcarlos.vale: posts the ante 225
kensui: posts the ante 225
Ajax2530: posts the ante 225
Ermuun_34b: posts the ante 225
Matzen10: posts the ante 225
roddypra: posts the ante 225
dim@n.89liza: posts small blind 900
jcarlos.vale: posts big blind 1800
*** HOLE CARDS ***
Dealt to jcarlos.vale [3c 7h]
kensui: folds 
Ajax2530: folds 
Ermuun_34b: raises 4500 to 6300
Matzen10: folds 
roddypra: folds 
Bigmag2011: folds 
TRENDLINEOKI: folds 
dim@n.89liza: folds 
jcarlos.vale: folds 
Uncalled bet (4500) returned to Ermuun_34b
Ermuun_34b collected 6525 from pot
Ermuun_34b: doesn't show handDTO
*** SUMMARY ***
Total pot 6525 | Rake 0 
Seat 1: Bigmag2011 folded before Flop (didn't bet)
Seat 2: TRENDLINEOKI (button) folded before Flop (didn't bet)
Seat 3: dim@n.89liza (small blind) folded before Flop
Seat 4: jcarlos.vale (big blind) folded before Flop
Seat 5: kensui folded before Flop (didn't bet)
Seat 6: Ajax2530 folded before Flop (didn't bet)
Seat 7: Ermuun_34b collected (6525)
Seat 8: Matzen10 folded before Flop (didn't bet)
Seat 9: roddypra folded before Flop (didn't bet)



PokerStars Hand #221908316910: Tournament #3082657132, $0.98+$0.12 USD Hold'em No Limit - Level XXI (900/1800) - 2020/12/27 20:08:35 EET [2020/12/27 13:08:35 ET]
Table '3082657132 62' 9-max Seat #3 is the button
Seat 1: Bigmag2011 (35924 in chips) 
Seat 2: TRENDLINEOKI (39676 in chips) 
Seat 3: dim@n.89liza (149682 in chips) 
Seat 4: jcarlos.vale (46247 in chips) 
Seat 5: kensui (33931 in chips) 
Seat 6: Ajax2530 (95384 in chips) 
Seat 7: Ermuun_34b (84618 in chips) 
Seat 8: Matzen10 (59136 in chips) 
Seat 9: roddypra (28124 in chips) 
Bigmag2011: posts the ante 225
TRENDLINEOKI: posts the ante 225
dim@n.89liza: posts the ante 225
jcarlos.vale: posts the ante 225
kensui: posts the ante 225
Ajax2530: posts the ante 225
Ermuun_34b: posts the ante 225
Matzen10: posts the ante 225
roddypra: posts the ante 225
jcarlos.vale: posts small blind 900
kensui: posts big blind 1800
*** HOLE CARDS ***
Dealt to jcarlos.vale [Jc 7d]
Ajax2530: raises 2080 to 3880
Ermuun_34b: folds 
Matzen10: folds 
roddypra: folds 
Bigmag2011: folds 
TRENDLINEOKI: folds 
dim@n.89liza: folds 
jcarlos.vale: folds 
kensui: calls 2080
*** FLOP *** [Kh Th 4h]
kensui: checks 
Ajax2530: bets 3330
kensui: folds 
Uncalled bet (3330) returned to Ajax2530
Ajax2530 collected 10685 from pot
Ajax2530: doesn't show handDTO
*** SUMMARY ***
Total pot 10685 | Rake 0 
Board [Kh Th 4h]
Seat 1: Bigmag2011 folded before Flop (didn't bet)
Seat 2: TRENDLINEOKI folded before Flop (didn't bet)
Seat 3: dim@n.89liza (button) folded before Flop (didn't bet)
Seat 4: jcarlos.vale (small blind) folded before Flop
Seat 5: kensui (big blind) folded on the Flop
Seat 6: Ajax2530 collected (10685)
Seat 7: Ermuun_34b folded before Flop (didn't bet)
Seat 8: Matzen10 folded before Flop (didn't bet)
Seat 9: roddypra folded before Flop (didn't bet)



PokerStars Hand #221908359916: Tournament #3082657132, $0.98+$0.12 USD Hold'em No Limit - Level XXI (900/1800) - 2020/12/27 20:09:22 EET [2020/12/27 13:09:22 ET]
Table '3082657132 62' 9-max Seat #4 is the button
Seat 1: Bigmag2011 (35699 in chips) 
Seat 2: TRENDLINEOKI (39451 in chips) 
Seat 3: dim@n.89liza (149457 in chips) 
Seat 4: jcarlos.vale (45122 in chips) 
Seat 5: kensui (29826 in chips) 
Seat 6: Ajax2530 (101964 in chips) 
Seat 7: Ermuun_34b (84393 in chips) 
Seat 8: Matzen10 (58911 in chips) 
Seat 9: roddypra (27899 in chips) 
Bigmag2011: posts the ante 225
TRENDLINEOKI: posts the ante 225
dim@n.89liza: posts the ante 225
jcarlos.vale: posts the ante 225
kensui: posts the ante 225
Ajax2530: posts the ante 225
Ermuun_34b: posts the ante 225
Matzen10: posts the ante 225
roddypra: posts the ante 225
kensui: posts small blind 900
Ajax2530: posts big blind 1800
*** HOLE CARDS ***
Dealt to jcarlos.vale [6s Ac]
Ermuun_34b: folds 
Matzen10: raises 2160 to 3960
roddypra: folds 
Bigmag2011: folds 
TRENDLINEOKI: folds 
dim@n.89liza: folds 
jcarlos.vale: folds 
kensui: folds 
Ajax2530: folds 
Uncalled bet (2160) returned to Matzen10
Matzen10 collected 6525 from pot
Matzen10: doesn't show handDTO
*** SUMMARY ***
Total pot 6525 | Rake 0 
Seat 1: Bigmag2011 folded before Flop (didn't bet)
Seat 2: TRENDLINEOKI folded before Flop (didn't bet)
Seat 3: dim@n.89liza folded before Flop (didn't bet)
Seat 4: jcarlos.vale (button) folded before Flop (didn't bet)
Seat 5: kensui (small blind) folded before Flop
Seat 6: Ajax2530 (big blind) folded before Flop
Seat 7: Ermuun_34b folded before Flop (didn't bet)
Seat 8: Matzen10 collected (6525)
Seat 9: roddypra folded before Flop (didn't bet)



PokerStars Hand #221908385656: Tournament #3082657132, $0.98+$0.12 USD Hold'em No Limit - Level XXI (900/1800) - 2020/12/27 20:09:50 EET [2020/12/27 13:09:50 ET]
Table '3082657132 62' 9-max Seat #5 is the button
Seat 1: Bigmag2011 (35474 in chips) 
Seat 2: TRENDLINEOKI (39226 in chips) 
Seat 3: dim@n.89liza (149232 in chips) 
Seat 4: jcarlos.vale (44897 in chips) 
Seat 5: kensui (28701 in chips) 
Seat 6: Ajax2530 (99939 in chips) 
Seat 7: Ermuun_34b (84168 in chips) 
Seat 8: Matzen10 (63411 in chips) 
Seat 9: roddypra (27674 in chips) 
Bigmag2011: posts the ante 225
TRENDLINEOKI: posts the ante 225
dim@n.89liza: posts the ante 225
jcarlos.vale: posts the ante 225
kensui: posts the ante 225
Ajax2530: posts the ante 225
Ermuun_34b: posts the ante 225
Matzen10: posts the ante 225
roddypra: posts the ante 225
Ajax2530: posts small blind 900
Ermuun_34b: posts big blind 1800
*** HOLE CARDS ***
Dealt to jcarlos.vale [Qs Ac]
Matzen10: folds 
roddypra: folds 
Bigmag2011 has timed out
Bigmag2011: folds 
Bigmag2011 is sitting out
TRENDLINEOKI: folds 
dim@n.89liza: folds 
Bigmag2011 has returned
jcarlos.vale: raises 2880 to 4680
kensui: folds 
Ajax2530: calls 3780
Ermuun_34b: folds 
*** FLOP *** [7s Kc 4c]
Ajax2530: checks 
jcarlos.vale: bets 3600
Ajax2530: folds 
Uncalled bet (3600) returned to jcarlos.vale
jcarlos.vale collected 13185 from pot
jcarlos.vale: doesn't show handDTO
*** SUMMARY ***
Total pot 13185 | Rake 0 
Board [7s Kc 4c]
Seat 1: Bigmag2011 folded before Flop (didn't bet)
Seat 2: TRENDLINEOKI folded before Flop (didn't bet)
Seat 3: dim@n.89liza folded before Flop (didn't bet)
Seat 4: jcarlos.vale collected (13185)
Seat 5: kensui (button) folded before Flop (didn't bet)
Seat 6: Ajax2530 (small blind) folded on the Flop
Seat 7: Ermuun_34b (big blind) folded before Flop
Seat 8: Matzen10 folded before Flop (didn't bet)
Seat 9: roddypra folded before Flop (didn't bet)



PokerStars Hand #221908439940: Tournament #3082657132, $0.98+$0.12 USD Hold'em No Limit - Level XXI (900/1800) - 2020/12/27 20:10:50 EET [2020/12/27 13:10:50 ET]
Table '3082657132 62' 9-max Seat #6 is the button
Seat 1: Bigmag2011 (35249 in chips) 
Seat 2: TRENDLINEOKI (39001 in chips) 
Seat 3: dim@n.89liza (149007 in chips) 
Seat 4: jcarlos.vale (53177 in chips) 
Seat 5: kensui (28476 in chips) 
Seat 6: Ajax2530 (95034 in chips) 
Seat 7: Ermuun_34b (82143 in chips) 
Seat 8: Matzen10 (63186 in chips) 
Seat 9: roddypra (27449 in chips) 
Bigmag2011: posts the ante 225
TRENDLINEOKI: posts the ante 225
dim@n.89liza: posts the ante 225
jcarlos.vale: posts the ante 225
kensui: posts the ante 225
Ajax2530: posts the ante 225
Ermuun_34b: posts the ante 225
Matzen10: posts the ante 225
roddypra: posts the ante 225
Ermuun_34b: posts small blind 900
Matzen10: posts big blind 1800
*** HOLE CARDS ***
Dealt to jcarlos.vale [9d Ah]
roddypra: raises 25424 to 27224 and is all-in
Bigmag2011: folds 
TRENDLINEOKI: folds 
dim@n.89liza: folds 
jcarlos.vale: folds 
kensui: folds 
Ajax2530: folds 
Ermuun_34b: folds 
Matzen10: folds 
Uncalled bet (25424) returned to roddypra
roddypra collected 6525 from pot
*** SUMMARY ***
Total pot 6525 | Rake 0 
Seat 1: Bigmag2011 folded before Flop (didn't bet)
Seat 2: TRENDLINEOKI folded before Flop (didn't bet)
Seat 3: dim@n.89liza folded before Flop (didn't bet)
Seat 4: jcarlos.vale folded before Flop (didn't bet)
Seat 5: kensui folded before Flop (didn't bet)
Seat 6: Ajax2530 (button) folded before Flop (didn't bet)
Seat 7: Ermuun_34b (small blind) folded before Flop
Seat 8: Matzen10 (big blind) folded before Flop
Seat 9: roddypra collected (6525)



PokerStars Hand #221908456934: Tournament #3082657132, $0.98+$0.12 USD Hold'em No Limit - Level XXI (900/1800) - 2020/12/27 20:11:09 EET [2020/12/27 13:11:09 ET]
Table '3082657132 62' 9-max Seat #7 is the button
Seat 1: Bigmag2011 (35024 in chips) 
Seat 2: TRENDLINEOKI (38776 in chips) 
Seat 3: dim@n.89liza (148782 in chips) 
Seat 4: jcarlos.vale (52952 in chips) 
Seat 5: kensui (28251 in chips) 
Seat 6: Ajax2530 (94809 in chips) 
Seat 7: Ermuun_34b (81018 in chips) 
Seat 8: Matzen10 (61161 in chips) 
Seat 9: roddypra (31949 in chips) 
Bigmag2011: posts the ante 225
TRENDLINEOKI: posts the ante 225
dim@n.89liza: posts the ante 225
jcarlos.vale: posts the ante 225
kensui: posts the ante 225
Ajax2530: posts the ante 225
Ermuun_34b: posts the ante 225
Matzen10: posts the ante 225
roddypra: posts the ante 225
Matzen10: posts small blind 900
roddypra: posts big blind 1800
*** HOLE CARDS ***
Dealt to jcarlos.vale [Jc Tc]
Bigmag2011: folds 
TRENDLINEOKI: folds 
dim@n.89liza: folds 
jcarlos.vale: calls 1800
kensui: raises 26226 to 28026 and is all-in
Ajax2530: folds 
Ermuun_34b: folds 
Matzen10: folds 
roddypra: folds 
jcarlos.vale: folds 
Uncalled bet (26226) returned to kensui
kensui collected 8325 from pot
kensui: doesn't show handDTO
*** SUMMARY ***
Total pot 8325 | Rake 0 
Seat 1: Bigmag2011 folded before Flop (didn't bet)
Seat 2: TRENDLINEOKI folded before Flop (didn't bet)
Seat 3: dim@n.89liza folded before Flop (didn't bet)
Seat 4: jcarlos.vale folded before Flop
Seat 5: kensui collected (8325)
Seat 6: Ajax2530 folded before Flop (didn't bet)
Seat 7: Ermuun_34b (button) folded before Flop (didn't bet)
Seat 8: Matzen10 (small blind) folded before Flop
Seat 9: roddypra (big blind) folded before Flop



PokerStars Hand #221908482139: Tournament #3082657132, $0.98+$0.12 USD Hold'em No Limit - Level XXII (1000/2000) - 2020/12/27 20:11:36 EET [2020/12/27 13:11:36 ET]
Table '3082657132 62' 9-max Seat #8 is the button
Seat 1: Bigmag2011 (34799 in chips) 
Seat 2: TRENDLINEOKI (38551 in chips) 
Seat 3: dim@n.89liza (148557 in chips) 
Seat 4: jcarlos.vale (50927 in chips) 
Seat 5: kensui (34551 in chips) 
Seat 6: Ajax2530 (94584 in chips) 
Seat 7: Ermuun_34b (80793 in chips) 
Seat 8: Matzen10 (60036 in chips) 
Seat 9: roddypra (29924 in chips) 
Bigmag2011: posts the ante 250
TRENDLINEOKI: posts the ante 250
dim@n.89liza: posts the ante 250
jcarlos.vale: posts the ante 250
kensui: posts the ante 250
Ajax2530: posts the ante 250
Ermuun_34b: posts the ante 250
Matzen10: posts the ante 250
roddypra: posts the ante 250
roddypra: posts small blind 1000
Bigmag2011: posts big blind 2000
*** HOLE CARDS ***
Dealt to jcarlos.vale [7d 6c]
TRENDLINEOKI: folds 
dim@n.89liza: folds 
jcarlos.vale: folds 
kensui: folds 
Ajax2530: folds 
Ermuun_34b: folds 
Matzen10: folds 
roddypra: raises 3000 to 5000
Bigmag2011: folds 
Uncalled bet (3000) returned to roddypra
roddypra collected 6250 from pot
*** SUMMARY ***
Total pot 6250 | Rake 0 
Seat 1: Bigmag2011 (big blind) folded before Flop
Seat 2: TRENDLINEOKI folded before Flop (didn't bet)
Seat 3: dim@n.89liza folded before Flop (didn't bet)
Seat 4: jcarlos.vale folded before Flop (didn't bet)
Seat 5: kensui folded before Flop (didn't bet)
Seat 6: Ajax2530 folded before Flop (didn't bet)
Seat 7: Ermuun_34b folded before Flop (didn't bet)
Seat 8: Matzen10 (button) folded before Flop (didn't bet)
Seat 9: roddypra (small blind) collected (6250)



PokerStars Hand #221908504407: Tournament #3082657132, $0.98+$0.12 USD Hold'em No Limit - Level XXII (1000/2000) - 2020/12/27 20:12:01 EET [2020/12/27 13:12:01 ET]
Table '3082657132 62' 9-max Seat #9 is the button
Seat 1: Bigmag2011 (32549 in chips) 
Seat 2: TRENDLINEOKI (38301 in chips) 
Seat 3: dim@n.89liza (148307 in chips) 
Seat 4: jcarlos.vale (50677 in chips) 
Seat 5: kensui (34301 in chips) 
Seat 6: Ajax2530 (94334 in chips) 
Seat 7: Ermuun_34b (80543 in chips) 
Seat 8: Matzen10 (59786 in chips) 
Seat 9: roddypra (33924 in chips) 
Bigmag2011: posts the ante 250
TRENDLINEOKI: posts the ante 250
dim@n.89liza: posts the ante 250
jcarlos.vale: posts the ante 250
kensui: posts the ante 250
Ajax2530: posts the ante 250
Ermuun_34b: posts the ante 250
Matzen10: posts the ante 250
roddypra: posts the ante 250
Bigmag2011: posts small blind 1000
TRENDLINEOKI: posts big blind 2000
*** HOLE CARDS ***
Dealt to jcarlos.vale [8c As]
dim@n.89liza: folds 
jcarlos.vale: folds 
kensui: folds 
Ajax2530: folds 
Ermuun_34b: folds 
Matzen10: raises 2000 to 4000
roddypra: calls 4000
Bigmag2011: folds 
TRENDLINEOKI: folds 
*** FLOP *** [2d 7h Td]
Matzen10: bets 4373
roddypra: folds 
Uncalled bet (4373) returned to Matzen10
Matzen10 collected 13250 from pot
Matzen10: doesn't show handDTO
*** SUMMARY ***
Total pot 13250 | Rake 0 
Board [2d 7h Td]
Seat 1: Bigmag2011 (small blind) folded before Flop
Seat 2: TRENDLINEOKI (big blind) folded before Flop
Seat 3: dim@n.89liza folded before Flop (didn't bet)
Seat 4: jcarlos.vale folded before Flop (didn't bet)
Seat 5: kensui folded before Flop (didn't bet)
Seat 6: Ajax2530 folded before Flop (didn't bet)
Seat 7: Ermuun_34b folded before Flop (didn't bet)
Seat 8: Matzen10 collected (13250)
Seat 9: roddypra (button) folded on the Flop



PokerStars Hand #221908536940: Tournament #3082657132, $0.98+$0.12 USD Hold'em No Limit - Level XXII (1000/2000) - 2020/12/27 20:12:37 EET [2020/12/27 13:12:37 ET]
Table '3082657132 62' 9-max Seat #1 is the button
Seat 1: Bigmag2011 (31299 in chips) 
Seat 2: TRENDLINEOKI (36051 in chips) 
Seat 3: dim@n.89liza (148057 in chips) 
Seat 4: jcarlos.vale (50427 in chips) 
Seat 5: kensui (34051 in chips) 
Seat 6: Ajax2530 (94084 in chips) 
Seat 7: Ermuun_34b (80293 in chips) 
Seat 8: Matzen10 (68786 in chips) 
Seat 9: roddypra (29674 in chips) 
Bigmag2011: posts the ante 250
TRENDLINEOKI: posts the ante 250
dim@n.89liza: posts the ante 250
jcarlos.vale: posts the ante 250
kensui: posts the ante 250
Ajax2530: posts the ante 250
Ermuun_34b: posts the ante 250
Matzen10: posts the ante 250
roddypra: posts the ante 250
TRENDLINEOKI: posts small blind 1000
dim@n.89liza: posts big blind 2000
*** HOLE CARDS ***
Dealt to jcarlos.vale [6h 7c]
jcarlos.vale: folds 
kensui: folds 
Ajax2530: folds 
Ermuun_34b: raises 2720 to 4720
Matzen10: folds 
roddypra: folds 
Bigmag2011: folds 
TRENDLINEOKI: folds 
dim@n.89liza: calls 2720
*** FLOP *** [8c 8s 5c]
dim@n.89liza: checks 
Ermuun_34b: checks 
*** TURN *** [8c 8s 5c] [4c]
dim@n.89liza: bets 11000
Ermuun_34b: folds 
Uncalled bet (11000) returned to dim@n.89liza
dim@n.89liza collected 12690 from pot
dim@n.89liza: doesn't show handDTO
*** SUMMARY ***
Total pot 12690 | Rake 0 
Board [8c 8s 5c 4c]
Seat 1: Bigmag2011 (button) folded before Flop (didn't bet)
Seat 2: TRENDLINEOKI (small blind) folded before Flop
Seat 3: dim@n.89liza (big blind) collected (12690)
Seat 4: jcarlos.vale folded before Flop (didn't bet)
Seat 5: kensui folded before Flop (didn't bet)
Seat 6: Ajax2530 folded before Flop (didn't bet)
Seat 7: Ermuun_34b folded on the Turn
Seat 8: Matzen10 folded before Flop (didn't bet)
Seat 9: roddypra folded before Flop (didn't bet)



PokerStars Hand #221908581810: Tournament #3082657132, $0.98+$0.12 USD Hold'em No Limit - Level XXII (1000/2000) - 2020/12/27 20:13:27 EET [2020/12/27 13:13:27 ET]
Table '3082657132 62' 9-max Seat #2 is the button
Seat 1: Bigmag2011 (31049 in chips) 
Seat 2: TRENDLINEOKI (34801 in chips) 
Seat 3: dim@n.89liza (155777 in chips) 
Seat 4: jcarlos.vale (50177 in chips) 
Seat 5: kensui (33801 in chips) 
Seat 6: Ajax2530 (93834 in chips) 
Seat 7: Ermuun_34b (75323 in chips) 
Seat 8: Matzen10 (68536 in chips) 
Seat 9: roddypra (29424 in chips) 
Bigmag2011: posts the ante 250
TRENDLINEOKI: posts the ante 250
dim@n.89liza: posts the ante 250
jcarlos.vale: posts the ante 250
kensui: posts the ante 250
Ajax2530: posts the ante 250
Ermuun_34b: posts the ante 250
Matzen10: posts the ante 250
roddypra: posts the ante 250
dim@n.89liza: posts small blind 1000
jcarlos.vale: posts big blind 2000
*** HOLE CARDS ***
Dealt to jcarlos.vale [8h 3h]
kensui: folds 
Ajax2530: folds 
Ermuun_34b: folds 
Matzen10: folds 
roddypra: folds 
Bigmag2011: raises 2000 to 4000
TRENDLINEOKI: folds 
dim@n.89liza: raises 151527 to 155527 and is all-in
jcarlos.vale: folds 
Bigmag2011: folds 
Uncalled bet (151527) returned to dim@n.89liza
dim@n.89liza collected 12250 from pot
dim@n.89liza: doesn't show handDTO
*** SUMMARY ***
Total pot 12250 | Rake 0 
Seat 1: Bigmag2011 folded before Flop
Seat 2: TRENDLINEOKI (button) folded before Flop (didn't bet)
Seat 3: dim@n.89liza (small blind) collected (12250)
Seat 4: jcarlos.vale (big blind) folded before Flop
Seat 5: kensui folded before Flop (didn't bet)
Seat 6: Ajax2530 folded before Flop (didn't bet)
Seat 7: Ermuun_34b folded before Flop (didn't bet)
Seat 8: Matzen10 folded before Flop (didn't bet)
Seat 9: roddypra folded before Flop (didn't bet)



PokerStars Hand #221908615666: Tournament #3082657132, $0.98+$0.12 USD Hold'em No Limit - Level XXII (1000/2000) - 2020/12/27 20:14:04 EET [2020/12/27 13:14:04 ET]
Table '3082657132 62' 9-max Seat #3 is the button
Seat 1: Bigmag2011 (26799 in chips) 
Seat 2: TRENDLINEOKI (34551 in chips) 
Seat 3: dim@n.89liza (163777 in chips) 
Seat 4: jcarlos.vale (47927 in chips) 
Seat 5: kensui (33551 in chips) 
Seat 6: Ajax2530 (93584 in chips) 
Seat 7: Ermuun_34b (75073 in chips) 
Seat 8: Matzen10 (68286 in chips) 
Seat 9: roddypra (29174 in chips) 
Bigmag2011: posts the ante 250
TRENDLINEOKI: posts the ante 250
dim@n.89liza: posts the ante 250
jcarlos.vale: posts the ante 250
kensui: posts the ante 250
Ajax2530: posts the ante 250
Ermuun_34b: posts the ante 250
Matzen10: posts the ante 250
roddypra: posts the ante 250
jcarlos.vale: posts small blind 1000
kensui: posts big blind 2000
*** HOLE CARDS ***
Dealt to jcarlos.vale [Qs Qc]
Ajax2530: folds 
Ermuun_34b: folds 
Matzen10: folds 
roddypra: folds 
Bigmag2011: folds 
TRENDLINEOKI: folds 
dim@n.89liza: folds 
jcarlos.vale: raises 4000 to 6000
kensui: calls 4000
*** FLOP *** [7c Ks 4h]
jcarlos.vale: bets 10688
kensui: folds 
Uncalled bet (10688) returned to jcarlos.vale
jcarlos.vale collected 14250 from pot
jcarlos.vale: doesn't show handDTO
*** SUMMARY ***
Total pot 14250 | Rake 0 
Board [7c Ks 4h]
Seat 1: Bigmag2011 folded before Flop (didn't bet)
Seat 2: TRENDLINEOKI folded before Flop (didn't bet)
Seat 3: dim@n.89liza (button) folded before Flop (didn't bet)
Seat 4: jcarlos.vale (small blind) collected (14250)
Seat 5: kensui (big blind) folded on the Flop
Seat 6: Ajax2530 folded before Flop (didn't bet)
Seat 7: Ermuun_34b folded before Flop (didn't bet)
Seat 8: Matzen10 folded before Flop (didn't bet)
Seat 9: roddypra folded before Flop (didn't bet)



PokerStars Hand #221908649974: Tournament #3082657132, $0.98+$0.12 USD Hold'em No Limit - Level XXII (1000/2000) - 2020/12/27 20:14:42 EET [2020/12/27 13:14:42 ET]
Table '3082657132 62' 9-max Seat #4 is the button
Seat 1: Bigmag2011 (26549 in chips) 
Seat 2: TRENDLINEOKI (34301 in chips) 
Seat 3: dim@n.89liza (163527 in chips) 
Seat 4: jcarlos.vale (55927 in chips) 
Seat 5: kensui (27301 in chips) 
Seat 6: Ajax2530 (93334 in chips) 
Seat 7: Ermuun_34b (74823 in chips) 
Seat 8: Matzen10 (68036 in chips) 
Seat 9: roddypra (28924 in chips) 
Bigmag2011: posts the ante 250
TRENDLINEOKI: posts the ante 250
dim@n.89liza: posts the ante 250
jcarlos.vale: posts the ante 250
kensui: posts the ante 250
Ajax2530: posts the ante 250
Ermuun_34b: posts the ante 250
Matzen10: posts the ante 250
roddypra: posts the ante 250
kensui: posts small blind 1000
Ajax2530: posts big blind 2000
*** HOLE CARDS ***
Dealt to jcarlos.vale [Jd 4d]
Ermuun_34b: folds 
Matzen10: folds 
roddypra: folds 
Bigmag2011: folds 
TRENDLINEOKI: folds 
dim@n.89liza: raises 4000 to 6000
jcarlos.vale: folds 
kensui: folds 
Ajax2530: calls 4000
*** FLOP *** [3c 4c 2c]
Ajax2530: checks 
dim@n.89liza: bets 8000
Ajax2530: folds 
Uncalled bet (8000) returned to dim@n.89liza
dim@n.89liza collected 15250 from pot
dim@n.89liza: doesn't show handDTO
*** SUMMARY ***
Total pot 15250 | Rake 0 
Board [3c 4c 2c]
Seat 1: Bigmag2011 folded before Flop (didn't bet)
Seat 2: TRENDLINEOKI folded before Flop (didn't bet)
Seat 3: dim@n.89liza collected (15250)
Seat 4: jcarlos.vale (button) folded before Flop (didn't bet)
Seat 5: kensui (small blind) folded before Flop
Seat 6: Ajax2530 (big blind) folded on the Flop
Seat 7: Ermuun_34b folded before Flop (didn't bet)
Seat 8: Matzen10 folded before Flop (didn't bet)
Seat 9: roddypra folded before Flop (didn't bet)



PokerStars Hand #221908698380: Tournament #3082657132, $0.98+$0.12 USD Hold'em No Limit - Level XXII (1000/2000) - 2020/12/27 20:15:35 EET [2020/12/27 13:15:35 ET]
Table '3082657132 62' 9-max Seat #5 is the button
Seat 1: Bigmag2011 (26299 in chips) 
Seat 2: TRENDLINEOKI (34051 in chips) 
Seat 3: dim@n.89liza (172527 in chips) 
Seat 4: jcarlos.vale (55677 in chips) 
Seat 5: kensui (26051 in chips) 
Seat 6: Ajax2530 (87084 in chips) 
Seat 7: Ermuun_34b (74573 in chips) 
Seat 8: Matzen10 (67786 in chips) 
Seat 9: roddypra (28674 in chips) 
Bigmag2011: posts the ante 250
TRENDLINEOKI: posts the ante 250
dim@n.89liza: posts the ante 250
jcarlos.vale: posts the ante 250
kensui: posts the ante 250
Ajax2530: posts the ante 250
Ermuun_34b: posts the ante 250
Matzen10: posts the ante 250
roddypra: posts the ante 250
Ajax2530: posts small blind 1000
Ermuun_34b: posts big blind 2000
*** HOLE CARDS ***
Dealt to jcarlos.vale [8c Js]
Matzen10: folds 
roddypra: raises 26424 to 28424 and is all-in
Bigmag2011: folds 
TRENDLINEOKI: folds 
dim@n.89liza: folds 
jcarlos.vale: folds 
kensui: folds 
Ajax2530: folds 
Ermuun_34b: calls 26424
*** FLOP *** [Th Jc Td]
*** TURN *** [Th Jc Td] [4s]
*** RIVER *** [Th Jc Td 4s] [7h]
*** SHOW DOWN ***
Ermuun_34b: shows [9s 9c] (two pair, Tens and Nines)
roddypra: shows [Ac Kd] (a pair of Tens)
Ermuun_34b collected 60098 from pot
roddypra finished the tournament in 137th place and received $4.50.
*** SUMMARY ***
Total pot 60098 | Rake 0 
Board [Th Jc Td 4s 7h]
Seat 1: Bigmag2011 folded before Flop (didn't bet)
Seat 2: TRENDLINEOKI folded before Flop (didn't bet)
Seat 3: dim@n.89liza folded before Flop (didn't bet)
Seat 4: jcarlos.vale folded before Flop (didn't bet)
Seat 5: kensui (button) folded before Flop (didn't bet)
Seat 6: Ajax2530 (small blind) folded before Flop
Seat 7: Ermuun_34b (big blind) showed [9s 9c] and won (60098) with two pair, Tens and Nines
Seat 8: Matzen10 folded before Flop (didn't bet)
Seat 9: roddypra showed [Ac Kd] and lost with a pair of Tens



PokerStars Hand #221908729467: Tournament #3082657132, $0.98+$0.12 USD Hold'em No Limit - Level XXII (1000/2000) - 2020/12/27 20:16:10 EET [2020/12/27 13:16:10 ET]
Table '3082657132 62' 9-max Seat #6 is the button
Seat 1: Bigmag2011 (26049 in chips) 
Seat 2: TRENDLINEOKI (33801 in chips) 
Seat 3: dim@n.89liza (172277 in chips) 
Seat 4: jcarlos.vale (55427 in chips) 
Seat 5: kensui (25801 in chips) 
Seat 6: Ajax2530 (85834 in chips) 
Seat 7: Ermuun_34b (105997 in chips) 
Seat 8: Matzen10 (67536 in chips) 
Bigmag2011: posts the ante 250
TRENDLINEOKI: posts the ante 250
dim@n.89liza: posts the ante 250
jcarlos.vale: posts the ante 250
kensui: posts the ante 250
Ajax2530: posts the ante 250
Ermuun_34b: posts the ante 250
Matzen10: posts the ante 250
Ermuun_34b: posts small blind 1000
Matzen10: posts big blind 2000
*** HOLE CARDS ***
Dealt to jcarlos.vale [5h 9h]
Bigmag2011: folds 
TRENDLINEOKI: folds 
dim@n.89liza: raises 4000 to 6000
jcarlos.vale: folds 
kensui: folds 
Ajax2530: folds 
Ermuun_34b: calls 5000
Matzen10: raises 61286 to 67286 and is all-in
dim@n.89liza: folds 
Ermuun_34b: folds 
Uncalled bet (61286) returned to Matzen10
Matzen10 collected 20000 from pot
Matzen10: doesn't show handDTO
*** SUMMARY ***
Total pot 20000 | Rake 0 
Seat 1: Bigmag2011 folded before Flop (didn't bet)
Seat 2: TRENDLINEOKI folded before Flop (didn't bet)
Seat 3: dim@n.89liza folded before Flop
Seat 4: jcarlos.vale folded before Flop (didn't bet)
Seat 5: kensui folded before Flop (didn't bet)
Seat 6: Ajax2530 (button) folded before Flop (didn't bet)
Seat 7: Ermuun_34b (small blind) folded before Flop
Seat 8: Matzen10 (big blind) collected (20000)



PokerStars Hand #221908767480: Tournament #3082657132, $0.98+$0.12 USD Hold'em No Limit - Level XXII (1000/2000) - 2020/12/27 20:16:52 EET [2020/12/27 13:16:52 ET]
Table '3082657132 62' 9-max Seat #7 is the button
Seat 1: Bigmag2011 (25799 in chips) 
Seat 2: TRENDLINEOKI (33551 in chips) 
Seat 3: dim@n.89liza (166027 in chips) 
Seat 4: jcarlos.vale (55177 in chips) 
Seat 5: kensui (25551 in chips) 
Seat 6: Ajax2530 (85584 in chips) 
Seat 7: Ermuun_34b (99747 in chips) 
Seat 8: Matzen10 (81286 in chips) 
Seat 9: Alina 0297 (25522 in chips) 
Bigmag2011: posts the ante 250
TRENDLINEOKI: posts the ante 250
dim@n.89liza: posts the ante 250
jcarlos.vale: posts the ante 250
kensui: posts the ante 250
Ajax2530: posts the ante 250
Ermuun_34b: posts the ante 250
Matzen10: posts the ante 250
Alina 0297: posts the ante 250
Matzen10: posts small blind 1000
Alina 0297: posts big blind 2000
*** HOLE CARDS ***
Dealt to jcarlos.vale [6h 7c]
Bigmag2011: folds 
TRENDLINEOKI: folds 
dim@n.89liza: folds 
jcarlos.vale: folds 
kensui: folds 
Ajax2530: folds 
Ermuun_34b: folds 
Matzen10: raises 79036 to 81036 and is all-in
Alina 0297: folds 
Uncalled bet (79036) returned to Matzen10
Matzen10 collected 6250 from pot
Matzen10: doesn't show handDTO
*** SUMMARY ***
Total pot 6250 | Rake 0 
Seat 1: Bigmag2011 folded before Flop (didn't bet)
Seat 2: TRENDLINEOKI folded before Flop (didn't bet)
Seat 3: dim@n.89liza folded before Flop (didn't bet)
Seat 4: jcarlos.vale folded before Flop (didn't bet)
Seat 5: kensui folded before Flop (didn't bet)
Seat 6: Ajax2530 folded before Flop (didn't bet)
Seat 7: Ermuun_34b (button) folded before Flop (didn't bet)
Seat 8: Matzen10 (small blind) collected (6250)
Seat 9: Alina 0297 (big blind) folded before Flop



PokerStars Hand #221908799344: Tournament #3082657132, $0.98+$0.12 USD Hold'em No Limit - Level XXII (1000/2000) - 2020/12/27 20:17:27 EET [2020/12/27 13:17:27 ET]
Table '3082657132 62' 9-max Seat #8 is the button
Seat 1: Bigmag2011 (25549 in chips) 
Seat 2: TRENDLINEOKI (33301 in chips) 
Seat 3: dim@n.89liza (165777 in chips) 
Seat 4: jcarlos.vale (54927 in chips) 
Seat 5: kensui (25301 in chips) 
Seat 6: Ajax2530 (85334 in chips) 
Seat 7: Ermuun_34b (99497 in chips) 
Seat 8: Matzen10 (85286 in chips) 
Seat 9: Alina 0297 (23272 in chips) 
Bigmag2011: posts the ante 250
TRENDLINEOKI: posts the ante 250
dim@n.89liza: posts the ante 250
jcarlos.vale: posts the ante 250
kensui: posts the ante 250
Ajax2530: posts the ante 250
Ermuun_34b: posts the ante 250
Matzen10: posts the ante 250
Alina 0297: posts the ante 250
Alina 0297: posts small blind 1000
Bigmag2011: posts big blind 2000
*** HOLE CARDS ***
Dealt to jcarlos.vale [5s Qh]
TRENDLINEOKI: folds 
dim@n.89liza has timed out
dim@n.89liza: folds 
dim@n.89liza is sitting out
dim@n.89liza has returned
jcarlos.vale: folds 
kensui: folds 
Ajax2530: folds 
Ermuun_34b: folds 
Matzen10: raises 83036 to 85036 and is all-in
Alina 0297: folds 
Bigmag2011: folds 
Uncalled bet (83036) returned to Matzen10
Matzen10 collected 7250 from pot
Matzen10: doesn't show handDTO
*** SUMMARY ***
Total pot 7250 | Rake 0 
Seat 1: Bigmag2011 (big blind) folded before Flop
Seat 2: TRENDLINEOKI folded before Flop (didn't bet)
Seat 3: dim@n.89liza folded before Flop (didn't bet)
Seat 4: jcarlos.vale folded before Flop (didn't bet)
Seat 5: kensui folded before Flop (didn't bet)
Seat 6: Ajax2530 folded before Flop (didn't bet)
Seat 7: Ermuun_34b folded before Flop (didn't bet)
Seat 8: Matzen10 (button) collected (7250)
Seat 9: Alina 0297 (small blind) folded before Flop



PokerStars Hand #221908826230: Tournament #3082657132, $0.98+$0.12 USD Hold'em No Limit - Level XXII (1000/2000) - 2020/12/27 20:17:56 EET [2020/12/27 13:17:56 ET]
Table '3082657132 62' 9-max Seat #9 is the button
Seat 1: Bigmag2011 (23299 in chips) 
Seat 2: TRENDLINEOKI (33051 in chips) 
Seat 3: dim@n.89liza (165527 in chips) 
Seat 4: jcarlos.vale (54677 in chips) 
Seat 5: kensui (25051 in chips) 
Seat 6: Ajax2530 (85084 in chips) 
Seat 7: Ermuun_34b (99247 in chips) 
Seat 8: Matzen10 (90286 in chips) 
Seat 9: Alina 0297 (22022 in chips) 
Bigmag2011: posts the ante 250
TRENDLINEOKI: posts the ante 250
dim@n.89liza: posts the ante 250
jcarlos.vale: posts the ante 250
kensui: posts the ante 250
Ajax2530: posts the ante 250
Ermuun_34b: posts the ante 250
Matzen10: posts the ante 250
Alina 0297: posts the ante 250
Bigmag2011: posts small blind 1000
TRENDLINEOKI: posts big blind 2000
*** HOLE CARDS ***
Dealt to jcarlos.vale [4h Jh]
dim@n.89liza has timed out
dim@n.89liza: folds 
dim@n.89liza is sitting out
dim@n.89liza has returned
jcarlos.vale: folds 
kensui: folds 
Ajax2530: raises 2880 to 4880
Ermuun_34b: folds 
Matzen10: folds 
Alina 0297: folds 
Bigmag2011: folds 
TRENDLINEOKI: folds 
Uncalled bet (2880) returned to Ajax2530
Ajax2530 collected 7250 from pot
Ajax2530: doesn't show handDTO
*** SUMMARY ***
Total pot 7250 | Rake 0 
Seat 1: Bigmag2011 (small blind) folded before Flop
Seat 2: TRENDLINEOKI (big blind) folded before Flop
Seat 3: dim@n.89liza folded before Flop (didn't bet)
Seat 4: jcarlos.vale folded before Flop (didn't bet)
Seat 5: kensui folded before Flop (didn't bet)
Seat 6: Ajax2530 collected (7250)
Seat 7: Ermuun_34b folded before Flop (didn't bet)
Seat 8: Matzen10 folded before Flop (didn't bet)
Seat 9: Alina 0297 (button) folded before Flop (didn't bet)



PokerStars Hand #221908858513: Tournament #3082657132, $0.98+$0.12 USD Hold'em No Limit - Level XXII (1000/2000) - 2020/12/27 20:18:32 EET [2020/12/27 13:18:32 ET]
Table '3082657132 62' 9-max Seat #1 is the button
Seat 1: Bigmag2011 (22049 in chips) 
Seat 2: TRENDLINEOKI (30801 in chips) 
Seat 3: dim@n.89liza (165277 in chips) 
Seat 4: jcarlos.vale (54427 in chips) 
Seat 5: kensui (24801 in chips) 
Seat 6: Ajax2530 (90084 in chips) 
Seat 7: Ermuun_34b (98997 in chips) 
Seat 8: Matzen10 (90036 in chips) 
Seat 9: Alina 0297 (21772 in chips) 
Bigmag2011: posts the ante 250
TRENDLINEOKI: posts the ante 250
dim@n.89liza: posts the ante 250
jcarlos.vale: posts the ante 250
kensui: posts the ante 250
Ajax2530: posts the ante 250
Ermuun_34b: posts the ante 250
Matzen10: posts the ante 250
Alina 0297: posts the ante 250
TRENDLINEOKI: posts small blind 1000
dim@n.89liza: posts big blind 2000
*** HOLE CARDS ***
Dealt to jcarlos.vale [6d 2s]
jcarlos.vale: folds 
kensui: folds 
Ajax2530: folds 
Ermuun_34b: calls 2000
Matzen10: folds 
Alina 0297: raises 19522 to 21522 and is all-in
Bigmag2011: folds 
TRENDLINEOKI: raises 9029 to 30551 and is all-in
dim@n.89liza: folds 
Ermuun_34b: calls 28551
*** FLOP *** [4s 7c Kc]
*** TURN *** [4s 7c Kc] [4d]
*** RIVER *** [4s 7c Kc 4d] [3s]
*** SHOW DOWN ***
TRENDLINEOKI: shows [9d 9h] (two pair, Nines and Fours)
Ermuun_34b: shows [Jh Ah] (a pair of Fours)
TRENDLINEOKI collected 18058 from side pot
Alina 0297: shows [Qs Qh] (two pair, Queens and Fours)
Alina 0297 collected 68816 from main pot
*** SUMMARY ***
Total pot 86874 Main pot 68816. Side pot 18058. | Rake 0 
Board [4s 7c Kc 4d 3s]
Seat 1: Bigmag2011 (button) folded before Flop (didn't bet)
Seat 2: TRENDLINEOKI (small blind) showed [9d 9h] and won (18058) with two pair, Nines and Fours
Seat 3: dim@n.89liza (big blind) folded before Flop
Seat 4: jcarlos.vale folded before Flop (didn't bet)
Seat 5: kensui folded before Flop (didn't bet)
Seat 6: Ajax2530 folded before Flop (didn't bet)
Seat 7: Ermuun_34b showed [Jh Ah] and lost with a pair of Fours
Seat 8: Matzen10 folded before Flop (didn't bet)
Seat 9: Alina 0297 showed [Qs Qh] and won (68816) with two pair, Queens and Fours



PokerStars Hand #221908887731: Tournament #3082657132, $0.98+$0.12 USD Hold'em No Limit - Level XXII (1000/2000) - 2020/12/27 20:19:04 EET [2020/12/27 13:19:04 ET]
Table '3082657132 62' 9-max Seat #2 is the button
Seat 1: Bigmag2011 (21799 in chips) 
Seat 2: TRENDLINEOKI (18058 in chips) 
Seat 3: dim@n.89liza (163027 in chips) 
Seat 4: jcarlos.vale (54177 in chips) 
Seat 5: kensui (24551 in chips) 
Seat 6: Ajax2530 (89834 in chips) 
Seat 7: Ermuun_34b (68196 in chips) 
Seat 8: Matzen10 (89786 in chips) 
Seat 9: Alina 0297 (68816 in chips) 
Bigmag2011: posts the ante 250
TRENDLINEOKI: posts the ante 250
dim@n.89liza: posts the ante 250
jcarlos.vale: posts the ante 250
kensui: posts the ante 250
Ajax2530: posts the ante 250
Ermuun_34b: posts the ante 250
Matzen10: posts the ante 250
Alina 0297: posts the ante 250
dim@n.89liza: posts small blind 1000
jcarlos.vale: posts big blind 2000
*** HOLE CARDS ***
Dealt to jcarlos.vale [2s Kd]
kensui: folds 
Ajax2530: folds 
Ermuun_34b: folds 
Matzen10: raises 2000 to 4000
Alina 0297: folds 
Bigmag2011: folds 
TRENDLINEOKI: folds 
dim@n.89liza: folds 
jcarlos.vale: folds 
Uncalled bet (2000) returned to Matzen10
Matzen10 collected 7250 from pot
Matzen10: doesn't show handDTO
*** SUMMARY ***
Total pot 7250 | Rake 0 
Seat 1: Bigmag2011 folded before Flop (didn't bet)
Seat 2: TRENDLINEOKI (button) folded before Flop (didn't bet)
Seat 3: dim@n.89liza (small blind) folded before Flop
Seat 4: jcarlos.vale (big blind) folded before Flop
Seat 5: kensui folded before Flop (didn't bet)
Seat 6: Ajax2530 folded before Flop (didn't bet)
Seat 7: Ermuun_34b folded before Flop (didn't bet)
Seat 8: Matzen10 collected (7250)
Seat 9: Alina 0297 folded before Flop (didn't bet)



PokerStars Hand #221908924152: Tournament #3082657132, $0.98+$0.12 USD Hold'em No Limit - Level XXII (1000/2000) - 2020/12/27 20:19:44 EET [2020/12/27 13:19:44 ET]
Table '3082657132 62' 9-max Seat #3 is the button
Seat 1: Bigmag2011 (21549 in chips) 
Seat 2: TRENDLINEOKI (17808 in chips) 
Seat 3: dim@n.89liza (161777 in chips) 
Seat 4: jcarlos.vale (51927 in chips) 
Seat 5: kensui (24301 in chips) 
Seat 6: Ajax2530 (89584 in chips) 
Seat 7: Ermuun_34b (67946 in chips) 
Seat 8: Matzen10 (94786 in chips) 
Seat 9: Alina 0297 (68566 in chips) 
Bigmag2011: posts the ante 250
TRENDLINEOKI: posts the ante 250
dim@n.89liza: posts the ante 250
jcarlos.vale: posts the ante 250
kensui: posts the ante 250
Ajax2530: posts the ante 250
Ermuun_34b: posts the ante 250
Matzen10: posts the ante 250
Alina 0297: posts the ante 250
jcarlos.vale: posts small blind 1000
kensui: posts big blind 2000
*** HOLE CARDS ***
Dealt to jcarlos.vale [3h 8s]
Ajax2530: raises 2880 to 4880
Ermuun_34b: folds 
Matzen10: folds 
Alina 0297: folds 
Bigmag2011: folds 
TRENDLINEOKI: folds 
dim@n.89liza: calls 4880
jcarlos.vale: folds 
kensui: calls 2880
*** FLOP *** [7d Td 4h]
kensui: checks 
Ajax2530: checks 
dim@n.89liza: checks 
*** TURN *** [7d Td 4h] [5s]
kensui: checks 
Ajax2530: bets 5650
dim@n.89liza: folds 
kensui: calls 5650
*** RIVER *** [7d Td 4h 5s] [8h]
kensui: checks 
Ajax2530: checks 
*** SHOW DOWN ***
kensui: shows [8c Jc] (a pair of Eights)
Ajax2530: mucks handDTO
kensui collected 29190 from pot
*** SUMMARY ***
Total pot 29190 | Rake 0 
Board [7d Td 4h 5s 8h]
Seat 1: Bigmag2011 folded before Flop (didn't bet)
Seat 2: TRENDLINEOKI folded before Flop (didn't bet)
Seat 3: dim@n.89liza (button) folded on the Turn
Seat 4: jcarlos.vale (small blind) folded before Flop
Seat 5: kensui (big blind) showed [8c Jc] and won (29190) with a pair of Eights
Seat 6: Ajax2530 mucked [Kd Qc]
Seat 7: Ermuun_34b folded before Flop (didn't bet)
Seat 8: Matzen10 folded before Flop (didn't bet)
Seat 9: Alina 0297 folded before Flop (didn't bet)



PokerStars Hand #221908994299: Tournament #3082657132, $0.98+$0.12 USD Hold'em No Limit - Level XXII (1000/2000) - 2020/12/27 20:21:02 EET [2020/12/27 13:21:02 ET]
Table '3082657132 62' 9-max Seat #4 is the button
Seat 1: Bigmag2011 (21299 in chips) 
Seat 2: TRENDLINEOKI (17558 in chips) 
Seat 3: dim@n.89liza (156647 in chips) 
Seat 4: jcarlos.vale (50677 in chips) 
Seat 5: kensui (42711 in chips) 
Seat 6: Ajax2530 (78804 in chips) 
Seat 7: Ermuun_34b (67696 in chips) 
Seat 8: Matzen10 (94536 in chips) 
Seat 9: Alina 0297 (68316 in chips) 
Bigmag2011: posts the ante 250
TRENDLINEOKI: posts the ante 250
dim@n.89liza: posts the ante 250
jcarlos.vale: posts the ante 250
kensui: posts the ante 250
Ajax2530: posts the ante 250
Ermuun_34b: posts the ante 250
Matzen10: posts the ante 250
Alina 0297: posts the ante 250
kensui: posts small blind 1000
Ajax2530: posts big blind 2000
*** HOLE CARDS ***
Dealt to jcarlos.vale [2s 7d]
Ermuun_34b: calls 2000
Matzen10: folds 
Alina 0297: folds 
Bigmag2011: folds 
TRENDLINEOKI: raises 15308 to 17308 and is all-in
dim@n.89liza: folds 
jcarlos.vale: folds 
kensui: folds 
Ajax2530: calls 15308
Ermuun_34b: raises 50138 to 67446 and is all-in
Ajax2530: folds 
Uncalled bet (50138) returned to Ermuun_34b
*** FLOP *** [Js 5h Kd]
*** TURN *** [Js 5h Kd] [4h]
*** RIVER *** [Js 5h Kd 4h] [2h]
*** SHOW DOWN ***
Ermuun_34b: shows [8c 8d] (a pair of Eights)
TRENDLINEOKI: shows [8s 8h] (a pair of Eights)
Ermuun_34b collected 27587 from pot
TRENDLINEOKI collected 27587 from pot
*** SUMMARY ***
Total pot 55174 | Rake 0 
Board [Js 5h Kd 4h 2h]
Seat 1: Bigmag2011 folded before Flop (didn't bet)
Seat 2: TRENDLINEOKI showed [8s 8h] and won (27587) with a pair of Eights
Seat 3: dim@n.89liza folded before Flop (didn't bet)
Seat 4: jcarlos.vale (button) folded before Flop (didn't bet)
Seat 5: kensui (small blind) folded before Flop
Seat 6: Ajax2530 (big blind) folded before Flop
Seat 7: Ermuun_34b showed [8c 8d] and won (27587) with a pair of Eights
Seat 8: Matzen10 folded before Flop (didn't bet)
Seat 9: Alina 0297 folded before Flop (didn't bet)



PokerStars Hand #221909039272: Tournament #3082657132, $0.98+$0.12 USD Hold'em No Limit - Level XXIII (1200/2400) - 2020/12/27 20:21:53 EET [2020/12/27 13:21:53 ET]
Table '3082657132 62' 9-max Seat #5 is the button
Seat 1: Bigmag2011 (21049 in chips) 
Seat 2: TRENDLINEOKI (27587 in chips) 
Seat 3: dim@n.89liza (156397 in chips) 
Seat 4: jcarlos.vale (50427 in chips) 
Seat 5: kensui (41461 in chips) 
Seat 6: Ajax2530 (61246 in chips) 
Seat 7: Ermuun_34b (77725 in chips) 
Seat 8: Matzen10 (94286 in chips) 
Seat 9: Alina 0297 (68066 in chips) 
Bigmag2011: posts the ante 300
TRENDLINEOKI: posts the ante 300
dim@n.89liza: posts the ante 300
jcarlos.vale: posts the ante 300
kensui: posts the ante 300
Ajax2530: posts the ante 300
Ermuun_34b: posts the ante 300
Matzen10: posts the ante 300
Alina 0297: posts the ante 300
Ajax2530: posts small blind 1200
Ermuun_34b: posts big blind 2400
*** HOLE CARDS ***
Dealt to jcarlos.vale [Ac 9c]
Matzen10: folds 
Alina 0297: folds 
Bigmag2011: folds 
TRENDLINEOKI: folds 
dim@n.89liza: raises 4800 to 7200
jcarlos.vale: folds 
kensui: folds 
Ajax2530: folds 
Ermuun_34b: calls 4800
*** FLOP *** [7c 4h 2h]
Ermuun_34b: checks 
dim@n.89liza: bets 9600
Ermuun_34b: folds 
Uncalled bet (9600) returned to dim@n.89liza
dim@n.89liza collected 18300 from pot
dim@n.89liza: doesn't show handDTO
*** SUMMARY ***
Total pot 18300 | Rake 0 
Board [7c 4h 2h]
Seat 1: Bigmag2011 folded before Flop (didn't bet)
Seat 2: TRENDLINEOKI folded before Flop (didn't bet)
Seat 3: dim@n.89liza collected (18300)
Seat 4: jcarlos.vale folded before Flop (didn't bet)
Seat 5: kensui (button) folded before Flop (didn't bet)
Seat 6: Ajax2530 (small blind) folded before Flop
Seat 7: Ermuun_34b (big blind) folded on the Flop
Seat 8: Matzen10 folded before Flop (didn't bet)
Seat 9: Alina 0297 folded before Flop (didn't bet)



PokerStars Hand #221909075810: Tournament #3082657132, $0.98+$0.12 USD Hold'em No Limit - Level XXIII (1200/2400) - 2020/12/27 20:22:31 EET [2020/12/27 13:22:31 ET]
Table '3082657132 62' 9-max Seat #6 is the button
Seat 1: Bigmag2011 (20749 in chips) 
Seat 2: TRENDLINEOKI (27287 in chips) 
Seat 3: dim@n.89liza (167197 in chips) 
Seat 4: jcarlos.vale (50127 in chips) 
Seat 5: kensui (41161 in chips) 
Seat 6: Ajax2530 (59746 in chips) 
Seat 7: Ermuun_34b (70225 in chips) 
Seat 8: Matzen10 (93986 in chips) 
Seat 9: Alina 0297 (67766 in chips) 
Bigmag2011: posts the ante 300
TRENDLINEOKI: posts the ante 300
dim@n.89liza: posts the ante 300
jcarlos.vale: posts the ante 300
kensui: posts the ante 300
Ajax2530: posts the ante 300
Ermuun_34b: posts the ante 300
Matzen10: posts the ante 300
Alina 0297: posts the ante 300
Ermuun_34b: posts small blind 1200
Matzen10: posts big blind 2400
*** HOLE CARDS ***
Dealt to jcarlos.vale [Tc Ks]
Alina 0297: folds 
Bigmag2011: folds 
TRENDLINEOKI: folds 
dim@n.89liza: raises 4800 to 7200
jcarlos.vale: folds 
kensui: folds 
Ajax2530: folds 
Ermuun_34b: folds 
Matzen10: folds 
Uncalled bet (4800) returned to dim@n.89liza
dim@n.89liza collected 8700 from pot
dim@n.89liza: doesn't show handDTO
*** SUMMARY ***
Total pot 8700 | Rake 0 
Seat 1: Bigmag2011 folded before Flop (didn't bet)
Seat 2: TRENDLINEOKI folded before Flop (didn't bet)
Seat 3: dim@n.89liza collected (8700)
Seat 4: jcarlos.vale folded before Flop (didn't bet)
Seat 5: kensui folded before Flop (didn't bet)
Seat 6: Ajax2530 (button) folded before Flop (didn't bet)
Seat 7: Ermuun_34b (small blind) folded before Flop
Seat 8: Matzen10 (big blind) folded before Flop
Seat 9: Alina 0297 folded before Flop (didn't bet)



PokerStars Hand #221909102505: Tournament #3082657132, $0.98+$0.12 USD Hold'em No Limit - Level XXIII (1200/2400) - 2020/12/27 20:23:01 EET [2020/12/27 13:23:01 ET]
Table '3082657132 62' 9-max Seat #7 is the button
Seat 1: Bigmag2011 (20449 in chips) 
Seat 2: TRENDLINEOKI (26987 in chips) 
Seat 3: dim@n.89liza (173197 in chips) 
Seat 4: jcarlos.vale (49827 in chips) 
Seat 5: kensui (40861 in chips) 
Seat 6: Ajax2530 (59446 in chips) 
Seat 7: Ermuun_34b (68725 in chips) 
Seat 8: Matzen10 (91286 in chips) 
Seat 9: Alina 0297 (67466 in chips) 
Bigmag2011: posts the ante 300
TRENDLINEOKI: posts the ante 300
dim@n.89liza: posts the ante 300
jcarlos.vale: posts the ante 300
kensui: posts the ante 300
Ajax2530: posts the ante 300
Ermuun_34b: posts the ante 300
Matzen10: posts the ante 300
Alina 0297: posts the ante 300
Matzen10: posts small blind 1200
Alina 0297: posts big blind 2400
*** HOLE CARDS ***
Dealt to jcarlos.vale [8s Jh]
Bigmag2011 has timed out
Bigmag2011: folds 
Bigmag2011 is sitting out
Bigmag2011 has returned
TRENDLINEOKI: raises 24287 to 26687 and is all-in
dim@n.89liza: folds 
jcarlos.vale: folds 
kensui: folds 
Ajax2530: folds 
Ermuun_34b: folds 
Matzen10: folds 
Alina 0297: folds 
Uncalled bet (24287) returned to TRENDLINEOKI
TRENDLINEOKI collected 8700 from pot
TRENDLINEOKI: doesn't show handDTO
*** SUMMARY ***
Total pot 8700 | Rake 0 
Seat 1: Bigmag2011 folded before Flop (didn't bet)
Seat 2: TRENDLINEOKI collected (8700)
Seat 3: dim@n.89liza folded before Flop (didn't bet)
Seat 4: jcarlos.vale folded before Flop (didn't bet)
Seat 5: kensui folded before Flop (didn't bet)
Seat 6: Ajax2530 folded before Flop (didn't bet)
Seat 7: Ermuun_34b (button) folded before Flop (didn't bet)
Seat 8: Matzen10 (small blind) folded before Flop
Seat 9: Alina 0297 (big blind) folded before Flop



PokerStars Hand #221909135635: Tournament #3082657132, $0.98+$0.12 USD Hold'em No Limit - Level XXIII (1200/2400) - 2020/12/27 20:23:38 EET [2020/12/27 13:23:38 ET]
Table '3082657132 62' 9-max Seat #8 is the button
Seat 1: Bigmag2011 (20149 in chips) 
Seat 2: TRENDLINEOKI (32987 in chips) 
Seat 3: dim@n.89liza (172897 in chips) 
Seat 4: jcarlos.vale (49527 in chips) 
Seat 5: kensui (40561 in chips) 
Seat 6: Ajax2530 (59146 in chips) 
Seat 7: Ermuun_34b (68425 in chips) 
Seat 8: Matzen10 (89786 in chips) 
Seat 9: Alina 0297 (64766 in chips) 
Bigmag2011: posts the ante 300
TRENDLINEOKI: posts the ante 300
dim@n.89liza: posts the ante 300
jcarlos.vale: posts the ante 300
kensui: posts the ante 300
Ajax2530: posts the ante 300
Ermuun_34b: posts the ante 300
Matzen10: posts the ante 300
Alina 0297: posts the ante 300
Alina 0297: posts small blind 1200
Bigmag2011: posts big blind 2400
*** HOLE CARDS ***
Dealt to jcarlos.vale [7c 3c]
TRENDLINEOKI: raises 30287 to 32687 and is all-in
dim@n.89liza: folds 
jcarlos.vale: folds 
kensui: folds 
Ajax2530 has timed out
Ajax2530: folds 
Ajax2530 is sitting out
Ermuun_34b: folds 
Matzen10: folds 
Ajax2530 has returned
Alina 0297: folds 
Bigmag2011: folds 
Uncalled bet (30287) returned to TRENDLINEOKI
TRENDLINEOKI collected 8700 from pot
TRENDLINEOKI: doesn't show handDTO
*** SUMMARY ***
Total pot 8700 | Rake 0 
Seat 1: Bigmag2011 (big blind) folded before Flop
Seat 2: TRENDLINEOKI collected (8700)
Seat 3: dim@n.89liza folded before Flop (didn't bet)
Seat 4: jcarlos.vale folded before Flop (didn't bet)
Seat 5: kensui folded before Flop (didn't bet)
Seat 6: Ajax2530 folded before Flop (didn't bet)
Seat 7: Ermuun_34b folded before Flop (didn't bet)
Seat 8: Matzen10 (button) folded before Flop (didn't bet)
Seat 9: Alina 0297 (small blind) folded before Flop



PokerStars Hand #221909173630: Tournament #3082657132, $0.98+$0.12 USD Hold'em No Limit - Level XXIII (1200/2400) - 2020/12/27 20:24:20 EET [2020/12/27 13:24:20 ET]
Table '3082657132 62' 9-max Seat #9 is the button
Seat 1: Bigmag2011 (17449 in chips) 
Seat 2: TRENDLINEOKI (38987 in chips) 
Seat 3: dim@n.89liza (172597 in chips) 
Seat 4: jcarlos.vale (49227 in chips) 
Seat 5: kensui (40261 in chips) 
Seat 6: Ajax2530 (58846 in chips) 
Seat 7: Ermuun_34b (68125 in chips) 
Seat 8: Matzen10 (89486 in chips) 
Seat 9: Alina 0297 (63266 in chips) 
Bigmag2011: posts the ante 300
TRENDLINEOKI: posts the ante 300
dim@n.89liza: posts the ante 300
jcarlos.vale: posts the ante 300
kensui: posts the ante 300
Ajax2530: posts the ante 300
Ermuun_34b: posts the ante 300
Matzen10: posts the ante 300
Alina 0297: posts the ante 300
Bigmag2011: posts small blind 1200
TRENDLINEOKI: posts big blind 2400
*** HOLE CARDS ***
Dealt to jcarlos.vale [4h Ks]
dim@n.89liza: folds 
jcarlos.vale: folds 
kensui: folds 
Ajax2530: folds 
Ermuun_34b: folds 
Matzen10: folds 
Alina 0297: folds 
Bigmag2011: raises 14749 to 17149 and is all-in
TRENDLINEOKI: folds 
Uncalled bet (14749) returned to Bigmag2011
Bigmag2011 collected 7500 from pot
Bigmag2011: doesn't show handDTO
*** SUMMARY ***
Total pot 7500 | Rake 0 
Seat 1: Bigmag2011 (small blind) collected (7500)
Seat 2: TRENDLINEOKI (big blind) folded before Flop
Seat 3: dim@n.89liza folded before Flop (didn't bet)
Seat 4: jcarlos.vale folded before Flop (didn't bet)
Seat 5: kensui folded before Flop (didn't bet)
Seat 6: Ajax2530 folded before Flop (didn't bet)
Seat 7: Ermuun_34b folded before Flop (didn't bet)
Seat 8: Matzen10 folded before Flop (didn't bet)
Seat 9: Alina 0297 (button) folded before Flop (didn't bet)



PokerStars Hand #221909192049: Tournament #3082657132, $0.98+$0.12 USD Hold'em No Limit - Level XXIII (1200/2400) - 2020/12/27 20:24:41 EET [2020/12/27 13:24:41 ET]
Table '3082657132 62' 9-max Seat #1 is the button
Seat 1: Bigmag2011 (22249 in chips) 
Seat 2: TRENDLINEOKI (36287 in chips) 
Seat 3: dim@n.89liza (172297 in chips) 
Seat 4: jcarlos.vale (48927 in chips) 
Seat 5: kensui (39961 in chips) 
Seat 6: Ajax2530 (58546 in chips) 
Seat 7: Ermuun_34b (67825 in chips) 
Seat 8: Matzen10 (89186 in chips) 
Seat 9: Alina 0297 (62966 in chips) 
Bigmag2011: posts the ante 300
TRENDLINEOKI: posts the ante 300
dim@n.89liza: posts the ante 300
jcarlos.vale: posts the ante 300
kensui: posts the ante 300
Ajax2530: posts the ante 300
Ermuun_34b: posts the ante 300
Matzen10: posts the ante 300
Alina 0297: posts the ante 300
TRENDLINEOKI: posts small blind 1200
dim@n.89liza: posts big blind 2400
*** HOLE CARDS ***
Dealt to jcarlos.vale [Th 2s]
jcarlos.vale: folds 
kensui: folds 
Ajax2530: folds 
Ermuun_34b: calls 2400
Matzen10: folds 
Alina 0297: folds 
Bigmag2011: folds 
TRENDLINEOKI: folds 
dim@n.89liza: checks 
*** FLOP *** [Ad Tc Td]
dim@n.89liza: checks 
Ermuun_34b: bets 2400
dim@n.89liza: folds 
Uncalled bet (2400) returned to Ermuun_34b
Ermuun_34b collected 8700 from pot
Ermuun_34b: doesn't show handDTO
*** SUMMARY ***
Total pot 8700 | Rake 0 
Board [Ad Tc Td]
Seat 1: Bigmag2011 (button) folded before Flop (didn't bet)
Seat 2: TRENDLINEOKI (small blind) folded before Flop
Seat 3: dim@n.89liza (big blind) folded on the Flop
Seat 4: jcarlos.vale folded before Flop (didn't bet)
Seat 5: kensui folded before Flop (didn't bet)
Seat 6: Ajax2530 folded before Flop (didn't bet)
Seat 7: Ermuun_34b collected (8700)
Seat 8: Matzen10 folded before Flop (didn't bet)
Seat 9: Alina 0297 folded before Flop (didn't bet)



PokerStars Hand #221909227238: Tournament #3082657132, $0.98+$0.12 USD Hold'em No Limit - Level XXIII (1200/2400) - 2020/12/27 20:25:20 EET [2020/12/27 13:25:20 ET]
Table '3082657132 62' 9-max Seat #2 is the button
Seat 1: Bigmag2011 (21949 in chips) 
Seat 2: TRENDLINEOKI (34787 in chips) 
Seat 3: dim@n.89liza (169597 in chips) 
Seat 4: jcarlos.vale (48627 in chips) 
Seat 5: kensui (39661 in chips) 
Seat 6: Ajax2530 (58246 in chips) 
Seat 7: Ermuun_34b (73825 in chips) 
Seat 8: Matzen10 (88886 in chips) 
Seat 9: Alina 0297 (62666 in chips) 
Bigmag2011: posts the ante 300
TRENDLINEOKI: posts the ante 300
dim@n.89liza: posts the ante 300
jcarlos.vale: posts the ante 300
kensui: posts the ante 300
Ajax2530: posts the ante 300
Ermuun_34b: posts the ante 300
Matzen10: posts the ante 300
Alina 0297: posts the ante 300
dim@n.89liza: posts small blind 1200
jcarlos.vale: posts big blind 2400
*** HOLE CARDS ***
Dealt to jcarlos.vale [8h 4d]
kensui: folds 
Ajax2530: folds 
Ermuun_34b: folds 
Matzen10: raises 2400 to 4800
Alina 0297: folds 
Bigmag2011: raises 16849 to 21649 and is all-in
TRENDLINEOKI: folds 
dim@n.89liza: folds 
jcarlos.vale: folds 
Matzen10: calls 16849
*** FLOP *** [7s 3h Jh]
*** TURN *** [7s 3h Jh] [Ac]
*** RIVER *** [7s 3h Jh Ac] [6s]
*** SHOW DOWN ***
Matzen10: shows [7c 7h] (three of a kind, Sevens)
Bigmag2011: shows [3s 3c] (three of a kind, Threes)
Matzen10 collected 49598 from pot
Bigmag2011 finished the tournament in 113th place and received $4.50.
*** SUMMARY ***
Total pot 49598 | Rake 0 
Board [7s 3h Jh Ac 6s]
Seat 1: Bigmag2011 showed [3s 3c] and lost with three of a kind, Threes
Seat 2: TRENDLINEOKI (button) folded before Flop (didn't bet)
Seat 3: dim@n.89liza (small blind) folded before Flop
Seat 4: jcarlos.vale (big blind) folded before Flop
Seat 5: kensui folded before Flop (didn't bet)
Seat 6: Ajax2530 folded before Flop (didn't bet)
Seat 7: Ermuun_34b folded before Flop (didn't bet)
Seat 8: Matzen10 showed [7c 7h] and won (49598) with three of a kind, Sevens
Seat 9: Alina 0297 folded before Flop (didn't bet)



PokerStars Hand #221909270982: Tournament #3082657132, $0.98+$0.12 USD Hold'em No Limit - Level XXIII (1200/2400) - 2020/12/27 20:26:09 EET [2020/12/27 13:26:09 ET]
Table '3082657132 62' 9-max Seat #3 is the button
Seat 2: TRENDLINEOKI (34487 in chips) 
Seat 3: dim@n.89liza (168097 in chips) 
Seat 4: jcarlos.vale (45927 in chips) 
Seat 5: kensui (39361 in chips) 
Seat 6: Ajax2530 (57946 in chips) 
Seat 7: Ermuun_34b (73525 in chips) 
Seat 8: Matzen10 (116535 in chips) 
Seat 9: Alina 0297 (62366 in chips) 
TRENDLINEOKI: posts the ante 300
dim@n.89liza: posts the ante 300
jcarlos.vale: posts the ante 300
kensui: posts the ante 300
Ajax2530: posts the ante 300
Ermuun_34b: posts the ante 300
Matzen10: posts the ante 300
Alina 0297: posts the ante 300
jcarlos.vale: posts small blind 1200
kensui: posts big blind 2400
*** HOLE CARDS ***
Dealt to jcarlos.vale [3h 3c]
Ajax2530: folds 
Ermuun_34b: folds 
Matzen10: folds 
Alina 0297: folds 
TRENDLINEOKI: raises 31787 to 34187 and is all-in
dim@n.89liza: folds 
jcarlos.vale: folds 
kensui: folds 
Uncalled bet (31787) returned to TRENDLINEOKI
TRENDLINEOKI collected 8400 from pot
TRENDLINEOKI: doesn't show handDTO
*** SUMMARY ***
Total pot 8400 | Rake 0 
Seat 2: TRENDLINEOKI collected (8400)
Seat 3: dim@n.89liza (button) folded before Flop (didn't bet)
Seat 4: jcarlos.vale (small blind) folded before Flop
Seat 5: kensui (big blind) folded before Flop
Seat 6: Ajax2530 folded before Flop (didn't bet)
Seat 7: Ermuun_34b folded before Flop (didn't bet)
Seat 8: Matzen10 folded before Flop (didn't bet)
Seat 9: Alina 0297 folded before Flop (didn't bet)



PokerStars Hand #221909305032: Tournament #3082657132, $0.98+$0.12 USD Hold'em No Limit - Level XXIII (1200/2400) - 2020/12/27 20:26:47 EET [2020/12/27 13:26:47 ET]
Table '3082657132 62' 9-max Seat #4 is the button
Seat 2: TRENDLINEOKI (40187 in chips) 
Seat 3: dim@n.89liza (167797 in chips) 
Seat 4: jcarlos.vale (44427 in chips) 
Seat 5: kensui (36661 in chips) 
Seat 6: Ajax2530 (57646 in chips) 
Seat 7: Ermuun_34b (73225 in chips) 
Seat 8: Matzen10 (116235 in chips) 
Seat 9: Alina 0297 (62066 in chips) 
TRENDLINEOKI: posts the ante 300
dim@n.89liza: posts the ante 300
jcarlos.vale: posts the ante 300
kensui: posts the ante 300
Ajax2530: posts the ante 300
Ermuun_34b: posts the ante 300
Matzen10: posts the ante 300
Alina 0297: posts the ante 300
kensui: posts small blind 1200
Ajax2530: posts big blind 2400
*** HOLE CARDS ***
Dealt to jcarlos.vale [Kd 2c]
Ermuun_34b: raises 6000 to 8400
Matzen10: folds 
Alina 0297: folds 
TRENDLINEOKI: folds 
dim@n.89liza: folds 
jcarlos.vale: folds 
kensui: folds 
Ajax2530: folds 
Uncalled bet (6000) returned to Ermuun_34b
Ermuun_34b collected 8400 from pot
Ermuun_34b: doesn't show handDTO
*** SUMMARY ***
Total pot 8400 | Rake 0 
Seat 2: TRENDLINEOKI folded before Flop (didn't bet)
Seat 3: dim@n.89liza folded before Flop (didn't bet)
Seat 4: jcarlos.vale (button) folded before Flop (didn't bet)
Seat 5: kensui (small blind) folded before Flop
Seat 6: Ajax2530 (big blind) folded before Flop
Seat 7: Ermuun_34b collected (8400)
Seat 8: Matzen10 folded before Flop (didn't bet)
Seat 9: Alina 0297 folded before Flop (didn't bet)



PokerStars Hand #221909325505: Tournament #3082657132, $0.98+$0.12 USD Hold'em No Limit - Level XXIII (1200/2400) - 2020/12/27 20:27:10 EET [2020/12/27 13:27:10 ET]
Table '3082657132 62' 9-max Seat #5 is the button
Seat 2: TRENDLINEOKI (39887 in chips) 
Seat 3: dim@n.89liza (167497 in chips) 
Seat 4: jcarlos.vale (44127 in chips) 
Seat 5: kensui (35161 in chips) 
Seat 6: Ajax2530 (54946 in chips) 
Seat 7: Ermuun_34b (78925 in chips) 
Seat 8: Matzen10 (115935 in chips) 
Seat 9: Alina 0297 (61766 in chips) 
TRENDLINEOKI: posts the ante 300
dim@n.89liza: posts the ante 300
jcarlos.vale: posts the ante 300
kensui: posts the ante 300
Ajax2530: posts the ante 300
Ermuun_34b: posts the ante 300
Matzen10: posts the ante 300
Alina 0297: posts the ante 300
Ajax2530: posts small blind 1200
Ermuun_34b: posts big blind 2400
*** HOLE CARDS ***
Dealt to jcarlos.vale [Qc 9d]
Matzen10: folds 
Alina 0297: folds 
TRENDLINEOKI: folds 
dim@n.89liza: folds 
jcarlos.vale: folds 
kensui: folds 
Ajax2530: folds 
Uncalled bet (1200) returned to Ermuun_34b
Ermuun_34b collected 4800 from pot
Ermuun_34b: doesn't show handDTO
*** SUMMARY ***
Total pot 4800 | Rake 0 
Seat 2: TRENDLINEOKI folded before Flop (didn't bet)
Seat 3: dim@n.89liza folded before Flop (didn't bet)
Seat 4: jcarlos.vale folded before Flop (didn't bet)
Seat 5: kensui (button) folded before Flop (didn't bet)
Seat 6: Ajax2530 (small blind) folded before Flop
Seat 7: Ermuun_34b (big blind) collected (4800)
Seat 8: Matzen10 folded before Flop (didn't bet)
Seat 9: Alina 0297 folded before Flop (didn't bet)



PokerStars Hand #221909357586: Tournament #3082657132, $0.98+$0.12 USD Hold'em No Limit - Level XXIII (1200/2400) - 2020/12/27 20:27:35 EET [2020/12/27 13:27:35 ET]
Table '3082657132 62' 9-max Seat #6 is the button
Seat 2: TRENDLINEOKI (39587 in chips) 
Seat 3: dim@n.89liza (167197 in chips) 
Seat 4: jcarlos.vale (43827 in chips) 
Seat 5: kensui (34861 in chips) 
Seat 6: Ajax2530 (53446 in chips) 
Seat 7: Ermuun_34b (82225 in chips) 
Seat 8: Matzen10 (115635 in chips) 
Seat 9: Alina 0297 (61466 in chips) 
TRENDLINEOKI: posts the ante 300
dim@n.89liza: posts the ante 300
jcarlos.vale: posts the ante 300
kensui: posts the ante 300
Ajax2530: posts the ante 300
Ermuun_34b: posts the ante 300
Matzen10: posts the ante 300
Alina 0297: posts the ante 300
Ermuun_34b: posts small blind 1200
Matzen10: posts big blind 2400
*** HOLE CARDS ***
Dealt to jcarlos.vale [3s 2d]
Alina 0297: folds 
TRENDLINEOKI: folds 
dim@n.89liza: folds 
jcarlos.vale: folds 
kensui: folds 
Ajax2530: raises 2820 to 5220
Ermuun_34b: folds 
Matzen10: raises 110115 to 115335 and is all-in
Ajax2530: folds 
Uncalled bet (110115) returned to Matzen10
Matzen10 collected 14040 from pot
Matzen10: doesn't show handDTO
*** SUMMARY ***
Total pot 14040 | Rake 0 
Seat 2: TRENDLINEOKI folded before Flop (didn't bet)
Seat 3: dim@n.89liza folded before Flop (didn't bet)
Seat 4: jcarlos.vale folded before Flop (didn't bet)
Seat 5: kensui folded before Flop (didn't bet)
Seat 6: Ajax2530 (button) folded before Flop
Seat 7: Ermuun_34b (small blind) folded before Flop
Seat 8: Matzen10 (big blind) collected (14040)
Seat 9: Alina 0297 folded before Flop (didn't bet)



PokerStars Hand #221909414795: Tournament #3082657132, $0.98+$0.12 USD Hold'em No Limit - Level XXIII (1200/2400) - 2020/12/27 20:28:38 EET [2020/12/27 13:28:38 ET]
Table '3082657132 62' 9-max Seat #7 is the button
Seat 2: TRENDLINEOKI (39287 in chips) 
Seat 3: dim@n.89liza (166897 in chips) 
Seat 4: jcarlos.vale (43527 in chips) 
Seat 5: kensui (34561 in chips) 
Seat 6: Ajax2530 (47926 in chips) 
Seat 7: Ermuun_34b (80725 in chips) 
Seat 8: Matzen10 (124155 in chips) 
Seat 9: Alina 0297 (61166 in chips) 
TRENDLINEOKI: posts the ante 300
dim@n.89liza: posts the ante 300
jcarlos.vale: posts the ante 300
kensui: posts the ante 300
Ajax2530: posts the ante 300
Ermuun_34b: posts the ante 300
Matzen10: posts the ante 300
Alina 0297: posts the ante 300
Matzen10: posts small blind 1200
Alina 0297: posts big blind 2400
*** HOLE CARDS ***
Dealt to jcarlos.vale [6c 6h]
TRENDLINEOKI: folds 
dim@n.89liza: folds 
jcarlos.vale: raises 3840 to 6240
kensui: folds 
Ajax2530: folds 
Ermuun_34b: folds 
Matzen10: folds 
Alina 0297: folds 
Uncalled bet (3840) returned to jcarlos.vale
jcarlos.vale collected 8400 from pot
jcarlos.vale: doesn't show handDTO
*** SUMMARY ***
Total pot 8400 | Rake 0 
Seat 2: TRENDLINEOKI folded before Flop (didn't bet)
Seat 3: dim@n.89liza folded before Flop (didn't bet)
Seat 4: jcarlos.vale collected (8400)
Seat 5: kensui folded before Flop (didn't bet)
Seat 6: Ajax2530 folded before Flop (didn't bet)
Seat 7: Ermuun_34b (button) folded before Flop (didn't bet)
Seat 8: Matzen10 (small blind) folded before Flop
Seat 9: Alina 0297 (big blind) folded before Flop



PokerStars Hand #221909438240: Tournament #3082657132, $0.98+$0.12 USD Hold'em No Limit - Level XXIII (1200/2400) - 2020/12/27 20:29:04 EET [2020/12/27 13:29:04 ET]
Table '3082657132 62' 9-max Seat #8 is the button
Seat 2: TRENDLINEOKI (38987 in chips) 
Seat 3: dim@n.89liza (166597 in chips) 
Seat 4: jcarlos.vale (49227 in chips) 
Seat 5: kensui (34261 in chips) 
Seat 6: Ajax2530 (47626 in chips) 
Seat 7: Ermuun_34b (80425 in chips) 
Seat 8: Matzen10 (122655 in chips) 
Seat 9: Alina 0297 (58466 in chips) 
TRENDLINEOKI: posts the ante 300
dim@n.89liza: posts the ante 300
jcarlos.vale: posts the ante 300
kensui: posts the ante 300
Ajax2530: posts the ante 300
Ermuun_34b: posts the ante 300
Matzen10: posts the ante 300
Alina 0297: posts the ante 300
Alina 0297: posts small blind 1200
TRENDLINEOKI: posts big blind 2400
*** HOLE CARDS ***
Dealt to jcarlos.vale [Td Js]
dim@n.89liza: raises 4800 to 7200
jcarlos.vale: folds 
kensui: folds 
Ajax2530: folds 
Ermuun_34b: folds 
Matzen10: folds 
Alina 0297: folds 
TRENDLINEOKI: folds 
Uncalled bet (4800) returned to dim@n.89liza
dim@n.89liza collected 8400 from pot
dim@n.89liza: doesn't show handDTO
*** SUMMARY ***
Total pot 8400 | Rake 0 
Seat 2: TRENDLINEOKI (big blind) folded before Flop
Seat 3: dim@n.89liza collected (8400)
Seat 4: jcarlos.vale folded before Flop (didn't bet)
Seat 5: kensui folded before Flop (didn't bet)
Seat 6: Ajax2530 folded before Flop (didn't bet)
Seat 7: Ermuun_34b folded before Flop (didn't bet)
Seat 8: Matzen10 (button) folded before Flop (didn't bet)
Seat 9: Alina 0297 (small blind) folded before Flop



PokerStars Hand #221909458581: Tournament #3082657132, $0.98+$0.12 USD Hold'em No Limit - Level XXIII (1200/2400) - 2020/12/27 20:29:27 EET [2020/12/27 13:29:27 ET]
Table '3082657132 62' 9-max Seat #9 is the button
Seat 2: TRENDLINEOKI (36287 in chips) 
Seat 3: dim@n.89liza (172297 in chips) 
Seat 4: jcarlos.vale (48927 in chips) 
Seat 5: kensui (33961 in chips) 
Seat 6: Ajax2530 (47326 in chips) 
Seat 7: Ermuun_34b (80125 in chips) 
Seat 8: Matzen10 (122355 in chips) 
Seat 9: Alina 0297 (56966 in chips) 
TRENDLINEOKI: posts the ante 300
dim@n.89liza: posts the ante 300
jcarlos.vale: posts the ante 300
kensui: posts the ante 300
Ajax2530: posts the ante 300
Ermuun_34b: posts the ante 300
Matzen10: posts the ante 300
Alina 0297: posts the ante 300
TRENDLINEOKI: posts small blind 1200
dim@n.89liza: posts big blind 2400
*** HOLE CARDS ***
Dealt to jcarlos.vale [5h Kd]
jcarlos.vale: folds 
kensui: raises 31261 to 33661 and is all-in
Ajax2530: folds 
Ermuun_34b: folds 
Matzen10: folds 
Alina 0297: folds 
TRENDLINEOKI: folds 
dim@n.89liza: folds 
Uncalled bet (31261) returned to kensui
kensui collected 8400 from pot
kensui: doesn't show handDTO
*** SUMMARY ***
Total pot 8400 | Rake 0 
Seat 2: TRENDLINEOKI (small blind) folded before Flop
Seat 3: dim@n.89liza (big blind) folded before Flop
Seat 4: jcarlos.vale folded before Flop (didn't bet)
Seat 5: kensui collected (8400)
Seat 6: Ajax2530 folded before Flop (didn't bet)
Seat 7: Ermuun_34b folded before Flop (didn't bet)
Seat 8: Matzen10 folded before Flop (didn't bet)
Seat 9: Alina 0297 (button) folded before Flop (didn't bet)



PokerStars Hand #221909491809: Tournament #3082657132, $0.98+$0.12 USD Hold'em No Limit - Level XXIII (1200/2400) - 2020/12/27 20:30:04 EET [2020/12/27 13:30:04 ET]
Table '3082657132 62' 9-max Seat #2 is the button
Seat 1: giourkas_h (124082 in chips) 
Seat 2: TRENDLINEOKI (34787 in chips) 
Seat 3: dim@n.89liza (169597 in chips) 
Seat 4: jcarlos.vale (48627 in chips) 
Seat 5: kensui (39661 in chips) 
Seat 6: Ajax2530 (47026 in chips) 
Seat 7: Ermuun_34b (79825 in chips) 
Seat 8: Matzen10 (122055 in chips) 
Seat 9: Alina 0297 (56666 in chips) 
giourkas_h: posts the ante 300
TRENDLINEOKI: posts the ante 300
dim@n.89liza: posts the ante 300
jcarlos.vale: posts the ante 300
kensui: posts the ante 300
Ajax2530: posts the ante 300
Ermuun_34b: posts the ante 300
Matzen10: posts the ante 300
Alina 0297: posts the ante 300
dim@n.89liza: posts small blind 1200
jcarlos.vale: posts big blind 2400
*** HOLE CARDS ***
Dealt to jcarlos.vale [Qd Kc]
kensui: folds 
Ajax2530: folds 
Ermuun_34b: folds 
Matzen10: folds 
Alina 0297: raises 4800 to 7200
giourkas_h: calls 7200
TRENDLINEOKI: raises 27287 to 34487 and is all-in
dim@n.89liza: folds 
jcarlos.vale: folds 
Alina 0297: raises 21879 to 56366 and is all-in
giourkas_h: calls 49166
*** FLOP *** [2s Td 6s]
*** TURN *** [2s Td 6s] [8s]
*** RIVER *** [2s Td 6s 8s] [6d]
*** SHOW DOWN ***
Alina 0297: shows [9d 9s] (two pair, Nines and Sixes)
giourkas_h: shows [Th Ah] (two pair, Tens and Sixes)
giourkas_h collected 43758 from side pot
TRENDLINEOKI: shows [Qs Qh] (two pair, Queens and Sixes)
TRENDLINEOKI collected 109761 from main pot
Alina 0297 finished the tournament in 104th place and received $5.32.
*** SUMMARY ***
Total pot 153519 Main pot 109761. Side pot 43758. | Rake 0 
Board [2s Td 6s 8s 6d]
Seat 1: giourkas_h showed [Th Ah] and won (43758) with two pair, Tens and Sixes
Seat 2: TRENDLINEOKI (button) showed [Qs Qh] and won (109761) with two pair, Queens and Sixes
Seat 3: dim@n.89liza (small blind) folded before Flop
Seat 4: jcarlos.vale (big blind) folded before Flop
Seat 5: kensui folded before Flop (didn't bet)
Seat 6: Ajax2530 folded before Flop (didn't bet)
Seat 7: Ermuun_34b folded before Flop (didn't bet)
Seat 8: Matzen10 folded before Flop (didn't bet)
Seat 9: Alina 0297 showed [9d 9s] and lost with two pair, Nines and Sixes



PokerStars Hand #221909535767: Tournament #3082657132, $0.98+$0.12 USD Hold'em No Limit - Level XXIII (1200/2400) - 2020/12/27 20:30:52 EET [2020/12/27 13:30:52 ET]
Table '3082657132 62' 9-max Seat #3 is the button
Seat 1: giourkas_h (111174 in chips) 
Seat 2: TRENDLINEOKI (109761 in chips) 
Seat 3: dim@n.89liza (168097 in chips) 
Seat 4: jcarlos.vale (45927 in chips) 
Seat 5: kensui (39361 in chips) 
Seat 6: Ajax2530 (46726 in chips) 
Seat 7: Ermuun_34b (79525 in chips) 
Seat 8: Matzen10 (121755 in chips) 
giourkas_h: posts the ante 300
TRENDLINEOKI: posts the ante 300
dim@n.89liza: posts the ante 300
jcarlos.vale: posts the ante 300
kensui: posts the ante 300
Ajax2530: posts the ante 300
Ermuun_34b: posts the ante 300
Matzen10: posts the ante 300
jcarlos.vale: posts small blind 1200
kensui: posts big blind 2400
*** HOLE CARDS ***
Dealt to jcarlos.vale [Js 7d]
Ajax2530 has timed out
Ajax2530: folds 
Ajax2530 is sitting out
Ermuun_34b: folds 
Matzen10: raises 2400 to 4800
giourkas_h: folds 
TRENDLINEOKI: folds 
dim@n.89liza: folds 
Ajax2530 has returned
jcarlos.vale: folds 
kensui: calls 2400
*** FLOP *** [2h Qs 7s]
kensui: checks 
Matzen10: bets 4356
kensui: folds 
Uncalled bet (4356) returned to Matzen10
Matzen10 collected 13200 from pot
Matzen10: doesn't show handDTO
*** SUMMARY ***
Total pot 13200 | Rake 0 
Board [2h Qs 7s]
Seat 1: giourkas_h folded before Flop (didn't bet)
Seat 2: TRENDLINEOKI folded before Flop (didn't bet)
Seat 3: dim@n.89liza (button) folded before Flop (didn't bet)
Seat 4: jcarlos.vale (small blind) folded before Flop
Seat 5: kensui (big blind) folded on the Flop
Seat 6: Ajax2530 folded before Flop (didn't bet)
Seat 7: Ermuun_34b folded before Flop (didn't bet)
Seat 8: Matzen10 collected (13200)



PokerStars Hand #221909580959: Tournament #3082657132, $0.98+$0.12 USD Hold'em No Limit - Level XXIV (1400/2800) - 2020/12/27 20:31:41 EET [2020/12/27 13:31:41 ET]
Table '3082657132 62' 9-max Seat #4 is the button
Seat 1: giourkas_h (110874 in chips) 
Seat 2: TRENDLINEOKI (109461 in chips) 
Seat 3: dim@n.89liza (167797 in chips) 
Seat 4: jcarlos.vale (44427 in chips) 
Seat 5: kensui (34261 in chips) 
Seat 6: Ajax2530 (46426 in chips) 
Seat 7: Ermuun_34b (79225 in chips) 
Seat 8: Matzen10 (129855 in chips) 
giourkas_h: posts the ante 350
TRENDLINEOKI: posts the ante 350
dim@n.89liza: posts the ante 350
jcarlos.vale: posts the ante 350
kensui: posts the ante 350
Ajax2530: posts the ante 350
Ermuun_34b: posts the ante 350
Matzen10: posts the ante 350
kensui: posts small blind 1400
Ajax2530: posts big blind 2800
*** HOLE CARDS ***
Dealt to jcarlos.vale [Jc 7c]
Ermuun_34b: folds 
Matzen10: folds 
giourkas_h: raises 3752 to 6552
TRENDLINEOKI: folds 
dim@n.89liza: folds 
jcarlos.vale: folds 
kensui: folds 
Ajax2530 has timed out
Ajax2530: folds 
Ajax2530 is sitting out
Uncalled bet (3752) returned to giourkas_h
giourkas_h collected 9800 from pot
giourkas_h: doesn't show handDTO
*** SUMMARY ***
Total pot 9800 | Rake 0 
Seat 1: giourkas_h collected (9800)
Seat 2: TRENDLINEOKI folded before Flop (didn't bet)
Seat 3: dim@n.89liza folded before Flop (didn't bet)
Seat 4: jcarlos.vale (button) folded before Flop (didn't bet)
Seat 5: kensui (small blind) folded before Flop
Seat 6: Ajax2530 (big blind) folded before Flop
Seat 7: Ermuun_34b folded before Flop (didn't bet)
Seat 8: Matzen10 folded before Flop (didn't bet)



PokerStars Hand #221909614828: Tournament #3082657132, $0.98+$0.12 USD Hold'em No Limit - Level XXIV (1400/2800) - 2020/12/27 20:32:18 EET [2020/12/27 13:32:18 ET]
Table '3082657132 62' 9-max Seat #5 is the button
Seat 1: giourkas_h (117524 in chips) 
Seat 2: TRENDLINEOKI (109111 in chips) 
Seat 3: dim@n.89liza (167447 in chips) 
Seat 4: jcarlos.vale (44077 in chips) 
Seat 5: kensui (32511 in chips) 
Seat 6: Ajax2530 (43276 in chips) is sitting out
Seat 7: Ermuun_34b (78875 in chips) 
Seat 8: Matzen10 (129505 in chips) 
giourkas_h: posts the ante 350
TRENDLINEOKI: posts the ante 350
dim@n.89liza: posts the ante 350
jcarlos.vale: posts the ante 350
kensui: posts the ante 350
Ajax2530: posts the ante 350
Ermuun_34b: posts the ante 350
Matzen10: posts the ante 350
Ajax2530: posts small blind 1400
Ermuun_34b: posts big blind 2800
*** HOLE CARDS ***
Dealt to jcarlos.vale [8d Jc]
Ajax2530 has returned
Matzen10: raises 2800 to 5600
giourkas_h: folds 
TRENDLINEOKI: folds 
dim@n.89liza: raises 16800 to 22400
jcarlos.vale: folds 
kensui: folds 
Ajax2530: folds 
Ermuun_34b: folds 
Matzen10: folds 
Uncalled bet (16800) returned to dim@n.89liza
dim@n.89liza collected 18200 from pot
dim@n.89liza: doesn't show handDTO
*** SUMMARY ***
Total pot 18200 | Rake 0 
Seat 1: giourkas_h folded before Flop (didn't bet)
Seat 2: TRENDLINEOKI folded before Flop (didn't bet)
Seat 3: dim@n.89liza collected (18200)
Seat 4: jcarlos.vale folded before Flop (didn't bet)
Seat 5: kensui (button) folded before Flop (didn't bet)
Seat 6: Ajax2530 (small blind) folded before Flop
Seat 7: Ermuun_34b (big blind) folded before Flop
Seat 8: Matzen10 folded before Flop



PokerStars Hand #221909642938: Tournament #3082657132, $0.98+$0.12 USD Hold'em No Limit - Level XXIV (1400/2800) - 2020/12/27 20:32:49 EET [2020/12/27 13:32:49 ET]
Table '3082657132 62' 9-max Seat #6 is the button
Seat 1: giourkas_h (117174 in chips) 
Seat 2: TRENDLINEOKI (108761 in chips) 
Seat 3: dim@n.89liza (179697 in chips) 
Seat 4: jcarlos.vale (43727 in chips) 
Seat 5: kensui (32161 in chips) 
Seat 6: Ajax2530 (41526 in chips) 
Seat 7: Ermuun_34b (75725 in chips) 
Seat 8: Matzen10 (123555 in chips) 
giourkas_h: posts the ante 350
TRENDLINEOKI: posts the ante 350
dim@n.89liza: posts the ante 350
jcarlos.vale: posts the ante 350
kensui: posts the ante 350
Ajax2530: posts the ante 350
Ermuun_34b: posts the ante 350
Matzen10: posts the ante 350
Ermuun_34b: posts small blind 1400
Matzen10: posts big blind 2800
*** HOLE CARDS ***
Dealt to jcarlos.vale [Qc 5s]
giourkas_h: folds 
TRENDLINEOKI has timed out
TRENDLINEOKI: folds 
TRENDLINEOKI is sitting out
dim@n.89liza: folds 
jcarlos.vale: folds 
kensui: folds 
Ajax2530: folds 
TRENDLINEOKI has returned
Ermuun_34b: raises 2800 to 5600
Matzen10: calls 2800
*** FLOP *** [Ts 3c 3h]
Ermuun_34b: bets 2800
Matzen10: folds 
Uncalled bet (2800) returned to Ermuun_34b
Ermuun_34b collected 14000 from pot
Ermuun_34b: doesn't show handDTO
*** SUMMARY ***
Total pot 14000 | Rake 0 
Board [Ts 3c 3h]
Seat 1: giourkas_h folded before Flop (didn't bet)
Seat 2: TRENDLINEOKI folded before Flop (didn't bet)
Seat 3: dim@n.89liza folded before Flop (didn't bet)
Seat 4: jcarlos.vale folded before Flop (didn't bet)
Seat 5: kensui folded before Flop (didn't bet)
Seat 6: Ajax2530 (button) folded before Flop (didn't bet)
Seat 7: Ermuun_34b (small blind) collected (14000)
Seat 8: Matzen10 (big blind) folded on the Flop



PokerStars Hand #221909689677: Tournament #3082657132, $0.98+$0.12 USD Hold'em No Limit - Level XXIV (1400/2800) - 2020/12/27 20:33:40 EET [2020/12/27 13:33:40 ET]
Table '3082657132 62' 9-max Seat #7 is the button
Seat 1: giourkas_h (116824 in chips) 
Seat 2: TRENDLINEOKI (108411 in chips) 
Seat 3: dim@n.89liza (179347 in chips) 
Seat 4: jcarlos.vale (43377 in chips) 
Seat 5: kensui (31811 in chips) 
Seat 6: Ajax2530 (41176 in chips) 
Seat 7: Ermuun_34b (83775 in chips) 
Seat 8: Matzen10 (117605 in chips) 
Seat 9: dsg888 (76428 in chips) 
giourkas_h: posts the ante 350
TRENDLINEOKI: posts the ante 350
dim@n.89liza: posts the ante 350
jcarlos.vale: posts the ante 350
kensui: posts the ante 350
Ajax2530: posts the ante 350
Ermuun_34b: posts the ante 350
Matzen10: posts the ante 350
dsg888: posts the ante 350
Matzen10: posts small blind 1400
dsg888: posts big blind 2800
*** HOLE CARDS ***
Dealt to jcarlos.vale [6c 3h]
giourkas_h: folds 
TRENDLINEOKI: folds 
dim@n.89liza: folds 
jcarlos.vale: folds 
kensui: folds 
Ajax2530: folds 
Ermuun_34b: folds 
Matzen10: raises 7000 to 9800
dsg888: folds 
Uncalled bet (7000) returned to Matzen10
Matzen10 collected 8750 from pot
Matzen10: doesn't show handDTO
*** SUMMARY ***
Total pot 8750 | Rake 0 
Seat 1: giourkas_h folded before Flop (didn't bet)
Seat 2: TRENDLINEOKI folded before Flop (didn't bet)
Seat 3: dim@n.89liza folded before Flop (didn't bet)
Seat 4: jcarlos.vale folded before Flop (didn't bet)
Seat 5: kensui folded before Flop (didn't bet)
Seat 6: Ajax2530 folded before Flop (didn't bet)
Seat 7: Ermuun_34b (button) folded before Flop (didn't bet)
Seat 8: Matzen10 (small blind) collected (8750)
Seat 9: dsg888 (big blind) folded before Flop



PokerStars Hand #221909716945: Tournament #3082657132, $0.98+$0.12 USD Hold'em No Limit - Level XXIV (1400/2800) - 2020/12/27 20:34:10 EET [2020/12/27 13:34:10 ET]
Table '3082657132 62' 9-max Seat #8 is the button
Seat 1: giourkas_h (116474 in chips) 
Seat 2: TRENDLINEOKI (108061 in chips) 
Seat 3: dim@n.89liza (178997 in chips) 
Seat 4: jcarlos.vale (43027 in chips) 
Seat 6: Ajax2530 (40826 in chips) 
Seat 7: Ermuun_34b (83425 in chips) 
Seat 8: Matzen10 (123205 in chips) 
Seat 9: dsg888 (73278 in chips) 
giourkas_h: posts the ante 350
TRENDLINEOKI: posts the ante 350
dim@n.89liza: posts the ante 350
jcarlos.vale: posts the ante 350
Ajax2530: posts the ante 350
Ermuun_34b: posts the ante 350
Matzen10: posts the ante 350
dsg888: posts the ante 350
dsg888: posts small blind 1400
giourkas_h: posts big blind 2800
*** HOLE CARDS ***
Dealt to jcarlos.vale [9s 9c]
TRENDLINEOKI: folds 
dim@n.89liza: raises 5600 to 8400
jcarlos.vale: raises 34277 to 42677 and is all-in
Ajax2530: folds 
Ermuun_34b: folds 
Matzen10: folds 
dsg888: folds 
giourkas_h: folds 
dim@n.89liza: calls 34277
*** FLOP *** [7h Th Kc]
*** TURN *** [7h Th Kc] [7d]
*** RIVER *** [7h Th Kc 7d] [2h]
*** SHOW DOWN ***
dim@n.89liza: shows [Ah Qc] (a pair of Sevens)
jcarlos.vale: shows [9s 9c] (two pair, Nines and Sevens)
jcarlos.vale collected 92354 from pot
*** SUMMARY ***
Total pot 92354 | Rake 0 
Board [7h Th Kc 7d 2h]
Seat 1: giourkas_h (big blind) folded before Flop
Seat 2: TRENDLINEOKI folded before Flop (didn't bet)
Seat 3: dim@n.89liza showed [Ah Qc] and lost with a pair of Sevens
Seat 4: jcarlos.vale showed [9s 9c] and won (92354) with two pair, Nines and Sevens
Seat 6: Ajax2530 folded before Flop (didn't bet)
Seat 7: Ermuun_34b folded before Flop (didn't bet)
Seat 8: Matzen10 (button) folded before Flop (didn't bet)
Seat 9: dsg888 (small blind) folded before Flop



PokerStars Hand #221909752639: Tournament #3082657132, $0.98+$0.12 USD Hold'em No Limit - Level XXIV (1400/2800) - 2020/12/27 20:34:48 EET [2020/12/27 13:34:48 ET]
Table '3082657132 62' 9-max Seat #9 is the button
Seat 1: giourkas_h (113324 in chips) 
Seat 2: TRENDLINEOKI (107711 in chips) 
Seat 3: dim@n.89liza (135970 in chips) 
Seat 4: jcarlos.vale (92354 in chips) 
Seat 6: Ajax2530 (40476 in chips) 
Seat 7: Ermuun_34b (83075 in chips) 
Seat 8: Matzen10 (122855 in chips) 
Seat 9: dsg888 (71528 in chips) 
giourkas_h: posts the ante 350
TRENDLINEOKI: posts the ante 350
dim@n.89liza: posts the ante 350
jcarlos.vale: posts the ante 350
Ajax2530: posts the ante 350
Ermuun_34b: posts the ante 350
Matzen10: posts the ante 350
dsg888: posts the ante 350
giourkas_h: posts small blind 1400
TRENDLINEOKI: posts big blind 2800
*** HOLE CARDS ***
Dealt to jcarlos.vale [Tc Jd]
dim@n.89liza: folds 
jcarlos.vale: folds 
Ajax2530: folds 
Ermuun_34b: folds 
Matzen10: folds 
dsg888: folds 
giourkas_h: folds 
Uncalled bet (1400) returned to TRENDLINEOKI
TRENDLINEOKI collected 5600 from pot
TRENDLINEOKI: doesn't show handDTO
*** SUMMARY ***
Total pot 5600 | Rake 0 
Seat 1: giourkas_h (small blind) folded before Flop
Seat 2: TRENDLINEOKI (big blind) collected (5600)
Seat 3: dim@n.89liza folded before Flop (didn't bet)
Seat 4: jcarlos.vale folded before Flop (didn't bet)
Seat 6: Ajax2530 folded before Flop (didn't bet)
Seat 7: Ermuun_34b folded before Flop (didn't bet)
Seat 8: Matzen10 folded before Flop (didn't bet)
Seat 9: dsg888 (button) folded before Flop (didn't bet)



PokerStars Hand #221909768789: Tournament #3082657132, $0.98+$0.12 USD Hold'em No Limit - Level XXIV (1400/2800) - 2020/12/27 20:35:06 EET [2020/12/27 13:35:06 ET]
Table '3082657132 62' 9-max Seat #1 is the button
Seat 1: giourkas_h (111574 in chips) 
Seat 2: TRENDLINEOKI (111561 in chips) 
Seat 3: dim@n.89liza (135620 in chips) 
Seat 4: jcarlos.vale (92004 in chips) 
Seat 6: Ajax2530 (40126 in chips) 
Seat 7: Ermuun_34b (82725 in chips) 
Seat 8: Matzen10 (122505 in chips) 
Seat 9: dsg888 (71178 in chips) 
giourkas_h: posts the ante 350
TRENDLINEOKI: posts the ante 350
dim@n.89liza: posts the ante 350
jcarlos.vale: posts the ante 350
Ajax2530: posts the ante 350
Ermuun_34b: posts the ante 350
Matzen10: posts the ante 350
dsg888: posts the ante 350
TRENDLINEOKI: posts small blind 1400
dim@n.89liza: posts big blind 2800
*** HOLE CARDS ***
Dealt to jcarlos.vale [6s 7c]
jcarlos.vale: folds 
Ajax2530: folds 
Ermuun_34b: folds 
Matzen10: folds 
dsg888: folds 
giourkas_h: raises 9800 to 12600
TRENDLINEOKI: folds 
dim@n.89liza: calls 9800
*** FLOP *** [Ts Qs 7s]
dim@n.89liza: checks 
giourkas_h: bets 18816
dim@n.89liza: folds 
Uncalled bet (18816) returned to giourkas_h
giourkas_h collected 29400 from pot
giourkas_h: doesn't show handDTO
*** SUMMARY ***
Total pot 29400 | Rake 0 
Board [Ts Qs 7s]
Seat 1: giourkas_h (button) collected (29400)
Seat 2: TRENDLINEOKI (small blind) folded before Flop
Seat 3: dim@n.89liza (big blind) folded on the Flop
Seat 4: jcarlos.vale folded before Flop (didn't bet)
Seat 6: Ajax2530 folded before Flop (didn't bet)
Seat 7: Ermuun_34b folded before Flop (didn't bet)
Seat 8: Matzen10 folded before Flop (didn't bet)
Seat 9: dsg888 folded before Flop (didn't bet)



PokerStars Hand #221909810914: Tournament #3082657132, $0.98+$0.12 USD Hold'em No Limit - Level XXIV (1400/2800) - 2020/12/27 20:35:52 EET [2020/12/27 13:35:52 ET]
Table '3082657132 62' 9-max Seat #2 is the button
Seat 1: giourkas_h (128024 in chips) 
Seat 2: TRENDLINEOKI (109811 in chips) 
Seat 3: dim@n.89liza (122670 in chips) 
Seat 4: jcarlos.vale (91654 in chips) 
Seat 6: Ajax2530 (39776 in chips) 
Seat 7: Ermuun_34b (82375 in chips) 
Seat 8: Matzen10 (122155 in chips) 
Seat 9: dsg888 (70828 in chips) 
giourkas_h: posts the ante 350
TRENDLINEOKI: posts the ante 350
dim@n.89liza: posts the ante 350
jcarlos.vale: posts the ante 350
Ajax2530: posts the ante 350
Ermuun_34b: posts the ante 350
Matzen10: posts the ante 350
dsg888: posts the ante 350
dim@n.89liza: posts small blind 1400
jcarlos.vale: posts big blind 2800
*** HOLE CARDS ***
Dealt to jcarlos.vale [3h 9c]
Ajax2530: folds 
Ermuun_34b: folds 
Matzen10: folds 
dsg888: folds 
giourkas_h: folds 
TRENDLINEOKI: folds 
dim@n.89liza: folds 
Uncalled bet (1400) returned to jcarlos.vale
jcarlos.vale collected 5600 from pot
jcarlos.vale: doesn't show handDTO
*** SUMMARY ***
Total pot 5600 | Rake 0 
Seat 1: giourkas_h folded before Flop (didn't bet)
Seat 2: TRENDLINEOKI (button) folded before Flop (didn't bet)
Seat 3: dim@n.89liza (small blind) folded before Flop
Seat 4: jcarlos.vale (big blind) collected (5600)
Seat 6: Ajax2530 folded before Flop (didn't bet)
Seat 7: Ermuun_34b folded before Flop (didn't bet)
Seat 8: Matzen10 folded before Flop (didn't bet)
Seat 9: dsg888 folded before Flop (didn't bet)



PokerStars Hand #221909838048: Tournament #3082657132, $0.98+$0.12 USD Hold'em No Limit - Level XXIV (1400/2800) - 2020/12/27 20:36:21 EET [2020/12/27 13:36:21 ET]
Table '3082657132 62' 9-max Seat #3 is the button
Seat 1: giourkas_h (127674 in chips) 
Seat 2: TRENDLINEOKI (109461 in chips) 
Seat 3: dim@n.89liza (120920 in chips) 
Seat 4: jcarlos.vale (95504 in chips) 
Seat 5: 17michman17 (89888 in chips) 
Seat 6: Ajax2530 (39426 in chips) 
Seat 7: Ermuun_34b (82025 in chips) 
Seat 8: Matzen10 (121805 in chips) 
Seat 9: dsg888 (70478 in chips) 
giourkas_h: posts the ante 350
TRENDLINEOKI: posts the ante 350
dim@n.89liza: posts the ante 350
jcarlos.vale: posts the ante 350
17michman17: posts the ante 350
Ajax2530: posts the ante 350
Ermuun_34b: posts the ante 350
Matzen10: posts the ante 350
dsg888: posts the ante 350
jcarlos.vale: posts small blind 1400
17michman17: posts big blind 2800
*** HOLE CARDS ***
Dealt to jcarlos.vale [Qs Jd]
Ajax2530: raises 36276 to 39076 and is all-in
Ermuun_34b: folds 
Matzen10: folds 
dsg888: folds 
giourkas_h: folds 
TRENDLINEOKI: raises 70035 to 109111 and is all-in
dim@n.89liza: folds 
jcarlos.vale: folds 
17michman17: folds 
Uncalled bet (70035) returned to TRENDLINEOKI
*** FLOP *** [Tc 7h 2c]
*** TURN *** [Tc 7h 2c] [6h]
*** RIVER *** [Tc 7h 2c 6h] [7s]
*** SHOW DOWN ***
Ajax2530: shows [Ac Qh] (a pair of Sevens)
TRENDLINEOKI: shows [Ah Kh] (a pair of Sevens - Ace+King kicker)
TRENDLINEOKI collected 85502 from pot
Ajax2530 finished the tournament in 89th place and received $5.32.
*** SUMMARY ***
Total pot 85502 | Rake 0 
Board [Tc 7h 2c 6h 7s]
Seat 1: giourkas_h folded before Flop (didn't bet)
Seat 2: TRENDLINEOKI showed [Ah Kh] and won (85502) with a pair of Sevens
Seat 3: dim@n.89liza (button) folded before Flop (didn't bet)
Seat 4: jcarlos.vale (small blind) folded before Flop
Seat 5: 17michman17 (big blind) folded before Flop
Seat 6: Ajax2530 showed [Ac Qh] and lost with a pair of Sevens
Seat 7: Ermuun_34b folded before Flop (didn't bet)
Seat 8: Matzen10 folded before Flop (didn't bet)
Seat 9: dsg888 folded before Flop (didn't bet)



PokerStars Hand #221909881558: Tournament #3082657132, $0.98+$0.12 USD Hold'em No Limit - Level XXIV (1400/2800) - 2020/12/27 20:37:09 EET [2020/12/27 13:37:09 ET]
Table '3082657132 62' 9-max Seat #4 is the button
Seat 1: giourkas_h (127324 in chips) 
Seat 2: TRENDLINEOKI (155537 in chips) 
Seat 3: dim@n.89liza (120570 in chips) 
Seat 4: jcarlos.vale (93754 in chips) 
Seat 5: 17michman17 (86738 in chips) 
Seat 7: Ermuun_34b (81675 in chips) 
Seat 8: Matzen10 (121455 in chips) 
Seat 9: dsg888 (70128 in chips) 
giourkas_h: posts the ante 350
TRENDLINEOKI: posts the ante 350
dim@n.89liza: posts the ante 350
jcarlos.vale: posts the ante 350
17michman17: posts the ante 350
Ermuun_34b: posts the ante 350
Matzen10: posts the ante 350
dsg888: posts the ante 350
17michman17: posts small blind 1400
Ermuun_34b: posts big blind 2800
*** HOLE CARDS ***
Dealt to jcarlos.vale [Kc 9c]
Matzen10: folds 
dsg888: folds 
giourkas_h: folds 
TRENDLINEOKI: folds 
dim@n.89liza: raises 4200 to 7000
jcarlos.vale: folds 
17michman17: folds 
Ermuun_34b: folds 
Uncalled bet (4200) returned to dim@n.89liza
dim@n.89liza collected 9800 from pot
dim@n.89liza: doesn't show handDTO
*** SUMMARY ***
Total pot 9800 | Rake 0 
Seat 1: giourkas_h folded before Flop (didn't bet)
Seat 2: TRENDLINEOKI folded before Flop (didn't bet)
Seat 3: dim@n.89liza collected (9800)
Seat 4: jcarlos.vale (button) folded before Flop (didn't bet)
Seat 5: 17michman17 (small blind) folded before Flop
Seat 7: Ermuun_34b (big blind) folded before Flop
Seat 8: Matzen10 folded before Flop (didn't bet)
Seat 9: dsg888 folded before Flop (didn't bet)



PokerStars Hand #221909917690: Tournament #3082657132, $0.98+$0.12 USD Hold'em No Limit - Level XXIV (1400/2800) - 2020/12/27 20:37:48 EET [2020/12/27 13:37:48 ET]
Table '3082657132 62' 9-max Seat #5 is the button
Seat 1: giourkas_h (126974 in chips) 
Seat 2: TRENDLINEOKI (155187 in chips) 
Seat 3: dim@n.89liza (127220 in chips) 
Seat 4: jcarlos.vale (93404 in chips) 
Seat 5: 17michman17 (84988 in chips) 
Seat 7: Ermuun_34b (78525 in chips) 
Seat 8: Matzen10 (121105 in chips) 
Seat 9: dsg888 (69778 in chips) 
giourkas_h: posts the ante 350
TRENDLINEOKI: posts the ante 350
dim@n.89liza: posts the ante 350
jcarlos.vale: posts the ante 350
17michman17: posts the ante 350
Ermuun_34b: posts the ante 350
Matzen10: posts the ante 350
dsg888: posts the ante 350
Ermuun_34b: posts small blind 1400
Matzen10: posts big blind 2800
*** HOLE CARDS ***
Dealt to jcarlos.vale [7h 4h]
dsg888: raises 2800 to 5600
giourkas_h: calls 5600
TRENDLINEOKI: folds 
dim@n.89liza: folds 
jcarlos.vale: folds 
17michman17: raises 79038 to 84638 and is all-in
Ermuun_34b: folds 
Matzen10: folds 
dsg888: folds 
giourkas_h: folds 
Uncalled bet (79038) returned to 17michman17
17michman17 collected 23800 from pot
17michman17: doesn't show handDTO
*** SUMMARY ***
Total pot 23800 | Rake 0 
Seat 1: giourkas_h folded before Flop
Seat 2: TRENDLINEOKI folded before Flop (didn't bet)
Seat 3: dim@n.89liza folded before Flop (didn't bet)
Seat 4: jcarlos.vale folded before Flop (didn't bet)
Seat 5: 17michman17 (button) collected (23800)
Seat 7: Ermuun_34b (small blind) folded before Flop
Seat 8: Matzen10 (big blind) folded before Flop
Seat 9: dsg888 folded before Flop



PokerStars Hand #221909941578: Tournament #3082657132, $0.98+$0.12 USD Hold'em No Limit - Level XXIV (1400/2800) - 2020/12/27 20:38:15 EET [2020/12/27 13:38:15 ET]
Table '3082657132 62' 9-max Seat #7 is the button
Seat 1: giourkas_h (121024 in chips) 
Seat 2: TRENDLINEOKI (154837 in chips) 
Seat 3: dim@n.89liza (126870 in chips) 
Seat 4: jcarlos.vale (93054 in chips) 
Seat 5: 17michman17 (102838 in chips) 
Seat 7: Ermuun_34b (76775 in chips) 
Seat 8: Matzen10 (117955 in chips) 
Seat 9: dsg888 (63828 in chips) 
giourkas_h: posts the ante 350
TRENDLINEOKI: posts the ante 350
dim@n.89liza: posts the ante 350
jcarlos.vale: posts the ante 350
17michman17: posts the ante 350
Ermuun_34b: posts the ante 350
Matzen10: posts the ante 350
dsg888: posts the ante 350
Matzen10: posts small blind 1400
dsg888: posts big blind 2800
*** HOLE CARDS ***
Dealt to jcarlos.vale [5s Th]
giourkas_h: folds 
TRENDLINEOKI: folds 
dim@n.89liza has timed out
dim@n.89liza: folds 
dim@n.89liza is sitting out
dim@n.89liza has returned
jcarlos.vale: folds 
17michman17: folds 
Ermuun_34b: folds 
Matzen10: folds 
Uncalled bet (1400) returned to dsg888
dsg888 collected 5600 from pot
*** SUMMARY ***
Total pot 5600 | Rake 0 
Seat 1: giourkas_h folded before Flop (didn't bet)
Seat 2: TRENDLINEOKI folded before Flop (didn't bet)
Seat 3: dim@n.89liza folded before Flop (didn't bet)
Seat 4: jcarlos.vale folded before Flop (didn't bet)
Seat 5: 17michman17 folded before Flop (didn't bet)
Seat 7: Ermuun_34b (button) folded before Flop (didn't bet)
Seat 8: Matzen10 (small blind) folded before Flop
Seat 9: dsg888 (big blind) collected (5600)



PokerStars Hand #221909964840: Tournament #3082657132, $0.98+$0.12 USD Hold'em No Limit - Level XXIV (1400/2800) - 2020/12/27 20:38:40 EET [2020/12/27 13:38:40 ET]
Table '3082657132 62' 9-max Seat #8 is the button
Seat 1: giourkas_h (120674 in chips) 
Seat 2: TRENDLINEOKI (154487 in chips) 
Seat 3: dim@n.89liza (126520 in chips) 
Seat 4: jcarlos.vale (92704 in chips) 
Seat 5: 17michman17 (102488 in chips) 
Seat 7: Ermuun_34b (76425 in chips) 
Seat 8: Matzen10 (116205 in chips) 
Seat 9: dsg888 (67678 in chips) 
giourkas_h: posts the ante 350
TRENDLINEOKI: posts the ante 350
dim@n.89liza: posts the ante 350
jcarlos.vale: posts the ante 350
17michman17: posts the ante 350
Ermuun_34b: posts the ante 350
Matzen10: posts the ante 350
dsg888: posts the ante 350
dsg888: posts small blind 1400
giourkas_h: posts big blind 2800
*** HOLE CARDS ***
Dealt to jcarlos.vale [2h 7d]
TRENDLINEOKI: folds 
dim@n.89liza: folds 
jcarlos.vale: folds 
17michman17: raises 2800 to 5600
Ermuun_34b: calls 5600
Matzen10: folds 
dsg888: folds 
giourkas_h: folds 
*** FLOP *** [Ks 3h 8c]
17michman17: bets 18200
Ermuun_34b: folds 
Uncalled bet (18200) returned to 17michman17
17michman17 collected 18200 from pot
17michman17: doesn't show handDTO
*** SUMMARY ***
Total pot 18200 | Rake 0 
Board [Ks 3h 8c]
Seat 1: giourkas_h (big blind) folded before Flop
Seat 2: TRENDLINEOKI folded before Flop (didn't bet)
Seat 3: dim@n.89liza folded before Flop (didn't bet)
Seat 4: jcarlos.vale folded before Flop (didn't bet)
Seat 5: 17michman17 collected (18200)
Seat 7: Ermuun_34b folded on the Flop
Seat 8: Matzen10 (button) folded before Flop (didn't bet)
Seat 9: dsg888 (small blind) folded before Flop



PokerStars Hand #221910005325: Tournament #3082657132, $0.98+$0.12 USD Hold'em No Limit - Level XXIV (1400/2800) - 2020/12/27 20:39:24 EET [2020/12/27 13:39:24 ET]
Table '3082657132 62' 9-max Seat #9 is the button
Seat 1: giourkas_h (117524 in chips) 
Seat 2: TRENDLINEOKI (154137 in chips) 
Seat 3: dim@n.89liza (126170 in chips) 
Seat 4: jcarlos.vale (92354 in chips) 
Seat 5: 17michman17 (114738 in chips) 
Seat 7: Ermuun_34b (70475 in chips) 
Seat 8: Matzen10 (115855 in chips) 
Seat 9: dsg888 (65928 in chips) 
giourkas_h: posts the ante 350
TRENDLINEOKI: posts the ante 350
dim@n.89liza: posts the ante 350
jcarlos.vale: posts the ante 350
17michman17: posts the ante 350
Ermuun_34b: posts the ante 350
Matzen10: posts the ante 350
dsg888: posts the ante 350
giourkas_h: posts small blind 1400
TRENDLINEOKI: posts big blind 2800
*** HOLE CARDS ***
Dealt to jcarlos.vale [Ad Jh]
dim@n.89liza: folds 
jcarlos.vale: raises 4480 to 7280
17michman17: calls 7280
Ermuun_34b: folds 
Matzen10: folds 
dsg888: raises 58298 to 65578 and is all-in
giourkas_h: folds 
TRENDLINEOKI: folds 
jcarlos.vale: folds 
17michman17: folds 
Uncalled bet (58298) returned to dsg888
dsg888 collected 28840 from pot
*** SUMMARY ***
Total pot 28840 | Rake 0 
Seat 1: giourkas_h (small blind) folded before Flop
Seat 2: TRENDLINEOKI (big blind) folded before Flop
Seat 3: dim@n.89liza folded before Flop (didn't bet)
Seat 4: jcarlos.vale folded before Flop
Seat 5: 17michman17 folded before Flop
Seat 7: Ermuun_34b folded before Flop (didn't bet)
Seat 8: Matzen10 folded before Flop (didn't bet)
Seat 9: dsg888 (button) collected (28840)



PokerStars Hand #221910042352: Tournament #3082657132, $0.98+$0.12 USD Hold'em No Limit - Level XXIV (1400/2800) - 2020/12/27 20:40:04 EET [2020/12/27 13:40:04 ET]
Table '3082657132 62' 9-max Seat #1 is the button
Seat 1: giourkas_h (115774 in chips) 
Seat 2: TRENDLINEOKI (150987 in chips) 
Seat 3: dim@n.89liza (125820 in chips) 
Seat 4: jcarlos.vale (84724 in chips) 
Seat 5: 17michman17 (107108 in chips) 
Seat 7: Ermuun_34b (70125 in chips) 
Seat 8: Matzen10 (115505 in chips) 
Seat 9: dsg888 (87138 in chips) 
giourkas_h: posts the ante 350
TRENDLINEOKI: posts the ante 350
dim@n.89liza: posts the ante 350
jcarlos.vale: posts the ante 350
17michman17: posts the ante 350
Ermuun_34b: posts the ante 350
Matzen10: posts the ante 350
dsg888: posts the ante 350
TRENDLINEOKI: posts small blind 1400
dim@n.89liza: posts big blind 2800
*** HOLE CARDS ***
Dealt to jcarlos.vale [Tc 9d]
jcarlos.vale: folds 
17michman17: folds 
Ermuun_34b: folds 
Matzen10: folds 
dsg888: folds 
giourkas_h: raises 9800 to 12600
TRENDLINEOKI: folds 
dim@n.89liza: folds 
Uncalled bet (9800) returned to giourkas_h
giourkas_h collected 9800 from pot
giourkas_h: doesn't show handDTO
*** SUMMARY ***
Total pot 9800 | Rake 0 
Seat 1: giourkas_h (button) collected (9800)
Seat 2: TRENDLINEOKI (small blind) folded before Flop
Seat 3: dim@n.89liza (big blind) folded before Flop
Seat 4: jcarlos.vale folded before Flop (didn't bet)
Seat 5: 17michman17 folded before Flop (didn't bet)
Seat 7: Ermuun_34b folded before Flop (didn't bet)
Seat 8: Matzen10 folded before Flop (didn't bet)
Seat 9: dsg888 folded before Flop (didn't bet)



PokerStars Hand #221910068117: Tournament #3082657132, $0.98+$0.12 USD Hold'em No Limit - Level XXIV (1400/2800) - 2020/12/27 20:40:33 EET [2020/12/27 13:40:33 ET]
Table '3082657132 62' 9-max Seat #2 is the button
Seat 1: giourkas_h (122424 in chips) 
Seat 2: TRENDLINEOKI (149237 in chips) 
Seat 3: dim@n.89liza (122670 in chips) 
Seat 4: jcarlos.vale (84374 in chips) 
Seat 5: 17michman17 (106758 in chips) 
Seat 7: Ermuun_34b (69775 in chips) 
Seat 8: Matzen10 (115155 in chips) 
Seat 9: dsg888 (86788 in chips) 
giourkas_h: posts the ante 350
TRENDLINEOKI: posts the ante 350
dim@n.89liza: posts the ante 350
jcarlos.vale: posts the ante 350
17michman17: posts the ante 350
Ermuun_34b: posts the ante 350
Matzen10: posts the ante 350
dsg888: posts the ante 350
dim@n.89liza: posts small blind 1400
jcarlos.vale: posts big blind 2800
*** HOLE CARDS ***
Dealt to jcarlos.vale [5c 9d]
17michman17 has timed out
17michman17: folds 
17michman17 is sitting out
17michman17 has returned
Ermuun_34b: calls 2800
Matzen10: folds 
dsg888: folds 
giourkas_h: folds 
TRENDLINEOKI: folds 
dim@n.89liza: raises 119520 to 122320 and is all-in
jcarlos.vale: folds 
Ermuun_34b: folds 
Uncalled bet (119520) returned to dim@n.89liza
dim@n.89liza collected 11200 from pot
dim@n.89liza: doesn't show handDTO
*** SUMMARY ***
Total pot 11200 | Rake 0 
Seat 1: giourkas_h folded before Flop (didn't bet)
Seat 2: TRENDLINEOKI (button) folded before Flop (didn't bet)
Seat 3: dim@n.89liza (small blind) collected (11200)
Seat 4: jcarlos.vale (big blind) folded before Flop
Seat 5: 17michman17 folded before Flop (didn't bet)
Seat 7: Ermuun_34b folded before Flop
Seat 8: Matzen10 folded before Flop (didn't bet)
Seat 9: dsg888 folded before Flop (didn't bet)



PokerStars Hand #221910097142: Tournament #3082657132, $0.98+$0.12 USD Hold'em No Limit - Level XXIV (1400/2800) - 2020/12/27 20:41:05 EET [2020/12/27 13:41:05 ET]
Table '3082657132 62' 9-max Seat #3 is the button
Seat 1: giourkas_h (122074 in chips) 
Seat 2: TRENDLINEOKI (148887 in chips) 
Seat 3: dim@n.89liza (130720 in chips) 
Seat 4: jcarlos.vale (81224 in chips) 
Seat 5: 17michman17 (106408 in chips) 
Seat 7: Ermuun_34b (66625 in chips) 
Seat 8: Matzen10 (114805 in chips) 
Seat 9: dsg888 (86438 in chips) 
giourkas_h: posts the ante 350
TRENDLINEOKI: posts the ante 350
dim@n.89liza: posts the ante 350
jcarlos.vale: posts the ante 350
17michman17: posts the ante 350
Ermuun_34b: posts the ante 350
Matzen10: posts the ante 350
dsg888: posts the ante 350
jcarlos.vale: posts small blind 1400
17michman17: posts big blind 2800
*** HOLE CARDS ***
Dealt to jcarlos.vale [As 8d]
Ermuun_34b: folds 
Matzen10: folds 
dsg888: folds 
giourkas_h: folds 
TRENDLINEOKI: raises 3360 to 6160
dim@n.89liza: raises 16240 to 22400
jcarlos.vale: folds 
17michman17: folds 
TRENDLINEOKI: folds 
Uncalled bet (16240) returned to dim@n.89liza
dim@n.89liza collected 19320 from pot
dim@n.89liza: doesn't show handDTO
*** SUMMARY ***
Total pot 19320 | Rake 0 
Seat 1: giourkas_h folded before Flop (didn't bet)
Seat 2: TRENDLINEOKI folded before Flop
Seat 3: dim@n.89liza (button) collected (19320)
Seat 4: jcarlos.vale (small blind) folded before Flop
Seat 5: 17michman17 (big blind) folded before Flop
Seat 7: Ermuun_34b folded before Flop (didn't bet)
Seat 8: Matzen10 folded before Flop (didn't bet)
Seat 9: dsg888 folded before Flop (didn't bet)



PokerStars Hand #221910134509: Tournament #3082657132, $0.98+$0.12 USD Hold'em No Limit - Level XXV (1600/3200) - 2020/12/27 20:41:45 EET [2020/12/27 13:41:45 ET]
Table '3082657132 62' 9-max Seat #4 is the button
Seat 1: giourkas_h (121724 in chips) 
Seat 2: TRENDLINEOKI (142377 in chips) 
Seat 3: dim@n.89liza (143530 in chips) 
Seat 4: jcarlos.vale (79474 in chips) 
Seat 5: 17michman17 (103258 in chips) 
Seat 7: Ermuun_34b (66275 in chips) 
Seat 8: Matzen10 (114455 in chips) 
Seat 9: dsg888 (86088 in chips) 
giourkas_h: posts the ante 400
TRENDLINEOKI: posts the ante 400
dim@n.89liza: posts the ante 400
jcarlos.vale: posts the ante 400
17michman17: posts the ante 400
Ermuun_34b: posts the ante 400
Matzen10: posts the ante 400
dsg888: posts the ante 400
17michman17: posts small blind 1600
Ermuun_34b: posts big blind 3200
*** HOLE CARDS ***
Dealt to jcarlos.vale [4d Qh]
Matzen10: raises 3200 to 6400
dsg888: folds 
giourkas_h: calls 6400
TRENDLINEOKI: folds 
dim@n.89liza: folds 
jcarlos.vale: folds 
17michman17: calls 4800
Ermuun_34b: folds 
*** FLOP *** [2h 9h 5c]
17michman17: checks 
Matzen10: bets 14080
giourkas_h: folds 
17michman17: folds 
Uncalled bet (14080) returned to Matzen10
Matzen10 collected 25600 from pot
Matzen10: doesn't show handDTO
*** SUMMARY ***
Total pot 25600 | Rake 0 
Board [2h 9h 5c]
Seat 1: giourkas_h folded on the Flop
Seat 2: TRENDLINEOKI folded before Flop (didn't bet)
Seat 3: dim@n.89liza folded before Flop (didn't bet)
Seat 4: jcarlos.vale (button) folded before Flop (didn't bet)
Seat 5: 17michman17 (small blind) folded on the Flop
Seat 7: Ermuun_34b (big blind) folded before Flop
Seat 8: Matzen10 collected (25600)
Seat 9: dsg888 folded before Flop (didn't bet)



PokerStars Hand #221910175343: Tournament #3082657132, $0.98+$0.12 USD Hold'em No Limit - Level XXV (1600/3200) - 2020/12/27 20:42:30 EET [2020/12/27 13:42:30 ET]
Table '3082657132 62' 9-max Seat #5 is the button
Seat 1: giourkas_h (114924 in chips) 
Seat 2: TRENDLINEOKI (141977 in chips) 
Seat 3: dim@n.89liza (143130 in chips) 
Seat 4: jcarlos.vale (79074 in chips) 
Seat 5: 17michman17 (96458 in chips) 
Seat 7: Ermuun_34b (62675 in chips) 
Seat 8: Matzen10 (133255 in chips) 
Seat 9: dsg888 (85688 in chips) 
giourkas_h: posts the ante 400
TRENDLINEOKI: posts the ante 400
dim@n.89liza: posts the ante 400
jcarlos.vale: posts the ante 400
17michman17: posts the ante 400
Ermuun_34b: posts the ante 400
Matzen10: posts the ante 400
dsg888: posts the ante 400
Ermuun_34b: posts small blind 1600
Matzen10: posts big blind 3200
*** HOLE CARDS ***
Dealt to jcarlos.vale [4s Jd]
dsg888: folds 
giourkas_h: raises 11200 to 14400
TRENDLINEOKI: folds 
dim@n.89liza: folds 
jcarlos.vale: folds 
17michman17: folds 
Ermuun_34b: folds 
Matzen10: folds 
Uncalled bet (11200) returned to giourkas_h
giourkas_h collected 11200 from pot
giourkas_h: doesn't show handDTO
*** SUMMARY ***
Total pot 11200 | Rake 0 
Seat 1: giourkas_h collected (11200)
Seat 2: TRENDLINEOKI folded before Flop (didn't bet)
Seat 3: dim@n.89liza folded before Flop (didn't bet)
Seat 4: jcarlos.vale folded before Flop (didn't bet)
Seat 5: 17michman17 (button) folded before Flop (didn't bet)
Seat 7: Ermuun_34b (small blind) folded before Flop
Seat 8: Matzen10 (big blind) folded before Flop
Seat 9: dsg888 folded before Flop (didn't bet)



PokerStars Hand #221910194817: Tournament #3082657132, $0.98+$0.12 USD Hold'em No Limit - Level XXV (1600/3200) - 2020/12/27 20:42:51 EET [2020/12/27 13:42:51 ET]
Table '3082657132 62' 9-max Seat #7 is the button
Seat 1: giourkas_h (122524 in chips) 
Seat 2: TRENDLINEOKI (141577 in chips) 
Seat 3: dim@n.89liza (142730 in chips) 
Seat 4: jcarlos.vale (78674 in chips) 
Seat 5: 17michman17 (96058 in chips) 
Seat 7: Ermuun_34b (60675 in chips) 
Seat 8: Matzen10 (129655 in chips) 
Seat 9: dsg888 (85288 in chips) 
giourkas_h: posts the ante 400
TRENDLINEOKI: posts the ante 400
dim@n.89liza: posts the ante 400
jcarlos.vale: posts the ante 400
17michman17: posts the ante 400
Ermuun_34b: posts the ante 400
Matzen10: posts the ante 400
dsg888: posts the ante 400
Matzen10: posts small blind 1600
dsg888: posts big blind 3200
*** HOLE CARDS ***
Dealt to jcarlos.vale [8h 5h]
giourkas_h: folds 
TRENDLINEOKI: folds 
dim@n.89liza: folds 
jcarlos.vale: folds 
17michman17: folds 
Ermuun_34b: folds 
Matzen10: calls 1600
dsg888: raises 6400 to 9600
Matzen10: folds 
Uncalled bet (6400) returned to dsg888
dsg888 collected 9600 from pot
*** SUMMARY ***
Total pot 9600 | Rake 0 
Seat 1: giourkas_h folded before Flop (didn't bet)
Seat 2: TRENDLINEOKI folded before Flop (didn't bet)
Seat 3: dim@n.89liza folded before Flop (didn't bet)
Seat 4: jcarlos.vale folded before Flop (didn't bet)
Seat 5: 17michman17 folded before Flop (didn't bet)
Seat 7: Ermuun_34b (button) folded before Flop (didn't bet)
Seat 8: Matzen10 (small blind) folded before Flop
Seat 9: dsg888 (big blind) collected (9600)



PokerStars Hand #221910232310: Tournament #3082657132, $0.98+$0.12 USD Hold'em No Limit - Level XXV (1600/3200) - 2020/12/27 20:43:25 EET [2020/12/27 13:43:25 ET]
Table '3082657132 62' 9-max Seat #8 is the button
Seat 1: giourkas_h (122124 in chips) 
Seat 2: TRENDLINEOKI (141177 in chips) 
Seat 3: dim@n.89liza (142330 in chips) 
Seat 4: jcarlos.vale (78274 in chips) 
Seat 5: 17michman17 (95658 in chips) 
Seat 7: Ermuun_34b (60275 in chips) 
Seat 8: Matzen10 (126055 in chips) 
Seat 9: dsg888 (91288 in chips) 
giourkas_h: posts the ante 400
TRENDLINEOKI: posts the ante 400
dim@n.89liza: posts the ante 400
jcarlos.vale: posts the ante 400
17michman17: posts the ante 400
Ermuun_34b: posts the ante 400
Matzen10: posts the ante 400
dsg888: posts the ante 400
dsg888: posts small blind 1600
giourkas_h: posts big blind 3200
*** HOLE CARDS ***
Dealt to jcarlos.vale [7s 7d]
TRENDLINEOKI: folds 
dim@n.89liza: folds 
jcarlos.vale: raises 5120 to 8320
17michman17: folds 
Ermuun_34b: folds 
Matzen10: folds 
dsg888: folds 
giourkas_h: folds 
Uncalled bet (5120) returned to jcarlos.vale
jcarlos.vale collected 11200 from pot
jcarlos.vale: doesn't show handDTO
*** SUMMARY ***
Total pot 11200 | Rake 0 
Seat 1: giourkas_h (big blind) folded before Flop
Seat 2: TRENDLINEOKI folded before Flop (didn't bet)
Seat 3: dim@n.89liza folded before Flop (didn't bet)
Seat 4: jcarlos.vale collected (11200)
Seat 5: 17michman17 folded before Flop (didn't bet)
Seat 7: Ermuun_34b folded before Flop (didn't bet)
Seat 8: Matzen10 (button) folded before Flop (didn't bet)
Seat 9: dsg888 (small blind) folded before Flop



PokerStars Hand #221910245902: Tournament #3082657132, $0.98+$0.12 USD Hold'em No Limit - Level XXV (1600/3200) - 2020/12/27 20:43:40 EET [2020/12/27 13:43:40 ET]
Table '3082657132 62' 9-max Seat #9 is the button
Seat 1: giourkas_h (118524 in chips) 
Seat 2: TRENDLINEOKI (140777 in chips) 
Seat 3: dim@n.89liza (141930 in chips) 
Seat 4: jcarlos.vale (85874 in chips) 
Seat 5: 17michman17 (95258 in chips) 
Seat 6: Svetalina (107171 in chips) 
Seat 7: Ermuun_34b (59875 in chips) 
Seat 8: Matzen10 (125655 in chips) 
Seat 9: dsg888 (89288 in chips) 
giourkas_h: posts the ante 400
TRENDLINEOKI: posts the ante 400
dim@n.89liza: posts the ante 400
jcarlos.vale: posts the ante 400
17michman17: posts the ante 400
Svetalina: posts the ante 400
Ermuun_34b: posts the ante 400
Matzen10: posts the ante 400
dsg888: posts the ante 400
giourkas_h: posts small blind 1600
TRENDLINEOKI: posts big blind 3200
*** HOLE CARDS ***
Dealt to jcarlos.vale [Td Jc]
dim@n.89liza: folds 
jcarlos.vale: folds 
17michman17: folds 
Svetalina: folds 
Ermuun_34b: folds 
Matzen10: raises 3200 to 6400
dsg888: folds 
giourkas_h: folds 
TRENDLINEOKI: folds 
Uncalled bet (3200) returned to Matzen10
Matzen10 collected 11600 from pot
Matzen10: doesn't show handDTO
*** SUMMARY ***
Total pot 11600 | Rake 0 
Seat 1: giourkas_h (small blind) folded before Flop
Seat 2: TRENDLINEOKI (big blind) folded before Flop
Seat 3: dim@n.89liza folded before Flop (didn't bet)
Seat 4: jcarlos.vale folded before Flop (didn't bet)
Seat 5: 17michman17 folded before Flop (didn't bet)
Seat 6: Svetalina folded before Flop (didn't bet)
Seat 7: Ermuun_34b folded before Flop (didn't bet)
Seat 8: Matzen10 collected (11600)
Seat 9: dsg888 (button) folded before Flop (didn't bet)



PokerStars Hand #221910268441: Tournament #3082657132, $0.98+$0.12 USD Hold'em No Limit - Level XXV (1600/3200) - 2020/12/27 20:44:05 EET [2020/12/27 13:44:05 ET]
Table '3082657132 62' 9-max Seat #1 is the button
Seat 1: giourkas_h (116524 in chips) 
Seat 2: TRENDLINEOKI (137177 in chips) 
Seat 3: dim@n.89liza (141530 in chips) 
Seat 4: jcarlos.vale (85474 in chips) 
Seat 5: 17michman17 (94858 in chips) 
Seat 6: Svetalina (106771 in chips) 
Seat 7: Ermuun_34b (59475 in chips) 
Seat 8: Matzen10 (133655 in chips) 
Seat 9: dsg888 (88888 in chips) 
giourkas_h: posts the ante 400
TRENDLINEOKI: posts the ante 400
dim@n.89liza: posts the ante 400
jcarlos.vale: posts the ante 400
17michman17: posts the ante 400
Svetalina: posts the ante 400
Ermuun_34b: posts the ante 400
Matzen10: posts the ante 400
dsg888: posts the ante 400
TRENDLINEOKI: posts small blind 1600
dim@n.89liza: posts big blind 3200
*** HOLE CARDS ***
Dealt to jcarlos.vale [8d Jh]
jcarlos.vale: folds 
17michman17: folds 
Svetalina: raises 3520 to 6720
Ermuun_34b: folds 
Matzen10: folds 
dsg888: folds 
giourkas_h: folds 
TRENDLINEOKI: folds 
dim@n.89liza: calls 3520
*** FLOP *** [5c 7d Kc]
dim@n.89liza: checks 
Svetalina: bets 4800
dim@n.89liza: raises 16000 to 20800
Svetalina: folds 
Uncalled bet (16000) returned to dim@n.89liza
dim@n.89liza collected 28240 from pot
dim@n.89liza: doesn't show handDTO
*** SUMMARY ***
Total pot 28240 | Rake 0 
Board [5c 7d Kc]
Seat 1: giourkas_h (button) folded before Flop (didn't bet)
Seat 2: TRENDLINEOKI (small blind) folded before Flop
Seat 3: dim@n.89liza (big blind) collected (28240)
Seat 4: jcarlos.vale folded before Flop (didn't bet)
Seat 5: 17michman17 folded before Flop (didn't bet)
Seat 6: Svetalina folded on the Flop
Seat 7: Ermuun_34b folded before Flop (didn't bet)
Seat 8: Matzen10 folded before Flop (didn't bet)
Seat 9: dsg888 folded before Flop (didn't bet)



PokerStars Hand #221910307434: Tournament #3082657132, $0.98+$0.12 USD Hold'em No Limit - Level XXV (1600/3200) - 2020/12/27 20:44:48 EET [2020/12/27 13:44:48 ET]
Table '3082657132 62' 9-max Seat #2 is the button
Seat 1: giourkas_h (116124 in chips) 
Seat 2: TRENDLINEOKI (135177 in chips) 
Seat 3: dim@n.89liza (157850 in chips) 
Seat 4: jcarlos.vale (85074 in chips) 
Seat 5: 17michman17 (94458 in chips) 
Seat 6: Svetalina (94851 in chips) 
Seat 7: Ermuun_34b (59075 in chips) 
Seat 8: Matzen10 (133255 in chips) 
Seat 9: dsg888 (88488 in chips) 
giourkas_h: posts the ante 400
TRENDLINEOKI: posts the ante 400
dim@n.89liza: posts the ante 400
jcarlos.vale: posts the ante 400
17michman17: posts the ante 400
Svetalina: posts the ante 400
Ermuun_34b: posts the ante 400
Matzen10: posts the ante 400
dsg888: posts the ante 400
dim@n.89liza: posts small blind 1600
jcarlos.vale: posts big blind 3200
*** HOLE CARDS ***
Dealt to jcarlos.vale [Qd 8h]
17michman17: folds 
Svetalina: folds 
Ermuun_34b: folds 
Matzen10: folds 
dsg888: folds 
giourkas_h: folds 
TRENDLINEOKI: raises 3840 to 7040
dim@n.89liza: folds 
jcarlos.vale: folds 
Uncalled bet (3840) returned to TRENDLINEOKI
TRENDLINEOKI collected 11600 from pot
TRENDLINEOKI: doesn't show handDTO
*** SUMMARY ***
Total pot 11600 | Rake 0 
Seat 1: giourkas_h folded before Flop (didn't bet)
Seat 2: TRENDLINEOKI (button) collected (11600)
Seat 3: dim@n.89liza (small blind) folded before Flop
Seat 4: jcarlos.vale (big blind) folded before Flop
Seat 5: 17michman17 folded before Flop (didn't bet)
Seat 6: Svetalina folded before Flop (didn't bet)
Seat 7: Ermuun_34b folded before Flop (didn't bet)
Seat 8: Matzen10 folded before Flop (didn't bet)
Seat 9: dsg888 folded before Flop (didn't bet)



PokerStars Hand #221910329635: Tournament #3082657132, $0.98+$0.12 USD Hold'em No Limit - Level XXV (1600/3200) - 2020/12/27 20:45:12 EET [2020/12/27 13:45:12 ET]
Table '3082657132 62' 9-max Seat #3 is the button
Seat 1: giourkas_h (115724 in chips) 
Seat 2: TRENDLINEOKI (143177 in chips) 
Seat 3: dim@n.89liza (155850 in chips) 
Seat 4: jcarlos.vale (81474 in chips) 
Seat 5: 17michman17 (94058 in chips) 
Seat 6: Svetalina (94451 in chips) 
Seat 7: Ermuun_34b (58675 in chips) 
Seat 8: Matzen10 (132855 in chips) 
Seat 9: dsg888 (88088 in chips) 
giourkas_h: posts the ante 400
TRENDLINEOKI: posts the ante 400
dim@n.89liza: posts the ante 400
jcarlos.vale: posts the ante 400
17michman17: posts the ante 400
Svetalina: posts the ante 400
Ermuun_34b: posts the ante 400
Matzen10: posts the ante 400
dsg888: posts the ante 400
jcarlos.vale: posts small blind 1600
17michman17: posts big blind 3200
*** HOLE CARDS ***
Dealt to jcarlos.vale [Qc Jh]
Svetalina: folds 
Ermuun_34b: folds 
Matzen10: folds 
dsg888: folds 
giourkas_h: folds 
TRENDLINEOKI: folds 
dim@n.89liza: raises 4800 to 8000
jcarlos.vale: raises 73074 to 81074 and is all-in
17michman17: folds 
dim@n.89liza: folds 
Uncalled bet (73074) returned to jcarlos.vale
jcarlos.vale collected 22800 from pot
jcarlos.vale: doesn't show handDTO
*** SUMMARY ***
Total pot 22800 | Rake 0 
Seat 1: giourkas_h folded before Flop (didn't bet)
Seat 2: TRENDLINEOKI folded before Flop (didn't bet)
Seat 3: dim@n.89liza (button) folded before Flop
Seat 4: jcarlos.vale (small blind) collected (22800)
Seat 5: 17michman17 (big blind) folded before Flop
Seat 6: Svetalina folded before Flop (didn't bet)
Seat 7: Ermuun_34b folded before Flop (didn't bet)
Seat 8: Matzen10 folded before Flop (didn't bet)
Seat 9: dsg888 folded before Flop (didn't bet)



PokerStars Hand #221910359176: Tournament #3082657132, $0.98+$0.12 USD Hold'em No Limit - Level XXV (1600/3200) - 2020/12/27 20:45:45 EET [2020/12/27 13:45:45 ET]
Table '3082657132 62' 9-max Seat #4 is the button
Seat 1: giourkas_h (115324 in chips) 
Seat 2: TRENDLINEOKI (142777 in chips) 
Seat 3: dim@n.89liza (147450 in chips) 
Seat 4: jcarlos.vale (95874 in chips) 
Seat 5: 17michman17 (90458 in chips) 
Seat 6: Svetalina (94051 in chips) 
Seat 7: Ermuun_34b (58275 in chips) 
Seat 8: Matzen10 (132455 in chips) 
Seat 9: dsg888 (87688 in chips) 
giourkas_h: posts the ante 400
TRENDLINEOKI: posts the ante 400
dim@n.89liza: posts the ante 400
jcarlos.vale: posts the ante 400
17michman17: posts the ante 400
Svetalina: posts the ante 400
Ermuun_34b: posts the ante 400
Matzen10: posts the ante 400
dsg888: posts the ante 400
17michman17: posts small blind 1600
Svetalina: posts big blind 3200
*** HOLE CARDS ***
Dealt to jcarlos.vale [3s 6c]
Ermuun_34b: folds 
Matzen10: folds 
dsg888: folds 
giourkas_h: folds 
TRENDLINEOKI: folds 
dim@n.89liza: raises 3200 to 6400
jcarlos.vale: folds 
17michman17: calls 4800
Svetalina: calls 3200
*** FLOP *** [Ah 6d Jh]
17michman17: checks 
Svetalina: checks 
dim@n.89liza: checks 
*** TURN *** [Ah 6d Jh] [2h]
17michman17: bets 6400
Svetalina: raises 17600 to 24000
dim@n.89liza: folds 
17michman17: folds 
Uncalled bet (17600) returned to Svetalina
Svetalina collected 35600 from pot
*** SUMMARY ***
Total pot 35600 | Rake 0 
Board [Ah 6d Jh 2h]
Seat 1: giourkas_h folded before Flop (didn't bet)
Seat 2: TRENDLINEOKI folded before Flop (didn't bet)
Seat 3: dim@n.89liza folded on the Turn
Seat 4: jcarlos.vale (button) folded before Flop (didn't bet)
Seat 5: 17michman17 (small blind) folded on the Turn
Seat 6: Svetalina (big blind) collected (35600)
Seat 7: Ermuun_34b folded before Flop (didn't bet)
Seat 8: Matzen10 folded before Flop (didn't bet)
Seat 9: dsg888 folded before Flop (didn't bet)



PokerStars Hand #221910423691: Tournament #3082657132, $0.98+$0.12 USD Hold'em No Limit - Level XXV (1600/3200) - 2020/12/27 20:46:57 EET [2020/12/27 13:46:57 ET]
Table '3082657132 62' 9-max Seat #5 is the button
Seat 1: giourkas_h (114924 in chips) 
Seat 2: TRENDLINEOKI (142377 in chips) 
Seat 3: dim@n.89liza (140650 in chips) 
Seat 4: jcarlos.vale (95474 in chips) 
Seat 5: 17michman17 (77258 in chips) 
Seat 6: Svetalina (116451 in chips) 
Seat 7: Ermuun_34b (57875 in chips) 
Seat 8: Matzen10 (132055 in chips) 
Seat 9: dsg888 (87288 in chips) 
giourkas_h: posts the ante 400
TRENDLINEOKI: posts the ante 400
dim@n.89liza: posts the ante 400
jcarlos.vale: posts the ante 400
17michman17: posts the ante 400
Svetalina: posts the ante 400
Ermuun_34b: posts the ante 400
Matzen10: posts the ante 400
dsg888: posts the ante 400
Svetalina: posts small blind 1600
Ermuun_34b: posts big blind 3200
*** HOLE CARDS ***
Dealt to jcarlos.vale [9s Jh]
Matzen10: folds 
dsg888: folds 
giourkas_h: folds 
TRENDLINEOKI: calls 3200
dim@n.89liza: raises 9600 to 12800
jcarlos.vale: folds 
17michman17: raises 64058 to 76858 and is all-in
Svetalina: folds 
Ermuun_34b: folds 
TRENDLINEOKI: folds 
dim@n.89liza: folds 
Uncalled bet (64058) returned to 17michman17
17michman17 collected 37200 from pot
17michman17: doesn't show handDTO
*** SUMMARY ***
Total pot 37200 | Rake 0 
Seat 1: giourkas_h folded before Flop (didn't bet)
Seat 2: TRENDLINEOKI folded before Flop
Seat 3: dim@n.89liza folded before Flop
Seat 4: jcarlos.vale folded before Flop (didn't bet)
Seat 5: 17michman17 (button) collected (37200)
Seat 6: Svetalina (small blind) folded before Flop
Seat 7: Ermuun_34b (big blind) folded before Flop
Seat 8: Matzen10 folded before Flop (didn't bet)
Seat 9: dsg888 folded before Flop (didn't bet)



PokerStars Hand #221910454389: Tournament #3082657132, $0.98+$0.12 USD Hold'em No Limit - Level XXV (1600/3200) - 2020/12/27 20:47:31 EET [2020/12/27 13:47:31 ET]
Table '3082657132 62' 9-max Seat #6 is the button
Seat 1: giourkas_h (114524 in chips) 
Seat 2: TRENDLINEOKI (138777 in chips) 
Seat 3: dim@n.89liza (127450 in chips) 
Seat 4: jcarlos.vale (95074 in chips) 
Seat 5: 17michman17 (101258 in chips) 
Seat 6: Svetalina (114451 in chips) 
Seat 8: Matzen10 (131655 in chips) 
Seat 9: dsg888 (86888 in chips) 
giourkas_h: posts the ante 400
TRENDLINEOKI: posts the ante 400
dim@n.89liza: posts the ante 400
jcarlos.vale: posts the ante 400
17michman17: posts the ante 400
Svetalina: posts the ante 400
Matzen10: posts the ante 400
dsg888: posts the ante 400
Matzen10: posts small blind 1600
dsg888: posts big blind 3200
*** HOLE CARDS ***
Dealt to jcarlos.vale [9s Jc]
giourkas_h: folds 
TRENDLINEOKI: folds 
dim@n.89liza: raises 6400 to 9600
jcarlos.vale: folds 
17michman17: calls 9600
Svetalina: folds 
Matzen10: folds 
dsg888: folds 
*** FLOP *** [Ks 6h 6c]
dim@n.89liza: bets 12800
17michman17: folds 
Uncalled bet (12800) returned to dim@n.89liza
dim@n.89liza collected 27200 from pot
dim@n.89liza: doesn't show handDTO
*** SUMMARY ***
Total pot 27200 | Rake 0 
Board [Ks 6h 6c]
Seat 1: giourkas_h folded before Flop (didn't bet)
Seat 2: TRENDLINEOKI folded before Flop (didn't bet)
Seat 3: dim@n.89liza collected (27200)
Seat 4: jcarlos.vale folded before Flop (didn't bet)
Seat 5: 17michman17 folded on the Flop
Seat 6: Svetalina (button) folded before Flop (didn't bet)
Seat 8: Matzen10 (small blind) folded before Flop
Seat 9: dsg888 (big blind) folded before Flop



PokerStars Hand #221910492242: Tournament #3082657132, $0.98+$0.12 USD Hold'em No Limit - Level XXV (1600/3200) - 2020/12/27 20:48:13 EET [2020/12/27 13:48:13 ET]
Table '3082657132 62' 9-max Seat #8 is the button
Seat 1: giourkas_h (114124 in chips) 
Seat 2: TRENDLINEOKI (138377 in chips) 
Seat 3: dim@n.89liza (144650 in chips) 
Seat 4: jcarlos.vale (94674 in chips) 
Seat 5: 17michman17 (91258 in chips) 
Seat 6: Svetalina (114051 in chips) 
Seat 8: Matzen10 (129655 in chips) 
Seat 9: dsg888 (83288 in chips) 
giourkas_h: posts the ante 400
TRENDLINEOKI: posts the ante 400
dim@n.89liza: posts the ante 400
jcarlos.vale: posts the ante 400
17michman17: posts the ante 400
Svetalina: posts the ante 400
Matzen10: posts the ante 400
dsg888: posts the ante 400
dsg888: posts small blind 1600
giourkas_h: posts big blind 3200
*** HOLE CARDS ***
Dealt to jcarlos.vale [Ad 5d]
TRENDLINEOKI: folds 
dim@n.89liza: folds 
jcarlos.vale: raises 5120 to 8320
17michman17: folds 
Svetalina: folds 
Matzen10: folds 
dsg888: raises 74568 to 82888 and is all-in
giourkas_h: folds 
jcarlos.vale: folds 
Uncalled bet (74568) returned to dsg888
dsg888 collected 23040 from pot
*** SUMMARY ***
Total pot 23040 | Rake 0 
Seat 1: giourkas_h (big blind) folded before Flop
Seat 2: TRENDLINEOKI folded before Flop (didn't bet)
Seat 3: dim@n.89liza folded before Flop (didn't bet)
Seat 4: jcarlos.vale folded before Flop
Seat 5: 17michman17 folded before Flop (didn't bet)
Seat 6: Svetalina folded before Flop (didn't bet)
Seat 8: Matzen10 (button) folded before Flop (didn't bet)
Seat 9: dsg888 (small blind) collected (23040)



PokerStars Hand #221910529343: Tournament #3082657132, $0.98+$0.12 USD Hold'em No Limit - Level XXV (1600/3200) - 2020/12/27 20:48:55 EET [2020/12/27 13:48:55 ET]
Table '3082657132 62' 9-max Seat #9 is the button
Seat 1: giourkas_h (110524 in chips) 
Seat 2: TRENDLINEOKI (137977 in chips) 
Seat 3: dim@n.89liza (144250 in chips) 
Seat 4: jcarlos.vale (85954 in chips) 
Seat 5: 17michman17 (90858 in chips) 
Seat 6: Svetalina (113651 in chips) 
Seat 8: Matzen10 (129255 in chips) 
Seat 9: dsg888 (97608 in chips) 
giourkas_h: posts the ante 400
TRENDLINEOKI: posts the ante 400
dim@n.89liza: posts the ante 400
jcarlos.vale: posts the ante 400
17michman17: posts the ante 400
Svetalina: posts the ante 400
Matzen10: posts the ante 400
dsg888: posts the ante 400
giourkas_h: posts small blind 1600
TRENDLINEOKI: posts big blind 3200
*** HOLE CARDS ***
Dealt to jcarlos.vale [4c 8h]
dim@n.89liza: folds 
jcarlos.vale: folds 
17michman17: raises 9600 to 12800
Svetalina: folds 
Matzen10: folds 
dsg888: folds 
giourkas_h: folds 
TRENDLINEOKI: folds 
Uncalled bet (9600) returned to 17michman17
17michman17 collected 11200 from pot
17michman17: doesn't show handDTO
*** SUMMARY ***
Total pot 11200 | Rake 0 
Seat 1: giourkas_h (small blind) folded before Flop
Seat 2: TRENDLINEOKI (big blind) folded before Flop
Seat 3: dim@n.89liza folded before Flop (didn't bet)
Seat 4: jcarlos.vale folded before Flop (didn't bet)
Seat 5: 17michman17 collected (11200)
Seat 6: Svetalina folded before Flop (didn't bet)
Seat 8: Matzen10 folded before Flop (didn't bet)
Seat 9: dsg888 (button) folded before Flop (didn't bet)



PokerStars Hand #221910543139: Tournament #3082657132, $0.98+$0.12 USD Hold'em No Limit - Level XXV (1600/3200) - 2020/12/27 20:49:10 EET [2020/12/27 13:49:10 ET]
Table '3082657132 62' 9-max Seat #1 is the button
Seat 1: giourkas_h (108524 in chips) 
Seat 2: TRENDLINEOKI (134377 in chips) 
Seat 3: dim@n.89liza (143850 in chips) 
Seat 4: jcarlos.vale (85554 in chips) 
Seat 5: 17michman17 (98458 in chips) 
Seat 6: Svetalina (113251 in chips) 
Seat 8: Matzen10 (128855 in chips) 
Seat 9: dsg888 (97208 in chips) 
giourkas_h: posts the ante 400
TRENDLINEOKI: posts the ante 400
dim@n.89liza: posts the ante 400
jcarlos.vale: posts the ante 400
17michman17: posts the ante 400
Svetalina: posts the ante 400
Matzen10: posts the ante 400
dsg888: posts the ante 400
TRENDLINEOKI: posts small blind 1600
dim@n.89liza: posts big blind 3200
*** HOLE CARDS ***
Dealt to jcarlos.vale [Js Ts]
jcarlos.vale: folds 
17michman17: folds 
Svetalina: folds 
Matzen10: folds 
dsg888: raises 3200 to 6400
giourkas_h: folds 
TRENDLINEOKI: folds 
dim@n.89liza: folds 
Uncalled bet (3200) returned to dsg888
dsg888 collected 11200 from pot
*** SUMMARY ***
Total pot 11200 | Rake 0 
Seat 1: giourkas_h (button) folded before Flop (didn't bet)
Seat 2: TRENDLINEOKI (small blind) folded before Flop
Seat 3: dim@n.89liza (big blind) folded before Flop
Seat 4: jcarlos.vale folded before Flop (didn't bet)
Seat 5: 17michman17 folded before Flop (didn't bet)
Seat 6: Svetalina folded before Flop (didn't bet)
Seat 8: Matzen10 folded before Flop (didn't bet)
Seat 9: dsg888 collected (11200)



PokerStars Hand #221910577441: Tournament #3082657132, $0.98+$0.12 USD Hold'em No Limit - Level XXV (1600/3200) - 2020/12/27 20:49:48 EET [2020/12/27 13:49:48 ET]
Table '3082657132 62' 9-max Seat #2 is the button
Seat 1: giourkas_h (108124 in chips) 
Seat 2: TRENDLINEOKI (132377 in chips) 
Seat 3: dim@n.89liza (140250 in chips) 
Seat 4: jcarlos.vale (85154 in chips) 
Seat 5: 17michman17 (98058 in chips) 
Seat 6: Svetalina (112851 in chips) 
Seat 8: Matzen10 (128455 in chips) 
Seat 9: dsg888 (104808 in chips) 
giourkas_h: posts the ante 400
TRENDLINEOKI: posts the ante 400
dim@n.89liza: posts the ante 400
jcarlos.vale: posts the ante 400
17michman17: posts the ante 400
Svetalina: posts the ante 400
Matzen10: posts the ante 400
dsg888: posts the ante 400
dim@n.89liza: posts small blind 1600
jcarlos.vale: posts big blind 3200
*** HOLE CARDS ***
Dealt to jcarlos.vale [Qs 4c]
17michman17: folds 
Svetalina: folds 
Matzen10: raises 3200 to 6400
dsg888: folds 
giourkas_h: folds 
TRENDLINEOKI: folds 
dim@n.89liza: folds 
jcarlos.vale: folds 
Uncalled bet (3200) returned to Matzen10
Matzen10 collected 11200 from pot
Matzen10: doesn't show handDTO
*** SUMMARY ***
Total pot 11200 | Rake 0 
Seat 1: giourkas_h folded before Flop (didn't bet)
Seat 2: TRENDLINEOKI (button) folded before Flop (didn't bet)
Seat 3: dim@n.89liza (small blind) folded before Flop
Seat 4: jcarlos.vale (big blind) folded before Flop
Seat 5: 17michman17 folded before Flop (didn't bet)
Seat 6: Svetalina folded before Flop (didn't bet)
Seat 8: Matzen10 collected (11200)
Seat 9: dsg888 folded before Flop (didn't bet)



PokerStars Hand #221910599768: Tournament #3082657132, $0.98+$0.12 USD Hold'em No Limit - Level XXV (1600/3200) - 2020/12/27 20:50:14 EET [2020/12/27 13:50:14 ET]
Table '3082657132 62' 9-max Seat #3 is the button
Seat 1: giourkas_h (107724 in chips) 
Seat 2: TRENDLINEOKI (131977 in chips) 
Seat 3: dim@n.89liza (138250 in chips) 
Seat 4: jcarlos.vale (81554 in chips) 
Seat 5: 17michman17 (97658 in chips) 
Seat 6: Svetalina (112451 in chips) 
Seat 8: Matzen10 (136055 in chips) 
Seat 9: dsg888 (104408 in chips) 
giourkas_h: posts the ante 400
TRENDLINEOKI: posts the ante 400
dim@n.89liza: posts the ante 400
jcarlos.vale: posts the ante 400
17michman17: posts the ante 400
Svetalina: posts the ante 400
Matzen10: posts the ante 400
dsg888: posts the ante 400
jcarlos.vale: posts small blind 1600
17michman17: posts big blind 3200
*** HOLE CARDS ***
Dealt to jcarlos.vale [Kc Th]
Svetalina: folds 
Matzen10: folds 
dsg888: raises 3200 to 6400
giourkas_h: calls 6400
TRENDLINEOKI: folds 
dim@n.89liza: folds 
jcarlos.vale: folds 
17michman17: calls 3200
*** FLOP *** [Ac As 3h]
17michman17: checks 
dsg888: checks 
giourkas_h: checks 
*** TURN *** [Ac As 3h] [7s]
17michman17: bets 3200
dsg888: folds 
giourkas_h: folds 
Uncalled bet (3200) returned to 17michman17
17michman17 collected 24000 from pot
17michman17: doesn't show handDTO
*** SUMMARY ***
Total pot 24000 | Rake 0 
Board [Ac As 3h 7s]
Seat 1: giourkas_h folded on the Turn
Seat 2: TRENDLINEOKI folded before Flop (didn't bet)
Seat 3: dim@n.89liza (button) folded before Flop (didn't bet)
Seat 4: jcarlos.vale (small blind) folded before Flop
Seat 5: 17michman17 (big blind) collected (24000)
Seat 6: Svetalina folded before Flop (didn't bet)
Seat 8: Matzen10 folded before Flop (didn't bet)
Seat 9: dsg888 folded on the Turn



PokerStars Hand #221910643558: Tournament #3082657132, $0.98+$0.12 USD Hold'em No Limit - Level XXV (1600/3200) - 2020/12/27 20:51:03 EET [2020/12/27 13:51:03 ET]
Table '3082657132 62' 9-max Seat #4 is the button
Seat 1: giourkas_h (100924 in chips) 
Seat 2: TRENDLINEOKI (131577 in chips) 
Seat 3: dim@n.89liza (137850 in chips) 
Seat 4: jcarlos.vale (79554 in chips) 
Seat 5: 17michman17 (114858 in chips) 
Seat 6: Svetalina (112051 in chips) 
Seat 8: Matzen10 (135655 in chips) 
Seat 9: dsg888 (97608 in chips) 
giourkas_h: posts the ante 400
TRENDLINEOKI: posts the ante 400
dim@n.89liza: posts the ante 400
jcarlos.vale: posts the ante 400
17michman17: posts the ante 400
Svetalina: posts the ante 400
Matzen10: posts the ante 400
dsg888: posts the ante 400
17michman17: posts small blind 1600
Svetalina: posts big blind 3200
*** HOLE CARDS ***
Dealt to jcarlos.vale [6h 2d]
Matzen10: folds 
dsg888: folds 
giourkas_h: folds 
TRENDLINEOKI: folds 
dim@n.89liza: folds 
jcarlos.vale: folds 
17michman17: calls 1600
Svetalina: checks 
*** FLOP *** [Jc Ks 6d]
17michman17: bets 3200
Svetalina: folds 
Uncalled bet (3200) returned to 17michman17
17michman17 collected 9600 from pot
17michman17: doesn't show handDTO
*** SUMMARY ***
Total pot 9600 | Rake 0 
Board [Jc Ks 6d]
Seat 1: giourkas_h folded before Flop (didn't bet)
Seat 2: TRENDLINEOKI folded before Flop (didn't bet)
Seat 3: dim@n.89liza folded before Flop (didn't bet)
Seat 4: jcarlos.vale (button) folded before Flop (didn't bet)
Seat 5: 17michman17 (small blind) collected (9600)
Seat 6: Svetalina (big blind) folded on the Flop
Seat 8: Matzen10 folded before Flop (didn't bet)
Seat 9: dsg888 folded before Flop (didn't bet)



PokerStars Hand #221910682530: Tournament #3082657132, $0.98+$0.12 USD Hold'em No Limit - Level XXVI (1800/3600) - 2020/12/27 20:51:47 EET [2020/12/27 13:51:47 ET]
Table '3082657132 62' 9-max Seat #5 is the button
Seat 1: giourkas_h (100524 in chips) 
Seat 2: TRENDLINEOKI (131177 in chips) 
Seat 3: dim@n.89liza (137450 in chips) 
Seat 4: jcarlos.vale (79154 in chips) 
Seat 5: 17michman17 (120858 in chips) 
Seat 6: Svetalina (108451 in chips) 
Seat 7: Monstrson (142864 in chips) 
Seat 8: Matzen10 (135255 in chips) 
Seat 9: dsg888 (97208 in chips) 
giourkas_h: posts the ante 450
TRENDLINEOKI: posts the ante 450
dim@n.89liza: posts the ante 450
jcarlos.vale: posts the ante 450
17michman17: posts the ante 450
Svetalina: posts the ante 450
Monstrson: posts the ante 450
Matzen10: posts the ante 450
dsg888: posts the ante 450
Svetalina: posts small blind 1800
Monstrson: posts big blind 3600
*** HOLE CARDS ***
Dealt to jcarlos.vale [9h Jh]
Matzen10: folds 
dsg888: folds 
giourkas_h: folds 
TRENDLINEOKI: folds 
dim@n.89liza: raises 5400 to 9000
jcarlos.vale: folds 
17michman17: folds 
Svetalina: folds 
Monstrson: folds 
Uncalled bet (5400) returned to dim@n.89liza
dim@n.89liza collected 13050 from pot
dim@n.89liza: doesn't show handDTO
*** SUMMARY ***
Total pot 13050 | Rake 0 
Seat 1: giourkas_h folded before Flop (didn't bet)
Seat 2: TRENDLINEOKI folded before Flop (didn't bet)
Seat 3: dim@n.89liza collected (13050)
Seat 4: jcarlos.vale folded before Flop (didn't bet)
Seat 5: 17michman17 (button) folded before Flop (didn't bet)
Seat 6: Svetalina (small blind) folded before Flop
Seat 7: Monstrson (big blind) folded before Flop
Seat 8: Matzen10 folded before Flop (didn't bet)
Seat 9: dsg888 folded before Flop (didn't bet)



PokerStars Hand #221910704620: Tournament #3082657132, $0.98+$0.12 USD Hold'em No Limit - Level XXVI (1800/3600) - 2020/12/27 20:52:11 EET [2020/12/27 13:52:11 ET]
Table '3082657132 62' 9-max Seat #6 is the button
Seat 1: giourkas_h (100074 in chips) 
Seat 2: TRENDLINEOKI (130727 in chips) 
Seat 3: dim@n.89liza (146450 in chips) 
Seat 4: jcarlos.vale (78704 in chips) 
Seat 5: 17michman17 (120408 in chips) 
Seat 6: Svetalina (106201 in chips) 
Seat 7: Monstrson (138814 in chips) 
Seat 8: Matzen10 (134805 in chips) 
Seat 9: dsg888 (96758 in chips) 
giourkas_h: posts the ante 450
TRENDLINEOKI: posts the ante 450
dim@n.89liza: posts the ante 450
jcarlos.vale: posts the ante 450
17michman17: posts the ante 450
Svetalina: posts the ante 450
Monstrson: posts the ante 450
Matzen10: posts the ante 450
dsg888: posts the ante 450
Monstrson: posts small blind 1800
Matzen10: posts big blind 3600
*** HOLE CARDS ***
Dealt to jcarlos.vale [7h Jc]
dsg888: raises 3600 to 7200
giourkas_h: folds 
TRENDLINEOKI: folds 
dim@n.89liza: folds 
jcarlos.vale: folds 
17michman17: calls 7200
Svetalina: folds 
Monstrson: folds 
Matzen10: raises 25200 to 32400
dsg888: raises 63908 to 96308 and is all-in
17michman17: folds 
Matzen10: calls 63908
*** FLOP *** [8c 7c 7s]
*** TURN *** [8c 7c 7s] [3s]
*** RIVER *** [8c 7c 7s 3s] [5d]
*** SHOW DOWN ***
Matzen10: shows [Ks Kh] (two pair, Kings and Sevens)
dsg888: shows [Ac Kc] (a pair of Sevens)
Matzen10 collected 205666 from pot
dsg888 finished the tournament in 71st place and received $6.24.
*** SUMMARY ***
Total pot 205666 | Rake 0 
Board [8c 7c 7s 3s 5d]
Seat 1: giourkas_h folded before Flop (didn't bet)
Seat 2: TRENDLINEOKI folded before Flop (didn't bet)
Seat 3: dim@n.89liza folded before Flop (didn't bet)
Seat 4: jcarlos.vale folded before Flop (didn't bet)
Seat 5: 17michman17 folded before Flop
Seat 6: Svetalina (button) folded before Flop (didn't bet)
Seat 7: Monstrson (small blind) folded before Flop
Seat 8: Matzen10 (big blind) showed [Ks Kh] and won (205666) with two pair, Kings and Sevens
Seat 9: dsg888 showed [Ac Kc] and lost with a pair of Sevens



PokerStars Hand #221910761380: Tournament #3082657132, $0.98+$0.12 USD Hold'em No Limit - Level XXVI (1800/3600) - 2020/12/27 20:53:15 EET [2020/12/27 13:53:15 ET]
Table '3082657132 62' 9-max Seat #7 is the button
Seat 1: giourkas_h (99624 in chips) 
Seat 2: TRENDLINEOKI (130277 in chips) 
Seat 3: dim@n.89liza (146000 in chips) 
Seat 4: jcarlos.vale (78254 in chips) 
Seat 5: 17michman17 (112758 in chips) 
Seat 6: Svetalina (105751 in chips) 
Seat 7: Monstrson (136564 in chips) 
Seat 8: Matzen10 (243713 in chips) 
giourkas_h: posts the ante 450
TRENDLINEOKI: posts the ante 450
dim@n.89liza: posts the ante 450
jcarlos.vale: posts the ante 450
17michman17: posts the ante 450
Svetalina: posts the ante 450
Monstrson: posts the ante 450
Matzen10: posts the ante 450
Matzen10: posts small blind 1800
giourkas_h: posts big blind 3600
*** HOLE CARDS ***
Dealt to jcarlos.vale [9c Th]
TRENDLINEOKI: folds 
dim@n.89liza: folds 
jcarlos.vale: folds 
17michman17: folds 
Svetalina: raises 3960 to 7560
Monstrson: raises 14040 to 21600
Matzen10: folds 
giourkas_h: folds 
Svetalina: calls 14040
*** FLOP *** [5s 9h 6h]
Svetalina: checks 
Monstrson: checks 
*** TURN *** [5s 9h 6h] [Jh]
Svetalina: checks 
Monstrson: checks 
*** RIVER *** [5s 9h 6h Jh] [5c]
Svetalina: bets 83701 and is all-in
Monstrson: folds 
Uncalled bet (83701) returned to Svetalina
Svetalina collected 52200 from pot
*** SUMMARY ***
Total pot 52200 | Rake 0 
Board [5s 9h 6h Jh 5c]
Seat 1: giourkas_h (big blind) folded before Flop
Seat 2: TRENDLINEOKI folded before Flop (didn't bet)
Seat 3: dim@n.89liza folded before Flop (didn't bet)
Seat 4: jcarlos.vale folded before Flop (didn't bet)
Seat 5: 17michman17 folded before Flop (didn't bet)
Seat 6: Svetalina collected (52200)
Seat 7: Monstrson (button) folded on the River
Seat 8: Matzen10 (small blind) folded before Flop



PokerStars Hand #221910821559: Tournament #3082657132, $0.98+$0.12 USD Hold'em No Limit - Level XXVI (1800/3600) - 2020/12/27 20:54:24 EET [2020/12/27 13:54:24 ET]
Table '3082657132 62' 9-max Seat #8 is the button
Seat 1: giourkas_h (95574 in chips) 
Seat 2: TRENDLINEOKI (129827 in chips) 
Seat 3: dim@n.89liza (145550 in chips) 
Seat 4: jcarlos.vale (77804 in chips) 
Seat 5: 17michman17 (112308 in chips) 
Seat 6: Svetalina (135901 in chips) 
Seat 7: Monstrson (114514 in chips) 
Seat 8: Matzen10 (241463 in chips) 
giourkas_h: posts the ante 450
TRENDLINEOKI: posts the ante 450
dim@n.89liza: posts the ante 450
jcarlos.vale: posts the ante 450
17michman17: posts the ante 450
Svetalina: posts the ante 450
Monstrson: posts the ante 450
Matzen10: posts the ante 450
giourkas_h: posts small blind 1800
TRENDLINEOKI: posts big blind 3600
*** HOLE CARDS ***
Dealt to jcarlos.vale [As Jh]
dim@n.89liza: folds 
jcarlos.vale: raises 5760 to 9360
17michman17: folds 
Svetalina: calls 9360
Monstrson: folds 
Matzen10: folds 
giourkas_h: folds 
TRENDLINEOKI: folds 
*** FLOP *** [2s Kh Ks]
jcarlos.vale: checks 
Svetalina: checks 
*** TURN *** [2s Kh Ks] [Ac]
jcarlos.vale: bets 13860
Svetalina: folds 
Uncalled bet (13860) returned to jcarlos.vale
jcarlos.vale collected 27720 from pot
jcarlos.vale: doesn't show handDTO
*** SUMMARY ***
Total pot 27720 | Rake 0 
Board [2s Kh Ks Ac]
Seat 1: giourkas_h (small blind) folded before Flop
Seat 2: TRENDLINEOKI (big blind) folded before Flop
Seat 3: dim@n.89liza folded before Flop (didn't bet)
Seat 4: jcarlos.vale collected (27720)
Seat 5: 17michman17 folded before Flop (didn't bet)
Seat 6: Svetalina folded on the Turn
Seat 7: Monstrson folded before Flop (didn't bet)
Seat 8: Matzen10 (button) folded before Flop (didn't bet)



PokerStars Hand #221910842975: Tournament #3082657132, $0.98+$0.12 USD Hold'em No Limit - Level XXVI (1800/3600) - 2020/12/27 20:54:48 EET [2020/12/27 13:54:48 ET]
Table '3082657132 62' 9-max Seat #1 is the button
Seat 1: giourkas_h (93324 in chips) 
Seat 2: TRENDLINEOKI (125777 in chips) 
Seat 3: dim@n.89liza (145100 in chips) 
Seat 4: jcarlos.vale (95714 in chips) 
Seat 5: 17michman17 (111858 in chips) 
Seat 6: Svetalina (126091 in chips) 
Seat 7: Monstrson (114064 in chips) 
Seat 8: Matzen10 (241013 in chips) 
giourkas_h: posts the ante 450
TRENDLINEOKI: posts the ante 450
dim@n.89liza: posts the ante 450
jcarlos.vale: posts the ante 450
17michman17: posts the ante 450
Svetalina: posts the ante 450
Monstrson: posts the ante 450
Matzen10: posts the ante 450
TRENDLINEOKI: posts small blind 1800
dim@n.89liza: posts big blind 3600
*** HOLE CARDS ***
Dealt to jcarlos.vale [Kc Ah]
jcarlos.vale: raises 5760 to 9360
17michman17: folds 
Svetalina: folds 
Monstrson: folds 
Matzen10: folds 
giourkas_h: folds 
TRENDLINEOKI: folds 
dim@n.89liza: folds 
Uncalled bet (5760) returned to jcarlos.vale
jcarlos.vale collected 12600 from pot
jcarlos.vale: doesn't show handDTO
*** SUMMARY ***
Total pot 12600 | Rake 0 
Seat 1: giourkas_h (button) folded before Flop (didn't bet)
Seat 2: TRENDLINEOKI (small blind) folded before Flop
Seat 3: dim@n.89liza (big blind) folded before Flop
Seat 4: jcarlos.vale collected (12600)
Seat 5: 17michman17 folded before Flop (didn't bet)
Seat 6: Svetalina folded before Flop (didn't bet)
Seat 7: Monstrson folded before Flop (didn't bet)
Seat 8: Matzen10 folded before Flop (didn't bet)



PokerStars Hand #221910863583: Tournament #3082657132, $0.98+$0.12 USD Hold'em No Limit - Level XXVI (1800/3600) - 2020/12/27 20:55:11 EET [2020/12/27 13:55:11 ET]
Table '3082657132 62' 9-max Seat #2 is the button
Seat 1: giourkas_h (92874 in chips) 
Seat 2: TRENDLINEOKI (123527 in chips) 
Seat 3: dim@n.89liza (141050 in chips) 
Seat 4: jcarlos.vale (104264 in chips) 
Seat 5: 17michman17 (111408 in chips) 
Seat 6: Svetalina (125641 in chips) 
Seat 7: Monstrson (113614 in chips) 
Seat 8: Matzen10 (240563 in chips) 
giourkas_h: posts the ante 450
TRENDLINEOKI: posts the ante 450
dim@n.89liza: posts the ante 450
jcarlos.vale: posts the ante 450
17michman17: posts the ante 450
Svetalina: posts the ante 450
Monstrson: posts the ante 450
Matzen10: posts the ante 450
dim@n.89liza: posts small blind 1800
jcarlos.vale: posts big blind 3600
*** HOLE CARDS ***
Dealt to jcarlos.vale [3s Th]
17michman17: calls 3600
Svetalina: folds 
Monstrson: folds 
Matzen10: raises 9000 to 12600
giourkas_h: folds 
TRENDLINEOKI: folds 
dim@n.89liza: raises 128000 to 140600 and is all-in
jcarlos.vale: folds 
17michman17: folds 
Matzen10: folds 
Uncalled bet (128000) returned to dim@n.89liza
dim@n.89liza collected 36000 from pot
dim@n.89liza: doesn't show handDTO
*** SUMMARY ***
Total pot 36000 | Rake 0 
Seat 1: giourkas_h folded before Flop (didn't bet)
Seat 2: TRENDLINEOKI (button) folded before Flop (didn't bet)
Seat 3: dim@n.89liza (small blind) collected (36000)
Seat 4: jcarlos.vale (big blind) folded before Flop
Seat 5: 17michman17 folded before Flop
Seat 6: Svetalina folded before Flop (didn't bet)
Seat 7: Monstrson folded before Flop (didn't bet)
Seat 8: Matzen10 folded before Flop



PokerStars Hand #221911060722: Tournament #3082657132, $0.98+$0.12 USD Hold'em No Limit - Level XXVI (1800/3600) - 2020/12/27 21:01:05 EET [2020/12/27 14:01:05 ET]
Table '3082657132 62' 9-max Seat #3 is the button
Seat 1: giourkas_h (92424 in chips) 
Seat 2: TRENDLINEOKI (123077 in chips) 
Seat 3: dim@n.89liza (164000 in chips) 
Seat 4: jcarlos.vale (100214 in chips) 
Seat 5: 17michman17 (107358 in chips) 
Seat 6: Svetalina (125191 in chips) 
Seat 7: Monstrson (113164 in chips) 
Seat 8: Matzen10 (227513 in chips) 
giourkas_h: posts the ante 450
TRENDLINEOKI: posts the ante 450
dim@n.89liza: posts the ante 450
jcarlos.vale: posts the ante 450
17michman17: posts the ante 450
Svetalina: posts the ante 450
Monstrson: posts the ante 450
Matzen10: posts the ante 450
jcarlos.vale: posts small blind 1800
17michman17: posts big blind 3600
*** HOLE CARDS ***
Dealt to jcarlos.vale [8d 6d]
Svetalina: folds 
Monstrson: raises 4320 to 7920
Matzen10: folds 
giourkas_h: calls 7920
TRENDLINEOKI: folds 
dim@n.89liza: folds 
jcarlos.vale: folds 
17michman17: calls 4320
*** FLOP *** [4c Ts Kh]
17michman17: checks 
Monstrson: bets 14288
giourkas_h: calls 14288
17michman17: folds 
*** TURN *** [4c Ts Kh] [2h]
Monstrson: bets 28291
giourkas_h: calls 28291
*** RIVER *** [4c Ts Kh 2h] [2c]
Monstrson: bets 62215 and is all-in
giourkas_h: calls 41475 and is all-in
Uncalled bet (20740) returned to Monstrson
*** SHOW DOWN ***
Monstrson: shows [Ks Ah] (two pair, Kings and Deuces)
giourkas_h: shows [Th Qd] (two pair, Tens and Deuces)
Monstrson collected 197268 from pot
giourkas_h finished the tournament in 66th place and received $6.24.
*** SUMMARY ***
Total pot 197268 | Rake 0 
Board [4c Ts Kh 2h 2c]
Seat 1: giourkas_h showed [Th Qd] and lost with two pair, Tens and Deuces
Seat 2: TRENDLINEOKI folded before Flop (didn't bet)
Seat 3: dim@n.89liza (button) folded before Flop (didn't bet)
Seat 4: jcarlos.vale (small blind) folded before Flop
Seat 5: 17michman17 (big blind) folded on the Flop
Seat 6: Svetalina folded before Flop (didn't bet)
Seat 7: Monstrson showed [Ks Ah] and won (197268) with two pair, Kings and Deuces
Seat 8: Matzen10 folded before Flop (didn't bet)



PokerStars Hand #221911115939: Tournament #3082657132, $0.98+$0.12 USD Hold'em No Limit - Level XXVI (1800/3600) - 2020/12/27 21:02:18 EET [2020/12/27 14:02:18 ET]
Table '3082657132 62' 9-max Seat #4 is the button
Seat 2: TRENDLINEOKI (122627 in chips) 
Seat 3: dim@n.89liza (163550 in chips) 
Seat 4: jcarlos.vale (97964 in chips) 
Seat 5: 17michman17 (98988 in chips) 
Seat 6: Svetalina (124741 in chips) 
Seat 7: Monstrson (218008 in chips) 
Seat 8: Matzen10 (227063 in chips) 
TRENDLINEOKI: posts the ante 450
dim@n.89liza: posts the ante 450
jcarlos.vale: posts the ante 450
17michman17: posts the ante 450
Svetalina: posts the ante 450
Monstrson: posts the ante 450
Matzen10: posts the ante 450
17michman17: posts small blind 1800
Svetalina: posts big blind 3600
*** HOLE CARDS ***
Dealt to jcarlos.vale [Ac 3c]
Monstrson: raises 4320 to 7920
Matzen10: folds 
TRENDLINEOKI: folds 
dim@n.89liza: folds 
jcarlos.vale: folds 
17michman17: folds 
Svetalina: folds 
Uncalled bet (4320) returned to Monstrson
Monstrson collected 12150 from pot
*** SUMMARY ***
Total pot 12150 | Rake 0 
Seat 2: TRENDLINEOKI folded before Flop (didn't bet)
Seat 3: dim@n.89liza folded before Flop (didn't bet)
Seat 4: jcarlos.vale (button) folded before Flop (didn't bet)
Seat 5: 17michman17 (small blind) folded before Flop
Seat 6: Svetalina (big blind) folded before Flop
Seat 7: Monstrson collected (12150)
Seat 8: Matzen10 folded before Flop (didn't bet)



PokerStars Hand #221911131162: Tournament #3082657132, $0.98+$0.12 USD Hold'em No Limit - Level XXVI (1800/3600) - 2020/12/27 21:02:37 EET [2020/12/27 14:02:37 ET]
Table '3082657132 62' 9-max Seat #5 is the button
Seat 1: Quent Berthe (251758 in chips) 
Seat 2: TRENDLINEOKI (122177 in chips) 
Seat 3: dim@n.89liza (163100 in chips) 
Seat 4: jcarlos.vale (97514 in chips) 
Seat 5: 17michman17 (96738 in chips) 
Seat 6: Svetalina (120691 in chips) 
Seat 7: Monstrson (226108 in chips) 
Seat 8: Matzen10 (226613 in chips) 
Quent Berthe: posts the ante 450
TRENDLINEOKI: posts the ante 450
dim@n.89liza: posts the ante 450
jcarlos.vale: posts the ante 450
17michman17: posts the ante 450
Svetalina: posts the ante 450
Monstrson: posts the ante 450
Matzen10: posts the ante 450
Svetalina: posts small blind 1800
Monstrson: posts big blind 3600
*** HOLE CARDS ***
Dealt to jcarlos.vale [3c Qh]
Matzen10: folds 
Quent Berthe: raises 3600 to 7200
TRENDLINEOKI: folds 
dim@n.89liza: raises 21600 to 28800
jcarlos.vale: folds 
17michman17: folds 
Svetalina: folds 
Monstrson: folds 
Quent Berthe: folds 
Uncalled bet (21600) returned to dim@n.89liza
dim@n.89liza collected 23400 from pot
dim@n.89liza: doesn't show handDTO
*** SUMMARY ***
Total pot 23400 | Rake 0 
Seat 1: Quent Berthe folded before Flop
Seat 2: TRENDLINEOKI folded before Flop (didn't bet)
Seat 3: dim@n.89liza collected (23400)
Seat 4: jcarlos.vale folded before Flop (didn't bet)
Seat 5: 17michman17 (button) folded before Flop (didn't bet)
Seat 6: Svetalina (small blind) folded before Flop
Seat 7: Monstrson (big blind) folded before Flop
Seat 8: Matzen10 folded before Flop (didn't bet)



PokerStars Hand #221911152989: Tournament #3082657132, $0.98+$0.12 USD Hold'em No Limit - Level XXVI (1800/3600) - 2020/12/27 21:03:04 EET [2020/12/27 14:03:04 ET]
Table '3082657132 62' 9-max Seat #6 is the button
Seat 1: Quent Berthe (244108 in chips) 
Seat 2: TRENDLINEOKI (121727 in chips) 
Seat 3: dim@n.89liza (178850 in chips) 
Seat 4: jcarlos.vale (97064 in chips) 
Seat 5: 17michman17 (96288 in chips) 
Seat 6: Svetalina (118441 in chips) 
Seat 7: Monstrson (222058 in chips) 
Seat 8: Matzen10 (226163 in chips) 
Quent Berthe: posts the ante 450
TRENDLINEOKI: posts the ante 450
dim@n.89liza: posts the ante 450
jcarlos.vale: posts the ante 450
17michman17: posts the ante 450
Svetalina: posts the ante 450
Monstrson: posts the ante 450
Matzen10: posts the ante 450
Monstrson: posts small blind 1800
Matzen10: posts big blind 3600
*** HOLE CARDS ***
Dealt to jcarlos.vale [6d 6s]
Quent Berthe: raises 3600 to 7200
TRENDLINEOKI: folds 
dim@n.89liza: folds 
jcarlos.vale: calls 7200
17michman17: folds 
Svetalina: folds 
Monstrson: folds 
Matzen10: folds 
*** FLOP *** [6h Td 7d]
Quent Berthe: bets 11700
jcarlos.vale: raises 35100 to 46800
Quent Berthe: folds 
Uncalled bet (35100) returned to jcarlos.vale
jcarlos.vale collected 46800 from pot
jcarlos.vale: doesn't show handDTO
*** SUMMARY ***
Total pot 46800 | Rake 0 
Board [6h Td 7d]
Seat 1: Quent Berthe folded on the Flop
Seat 2: TRENDLINEOKI folded before Flop (didn't bet)
Seat 3: dim@n.89liza folded before Flop (didn't bet)
Seat 4: jcarlos.vale collected (46800)
Seat 5: 17michman17 folded before Flop (didn't bet)
Seat 6: Svetalina (button) folded before Flop (didn't bet)
Seat 7: Monstrson (small blind) folded before Flop
Seat 8: Matzen10 (big blind) folded before Flop



PokerStars Hand #221911185624: Tournament #3082657132, $0.98+$0.12 USD Hold'em No Limit - Level XXVI (1800/3600) - 2020/12/27 21:03:40 EET [2020/12/27 14:03:40 ET]
Table '3082657132 62' 9-max Seat #7 is the button
Seat 1: Quent Berthe (224758 in chips) 
Seat 2: TRENDLINEOKI (121277 in chips) 
Seat 3: dim@n.89liza (178400 in chips) 
Seat 4: jcarlos.vale (124514 in chips) 
Seat 5: 17michman17 (95838 in chips) 
Seat 6: Svetalina (117991 in chips) 
Seat 7: Monstrson (219808 in chips) 
Seat 8: Matzen10 (222113 in chips) 
Quent Berthe: posts the ante 450
TRENDLINEOKI: posts the ante 450
dim@n.89liza: posts the ante 450
jcarlos.vale: posts the ante 450
17michman17: posts the ante 450
Svetalina: posts the ante 450
Monstrson: posts the ante 450
Matzen10: posts the ante 450
Matzen10: posts small blind 1800
Quent Berthe: posts big blind 3600
*** HOLE CARDS ***
Dealt to jcarlos.vale [7s 7d]
TRENDLINEOKI: folds 
dim@n.89liza: raises 7200 to 10800
jcarlos.vale: folds 
17michman17: calls 10800
Svetalina: folds 
Monstrson: folds 
Matzen10: folds 
Quent Berthe: folds 
*** FLOP *** [5s 9s Kh]
dim@n.89liza: bets 16200
17michman17: calls 16200
*** TURN *** [5s 9s Kh] [5d]
dim@n.89liza: checks 
17michman17: bets 31500
dim@n.89liza: folds 
Uncalled bet (31500) returned to 17michman17
17michman17 collected 63000 from pot
17michman17: doesn't show handDTO
*** SUMMARY ***
Total pot 63000 | Rake 0 
Board [5s 9s Kh 5d]
Seat 1: Quent Berthe (big blind) folded before Flop
Seat 2: TRENDLINEOKI folded before Flop (didn't bet)
Seat 3: dim@n.89liza folded on the Turn
Seat 4: jcarlos.vale folded before Flop (didn't bet)
Seat 5: 17michman17 collected (63000)
Seat 6: Svetalina folded before Flop (didn't bet)
Seat 7: Monstrson (button) folded before Flop (didn't bet)
Seat 8: Matzen10 (small blind) folded before Flop



PokerStars Hand #221911225373: Tournament #3082657132, $0.98+$0.12 USD Hold'em No Limit - Level XXVI (1800/3600) - 2020/12/27 21:04:24 EET [2020/12/27 14:04:24 ET]
Table '3082657132 62' 9-max Seat #8 is the button
Seat 1: Quent Berthe (220708 in chips) 
Seat 2: TRENDLINEOKI (120827 in chips) 
Seat 3: dim@n.89liza (150950 in chips) 
Seat 4: jcarlos.vale (124064 in chips) 
Seat 5: 17michman17 (131388 in chips) 
Seat 6: Svetalina (117541 in chips) 
Seat 7: Monstrson (219358 in chips) 
Seat 8: Matzen10 (219863 in chips) 
Quent Berthe: posts the ante 450
TRENDLINEOKI: posts the ante 450
dim@n.89liza: posts the ante 450
jcarlos.vale: posts the ante 450
17michman17: posts the ante 450
Svetalina: posts the ante 450
Monstrson: posts the ante 450
Matzen10: posts the ante 450
Quent Berthe: posts small blind 1800
TRENDLINEOKI: posts big blind 3600
*** HOLE CARDS ***
Dealt to jcarlos.vale [2s Qd]
dim@n.89liza: calls 3600
jcarlos.vale: folds 
17michman17: folds 
Svetalina has timed out
Svetalina: folds 
Svetalina is sitting out
Svetalina has returned
Monstrson: folds 
Matzen10: folds 
Quent Berthe: raises 3600 to 7200
TRENDLINEOKI: calls 3600
dim@n.89liza: raises 21600 to 28800
Quent Berthe: calls 21600
TRENDLINEOKI: folds 
*** FLOP *** [Ks 2d 7s]
Quent Berthe: checks 
dim@n.89liza: bets 3600
Quent Berthe: folds 
Uncalled bet (3600) returned to dim@n.89liza
dim@n.89liza collected 68400 from pot
dim@n.89liza: doesn't show handDTO
*** SUMMARY ***
Total pot 68400 | Rake 0 
Board [Ks 2d 7s]
Seat 1: Quent Berthe (small blind) folded on the Flop
Seat 2: TRENDLINEOKI (big blind) folded before Flop
Seat 3: dim@n.89liza collected (68400)
Seat 4: jcarlos.vale folded before Flop (didn't bet)
Seat 5: 17michman17 folded before Flop (didn't bet)
Seat 6: Svetalina folded before Flop (didn't bet)
Seat 7: Monstrson folded before Flop (didn't bet)
Seat 8: Matzen10 (button) folded before Flop (didn't bet)



PokerStars Hand #221911273256: Tournament #3082657132, $0.98+$0.12 USD Hold'em No Limit - Level XXVI (1800/3600) - 2020/12/27 21:05:16 EET [2020/12/27 14:05:16 ET]
Table '3082657132 62' 9-max Seat #1 is the button
Seat 1: Quent Berthe (191458 in chips) 
Seat 2: TRENDLINEOKI (113177 in chips) 
Seat 3: dim@n.89liza (190100 in chips) 
Seat 4: jcarlos.vale (123614 in chips) 
Seat 5: 17michman17 (130938 in chips) 
Seat 6: Svetalina (117091 in chips) 
Seat 7: Monstrson (218908 in chips) 
Seat 8: Matzen10 (219413 in chips) 
Seat 9: lukekus87 (103626 in chips) 
Quent Berthe: posts the ante 450
TRENDLINEOKI: posts the ante 450
dim@n.89liza: posts the ante 450
jcarlos.vale: posts the ante 450
17michman17: posts the ante 450
Svetalina: posts the ante 450
Monstrson: posts the ante 450
Matzen10: posts the ante 450
lukekus87: posts the ante 450
TRENDLINEOKI: posts small blind 1800
dim@n.89liza: posts big blind 3600
*** HOLE CARDS ***
Dealt to jcarlos.vale [6c Tc]
jcarlos.vale: folds 
17michman17: folds 
Svetalina: folds 
Monstrson: folds 
Matzen10: folds 
lukekus87: folds 
Quent Berthe: folds 
TRENDLINEOKI: raises 5760 to 9360
dim@n.89liza: raises 23040 to 32400
TRENDLINEOKI: folds 
Uncalled bet (23040) returned to dim@n.89liza
dim@n.89liza collected 22770 from pot
dim@n.89liza: doesn't show handDTO
*** SUMMARY ***
Total pot 22770 | Rake 0 
Seat 1: Quent Berthe (button) folded before Flop (didn't bet)
Seat 2: TRENDLINEOKI (small blind) folded before Flop
Seat 3: dim@n.89liza (big blind) collected (22770)
Seat 4: jcarlos.vale folded before Flop (didn't bet)
Seat 5: 17michman17 folded before Flop (didn't bet)
Seat 6: Svetalina folded before Flop (didn't bet)
Seat 7: Monstrson folded before Flop (didn't bet)
Seat 8: Matzen10 folded before Flop (didn't bet)
Seat 9: lukekus87 folded before Flop (didn't bet)



PokerStars Hand #221911304501: Tournament #3082657132, $0.98+$0.12 USD Hold'em No Limit - Level XXVI (1800/3600) - 2020/12/27 21:05:44 EET [2020/12/27 14:05:44 ET]
Table '3082657132 62' 9-max Seat #2 is the button
Seat 1: Quent Berthe (191008 in chips) 
Seat 2: TRENDLINEOKI (103367 in chips) 
Seat 3: dim@n.89liza (203060 in chips) 
Seat 4: jcarlos.vale (123164 in chips) 
Seat 5: 17michman17 (130488 in chips) 
Seat 6: Svetalina (116641 in chips) 
Seat 7: Monstrson (218458 in chips) 
Seat 8: Matzen10 (218963 in chips) 
Seat 9: lukekus87 (103176 in chips) 
Quent Berthe: posts the ante 450
TRENDLINEOKI: posts the ante 450
dim@n.89liza: posts the ante 450
jcarlos.vale: posts the ante 450
17michman17: posts the ante 450
Svetalina: posts the ante 450
Monstrson: posts the ante 450
Matzen10: posts the ante 450
lukekus87: posts the ante 450
dim@n.89liza: posts small blind 1800
jcarlos.vale: posts big blind 3600
*** HOLE CARDS ***
Dealt to jcarlos.vale [9d 3d]
17michman17: folds 
Svetalina: folds 
Monstrson: folds 
Matzen10: folds 
lukekus87: calls 3600
Quent Berthe: folds 
TRENDLINEOKI: raises 4320 to 7920
dim@n.89liza: raises 194690 to 202610 and is all-in
jcarlos.vale: folds 
lukekus87: folds 
TRENDLINEOKI: calls 94997 and is all-in
Uncalled bet (99693) returned to dim@n.89liza
*** FLOP *** [Qd 2d 8c]
*** TURN *** [Qd 2d 8c] [As]
*** RIVER *** [Qd 2d 8c As] [6s]
*** SHOW DOWN ***
dim@n.89liza: shows [Ks Ac] (a pair of Aces)
TRENDLINEOKI: shows [Td Tc] (a pair of Tens)
dim@n.89liza collected 217084 from pot
TRENDLINEOKI finished the tournament in 63rd place and received $6.24.
*** SUMMARY ***
Total pot 217084 | Rake 0 
Board [Qd 2d 8c As 6s]
Seat 1: Quent Berthe folded before Flop (didn't bet)
Seat 2: TRENDLINEOKI (button) showed [Td Tc] and lost with a pair of Tens
Seat 3: dim@n.89liza (small blind) showed [Ks Ac] and won (217084) with a pair of Aces
Seat 4: jcarlos.vale (big blind) folded before Flop
Seat 5: 17michman17 folded before Flop (didn't bet)
Seat 6: Svetalina folded before Flop (didn't bet)
Seat 7: Monstrson folded before Flop (didn't bet)
Seat 8: Matzen10 folded before Flop (didn't bet)
Seat 9: lukekus87 folded before Flop



PokerStars Hand #221911345535: Tournament #3082657132, $0.98+$0.12 USD Hold'em No Limit - Level XXVI (1800/3600) - 2020/12/27 21:06:28 EET [2020/12/27 14:06:28 ET]
Table '3082657132 62' 9-max Seat #3 is the button
Seat 1: Quent Berthe (190558 in chips) 
Seat 3: dim@n.89liza (316777 in chips) 
Seat 4: jcarlos.vale (119114 in chips) 
Seat 5: 17michman17 (130038 in chips) 
Seat 6: Svetalina (116191 in chips) 
Seat 7: Monstrson (218008 in chips) 
Seat 8: Matzen10 (218513 in chips) 
Seat 9: lukekus87 (99126 in chips) 
Quent Berthe: posts the ante 450
dim@n.89liza: posts the ante 450
jcarlos.vale: posts the ante 450
17michman17: posts the ante 450
Svetalina: posts the ante 450
Monstrson: posts the ante 450
Matzen10: posts the ante 450
lukekus87: posts the ante 450
jcarlos.vale: posts small blind 1800
17michman17: posts big blind 3600
*** HOLE CARDS ***
Dealt to jcarlos.vale [3c Kc]
Svetalina has timed out
Svetalina: folds 
Svetalina is sitting out
Monstrson: raises 3600 to 7200
Matzen10: folds 
lukekus87: folds 
Quent Berthe: folds 
Svetalina has returned
dim@n.89liza: folds 
jcarlos.vale: folds 
17michman17: calls 3600
*** FLOP *** [7h 4s Qd]
17michman17: checks 
Monstrson: bets 6336
17michman17: calls 6336
*** TURN *** [7h 4s Qd] [9h]
17michman17: checks 
Monstrson: bets 8118
17michman17: calls 8118
*** RIVER *** [7h 4s Qd 9h] [5c]
17michman17: bets 24354
Monstrson: folds 
Uncalled bet (24354) returned to 17michman17
17michman17 collected 48708 from pot
17michman17: doesn't show handDTO
*** SUMMARY ***
Total pot 48708 | Rake 0 
Board [7h 4s Qd 9h 5c]
Seat 1: Quent Berthe folded before Flop (didn't bet)
Seat 3: dim@n.89liza (button) folded before Flop (didn't bet)
Seat 4: jcarlos.vale (small blind) folded before Flop
Seat 5: 17michman17 (big blind) collected (48708)
Seat 6: Svetalina folded before Flop (didn't bet)
Seat 7: Monstrson folded on the River
Seat 8: Matzen10 folded before Flop (didn't bet)
Seat 9: lukekus87 folded before Flop (didn't bet)



PokerStars Hand #221911428360: Tournament #3082657132, $0.98+$0.12 USD Hold'em No Limit - Level XXVII (2000/4000) - 2020/12/27 21:07:58 EET [2020/12/27 14:07:58 ET]
Table '3082657132 62' 9-max Seat #4 is the button
Seat 1: Quent Berthe (190108 in chips) 
Seat 3: dim@n.89liza (316327 in chips) 
Seat 4: jcarlos.vale (116864 in chips) 
Seat 5: 17michman17 (156642 in chips) 
Seat 6: Svetalina (115741 in chips) 
Seat 7: Monstrson (195904 in chips) 
Seat 8: Matzen10 (218063 in chips) 
Seat 9: lukekus87 (98676 in chips) 
Quent Berthe: posts the ante 500
dim@n.89liza: posts the ante 500
jcarlos.vale: posts the ante 500
17michman17: posts the ante 500
Svetalina: posts the ante 500
Monstrson: posts the ante 500
Matzen10: posts the ante 500
lukekus87: posts the ante 500
17michman17: posts small blind 2000
Svetalina: posts big blind 4000
*** HOLE CARDS ***
Dealt to jcarlos.vale [3s Ts]
Monstrson: folds 
Matzen10: raises 4000 to 8000
lukekus87: folds 
Quent Berthe: folds 
dim@n.89liza: folds 
jcarlos.vale: folds 
17michman17: folds 
Svetalina: calls 4000
*** FLOP *** [2c 6s 2s]
Svetalina: checks 
Matzen10: checks 
*** TURN *** [2c 6s 2s] [5h]
Svetalina: bets 18000
Matzen10: folds 
Uncalled bet (18000) returned to Svetalina
Svetalina collected 22000 from pot
*** SUMMARY ***
Total pot 22000 | Rake 0 
Board [2c 6s 2s 5h]
Seat 1: Quent Berthe folded before Flop (didn't bet)
Seat 3: dim@n.89liza folded before Flop (didn't bet)
Seat 4: jcarlos.vale (button) folded before Flop (didn't bet)
Seat 5: 17michman17 (small blind) folded before Flop
Seat 6: Svetalina (big blind) collected (22000)
Seat 7: Monstrson folded before Flop (didn't bet)
Seat 8: Matzen10 folded on the Turn
Seat 9: lukekus87 folded before Flop (didn't bet)



PokerStars Hand #221911473316: Tournament #3082657132, $0.98+$0.12 USD Hold'em No Limit - Level XXVII (2000/4000) - 2020/12/27 21:08:46 EET [2020/12/27 14:08:46 ET]
Table '3082657132 62' 9-max Seat #5 is the button
Seat 1: Quent Berthe (189608 in chips) 
Seat 3: dim@n.89liza (315827 in chips) 
Seat 4: jcarlos.vale (116364 in chips) 
Seat 5: 17michman17 (154142 in chips) 
Seat 6: Svetalina (129241 in chips) 
Seat 7: Monstrson (195404 in chips) 
Seat 8: Matzen10 (209563 in chips) 
Seat 9: lukekus87 (98176 in chips) 
Quent Berthe: posts the ante 500
dim@n.89liza: posts the ante 500
jcarlos.vale: posts the ante 500
17michman17: posts the ante 500
Svetalina: posts the ante 500
Monstrson: posts the ante 500
Matzen10: posts the ante 500
lukekus87: posts the ante 500
Svetalina: posts small blind 2000
Monstrson: posts big blind 4000
*** HOLE CARDS ***
Dealt to jcarlos.vale [2s 3h]
Matzen10: folds 
lukekus87: folds 
Quent Berthe: raises 4000 to 8000
dim@n.89liza: calls 8000
jcarlos.vale: folds 
17michman17: calls 8000
Svetalina: calls 6000
Monstrson: folds 
*** FLOP *** [7d 9h 6s]
Svetalina: checks 
Quent Berthe: bets 20000
dim@n.89liza: calls 20000
17michman17: calls 20000
Svetalina: folds 
*** TURN *** [7d 9h 6s] [8c]
Quent Berthe: bets 100000
dim@n.89liza: folds 
17michman17: raises 25642 to 125642 and is all-in
Quent Berthe: calls 25642
*** RIVER *** [7d 9h 6s 8c] [Jh]
*** SHOW DOWN ***
Quent Berthe: shows [8d Td] (a straight, Seven to Jack)
17michman17: shows [Th Jd] (a straight, Seven to Jack)
Quent Berthe collected 175642 from pot
17michman17 collected 175642 from pot
*** SUMMARY ***
Total pot 351284 | Rake 0 
Board [7d 9h 6s 8c Jh]
Seat 1: Quent Berthe showed [8d Td] and won (175642) with a straight, Seven to Jack
Seat 3: dim@n.89liza folded on the Turn
Seat 4: jcarlos.vale folded before Flop (didn't bet)
Seat 5: 17michman17 (button) showed [Th Jd] and won (175642) with a straight, Seven to Jack
Seat 6: Svetalina (small blind) folded on the Flop
Seat 7: Monstrson (big blind) folded before Flop
Seat 8: Matzen10 folded before Flop (didn't bet)
Seat 9: lukekus87 folded before Flop (didn't bet)



PokerStars Hand #221911526057: Tournament #3082657132, $0.98+$0.12 USD Hold'em No Limit - Level XXVII (2000/4000) - 2020/12/27 21:09:43 EET [2020/12/27 14:09:43 ET]
Table '3082657132 62' 9-max Seat #6 is the button
Seat 1: Quent Berthe (211108 in chips) 
Seat 3: dim@n.89liza (287327 in chips) 
Seat 4: jcarlos.vale (115864 in chips) 
Seat 5: 17michman17 (175642 in chips) 
Seat 6: Svetalina (120741 in chips) 
Seat 7: Monstrson (190904 in chips) 
Seat 8: Matzen10 (209063 in chips) 
Seat 9: lukekus87 (97676 in chips) 
Quent Berthe: posts the ante 500
dim@n.89liza: posts the ante 500
jcarlos.vale: posts the ante 500
17michman17: posts the ante 500
Svetalina: posts the ante 500
Monstrson: posts the ante 500
Matzen10: posts the ante 500
lukekus87: posts the ante 500
Monstrson: posts small blind 2000
Matzen10: posts big blind 4000
*** HOLE CARDS ***
Dealt to jcarlos.vale [4c 7s]
lukekus87: folds 
Quent Berthe: folds 
dim@n.89liza: folds 
jcarlos.vale: folds 
17michman17: calls 4000
Svetalina: folds 
Monstrson: calls 2000
Matzen10: checks 
*** FLOP *** [4d Jd 2s]
Monstrson: checks 
Matzen10: checks 
17michman17: bets 8000
Monstrson: folds 
Matzen10: folds 
Uncalled bet (8000) returned to 17michman17
17michman17 collected 16000 from pot
17michman17: doesn't show handDTO
*** SUMMARY ***
Total pot 16000 | Rake 0 
Board [4d Jd 2s]
Seat 1: Quent Berthe folded before Flop (didn't bet)
Seat 3: dim@n.89liza folded before Flop (didn't bet)
Seat 4: jcarlos.vale folded before Flop (didn't bet)
Seat 5: 17michman17 collected (16000)
Seat 6: Svetalina (button) folded before Flop (didn't bet)
Seat 7: Monstrson (small blind) folded on the Flop
Seat 8: Matzen10 (big blind) folded on the Flop
Seat 9: lukekus87 folded before Flop (didn't bet)



PokerStars Hand #221911569396: Tournament #3082657132, $0.98+$0.12 USD Hold'em No Limit - Level XXVII (2000/4000) - 2020/12/27 21:10:30 EET [2020/12/27 14:10:30 ET]
Table '3082657132 62' 9-max Seat #7 is the button
Seat 1: Quent Berthe (210608 in chips) 
Seat 3: dim@n.89liza (286827 in chips) 
Seat 4: jcarlos.vale (115364 in chips) 
Seat 5: 17michman17 (187142 in chips) 
Seat 6: Svetalina (120241 in chips) 
Seat 7: Monstrson (186404 in chips) 
Seat 8: Matzen10 (204563 in chips) 
Seat 9: lukekus87 (97176 in chips) 
Quent Berthe: posts the ante 500
dim@n.89liza: posts the ante 500
jcarlos.vale: posts the ante 500
17michman17: posts the ante 500
Svetalina: posts the ante 500
Monstrson: posts the ante 500
Matzen10: posts the ante 500
lukekus87: posts the ante 500
Matzen10: posts small blind 2000
lukekus87: posts big blind 4000
*** HOLE CARDS ***
Dealt to jcarlos.vale [Ac 6s]
Quent Berthe: folds 
dim@n.89liza: folds 
jcarlos.vale: raises 6400 to 10400
17michman17: calls 10400
Svetalina: folds 
Monstrson: folds 
Matzen10: folds 
lukekus87: calls 6400
*** FLOP *** [3d 8c 8s]
lukekus87: checks 
jcarlos.vale: bets 8000
17michman17: calls 8000
lukekus87: folds 
*** TURN *** [3d 8c 8s] [4d]
jcarlos.vale: checks 
17michman17: bets 26600
jcarlos.vale: folds 
Uncalled bet (26600) returned to 17michman17
17michman17 collected 53200 from pot
17michman17: doesn't show handDTO
*** SUMMARY ***
Total pot 53200 | Rake 0 
Board [3d 8c 8s 4d]
Seat 1: Quent Berthe folded before Flop (didn't bet)
Seat 3: dim@n.89liza folded before Flop (didn't bet)
Seat 4: jcarlos.vale folded on the Turn
Seat 5: 17michman17 collected (53200)
Seat 6: Svetalina folded before Flop (didn't bet)
Seat 7: Monstrson (button) folded before Flop (didn't bet)
Seat 8: Matzen10 (small blind) folded before Flop
Seat 9: lukekus87 (big blind) folded on the Flop



PokerStars Hand #221911617257: Tournament #3082657132, $0.98+$0.12 USD Hold'em No Limit - Level XXVII (2000/4000) - 2020/12/27 21:11:21 EET [2020/12/27 14:11:21 ET]
Table '3082657132 62' 9-max Seat #8 is the button
Seat 1: Quent Berthe (210108 in chips) 
Seat 3: dim@n.89liza (286327 in chips) 
Seat 4: jcarlos.vale (96464 in chips) 
Seat 5: 17michman17 (221442 in chips) 
Seat 6: Svetalina (119741 in chips) 
Seat 7: Monstrson (185904 in chips) 
Seat 8: Matzen10 (202063 in chips) 
Seat 9: lukekus87 (86276 in chips) 
Quent Berthe: posts the ante 500
dim@n.89liza: posts the ante 500
jcarlos.vale: posts the ante 500
17michman17: posts the ante 500
Svetalina: posts the ante 500
Monstrson: posts the ante 500
Matzen10: posts the ante 500
lukekus87: posts the ante 500
lukekus87: posts small blind 2000
Quent Berthe: posts big blind 4000
*** HOLE CARDS ***
Dealt to jcarlos.vale [Js 5d]
dim@n.89liza: folds 
jcarlos.vale: folds 
17michman17: folds 
Svetalina: folds 
Monstrson: folds 
Matzen10: folds 
lukekus87: calls 2000
Quent Berthe: raises 12000 to 16000
lukekus87: raises 69776 to 85776 and is all-in
Quent Berthe: calls 69776
*** FLOP *** [Qc 7h Kd]
*** TURN *** [Qc 7h Kd] [6s]
*** RIVER *** [Qc 7h Kd 6s] [6h]
*** SHOW DOWN ***
lukekus87: shows [Ah Kh] (two pair, Kings and Sixes)
Quent Berthe: shows [Tc Ac] (a pair of Sixes)
lukekus87 collected 175552 from pot
*** SUMMARY ***
Total pot 175552 | Rake 0 
Board [Qc 7h Kd 6s 6h]
Seat 1: Quent Berthe (big blind) showed [Tc Ac] and lost with a pair of Sixes
Seat 3: dim@n.89liza folded before Flop (didn't bet)
Seat 4: jcarlos.vale folded before Flop (didn't bet)
Seat 5: 17michman17 folded before Flop (didn't bet)
Seat 6: Svetalina folded before Flop (didn't bet)
Seat 7: Monstrson folded before Flop (didn't bet)
Seat 8: Matzen10 (button) folded before Flop (didn't bet)
Seat 9: lukekus87 (small blind) showed [Ah Kh] and won (175552) with two pair, Kings and Sixes



PokerStars Hand #221911645832: Tournament #3082657132, $0.98+$0.12 USD Hold'em No Limit - Level XXVII (2000/4000) - 2020/12/27 21:11:52 EET [2020/12/27 14:11:52 ET]
Table '3082657132 62' 9-max Seat #9 is the button
Seat 1: Quent Berthe (123832 in chips) 
Seat 3: dim@n.89liza (285827 in chips) 
Seat 4: jcarlos.vale (95964 in chips) 
Seat 5: 17michman17 (220942 in chips) 
Seat 6: Svetalina (119241 in chips) 
Seat 7: Monstrson (185404 in chips) 
Seat 8: Matzen10 (201563 in chips) 
Seat 9: lukekus87 (175552 in chips) 
Quent Berthe: posts the ante 500
dim@n.89liza: posts the ante 500
jcarlos.vale: posts the ante 500
17michman17: posts the ante 500
Svetalina: posts the ante 500
Monstrson: posts the ante 500
Matzen10: posts the ante 500
lukekus87: posts the ante 500
Quent Berthe: posts small blind 2000
dim@n.89liza: posts big blind 4000
*** HOLE CARDS ***
Dealt to jcarlos.vale [7s 4s]
jcarlos.vale: folds 
17michman17: folds 
Svetalina: raises 4400 to 8400
Monstrson: folds 
Matzen10: folds 
lukekus87: folds 
Quent Berthe: raises 24800 to 33200
dim@n.89liza: folds 
Svetalina: folds 
Uncalled bet (24800) returned to Quent Berthe
Quent Berthe collected 24800 from pot
*** SUMMARY ***
Total pot 24800 | Rake 0 
Seat 1: Quent Berthe (small blind) collected (24800)
Seat 3: dim@n.89liza (big blind) folded before Flop
Seat 4: jcarlos.vale folded before Flop (didn't bet)
Seat 5: 17michman17 folded before Flop (didn't bet)
Seat 6: Svetalina folded before Flop
Seat 7: Monstrson folded before Flop (didn't bet)
Seat 8: Matzen10 folded before Flop (didn't bet)
Seat 9: lukekus87 (button) folded before Flop (didn't bet)



PokerStars Hand #221911671622: Tournament #3082657132, $0.98+$0.12 USD Hold'em No Limit - Level XXVII (2000/4000) - 2020/12/27 21:12:20 EET [2020/12/27 14:12:20 ET]
Table '3082657132 62' 9-max Seat #1 is the button
Seat 1: Quent Berthe (139732 in chips) 
Seat 3: dim@n.89liza (281327 in chips) 
Seat 4: jcarlos.vale (95464 in chips) 
Seat 5: 17michman17 (220442 in chips) 
Seat 6: Svetalina (110341 in chips) 
Seat 7: Monstrson (184904 in chips) 
Seat 8: Matzen10 (201063 in chips) 
Seat 9: lukekus87 (175052 in chips) 
Quent Berthe: posts the ante 500
dim@n.89liza: posts the ante 500
jcarlos.vale: posts the ante 500
17michman17: posts the ante 500
Svetalina: posts the ante 500
Monstrson: posts the ante 500
Matzen10: posts the ante 500
lukekus87: posts the ante 500
dim@n.89liza: posts small blind 2000
jcarlos.vale: posts big blind 4000
*** HOLE CARDS ***
Dealt to jcarlos.vale [5h Td]
17michman17: folds 
Svetalina: folds 
Monstrson: raises 4000 to 8000
Matzen10: folds 
lukekus87: folds 
Quent Berthe: folds 
dim@n.89liza: folds 
jcarlos.vale: folds 
Uncalled bet (4000) returned to Monstrson
Monstrson collected 14000 from pot
*** SUMMARY ***
Total pot 14000 | Rake 0 
Seat 1: Quent Berthe (button) folded before Flop (didn't bet)
Seat 3: dim@n.89liza (small blind) folded before Flop
Seat 4: jcarlos.vale (big blind) folded before Flop
Seat 5: 17michman17 folded before Flop (didn't bet)
Seat 6: Svetalina folded before Flop (didn't bet)
Seat 7: Monstrson collected (14000)
Seat 8: Matzen10 folded before Flop (didn't bet)
Seat 9: lukekus87 folded before Flop (didn't bet)



PokerStars Hand #221911695194: Tournament #3082657132, $0.98+$0.12 USD Hold'em No Limit - Level XXVII (2000/4000) - 2020/12/27 21:12:45 EET [2020/12/27 14:12:45 ET]
Table '3082657132 62' 9-max Seat #3 is the button
Seat 1: Quent Berthe (139232 in chips) 
Seat 3: dim@n.89liza (278827 in chips) 
Seat 4: jcarlos.vale (90964 in chips) 
Seat 5: 17michman17 (219942 in chips) 
Seat 6: Svetalina (109841 in chips) 
Seat 7: Monstrson (194404 in chips) 
Seat 8: Matzen10 (200563 in chips) 
Seat 9: lukekus87 (174552 in chips) 
Quent Berthe: posts the ante 500
dim@n.89liza: posts the ante 500
jcarlos.vale: posts the ante 500
17michman17: posts the ante 500
Svetalina: posts the ante 500
Monstrson: posts the ante 500
Matzen10: posts the ante 500
lukekus87: posts the ante 500
jcarlos.vale: posts small blind 2000
17michman17: posts big blind 4000
*** HOLE CARDS ***
Dealt to jcarlos.vale [3d 5s]
Svetalina: folds 
Monstrson: folds 
Matzen10: folds 
lukekus87: calls 4000
Quent Berthe: folds 
dim@n.89liza: folds 
jcarlos.vale: calls 2000
17michman17: checks 
*** FLOP *** [Tc Ad Th]
jcarlos.vale: checks 
17michman17: checks 
lukekus87: bets 4000
jcarlos.vale: folds 
17michman17: folds 
Uncalled bet (4000) returned to lukekus87
lukekus87 collected 16000 from pot
lukekus87: doesn't show handDTO
*** SUMMARY ***
Total pot 16000 | Rake 0 
Board [Tc Ad Th]
Seat 1: Quent Berthe folded before Flop (didn't bet)
Seat 3: dim@n.89liza (button) folded before Flop (didn't bet)
Seat 4: jcarlos.vale (small blind) folded on the Flop
Seat 5: 17michman17 (big blind) folded on the Flop
Seat 6: Svetalina folded before Flop (didn't bet)
Seat 7: Monstrson folded before Flop (didn't bet)
Seat 8: Matzen10 folded before Flop (didn't bet)
Seat 9: lukekus87 collected (16000)



PokerStars Hand #221911723125: Tournament #3082657132, $0.98+$0.12 USD Hold'em No Limit - Level XXVII (2000/4000) - 2020/12/27 21:13:16 EET [2020/12/27 14:13:16 ET]
Table '3082657132 62' 9-max Seat #4 is the button
Seat 1: Quent Berthe (138732 in chips) 
Seat 3: dim@n.89liza (278327 in chips) 
Seat 4: jcarlos.vale (86464 in chips) 
Seat 5: 17michman17 (215442 in chips) 
Seat 6: Svetalina (109341 in chips) 
Seat 7: Monstrson (193904 in chips) 
Seat 8: Matzen10 (200063 in chips) 
Seat 9: lukekus87 (186052 in chips) 
Quent Berthe: posts the ante 500
dim@n.89liza: posts the ante 500
jcarlos.vale: posts the ante 500
17michman17: posts the ante 500
Svetalina: posts the ante 500
Monstrson: posts the ante 500
Matzen10: posts the ante 500
lukekus87: posts the ante 500
17michman17: posts small blind 2000
Svetalina: posts big blind 4000
*** HOLE CARDS ***
Dealt to jcarlos.vale [3s 6c]
Monstrson: raises 4000 to 8000
Matzen10: calls 8000
lukekus87: folds 
Quent Berthe: folds 
dim@n.89liza: folds 
jcarlos.vale: folds 
17michman17: folds 
Svetalina: raises 100841 to 108841 and is all-in
Monstrson: folds 
Matzen10: calls 100841
*** FLOP *** [5s 3h Ts]
*** TURN *** [5s 3h Ts] [3d]
*** RIVER *** [5s 3h Ts 3d] [Qs]
*** SHOW DOWN ***
Svetalina: shows [Jh Kh] (a pair of Threes)
Matzen10: shows [Th Tc] (a full house, Tens full of Threes)
Matzen10 collected 231682 from pot
Svetalina finished the tournament in 57th place and received $6.24.
*** SUMMARY ***
Total pot 231682 | Rake 0 
Board [5s 3h Ts 3d Qs]
Seat 1: Quent Berthe folded before Flop (didn't bet)
Seat 3: dim@n.89liza folded before Flop (didn't bet)
Seat 4: jcarlos.vale (button) folded before Flop (didn't bet)
Seat 5: 17michman17 (small blind) folded before Flop
Seat 6: Svetalina (big blind) showed [Jh Kh] and lost with a pair of Threes
Seat 7: Monstrson folded before Flop
Seat 8: Matzen10 showed [Th Tc] and won (231682) with a full house, Tens full of Threes
Seat 9: lukekus87 folded before Flop (didn't bet)



PokerStars Hand #221911794274: Tournament #3082657132, $0.98+$0.12 USD Hold'em No Limit - Level XXVII (2000/4000) - 2020/12/27 21:14:33 EET [2020/12/27 14:14:33 ET]
Table '3082657132 62' 9-max Seat #5 is the button
Seat 1: Quent Berthe (138232 in chips) 
Seat 3: dim@n.89liza (277827 in chips) 
Seat 4: jcarlos.vale (85964 in chips) 
Seat 5: 17michman17 (212942 in chips) 
Seat 7: Monstrson (185404 in chips) 
Seat 8: Matzen10 (322404 in chips) 
Seat 9: lukekus87 (185552 in chips) 
Quent Berthe: posts the ante 500
dim@n.89liza: posts the ante 500
jcarlos.vale: posts the ante 500
17michman17: posts the ante 500
Monstrson: posts the ante 500
Matzen10: posts the ante 500
lukekus87: posts the ante 500
Monstrson: posts small blind 2000
Matzen10: posts big blind 4000
*** HOLE CARDS ***
Dealt to jcarlos.vale [7d Ks]
lukekus87: calls 4000
Quent Berthe: raises 17500 to 21500
dim@n.89liza: folds 
jcarlos.vale: folds 
17michman17: folds 
Monstrson: folds 
Matzen10: folds 
lukekus87: calls 17500
*** FLOP *** [2h 3d Kc]
lukekus87: checks 
Quent Berthe: bets 116232 and is all-in
lukekus87: folds 
Uncalled bet (116232) returned to Quent Berthe
Quent Berthe collected 52500 from pot
*** SUMMARY ***
Total pot 52500 | Rake 0 
Board [2h 3d Kc]
Seat 1: Quent Berthe collected (52500)
Seat 3: dim@n.89liza folded before Flop (didn't bet)
Seat 4: jcarlos.vale folded before Flop (didn't bet)
Seat 5: 17michman17 (button) folded before Flop (didn't bet)
Seat 7: Monstrson (small blind) folded before Flop
Seat 8: Matzen10 (big blind) folded before Flop
Seat 9: lukekus87 folded on the Flop



PokerStars Hand #221911828220: Tournament #3082657132, $0.98+$0.12 USD Hold'em No Limit - Level XXVII (2000/4000) - 2020/12/27 21:15:10 EET [2020/12/27 14:15:10 ET]
Table '3082657132 62' 9-max Seat #7 is the button
Seat 1: Quent Berthe (168732 in chips) 
Seat 2: muskymac23 (523009 in chips) 
Seat 3: dim@n.89liza (277327 in chips) 
Seat 4: jcarlos.vale (85464 in chips) 
Seat 5: 17michman17 (212442 in chips) 
Seat 7: Monstrson (182904 in chips) 
Seat 8: Matzen10 (317904 in chips) 
Seat 9: lukekus87 (163552 in chips) 
Quent Berthe: posts the ante 500
muskymac23: posts the ante 500
dim@n.89liza: posts the ante 500
jcarlos.vale: posts the ante 500
17michman17: posts the ante 500
Monstrson: posts the ante 500
Matzen10: posts the ante 500
lukekus87: posts the ante 500
Matzen10: posts small blind 2000
lukekus87: posts big blind 4000
*** HOLE CARDS ***
Dealt to jcarlos.vale [Kd As]
Quent Berthe: folds 
muskymac23: folds 
dim@n.89liza: folds 
jcarlos.vale: raises 80964 to 84964 and is all-in
17michman17: folds 
Monstrson: folds 
Matzen10: folds 
lukekus87: folds 
Uncalled bet (80964) returned to jcarlos.vale
jcarlos.vale collected 14000 from pot
jcarlos.vale: doesn't show handDTO
*** SUMMARY ***
Total pot 14000 | Rake 0 
Seat 1: Quent Berthe folded before Flop (didn't bet)
Seat 2: muskymac23 folded before Flop (didn't bet)
Seat 3: dim@n.89liza folded before Flop (didn't bet)
Seat 4: jcarlos.vale collected (14000)
Seat 5: 17michman17 folded before Flop (didn't bet)
Seat 7: Monstrson (button) folded before Flop (didn't bet)
Seat 8: Matzen10 (small blind) folded before Flop
Seat 9: lukekus87 (big blind) folded before Flop



PokerStars Hand #221911846344: Tournament #3082657132, $0.98+$0.12 USD Hold'em No Limit - Level XXVII (2000/4000) - 2020/12/27 21:15:29 EET [2020/12/27 14:15:29 ET]
Table '3082657132 62' 9-max Seat #8 is the button
Seat 1: Quent Berthe (168232 in chips) 
Seat 2: muskymac23 (522509 in chips) 
Seat 3: dim@n.89liza (276827 in chips) 
Seat 4: jcarlos.vale (94964 in chips) 
Seat 5: 17michman17 (211942 in chips) 
Seat 7: Monstrson (182404 in chips) 
Seat 8: Matzen10 (315404 in chips) 
Seat 9: lukekus87 (159052 in chips) 
Quent Berthe: posts the ante 500
muskymac23: posts the ante 500
dim@n.89liza: posts the ante 500
jcarlos.vale: posts the ante 500
17michman17: posts the ante 500
Monstrson: posts the ante 500
Matzen10: posts the ante 500
lukekus87: posts the ante 500
lukekus87: posts small blind 2000
Quent Berthe: posts big blind 4000
*** HOLE CARDS ***
Dealt to jcarlos.vale [9s 7h]
muskymac23: folds 
dim@n.89liza: folds 
jcarlos.vale: folds 
17michman17: folds 
Monstrson: raises 4000 to 8000
Matzen10: folds 
lukekus87: folds 
Quent Berthe: folds 
Uncalled bet (4000) returned to Monstrson
Monstrson collected 14000 from pot
*** SUMMARY ***
Total pot 14000 | Rake 0 
Seat 1: Quent Berthe (big blind) folded before Flop
Seat 2: muskymac23 folded before Flop (didn't bet)
Seat 3: dim@n.89liza folded before Flop (didn't bet)
Seat 4: jcarlos.vale folded before Flop (didn't bet)
Seat 5: 17michman17 folded before Flop (didn't bet)
Seat 7: Monstrson collected (14000)
Seat 8: Matzen10 (button) folded before Flop (didn't bet)
Seat 9: lukekus87 (small blind) folded before Flop



PokerStars Hand #221911872073: Tournament #3082657132, $0.98+$0.12 USD Hold'em No Limit - Level XXVII (2000/4000) - 2020/12/27 21:15:57 EET [2020/12/27 14:15:57 ET]
Table '3082657132 62' 9-max Seat #9 is the button
Seat 1: Quent Berthe (163732 in chips) 
Seat 2: muskymac23 (522009 in chips) 
Seat 3: dim@n.89liza (276327 in chips) 
Seat 4: jcarlos.vale (94464 in chips) 
Seat 5: 17michman17 (211442 in chips) 
Seat 7: Monstrson (191904 in chips) 
Seat 8: Matzen10 (314904 in chips) 
Seat 9: lukekus87 (156552 in chips) 
Quent Berthe: posts the ante 500
muskymac23: posts the ante 500
dim@n.89liza: posts the ante 500
jcarlos.vale: posts the ante 500
17michman17: posts the ante 500
Monstrson: posts the ante 500
Matzen10: posts the ante 500
lukekus87: posts the ante 500
Quent Berthe: posts small blind 2000
muskymac23: posts big blind 4000
*** HOLE CARDS ***
Dealt to jcarlos.vale [3d 9s]
dim@n.89liza: folds 
jcarlos.vale: folds 
17michman17: folds 
Monstrson: folds 
Matzen10: raises 4000 to 8000
lukekus87: folds 
Quent Berthe: folds 
muskymac23: folds 
Uncalled bet (4000) returned to Matzen10
Matzen10 collected 14000 from pot
Matzen10: doesn't show handDTO
*** SUMMARY ***
Total pot 14000 | Rake 0 
Seat 1: Quent Berthe (small blind) folded before Flop
Seat 2: muskymac23 (big blind) folded before Flop
Seat 3: dim@n.89liza folded before Flop (didn't bet)
Seat 4: jcarlos.vale folded before Flop (didn't bet)
Seat 5: 17michman17 folded before Flop (didn't bet)
Seat 7: Monstrson folded before Flop (didn't bet)
Seat 8: Matzen10 collected (14000)
Seat 9: lukekus87 (button) folded before Flop (didn't bet)



PokerStars Hand #221911892597: Tournament #3082657132, $0.98+$0.12 USD Hold'em No Limit - Level XXVII (2000/4000) - 2020/12/27 21:16:20 EET [2020/12/27 14:16:20 ET]
Table '3082657132 62' 9-max Seat #1 is the button
Seat 1: Quent Berthe (161232 in chips) 
Seat 2: muskymac23 (517509 in chips) 
Seat 3: dim@n.89liza (275827 in chips) 
Seat 4: jcarlos.vale (93964 in chips) 
Seat 5: 17michman17 (210942 in chips) 
Seat 7: Monstrson (191404 in chips) 
Seat 8: Matzen10 (324404 in chips) 
Seat 9: lukekus87 (156052 in chips) 
Quent Berthe: posts the ante 500
muskymac23: posts the ante 500
dim@n.89liza: posts the ante 500
jcarlos.vale: posts the ante 500
17michman17: posts the ante 500
Monstrson: posts the ante 500
Matzen10: posts the ante 500
lukekus87: posts the ante 500
muskymac23: posts small blind 2000
dim@n.89liza: posts big blind 4000
*** HOLE CARDS ***
Dealt to jcarlos.vale [4d 9c]
jcarlos.vale: folds 
17michman17: folds 
Monstrson: folds 
Matzen10: folds 
lukekus87: calls 4000
Quent Berthe: folds 
muskymac23: calls 2000
dim@n.89liza: checks 
*** FLOP *** [6s 7d Ks]
muskymac23: checks 
dim@n.89liza: checks 
lukekus87: bets 4000
muskymac23: calls 4000
dim@n.89liza: raises 22000 to 26000
lukekus87: folds 
muskymac23: folds 
Uncalled bet (22000) returned to dim@n.89liza
dim@n.89liza collected 28000 from pot
dim@n.89liza: doesn't show handDTO
*** SUMMARY ***
Total pot 28000 | Rake 0 
Board [6s 7d Ks]
Seat 1: Quent Berthe (button) folded before Flop (didn't bet)
Seat 2: muskymac23 (small blind) folded on the Flop
Seat 3: dim@n.89liza (big blind) collected (28000)
Seat 4: jcarlos.vale folded before Flop (didn't bet)
Seat 5: 17michman17 folded before Flop (didn't bet)
Seat 7: Monstrson folded before Flop (didn't bet)
Seat 8: Matzen10 folded before Flop (didn't bet)
Seat 9: lukekus87 folded on the Flop



PokerStars Hand #221911953121: Tournament #3082657132, $0.98+$0.12 USD Hold'em No Limit - Level XXVIII (2400/4800) - 2020/12/27 21:17:20 EET [2020/12/27 14:17:20 ET]
Table '3082657132 62' 9-max Seat #2 is the button
Seat 1: Quent Berthe (160732 in chips) 
Seat 2: muskymac23 (509009 in chips) 
Seat 3: dim@n.89liza (295327 in chips) 
Seat 4: jcarlos.vale (93464 in chips) 
Seat 5: 17michman17 (210442 in chips) 
Seat 7: Monstrson (190904 in chips) 
Seat 8: Matzen10 (323904 in chips) 
Seat 9: lukekus87 (147552 in chips) 
Quent Berthe: posts the ante 600
muskymac23: posts the ante 600
dim@n.89liza: posts the ante 600
jcarlos.vale: posts the ante 600
17michman17: posts the ante 600
Monstrson: posts the ante 600
Matzen10: posts the ante 600
lukekus87: posts the ante 600
dim@n.89liza: posts small blind 2400
jcarlos.vale: posts big blind 4800
*** HOLE CARDS ***
Dealt to jcarlos.vale [9h 6d]
17michman17: calls 4800
Monstrson: folds 
Matzen10: folds 
lukekus87: folds 
Quent Berthe: calls 4800
muskymac23: folds 
dim@n.89liza: raises 31200 to 36000
jcarlos.vale: folds 
17michman17: folds 
Quent Berthe: folds 
Uncalled bet (31200) returned to dim@n.89liza
dim@n.89liza collected 24000 from pot
dim@n.89liza: doesn't show handDTO
*** SUMMARY ***
Total pot 24000 | Rake 0 
Seat 1: Quent Berthe folded before Flop
Seat 2: muskymac23 (button) folded before Flop (didn't bet)
Seat 3: dim@n.89liza (small blind) collected (24000)
Seat 4: jcarlos.vale (big blind) folded before Flop
Seat 5: 17michman17 folded before Flop
Seat 7: Monstrson folded before Flop (didn't bet)
Seat 8: Matzen10 folded before Flop (didn't bet)
Seat 9: lukekus87 folded before Flop (didn't bet)



PokerStars Hand #221911997037: Tournament #3082657132, $0.98+$0.12 USD Hold'em No Limit - Level XXVIII (2400/4800) - 2020/12/27 21:18:08 EET [2020/12/27 14:18:08 ET]
Table '3082657132 62' 9-max Seat #3 is the button
Seat 1: Quent Berthe (155332 in chips) 
Seat 2: muskymac23 (508409 in chips) 
Seat 3: dim@n.89liza (313927 in chips) 
Seat 4: jcarlos.vale (88064 in chips) 
Seat 5: 17michman17 (205042 in chips) 
Seat 7: Monstrson (190304 in chips) 
Seat 8: Matzen10 (323304 in chips) 
Seat 9: lukekus87 (146952 in chips) 
Quent Berthe: posts the ante 600
muskymac23: posts the ante 600
dim@n.89liza: posts the ante 600
jcarlos.vale: posts the ante 600
17michman17: posts the ante 600
Monstrson: posts the ante 600
Matzen10: posts the ante 600
lukekus87: posts the ante 600
jcarlos.vale: posts small blind 2400
17michman17: posts big blind 4800
*** HOLE CARDS ***
Dealt to jcarlos.vale [4h 2c]
Monstrson: folds 
Matzen10: folds 
lukekus87: calls 4800
Quent Berthe: raises 21600 to 26400
muskymac23: folds 
dim@n.89liza: calls 26400
jcarlos.vale: folds 
17michman17: folds 
lukekus87: calls 21600
*** FLOP *** [Qh 6s 9s]
lukekus87: bets 119952 and is all-in
Quent Berthe: folds 
dim@n.89liza: folds 
Uncalled bet (119952) returned to lukekus87
lukekus87 collected 91200 from pot
lukekus87: doesn't show handDTO
*** SUMMARY ***
Total pot 91200 | Rake 0 
Board [Qh 6s 9s]
Seat 1: Quent Berthe folded on the Flop
Seat 2: muskymac23 folded before Flop (didn't bet)
Seat 3: dim@n.89liza (button) folded on the Flop
Seat 4: jcarlos.vale (small blind) folded before Flop
Seat 5: 17michman17 (big blind) folded before Flop
Seat 7: Monstrson folded before Flop (didn't bet)
Seat 8: Matzen10 folded before Flop (didn't bet)
Seat 9: lukekus87 collected (91200)



PokerStars Hand #221912032780: Tournament #3082657132, $0.98+$0.12 USD Hold'em No Limit - Level XXVIII (2400/4800) - 2020/12/27 21:18:47 EET [2020/12/27 14:18:47 ET]
Table '3082657132 62' 9-max Seat #4 is the button
Seat 1: Quent Berthe (128332 in chips) 
Seat 2: muskymac23 (507809 in chips) 
Seat 3: dim@n.89liza (286927 in chips) 
Seat 4: jcarlos.vale (85064 in chips) 
Seat 5: 17michman17 (199642 in chips) 
Seat 7: Monstrson (189704 in chips) 
Seat 8: Matzen10 (322704 in chips) 
Seat 9: lukekus87 (211152 in chips) 
Quent Berthe: posts the ante 600
muskymac23: posts the ante 600
dim@n.89liza: posts the ante 600
jcarlos.vale: posts the ante 600
17michman17: posts the ante 600
Monstrson: posts the ante 600
Matzen10: posts the ante 600
lukekus87: posts the ante 600
17michman17: posts small blind 2400
Monstrson: posts big blind 4800
*** HOLE CARDS ***
Dealt to jcarlos.vale [5s 3s]
Matzen10: folds 
lukekus87: folds 
Quent Berthe: raises 16800 to 21600
muskymac23: folds 
dim@n.89liza: raises 264727 to 286327 and is all-in
jcarlos.vale: folds 
17michman17: folds 
Monstrson: folds 
Quent Berthe: calls 106132 and is all-in
Uncalled bet (158595) returned to dim@n.89liza
*** FLOP *** [6d Qs 6h]
*** TURN *** [6d Qs 6h] [Qh]
*** RIVER *** [6d Qs 6h Qh] [9h]
*** SHOW DOWN ***
Quent Berthe: shows [Kh Jh] (a flush, King high)
dim@n.89liza: shows [As Kc] (two pair, Queens and Sixes)
Quent Berthe collected 267464 from pot
*** SUMMARY ***
Total pot 267464 | Rake 0 
Board [6d Qs 6h Qh 9h]
Seat 1: Quent Berthe showed [Kh Jh] and won (267464) with a flush, King high
Seat 2: muskymac23 folded before Flop (didn't bet)
Seat 3: dim@n.89liza showed [As Kc] and lost with two pair, Queens and Sixes
Seat 4: jcarlos.vale (button) folded before Flop (didn't bet)
Seat 5: 17michman17 (small blind) folded before Flop
Seat 7: Monstrson (big blind) folded before Flop
Seat 8: Matzen10 folded before Flop (didn't bet)
Seat 9: lukekus87 folded before Flop (didn't bet)



PokerStars Hand #221912073223: Tournament #3082657132, $0.98+$0.12 USD Hold'em No Limit - Level XXVIII (2400/4800) - 2020/12/27 21:19:31 EET [2020/12/27 14:19:31 ET]
Table '3082657132 62' 9-max Seat #5 is the button
Seat 1: Quent Berthe (267464 in chips) 
Seat 2: muskymac23 (507209 in chips) 
Seat 3: dim@n.89liza (158595 in chips) 
Seat 4: jcarlos.vale (84464 in chips) 
Seat 5: 17michman17 (196642 in chips) 
Seat 7: Monstrson (184304 in chips) 
Seat 8: Matzen10 (322104 in chips) 
Seat 9: lukekus87 (210552 in chips) 
Quent Berthe: posts the ante 600
muskymac23: posts the ante 600
dim@n.89liza: posts the ante 600
jcarlos.vale: posts the ante 600
17michman17: posts the ante 600
Monstrson: posts the ante 600
Matzen10: posts the ante 600
lukekus87: posts the ante 600
Monstrson: posts small blind 2400
Matzen10: posts big blind 4800
*** HOLE CARDS ***
Dealt to jcarlos.vale [5s Qh]
lukekus87: folds 
Quent Berthe: folds 
muskymac23: folds 
dim@n.89liza: folds 
jcarlos.vale: folds 
17michman17: calls 4800
Monstrson: calls 2400
Matzen10: checks 
*** FLOP *** [9h 8d Jc]
Monstrson: checks 
Matzen10: checks 
17michman17: bets 19200
Monstrson: folds 
Matzen10: folds 
Uncalled bet (19200) returned to 17michman17
17michman17 collected 19200 from pot
17michman17: doesn't show handDTO
*** SUMMARY ***
Total pot 19200 | Rake 0 
Board [9h 8d Jc]
Seat 1: Quent Berthe folded before Flop (didn't bet)
Seat 2: muskymac23 folded before Flop (didn't bet)
Seat 3: dim@n.89liza folded before Flop (didn't bet)
Seat 4: jcarlos.vale folded before Flop (didn't bet)
Seat 5: 17michman17 (button) collected (19200)
Seat 7: Monstrson (small blind) folded on the Flop
Seat 8: Matzen10 (big blind) folded on the Flop
Seat 9: lukekus87 folded before Flop (didn't bet)



PokerStars Hand #221912115014: Tournament #3082657132, $0.98+$0.12 USD Hold'em No Limit - Level XXVIII (2400/4800) - 2020/12/27 21:20:16 EET [2020/12/27 14:20:16 ET]
Table '3082657132 62' 9-max Seat #7 is the button
Seat 1: Quent Berthe (266864 in chips) 
Seat 2: muskymac23 (506609 in chips) 
Seat 3: dim@n.89liza (157995 in chips) 
Seat 4: jcarlos.vale (83864 in chips) 
Seat 5: 17michman17 (210442 in chips) 
Seat 6: dihalves13 (66942 in chips) 
Seat 7: Monstrson (178904 in chips) 
Seat 8: Matzen10 (316704 in chips) 
Seat 9: lukekus87 (209952 in chips) 
Quent Berthe: posts the ante 600
muskymac23: posts the ante 600
dim@n.89liza: posts the ante 600
jcarlos.vale: posts the ante 600
17michman17: posts the ante 600
dihalves13: posts the ante 600
Monstrson: posts the ante 600
Matzen10: posts the ante 600
lukekus87: posts the ante 600
Matzen10: posts small blind 2400
lukekus87: posts big blind 4800
*** HOLE CARDS ***
Dealt to jcarlos.vale [4c 5d]
Quent Berthe: folds 
muskymac23: folds 
dim@n.89liza: folds 
jcarlos.vale: folds 
17michman17: folds 
dihalves13 has timed out
dihalves13: folds 
dihalves13 is sitting out
dihalves13 has returned
Monstrson: folds 
Matzen10: folds 
Uncalled bet (2400) returned to lukekus87
lukekus87 collected 10200 from pot
lukekus87: doesn't show handDTO
*** SUMMARY ***
Total pot 10200 | Rake 0 
Seat 1: Quent Berthe folded before Flop (didn't bet)
Seat 2: muskymac23 folded before Flop (didn't bet)
Seat 3: dim@n.89liza folded before Flop (didn't bet)
Seat 4: jcarlos.vale folded before Flop (didn't bet)
Seat 5: 17michman17 folded before Flop (didn't bet)
Seat 6: dihalves13 folded before Flop (didn't bet)
Seat 7: Monstrson (button) folded before Flop (didn't bet)
Seat 8: Matzen10 (small blind) folded before Flop
Seat 9: lukekus87 (big blind) collected (10200)



PokerStars Hand #221912161245: Tournament #3082657132, $0.98+$0.12 USD Hold'em No Limit - Level XXVIII (2400/4800) - 2020/12/27 21:21:07 EET [2020/12/27 14:21:07 ET]
Table '3082657132 62' 9-max Seat #8 is the button
Seat 1: Quent Berthe (266264 in chips) 
Seat 2: muskymac23 (506009 in chips) 
Seat 3: dim@n.89liza (157395 in chips) 
Seat 4: jcarlos.vale (83264 in chips) 
Seat 5: 17michman17 (209842 in chips) 
Seat 6: dihalves13 (66342 in chips) 
Seat 7: Monstrson (178304 in chips) 
Seat 8: Matzen10 (313704 in chips) 
Seat 9: lukekus87 (217152 in chips) 
Quent Berthe: posts the ante 600
muskymac23: posts the ante 600
dim@n.89liza: posts the ante 600
jcarlos.vale: posts the ante 600
17michman17: posts the ante 600
dihalves13: posts the ante 600
Monstrson: posts the ante 600
Matzen10: posts the ante 600
lukekus87: posts the ante 600
lukekus87: posts small blind 2400
Quent Berthe: posts big blind 4800
*** HOLE CARDS ***
Dealt to jcarlos.vale [6s 6h]
muskymac23: folds 
dim@n.89liza: raises 9600 to 14400
jcarlos.vale: raises 68264 to 82664 and is all-in
17michman17: folds 
dihalves13: folds 
Monstrson: folds 
Matzen10: folds 
lukekus87: folds 
Quent Berthe: folds 
dim@n.89liza: folds 
Uncalled bet (68264) returned to jcarlos.vale
jcarlos.vale collected 41400 from pot
jcarlos.vale: doesn't show handDTO
*** SUMMARY ***
Total pot 41400 | Rake 0 
Seat 1: Quent Berthe (big blind) folded before Flop
Seat 2: muskymac23 folded before Flop (didn't bet)
Seat 3: dim@n.89liza folded before Flop
Seat 4: jcarlos.vale collected (41400)
Seat 5: 17michman17 folded before Flop (didn't bet)
Seat 6: dihalves13 folded before Flop (didn't bet)
Seat 7: Monstrson folded before Flop (didn't bet)
Seat 8: Matzen10 (button) folded before Flop (didn't bet)
Seat 9: lukekus87 (small blind) folded before Flop



PokerStars Hand #221912180288: Tournament #3082657132, $0.98+$0.12 USD Hold'em No Limit - Level XXVIII (2400/4800) - 2020/12/27 21:21:27 EET [2020/12/27 14:21:27 ET]
Table '3082657132 62' 9-max Seat #9 is the button
Seat 1: Quent Berthe (260864 in chips) 
Seat 2: muskymac23 (505409 in chips) 
Seat 3: dim@n.89liza (142395 in chips) 
Seat 4: jcarlos.vale (109664 in chips) 
Seat 5: 17michman17 (209242 in chips) 
Seat 6: dihalves13 (65742 in chips) 
Seat 7: Monstrson (177704 in chips) 
Seat 8: Matzen10 (313104 in chips) 
Seat 9: lukekus87 (214152 in chips) 
Quent Berthe: posts the ante 600
muskymac23: posts the ante 600
dim@n.89liza: posts the ante 600
jcarlos.vale: posts the ante 600
17michman17: posts the ante 600
dihalves13: posts the ante 600
Monstrson: posts the ante 600
Matzen10: posts the ante 600
lukekus87: posts the ante 600
Quent Berthe: posts small blind 2400
muskymac23: posts big blind 4800
*** HOLE CARDS ***
Dealt to jcarlos.vale [9s 2d]
dim@n.89liza: raises 9600 to 14400
jcarlos.vale: folds 
17michman17: folds 
dihalves13: folds 
Monstrson: folds 
Matzen10: folds 
lukekus87: folds 
Quent Berthe: folds 
muskymac23: raises 28800 to 43200
dim@n.89liza: calls 28800
*** FLOP *** [9c 2s 9h]
muskymac23: bets 461609 and is all-in
dim@n.89liza: calls 98595 and is all-in
Uncalled bet (363014) returned to muskymac23
*** TURN *** [9c 2s 9h] [Td]
*** RIVER *** [9c 2s 9h Td] [6h]
*** SHOW DOWN ***
muskymac23: shows [Kd Kc] (two pair, Kings and Nines)
dim@n.89liza: shows [As 2h] (two pair, Nines and Deuces)
muskymac23 collected 291390 from pot
dim@n.89liza finished the tournament in 52nd place and received $6.24.
*** SUMMARY ***
Total pot 291390 | Rake 0 
Board [9c 2s 9h Td 6h]
Seat 1: Quent Berthe (small blind) folded before Flop
Seat 2: muskymac23 (big blind) showed [Kd Kc] and won (291390) with two pair, Kings and Nines
Seat 3: dim@n.89liza showed [As 2h] and lost with two pair, Nines and Deuces
Seat 4: jcarlos.vale folded before Flop (didn't bet)
Seat 5: 17michman17 folded before Flop (didn't bet)
Seat 6: dihalves13 folded before Flop (didn't bet)
Seat 7: Monstrson folded before Flop (didn't bet)
Seat 8: Matzen10 folded before Flop (didn't bet)
Seat 9: lukekus87 (button) folded before Flop (didn't bet)



PokerStars Hand #221912235391: Tournament #3082657132, $0.98+$0.12 USD Hold'em No Limit - Level XXVIII (2400/4800) - 2020/12/27 21:22:27 EET [2020/12/27 14:22:27 ET]
Table '3082657132 62' 9-max Seat #1 is the button
Seat 1: Quent Berthe (257864 in chips) 
Seat 2: muskymac23 (654404 in chips) 
Seat 4: jcarlos.vale (109064 in chips) 
Seat 5: 17michman17 (208642 in chips) 
Seat 6: dihalves13 (65142 in chips) 
Seat 7: Monstrson (177104 in chips) 
Seat 8: Matzen10 (312504 in chips) 
Seat 9: lukekus87 (213552 in chips) 
Quent Berthe: posts the ante 600
muskymac23: posts the ante 600
jcarlos.vale: posts the ante 600
17michman17: posts the ante 600
dihalves13: posts the ante 600
Monstrson: posts the ante 600
Matzen10: posts the ante 600
lukekus87: posts the ante 600
muskymac23: posts small blind 2400
jcarlos.vale: posts big blind 4800
*** HOLE CARDS ***
Dealt to jcarlos.vale [Ks Jh]
17michman17: folds 
dihalves13: folds 
Monstrson: raises 4800 to 9600
Matzen10: folds 
lukekus87: folds 
Quent Berthe: raises 247664 to 257264 and is all-in
muskymac23: folds 
jcarlos.vale: folds 
Monstrson: folds 
Uncalled bet (247664) returned to Quent Berthe
Quent Berthe collected 31200 from pot
*** SUMMARY ***
Total pot 31200 | Rake 0 
Seat 1: Quent Berthe (button) collected (31200)
Seat 2: muskymac23 (small blind) folded before Flop
Seat 4: jcarlos.vale (big blind) folded before Flop
Seat 5: 17michman17 folded before Flop (didn't bet)
Seat 6: dihalves13 folded before Flop (didn't bet)
Seat 7: Monstrson folded before Flop
Seat 8: Matzen10 folded before Flop (didn't bet)
Seat 9: lukekus87 folded before Flop (didn't bet)



PokerStars Hand #221912258519: Tournament #3082657132, $0.98+$0.12 USD Hold'em No Limit - Level XXVIII (2400/4800) - 2020/12/27 21:22:53 EET [2020/12/27 14:22:53 ET]
Table '3082657132 62' 9-max Seat #2 is the button
Seat 1: Quent Berthe (278864 in chips) 
Seat 2: muskymac23 (651404 in chips) 
Seat 4: jcarlos.vale (103664 in chips) 
Seat 5: 17michman17 (208042 in chips) 
Seat 6: dihalves13 (64542 in chips) 
Seat 7: Monstrson (166904 in chips) 
Seat 8: Matzen10 (311904 in chips) 
Seat 9: lukekus87 (212952 in chips) 
Quent Berthe: posts the ante 600
muskymac23: posts the ante 600
jcarlos.vale: posts the ante 600
17michman17: posts the ante 600
dihalves13: posts the ante 600
Monstrson: posts the ante 600
Matzen10: posts the ante 600
lukekus87: posts the ante 600
jcarlos.vale: posts small blind 2400
17michman17: posts big blind 4800
*** HOLE CARDS ***
Dealt to jcarlos.vale [2c 5h]
dihalves13: folds 
Monstrson: folds 
Matzen10: raises 4800 to 9600
lukekus87: folds 
Quent Berthe: folds 
muskymac23: folds 
jcarlos.vale: folds 
17michman17: calls 4800
*** FLOP *** [Ad 5d 9h]
17michman17: bets 9600
Matzen10: calls 9600
*** TURN *** [Ad 5d 9h] [Jh]
17michman17: bets 22800
Matzen10: calls 22800
*** RIVER *** [Ad 5d 9h Jh] [7h]
17michman17: bets 52800
Matzen10: calls 52800
*** SHOW DOWN ***
17michman17: shows [9c 4d] (a pair of Nines)
Matzen10: shows [Ac Th] (a pair of Aces)
Matzen10 collected 196800 from pot
*** SUMMARY ***
Total pot 196800 | Rake 0 
Board [Ad 5d 9h Jh 7h]
Seat 1: Quent Berthe folded before Flop (didn't bet)
Seat 2: muskymac23 (button) folded before Flop (didn't bet)
Seat 4: jcarlos.vale (small blind) folded before Flop
Seat 5: 17michman17 (big blind) showed [9c 4d] and lost with a pair of Nines
Seat 6: dihalves13 folded before Flop (didn't bet)
Seat 7: Monstrson folded before Flop (didn't bet)
Seat 8: Matzen10 showed [Ac Th] and won (196800) with a pair of Aces
Seat 9: lukekus87 folded before Flop (didn't bet)



PokerStars Hand #221912314517: Tournament #3082657132, $0.98+$0.12 USD Hold'em No Limit - Level XXVIII (2400/4800) - 2020/12/27 21:23:54 EET [2020/12/27 14:23:54 ET]
Table '3082657132 62' 9-max Seat #4 is the button
Seat 1: Quent Berthe (278264 in chips) 
Seat 2: muskymac23 (650804 in chips) 
Seat 4: jcarlos.vale (100664 in chips) 
Seat 5: 17michman17 (112642 in chips) 
Seat 6: dihalves13 (63942 in chips) 
Seat 7: Monstrson (166304 in chips) 
Seat 8: Matzen10 (413304 in chips) 
Seat 9: lukekus87 (212352 in chips) 
Quent Berthe: posts the ante 600
muskymac23: posts the ante 600
jcarlos.vale: posts the ante 600
17michman17: posts the ante 600
dihalves13: posts the ante 600
Monstrson: posts the ante 600
Matzen10: posts the ante 600
lukekus87: posts the ante 600
17michman17: posts small blind 2400
dihalves13: posts big blind 4800
*** HOLE CARDS ***
Dealt to jcarlos.vale [5h 9s]
Monstrson: folds 
Matzen10: folds 
lukekus87: folds 
Quent Berthe: folds 
muskymac23: folds 
jcarlos.vale: folds 
17michman17: calls 2400
dihalves13: raises 58542 to 63342 and is all-in
17michman17: folds 
Uncalled bet (58542) returned to dihalves13
dihalves13 collected 14400 from pot
dihalves13: doesn't show handDTO
*** SUMMARY ***
Total pot 14400 | Rake 0 
Seat 1: Quent Berthe folded before Flop (didn't bet)
Seat 2: muskymac23 folded before Flop (didn't bet)
Seat 4: jcarlos.vale (button) folded before Flop (didn't bet)
Seat 5: 17michman17 (small blind) folded before Flop
Seat 6: dihalves13 (big blind) collected (14400)
Seat 7: Monstrson folded before Flop (didn't bet)
Seat 8: Matzen10 folded before Flop (didn't bet)
Seat 9: lukekus87 folded before Flop (didn't bet)



PokerStars Hand #221912332778: Tournament #3082657132, $0.98+$0.12 USD Hold'em No Limit - Level XXVIII (2400/4800) - 2020/12/27 21:24:14 EET [2020/12/27 14:24:14 ET]
Table '3082657132 62' 9-max Seat #5 is the button
Seat 1: Quent Berthe (277664 in chips) 
Seat 2: muskymac23 (650204 in chips) 
Seat 4: jcarlos.vale (100064 in chips) 
Seat 5: 17michman17 (107242 in chips) 
Seat 6: dihalves13 (72942 in chips) 
Seat 7: Monstrson (165704 in chips) 
Seat 8: Matzen10 (412704 in chips) 
Seat 9: lukekus87 (211752 in chips) 
Quent Berthe: posts the ante 600
muskymac23: posts the ante 600
jcarlos.vale: posts the ante 600
17michman17: posts the ante 600
dihalves13: posts the ante 600
Monstrson: posts the ante 600
Matzen10: posts the ante 600
lukekus87: posts the ante 600
dihalves13: posts small blind 2400
Monstrson: posts big blind 4800
*** HOLE CARDS ***
Dealt to jcarlos.vale [Jc 3d]
Matzen10: folds 
lukekus87: folds 
Quent Berthe: folds 
muskymac23: folds 
jcarlos.vale: folds 
17michman17: folds 
dihalves13: calls 2400
Monstrson: raises 160304 to 165104 and is all-in
dihalves13: folds 
Uncalled bet (160304) returned to Monstrson
Monstrson collected 14400 from pot
*** SUMMARY ***
Total pot 14400 | Rake 0 
Seat 1: Quent Berthe folded before Flop (didn't bet)
Seat 2: muskymac23 folded before Flop (didn't bet)
Seat 4: jcarlos.vale folded before Flop (didn't bet)
Seat 5: 17michman17 (button) folded before Flop (didn't bet)
Seat 6: dihalves13 (small blind) folded before Flop
Seat 7: Monstrson (big blind) collected (14400)
Seat 8: Matzen10 folded before Flop (didn't bet)
Seat 9: lukekus87 folded before Flop (didn't bet)



PokerStars Hand #221912360143: Tournament #3082657132, $0.98+$0.12 USD Hold'em No Limit - Level XXVIII (2400/4800) - 2020/12/27 21:24:43 EET [2020/12/27 14:24:43 ET]
Table '3082657132 62' 9-max Seat #6 is the button
Seat 1: Quent Berthe (277064 in chips) 
Seat 2: muskymac23 (649604 in chips) 
Seat 4: jcarlos.vale (99464 in chips) 
Seat 5: 17michman17 (106642 in chips) 
Seat 6: dihalves13 (67542 in chips) 
Seat 7: Monstrson (174704 in chips) 
Seat 8: Matzen10 (412104 in chips) 
Seat 9: lukekus87 (211152 in chips) 
Quent Berthe: posts the ante 600
muskymac23: posts the ante 600
jcarlos.vale: posts the ante 600
17michman17: posts the ante 600
dihalves13: posts the ante 600
Monstrson: posts the ante 600
Matzen10: posts the ante 600
lukekus87: posts the ante 600
Monstrson: posts small blind 2400
Matzen10: posts big blind 4800
*** HOLE CARDS ***
Dealt to jcarlos.vale [5s 2h]
lukekus87: folds 
Quent Berthe: folds 
muskymac23: folds 
jcarlos.vale: folds 
17michman17: raises 9600 to 14400
dihalves13: folds 
Monstrson: folds 
Matzen10: folds 
Uncalled bet (9600) returned to 17michman17
17michman17 collected 16800 from pot
17michman17: doesn't show handDTO
*** SUMMARY ***
Total pot 16800 | Rake 0 
Seat 1: Quent Berthe folded before Flop (didn't bet)
Seat 2: muskymac23 folded before Flop (didn't bet)
Seat 4: jcarlos.vale folded before Flop (didn't bet)
Seat 5: 17michman17 collected (16800)
Seat 6: dihalves13 (button) folded before Flop (didn't bet)
Seat 7: Monstrson (small blind) folded before Flop
Seat 8: Matzen10 (big blind) folded before Flop
Seat 9: lukekus87 folded before Flop (didn't bet)



PokerStars Hand #221912380122: Tournament #3082657132, $0.98+$0.12 USD Hold'em No Limit - Level XXVIII (2400/4800) - 2020/12/27 21:25:05 EET [2020/12/27 14:25:05 ET]
Table '3082657132 62' 9-max Seat #7 is the button
Seat 1: Quent Berthe (276464 in chips) 
Seat 2: muskymac23 (649004 in chips) 
Seat 4: jcarlos.vale (98864 in chips) 
Seat 5: 17michman17 (118042 in chips) 
Seat 6: dihalves13 (66942 in chips) 
Seat 7: Monstrson (171704 in chips) 
Seat 8: Matzen10 (406704 in chips) 
Seat 9: lukekus87 (210552 in chips) 
Quent Berthe: posts the ante 600
muskymac23: posts the ante 600
jcarlos.vale: posts the ante 600
17michman17: posts the ante 600
dihalves13: posts the ante 600
Monstrson: posts the ante 600
Matzen10: posts the ante 600
lukekus87: posts the ante 600
Matzen10: posts small blind 2400
lukekus87: posts big blind 4800
*** HOLE CARDS ***
Dealt to jcarlos.vale [7d 9s]
Quent Berthe: raises 4800 to 9600
muskymac23: folds 
jcarlos.vale: folds 
17michman17: folds 
dihalves13: folds 
Monstrson: folds 
Matzen10: folds 
lukekus87: calls 4800
*** FLOP *** [6c Ac Ah]
lukekus87: checks 
Quent Berthe: checks 
*** TURN *** [6c Ac Ah] [8s]
lukekus87: bets 4800
Quent Berthe: folds 
Uncalled bet (4800) returned to lukekus87
lukekus87 collected 26400 from pot
lukekus87: doesn't show handDTO
*** SUMMARY ***
Total pot 26400 | Rake 0 
Board [6c Ac Ah 8s]
Seat 1: Quent Berthe folded on the Turn
Seat 2: muskymac23 folded before Flop (didn't bet)
Seat 4: jcarlos.vale folded before Flop (didn't bet)
Seat 5: 17michman17 folded before Flop (didn't bet)
Seat 6: dihalves13 folded before Flop (didn't bet)
Seat 7: Monstrson (button) folded before Flop (didn't bet)
Seat 8: Matzen10 (small blind) folded before Flop
Seat 9: lukekus87 (big blind) collected (26400)



PokerStars Hand #221912414556: Tournament #3082657132, $0.98+$0.12 USD Hold'em No Limit - Level XXVIII (2400/4800) - 2020/12/27 21:25:39 EET [2020/12/27 14:25:39 ET]
Table '3082657132 62' 9-max Seat #8 is the button
Seat 1: Quent Berthe (266264 in chips) 
Seat 2: muskymac23 (648404 in chips) 
Seat 4: jcarlos.vale (98264 in chips) 
Seat 5: 17michman17 (117442 in chips) 
Seat 6: dihalves13 (66342 in chips) 
Seat 7: Monstrson (171104 in chips) 
Seat 8: Matzen10 (403704 in chips) 
Seat 9: lukekus87 (226752 in chips) 
Quent Berthe: posts the ante 600
muskymac23: posts the ante 600
jcarlos.vale: posts the ante 600
17michman17: posts the ante 600
dihalves13: posts the ante 600
Monstrson: posts the ante 600
Matzen10: posts the ante 600
lukekus87: posts the ante 600
lukekus87: posts small blind 2400
Quent Berthe: posts big blind 4800
*** HOLE CARDS ***
Dealt to jcarlos.vale [Qc 4h]
muskymac23: folds 
jcarlos.vale: folds 
17michman17: raises 4800 to 9600
dihalves13: folds 
Monstrson: folds 
Matzen10: folds 
lukekus87: folds 
Quent Berthe: folds 
Uncalled bet (4800) returned to 17michman17
17michman17 collected 16800 from pot
17michman17: doesn't show handDTO
*** SUMMARY ***
Total pot 16800 | Rake 0 
Seat 1: Quent Berthe (big blind) folded before Flop
Seat 2: muskymac23 folded before Flop (didn't bet)
Seat 4: jcarlos.vale folded before Flop (didn't bet)
Seat 5: 17michman17 collected (16800)
Seat 6: dihalves13 folded before Flop (didn't bet)
Seat 7: Monstrson folded before Flop (didn't bet)
Seat 8: Matzen10 (button) folded before Flop (didn't bet)
Seat 9: lukekus87 (small blind) folded before Flop



PokerStars Hand #221912428242: Tournament #3082657132, $0.98+$0.12 USD Hold'em No Limit - Level XXVIII (2400/4800) - 2020/12/27 21:25:54 EET [2020/12/27 14:25:54 ET]
Table '3082657132 62' 9-max Seat #9 is the button
Seat 1: Quent Berthe (260864 in chips) 
Seat 2: muskymac23 (647804 in chips) 
Seat 4: jcarlos.vale (97664 in chips) 
Seat 5: 17michman17 (128842 in chips) 
Seat 6: dihalves13 (65742 in chips) 
Seat 7: Monstrson (170504 in chips) 
Seat 8: Matzen10 (403104 in chips) 
Seat 9: lukekus87 (223752 in chips) 
Quent Berthe: posts the ante 600
muskymac23: posts the ante 600
jcarlos.vale: posts the ante 600
17michman17: posts the ante 600
dihalves13: posts the ante 600
Monstrson: posts the ante 600
Matzen10: posts the ante 600
lukekus87: posts the ante 600
Quent Berthe: posts small blind 2400
muskymac23: posts big blind 4800
*** HOLE CARDS ***
Dealt to jcarlos.vale [8s 7s]
jcarlos.vale: raises 7680 to 12480
17michman17: folds 
dihalves13: calls 12480
Monstrson: folds 
Matzen10: folds 
lukekus87: folds 
Quent Berthe: folds 
muskymac23: calls 7680
*** FLOP *** [8c 6d 4d]
muskymac23: checks 
jcarlos.vale: bets 84584 and is all-in
dihalves13: folds 
muskymac23: folds 
Uncalled bet (84584) returned to jcarlos.vale
jcarlos.vale collected 44640 from pot
jcarlos.vale: doesn't show handDTO
*** SUMMARY ***
Total pot 44640 | Rake 0 
Board [8c 6d 4d]
Seat 1: Quent Berthe (small blind) folded before Flop
Seat 2: muskymac23 (big blind) folded on the Flop
Seat 4: jcarlos.vale collected (44640)
Seat 5: 17michman17 folded before Flop (didn't bet)
Seat 6: dihalves13 folded on the Flop
Seat 7: Monstrson folded before Flop (didn't bet)
Seat 8: Matzen10 folded before Flop (didn't bet)
Seat 9: lukekus87 (button) folded before Flop (didn't bet)



PokerStars Hand #221912469254: Tournament #3082657132, $0.98+$0.12 USD Hold'em No Limit - Level XXVIII (2400/4800) - 2020/12/27 21:26:39 EET [2020/12/27 14:26:39 ET]
Table '3082657132 62' 9-max Seat #1 is the button
Seat 1: Quent Berthe (257864 in chips) 
Seat 2: muskymac23 (634724 in chips) 
Seat 4: jcarlos.vale (129224 in chips) 
Seat 5: 17michman17 (128242 in chips) 
Seat 6: dihalves13 (52662 in chips) 
Seat 7: Monstrson (169904 in chips) 
Seat 8: Matzen10 (402504 in chips) 
Seat 9: lukekus87 (223152 in chips) 
Quent Berthe: posts the ante 600
muskymac23: posts the ante 600
jcarlos.vale: posts the ante 600
17michman17: posts the ante 600
dihalves13: posts the ante 600
Monstrson: posts the ante 600
Matzen10: posts the ante 600
lukekus87: posts the ante 600
muskymac23: posts small blind 2400
jcarlos.vale: posts big blind 4800
*** HOLE CARDS ***
Dealt to jcarlos.vale [Qc 4c]
17michman17: folds 
dihalves13: calls 4800
Monstrson: folds 
Matzen10: folds 
lukekus87: folds 
Quent Berthe: raises 21600 to 26400
muskymac23: folds 
jcarlos.vale: folds 
dihalves13: calls 21600
*** FLOP *** [3h Jd Js]
dihalves13: checks 
Quent Berthe: bets 32400
dihalves13: folds 
Uncalled bet (32400) returned to Quent Berthe
Quent Berthe collected 64800 from pot
*** SUMMARY ***
Total pot 64800 | Rake 0 
Board [3h Jd Js]
Seat 1: Quent Berthe (button) collected (64800)
Seat 2: muskymac23 (small blind) folded before Flop
Seat 4: jcarlos.vale (big blind) folded before Flop
Seat 5: 17michman17 folded before Flop (didn't bet)
Seat 6: dihalves13 folded on the Flop
Seat 7: Monstrson folded before Flop (didn't bet)
Seat 8: Matzen10 folded before Flop (didn't bet)
Seat 9: lukekus87 folded before Flop (didn't bet)



PokerStars Hand #221912508470: Tournament #3082657132, $0.98+$0.12 USD Hold'em No Limit - Level XXIX (2800/5600) - 2020/12/27 21:27:22 EET [2020/12/27 14:27:22 ET]
Table '3082657132 62' 9-max Seat #2 is the button
Seat 1: Quent Berthe (295664 in chips) 
Seat 2: muskymac23 (631724 in chips) 
Seat 4: jcarlos.vale (123824 in chips) 
Seat 5: 17michman17 (127642 in chips) 
Seat 6: dihalves13 (25662 in chips) 
Seat 7: Monstrson (169304 in chips) 
Seat 8: Matzen10 (401904 in chips) 
Seat 9: lukekus87 (222552 in chips) 
Quent Berthe: posts the ante 700
muskymac23: posts the ante 700
jcarlos.vale: posts the ante 700
17michman17: posts the ante 700
dihalves13: posts the ante 700
Monstrson: posts the ante 700
Matzen10: posts the ante 700
lukekus87: posts the ante 700
jcarlos.vale: posts small blind 2800
17michman17: posts big blind 5600
*** HOLE CARDS ***
Dealt to jcarlos.vale [Qc Ks]
dihalves13: folds 
Monstrson: raises 5600 to 11200
Matzen10: folds 
lukekus87: folds 
Quent Berthe: folds 
muskymac23: folds 
jcarlos.vale: calls 8400
17michman17: calls 5600
*** FLOP *** [Td 5d Kc]
jcarlos.vale: bets 29400
17michman17: folds 
Monstrson: folds 
Uncalled bet (29400) returned to jcarlos.vale
jcarlos.vale collected 39200 from pot
jcarlos.vale: doesn't show handDTO
*** SUMMARY ***
Total pot 39200 | Rake 0 
Board [Td 5d Kc]
Seat 1: Quent Berthe folded before Flop (didn't bet)
Seat 2: muskymac23 (button) folded before Flop (didn't bet)
Seat 4: jcarlos.vale (small blind) collected (39200)
Seat 5: 17michman17 (big blind) folded on the Flop
Seat 6: dihalves13 folded before Flop (didn't bet)
Seat 7: Monstrson folded on the Flop
Seat 8: Matzen10 folded before Flop (didn't bet)
Seat 9: lukekus87 folded before Flop (didn't bet)



PokerStars Hand #221912542040: Tournament #3082657132, $0.98+$0.12 USD Hold'em No Limit - Level XXIX (2800/5600) - 2020/12/27 21:28:00 EET [2020/12/27 14:28:00 ET]
Table '3082657132 62' 9-max Seat #4 is the button
Seat 1: Quent Berthe (294964 in chips) 
Seat 2: muskymac23 (631024 in chips) 
Seat 4: jcarlos.vale (151124 in chips) 
Seat 5: 17michman17 (115742 in chips) 
Seat 6: dihalves13 (24962 in chips) 
Seat 7: Monstrson (157404 in chips) 
Seat 8: Matzen10 (401204 in chips) 
Seat 9: lukekus87 (221852 in chips) 
Quent Berthe: posts the ante 700
muskymac23: posts the ante 700
jcarlos.vale: posts the ante 700
17michman17: posts the ante 700
dihalves13: posts the ante 700
Monstrson: posts the ante 700
Matzen10: posts the ante 700
lukekus87: posts the ante 700
17michman17: posts small blind 2800
dihalves13: posts big blind 5600
*** HOLE CARDS ***
Dealt to jcarlos.vale [5h 9s]
Monstrson: folds 
Matzen10: folds 
lukekus87: folds 
Quent Berthe: folds 
muskymac23: folds 
jcarlos.vale: folds 
17michman17: raises 16800 to 22400
dihalves13: folds 
Uncalled bet (16800) returned to 17michman17
17michman17 collected 16800 from pot
17michman17: doesn't show handDTO
*** SUMMARY ***
Total pot 16800 | Rake 0 
Seat 1: Quent Berthe folded before Flop (didn't bet)
Seat 2: muskymac23 folded before Flop (didn't bet)
Seat 4: jcarlos.vale (button) folded before Flop (didn't bet)
Seat 5: 17michman17 (small blind) collected (16800)
Seat 6: dihalves13 (big blind) folded before Flop
Seat 7: Monstrson folded before Flop (didn't bet)
Seat 8: Matzen10 folded before Flop (didn't bet)
Seat 9: lukekus87 folded before Flop (didn't bet)



PokerStars Hand #221912571517: Tournament #3082657132, $0.98+$0.12 USD Hold'em No Limit - Level XXIX (2800/5600) - 2020/12/27 21:28:32 EET [2020/12/27 14:28:32 ET]
Table '3082657132 62' 9-max Seat #5 is the button
Seat 1: Quent Berthe (294264 in chips) 
Seat 2: muskymac23 (630324 in chips) 
Seat 3: stratos0071 (303630 in chips) 
Seat 4: jcarlos.vale (150424 in chips) 
Seat 5: 17michman17 (126242 in chips) 
Seat 6: dihalves13 (18662 in chips) 
Seat 7: Monstrson (156704 in chips) 
Seat 8: Matzen10 (400504 in chips) 
Seat 9: lukekus87 (221152 in chips) 
Quent Berthe: posts the ante 700
muskymac23: posts the ante 700
stratos0071: posts the ante 700
jcarlos.vale: posts the ante 700
17michman17: posts the ante 700
dihalves13: posts the ante 700
Monstrson: posts the ante 700
Matzen10: posts the ante 700
lukekus87: posts the ante 700
dihalves13: posts small blind 2800
Monstrson: posts big blind 5600
*** HOLE CARDS ***
Dealt to jcarlos.vale [7h Ah]
Matzen10: folds 
lukekus87: folds 
Quent Berthe: raises 5600 to 11200
muskymac23: folds 
stratos0071: folds 
jcarlos.vale: calls 11200
17michman17: folds 
dihalves13: folds 
Monstrson: folds 
*** FLOP *** [3d 5d 7c]
Quent Berthe: bets 18550
jcarlos.vale: raises 119974 to 138524 and is all-in
Quent Berthe: folds 
Uncalled bet (119974) returned to jcarlos.vale
jcarlos.vale collected 74200 from pot
jcarlos.vale: doesn't show handDTO
*** SUMMARY ***
Total pot 74200 | Rake 0 
Board [3d 5d 7c]
Seat 1: Quent Berthe folded on the Flop
Seat 2: muskymac23 folded before Flop (didn't bet)
Seat 3: stratos0071 folded before Flop (didn't bet)
Seat 4: jcarlos.vale collected (74200)
Seat 5: 17michman17 (button) folded before Flop (didn't bet)
Seat 6: dihalves13 (small blind) folded before Flop
Seat 7: Monstrson (big blind) folded before Flop
Seat 8: Matzen10 folded before Flop (didn't bet)
Seat 9: lukekus87 folded before Flop (didn't bet)



PokerStars Hand #221912598610: Tournament #3082657132, $0.98+$0.12 USD Hold'em No Limit - Level XXIX (2800/5600) - 2020/12/27 21:29:02 EET [2020/12/27 14:29:02 ET]
Table '3082657132 62' 9-max Seat #6 is the button
Seat 1: Quent Berthe (263814 in chips) 
Seat 2: muskymac23 (629624 in chips) 
Seat 3: stratos0071 (302930 in chips) 
Seat 4: jcarlos.vale (194174 in chips) 
Seat 5: 17michman17 (125542 in chips) 
Seat 6: dihalves13 (15162 in chips) 
Seat 7: Monstrson (150404 in chips) 
Seat 8: Matzen10 (399804 in chips) 
Seat 9: lukekus87 (220452 in chips) 
Quent Berthe: posts the ante 700
muskymac23: posts the ante 700
stratos0071: posts the ante 700
jcarlos.vale: posts the ante 700
17michman17: posts the ante 700
dihalves13: posts the ante 700
Monstrson: posts the ante 700
Matzen10: posts the ante 700
lukekus87: posts the ante 700
Monstrson: posts small blind 2800
Matzen10: posts big blind 5600
*** HOLE CARDS ***
Dealt to jcarlos.vale [Qd 5d]
lukekus87: folds 
Quent Berthe: raises 5600 to 11200
muskymac23: folds 
stratos0071: calls 11200
jcarlos.vale: folds 
17michman17: folds 
dihalves13: folds 
Monstrson: folds 
Matzen10: calls 5600
*** FLOP *** [Tc 7d 6d]
Matzen10: checks 
Quent Berthe: bets 21350
stratos0071: folds 
Matzen10: calls 21350
*** TURN *** [Tc 7d 6d] [7s]
Matzen10: checks 
Quent Berthe: checks 
*** RIVER *** [Tc 7d 6d 7s] [8s]
Matzen10: checks 
Quent Berthe: checks 
*** SHOW DOWN ***
Matzen10: shows [Ts Js] (two pair, Tens and Sevens)
Quent Berthe: mucks handDTO
Matzen10 collected 85400 from pot
*** SUMMARY ***
Total pot 85400 | Rake 0 
Board [Tc 7d 6d 7s 8s]
Seat 1: Quent Berthe mucked [Jd 8d]
Seat 2: muskymac23 folded before Flop (didn't bet)
Seat 3: stratos0071 folded on the Flop
Seat 4: jcarlos.vale folded before Flop (didn't bet)
Seat 5: 17michman17 folded before Flop (didn't bet)
Seat 6: dihalves13 (button) folded before Flop (didn't bet)
Seat 7: Monstrson (small blind) folded before Flop
Seat 8: Matzen10 (big blind) showed [Ts Js] and won (85400) with two pair, Tens and Sevens
Seat 9: lukekus87 folded before Flop (didn't bet)



PokerStars Hand #221912670803: Tournament #3082657132, $0.98+$0.12 USD Hold'em No Limit - Level XXIX (2800/5600) - 2020/12/27 21:30:17 EET [2020/12/27 14:30:17 ET]
Table '3082657132 62' 9-max Seat #7 is the button
Seat 1: Quent Berthe (230564 in chips) 
Seat 2: muskymac23 (628924 in chips) 
Seat 3: stratos0071 (291030 in chips) 
Seat 4: jcarlos.vale (193474 in chips) 
Seat 5: 17michman17 (124842 in chips) 
Seat 6: dihalves13 (14462 in chips) 
Seat 7: Monstrson (146904 in chips) 
Seat 8: Matzen10 (451954 in chips) 
Seat 9: lukekus87 (219752 in chips) 
Quent Berthe: posts the ante 700
muskymac23: posts the ante 700
stratos0071: posts the ante 700
jcarlos.vale: posts the ante 700
17michman17: posts the ante 700
dihalves13: posts the ante 700
Monstrson: posts the ante 700
Matzen10: posts the ante 700
lukekus87: posts the ante 700
Matzen10: posts small blind 2800
lukekus87: posts big blind 5600
*** HOLE CARDS ***
Dealt to jcarlos.vale [As 4d]
Quent Berthe: raises 20300 to 25900
muskymac23: folds 
stratos0071: folds 
jcarlos.vale: folds 
17michman17: folds 
dihalves13: calls 13762 and is all-in
Monstrson: folds 
Matzen10: folds 
lukekus87: folds 
Uncalled bet (12138) returned to Quent Berthe
*** FLOP *** [Ks Qd 5s]
*** TURN *** [Ks Qd 5s] [5h]
*** RIVER *** [Ks Qd 5s 5h] [Jc]
*** SHOW DOWN ***
Quent Berthe: shows [7h 7c] (two pair, Sevens and Fives)
dihalves13: shows [Jd Ad] (two pair, Jacks and Fives)
dihalves13 collected 42224 from pot
*** SUMMARY ***
Total pot 42224 | Rake 0 
Board [Ks Qd 5s 5h Jc]
Seat 1: Quent Berthe showed [7h 7c] and lost with two pair, Sevens and Fives
Seat 2: muskymac23 folded before Flop (didn't bet)
Seat 3: stratos0071 folded before Flop (didn't bet)
Seat 4: jcarlos.vale folded before Flop (didn't bet)
Seat 5: 17michman17 folded before Flop (didn't bet)
Seat 6: dihalves13 showed [Jd Ad] and won (42224) with two pair, Jacks and Fives
Seat 7: Monstrson (button) folded before Flop (didn't bet)
Seat 8: Matzen10 (small blind) folded before Flop
Seat 9: lukekus87 (big blind) folded before Flop



PokerStars Hand #221912692345: Tournament #3082657132, $0.98+$0.12 USD Hold'em No Limit - Level XXIX (2800/5600) - 2020/12/27 21:30:40 EET [2020/12/27 14:30:40 ET]
Table '3082657132 62' 9-max Seat #8 is the button
Seat 1: Quent Berthe (216102 in chips) 
Seat 2: muskymac23 (628224 in chips) 
Seat 3: stratos0071 (290330 in chips) 
Seat 4: jcarlos.vale (192774 in chips) 
Seat 5: 17michman17 (124142 in chips) 
Seat 6: dihalves13 (42224 in chips) 
Seat 7: Monstrson (146204 in chips) 
Seat 8: Matzen10 (448454 in chips) 
Seat 9: lukekus87 (213452 in chips) 
Quent Berthe: posts the ante 700
muskymac23: posts the ante 700
stratos0071: posts the ante 700
jcarlos.vale: posts the ante 700
17michman17: posts the ante 700
dihalves13: posts the ante 700
Monstrson: posts the ante 700
Matzen10: posts the ante 700
lukekus87: posts the ante 700
lukekus87: posts small blind 2800
Quent Berthe: posts big blind 5600
*** HOLE CARDS ***
Dealt to jcarlos.vale [4d Kh]
muskymac23: folds 
stratos0071: folds 
jcarlos.vale: folds 
17michman17: folds 
dihalves13: folds 
Monstrson: folds 
Matzen10: raises 5600 to 11200
lukekus87: calls 8400
Quent Berthe: calls 5600
*** FLOP *** [6s Kd Ad]
lukekus87: checks 
Quent Berthe: checks 
Matzen10: bets 16800
lukekus87: raises 16800 to 33600
Quent Berthe: folds 
Matzen10: calls 16800
*** TURN *** [6s Kd Ad] [2c]
lukekus87: bets 56000
Matzen10: raises 346954 to 402954 and is all-in
lukekus87: folds 
Uncalled bet (346954) returned to Matzen10
Matzen10 collected 219100 from pot
Matzen10: doesn't show handDTO
*** SUMMARY ***
Total pot 219100 | Rake 0 
Board [6s Kd Ad 2c]
Seat 1: Quent Berthe (big blind) folded on the Flop
Seat 2: muskymac23 folded before Flop (didn't bet)
Seat 3: stratos0071 folded before Flop (didn't bet)
Seat 4: jcarlos.vale folded before Flop (didn't bet)
Seat 5: 17michman17 folded before Flop (didn't bet)
Seat 6: dihalves13 folded before Flop (didn't bet)
Seat 7: Monstrson folded before Flop (didn't bet)
Seat 8: Matzen10 (button) collected (219100)
Seat 9: lukekus87 (small blind) folded on the Turn



PokerStars Hand #221912779369: Tournament #3082657132, $0.98+$0.12 USD Hold'em No Limit - Level XXIX (2800/5600) - 2020/12/27 21:32:13 EET [2020/12/27 14:32:13 ET]
Table '3082657132 62' 9-max Seat #9 is the button
Seat 1: Quent Berthe (204202 in chips) 
Seat 2: muskymac23 (627524 in chips) 
Seat 3: stratos0071 (289630 in chips) 
Seat 4: jcarlos.vale (192074 in chips) 
Seat 5: 17michman17 (123442 in chips) 
Seat 7: Monstrson (145504 in chips) 
Seat 8: Matzen10 (566054 in chips) 
Seat 9: lukekus87 (111952 in chips) 
Quent Berthe: posts the ante 700
muskymac23: posts the ante 700
stratos0071: posts the ante 700
jcarlos.vale: posts the ante 700
17michman17: posts the ante 700
Monstrson: posts the ante 700
Matzen10: posts the ante 700
lukekus87: posts the ante 700
Quent Berthe: posts small blind 2800
muskymac23: posts big blind 5600
*** HOLE CARDS ***
Dealt to jcarlos.vale [Th Jh]
stratos0071: folds 
jcarlos.vale: raises 8960 to 14560
17michman17: folds 
Monstrson: folds 
Matzen10: folds 
lukekus87: folds 
Quent Berthe: folds 
muskymac23: folds 
Uncalled bet (8960) returned to jcarlos.vale
jcarlos.vale collected 19600 from pot
jcarlos.vale: doesn't show handDTO
*** SUMMARY ***
Total pot 19600 | Rake 0 
Seat 1: Quent Berthe (small blind) folded before Flop
Seat 2: muskymac23 (big blind) folded before Flop
Seat 3: stratos0071 folded before Flop (didn't bet)
Seat 4: jcarlos.vale collected (19600)
Seat 5: 17michman17 folded before Flop (didn't bet)
Seat 7: Monstrson folded before Flop (didn't bet)
Seat 8: Matzen10 folded before Flop (didn't bet)
Seat 9: lukekus87 (button) folded before Flop (didn't bet)



PokerStars Hand #221912798826: Tournament #3082657132, $0.98+$0.12 USD Hold'em No Limit - Level XXIX (2800/5600) - 2020/12/27 21:32:33 EET [2020/12/27 14:32:33 ET]
Table '3082657132 62' 9-max Seat #1 is the button
Seat 1: Quent Berthe (200702 in chips) 
Seat 2: muskymac23 (621224 in chips) 
Seat 3: stratos0071 (288930 in chips) 
Seat 4: jcarlos.vale (205374 in chips) 
Seat 5: 17michman17 (122742 in chips) 
Seat 7: Monstrson (144804 in chips) 
Seat 8: Matzen10 (565354 in chips) 
Seat 9: lukekus87 (111252 in chips) 
Quent Berthe: posts the ante 700
muskymac23: posts the ante 700
stratos0071: posts the ante 700
jcarlos.vale: posts the ante 700
17michman17: posts the ante 700
Monstrson: posts the ante 700
Matzen10: posts the ante 700
lukekus87: posts the ante 700
muskymac23: posts small blind 2800
stratos0071: posts big blind 5600
*** HOLE CARDS ***
Dealt to jcarlos.vale [3c Jh]
jcarlos.vale: folds 
17michman17: calls 5600
Monstrson: raises 11200 to 16800
Matzen10: folds 
lukekus87: calls 16800
Quent Berthe: folds 
muskymac23: folds 
stratos0071: folds 
17michman17: raises 105242 to 122042 and is all-in
Monstrson: folds 
lukekus87: calls 93752 and is all-in
Uncalled bet (11490) returned to 17michman17
*** FLOP *** [8d 5c 9s]
*** TURN *** [8d 5c 9s] [6h]
*** RIVER *** [8d 5c 9s 6h] [8h]
*** SHOW DOWN ***
17michman17: shows [5h 5d] (a full house, Fives full of Eights)
lukekus87: shows [Qh 2h] (a pair of Eights)
17michman17 collected 251904 from pot
lukekus87 finished the tournament in 40th place and received $7.31.
*** SUMMARY ***
Total pot 251904 | Rake 0 
Board [8d 5c 9s 6h 8h]
Seat 1: Quent Berthe (button) folded before Flop (didn't bet)
Seat 2: muskymac23 (small blind) folded before Flop
Seat 3: stratos0071 (big blind) folded before Flop
Seat 4: jcarlos.vale folded before Flop (didn't bet)
Seat 5: 17michman17 showed [5h 5d] and won (251904) with a full house, Fives full of Eights
Seat 7: Monstrson folded before Flop
Seat 8: Matzen10 folded before Flop (didn't bet)
Seat 9: lukekus87 showed [Qh 2h] and lost with a pair of Eights



PokerStars Hand #221912840069: Tournament #3082657132, $0.98+$0.12 USD Hold'em No Limit - Level XXIX (2800/5600) - 2020/12/27 21:33:17 EET [2020/12/27 14:33:17 ET]
Table '3082657132 62' 9-max Seat #2 is the button
Seat 1: Quent Berthe (200002 in chips) 
Seat 2: muskymac23 (617724 in chips) 
Seat 3: stratos0071 (282630 in chips) 
Seat 4: jcarlos.vale (204674 in chips) 
Seat 5: 17michman17 (263394 in chips) 
Seat 7: Monstrson (127304 in chips) 
Seat 8: Matzen10 (564654 in chips) 
Quent Berthe: posts the ante 700
muskymac23: posts the ante 700
stratos0071: posts the ante 700
jcarlos.vale: posts the ante 700
17michman17: posts the ante 700
Monstrson: posts the ante 700
Matzen10: posts the ante 700
stratos0071: posts small blind 2800
jcarlos.vale: posts big blind 5600
*** HOLE CARDS ***
Dealt to jcarlos.vale [2s 7c]
17michman17: calls 5600
Monstrson: calls 5600
Matzen10: calls 5600
Quent Berthe: folds 
muskymac23: folds 
stratos0071: calls 2800
jcarlos.vale: checks 
*** FLOP *** [9c 8h Tc]
stratos0071: checks 
jcarlos.vale: checks 
17michman17: checks 
Monstrson: checks 
Matzen10: bets 16800
stratos0071: folds 
jcarlos.vale: folds 
17michman17: folds 
Monstrson: raises 104204 to 121004 and is all-in
Matzen10: calls 104204
*** TURN *** [9c 8h Tc] [6d]
*** RIVER *** [9c 8h Tc 6d] [5h]
*** SHOW DOWN ***
Monstrson: shows [Jh Kh] (high pairOfCards King)
Matzen10: shows [8c 8d] (three of a kind, Eights)
Matzen10 collected 274908 from pot
Monstrson finished the tournament in 39th place and received $7.31.
*** SUMMARY ***
Total pot 274908 | Rake 0 
Board [9c 8h Tc 6d 5h]
Seat 1: Quent Berthe folded before Flop (didn't bet)
Seat 2: muskymac23 (button) folded before Flop (didn't bet)
Seat 3: stratos0071 (small blind) folded on the Flop
Seat 4: jcarlos.vale (big blind) folded on the Flop
Seat 5: 17michman17 folded on the Flop
Seat 7: Monstrson showed [Jh Kh] and lost with high pairOfCards King
Seat 8: Matzen10 showed [8c 8d] and won (274908) with three of a kind, Eights



PokerStars Hand #221912917834: Tournament #3082657132, $0.98+$0.12 USD Hold'em No Limit - Level XXIX (2800/5600) - 2020/12/27 21:34:39 EET [2020/12/27 14:34:39 ET]
Table '3082657132 62' 9-max Seat #3 is the button
Seat 1: Quent Berthe (199302 in chips) 
Seat 2: muskymac23 (617024 in chips) 
Seat 3: stratos0071 (276330 in chips) 
Seat 4: jcarlos.vale (198374 in chips) 
Seat 5: 17michman17 (257094 in chips) 
Seat 8: Matzen10 (712258 in chips) 
Quent Berthe: posts the ante 700
muskymac23: posts the ante 700
stratos0071: posts the ante 700
jcarlos.vale: posts the ante 700
17michman17: posts the ante 700
Matzen10: posts the ante 700
jcarlos.vale: posts small blind 2800
17michman17: posts big blind 5600
*** HOLE CARDS ***
Dealt to jcarlos.vale [8c 4d]
Matzen10: folds 
Quent Berthe: raises 5600 to 11200
muskymac23: folds 
stratos0071: folds 
jcarlos.vale: folds 
17michman17: calls 5600
*** FLOP *** [7h Td Qs]
17michman17: checks 
Quent Berthe: bets 14700
17michman17: calls 14700
*** TURN *** [7h Td Qs] [5h]
17michman17: checks 
Quent Berthe: checks 
*** RIVER *** [7h Td Qs 5h] [4h]
17michman17: bets 29400
Quent Berthe: calls 29400
*** SHOW DOWN ***
17michman17: shows [9c Jc] (high pairOfCards Queen)
Quent Berthe: shows [Jh Ts] (a pair of Tens)
Quent Berthe collected 117600 from pot
*** SUMMARY ***
Total pot 117600 | Rake 0 
Board [7h Td Qs 5h 4h]
Seat 1: Quent Berthe showed [Jh Ts] and won (117600) with a pair of Tens
Seat 2: muskymac23 folded before Flop (didn't bet)
Seat 3: stratos0071 (button) folded before Flop (didn't bet)
Seat 4: jcarlos.vale (small blind) folded before Flop
Seat 5: 17michman17 (big blind) showed [9c Jc] and lost with high pairOfCards Queen
Seat 8: Matzen10 folded before Flop (didn't bet)



PokerStars Hand #221912950121: Tournament #3082657132, $0.98+$0.12 USD Hold'em No Limit - Level XXIX (2800/5600) - 2020/12/27 21:35:13 EET [2020/12/27 14:35:13 ET]
Table '3082657132 62' 9-max Seat #4 is the button
Seat 1: Quent Berthe (260902 in chips) 
Seat 2: muskymac23 (616324 in chips) 
Seat 3: stratos0071 (275630 in chips) 
Seat 4: jcarlos.vale (194874 in chips) 
Seat 5: 17michman17 (201094 in chips) 
Seat 6: 1TYSZKA (80538 in chips) 
Seat 8: Matzen10 (711558 in chips) 
Quent Berthe: posts the ante 700
muskymac23: posts the ante 700
stratos0071: posts the ante 700
jcarlos.vale: posts the ante 700
17michman17: posts the ante 700
1TYSZKA: posts the ante 700
Matzen10: posts the ante 700
17michman17: posts small blind 2800
1TYSZKA: posts big blind 5600
*** HOLE CARDS ***
Dealt to jcarlos.vale [9h Ac]
Matzen10: folds 
Quent Berthe: folds 
muskymac23: raises 15120 to 20720
stratos0071: folds 
jcarlos.vale: folds 
17michman17: calls 17920
1TYSZKA: raises 59118 to 79838 and is all-in
muskymac23: raises 535786 to 615624 and is all-in
17michman17: calls 179674 and is all-in
Uncalled bet (415230) returned to muskymac23
*** FLOP *** [As 5c Ks]
*** TURN *** [As 5c Ks] [2s]
*** RIVER *** [As 5c Ks 2s] [7c]
*** SHOW DOWN ***
17michman17: shows [9s 9c] (a pair of Nines)
muskymac23: shows [Ts Tc] (a pair of Tens)
muskymac23 collected 241112 from side pot
1TYSZKA: shows [Td Th] (a pair of Tens)
1TYSZKA collected 122207 from main pot
muskymac23 collected 122207 from main pot
17michman17 finished the tournament in 37th place and received $7.31.
*** SUMMARY ***
Total pot 485526 Main pot 244414. Side pot 241112. | Rake 0 
Board [As 5c Ks 2s 7c]
Seat 1: Quent Berthe folded before Flop (didn't bet)
Seat 2: muskymac23 showed [Ts Tc] and won (363319) with a pair of Tens
Seat 3: stratos0071 folded before Flop (didn't bet)
Seat 4: jcarlos.vale (button) folded before Flop (didn't bet)
Seat 5: 17michman17 (small blind) showed [9s 9c] and lost with a pair of Nines
Seat 6: 1TYSZKA (big blind) showed [Td Th] and won (122207) with a pair of Tens
Seat 8: Matzen10 folded before Flop (didn't bet)



PokerStars Hand #221913038575: Tournament #3082657132, $0.98+$0.12 USD Hold'em No Limit - Level XXIX (2800/5600) - 2020/12/27 21:36:38 EET [2020/12/27 14:36:38 ET]
Table '3082657132 89' 9-max Seat #7 is the button
Seat 1: neverwins333 (398528 in chips) 
Seat 2: TRACE'21'36 (429092 in chips) 
Seat 3: Sarg2006 (87846 in chips) is sitting out
Seat 4: jcarlos.vale (194174 in chips) 
Seat 5: stratos0071 (274930 in chips) 
Seat 6: abnormaarten (184618 in chips) 
Seat 7: chereppauner (72889 in chips) 
Seat 8: vereke218 (264181 in chips) 
Seat 9: Lucas CWB1 (334146 in chips) 
neverwins333: posts the ante 700
TRACE'21'36: posts the ante 700
Sarg2006: posts the ante 700
jcarlos.vale: posts the ante 700
stratos0071: posts the ante 700
abnormaarten: posts the ante 700
chereppauner: posts the ante 700
vereke218: posts the ante 700
Lucas CWB1: posts the ante 700
vereke218: posts small blind 2800
Lucas CWB1: posts big blind 5600
*** HOLE CARDS ***
Dealt to jcarlos.vale [Jh 5d]
neverwins333: calls 5600
TRACE'21'36: folds 
Sarg2006: folds 
jcarlos.vale: folds 
stratos0071: calls 5600
abnormaarten: folds 
chereppauner: folds 
vereke218: folds 
Lucas CWB1: checks 
*** FLOP *** [9h Js Ah]
Lucas CWB1: checks 
neverwins333: checks 
stratos0071: bets 11200
Lucas CWB1: folds 
neverwins333: folds 
Uncalled bet (11200) returned to stratos0071
stratos0071 collected 25900 from pot
*** SUMMARY ***
Total pot 25900 | Rake 0 
Board [9h Js Ah]
Seat 1: neverwins333 folded on the Flop
Seat 2: TRACE'21'36 folded before Flop (didn't bet)
Seat 3: Sarg2006 folded before Flop (didn't bet)
Seat 4: jcarlos.vale folded before Flop (didn't bet)
Seat 5: stratos0071 collected (25900)
Seat 6: abnormaarten folded before Flop (didn't bet)
Seat 7: chereppauner (button) folded before Flop (didn't bet)
Seat 8: vereke218 (small blind) folded before Flop
Seat 9: Lucas CWB1 (big blind) folded on the Flop



PokerStars Hand #221913083309: Tournament #3082657132, $0.98+$0.12 USD Hold'em No Limit - Level XXX (3200/6400) - 2020/12/27 21:37:25 EET [2020/12/27 14:37:25 ET]
Table '3082657132 89' 9-max Seat #8 is the button
Seat 1: neverwins333 (392228 in chips) 
Seat 2: TRACE'21'36 (428392 in chips) 
Seat 3: Sarg2006 (87146 in chips) is sitting out
Seat 4: jcarlos.vale (193474 in chips) 
Seat 5: stratos0071 (294530 in chips) 
Seat 6: abnormaarten (183918 in chips) 
Seat 7: chereppauner (72189 in chips) 
Seat 8: vereke218 (260681 in chips) 
Seat 9: Lucas CWB1 (327846 in chips) 
neverwins333: posts the ante 800
TRACE'21'36: posts the ante 800
Sarg2006: posts the ante 800
jcarlos.vale: posts the ante 800
stratos0071: posts the ante 800
abnormaarten: posts the ante 800
chereppauner: posts the ante 800
vereke218: posts the ante 800
Lucas CWB1: posts the ante 800
Lucas CWB1: posts small blind 3200
neverwins333: posts big blind 6400
*** HOLE CARDS ***
Dealt to jcarlos.vale [4s Th]
TRACE'21'36: raises 6400 to 12800
Sarg2006: folds 
jcarlos.vale: folds 
stratos0071: folds 
abnormaarten: folds 
chereppauner: folds 
vereke218: folds 
Lucas CWB1: folds 
neverwins333: folds 
Uncalled bet (6400) returned to TRACE'21'36
TRACE'21'36 collected 23200 from pot
TRACE'21'36: doesn't show handDTO
*** SUMMARY ***
Total pot 23200 | Rake 0 
Seat 1: neverwins333 (big blind) folded before Flop
Seat 2: TRACE'21'36 collected (23200)
Seat 3: Sarg2006 folded before Flop (didn't bet)
Seat 4: jcarlos.vale folded before Flop (didn't bet)
Seat 5: stratos0071 folded before Flop (didn't bet)
Seat 6: abnormaarten folded before Flop (didn't bet)
Seat 7: chereppauner folded before Flop (didn't bet)
Seat 8: vereke218 (button) folded before Flop (didn't bet)
Seat 9: Lucas CWB1 (small blind) folded before Flop



PokerStars Hand #221913095577: Tournament #3082657132, $0.98+$0.12 USD Hold'em No Limit - Level XXX (3200/6400) - 2020/12/27 21:37:38 EET [2020/12/27 14:37:38 ET]
Table '3082657132 89' 9-max Seat #9 is the button
Seat 1: neverwins333 (385028 in chips) 
Seat 2: TRACE'21'36 (444392 in chips) 
Seat 3: Sarg2006 (86346 in chips) is sitting out
Seat 4: jcarlos.vale (192674 in chips) 
Seat 5: stratos0071 (293730 in chips) 
Seat 6: abnormaarten (183118 in chips) 
Seat 7: chereppauner (71389 in chips) 
Seat 8: vereke218 (259881 in chips) 
Seat 9: Lucas CWB1 (323846 in chips) 
neverwins333: posts the ante 800
TRACE'21'36: posts the ante 800
Sarg2006: posts the ante 800
jcarlos.vale: posts the ante 800
stratos0071: posts the ante 800
abnormaarten: posts the ante 800
chereppauner: posts the ante 800
vereke218: posts the ante 800
Lucas CWB1: posts the ante 800
neverwins333: posts small blind 3200
TRACE'21'36: posts big blind 6400
*** HOLE CARDS ***
Dealt to jcarlos.vale [Ac 7d]
Sarg2006: folds 
jcarlos.vale: raises 10240 to 16640
stratos0071: folds 
abnormaarten: folds 
chereppauner: folds 
vereke218: folds 
Lucas CWB1: folds 
neverwins333: folds 
TRACE'21'36: calls 10240
*** FLOP *** [4h Ks 9d]
TRACE'21'36: checks 
jcarlos.vale: bets 12800
TRACE'21'36: calls 12800
*** TURN *** [4h Ks 9d] [5s]
TRACE'21'36: checks 
jcarlos.vale: checks 
*** RIVER *** [4h Ks 9d 5s] [8h]
TRACE'21'36: bets 25600
jcarlos.vale: folds 
Uncalled bet (25600) returned to TRACE'21'36
TRACE'21'36 collected 69280 from pot
TRACE'21'36: doesn't show handDTO
*** SUMMARY ***
Total pot 69280 | Rake 0 
Board [4h Ks 9d 5s 8h]
Seat 1: neverwins333 (small blind) folded before Flop
Seat 2: TRACE'21'36 (big blind) collected (69280)
Seat 3: Sarg2006 folded before Flop (didn't bet)
Seat 4: jcarlos.vale folded on the River
Seat 5: stratos0071 folded before Flop (didn't bet)
Seat 6: abnormaarten folded before Flop (didn't bet)
Seat 7: chereppauner folded before Flop (didn't bet)
Seat 8: vereke218 folded before Flop (didn't bet)
Seat 9: Lucas CWB1 (button) folded before Flop (didn't bet)



PokerStars Hand #221913140263: Tournament #3082657132, $0.98+$0.12 USD Hold'em No Limit - Level XXX (3200/6400) - 2020/12/27 21:38:26 EET [2020/12/27 14:38:26 ET]
Table '3082657132 89' 9-max Seat #1 is the button
Seat 1: neverwins333 (381028 in chips) 
Seat 2: TRACE'21'36 (483432 in chips) 
Seat 3: Sarg2006 (85546 in chips) is sitting out
Seat 4: jcarlos.vale (162434 in chips) 
Seat 5: stratos0071 (292930 in chips) 
Seat 6: abnormaarten (182318 in chips) 
Seat 7: chereppauner (70589 in chips) 
Seat 8: vereke218 (259081 in chips) 
Seat 9: Lucas CWB1 (323046 in chips) 
neverwins333: posts the ante 800
TRACE'21'36: posts the ante 800
Sarg2006: posts the ante 800
jcarlos.vale: posts the ante 800
stratos0071: posts the ante 800
abnormaarten: posts the ante 800
chereppauner: posts the ante 800
vereke218: posts the ante 800
Lucas CWB1: posts the ante 800
TRACE'21'36: posts small blind 3200
Sarg2006: posts big blind 6400
*** HOLE CARDS ***
Dealt to jcarlos.vale [Qh 8c]
jcarlos.vale: folds 
stratos0071: folds 
abnormaarten: folds 
chereppauner: folds 
vereke218: raises 6400 to 12800
Lucas CWB1: folds 
neverwins333: folds 
TRACE'21'36: calls 9600
Sarg2006: folds 
*** FLOP *** [Ad 3c 9c]
TRACE'21'36: bets 12544
vereke218: calls 12544
*** TURN *** [Ad 3c 9c] [6c]
TRACE'21'36: checks 
vereke218: bets 19200
TRACE'21'36: folds 
Uncalled bet (19200) returned to vereke218
vereke218 collected 64288 from pot
vereke218: doesn't show handDTO
*** SUMMARY ***
Total pot 64288 | Rake 0 
Board [Ad 3c 9c 6c]
Seat 1: neverwins333 (button) folded before Flop (didn't bet)
Seat 2: TRACE'21'36 (small blind) folded on the Turn
Seat 3: Sarg2006 (big blind) folded before Flop
Seat 4: jcarlos.vale folded before Flop (didn't bet)
Seat 5: stratos0071 folded before Flop (didn't bet)
Seat 6: abnormaarten folded before Flop (didn't bet)
Seat 7: chereppauner folded before Flop (didn't bet)
Seat 8: vereke218 collected (64288)
Seat 9: Lucas CWB1 folded before Flop (didn't bet)



PokerStars Hand #221913175053: Tournament #3082657132, $0.98+$0.12 USD Hold'em No Limit - Level XXX (3200/6400) - 2020/12/27 21:39:03 EET [2020/12/27 14:39:03 ET]
Table '3082657132 89' 9-max Seat #2 is the button
Seat 1: neverwins333 (380228 in chips) 
Seat 2: TRACE'21'36 (457288 in chips) 
Seat 3: Sarg2006 (78346 in chips) is sitting out
Seat 4: jcarlos.vale (161634 in chips) 
Seat 5: stratos0071 (292130 in chips) 
Seat 6: abnormaarten (181518 in chips) 
Seat 7: chereppauner (69789 in chips) 
Seat 8: vereke218 (297225 in chips) 
Seat 9: Lucas CWB1 (322246 in chips) 
neverwins333: posts the ante 800
TRACE'21'36: posts the ante 800
Sarg2006: posts the ante 800
jcarlos.vale: posts the ante 800
stratos0071: posts the ante 800
abnormaarten: posts the ante 800
chereppauner: posts the ante 800
vereke218: posts the ante 800
Lucas CWB1: posts the ante 800
Sarg2006: posts small blind 3200
jcarlos.vale: posts big blind 6400
*** HOLE CARDS ***
Dealt to jcarlos.vale [3c 6h]
stratos0071: folds 
abnormaarten has timed out
abnormaarten: folds 
abnormaarten is sitting out
chereppauner: folds 
vereke218: folds 
Lucas CWB1: folds 
abnormaarten has returned
neverwins333: calls 6400
TRACE'21'36: folds 
Sarg2006: folds 
jcarlos.vale: checks 
*** FLOP *** [6d Ts Jc]
jcarlos.vale: checks 
neverwins333: checks 
*** TURN *** [6d Ts Jc] [4d]
jcarlos.vale: bets 12800
neverwins333: folds 
Uncalled bet (12800) returned to jcarlos.vale
jcarlos.vale collected 23200 from pot
jcarlos.vale: doesn't show handDTO
*** SUMMARY ***
Total pot 23200 | Rake 0 
Board [6d Ts Jc 4d]
Seat 1: neverwins333 folded on the Turn
Seat 2: TRACE'21'36 (button) folded before Flop (didn't bet)
Seat 3: Sarg2006 (small blind) folded before Flop
Seat 4: jcarlos.vale (big blind) collected (23200)
Seat 5: stratos0071 folded before Flop (didn't bet)
Seat 6: abnormaarten folded before Flop (didn't bet)
Seat 7: chereppauner folded before Flop (didn't bet)
Seat 8: vereke218 folded before Flop (didn't bet)
Seat 9: Lucas CWB1 folded before Flop (didn't bet)



PokerStars Hand #221913223071: Tournament #3082657132, $0.98+$0.12 USD Hold'em No Limit - Level XXX (3200/6400) - 2020/12/27 21:39:54 EET [2020/12/27 14:39:54 ET]
Table '3082657132 89' 9-max Seat #3 is the button
Seat 1: neverwins333 (373028 in chips) 
Seat 2: TRACE'21'36 (456488 in chips) 
Seat 3: Sarg2006 (74346 in chips) is sitting out
Seat 4: jcarlos.vale (177634 in chips) 
Seat 5: stratos0071 (291330 in chips) 
Seat 6: abnormaarten (180718 in chips) 
Seat 7: chereppauner (68989 in chips) 
Seat 8: vereke218 (296425 in chips) 
Seat 9: Lucas CWB1 (321446 in chips) 
neverwins333: posts the ante 800
TRACE'21'36: posts the ante 800
Sarg2006: posts the ante 800
jcarlos.vale: posts the ante 800
stratos0071: posts the ante 800
abnormaarten: posts the ante 800
chereppauner: posts the ante 800
vereke218: posts the ante 800
Lucas CWB1: posts the ante 800
jcarlos.vale: posts small blind 3200
stratos0071: posts big blind 6400
*** HOLE CARDS ***
Dealt to jcarlos.vale [Kd 5h]
abnormaarten: folds 
chereppauner: folds 
vereke218: raises 6400 to 12800
Lucas CWB1: raises 25600 to 38400
neverwins333: folds 
TRACE'21'36: folds 
Sarg2006: folds 
jcarlos.vale: folds 
stratos0071: folds 
vereke218: folds 
Uncalled bet (25600) returned to Lucas CWB1
Lucas CWB1 collected 42400 from pot
Lucas CWB1: doesn't show handDTO
*** SUMMARY ***
Total pot 42400 | Rake 0 
Seat 1: neverwins333 folded before Flop (didn't bet)
Seat 2: TRACE'21'36 folded before Flop (didn't bet)
Seat 3: Sarg2006 (button) folded before Flop (didn't bet)
Seat 4: jcarlos.vale (small blind) folded before Flop
Seat 5: stratos0071 (big blind) folded before Flop
Seat 6: abnormaarten folded before Flop (didn't bet)
Seat 7: chereppauner folded before Flop (didn't bet)
Seat 8: vereke218 folded before Flop
Seat 9: Lucas CWB1 collected (42400)



PokerStars Hand #221913248013: Tournament #3082657132, $0.98+$0.12 USD Hold'em No Limit - Level XXX (3200/6400) - 2020/12/27 21:40:21 EET [2020/12/27 14:40:21 ET]
Table '3082657132 89' 9-max Seat #4 is the button
Seat 1: neverwins333 (372228 in chips) 
Seat 2: TRACE'21'36 (455688 in chips) 
Seat 3: Sarg2006 (73546 in chips) is sitting out
Seat 4: jcarlos.vale (173634 in chips) 
Seat 5: stratos0071 (284130 in chips) 
Seat 6: abnormaarten (179918 in chips) 
Seat 7: chereppauner (68189 in chips) 
Seat 8: vereke218 (282825 in chips) 
Seat 9: Lucas CWB1 (350246 in chips) 
neverwins333: posts the ante 800
TRACE'21'36: posts the ante 800
Sarg2006: posts the ante 800
jcarlos.vale: posts the ante 800
stratos0071: posts the ante 800
abnormaarten: posts the ante 800
chereppauner: posts the ante 800
vereke218: posts the ante 800
Lucas CWB1: posts the ante 800
stratos0071: posts small blind 3200
abnormaarten: posts big blind 6400
*** HOLE CARDS ***
Dealt to jcarlos.vale [Ah 4d]
chereppauner: folds 
vereke218: folds 
Lucas CWB1: folds 
neverwins333: folds 
TRACE'21'36: folds 
Sarg2006: folds 
jcarlos.vale: raises 10240 to 16640
stratos0071: folds 
abnormaarten: folds 
Uncalled bet (10240) returned to jcarlos.vale
jcarlos.vale collected 23200 from pot
jcarlos.vale: doesn't show handDTO
*** SUMMARY ***
Total pot 23200 | Rake 0 
Seat 1: neverwins333 folded before Flop (didn't bet)
Seat 2: TRACE'21'36 folded before Flop (didn't bet)
Seat 3: Sarg2006 folded before Flop (didn't bet)
Seat 4: jcarlos.vale (button) collected (23200)
Seat 5: stratos0071 (small blind) folded before Flop
Seat 6: abnormaarten (big blind) folded before Flop
Seat 7: chereppauner folded before Flop (didn't bet)
Seat 8: vereke218 folded before Flop (didn't bet)
Seat 9: Lucas CWB1 folded before Flop (didn't bet)



PokerStars Hand #221913269503: Tournament #3082657132, $0.98+$0.12 USD Hold'em No Limit - Level XXX (3200/6400) - 2020/12/27 21:40:44 EET [2020/12/27 14:40:44 ET]
Table '3082657132 89' 9-max Seat #5 is the button
Seat 1: neverwins333 (371428 in chips) 
Seat 2: TRACE'21'36 (454888 in chips) 
Seat 3: Sarg2006 (72746 in chips) is sitting out
Seat 4: jcarlos.vale (189634 in chips) 
Seat 5: stratos0071 (280130 in chips) 
Seat 6: abnormaarten (172718 in chips) 
Seat 7: chereppauner (67389 in chips) 
Seat 8: vereke218 (282025 in chips) 
Seat 9: Lucas CWB1 (349446 in chips) 
neverwins333: posts the ante 800
TRACE'21'36: posts the ante 800
Sarg2006: posts the ante 800
jcarlos.vale: posts the ante 800
stratos0071: posts the ante 800
abnormaarten: posts the ante 800
chereppauner: posts the ante 800
vereke218: posts the ante 800
Lucas CWB1: posts the ante 800
abnormaarten: posts small blind 3200
chereppauner: posts big blind 6400
*** HOLE CARDS ***
Dealt to jcarlos.vale [8s 8d]
vereke218: folds 
Lucas CWB1: folds 
neverwins333: folds 
TRACE'21'36: raises 6400 to 12800
Sarg2006: folds 
jcarlos.vale: calls 12800
stratos0071: folds 
abnormaarten: folds 
chereppauner: folds 
*** FLOP *** [9h 4d 2s]
TRACE'21'36: bets 13568
jcarlos.vale: raises 162466 to 176034 and is all-in
TRACE'21'36: folds 
Uncalled bet (162466) returned to jcarlos.vale
jcarlos.vale collected 69536 from pot
jcarlos.vale: doesn't show handDTO
*** SUMMARY ***
Total pot 69536 | Rake 0 
Board [9h 4d 2s]
Seat 1: neverwins333 folded before Flop (didn't bet)
Seat 2: TRACE'21'36 folded on the Flop
Seat 3: Sarg2006 folded before Flop (didn't bet)
Seat 4: jcarlos.vale collected (69536)
Seat 5: stratos0071 (button) folded before Flop (didn't bet)
Seat 6: abnormaarten (small blind) folded before Flop
Seat 7: chereppauner (big blind) folded before Flop
Seat 8: vereke218 folded before Flop (didn't bet)
Seat 9: Lucas CWB1 folded before Flop (didn't bet)



PokerStars Hand #221913306638: Tournament #3082657132, $0.98+$0.12 USD Hold'em No Limit - Level XXX (3200/6400) - 2020/12/27 21:41:23 EET [2020/12/27 14:41:23 ET]
Table '3082657132 89' 9-max Seat #6 is the button
Seat 1: neverwins333 (370628 in chips) 
Seat 2: TRACE'21'36 (427720 in chips) 
Seat 3: Sarg2006 (71946 in chips) is sitting out
Seat 4: jcarlos.vale (232002 in chips) 
Seat 5: stratos0071 (279330 in chips) 
Seat 6: abnormaarten (168718 in chips) 
Seat 7: chereppauner (60189 in chips) 
Seat 8: vereke218 (281225 in chips) 
Seat 9: Lucas CWB1 (348646 in chips) 
neverwins333: posts the ante 800
TRACE'21'36: posts the ante 800
Sarg2006: posts the ante 800
jcarlos.vale: posts the ante 800
stratos0071: posts the ante 800
abnormaarten: posts the ante 800
chereppauner: posts the ante 800
vereke218: posts the ante 800
Lucas CWB1: posts the ante 800
chereppauner: posts small blind 3200
vereke218: posts big blind 6400
*** HOLE CARDS ***
Dealt to jcarlos.vale [Kc 7d]
Lucas CWB1: folds 
neverwins333: folds 
TRACE'21'36: folds 
Sarg2006: folds 
jcarlos.vale: folds 
stratos0071: raises 12800 to 19200
abnormaarten: folds 
chereppauner: raises 40189 to 59389 and is all-in
vereke218: folds 
stratos0071: calls 40189
*** FLOP *** [4d 5h Qd]
*** TURN *** [4d 5h Qd] [7c]
*** RIVER *** [4d 5h Qd 7c] [5d]
*** SHOW DOWN ***
chereppauner: shows [Ah 7h] (two pair, Sevens and Fives)
stratos0071: shows [Ad Jd] (a flush, Ace high)
stratos0071 collected 132378 from pot
chereppauner finished the tournament in 34th place and received $7.31.
*** SUMMARY ***
Total pot 132378 | Rake 0 
Board [4d 5h Qd 7c 5d]
Seat 1: neverwins333 folded before Flop (didn't bet)
Seat 2: TRACE'21'36 folded before Flop (didn't bet)
Seat 3: Sarg2006 folded before Flop (didn't bet)
Seat 4: jcarlos.vale folded before Flop (didn't bet)
Seat 5: stratos0071 showed [Ad Jd] and won (132378) with a flush, Ace high
Seat 6: abnormaarten (button) folded before Flop (didn't bet)
Seat 7: chereppauner (small blind) showed [Ah 7h] and lost with two pair, Sevens and Fives
Seat 8: vereke218 (big blind) folded before Flop
Seat 9: Lucas CWB1 folded before Flop (didn't bet)



PokerStars Hand #221913347133: Tournament #3082657132, $0.98+$0.12 USD Hold'em No Limit - Level XXX (3200/6400) - 2020/12/27 21:42:06 EET [2020/12/27 14:42:06 ET]
Table '3082657132 89' 9-max Seat #8 is the button
Seat 1: neverwins333 (369828 in chips) 
Seat 2: TRACE'21'36 (426920 in chips) 
Seat 3: Sarg2006 (71146 in chips) is sitting out
Seat 4: jcarlos.vale (231202 in chips) 
Seat 5: stratos0071 (351519 in chips) 
Seat 6: abnormaarten (167918 in chips) 
Seat 8: vereke218 (274025 in chips) 
Seat 9: Lucas CWB1 (347846 in chips) 
neverwins333: posts the ante 800
TRACE'21'36: posts the ante 800
Sarg2006: posts the ante 800
jcarlos.vale: posts the ante 800
stratos0071: posts the ante 800
abnormaarten: posts the ante 800
vereke218: posts the ante 800
Lucas CWB1: posts the ante 800
Lucas CWB1: posts small blind 3200
neverwins333: posts big blind 6400
*** HOLE CARDS ***
Dealt to jcarlos.vale [Jc 4c]
TRACE'21'36: folds 
Sarg2006: folds 
jcarlos.vale: folds 
stratos0071: folds 
abnormaarten: raises 7680 to 14080
vereke218: folds 
Lucas CWB1: folds 
neverwins333: calls 7680
*** FLOP *** [4d Td Kh]
neverwins333: checks 
abnormaarten: checks 
*** TURN *** [4d Td Kh] [3h]
neverwins333: checks 
abnormaarten: checks 
*** RIVER *** [4d Td Kh 3h] [Jd]
neverwins333: checks 
abnormaarten: checks 
*** SHOW DOWN ***
neverwins333: shows [6c 6s] (a pair of Sixes)
abnormaarten: mucks handDTO
neverwins333 collected 37760 from pot
*** SUMMARY ***
Total pot 37760 | Rake 0 
Board [4d Td Kh 3h Jd]
Seat 1: neverwins333 (big blind) showed [6c 6s] and won (37760) with a pair of Sixes
Seat 2: TRACE'21'36 folded before Flop (didn't bet)
Seat 3: Sarg2006 folded before Flop (didn't bet)
Seat 4: jcarlos.vale folded before Flop (didn't bet)
Seat 5: stratos0071 folded before Flop (didn't bet)
Seat 6: abnormaarten mucked [Ad 3c]
Seat 8: vereke218 (button) folded before Flop (didn't bet)
Seat 9: Lucas CWB1 (small blind) folded before Flop



PokerStars Hand #221913406089: Tournament #3082657132, $0.98+$0.12 USD Hold'em No Limit - Level XXX (3200/6400) - 2020/12/27 21:43:08 EET [2020/12/27 14:43:08 ET]
Table '3082657132 89' 9-max Seat #9 is the button
Seat 1: neverwins333 (392708 in chips) 
Seat 2: TRACE'21'36 (426120 in chips) 
Seat 3: Sarg2006 (70346 in chips) is sitting out
Seat 4: jcarlos.vale (230402 in chips) 
Seat 5: stratos0071 (350719 in chips) 
Seat 6: abnormaarten (153038 in chips) 
Seat 8: vereke218 (273225 in chips) 
Seat 9: Lucas CWB1 (343846 in chips) 
neverwins333: posts the ante 800
TRACE'21'36: posts the ante 800
Sarg2006: posts the ante 800
jcarlos.vale: posts the ante 800
stratos0071: posts the ante 800
abnormaarten: posts the ante 800
vereke218: posts the ante 800
Lucas CWB1: posts the ante 800
neverwins333: posts small blind 3200
TRACE'21'36: posts big blind 6400
*** HOLE CARDS ***
Dealt to jcarlos.vale [9h Js]
Sarg2006: folds 
jcarlos.vale: folds 
stratos0071: folds 
abnormaarten: raises 7680 to 14080
vereke218: folds 
Lucas CWB1: folds 
neverwins333: folds 
TRACE'21'36: calls 7680
*** FLOP *** [9c 7c Jh]
TRACE'21'36: checks 
abnormaarten: bets 11328
TRACE'21'36: calls 11328
*** TURN *** [9c 7c Jh] [Ks]
TRACE'21'36: checks 
abnormaarten: checks 
*** RIVER *** [9c 7c Jh Ks] [5c]
TRACE'21'36: bets 47124
abnormaarten: folds 
Uncalled bet (47124) returned to TRACE'21'36
TRACE'21'36 collected 60416 from pot
TRACE'21'36: doesn't show handDTO
*** SUMMARY ***
Total pot 60416 | Rake 0 
Board [9c 7c Jh Ks 5c]
Seat 1: neverwins333 (small blind) folded before Flop
Seat 2: TRACE'21'36 (big blind) collected (60416)
Seat 3: Sarg2006 folded before Flop (didn't bet)
Seat 4: jcarlos.vale folded before Flop (didn't bet)
Seat 5: stratos0071 folded before Flop (didn't bet)
Seat 6: abnormaarten folded on the River
Seat 8: vereke218 folded before Flop (didn't bet)
Seat 9: Lucas CWB1 (button) folded before Flop (didn't bet)



PokerStars Hand #221913446280: Tournament #3082657132, $0.98+$0.12 USD Hold'em No Limit - Level XXX (3200/6400) - 2020/12/27 21:43:51 EET [2020/12/27 14:43:51 ET]
Table '3082657132 89' 9-max Seat #1 is the button
Seat 1: neverwins333 (388708 in chips) 
Seat 2: TRACE'21'36 (460328 in chips) 
Seat 3: Sarg2006 (69546 in chips) is sitting out
Seat 4: jcarlos.vale (229602 in chips) 
Seat 5: stratos0071 (349919 in chips) 
Seat 6: abnormaarten (126830 in chips) 
Seat 8: vereke218 (272425 in chips) 
Seat 9: Lucas CWB1 (343046 in chips) 
neverwins333: posts the ante 800
TRACE'21'36: posts the ante 800
Sarg2006: posts the ante 800
jcarlos.vale: posts the ante 800
stratos0071: posts the ante 800
abnormaarten: posts the ante 800
vereke218: posts the ante 800
Lucas CWB1: posts the ante 800
TRACE'21'36: posts small blind 3200
Sarg2006: posts big blind 6400
*** HOLE CARDS ***
Dealt to jcarlos.vale [5h 4h]
jcarlos.vale: folds 
stratos0071: folds 
abnormaarten: folds 
vereke218: raises 6400 to 12800
Lucas CWB1: folds 
neverwins333: folds 
TRACE'21'36: folds 
Sarg2006: folds 
Uncalled bet (6400) returned to vereke218
vereke218 collected 22400 from pot
vereke218: doesn't show handDTO
*** SUMMARY ***
Total pot 22400 | Rake 0 
Seat 1: neverwins333 (button) folded before Flop (didn't bet)
Seat 2: TRACE'21'36 (small blind) folded before Flop
Seat 3: Sarg2006 (big blind) folded before Flop
Seat 4: jcarlos.vale folded before Flop (didn't bet)
Seat 5: stratos0071 folded before Flop (didn't bet)
Seat 6: abnormaarten folded before Flop (didn't bet)
Seat 8: vereke218 collected (22400)
Seat 9: Lucas CWB1 folded before Flop (didn't bet)



PokerStars Hand #221913467265: Tournament #3082657132, $0.98+$0.12 USD Hold'em No Limit - Level XXX (3200/6400) - 2020/12/27 21:44:13 EET [2020/12/27 14:44:13 ET]
Table '3082657132 89' 9-max Seat #2 is the button
Seat 1: neverwins333 (387908 in chips) 
Seat 2: TRACE'21'36 (456328 in chips) 
Seat 3: Sarg2006 (62346 in chips) is sitting out
Seat 4: jcarlos.vale (228802 in chips) 
Seat 5: stratos0071 (349119 in chips) 
Seat 6: abnormaarten (126030 in chips) 
Seat 8: vereke218 (287625 in chips) 
Seat 9: Lucas CWB1 (342246 in chips) 
neverwins333: posts the ante 800
TRACE'21'36: posts the ante 800
Sarg2006: posts the ante 800
jcarlos.vale: posts the ante 800
stratos0071: posts the ante 800
abnormaarten: posts the ante 800
vereke218: posts the ante 800
Lucas CWB1: posts the ante 800
Sarg2006: posts small blind 3200
jcarlos.vale: posts big blind 6400
*** HOLE CARDS ***
Dealt to jcarlos.vale [Kd 9h]
stratos0071: folds 
abnormaarten: folds 
vereke218: folds 
Lucas CWB1: folds 
neverwins333: folds 
TRACE'21'36: raises 7808 to 14208
Sarg2006: folds 
jcarlos.vale: folds 
Uncalled bet (7808) returned to TRACE'21'36
TRACE'21'36 collected 22400 from pot
TRACE'21'36: doesn't show handDTO
*** SUMMARY ***
Total pot 22400 | Rake 0 
Seat 1: neverwins333 folded before Flop (didn't bet)
Seat 2: TRACE'21'36 (button) collected (22400)
Seat 3: Sarg2006 (small blind) folded before Flop
Seat 4: jcarlos.vale (big blind) folded before Flop
Seat 5: stratos0071 folded before Flop (didn't bet)
Seat 6: abnormaarten folded before Flop (didn't bet)
Seat 8: vereke218 folded before Flop (didn't bet)
Seat 9: Lucas CWB1 folded before Flop (didn't bet)



PokerStars Hand #221913495484: Tournament #3082657132, $0.98+$0.12 USD Hold'em No Limit - Level XXX (3200/6400) - 2020/12/27 21:44:43 EET [2020/12/27 14:44:43 ET]
Table '3082657132 89' 9-max Seat #3 is the button
Seat 1: neverwins333 (387108 in chips) 
Seat 2: TRACE'21'36 (471528 in chips) 
Seat 3: Sarg2006 (58346 in chips) is sitting out
Seat 4: jcarlos.vale (221602 in chips) 
Seat 5: stratos0071 (348319 in chips) 
Seat 6: abnormaarten (125230 in chips) 
Seat 8: vereke218 (286825 in chips) 
Seat 9: Lucas CWB1 (341446 in chips) 
neverwins333: posts the ante 800
TRACE'21'36: posts the ante 800
Sarg2006: posts the ante 800
jcarlos.vale: posts the ante 800
stratos0071: posts the ante 800
abnormaarten: posts the ante 800
vereke218: posts the ante 800
Lucas CWB1: posts the ante 800
jcarlos.vale: posts small blind 3200
stratos0071: posts big blind 6400
*** HOLE CARDS ***
Dealt to jcarlos.vale [Kh 9h]
abnormaarten: raises 7680 to 14080
vereke218: folds 
Lucas CWB1: raises 17920 to 32000
neverwins333: folds 
TRACE'21'36: folds 
Sarg2006: folds 
jcarlos.vale: folds 
stratos0071: folds 
abnormaarten: calls 17920
*** FLOP *** [8s Jd Th]
abnormaarten: checks 
Lucas CWB1: bets 56000
abnormaarten: folds 
Uncalled bet (56000) returned to Lucas CWB1
Lucas CWB1 collected 80000 from pot
*** SUMMARY ***
Total pot 80000 | Rake 0 
Board [8s Jd Th]
Seat 1: neverwins333 folded before Flop (didn't bet)
Seat 2: TRACE'21'36 folded before Flop (didn't bet)
Seat 3: Sarg2006 (button) folded before Flop (didn't bet)
Seat 4: jcarlos.vale (small blind) folded before Flop
Seat 5: stratos0071 (big blind) folded before Flop
Seat 6: abnormaarten folded on the Flop
Seat 8: vereke218 folded before Flop (didn't bet)
Seat 9: Lucas CWB1 collected (80000)



PokerStars Hand #221913536354: Tournament #3082657132, $0.98+$0.12 USD Hold'em No Limit - Level XXX (3200/6400) - 2020/12/27 21:45:26 EET [2020/12/27 14:45:26 ET]
Table '3082657132 89' 9-max Seat #4 is the button
Seat 1: neverwins333 (386308 in chips) 
Seat 2: TRACE'21'36 (470728 in chips) 
Seat 3: Sarg2006 (57546 in chips) is sitting out
Seat 4: jcarlos.vale (217602 in chips) 
Seat 5: stratos0071 (341119 in chips) 
Seat 6: abnormaarten (92430 in chips) 
Seat 8: vereke218 (286025 in chips) 
Seat 9: Lucas CWB1 (388646 in chips) 
neverwins333: posts the ante 800
TRACE'21'36: posts the ante 800
Sarg2006: posts the ante 800
jcarlos.vale: posts the ante 800
stratos0071: posts the ante 800
abnormaarten: posts the ante 800
vereke218: posts the ante 800
Lucas CWB1: posts the ante 800
stratos0071: posts small blind 3200
abnormaarten: posts big blind 6400
*** HOLE CARDS ***
Dealt to jcarlos.vale [Kd 8h]
vereke218: folds 
Lucas CWB1: raises 6400 to 12800
neverwins333: folds 
TRACE'21'36: folds 
Sarg2006: folds 
jcarlos.vale: folds 
stratos0071: calls 9600
abnormaarten: folds 
*** FLOP *** [Ac Ks Td]
stratos0071: checks 
Lucas CWB1: bets 26880
stratos0071: calls 26880
*** TURN *** [Ac Ks Td] [Ah]
stratos0071: checks 
Lucas CWB1: checks 
*** RIVER *** [Ac Ks Td Ah] [4h]
stratos0071: bets 38400
Lucas CWB1: folds 
Uncalled bet (38400) returned to stratos0071
stratos0071 collected 92160 from pot
*** SUMMARY ***
Total pot 92160 | Rake 0 
Board [Ac Ks Td Ah 4h]
Seat 1: neverwins333 folded before Flop (didn't bet)
Seat 2: TRACE'21'36 folded before Flop (didn't bet)
Seat 3: Sarg2006 folded before Flop (didn't bet)
Seat 4: jcarlos.vale (button) folded before Flop (didn't bet)
Seat 5: stratos0071 (small blind) collected (92160)
Seat 6: abnormaarten (big blind) folded before Flop
Seat 8: vereke218 folded before Flop (didn't bet)
Seat 9: Lucas CWB1 folded on the River



PokerStars Hand #221913596147: Tournament #3082657132, $0.98+$0.12 USD Hold'em No Limit - Level XXX (3200/6400) - 2020/12/27 21:46:20 EET [2020/12/27 14:46:20 ET]
Table '3082657132 89' 9-max Seat #5 is the button
Seat 1: neverwins333 (385508 in chips) 
Seat 2: TRACE'21'36 (469928 in chips) 
Seat 3: Sarg2006 (56746 in chips) is sitting out
Seat 4: jcarlos.vale (216802 in chips) 
Seat 5: stratos0071 (392799 in chips) 
Seat 6: abnormaarten (85230 in chips) 
Seat 8: vereke218 (285225 in chips) 
Seat 9: Lucas CWB1 (348166 in chips) 
neverwins333: posts the ante 800
TRACE'21'36: posts the ante 800
Sarg2006: posts the ante 800
jcarlos.vale: posts the ante 800
stratos0071: posts the ante 800
abnormaarten: posts the ante 800
vereke218: posts the ante 800
Lucas CWB1: posts the ante 800
abnormaarten: posts small blind 3200
vereke218: posts big blind 6400
*** HOLE CARDS ***
Dealt to jcarlos.vale [7s Jd]
Lucas CWB1: folds 
neverwins333: folds 
TRACE'21'36: raises 6400 to 12800
Sarg2006: folds 
jcarlos.vale: folds 
stratos0071: calls 12800
abnormaarten: folds 
vereke218: calls 6400
*** FLOP *** [Jc Js 5h]
vereke218: checks 
TRACE'21'36: bets 15360
stratos0071: calls 15360
vereke218: folds 
*** TURN *** [Jc Js 5h] [3d]
TRACE'21'36: bets 25190
stratos0071: folds 
Uncalled bet (25190) returned to TRACE'21'36
TRACE'21'36 collected 78720 from pot
TRACE'21'36: doesn't show handDTO
*** SUMMARY ***
Total pot 78720 | Rake 0 
Board [Jc Js 5h 3d]
Seat 1: neverwins333 folded before Flop (didn't bet)
Seat 2: TRACE'21'36 collected (78720)
Seat 3: Sarg2006 folded before Flop (didn't bet)
Seat 4: jcarlos.vale folded before Flop (didn't bet)
Seat 5: stratos0071 (button) folded on the Turn
Seat 6: abnormaarten (small blind) folded before Flop
Seat 8: vereke218 (big blind) folded on the Flop
Seat 9: Lucas CWB1 folded before Flop (didn't bet)



PokerStars Hand #221913639643: Tournament #3082657132, $0.98+$0.12 USD Hold'em No Limit - Level XXX (3200/6400) - 2020/12/27 21:47:06 EET [2020/12/27 14:47:06 ET]
Table '3082657132 89' 9-max Seat #6 is the button
Seat 1: neverwins333 (384708 in chips) 
Seat 2: TRACE'21'36 (519688 in chips) 
Seat 3: Sarg2006 (55946 in chips) is sitting out
Seat 4: jcarlos.vale (216002 in chips) 
Seat 5: stratos0071 (363839 in chips) 
Seat 6: abnormaarten (81230 in chips) 
Seat 8: vereke218 (271625 in chips) 
Seat 9: Lucas CWB1 (347366 in chips) 
neverwins333: posts the ante 800
TRACE'21'36: posts the ante 800
Sarg2006: posts the ante 800
jcarlos.vale: posts the ante 800
stratos0071: posts the ante 800
abnormaarten: posts the ante 800
vereke218: posts the ante 800
Lucas CWB1: posts the ante 800
vereke218: posts small blind 3200
Lucas CWB1: posts big blind 6400
*** HOLE CARDS ***
Dealt to jcarlos.vale [Tc 7s]
neverwins333: folds 
TRACE'21'36: raises 6400 to 12800
Sarg2006: folds 
jcarlos.vale: folds 
stratos0071: folds 
abnormaarten: folds 
vereke218: folds 
Lucas CWB1: calls 6400
*** FLOP *** [5s 4s 6h]
Lucas CWB1: checks 
TRACE'21'36: checks 
*** TURN *** [5s 4s 6h] [Js]
Lucas CWB1: checks 
TRACE'21'36: checks 
*** RIVER *** [5s 4s 6h Js] [6c]
Lucas CWB1: bets 24640
TRACE'21'36: calls 24640
*** SHOW DOWN ***
Lucas CWB1: shows [Th Ts] (two pair, Tens and Sixes)
TRACE'21'36: mucks handDTO
Lucas CWB1 collected 84480 from pot
*** SUMMARY ***
Total pot 84480 | Rake 0 
Board [5s 4s 6h Js 6c]
Seat 1: neverwins333 folded before Flop (didn't bet)
Seat 2: TRACE'21'36 mucked [5d 8d]
Seat 3: Sarg2006 folded before Flop (didn't bet)
Seat 4: jcarlos.vale folded before Flop (didn't bet)
Seat 5: stratos0071 folded before Flop (didn't bet)
Seat 6: abnormaarten (button) folded before Flop (didn't bet)
Seat 8: vereke218 (small blind) folded before Flop
Seat 9: Lucas CWB1 (big blind) showed [Th Ts] and won (84480) with two pair, Tens and Sixes



PokerStars Hand #221913671127: Tournament #3082657132, $0.98+$0.12 USD Hold'em No Limit - Level XXXI (3600/7200) - 2020/12/27 21:47:40 EET [2020/12/27 14:47:40 ET]
Table '3082657132 89' 9-max Seat #8 is the button
Seat 1: neverwins333 (383908 in chips) 
Seat 2: TRACE'21'36 (481448 in chips) 
Seat 3: Sarg2006 (55146 in chips) is sitting out
Seat 4: jcarlos.vale (215202 in chips) 
Seat 5: stratos0071 (363039 in chips) 
Seat 6: abnormaarten (80430 in chips) 
Seat 8: vereke218 (267625 in chips) 
Seat 9: Lucas CWB1 (393606 in chips) 
neverwins333: posts the ante 900
TRACE'21'36: posts the ante 900
Sarg2006: posts the ante 900
jcarlos.vale: posts the ante 900
stratos0071: posts the ante 900
abnormaarten: posts the ante 900
vereke218: posts the ante 900
Lucas CWB1: posts the ante 900
Lucas CWB1: posts small blind 3600
neverwins333: posts big blind 7200
*** HOLE CARDS ***
Dealt to jcarlos.vale [Qc Th]
TRACE'21'36: folds 
Sarg2006: folds 
jcarlos.vale: raises 11520 to 18720
stratos0071: folds 
abnormaarten: folds 
vereke218: folds 
Lucas CWB1: folds 
neverwins333: calls 11520
*** FLOP *** [Tc Jc 4h]
neverwins333: checks 
jcarlos.vale: bets 21600
neverwins333: folds 
Uncalled bet (21600) returned to jcarlos.vale
jcarlos.vale collected 48240 from pot
jcarlos.vale: doesn't show handDTO
*** SUMMARY ***
Total pot 48240 | Rake 0 
Board [Tc Jc 4h]
Seat 1: neverwins333 (big blind) folded on the Flop
Seat 2: TRACE'21'36 folded before Flop (didn't bet)
Seat 3: Sarg2006 folded before Flop (didn't bet)
Seat 4: jcarlos.vale collected (48240)
Seat 5: stratos0071 folded before Flop (didn't bet)
Seat 6: abnormaarten folded before Flop (didn't bet)
Seat 8: vereke218 (button) folded before Flop (didn't bet)
Seat 9: Lucas CWB1 (small blind) folded before Flop



PokerStars Hand #221913714806: Tournament #3082657132, $0.98+$0.12 USD Hold'em No Limit - Level XXXI (3600/7200) - 2020/12/27 21:48:25 EET [2020/12/27 14:48:25 ET]
Table '3082657132 89' 9-max Seat #9 is the button
Seat 1: neverwins333 (364288 in chips) 
Seat 2: TRACE'21'36 (480548 in chips) 
Seat 3: Sarg2006 (54246 in chips) is sitting out
Seat 4: jcarlos.vale (243822 in chips) 
Seat 5: stratos0071 (362139 in chips) 
Seat 6: abnormaarten (79530 in chips) 
Seat 8: vereke218 (266725 in chips) 
Seat 9: Lucas CWB1 (389106 in chips) 
neverwins333: posts the ante 900
TRACE'21'36: posts the ante 900
Sarg2006: posts the ante 900
jcarlos.vale: posts the ante 900
stratos0071: posts the ante 900
abnormaarten: posts the ante 900
vereke218: posts the ante 900
Lucas CWB1: posts the ante 900
neverwins333: posts small blind 3600
TRACE'21'36: posts big blind 7200
*** HOLE CARDS ***
Dealt to jcarlos.vale [Jc Td]
Sarg2006: folds 
jcarlos.vale: folds 
stratos0071: folds 
abnormaarten: raises 71430 to 78630 and is all-in
vereke218: folds 
Lucas CWB1: folds 
neverwins333: folds 
TRACE'21'36: folds 
Uncalled bet (71430) returned to abnormaarten
abnormaarten collected 25200 from pot
*** SUMMARY ***
Total pot 25200 | Rake 0 
Seat 1: neverwins333 (small blind) folded before Flop
Seat 2: TRACE'21'36 (big blind) folded before Flop
Seat 3: Sarg2006 folded before Flop (didn't bet)
Seat 4: jcarlos.vale folded before Flop (didn't bet)
Seat 5: stratos0071 folded before Flop (didn't bet)
Seat 6: abnormaarten collected (25200)
Seat 8: vereke218 folded before Flop (didn't bet)
Seat 9: Lucas CWB1 (button) folded before Flop (didn't bet)



PokerStars Hand #221913744483: Tournament #3082657132, $0.98+$0.12 USD Hold'em No Limit - Level XXXI (3600/7200) - 2020/12/27 21:48:57 EET [2020/12/27 14:48:57 ET]
Table '3082657132 89' 9-max Seat #1 is the button
Seat 1: neverwins333 (359788 in chips) 
Seat 2: TRACE'21'36 (472448 in chips) 
Seat 3: Sarg2006 (53346 in chips) is sitting out
Seat 4: jcarlos.vale (242922 in chips) 
Seat 5: stratos0071 (361239 in chips) 
Seat 6: abnormaarten (96630 in chips) 
Seat 8: vereke218 (265825 in chips) 
Seat 9: Lucas CWB1 (388206 in chips) 
neverwins333: posts the ante 900
TRACE'21'36: posts the ante 900
Sarg2006: posts the ante 900
jcarlos.vale: posts the ante 900
stratos0071: posts the ante 900
abnormaarten: posts the ante 900
vereke218: posts the ante 900
Lucas CWB1: posts the ante 900
TRACE'21'36: posts small blind 3600
Sarg2006: posts big blind 7200
*** HOLE CARDS ***
Dealt to jcarlos.vale [3d Td]
jcarlos.vale: folds 
stratos0071: raises 7200 to 14400
abnormaarten: raises 81330 to 95730 and is all-in
vereke218: folds 
Lucas CWB1: folds 
neverwins333: folds 
TRACE'21'36: folds 
Sarg2006: folds 
stratos0071: calls 81330
*** FLOP *** [Qh 8h Tc]
*** TURN *** [Qh 8h Tc] [5c]
*** RIVER *** [Qh 8h Tc 5c] [4s]
*** SHOW DOWN ***
stratos0071: shows [Ts Ad] (a pair of Tens)
abnormaarten: shows [Jc Js] (a pair of Jacks)
abnormaarten collected 209460 from pot
*** SUMMARY ***
Total pot 209460 | Rake 0 
Board [Qh 8h Tc 5c 4s]
Seat 1: neverwins333 (button) folded before Flop (didn't bet)
Seat 2: TRACE'21'36 (small blind) folded before Flop
Seat 3: Sarg2006 (big blind) folded before Flop
Seat 4: jcarlos.vale folded before Flop (didn't bet)
Seat 5: stratos0071 showed [Ts Ad] and lost with a pair of Tens
Seat 6: abnormaarten showed [Jc Js] and won (209460) with a pair of Jacks
Seat 8: vereke218 folded before Flop (didn't bet)
Seat 9: Lucas CWB1 folded before Flop (didn't bet)



PokerStars Hand #221913774115: Tournament #3082657132, $0.98+$0.12 USD Hold'em No Limit - Level XXXI (3600/7200) - 2020/12/27 21:49:28 EET [2020/12/27 14:49:28 ET]
Table '3082657132 89' 9-max Seat #2 is the button
Seat 1: neverwins333 (358888 in chips) 
Seat 2: TRACE'21'36 (467948 in chips) 
Seat 3: Sarg2006 (45246 in chips) is sitting out
Seat 4: jcarlos.vale (242022 in chips) 
Seat 5: stratos0071 (264609 in chips) 
Seat 6: abnormaarten (209460 in chips) 
Seat 8: vereke218 (264925 in chips) 
Seat 9: Lucas CWB1 (387306 in chips) 
neverwins333: posts the ante 900
TRACE'21'36: posts the ante 900
Sarg2006: posts the ante 900
jcarlos.vale: posts the ante 900
stratos0071: posts the ante 900
abnormaarten: posts the ante 900
vereke218: posts the ante 900
Lucas CWB1: posts the ante 900
Sarg2006: posts small blind 3600
jcarlos.vale: posts big blind 7200
*** HOLE CARDS ***
Dealt to jcarlos.vale [3h 4c]
stratos0071: folds 
abnormaarten: raises 8640 to 15840
vereke218: raises 248185 to 264025 and is all-in
Lucas CWB1: folds 
neverwins333: folds 
TRACE'21'36: raises 203023 to 467048 and is all-in
Sarg2006: folds 
jcarlos.vale: folds 
abnormaarten: folds 
Uncalled bet (203023) returned to TRACE'21'36
*** FLOP *** [7s Qh 6s]
*** TURN *** [7s Qh 6s] [6c]
*** RIVER *** [7s Qh 6s 6c] [Jc]
*** SHOW DOWN ***
vereke218: shows [Qd Qs] (a full house, Queens full of Sixes)
TRACE'21'36: shows [Ks Kc] (two pair, Kings and Sixes)
vereke218 collected 561890 from pot
*** SUMMARY ***
Total pot 561890 | Rake 0 
Board [7s Qh 6s 6c Jc]
Seat 1: neverwins333 folded before Flop (didn't bet)
Seat 2: TRACE'21'36 (button) showed [Ks Kc] and lost with two pair, Kings and Sixes
Seat 3: Sarg2006 (small blind) folded before Flop
Seat 4: jcarlos.vale (big blind) folded before Flop
Seat 5: stratos0071 folded before Flop (didn't bet)
Seat 6: abnormaarten folded before Flop
Seat 8: vereke218 showed [Qd Qs] and won (561890) with a full house, Queens full of Sixes
Seat 9: Lucas CWB1 folded before Flop (didn't bet)



PokerStars Hand #221913799704: Tournament #3082657132, $0.98+$0.12 USD Hold'em No Limit - Level XXXI (3600/7200) - 2020/12/27 21:49:55 EET [2020/12/27 14:49:55 ET]
Table '3082657132 89' 9-max Seat #3 is the button
Seat 1: neverwins333 (357988 in chips) 
Seat 2: TRACE'21'36 (203023 in chips) 
Seat 3: Sarg2006 (40746 in chips) is sitting out
Seat 4: jcarlos.vale (233922 in chips) 
Seat 5: stratos0071 (263709 in chips) 
Seat 6: abnormaarten (192720 in chips) 
Seat 8: vereke218 (561890 in chips) 
Seat 9: Lucas CWB1 (386406 in chips) 
neverwins333: posts the ante 900
TRACE'21'36: posts the ante 900
Sarg2006: posts the ante 900
jcarlos.vale: posts the ante 900
stratos0071: posts the ante 900
abnormaarten: posts the ante 900
vereke218: posts the ante 900
Lucas CWB1: posts the ante 900
jcarlos.vale: posts small blind 3600
stratos0071: posts big blind 7200
*** HOLE CARDS ***
Dealt to jcarlos.vale [3h Jd]
abnormaarten: folds 
vereke218: folds 
Lucas CWB1: folds 
neverwins333: folds 
TRACE'21'36: folds 
Sarg2006: folds 
jcarlos.vale: folds 
Uncalled bet (3600) returned to stratos0071
stratos0071 collected 14400 from pot
*** SUMMARY ***
Total pot 14400 | Rake 0 
Seat 1: neverwins333 folded before Flop (didn't bet)
Seat 2: TRACE'21'36 folded before Flop (didn't bet)
Seat 3: Sarg2006 (button) folded before Flop (didn't bet)
Seat 4: jcarlos.vale (small blind) folded before Flop
Seat 5: stratos0071 (big blind) collected (14400)
Seat 6: abnormaarten folded before Flop (didn't bet)
Seat 8: vereke218 folded before Flop (didn't bet)
Seat 9: Lucas CWB1 folded before Flop (didn't bet)



PokerStars Hand #221913822751: Tournament #3082657132, $0.98+$0.12 USD Hold'em No Limit - Level XXXI (3600/7200) - 2020/12/27 21:50:19 EET [2020/12/27 14:50:19 ET]
Table '3082657132 89' 9-max Seat #4 is the button
Seat 1: neverwins333 (357088 in chips) 
Seat 2: TRACE'21'36 (202123 in chips) 
Seat 3: Sarg2006 (39846 in chips) is sitting out
Seat 4: jcarlos.vale (229422 in chips) 
Seat 5: stratos0071 (273609 in chips) 
Seat 6: abnormaarten (191820 in chips) 
Seat 8: vereke218 (560990 in chips) 
Seat 9: Lucas CWB1 (385506 in chips) 
neverwins333: posts the ante 900
TRACE'21'36: posts the ante 900
Sarg2006: posts the ante 900
jcarlos.vale: posts the ante 900
stratos0071: posts the ante 900
abnormaarten: posts the ante 900
vereke218: posts the ante 900
Lucas CWB1: posts the ante 900
stratos0071: posts small blind 3600
abnormaarten: posts big blind 7200
*** HOLE CARDS ***
Dealt to jcarlos.vale [2c Kh]
vereke218: folds 
Lucas CWB1: folds 
neverwins333: folds 
TRACE'21'36: raises 7200 to 14400
Sarg2006: folds 
jcarlos.vale: folds 
stratos0071: folds 
abnormaarten: folds 
Uncalled bet (7200) returned to TRACE'21'36
TRACE'21'36 collected 25200 from pot
TRACE'21'36: doesn't show handDTO
*** SUMMARY ***
Total pot 25200 | Rake 0 
Seat 1: neverwins333 folded before Flop (didn't bet)
Seat 2: TRACE'21'36 collected (25200)
Seat 3: Sarg2006 folded before Flop (didn't bet)
Seat 4: jcarlos.vale (button) folded before Flop (didn't bet)
Seat 5: stratos0071 (small blind) folded before Flop
Seat 6: abnormaarten (big blind) folded before Flop
Seat 8: vereke218 folded before Flop (didn't bet)
Seat 9: Lucas CWB1 folded before Flop (didn't bet)



PokerStars Hand #221913835357: Tournament #3082657132, $0.98+$0.12 USD Hold'em No Limit - Level XXXI (3600/7200) - 2020/12/27 21:50:33 EET [2020/12/27 14:50:33 ET]
Table '3082657132 89' 9-max Seat #5 is the button
Seat 1: neverwins333 (356188 in chips) 
Seat 2: TRACE'21'36 (219223 in chips) 
Seat 3: Sarg2006 (38946 in chips) is sitting out
Seat 4: jcarlos.vale (228522 in chips) 
Seat 5: stratos0071 (269109 in chips) 
Seat 6: abnormaarten (183720 in chips) 
Seat 8: vereke218 (560090 in chips) 
Seat 9: Lucas CWB1 (384606 in chips) 
neverwins333: posts the ante 900
TRACE'21'36: posts the ante 900
Sarg2006: posts the ante 900
jcarlos.vale: posts the ante 900
stratos0071: posts the ante 900
abnormaarten: posts the ante 900
vereke218: posts the ante 900
Lucas CWB1: posts the ante 900
abnormaarten: posts small blind 3600
vereke218: posts big blind 7200
*** HOLE CARDS ***
Dealt to jcarlos.vale [Kc 9h]
Lucas CWB1: folds 
neverwins333: folds 
TRACE'21'36: folds 
Sarg2006: folds 
jcarlos.vale: folds 
stratos0071: folds 
abnormaarten: folds 
Uncalled bet (3600) returned to vereke218
vereke218 collected 14400 from pot
vereke218: doesn't show handDTO
*** SUMMARY ***
Total pot 14400 | Rake 0 
Seat 1: neverwins333 folded before Flop (didn't bet)
Seat 2: TRACE'21'36 folded before Flop (didn't bet)
Seat 3: Sarg2006 folded before Flop (didn't bet)
Seat 4: jcarlos.vale folded before Flop (didn't bet)
Seat 5: stratos0071 (button) folded before Flop (didn't bet)
Seat 6: abnormaarten (small blind) folded before Flop
Seat 8: vereke218 (big blind) collected (14400)
Seat 9: Lucas CWB1 folded before Flop (didn't bet)



PokerStars Hand #221913855572: Tournament #3082657132, $0.98+$0.12 USD Hold'em No Limit - Level XXXI (3600/7200) - 2020/12/27 21:50:54 EET [2020/12/27 14:50:54 ET]
Table '3082657132 89' 9-max Seat #6 is the button
Seat 1: neverwins333 (355288 in chips) 
Seat 2: TRACE'21'36 (218323 in chips) 
Seat 3: Sarg2006 (38046 in chips) is sitting out
Seat 4: jcarlos.vale (227622 in chips) 
Seat 5: stratos0071 (268209 in chips) 
Seat 6: abnormaarten (179220 in chips) 
Seat 8: vereke218 (569990 in chips) 
Seat 9: Lucas CWB1 (383706 in chips) 
neverwins333: posts the ante 900
TRACE'21'36: posts the ante 900
Sarg2006: posts the ante 900
jcarlos.vale: posts the ante 900
stratos0071: posts the ante 900
abnormaarten: posts the ante 900
vereke218: posts the ante 900
Lucas CWB1: posts the ante 900
vereke218: posts small blind 3600
Lucas CWB1: posts big blind 7200
*** HOLE CARDS ***
Dealt to jcarlos.vale [Ah Ad]
neverwins333: folds 
TRACE'21'36: raises 7200 to 14400
Sarg2006: folds 
jcarlos.vale: raises 21600 to 36000
stratos0071: folds 
abnormaarten: folds 
vereke218: folds 
Lucas CWB1: folds 
TRACE'21'36: calls 21600
*** FLOP *** [7h 4h 8h]
TRACE'21'36: checks 
jcarlos.vale: bets 67500
TRACE'21'36: folds 
Uncalled bet (67500) returned to jcarlos.vale
jcarlos.vale collected 90000 from pot
jcarlos.vale: doesn't show handDTO
*** SUMMARY ***
Total pot 90000 | Rake 0 
Board [7h 4h 8h]
Seat 1: neverwins333 folded before Flop (didn't bet)
Seat 2: TRACE'21'36 folded on the Flop
Seat 3: Sarg2006 folded before Flop (didn't bet)
Seat 4: jcarlos.vale collected (90000)
Seat 5: stratos0071 folded before Flop (didn't bet)
Seat 6: abnormaarten (button) folded before Flop (didn't bet)
Seat 8: vereke218 (small blind) folded before Flop
Seat 9: Lucas CWB1 (big blind) folded before Flop



PokerStars Hand #221913881453: Tournament #3082657132, $0.98+$0.12 USD Hold'em No Limit - Level XXXI (3600/7200) - 2020/12/27 21:51:21 EET [2020/12/27 14:51:21 ET]
Table '3082657132 89' 9-max Seat #8 is the button
Seat 1: neverwins333 (354388 in chips) 
Seat 2: TRACE'21'36 (181423 in chips) 
Seat 3: Sarg2006 (37146 in chips) is sitting out
Seat 4: jcarlos.vale (280722 in chips) 
Seat 5: stratos0071 (267309 in chips) 
Seat 6: abnormaarten (178320 in chips) 
Seat 8: vereke218 (565490 in chips) 
Seat 9: Lucas CWB1 (375606 in chips) 
neverwins333: posts the ante 900
TRACE'21'36: posts the ante 900
Sarg2006: posts the ante 900
jcarlos.vale: posts the ante 900
stratos0071: posts the ante 900
abnormaarten: posts the ante 900
vereke218: posts the ante 900
Lucas CWB1: posts the ante 900
Lucas CWB1: posts small blind 3600
neverwins333: posts big blind 7200
*** HOLE CARDS ***
Dealt to jcarlos.vale [4c Kc]
TRACE'21'36: folds 
Sarg2006: folds 
jcarlos.vale: folds 
stratos0071: folds 
abnormaarten: raises 8640 to 15840
vereke218: folds 
Lucas CWB1: folds 
neverwins333: folds 
Uncalled bet (8640) returned to abnormaarten
abnormaarten collected 25200 from pot
*** SUMMARY ***
Total pot 25200 | Rake 0 
Seat 1: neverwins333 (big blind) folded before Flop
Seat 2: TRACE'21'36 folded before Flop (didn't bet)
Seat 3: Sarg2006 folded before Flop (didn't bet)
Seat 4: jcarlos.vale folded before Flop (didn't bet)
Seat 5: stratos0071 folded before Flop (didn't bet)
Seat 6: abnormaarten collected (25200)
Seat 8: vereke218 (button) folded before Flop (didn't bet)
Seat 9: Lucas CWB1 (small blind) folded before Flop



PokerStars Hand #221913894863: Tournament #3082657132, $0.98+$0.12 USD Hold'em No Limit - Level XXXI (3600/7200) - 2020/12/27 21:51:36 EET [2020/12/27 14:51:36 ET]
Table '3082657132 89' 9-max Seat #9 is the button
Seat 1: neverwins333 (346288 in chips) 
Seat 2: TRACE'21'36 (180523 in chips) 
Seat 3: Sarg2006 (36246 in chips) is sitting out
Seat 4: jcarlos.vale (279822 in chips) 
Seat 5: stratos0071 (266409 in chips) 
Seat 6: abnormaarten (195420 in chips) 
Seat 8: vereke218 (564590 in chips) 
Seat 9: Lucas CWB1 (371106 in chips) 
neverwins333: posts the ante 900
TRACE'21'36: posts the ante 900
Sarg2006: posts the ante 900
jcarlos.vale: posts the ante 900
stratos0071: posts the ante 900
abnormaarten: posts the ante 900
vereke218: posts the ante 900
Lucas CWB1: posts the ante 900
neverwins333: posts small blind 3600
TRACE'21'36: posts big blind 7200
*** HOLE CARDS ***
Dealt to jcarlos.vale [Th 6h]
Sarg2006: folds 
jcarlos.vale: folds 
stratos0071: folds 
abnormaarten: folds 
vereke218: raises 7200 to 14400
Lucas CWB1: folds 
neverwins333: folds 
TRACE'21'36: calls 7200
*** FLOP *** [9s Jc 9h]
TRACE'21'36: checks 
vereke218: bets 19800
TRACE'21'36: folds 
Uncalled bet (19800) returned to vereke218
vereke218 collected 39600 from pot
vereke218: doesn't show handDTO
*** SUMMARY ***
Total pot 39600 | Rake 0 
Board [9s Jc 9h]
Seat 1: neverwins333 (small blind) folded before Flop
Seat 2: TRACE'21'36 (big blind) folded on the Flop
Seat 3: Sarg2006 folded before Flop (didn't bet)
Seat 4: jcarlos.vale folded before Flop (didn't bet)
Seat 5: stratos0071 folded before Flop (didn't bet)
Seat 6: abnormaarten folded before Flop (didn't bet)
Seat 8: vereke218 collected (39600)
Seat 9: Lucas CWB1 (button) folded before Flop (didn't bet)



PokerStars Hand #221913917255: Tournament #3082657132, $0.98+$0.12 USD Hold'em No Limit - Level XXXI (3600/7200) - 2020/12/27 21:52:00 EET [2020/12/27 14:52:00 ET]
Table '3082657132 89' 9-max Seat #1 is the button
Seat 1: neverwins333 (341788 in chips) 
Seat 2: TRACE'21'36 (165223 in chips) 
Seat 3: Sarg2006 (35346 in chips) is sitting out
Seat 4: jcarlos.vale (278922 in chips) 
Seat 5: stratos0071 (265509 in chips) 
Seat 6: abnormaarten (194520 in chips) 
Seat 8: vereke218 (588890 in chips) 
Seat 9: Lucas CWB1 (370206 in chips) 
neverwins333: posts the ante 900
TRACE'21'36: posts the ante 900
Sarg2006: posts the ante 900
jcarlos.vale: posts the ante 900
stratos0071: posts the ante 900
abnormaarten: posts the ante 900
vereke218: posts the ante 900
Lucas CWB1: posts the ante 900
TRACE'21'36: posts small blind 3600
Sarg2006: posts big blind 7200
*** HOLE CARDS ***
Dealt to jcarlos.vale [8d 5h]
jcarlos.vale: folds 
stratos0071: folds 
abnormaarten: folds 
vereke218: raises 7200 to 14400
Lucas CWB1: folds 
neverwins333: folds 
TRACE'21'36: raises 149923 to 164323 and is all-in
Sarg2006: folds 
vereke218: folds 
Uncalled bet (149923) returned to TRACE'21'36
TRACE'21'36 collected 43200 from pot
TRACE'21'36: doesn't show handDTO
*** SUMMARY ***
Total pot 43200 | Rake 0 
Seat 1: neverwins333 (button) folded before Flop (didn't bet)
Seat 2: TRACE'21'36 (small blind) collected (43200)
Seat 3: Sarg2006 (big blind) folded before Flop
Seat 4: jcarlos.vale folded before Flop (didn't bet)
Seat 5: stratos0071 folded before Flop (didn't bet)
Seat 6: abnormaarten folded before Flop (didn't bet)
Seat 8: vereke218 folded before Flop
Seat 9: Lucas CWB1 folded before Flop (didn't bet)



PokerStars Hand #221913939036: Tournament #3082657132, $0.98+$0.12 USD Hold'em No Limit - Level XXXI (3600/7200) - 2020/12/27 21:52:23 EET [2020/12/27 14:52:23 ET]
Table '3082657132 89' 9-max Seat #2 is the button
Seat 1: neverwins333 (340888 in chips) 
Seat 2: TRACE'21'36 (193123 in chips) 
Seat 3: Sarg2006 (27246 in chips) is sitting out
Seat 4: jcarlos.vale (278022 in chips) 
Seat 5: stratos0071 (264609 in chips) 
Seat 6: abnormaarten (193620 in chips) 
Seat 8: vereke218 (573590 in chips) 
Seat 9: Lucas CWB1 (369306 in chips) 
neverwins333: posts the ante 900
TRACE'21'36: posts the ante 900
Sarg2006: posts the ante 900
jcarlos.vale: posts the ante 900
stratos0071: posts the ante 900
abnormaarten: posts the ante 900
vereke218: posts the ante 900
Lucas CWB1: posts the ante 900
Sarg2006: posts small blind 3600
jcarlos.vale: posts big blind 7200
*** HOLE CARDS ***
Dealt to jcarlos.vale [Qh 9c]
stratos0071: folds 
abnormaarten: folds 
vereke218: folds 
Lucas CWB1: folds 
neverwins333: calls 7200
TRACE'21'36: folds 
Sarg2006: folds 
jcarlos.vale: checks 
*** FLOP *** [5h Td 6h]
jcarlos.vale: checks 
neverwins333: checks 
*** TURN *** [5h Td 6h] [Js]
jcarlos.vale: checks 
neverwins333: checks 
*** RIVER *** [5h Td 6h Js] [As]
jcarlos.vale: checks 
neverwins333: checks 
*** SHOW DOWN ***
jcarlos.vale: shows [Qh 9c] (high pairOfCards Ace)
neverwins333: shows [4h Ah] (a pair of Aces)
neverwins333 collected 25200 from pot
*** SUMMARY ***
Total pot 25200 | Rake 0 
Board [5h Td 6h Js As]
Seat 1: neverwins333 showed [4h Ah] and won (25200) with a pair of Aces
Seat 2: TRACE'21'36 (button) folded before Flop (didn't bet)
Seat 3: Sarg2006 (small blind) folded before Flop
Seat 4: jcarlos.vale (big blind) showed [Qh 9c] and lost with high pairOfCards Ace
Seat 5: stratos0071 folded before Flop (didn't bet)
Seat 6: abnormaarten folded before Flop (didn't bet)
Seat 8: vereke218 folded before Flop (didn't bet)
Seat 9: Lucas CWB1 folded before Flop (didn't bet)



PokerStars Hand #221913976720: Tournament #3082657132, $0.98+$0.12 USD Hold'em No Limit - Level XXXI (3600/7200) - 2020/12/27 21:53:03 EET [2020/12/27 14:53:03 ET]
Table '3082657132 89' 9-max Seat #3 is the button
Seat 1: neverwins333 (357988 in chips) 
Seat 2: TRACE'21'36 (192223 in chips) 
Seat 3: Sarg2006 (22746 in chips) is sitting out
Seat 4: jcarlos.vale (269922 in chips) 
Seat 5: stratos0071 (263709 in chips) 
Seat 6: abnormaarten (192720 in chips) 
Seat 8: vereke218 (572690 in chips) 
Seat 9: Lucas CWB1 (368406 in chips) 
neverwins333: posts the ante 900
TRACE'21'36: posts the ante 900
Sarg2006: posts the ante 900
jcarlos.vale: posts the ante 900
stratos0071: posts the ante 900
abnormaarten: posts the ante 900
vereke218: posts the ante 900
Lucas CWB1: posts the ante 900
jcarlos.vale: posts small blind 3600
stratos0071: posts big blind 7200
*** HOLE CARDS ***
Dealt to jcarlos.vale [5c Qd]
abnormaarten: folds 
vereke218: folds 
Lucas CWB1: folds 
neverwins333: folds 
TRACE'21'36: folds 
Sarg2006: folds 
jcarlos.vale: folds 
Uncalled bet (3600) returned to stratos0071
stratos0071 collected 14400 from pot
*** SUMMARY ***
Total pot 14400 | Rake 0 
Seat 1: neverwins333 folded before Flop (didn't bet)
Seat 2: TRACE'21'36 folded before Flop (didn't bet)
Seat 3: Sarg2006 (button) folded before Flop (didn't bet)
Seat 4: jcarlos.vale (small blind) folded before Flop
Seat 5: stratos0071 (big blind) collected (14400)
Seat 6: abnormaarten folded before Flop (didn't bet)
Seat 8: vereke218 folded before Flop (didn't bet)
Seat 9: Lucas CWB1 folded before Flop (didn't bet)



PokerStars Hand #221914000358: Tournament #3082657132, $0.98+$0.12 USD Hold'em No Limit - Level XXXI (3600/7200) - 2020/12/27 21:53:28 EET [2020/12/27 14:53:28 ET]
Table '3082657132 89' 9-max Seat #4 is the button
Seat 1: neverwins333 (357088 in chips) 
Seat 2: TRACE'21'36 (191323 in chips) 
Seat 3: Sarg2006 (21846 in chips) is sitting out
Seat 4: jcarlos.vale (265422 in chips) 
Seat 5: stratos0071 (273609 in chips) 
Seat 6: abnormaarten (191820 in chips) 
Seat 8: vereke218 (571790 in chips) 
Seat 9: Lucas CWB1 (367506 in chips) 
neverwins333: posts the ante 900
TRACE'21'36: posts the ante 900
Sarg2006: posts the ante 900
jcarlos.vale: posts the ante 900
stratos0071: posts the ante 900
abnormaarten: posts the ante 900
vereke218: posts the ante 900
Lucas CWB1: posts the ante 900
stratos0071: posts small blind 3600
abnormaarten: posts big blind 7200
*** HOLE CARDS ***
Dealt to jcarlos.vale [Kd 5c]
vereke218: raises 7200 to 14400
Lucas CWB1: folds 
neverwins333: folds 
TRACE'21'36: folds 
Sarg2006: folds 
jcarlos.vale: folds 
stratos0071: calls 10800
abnormaarten: folds 
*** FLOP *** [3h Th Ah]
stratos0071: checks 
vereke218: bets 14400
stratos0071: folds 
Uncalled bet (14400) returned to vereke218
vereke218 collected 43200 from pot
vereke218: doesn't show handDTO
*** SUMMARY ***
Total pot 43200 | Rake 0 
Board [3h Th Ah]
Seat 1: neverwins333 folded before Flop (didn't bet)
Seat 2: TRACE'21'36 folded before Flop (didn't bet)
Seat 3: Sarg2006 folded before Flop (didn't bet)
Seat 4: jcarlos.vale (button) folded before Flop (didn't bet)
Seat 5: stratos0071 (small blind) folded on the Flop
Seat 6: abnormaarten (big blind) folded before Flop
Seat 8: vereke218 collected (43200)
Seat 9: Lucas CWB1 folded before Flop (didn't bet)



PokerStars Hand #221914036270: Tournament #3082657132, $0.98+$0.12 USD Hold'em No Limit - Level XXXI (3600/7200) - 2020/12/27 21:53:58 EET [2020/12/27 14:53:58 ET]
Table '3082657132 89' 9-max Seat #5 is the button
Seat 1: neverwins333 (356188 in chips) 
Seat 2: TRACE'21'36 (190423 in chips) 
Seat 3: Sarg2006 (20946 in chips) is sitting out
Seat 4: jcarlos.vale (264522 in chips) 
Seat 5: stratos0071 (258309 in chips) 
Seat 6: abnormaarten (183720 in chips) 
Seat 8: vereke218 (599690 in chips) 
Seat 9: Lucas CWB1 (366606 in chips) 
neverwins333: posts the ante 900
TRACE'21'36: posts the ante 900
Sarg2006: posts the ante 900
jcarlos.vale: posts the ante 900
stratos0071: posts the ante 900
abnormaarten: posts the ante 900
vereke218: posts the ante 900
Lucas CWB1: posts the ante 900
abnormaarten: posts small blind 3600
vereke218: posts big blind 7200
*** HOLE CARDS ***
Dealt to jcarlos.vale [6h 5c]
Lucas CWB1: folds 
neverwins333: folds 
TRACE'21'36: raises 7200 to 14400
Sarg2006: folds 
jcarlos.vale: folds 
stratos0071: folds 
abnormaarten: folds 
vereke218: calls 7200
*** FLOP *** [3d Js Jh]
vereke218: checks 
TRACE'21'36: bets 12672
vereke218: folds 
Uncalled bet (12672) returned to TRACE'21'36
TRACE'21'36 collected 39600 from pot
TRACE'21'36: doesn't show handDTO
*** SUMMARY ***
Total pot 39600 | Rake 0 
Board [3d Js Jh]
Seat 1: neverwins333 folded before Flop (didn't bet)
Seat 2: TRACE'21'36 collected (39600)
Seat 3: Sarg2006 folded before Flop (didn't bet)
Seat 4: jcarlos.vale folded before Flop (didn't bet)
Seat 5: stratos0071 (button) folded before Flop (didn't bet)
Seat 6: abnormaarten (small blind) folded before Flop
Seat 8: vereke218 (big blind) folded on the Flop
Seat 9: Lucas CWB1 folded before Flop (didn't bet)



PokerStars Hand #221914066508: Tournament #3082657132, $0.98+$0.12 USD Hold'em No Limit - Level XXXI (3600/7200) - 2020/12/27 21:54:31 EET [2020/12/27 14:54:31 ET]
Table '3082657132 89' 9-max Seat #6 is the button
Seat 1: neverwins333 (355288 in chips) 
Seat 2: TRACE'21'36 (214723 in chips) 
Seat 3: Sarg2006 (20046 in chips) is sitting out
Seat 4: jcarlos.vale (263622 in chips) 
Seat 5: stratos0071 (257409 in chips) 
Seat 6: abnormaarten (179220 in chips) 
Seat 8: vereke218 (584390 in chips) 
Seat 9: Lucas CWB1 (365706 in chips) 
neverwins333: posts the ante 900
TRACE'21'36: posts the ante 900
Sarg2006: posts the ante 900
jcarlos.vale: posts the ante 900
stratos0071: posts the ante 900
abnormaarten: posts the ante 900
vereke218: posts the ante 900
Lucas CWB1: posts the ante 900
vereke218: posts small blind 3600
Lucas CWB1: posts big blind 7200
*** HOLE CARDS ***
Dealt to jcarlos.vale [Qc 7c]
neverwins333: folds 
TRACE'21'36: folds 
Sarg2006: folds 
jcarlos.vale: folds 
stratos0071: raises 7200 to 14400
abnormaarten: calls 14400
vereke218: folds 
Lucas CWB1: calls 7200
*** FLOP *** [3d 7d Ac]
Lucas CWB1: checks 
stratos0071: checks 
abnormaarten: checks 
*** TURN *** [3d 7d Ac] [2c]
Lucas CWB1: checks 
stratos0071: bets 14400
abnormaarten: calls 14400
Lucas CWB1: folds 
*** RIVER *** [3d 7d Ac 2c] [Kd]
stratos0071: bets 21600
abnormaarten: folds 
Uncalled bet (21600) returned to stratos0071
stratos0071 collected 82800 from pot
*** SUMMARY ***
Total pot 82800 | Rake 0 
Board [3d 7d Ac 2c Kd]
Seat 1: neverwins333 folded before Flop (didn't bet)
Seat 2: TRACE'21'36 folded before Flop (didn't bet)
Seat 3: Sarg2006 folded before Flop (didn't bet)
Seat 4: jcarlos.vale folded before Flop (didn't bet)
Seat 5: stratos0071 collected (82800)
Seat 6: abnormaarten (button) folded on the River
Seat 8: vereke218 (small blind) folded before Flop
Seat 9: Lucas CWB1 (big blind) folded on the Turn



PokerStars Hand #221914297548: Tournament #3082657132, $0.98+$0.12 USD Hold'em No Limit - Level XXXI (3600/7200) - 2020/12/27 22:00:52 EET [2020/12/27 15:00:52 ET]
Table '3082657132 89' 9-max Seat #8 is the button
Seat 1: neverwins333 (354388 in chips) 
Seat 2: TRACE'21'36 (213823 in chips) 
Seat 3: Sarg2006 (19146 in chips) is sitting out
Seat 4: jcarlos.vale (262722 in chips) 
Seat 5: stratos0071 (310509 in chips) 
Seat 6: abnormaarten (149520 in chips) 
Seat 8: vereke218 (579890 in chips) 
Seat 9: Lucas CWB1 (350406 in chips) 
neverwins333: posts the ante 900
TRACE'21'36: posts the ante 900
Sarg2006: posts the ante 900
jcarlos.vale: posts the ante 900
stratos0071: posts the ante 900
abnormaarten: posts the ante 900
vereke218: posts the ante 900
Lucas CWB1: posts the ante 900
Lucas CWB1: posts small blind 3600
neverwins333: posts big blind 7200
*** HOLE CARDS ***
Dealt to jcarlos.vale [Qc Jc]
TRACE'21'36: folds 
Sarg2006: folds 
jcarlos.vale: raises 11520 to 18720
stratos0071: folds 
abnormaarten: folds 
vereke218: folds 
Lucas CWB1: folds 
neverwins333: calls 11520
*** FLOP *** [As 9d Kd]
neverwins333: checks 
jcarlos.vale: bets 14400
neverwins333: folds 
Uncalled bet (14400) returned to jcarlos.vale
jcarlos.vale collected 48240 from pot
jcarlos.vale: doesn't show handDTO
*** SUMMARY ***
Total pot 48240 | Rake 0 
Board [As 9d Kd]
Seat 1: neverwins333 (big blind) folded on the Flop
Seat 2: TRACE'21'36 folded before Flop (didn't bet)
Seat 3: Sarg2006 folded before Flop (didn't bet)
Seat 4: jcarlos.vale collected (48240)
Seat 5: stratos0071 folded before Flop (didn't bet)
Seat 6: abnormaarten folded before Flop (didn't bet)
Seat 8: vereke218 (button) folded before Flop (didn't bet)
Seat 9: Lucas CWB1 (small blind) folded before Flop



PokerStars Hand #221914337580: Tournament #3082657132, $0.98+$0.12 USD Hold'em No Limit - Level XXXI (3600/7200) - 2020/12/27 22:01:50 EET [2020/12/27 15:01:50 ET]
Table '3082657132 89' 9-max Seat #9 is the button
Seat 1: neverwins333 (334768 in chips) 
Seat 2: TRACE'21'36 (212923 in chips) 
Seat 3: Sarg2006 (18246 in chips) is sitting out
Seat 4: jcarlos.vale (291342 in chips) 
Seat 5: stratos0071 (309609 in chips) 
Seat 6: abnormaarten (148620 in chips) 
Seat 8: vereke218 (578990 in chips) 
Seat 9: Lucas CWB1 (345906 in chips) 
neverwins333: posts the ante 900
TRACE'21'36: posts the ante 900
Sarg2006: posts the ante 900
jcarlos.vale: posts the ante 900
stratos0071: posts the ante 900
abnormaarten: posts the ante 900
vereke218: posts the ante 900
Lucas CWB1: posts the ante 900
neverwins333: posts small blind 3600
TRACE'21'36: posts big blind 7200
*** HOLE CARDS ***
Dealt to jcarlos.vale [Jh Kc]
Sarg2006: folds 
jcarlos.vale: raises 11520 to 18720
stratos0071: calls 18720
abnormaarten: folds 
vereke218: calls 18720
Lucas CWB1: folds 
neverwins333: folds 
TRACE'21'36: calls 11520
*** FLOP *** [4c 6c 5c]
TRACE'21'36: checks 
jcarlos.vale: bets 14400
stratos0071: folds 
vereke218: folds 
TRACE'21'36: raises 36634 to 51034
jcarlos.vale: folds 
Uncalled bet (36634) returned to TRACE'21'36
TRACE'21'36 collected 114480 from pot
TRACE'21'36: doesn't show handDTO
*** SUMMARY ***
Total pot 114480 | Rake 0 
Board [4c 6c 5c]
Seat 1: neverwins333 (small blind) folded before Flop
Seat 2: TRACE'21'36 (big blind) collected (114480)
Seat 3: Sarg2006 folded before Flop (didn't bet)
Seat 4: jcarlos.vale folded on the Flop
Seat 5: stratos0071 folded on the Flop
Seat 6: abnormaarten folded before Flop (didn't bet)
Seat 8: vereke218 folded on the Flop
Seat 9: Lucas CWB1 (button) folded before Flop (didn't bet)



PokerStars Hand #221914407250: Tournament #3082657132, $0.98+$0.12 USD Hold'em No Limit - Level XXXII (4000/8000) - 2020/12/27 22:03:09 EET [2020/12/27 15:03:09 ET]
Table '3082657132 89' 9-max Seat #1 is the button
Seat 1: neverwins333 (330268 in chips) 
Seat 2: TRACE'21'36 (293383 in chips) 
Seat 3: Sarg2006 (17346 in chips) is sitting out
Seat 4: jcarlos.vale (257322 in chips) 
Seat 5: stratos0071 (289989 in chips) 
Seat 6: abnormaarten (147720 in chips) 
Seat 8: vereke218 (559370 in chips) 
Seat 9: Lucas CWB1 (345006 in chips) 
neverwins333: posts the ante 1000
TRACE'21'36: posts the ante 1000
Sarg2006: posts the ante 1000
jcarlos.vale: posts the ante 1000
stratos0071: posts the ante 1000
abnormaarten: posts the ante 1000
vereke218: posts the ante 1000
Lucas CWB1: posts the ante 1000
TRACE'21'36: posts small blind 4000
Sarg2006: posts big blind 8000
*** HOLE CARDS ***
Dealt to jcarlos.vale [Ah 7s]
jcarlos.vale: folds 
stratos0071: folds 
abnormaarten: raises 9600 to 17600
vereke218: folds 
Lucas CWB1: folds 
neverwins333: folds 
TRACE'21'36: folds 
Sarg2006: folds 
Uncalled bet (9600) returned to abnormaarten
abnormaarten collected 28000 from pot
*** SUMMARY ***
Total pot 28000 | Rake 0 
Seat 1: neverwins333 (button) folded before Flop (didn't bet)
Seat 2: TRACE'21'36 (small blind) folded before Flop
Seat 3: Sarg2006 (big blind) folded before Flop
Seat 4: jcarlos.vale folded before Flop (didn't bet)
Seat 5: stratos0071 folded before Flop (didn't bet)
Seat 6: abnormaarten collected (28000)
Seat 8: vereke218 folded before Flop (didn't bet)
Seat 9: Lucas CWB1 folded before Flop (didn't bet)



PokerStars Hand #221914421881: Tournament #3082657132, $0.98+$0.12 USD Hold'em No Limit - Level XXXII (4000/8000) - 2020/12/27 22:03:25 EET [2020/12/27 15:03:25 ET]
Table '3082657132 89' 9-max Seat #2 is the button
Seat 1: neverwins333 (329268 in chips) 
Seat 2: TRACE'21'36 (288383 in chips) 
Seat 3: Sarg2006 (8346 in chips) is sitting out
Seat 4: jcarlos.vale (256322 in chips) 
Seat 5: stratos0071 (288989 in chips) 
Seat 6: abnormaarten (166720 in chips) 
Seat 8: vereke218 (558370 in chips) 
Seat 9: Lucas CWB1 (344006 in chips) 
neverwins333: posts the ante 1000
TRACE'21'36: posts the ante 1000
Sarg2006: posts the ante 1000
jcarlos.vale: posts the ante 1000
stratos0071: posts the ante 1000
abnormaarten: posts the ante 1000
vereke218: posts the ante 1000
Lucas CWB1: posts the ante 1000
Sarg2006: posts small blind 4000
jcarlos.vale: posts big blind 8000
*** HOLE CARDS ***
Dealt to jcarlos.vale [Qh 4c]
stratos0071: raises 8000 to 16000
abnormaarten: folds 
vereke218: folds 
Lucas CWB1: folds 
neverwins333: folds 
TRACE'21'36: folds 
Sarg2006: folds 
jcarlos.vale: folds 
Uncalled bet (8000) returned to stratos0071
stratos0071 collected 28000 from pot
*** SUMMARY ***
Total pot 28000 | Rake 0 
Seat 1: neverwins333 folded before Flop (didn't bet)
Seat 2: TRACE'21'36 (button) folded before Flop (didn't bet)
Seat 3: Sarg2006 (small blind) folded before Flop
Seat 4: jcarlos.vale (big blind) folded before Flop
Seat 5: stratos0071 collected (28000)
Seat 6: abnormaarten folded before Flop (didn't bet)
Seat 8: vereke218 folded before Flop (didn't bet)
Seat 9: Lucas CWB1 folded before Flop (didn't bet)



PokerStars Hand #221914440723: Tournament #3082657132, $0.98+$0.12 USD Hold'em No Limit - Level XXXII (4000/8000) - 2020/12/27 22:03:46 EET [2020/12/27 15:03:46 ET]
Table '3082657132 89' 9-max Seat #3 is the button
Seat 1: neverwins333 (328268 in chips) 
Seat 2: TRACE'21'36 (287383 in chips) 
Seat 3: Sarg2006 (3346 in chips) is sitting out
Seat 4: jcarlos.vale (247322 in chips) 
Seat 5: stratos0071 (307989 in chips) 
Seat 6: abnormaarten (165720 in chips) 
Seat 8: vereke218 (557370 in chips) 
Seat 9: Lucas CWB1 (343006 in chips) 
neverwins333: posts the ante 1000
TRACE'21'36: posts the ante 1000
Sarg2006: posts the ante 1000
jcarlos.vale: posts the ante 1000
stratos0071: posts the ante 1000
abnormaarten: posts the ante 1000
vereke218: posts the ante 1000
Lucas CWB1: posts the ante 1000
jcarlos.vale: posts small blind 4000
stratos0071: posts big blind 8000
*** HOLE CARDS ***
Dealt to jcarlos.vale [2c Kc]
abnormaarten: folds 
vereke218: raises 8000 to 16000
Lucas CWB1: folds 
neverwins333: folds 
TRACE'21'36: folds 
Sarg2006: folds 
jcarlos.vale: folds 
stratos0071: calls 8000
*** FLOP *** [Qc 2s Tc]
stratos0071: checks 
vereke218: bets 22000
stratos0071: calls 22000
*** TURN *** [Qc 2s Tc] [9h]
stratos0071: checks 
vereke218: checks 
*** RIVER *** [Qc 2s Tc 9h] [Ks]
stratos0071: bets 24000
vereke218: calls 24000
*** SHOW DOWN ***
stratos0071: shows [9c Qs] (two pair, Queens and Nines)
vereke218: mucks handDTO
stratos0071 collected 136000 from pot
*** SUMMARY ***
Total pot 136000 | Rake 0 
Board [Qc 2s Tc 9h Ks]
Seat 1: neverwins333 folded before Flop (didn't bet)
Seat 2: TRACE'21'36 folded before Flop (didn't bet)
Seat 3: Sarg2006 (button) folded before Flop (didn't bet)
Seat 4: jcarlos.vale (small blind) folded before Flop
Seat 5: stratos0071 (big blind) showed [9c Qs] and won (136000) with two pair, Queens and Nines
Seat 6: abnormaarten folded before Flop (didn't bet)
Seat 8: vereke218 mucked [Ac 6h]
Seat 9: Lucas CWB1 folded before Flop (didn't bet)



PokerStars Hand #221914498646: Tournament #3082657132, $0.98+$0.12 USD Hold'em No Limit - Level XXXII (4000/8000) - 2020/12/27 22:04:48 EET [2020/12/27 15:04:48 ET]
Table '3082657132 89' 9-max Seat #4 is the button
Seat 1: neverwins333 (327268 in chips) 
Seat 2: TRACE'21'36 (286383 in chips) 
Seat 3: Sarg2006 (2346 in chips) is sitting out
Seat 4: jcarlos.vale (242322 in chips) 
Seat 5: stratos0071 (380989 in chips) 
Seat 6: abnormaarten (164720 in chips) 
Seat 8: vereke218 (494370 in chips) 
Seat 9: Lucas CWB1 (342006 in chips) 
neverwins333: posts the ante 1000
TRACE'21'36: posts the ante 1000
Sarg2006: posts the ante 1000
jcarlos.vale: posts the ante 1000
stratos0071: posts the ante 1000
abnormaarten: posts the ante 1000
vereke218: posts the ante 1000
Lucas CWB1: posts the ante 1000
stratos0071: posts small blind 4000
abnormaarten: posts big blind 8000
*** HOLE CARDS ***
Dealt to jcarlos.vale [Ks 7s]
vereke218: folds 
Lucas CWB1: folds 
neverwins333: folds 
TRACE'21'36: folds 
Sarg2006: folds 
jcarlos.vale: raises 12800 to 20800
stratos0071: folds 
abnormaarten: calls 12800
*** FLOP *** [Ts 3c 8s]
abnormaarten: checks 
jcarlos.vale: bets 16000
abnormaarten: raises 126920 to 142920 and is all-in
jcarlos.vale: folds 
Uncalled bet (126920) returned to abnormaarten
abnormaarten collected 85600 from pot
abnormaarten: doesn't show handDTO
*** SUMMARY ***
Total pot 85600 | Rake 0 
Board [Ts 3c 8s]
Seat 1: neverwins333 folded before Flop (didn't bet)
Seat 2: TRACE'21'36 folded before Flop (didn't bet)
Seat 3: Sarg2006 folded before Flop (didn't bet)
Seat 4: jcarlos.vale (button) folded on the Flop
Seat 5: stratos0071 (small blind) folded before Flop
Seat 6: abnormaarten (big blind) collected (85600)
Seat 8: vereke218 folded before Flop (didn't bet)
Seat 9: Lucas CWB1 folded before Flop (didn't bet)



PokerStars Hand #221914531690: Tournament #3082657132, $0.98+$0.12 USD Hold'em No Limit - Level XXXII (4000/8000) - 2020/12/27 22:05:22 EET [2020/12/27 15:05:22 ET]
Table '3082657132 89' 9-max Seat #5 is the button
Seat 1: neverwins333 (326268 in chips) 
Seat 2: TRACE'21'36 (285383 in chips) 
Seat 3: Sarg2006 (1346 in chips) is sitting out
Seat 4: jcarlos.vale (204522 in chips) 
Seat 5: stratos0071 (375989 in chips) 
Seat 6: abnormaarten (212520 in chips) 
Seat 8: vereke218 (493370 in chips) 
Seat 9: Lucas CWB1 (341006 in chips) 
neverwins333: posts the ante 1000
TRACE'21'36: posts the ante 1000
Sarg2006: posts the ante 1000
jcarlos.vale: posts the ante 1000
stratos0071: posts the ante 1000
abnormaarten: posts the ante 1000
vereke218: posts the ante 1000
Lucas CWB1: posts the ante 1000
abnormaarten: posts small blind 4000
vereke218: posts big blind 8000
*** HOLE CARDS ***
Dealt to jcarlos.vale [7h 7c]
Lucas CWB1: folds 
neverwins333: calls 8000
TRACE'21'36: calls 8000
Sarg2006: folds 
jcarlos.vale: raises 12800 to 20800
stratos0071: folds 
abnormaarten: folds 
vereke218: folds 
neverwins333: calls 12800
TRACE'21'36: calls 12800
*** FLOP *** [8h Ks Ac]
neverwins333: checks 
TRACE'21'36: checks 
jcarlos.vale: checks 
*** TURN *** [8h Ks Ac] [Ah]
neverwins333: bets 82400
TRACE'21'36: folds 
jcarlos.vale: folds 
Uncalled bet (82400) returned to neverwins333
neverwins333 collected 82400 from pot
neverwins333: doesn't show handDTO
*** SUMMARY ***
Total pot 82400 | Rake 0 
Board [8h Ks Ac Ah]
Seat 1: neverwins333 collected (82400)
Seat 2: TRACE'21'36 folded on the Turn
Seat 3: Sarg2006 folded before Flop (didn't bet)
Seat 4: jcarlos.vale folded on the Turn
Seat 5: stratos0071 (button) folded before Flop (didn't bet)
Seat 6: abnormaarten (small blind) folded before Flop
Seat 8: vereke218 (big blind) folded before Flop
Seat 9: Lucas CWB1 folded before Flop (didn't bet)



PokerStars Hand #221914593501: Tournament #3082657132, $0.98+$0.12 USD Hold'em No Limit - Level XXXII (4000/8000) - 2020/12/27 22:06:26 EET [2020/12/27 15:06:26 ET]
Table '3082657132 89' 9-max Seat #6 is the button
Seat 1: neverwins333 (386868 in chips) 
Seat 2: TRACE'21'36 (263583 in chips) 
Seat 3: Sarg2006 (346 in chips) is sitting out
Seat 4: jcarlos.vale (182722 in chips) 
Seat 5: stratos0071 (374989 in chips) 
Seat 6: abnormaarten (207520 in chips) 
Seat 8: vereke218 (484370 in chips) 
Seat 9: Lucas CWB1 (340006 in chips) 
neverwins333: posts the ante 1000
TRACE'21'36: posts the ante 1000
Sarg2006: posts the ante 346 and is all-in
jcarlos.vale: posts the ante 1000
stratos0071: posts the ante 1000
abnormaarten: posts the ante 1000
vereke218: posts the ante 1000
Lucas CWB1: posts the ante 1000
vereke218: posts small blind 4000
Lucas CWB1: posts big blind 8000
*** HOLE CARDS ***
Dealt to jcarlos.vale [7d 8h]
neverwins333: folds 
TRACE'21'36: raises 8000 to 16000
Sarg2006: folds 
jcarlos.vale: folds 
stratos0071: calls 16000
abnormaarten: folds 
vereke218: folds 
Lucas CWB1: calls 8000
*** FLOP *** [2h 9c 3c]
Lucas CWB1: checks 
TRACE'21'36: bets 18991
stratos0071: folds 
Lucas CWB1: folds 
Uncalled bet (18991) returned to TRACE'21'36
TRACE'21'36 collected 59346 from pot
Sarg2006 finished the tournament in 29th place and received $7.31.
TRACE'21'36: doesn't show handDTO
*** SUMMARY ***
Total pot 59346 | Rake 0 
Board [2h 9c 3c]
Seat 1: neverwins333 folded before Flop (didn't bet)
Seat 2: TRACE'21'36 collected (59346)
Seat 3: Sarg2006 folded before Flop (didn't bet)
Seat 4: jcarlos.vale folded before Flop (didn't bet)
Seat 5: stratos0071 folded on the Flop
Seat 6: abnormaarten (button) folded before Flop (didn't bet)
Seat 8: vereke218 (small blind) folded before Flop
Seat 9: Lucas CWB1 (big blind) folded on the Flop



PokerStars Hand #221914661566: Tournament #3082657132, $0.98+$0.12 USD Hold'em No Limit - Level XXXII (4000/8000) - 2020/12/27 22:07:35 EET [2020/12/27 15:07:35 ET]
Table '3082657132 89' 9-max Seat #8 is the button
Seat 1: neverwins333 (385868 in chips) 
Seat 2: TRACE'21'36 (305929 in chips) 
Seat 4: jcarlos.vale (181722 in chips) 
Seat 5: stratos0071 (357989 in chips) 
Seat 6: abnormaarten (206520 in chips) 
Seat 8: vereke218 (479370 in chips) 
Seat 9: Lucas CWB1 (323006 in chips) 
neverwins333: posts the ante 1000
TRACE'21'36: posts the ante 1000
jcarlos.vale: posts the ante 1000
stratos0071: posts the ante 1000
abnormaarten: posts the ante 1000
vereke218: posts the ante 1000
Lucas CWB1: posts the ante 1000
Lucas CWB1: posts small blind 4000
neverwins333: posts big blind 8000
*** HOLE CARDS ***
Dealt to jcarlos.vale [Ad 9d]
TRACE'21'36: folds 
jcarlos.vale: raises 172722 to 180722 and is all-in
stratos0071: folds 
abnormaarten: calls 180722
vereke218: folds 
Lucas CWB1: folds 
neverwins333: folds 
*** FLOP *** [Qc 8s 7h]
*** TURN *** [Qc 8s 7h] [Jc]
*** RIVER *** [Qc 8s 7h Jc] [Ks]
*** SHOW DOWN ***
jcarlos.vale: shows [Ad 9d] (high pairOfCards Ace)
abnormaarten: shows [Ac Ah] (a pair of Aces)
abnormaarten collected 380444 from pot
jcarlos.vale finished the tournament in 28th place and received $7.31.
*** SUMMARY ***
Total pot 380444 | Rake 0 
Board [Qc 8s 7h Jc Ks]
Seat 1: neverwins333 (big blind) folded before Flop
Seat 2: TRACE'21'36 folded before Flop (didn't bet)
Seat 4: jcarlos.vale showed [Ad 9d] and lost with high pairOfCards Ace
Seat 5: stratos0071 folded before Flop (didn't bet)
Seat 6: abnormaarten showed [Ac Ah] and won (380444) with a pair of Aces
Seat 8: vereke218 (button) folded before Flop (didn't bet)
Seat 9: Lucas CWB1 (small blind) folded before Flop



