PokerStars Hand #222696958561: Tournament #3099770291, $0.98+$0.12 USD Hold'em No Limit - Level I (15/30) - 2021/01/16 20:00:05 EET [2021/01/16 13:00:05 ET]
Table '3099770291 62' 9-max Seat #1 is the button
Seat 1: di.nikity (5000 in chips) 
Seat 2: treytaylor20 (5000 in chips) 
Seat 3: tolentino_rd (5000 in chips) 
Seat 4: jcarlos.vale (5000 in chips) 
Seat 5: Nitriclol (5000 in chips) 
Seat 6: Izunna (5000 in chips) 
Seat 7: GutPewPew (5000 in chips) 
Seat 8: had3sssss (5000 in chips) 
Seat 9: raquel705 (5000 in chips) 
di.nikity: posts the ante 4
treytaylor20: posts the ante 4
tolentino_rd: posts the ante 4
jcarlos.vale: posts the ante 4
Nitriclol: posts the ante 4
Izunna: posts the ante 4
GutPewPew: posts the ante 4
had3sssss: posts the ante 4
raquel705: posts the ante 4
treytaylor20: posts small blind 15
tolentino_rd: posts big blind 30
*** HOLE CARDS ***
Dealt to jcarlos.vale [2c 4c]
jcarlos.vale: folds 
Nitriclol: folds 
Izunna: raises 45 to 75
GutPewPew: calls 75
had3sssss: calls 75
raquel705: calls 75
di.nikity: folds 
treytaylor20: folds 
tolentino_rd: folds 
*** FLOP *** [9h Th 3h]
Izunna: bets 171
GutPewPew: folds 
had3sssss: calls 171
raquel705: folds 
*** TURN *** [9h Th 3h] [Tc]
Izunna: bets 210
had3sssss: calls 210
*** RIVER *** [9h Th 3h Tc] [8c]
Izunna: bets 514
had3sssss: raises 1406 to 1920
Izunna: folds 
Uncalled bet (1406) returned to had3sssss
had3sssss collected 2171 from pot
had3sssss: doesn't show hand 
*** SUMMARY ***
Total pot 2171 | Rake 0 
Board [9h Th 3h Tc 8c]
Seat 1: di.nikity (button) folded before Flop (didn't bet)
Seat 2: treytaylor20 (small blind) folded before Flop
Seat 3: tolentino_rd (big blind) folded before Flop
Seat 4: jcarlos.vale folded before Flop (didn't bet)
Seat 5: Nitriclol folded before Flop (didn't bet)
Seat 6: Izunna folded on the River
Seat 7: GutPewPew folded on the Flop
Seat 8: had3sssss collected (2171)
Seat 9: raquel705 folded on the Flop



PokerStars Hand #222697058592: Tournament #3099770291, $0.98+$0.12 USD Hold'em No Limit - Level I (15/30) - 2021/01/16 20:02:34 EET [2021/01/16 13:02:34 ET]
Table '3099770291 62' 9-max Seat #2 is the button
Seat 1: di.nikity (4996 in chips) 
Seat 2: treytaylor20 (4981 in chips) 
Seat 3: tolentino_rd (4966 in chips) 
Seat 4: jcarlos.vale (4996 in chips) 
Seat 5: Nitriclol (4996 in chips) 
Seat 6: Izunna (4026 in chips) 
Seat 7: GutPewPew (4921 in chips) 
Seat 8: had3sssss (6197 in chips) 
Seat 9: raquel705 (4921 in chips) 
di.nikity: posts the ante 4
treytaylor20: posts the ante 4
tolentino_rd: posts the ante 4
jcarlos.vale: posts the ante 4
Nitriclol: posts the ante 4
Izunna: posts the ante 4
GutPewPew: posts the ante 4
had3sssss: posts the ante 4
raquel705: posts the ante 4
tolentino_rd: posts small blind 15
jcarlos.vale: posts big blind 30
*** HOLE CARDS ***
Dealt to jcarlos.vale [6d 9s]
Nitriclol: folds 
Izunna: folds 
GutPewPew: folds 
had3sssss: folds 
raquel705: folds 
di.nikity: folds 
treytaylor20: folds 
tolentino_rd: raises 60 to 90
jcarlos.vale: folds 
Uncalled bet (60) returned to tolentino_rd
tolentino_rd collected 96 from pot
*** SUMMARY ***
Total pot 96 | Rake 0 
Seat 1: di.nikity folded before Flop (didn't bet)
Seat 2: treytaylor20 (button) folded before Flop (didn't bet)
Seat 3: tolentino_rd (small blind) collected (96)
Seat 4: jcarlos.vale (big blind) folded before Flop
Seat 5: Nitriclol folded before Flop (didn't bet)
Seat 6: Izunna folded before Flop (didn't bet)
Seat 7: GutPewPew folded before Flop (didn't bet)
Seat 8: had3sssss folded before Flop (didn't bet)
Seat 9: raquel705 folded before Flop (didn't bet)



PokerStars Hand #222697071926: Tournament #3099770291, $0.98+$0.12 USD Hold'em No Limit - Level I (15/30) - 2021/01/16 20:02:52 EET [2021/01/16 13:02:52 ET]
Table '3099770291 62' 9-max Seat #3 is the button
Seat 1: di.nikity (4992 in chips) 
Seat 2: treytaylor20 (4977 in chips) 
Seat 3: tolentino_rd (5028 in chips) 
Seat 4: jcarlos.vale (4962 in chips) 
Seat 5: Nitriclol (4992 in chips) 
Seat 6: Izunna (4022 in chips) 
Seat 7: GutPewPew (4917 in chips) 
Seat 8: had3sssss (6193 in chips) 
Seat 9: raquel705 (4917 in chips) 
di.nikity: posts the ante 4
treytaylor20: posts the ante 4
tolentino_rd: posts the ante 4
jcarlos.vale: posts the ante 4
Nitriclol: posts the ante 4
Izunna: posts the ante 4
GutPewPew: posts the ante 4
had3sssss: posts the ante 4
raquel705: posts the ante 4
jcarlos.vale: posts small blind 15
Nitriclol: posts big blind 30
*** HOLE CARDS ***
Dealt to jcarlos.vale [4h 7h]
Izunna: folds 
GutPewPew: folds 
had3sssss: folds 
raquel705: folds 
di.nikity: folds 
treytaylor20: folds 
tolentino_rd: raises 60 to 90
jcarlos.vale: folds 
Nitriclol: calls 60
*** FLOP *** [5c 9h 8s]
Nitriclol: checks 
tolentino_rd: bets 150
Nitriclol: calls 150
*** TURN *** [5c 9h 8s] [Kh]
Nitriclol: checks 
tolentino_rd: checks 
*** RIVER *** [5c 9h 8s Kh] [5s]
Nitriclol: bets 159
tolentino_rd: folds 
Uncalled bet (159) returned to Nitriclol
Nitriclol collected 531 from pot
Nitriclol: doesn't show hand 
*** SUMMARY ***
Total pot 531 | Rake 0 
Board [5c 9h 8s Kh 5s]
Seat 1: di.nikity folded before Flop (didn't bet)
Seat 2: treytaylor20 folded before Flop (didn't bet)
Seat 3: tolentino_rd (button) folded on the River
Seat 4: jcarlos.vale (small blind) folded before Flop
Seat 5: Nitriclol (big blind) collected (531)
Seat 6: Izunna folded before Flop (didn't bet)
Seat 7: GutPewPew folded before Flop (didn't bet)
Seat 8: had3sssss folded before Flop (didn't bet)
Seat 9: raquel705 folded before Flop (didn't bet)



PokerStars Hand #222697123201: Tournament #3099770291, $0.98+$0.12 USD Hold'em No Limit - Level I (15/30) - 2021/01/16 20:04:04 EET [2021/01/16 13:04:04 ET]
Table '3099770291 62' 9-max Seat #4 is the button
Seat 1: di.nikity (4988 in chips) 
Seat 2: treytaylor20 (4973 in chips) 
Seat 3: tolentino_rd (4784 in chips) 
Seat 4: jcarlos.vale (4943 in chips) 
Seat 5: Nitriclol (5279 in chips) 
Seat 6: Izunna (4018 in chips) 
Seat 7: GutPewPew (4913 in chips) 
Seat 8: had3sssss (6189 in chips) 
di.nikity: posts the ante 4
treytaylor20: posts the ante 4
tolentino_rd: posts the ante 4
jcarlos.vale: posts the ante 4
Nitriclol: posts the ante 4
Izunna: posts the ante 4
GutPewPew: posts the ante 4
had3sssss: posts the ante 4
Nitriclol: posts small blind 15
Izunna: posts big blind 30
*** HOLE CARDS ***
Dealt to jcarlos.vale [Qc 3h]
GutPewPew: folds 
had3sssss: folds 
di.nikity: folds 
treytaylor20: folds 
tolentino_rd: folds 
jcarlos.vale: folds 
Nitriclol: raises 54 to 84
Izunna: calls 54
*** FLOP *** [Qs 2s Kc]
Nitriclol: bets 90
Izunna: calls 90
*** TURN *** [Qs 2s Kc] [Ad]
Nitriclol: bets 228
Izunna: calls 228
*** RIVER *** [Qs 2s Kc Ad] [2d]
Nitriclol: bets 502
Izunna: folds 
Uncalled bet (502) returned to Nitriclol
Nitriclol collected 836 from pot
Nitriclol: doesn't show hand 
*** SUMMARY ***
Total pot 836 | Rake 0 
Board [Qs 2s Kc Ad 2d]
Seat 1: di.nikity folded before Flop (didn't bet)
Seat 2: treytaylor20 folded before Flop (didn't bet)
Seat 3: tolentino_rd folded before Flop (didn't bet)
Seat 4: jcarlos.vale (button) folded before Flop (didn't bet)
Seat 5: Nitriclol (small blind) collected (836)
Seat 6: Izunna (big blind) folded on the River
Seat 7: GutPewPew folded before Flop (didn't bet)
Seat 8: had3sssss folded before Flop (didn't bet)



PokerStars Hand #222697180735: Tournament #3099770291, $0.98+$0.12 USD Hold'em No Limit - Level I (15/30) - 2021/01/16 20:05:22 EET [2021/01/16 13:05:22 ET]
Table '3099770291 62' 9-max Seat #5 is the button
Seat 2: treytaylor20 (4969 in chips) 
Seat 3: tolentino_rd (4780 in chips) 
Seat 4: jcarlos.vale (4939 in chips) 
Seat 5: Nitriclol (5709 in chips) 
Seat 6: Izunna (3612 in chips) 
Seat 7: GutPewPew (4909 in chips) 
Seat 8: had3sssss (6185 in chips) 
Seat 9: NotHereFish (5000 in chips) 
treytaylor20: posts the ante 4
tolentino_rd: posts the ante 4
jcarlos.vale: posts the ante 4
Nitriclol: posts the ante 4
Izunna: posts the ante 4
GutPewPew: posts the ante 4
had3sssss: posts the ante 4
NotHereFish: posts the ante 4
Izunna: posts small blind 15
GutPewPew: posts big blind 30
*** HOLE CARDS ***
Dealt to jcarlos.vale [Qc 4h]
had3sssss: folds 
NotHereFish: raises 60 to 90
treytaylor20: calls 90
tolentino_rd: folds 
jcarlos.vale: folds 
Nitriclol: folds 
Izunna: folds 
GutPewPew: folds 
*** FLOP *** [Ad 2h 6s]
NotHereFish: bets 93
treytaylor20: calls 93
*** TURN *** [Ad 2h 6s] [Kh]
NotHereFish: bets 240
treytaylor20: calls 240
*** RIVER *** [Ad 2h 6s Kh] [3d]
NotHereFish: bets 495
treytaylor20: calls 495
*** SHOW DOWN ***
NotHereFish: shows [Qd As] (a pair of Aces)
treytaylor20: shows [Ks 6h] (two pair, Kings and Sixes)
treytaylor20 collected 1913 from pot
*** SUMMARY ***
Total pot 1913 | Rake 0 
Board [Ad 2h 6s Kh 3d]
Seat 2: treytaylor20 showed [Ks 6h] and won (1913) with two pair, Kings and Sixes
Seat 3: tolentino_rd folded before Flop (didn't bet)
Seat 4: jcarlos.vale folded before Flop (didn't bet)
Seat 5: Nitriclol (button) folded before Flop (didn't bet)
Seat 6: Izunna (small blind) folded before Flop
Seat 7: GutPewPew (big blind) folded before Flop
Seat 8: had3sssss folded before Flop (didn't bet)
Seat 9: NotHereFish showed [Qd As] and lost with a pair of Aces



PokerStars Hand #222697248184: Tournament #3099770291, $0.98+$0.12 USD Hold'em No Limit - Level I (15/30) - 2021/01/16 20:06:47 EET [2021/01/16 13:06:47 ET]
Table '3099770291 62' 9-max Seat #6 is the button
Seat 1: lanerx5 (5000 in chips) 
Seat 2: treytaylor20 (5960 in chips) 
Seat 3: tolentino_rd (4776 in chips) 
Seat 4: jcarlos.vale (4935 in chips) 
Seat 5: Nitriclol (5705 in chips) 
Seat 6: Izunna (3593 in chips) 
Seat 7: GutPewPew (4875 in chips) 
Seat 8: had3sssss (6181 in chips) 
Seat 9: NotHereFish (4078 in chips) 
lanerx5: posts the ante 4
treytaylor20: posts the ante 4
tolentino_rd: posts the ante 4
jcarlos.vale: posts the ante 4
Nitriclol: posts the ante 4
Izunna: posts the ante 4
GutPewPew: posts the ante 4
had3sssss: posts the ante 4
NotHereFish: posts the ante 4
GutPewPew: posts small blind 15
had3sssss: posts big blind 30
*** HOLE CARDS ***
Dealt to jcarlos.vale [5d Kh]
NotHereFish: raises 45 to 75
lanerx5: folds 
treytaylor20: folds 
tolentino_rd: folds 
jcarlos.vale: folds 
Nitriclol: folds 
Izunna: calls 75
GutPewPew: calls 60
had3sssss: folds 
*** FLOP *** [2d Ks 8c]
GutPewPew: checks 
NotHereFish: bets 105
Izunna: calls 105
GutPewPew: calls 105
*** TURN *** [2d Ks 8c] [6c]
GutPewPew: checks 
NotHereFish: checks 
Izunna: bets 240
GutPewPew: calls 240
NotHereFish: folds 
*** RIVER *** [2d Ks 8c 6c] [Ad]
GutPewPew: checks 
Izunna: checks 
*** SHOW DOWN ***
GutPewPew: shows [Kd 8s] (two pair, Kings and Eights)
Izunna: mucks hand 
GutPewPew collected 1086 from pot
*** SUMMARY ***
Total pot 1086 | Rake 0 
Board [2d Ks 8c 6c Ad]
Seat 1: lanerx5 folded before Flop (didn't bet)
Seat 2: treytaylor20 folded before Flop (didn't bet)
Seat 3: tolentino_rd folded before Flop (didn't bet)
Seat 4: jcarlos.vale folded before Flop (didn't bet)
Seat 5: Nitriclol folded before Flop (didn't bet)
Seat 6: Izunna (button) mucked [Kc 7c]
Seat 7: GutPewPew (small blind) showed [Kd 8s] and won (1086) with two pair, Kings and Eights
Seat 8: had3sssss (big blind) folded before Flop
Seat 9: NotHereFish folded on the Turn



PokerStars Hand #222697320184: Tournament #3099770291, $0.98+$0.12 USD Hold'em No Limit - Level I (15/30) - 2021/01/16 20:08:23 EET [2021/01/16 13:08:23 ET]
Table '3099770291 62' 9-max Seat #7 is the button
Seat 1: lanerx5 (4996 in chips) 
Seat 2: treytaylor20 (5956 in chips) 
Seat 3: tolentino_rd (4772 in chips) 
Seat 4: jcarlos.vale (4931 in chips) 
Seat 5: Nitriclol (5701 in chips) 
Seat 6: Izunna (3169 in chips) 
Seat 7: GutPewPew (5537 in chips) 
Seat 8: had3sssss (6147 in chips) 
Seat 9: NotHereFish (3894 in chips) 
lanerx5: posts the ante 4
treytaylor20: posts the ante 4
tolentino_rd: posts the ante 4
jcarlos.vale: posts the ante 4
Nitriclol: posts the ante 4
Izunna: posts the ante 4
GutPewPew: posts the ante 4
had3sssss: posts the ante 4
NotHereFish: posts the ante 4
had3sssss: posts small blind 15
NotHereFish: posts big blind 30
*** HOLE CARDS ***
Dealt to jcarlos.vale [2h Qc]
lanerx5: calls 30
treytaylor20: folds 
tolentino_rd: folds 
jcarlos.vale: folds 
Nitriclol: calls 30
Izunna: raises 105 to 135
GutPewPew: folds 
had3sssss: folds 
NotHereFish: calls 105
lanerx5: calls 105
Nitriclol: folds 
*** FLOP *** [Qs 5h Qd]
NotHereFish: checks 
lanerx5: checks 
Izunna: bets 136
NotHereFish: calls 136
lanerx5: folds 
*** TURN *** [Qs 5h Qd] [8h]
NotHereFish: checks 
Izunna: bets 240
NotHereFish: calls 240
*** RIVER *** [Qs 5h Qd 8h] [6h]
NotHereFish: checks 
Izunna: checks 
*** SHOW DOWN ***
NotHereFish: shows [7c 7h] (two pair, Queens and Sevens)
Izunna: mucks hand 
NotHereFish collected 1238 from pot
*** SUMMARY ***
Total pot 1238 | Rake 0 
Board [Qs 5h Qd 8h 6h]
Seat 1: lanerx5 folded on the Flop
Seat 2: treytaylor20 folded before Flop (didn't bet)
Seat 3: tolentino_rd folded before Flop (didn't bet)
Seat 4: jcarlos.vale folded before Flop (didn't bet)
Seat 5: Nitriclol folded before Flop
Seat 6: Izunna mucked [Ah Jc]
Seat 7: GutPewPew (button) folded before Flop (didn't bet)
Seat 8: had3sssss (small blind) folded before Flop
Seat 9: NotHereFish (big blind) showed [7c 7h] and won (1238) with two pair, Queens and Sevens



PokerStars Hand #222697409512: Tournament #3099770291, $0.98+$0.12 USD Hold'em No Limit - Level II (20/40) - 2021/01/16 20:10:23 EET [2021/01/16 13:10:23 ET]
Table '3099770291 62' 9-max Seat #8 is the button
Seat 1: lanerx5 (4857 in chips) 
Seat 2: treytaylor20 (5952 in chips) 
Seat 3: tolentino_rd (4768 in chips) 
Seat 4: jcarlos.vale (4927 in chips) 
Seat 5: Nitriclol (5667 in chips) 
Seat 6: Izunna (2654 in chips) 
Seat 7: GutPewPew (5533 in chips) 
Seat 8: had3sssss (6128 in chips) 
Seat 9: NotHereFish (4617 in chips) 
lanerx5: posts the ante 5
treytaylor20: posts the ante 5
tolentino_rd: posts the ante 5
jcarlos.vale: posts the ante 5
Nitriclol: posts the ante 5
Izunna: posts the ante 5
GutPewPew: posts the ante 5
had3sssss: posts the ante 5
NotHereFish: posts the ante 5
NotHereFish: posts small blind 20
lanerx5: posts big blind 40
*** HOLE CARDS ***
Dealt to jcarlos.vale [Ks 5d]
treytaylor20: calls 40
tolentino_rd: calls 40
jcarlos.vale: folds 
Nitriclol: folds 
Izunna: folds 
GutPewPew: folds 
had3sssss: raises 225 to 265
NotHereFish: folds 
lanerx5: folds 
treytaylor20: folds 
tolentino_rd: folds 
Uncalled bet (225) returned to had3sssss
had3sssss collected 225 from pot
had3sssss: doesn't show hand 
*** SUMMARY ***
Total pot 225 | Rake 0 
Seat 1: lanerx5 (big blind) folded before Flop
Seat 2: treytaylor20 folded before Flop
Seat 3: tolentino_rd folded before Flop
Seat 4: jcarlos.vale folded before Flop (didn't bet)
Seat 5: Nitriclol folded before Flop (didn't bet)
Seat 6: Izunna folded before Flop (didn't bet)
Seat 7: GutPewPew folded before Flop (didn't bet)
Seat 8: had3sssss (button) collected (225)
Seat 9: NotHereFish (small blind) folded before Flop



PokerStars Hand #222697448207: Tournament #3099770291, $0.98+$0.12 USD Hold'em No Limit - Level II (20/40) - 2021/01/16 20:11:15 EET [2021/01/16 13:11:15 ET]
Table '3099770291 62' 9-max Seat #9 is the button
Seat 1: lanerx5 (4812 in chips) 
Seat 2: treytaylor20 (5907 in chips) 
Seat 3: tolentino_rd (4723 in chips) 
Seat 4: jcarlos.vale (4922 in chips) 
Seat 5: Nitriclol (5662 in chips) 
Seat 6: Izunna (2649 in chips) 
Seat 7: GutPewPew (5528 in chips) 
Seat 8: had3sssss (6308 in chips) 
Seat 9: NotHereFish (4592 in chips) 
lanerx5: posts the ante 5
treytaylor20: posts the ante 5
tolentino_rd: posts the ante 5
jcarlos.vale: posts the ante 5
Nitriclol: posts the ante 5
Izunna: posts the ante 5
GutPewPew: posts the ante 5
had3sssss: posts the ante 5
NotHereFish: posts the ante 5
lanerx5: posts small blind 20
treytaylor20: posts big blind 40
*** HOLE CARDS ***
Dealt to jcarlos.vale [Ac 5s]
tolentino_rd: folds 
jcarlos.vale: folds 
Nitriclol: raises 40 to 80
Izunna: calls 80
GutPewPew: raises 160 to 240
had3sssss: folds 
NotHereFish: folds 
lanerx5: folds 
treytaylor20: folds 
Nitriclol: folds 
Izunna: folds 
Uncalled bet (160) returned to GutPewPew
GutPewPew collected 345 from pot
GutPewPew: doesn't show hand 
*** SUMMARY ***
Total pot 345 | Rake 0 
Seat 1: lanerx5 (small blind) folded before Flop
Seat 2: treytaylor20 (big blind) folded before Flop
Seat 3: tolentino_rd folded before Flop (didn't bet)
Seat 4: jcarlos.vale folded before Flop (didn't bet)
Seat 5: Nitriclol folded before Flop
Seat 6: Izunna folded before Flop
Seat 7: GutPewPew collected (345)
Seat 8: had3sssss folded before Flop (didn't bet)
Seat 9: NotHereFish (button) folded before Flop (didn't bet)



PokerStars Hand #222697511392: Tournament #3099770291, $0.98+$0.12 USD Hold'em No Limit - Level II (20/40) - 2021/01/16 20:12:39 EET [2021/01/16 13:12:39 ET]
Table '3099770291 62' 9-max Seat #1 is the button
Seat 1: lanerx5 (4787 in chips) 
Seat 2: treytaylor20 (5862 in chips) 
Seat 3: tolentino_rd (4718 in chips) 
Seat 4: jcarlos.vale (4917 in chips) 
Seat 5: Nitriclol (5577 in chips) 
Seat 6: Izunna (2564 in chips) 
Seat 7: GutPewPew (5788 in chips) 
Seat 8: had3sssss (6303 in chips) 
Seat 9: NotHereFish (4587 in chips) 
lanerx5: posts the ante 5
treytaylor20: posts the ante 5
tolentino_rd: posts the ante 5
jcarlos.vale: posts the ante 5
Nitriclol: posts the ante 5
Izunna: posts the ante 5
GutPewPew: posts the ante 5
had3sssss: posts the ante 5
NotHereFish: posts the ante 5
treytaylor20: posts small blind 20
tolentino_rd: posts big blind 40
*** HOLE CARDS ***
Dealt to jcarlos.vale [9s 5c]
jcarlos.vale: folds 
Nitriclol: folds 
Izunna: folds 
GutPewPew: folds 
had3sssss: folds 
NotHereFish: folds 
lanerx5: calls 40
treytaylor20: folds 
tolentino_rd: checks 
*** FLOP *** [Td 4c 9d]
tolentino_rd: checks 
lanerx5: checks 
*** TURN *** [Td 4c 9d] [7d]
tolentino_rd: checks 
lanerx5: checks 
*** RIVER *** [Td 4c 9d 7d] [Ad]
tolentino_rd: checks 
lanerx5: checks 
*** SHOW DOWN ***
tolentino_rd: shows [Kc 3h] (high card Ace)
lanerx5: mucks hand 
tolentino_rd collected 145 from pot
*** SUMMARY ***
Total pot 145 | Rake 0 
Board [Td 4c 9d 7d Ad]
Seat 1: lanerx5 (button) mucked [6h Qh]
Seat 2: treytaylor20 (small blind) folded before Flop
Seat 3: tolentino_rd (big blind) showed [Kc 3h] and won (145) with high card Ace
Seat 4: jcarlos.vale folded before Flop (didn't bet)
Seat 5: Nitriclol folded before Flop (didn't bet)
Seat 6: Izunna folded before Flop (didn't bet)
Seat 7: GutPewPew folded before Flop (didn't bet)
Seat 8: had3sssss folded before Flop (didn't bet)
Seat 9: NotHereFish folded before Flop (didn't bet)



PokerStars Hand #222697552116: Tournament #3099770291, $0.98+$0.12 USD Hold'em No Limit - Level II (20/40) - 2021/01/16 20:13:34 EET [2021/01/16 13:13:34 ET]
Table '3099770291 62' 9-max Seat #2 is the button
Seat 1: lanerx5 (4742 in chips) 
Seat 2: treytaylor20 (5837 in chips) 
Seat 3: tolentino_rd (4818 in chips) 
Seat 4: jcarlos.vale (4912 in chips) 
Seat 5: Nitriclol (5572 in chips) 
Seat 6: Izunna (2559 in chips) 
Seat 7: GutPewPew (5783 in chips) 
Seat 8: had3sssss (6298 in chips) 
Seat 9: NotHereFish (4582 in chips) 
lanerx5: posts the ante 5
treytaylor20: posts the ante 5
tolentino_rd: posts the ante 5
jcarlos.vale: posts the ante 5
Nitriclol: posts the ante 5
Izunna: posts the ante 5
GutPewPew: posts the ante 5
had3sssss: posts the ante 5
NotHereFish: posts the ante 5
tolentino_rd: posts small blind 20
jcarlos.vale: posts big blind 40
*** HOLE CARDS ***
Dealt to jcarlos.vale [Kh Qd]
Nitriclol: folds 
Izunna: folds 
GutPewPew: folds 
had3sssss: folds 
NotHereFish: raises 60 to 100
lanerx5: folds 
treytaylor20: folds 
tolentino_rd: calls 80
jcarlos.vale: folds 
*** FLOP *** [7h As Kc]
tolentino_rd: checks 
NotHereFish: bets 103
tolentino_rd: calls 103
*** TURN *** [7h As Kc] [2s]
tolentino_rd: checks 
NotHereFish: checks 
*** RIVER *** [7h As Kc 2s] [Jc]
tolentino_rd: checks 
NotHereFish: bets 177
tolentino_rd: calls 177
*** SHOW DOWN ***
NotHereFish: shows [9s Ad] (a pair of Aces)
tolentino_rd: mucks hand 
NotHereFish collected 845 from pot
*** SUMMARY ***
Total pot 845 | Rake 0 
Board [7h As Kc 2s Jc]
Seat 1: lanerx5 folded before Flop (didn't bet)
Seat 2: treytaylor20 (button) folded before Flop (didn't bet)
Seat 3: tolentino_rd (small blind) mucked [3d Kd]
Seat 4: jcarlos.vale (big blind) folded before Flop
Seat 5: Nitriclol folded before Flop (didn't bet)
Seat 6: Izunna folded before Flop (didn't bet)
Seat 7: GutPewPew folded before Flop (didn't bet)
Seat 8: had3sssss folded before Flop (didn't bet)
Seat 9: NotHereFish showed [9s Ad] and won (845) with a pair of Aces



PokerStars Hand #222697617667: Tournament #3099770291, $0.98+$0.12 USD Hold'em No Limit - Level II (20/40) - 2021/01/16 20:15:02 EET [2021/01/16 13:15:02 ET]
Table '3099770291 62' 9-max Seat #3 is the button
Seat 1: lanerx5 (4737 in chips) 
Seat 2: treytaylor20 (5832 in chips) 
Seat 3: tolentino_rd (4433 in chips) 
Seat 4: jcarlos.vale (4867 in chips) 
Seat 5: Nitriclol (5567 in chips) 
Seat 6: Izunna (2554 in chips) 
Seat 7: GutPewPew (5778 in chips) 
Seat 8: had3sssss (6293 in chips) 
Seat 9: NotHereFish (5042 in chips) 
lanerx5: posts the ante 5
treytaylor20: posts the ante 5
tolentino_rd: posts the ante 5
jcarlos.vale: posts the ante 5
Nitriclol: posts the ante 5
Izunna: posts the ante 5
GutPewPew: posts the ante 5
had3sssss: posts the ante 5
NotHereFish: posts the ante 5
jcarlos.vale: posts small blind 20
Nitriclol: posts big blind 40
*** HOLE CARDS ***
Dealt to jcarlos.vale [5d 9c]
Izunna: folds 
GutPewPew: folds 
had3sssss: folds 
NotHereFish: folds 
lanerx5: folds 
treytaylor20: folds 
tolentino_rd: raises 40 to 80
jcarlos.vale: folds 
Nitriclol: raises 160 to 240
tolentino_rd: calls 160
*** FLOP *** [7s Kc Js]
Nitriclol: bets 164
tolentino_rd: folds 
Uncalled bet (164) returned to Nitriclol
Nitriclol collected 545 from pot
Nitriclol: doesn't show hand 
*** SUMMARY ***
Total pot 545 | Rake 0 
Board [7s Kc Js]
Seat 1: lanerx5 folded before Flop (didn't bet)
Seat 2: treytaylor20 folded before Flop (didn't bet)
Seat 3: tolentino_rd (button) folded on the Flop
Seat 4: jcarlos.vale (small blind) folded before Flop
Seat 5: Nitriclol (big blind) collected (545)
Seat 6: Izunna folded before Flop (didn't bet)
Seat 7: GutPewPew folded before Flop (didn't bet)
Seat 8: had3sssss folded before Flop (didn't bet)
Seat 9: NotHereFish folded before Flop (didn't bet)



PokerStars Hand #222697654955: Tournament #3099770291, $0.98+$0.12 USD Hold'em No Limit - Level II (20/40) - 2021/01/16 20:15:49 EET [2021/01/16 13:15:49 ET]
Table '3099770291 62' 9-max Seat #4 is the button
Seat 1: lanerx5 (4732 in chips) 
Seat 2: treytaylor20 (5827 in chips) 
Seat 3: tolentino_rd (4188 in chips) 
Seat 4: jcarlos.vale (4842 in chips) 
Seat 5: Nitriclol (5867 in chips) 
Seat 6: Izunna (2549 in chips) 
Seat 7: GutPewPew (5773 in chips) 
Seat 8: had3sssss (6288 in chips) 
Seat 9: NotHereFish (5037 in chips) 
lanerx5: posts the ante 5
treytaylor20: posts the ante 5
tolentino_rd: posts the ante 5
jcarlos.vale: posts the ante 5
Nitriclol: posts the ante 5
Izunna: posts the ante 5
GutPewPew: posts the ante 5
had3sssss: posts the ante 5
NotHereFish: posts the ante 5
Nitriclol: posts small blind 20
Izunna: posts big blind 40
*** HOLE CARDS ***
Dealt to jcarlos.vale [Td 7s]
GutPewPew: raises 60 to 100
had3sssss: folds 
NotHereFish: folds 
lanerx5: folds 
treytaylor20: folds 
tolentino_rd: calls 100
jcarlos.vale: folds 
Nitriclol: calls 80
Izunna: folds 
*** FLOP *** [6d 6h 5d]
Nitriclol: checks 
GutPewPew: bets 158
tolentino_rd: raises 575 to 733
Nitriclol: folds 
GutPewPew: calls 575
*** TURN *** [6d 6h 5d] [6s]
GutPewPew: checks 
tolentino_rd: bets 3350 and is all-in
GutPewPew: folds 
Uncalled bet (3350) returned to tolentino_rd
tolentino_rd collected 1851 from pot
*** SUMMARY ***
Total pot 1851 | Rake 0 
Board [6d 6h 5d 6s]
Seat 1: lanerx5 folded before Flop (didn't bet)
Seat 2: treytaylor20 folded before Flop (didn't bet)
Seat 3: tolentino_rd collected (1851)
Seat 4: jcarlos.vale (button) folded before Flop (didn't bet)
Seat 5: Nitriclol (small blind) folded on the Flop
Seat 6: Izunna (big blind) folded before Flop
Seat 7: GutPewPew folded on the Turn
Seat 8: had3sssss folded before Flop (didn't bet)
Seat 9: NotHereFish folded before Flop (didn't bet)



PokerStars Hand #222697731499: Tournament #3099770291, $0.98+$0.12 USD Hold'em No Limit - Level II (20/40) - 2021/01/16 20:17:25 EET [2021/01/16 13:17:25 ET]
Table '3099770291 62' 9-max Seat #5 is the button
Seat 1: lanerx5 (4727 in chips) 
Seat 2: treytaylor20 (5822 in chips) 
Seat 3: tolentino_rd (5201 in chips) 
Seat 4: jcarlos.vale (4837 in chips) 
Seat 5: Nitriclol (5762 in chips) 
Seat 6: Izunna (2504 in chips) 
Seat 7: GutPewPew (4935 in chips) 
Seat 8: had3sssss (6283 in chips) 
Seat 9: NotHereFish (5032 in chips) 
lanerx5: posts the ante 5
treytaylor20: posts the ante 5
tolentino_rd: posts the ante 5
jcarlos.vale: posts the ante 5
Nitriclol: posts the ante 5
Izunna: posts the ante 5
GutPewPew: posts the ante 5
had3sssss: posts the ante 5
NotHereFish: posts the ante 5
Izunna: posts small blind 20
GutPewPew: posts big blind 40
*** HOLE CARDS ***
Dealt to jcarlos.vale [7h Qd]
had3sssss: folds 
NotHereFish: folds 
lanerx5: calls 40
treytaylor20: calls 40
tolentino_rd: folds 
jcarlos.vale: folds 
Nitriclol: folds 
Izunna: calls 20
GutPewPew: checks 
*** FLOP *** [2h 6c 4c]
Izunna: checks 
GutPewPew: checks 
lanerx5: bets 160
treytaylor20: folds 
Izunna: folds 
GutPewPew: folds 
Uncalled bet (160) returned to lanerx5
lanerx5 collected 205 from pot
lanerx5: doesn't show hand 
*** SUMMARY ***
Total pot 205 | Rake 0 
Board [2h 6c 4c]
Seat 1: lanerx5 collected (205)
Seat 2: treytaylor20 folded on the Flop
Seat 3: tolentino_rd folded before Flop (didn't bet)
Seat 4: jcarlos.vale folded before Flop (didn't bet)
Seat 5: Nitriclol (button) folded before Flop (didn't bet)
Seat 6: Izunna (small blind) folded on the Flop
Seat 7: GutPewPew (big blind) folded on the Flop
Seat 8: had3sssss folded before Flop (didn't bet)
Seat 9: NotHereFish folded before Flop (didn't bet)



PokerStars Hand #222697779285: Tournament #3099770291, $0.98+$0.12 USD Hold'em No Limit - Level II (20/40) - 2021/01/16 20:18:25 EET [2021/01/16 13:18:25 ET]
Table '3099770291 62' 9-max Seat #6 is the button
Seat 1: lanerx5 (4887 in chips) 
Seat 2: treytaylor20 (5777 in chips) 
Seat 3: tolentino_rd (5196 in chips) 
Seat 4: jcarlos.vale (4832 in chips) 
Seat 5: Nitriclol (5757 in chips) 
Seat 6: Izunna (2459 in chips) 
Seat 7: GutPewPew (4890 in chips) 
Seat 8: had3sssss (6278 in chips) 
Seat 9: NotHereFish (5027 in chips) 
lanerx5: posts the ante 5
treytaylor20: posts the ante 5
tolentino_rd: posts the ante 5
jcarlos.vale: posts the ante 5
Nitriclol: posts the ante 5
Izunna: posts the ante 5
GutPewPew: posts the ante 5
had3sssss: posts the ante 5
NotHereFish: posts the ante 5
GutPewPew: posts small blind 20
had3sssss: posts big blind 40
*** HOLE CARDS ***
Dealt to jcarlos.vale [Ah 2h]
NotHereFish: folds 
lanerx5: folds 
treytaylor20: calls 40
tolentino_rd: folds 
jcarlos.vale: folds 
Nitriclol: folds 
Izunna: raises 112 to 152
GutPewPew: folds 
had3sssss: folds 
treytaylor20: calls 112
*** FLOP *** [7d 4d 5d]
treytaylor20: bets 5620 and is all-in
Izunna: folds 
Uncalled bet (5620) returned to treytaylor20
treytaylor20 collected 409 from pot
treytaylor20: doesn't show hand 
*** SUMMARY ***
Total pot 409 | Rake 0 
Board [7d 4d 5d]
Seat 1: lanerx5 folded before Flop (didn't bet)
Seat 2: treytaylor20 collected (409)
Seat 3: tolentino_rd folded before Flop (didn't bet)
Seat 4: jcarlos.vale folded before Flop (didn't bet)
Seat 5: Nitriclol folded before Flop (didn't bet)
Seat 6: Izunna (button) folded on the Flop
Seat 7: GutPewPew (small blind) folded before Flop
Seat 8: had3sssss (big blind) folded before Flop
Seat 9: NotHereFish folded before Flop (didn't bet)



PokerStars Hand #222697817323: Tournament #3099770291, $0.98+$0.12 USD Hold'em No Limit - Level II (20/40) - 2021/01/16 20:19:12 EET [2021/01/16 13:19:12 ET]
Table '3099770291 62' 9-max Seat #7 is the button
Seat 1: lanerx5 (4882 in chips) 
Seat 2: treytaylor20 (6029 in chips) 
Seat 3: tolentino_rd (5191 in chips) 
Seat 4: jcarlos.vale (4827 in chips) 
Seat 5: Nitriclol (5752 in chips) 
Seat 6: Izunna (2302 in chips) 
Seat 7: GutPewPew (4865 in chips) 
Seat 8: had3sssss (6233 in chips) 
Seat 9: NotHereFish (5022 in chips) 
lanerx5: posts the ante 5
treytaylor20: posts the ante 5
tolentino_rd: posts the ante 5
jcarlos.vale: posts the ante 5
Nitriclol: posts the ante 5
Izunna: posts the ante 5
GutPewPew: posts the ante 5
had3sssss: posts the ante 5
NotHereFish: posts the ante 5
had3sssss: posts small blind 20
NotHereFish: posts big blind 40
*** HOLE CARDS ***
Dealt to jcarlos.vale [7s 9h]
lanerx5: folds 
treytaylor20: folds 
tolentino_rd: folds 
jcarlos.vale: folds 
Nitriclol: folds 
Izunna: raises 60 to 100
GutPewPew: folds 
had3sssss: folds 
NotHereFish: folds 
Uncalled bet (60) returned to Izunna
Izunna collected 145 from pot
Izunna: doesn't show hand 
*** SUMMARY ***
Total pot 145 | Rake 0 
Seat 1: lanerx5 folded before Flop (didn't bet)
Seat 2: treytaylor20 folded before Flop (didn't bet)
Seat 3: tolentino_rd folded before Flop (didn't bet)
Seat 4: jcarlos.vale folded before Flop (didn't bet)
Seat 5: Nitriclol folded before Flop (didn't bet)
Seat 6: Izunna collected (145)
Seat 7: GutPewPew (button) folded before Flop (didn't bet)
Seat 8: had3sssss (small blind) folded before Flop
Seat 9: NotHereFish (big blind) folded before Flop



PokerStars Hand #222697849644: Tournament #3099770291, $0.98+$0.12 USD Hold'em No Limit - Level II (20/40) - 2021/01/16 20:19:52 EET [2021/01/16 13:19:52 ET]
Table '3099770291 62' 9-max Seat #8 is the button
Seat 1: lanerx5 (4877 in chips) 
Seat 2: treytaylor20 (6024 in chips) 
Seat 3: tolentino_rd (5186 in chips) 
Seat 4: jcarlos.vale (4822 in chips) 
Seat 5: Nitriclol (5747 in chips) 
Seat 6: Izunna (2402 in chips) 
Seat 7: GutPewPew (4860 in chips) 
Seat 8: had3sssss (6208 in chips) 
Seat 9: NotHereFish (4977 in chips) 
lanerx5: posts the ante 5
treytaylor20: posts the ante 5
tolentino_rd: posts the ante 5
jcarlos.vale: posts the ante 5
Nitriclol: posts the ante 5
Izunna: posts the ante 5
GutPewPew: posts the ante 5
had3sssss: posts the ante 5
NotHereFish: posts the ante 5
NotHereFish: posts small blind 20
lanerx5: posts big blind 40
*** HOLE CARDS ***
Dealt to jcarlos.vale [2c Qc]
treytaylor20: folds 
tolentino_rd: folds 
jcarlos.vale: folds 
Nitriclol: folds 
Izunna: folds 
GutPewPew: folds 
had3sssss: folds 
NotHereFish: raises 100 to 140
lanerx5: folds 
Uncalled bet (100) returned to NotHereFish
NotHereFish collected 125 from pot
NotHereFish: doesn't show hand 
*** SUMMARY ***
Total pot 125 | Rake 0 
Seat 1: lanerx5 (big blind) folded before Flop
Seat 2: treytaylor20 folded before Flop (didn't bet)
Seat 3: tolentino_rd folded before Flop (didn't bet)
Seat 4: jcarlos.vale folded before Flop (didn't bet)
Seat 5: Nitriclol folded before Flop (didn't bet)
Seat 6: Izunna folded before Flop (didn't bet)
Seat 7: GutPewPew folded before Flop (didn't bet)
Seat 8: had3sssss (button) folded before Flop (didn't bet)
Seat 9: NotHereFish (small blind) collected (125)



PokerStars Hand #222697873986: Tournament #3099770291, $0.98+$0.12 USD Hold'em No Limit - Level III (25/50) - 2021/01/16 20:20:22 EET [2021/01/16 13:20:22 ET]
Table '3099770291 62' 9-max Seat #9 is the button
Seat 1: lanerx5 (4832 in chips) 
Seat 2: treytaylor20 (6019 in chips) 
Seat 3: tolentino_rd (5181 in chips) 
Seat 4: jcarlos.vale (4817 in chips) 
Seat 5: Nitriclol (5742 in chips) 
Seat 6: Izunna (2397 in chips) 
Seat 7: GutPewPew (4855 in chips) 
Seat 8: had3sssss (6203 in chips) 
Seat 9: NotHereFish (5057 in chips) 
lanerx5: posts the ante 6
treytaylor20: posts the ante 6
tolentino_rd: posts the ante 6
jcarlos.vale: posts the ante 6
Nitriclol: posts the ante 6
Izunna: posts the ante 6
GutPewPew: posts the ante 6
had3sssss: posts the ante 6
NotHereFish: posts the ante 6
lanerx5: posts small blind 25
treytaylor20: posts big blind 50
*** HOLE CARDS ***
Dealt to jcarlos.vale [Ac 5h]
tolentino_rd: raises 50 to 100
jcarlos.vale: folds 
Nitriclol: folds 
Izunna: folds 
GutPewPew: folds 
had3sssss: calls 100
NotHereFish: folds 
lanerx5: folds 
treytaylor20: folds 
*** FLOP *** [3s 6h 9d]
tolentino_rd: checks 
had3sssss: checks 
*** TURN *** [3s 6h 9d] [8h]
tolentino_rd: checks 
had3sssss: bets 220
tolentino_rd: calls 220
*** RIVER *** [3s 6h 9d 8h] [3d]
tolentino_rd: checks 
had3sssss: bets 600
tolentino_rd: folds 
Uncalled bet (600) returned to had3sssss
had3sssss collected 769 from pot
had3sssss: doesn't show hand 
*** SUMMARY ***
Total pot 769 | Rake 0 
Board [3s 6h 9d 8h 3d]
Seat 1: lanerx5 (small blind) folded before Flop
Seat 2: treytaylor20 (big blind) folded before Flop
Seat 3: tolentino_rd folded on the River
Seat 4: jcarlos.vale folded before Flop (didn't bet)
Seat 5: Nitriclol folded before Flop (didn't bet)
Seat 6: Izunna folded before Flop (didn't bet)
Seat 7: GutPewPew folded before Flop (didn't bet)
Seat 8: had3sssss collected (769)
Seat 9: NotHereFish (button) folded before Flop (didn't bet)



PokerStars Hand #222697930472: Tournament #3099770291, $0.98+$0.12 USD Hold'em No Limit - Level III (25/50) - 2021/01/16 20:21:33 EET [2021/01/16 13:21:33 ET]
Table '3099770291 62' 9-max Seat #1 is the button
Seat 1: lanerx5 (4801 in chips) 
Seat 2: treytaylor20 (5963 in chips) 
Seat 4: jcarlos.vale (4811 in chips) 
Seat 5: Nitriclol (5736 in chips) 
Seat 6: Izunna (2391 in chips) 
Seat 7: GutPewPew (4849 in chips) 
Seat 8: had3sssss (6646 in chips) 
Seat 9: NotHereFish (5051 in chips) 
lanerx5: posts the ante 6
treytaylor20: posts the ante 6
jcarlos.vale: posts the ante 6
Nitriclol: posts the ante 6
Izunna: posts the ante 6
GutPewPew: posts the ante 6
had3sssss: posts the ante 6
NotHereFish: posts the ante 6
treytaylor20: posts small blind 25
jcarlos.vale: posts big blind 50
*** HOLE CARDS ***
Dealt to jcarlos.vale [Ac Qs]
Nitriclol: folds 
Izunna: folds 
GutPewPew: folds 
had3sssss: folds 
NotHereFish: folds 
lanerx5: raises 100 to 150
treytaylor20: folds 
jcarlos.vale: calls 100
*** FLOP *** [Qd 6d 7c]
jcarlos.vale: bets 280
lanerx5: calls 280
*** TURN *** [Qd 6d 7c] [Qc]
jcarlos.vale: bets 700
lanerx5: calls 700
*** RIVER *** [Qd 6d 7c Qc] [4h]
jcarlos.vale: bets 1750
lanerx5: raises 1915 to 3665 and is all-in
jcarlos.vale: calls 1915
*** SHOW DOWN ***
lanerx5: shows [Td Tc] (two pair, Queens and Tens)
jcarlos.vale: shows [Ac Qs] (three of a kind, Queens)
jcarlos.vale collected 9663 from pot
lanerx5 finished the tournament
*** SUMMARY ***
Total pot 9663 | Rake 0 
Board [Qd 6d 7c Qc 4h]
Seat 1: lanerx5 (button) showed [Td Tc] and lost with two pair, Queens and Tens
Seat 2: treytaylor20 (small blind) folded before Flop
Seat 4: jcarlos.vale (big blind) showed [Ac Qs] and won (9663) with three of a kind, Queens
Seat 5: Nitriclol folded before Flop (didn't bet)
Seat 6: Izunna folded before Flop (didn't bet)
Seat 7: GutPewPew folded before Flop (didn't bet)
Seat 8: had3sssss folded before Flop (didn't bet)
Seat 9: NotHereFish folded before Flop (didn't bet)



PokerStars Hand #222697991674: Tournament #3099770291, $0.98+$0.12 USD Hold'em No Limit - Level III (25/50) - 2021/01/16 20:22:48 EET [2021/01/16 13:22:48 ET]
Table '3099770291 62' 9-max Seat #2 is the button
Seat 2: treytaylor20 (5932 in chips) 
Seat 3: 812b4 (5000 in chips) out of hand (moved from another table into small blind)
Seat 4: jcarlos.vale (9673 in chips) 
Seat 6: Izunna (2385 in chips) 
Seat 7: GutPewPew (4843 in chips) 
Seat 8: had3sssss (6640 in chips) 
Seat 9: NotHereFish (5045 in chips) 
812b4 will be allowed to play after the button
treytaylor20: posts the ante 6
jcarlos.vale: posts the ante 6
Izunna: posts the ante 6
GutPewPew: posts the ante 6
had3sssss: posts the ante 6
NotHereFish: posts the ante 6
jcarlos.vale: posts small blind 25
Izunna: posts big blind 50
*** HOLE CARDS ***
Dealt to jcarlos.vale [9c 2h]
GutPewPew: folds 
had3sssss: folds 
NotHereFish: folds 
treytaylor20: folds 
jcarlos.vale: folds 
Uncalled bet (25) returned to Izunna
Izunna collected 86 from pot
Izunna: doesn't show hand 
*** SUMMARY ***
Total pot 86 | Rake 0 
Seat 2: treytaylor20 (button) folded before Flop (didn't bet)
Seat 4: jcarlos.vale (small blind) folded before Flop
Seat 6: Izunna (big blind) collected (86)
Seat 7: GutPewPew folded before Flop (didn't bet)
Seat 8: had3sssss folded before Flop (didn't bet)
Seat 9: NotHereFish folded before Flop (didn't bet)



PokerStars Hand #222698011513: Tournament #3099770291, $0.98+$0.12 USD Hold'em No Limit - Level III (25/50) - 2021/01/16 20:23:13 EET [2021/01/16 13:23:13 ET]
Table '3099770291 62' 9-max Seat #4 is the button
Seat 1: judith.f (4651 in chips) 
Seat 2: treytaylor20 (5926 in chips) 
Seat 3: 812b4 (5000 in chips) 
Seat 4: jcarlos.vale (9642 in chips) 
Seat 5: phantofant (5000 in chips) out of hand (moved from another table into small blind)
Seat 6: Izunna (2440 in chips) 
Seat 7: GutPewPew (4837 in chips) 
Seat 8: had3sssss (6634 in chips) 
Seat 9: NotHereFish (5039 in chips) 
phantofant will be allowed to play after the button
judith.f: posts the ante 6
treytaylor20: posts the ante 6
812b4: posts the ante 6
jcarlos.vale: posts the ante 6
Izunna: posts the ante 6
GutPewPew: posts the ante 6
had3sssss: posts the ante 6
NotHereFish: posts the ante 6
Izunna: posts small blind 25
GutPewPew: posts big blind 50
*** HOLE CARDS ***
Dealt to jcarlos.vale [3c 9h]
had3sssss: folds 
NotHereFish: folds 
judith.f: folds 
treytaylor20: folds 
812b4: raises 300 to 350
jcarlos.vale: folds 
Izunna: folds 
GutPewPew: folds 
Uncalled bet (300) returned to 812b4
812b4 collected 173 from pot
812b4: doesn't show hand 
*** SUMMARY ***
Total pot 173 | Rake 0 
Seat 1: judith.f folded before Flop (didn't bet)
Seat 2: treytaylor20 folded before Flop (didn't bet)
Seat 3: 812b4 collected (173)
Seat 4: jcarlos.vale (button) folded before Flop (didn't bet)
Seat 6: Izunna (small blind) folded before Flop
Seat 7: GutPewPew (big blind) folded before Flop
Seat 8: had3sssss folded before Flop (didn't bet)
Seat 9: NotHereFish folded before Flop (didn't bet)



PokerStars Hand #222698059143: Tournament #3099770291, $0.98+$0.12 USD Hold'em No Limit - Level III (25/50) - 2021/01/16 20:24:11 EET [2021/01/16 13:24:11 ET]
Table '3099770291 62' 9-max Seat #6 is the button
Seat 1: judith.f (4645 in chips) 
Seat 2: treytaylor20 (5920 in chips) 
Seat 3: 812b4 (5117 in chips) 
Seat 4: jcarlos.vale (9636 in chips) 
Seat 5: phantofant (5000 in chips) 
Seat 6: Izunna (2409 in chips) 
Seat 7: GutPewPew (4781 in chips) 
Seat 8: had3sssss (6628 in chips) 
Seat 9: NotHereFish (5033 in chips) 
judith.f: posts the ante 6
treytaylor20: posts the ante 6
812b4: posts the ante 6
jcarlos.vale: posts the ante 6
phantofant: posts the ante 6
Izunna: posts the ante 6
GutPewPew: posts the ante 6
had3sssss: posts the ante 6
NotHereFish: posts the ante 6
GutPewPew: posts small blind 25
had3sssss: posts big blind 50
*** HOLE CARDS ***
Dealt to jcarlos.vale [6d Jc]
NotHereFish: folds 
judith.f: folds 
treytaylor20: calls 50
812b4: calls 50
jcarlos.vale: folds 
phantofant: calls 50
Izunna: folds 
GutPewPew: calls 25
had3sssss: checks 
*** FLOP *** [5c Th 5d]
GutPewPew: checks 
had3sssss: checks 
treytaylor20: checks 
812b4: bets 304
phantofant: folds 
GutPewPew: folds 
had3sssss: calls 304
treytaylor20: folds 
*** TURN *** [5c Th 5d] [9h]
had3sssss: checks 
812b4: checks 
*** RIVER *** [5c Th 5d 9h] [7d]
had3sssss: bets 611
812b4: calls 611
*** SHOW DOWN ***
had3sssss: shows [8c 5s] (three of a kind, Fives)
812b4: mucks hand 
had3sssss collected 2134 from pot
*** SUMMARY ***
Total pot 2134 | Rake 0 
Board [5c Th 5d 9h 7d]
Seat 1: judith.f folded before Flop (didn't bet)
Seat 2: treytaylor20 folded on the Flop
Seat 3: 812b4 mucked [As Tc]
Seat 4: jcarlos.vale folded before Flop (didn't bet)
Seat 5: phantofant folded on the Flop
Seat 6: Izunna (button) folded before Flop (didn't bet)
Seat 7: GutPewPew (small blind) folded on the Flop
Seat 8: had3sssss (big blind) showed [8c 5s] and won (2134) with three of a kind, Fives
Seat 9: NotHereFish folded before Flop (didn't bet)



PokerStars Hand #222698107315: Tournament #3099770291, $0.98+$0.12 USD Hold'em No Limit - Level III (25/50) - 2021/01/16 20:25:10 EET [2021/01/16 13:25:10 ET]
Table '3099770291 62' 9-max Seat #7 is the button
Seat 1: judith.f (4639 in chips) 
Seat 2: treytaylor20 (5864 in chips) 
Seat 3: 812b4 (4146 in chips) 
Seat 4: jcarlos.vale (9630 in chips) 
Seat 5: phantofant (4944 in chips) 
Seat 6: Izunna (2403 in chips) 
Seat 7: GutPewPew (4725 in chips) 
Seat 8: had3sssss (7791 in chips) 
Seat 9: NotHereFish (5027 in chips) 
judith.f: posts the ante 6
treytaylor20: posts the ante 6
812b4: posts the ante 6
jcarlos.vale: posts the ante 6
phantofant: posts the ante 6
Izunna: posts the ante 6
GutPewPew: posts the ante 6
had3sssss: posts the ante 6
NotHereFish: posts the ante 6
had3sssss: posts small blind 25
NotHereFish: posts big blind 50
*** HOLE CARDS ***
Dealt to jcarlos.vale [Jc Ad]
judith.f: raises 65 to 115
treytaylor20: folds 
812b4: calls 115
jcarlos.vale: folds 
phantofant: folds 
Izunna: folds 
GutPewPew: folds 
had3sssss: folds 
NotHereFish: calls 65
*** FLOP *** [9h 2s 6h]
NotHereFish: checks 
judith.f: bets 300
812b4: folds 
NotHereFish: folds 
Uncalled bet (300) returned to judith.f
judith.f collected 424 from pot
judith.f: doesn't show hand 
*** SUMMARY ***
Total pot 424 | Rake 0 
Board [9h 2s 6h]
Seat 1: judith.f collected (424)
Seat 2: treytaylor20 folded before Flop (didn't bet)
Seat 3: 812b4 folded on the Flop
Seat 4: jcarlos.vale folded before Flop (didn't bet)
Seat 5: phantofant folded before Flop (didn't bet)
Seat 6: Izunna folded before Flop (didn't bet)
Seat 7: GutPewPew (button) folded before Flop (didn't bet)
Seat 8: had3sssss (small blind) folded before Flop
Seat 9: NotHereFish (big blind) folded on the Flop



PokerStars Hand #222698160975: Tournament #3099770291, $0.98+$0.12 USD Hold'em No Limit - Level III (25/50) - 2021/01/16 20:26:03 EET [2021/01/16 13:26:03 ET]
Table '3099770291 62' 9-max Seat #8 is the button
Seat 1: judith.f (4942 in chips) 
Seat 2: treytaylor20 (5858 in chips) 
Seat 3: 812b4 (4025 in chips) 
Seat 4: jcarlos.vale (9624 in chips) 
Seat 5: phantofant (4938 in chips) 
Seat 6: Izunna (2397 in chips) 
Seat 7: GutPewPew (4719 in chips) 
Seat 8: had3sssss (7760 in chips) 
Seat 9: NotHereFish (4906 in chips) 
judith.f: posts the ante 6
treytaylor20: posts the ante 6
812b4: posts the ante 6
jcarlos.vale: posts the ante 6
phantofant: posts the ante 6
Izunna: posts the ante 6
GutPewPew: posts the ante 6
had3sssss: posts the ante 6
NotHereFish: posts the ante 6
NotHereFish: posts small blind 25
judith.f: posts big blind 50
*** HOLE CARDS ***
Dealt to jcarlos.vale [Qh Kc]
treytaylor20: folds 
812b4: raises 50 to 100
jcarlos.vale: folds 
phantofant: folds 
Izunna: folds 
GutPewPew: raises 200 to 300
had3sssss: folds 
NotHereFish: folds 
judith.f: folds 
812b4: calls 200
*** FLOP *** [4c 9h 5d]
812b4: checks 
GutPewPew: bets 503
812b4: folds 
Uncalled bet (503) returned to GutPewPew
GutPewPew collected 729 from pot
GutPewPew: doesn't show hand 
*** SUMMARY ***
Total pot 729 | Rake 0 
Board [4c 9h 5d]
Seat 1: judith.f (big blind) folded before Flop
Seat 2: treytaylor20 folded before Flop (didn't bet)
Seat 3: 812b4 folded on the Flop
Seat 4: jcarlos.vale folded before Flop (didn't bet)
Seat 5: phantofant folded before Flop (didn't bet)
Seat 6: Izunna folded before Flop (didn't bet)
Seat 7: GutPewPew collected (729)
Seat 8: had3sssss (button) folded before Flop (didn't bet)
Seat 9: NotHereFish (small blind) folded before Flop



PokerStars Hand #222698236597: Tournament #3099770291, $0.98+$0.12 USD Hold'em No Limit - Level III (25/50) - 2021/01/16 20:27:36 EET [2021/01/16 13:27:36 ET]
Table '3099770291 62' 9-max Seat #9 is the button
Seat 1: judith.f (4886 in chips) 
Seat 2: treytaylor20 (5852 in chips) 
Seat 3: 812b4 (3719 in chips) 
Seat 4: jcarlos.vale (9618 in chips) 
Seat 5: phantofant (4932 in chips) 
Seat 6: Izunna (2391 in chips) 
Seat 7: GutPewPew (5142 in chips) 
Seat 8: had3sssss (7754 in chips) 
Seat 9: NotHereFish (4875 in chips) 
judith.f: posts the ante 6
treytaylor20: posts the ante 6
812b4: posts the ante 6
jcarlos.vale: posts the ante 6
phantofant: posts the ante 6
Izunna: posts the ante 6
GutPewPew: posts the ante 6
had3sssss: posts the ante 6
NotHereFish: posts the ante 6
judith.f: posts small blind 25
treytaylor20: posts big blind 50
*** HOLE CARDS ***
Dealt to jcarlos.vale [7h 8s]
812b4: folds 
jcarlos.vale: folds 
phantofant: calls 50
Izunna: folds 
GutPewPew: folds 
had3sssss: folds 
NotHereFish: raises 125 to 175
judith.f: folds 
treytaylor20: folds 
phantofant: calls 125
*** FLOP *** [9d 7d Th]
phantofant: bets 50
NotHereFish: raises 208 to 258
phantofant: folds 
Uncalled bet (208) returned to NotHereFish
NotHereFish collected 579 from pot
NotHereFish: doesn't show hand 
*** SUMMARY ***
Total pot 579 | Rake 0 
Board [9d 7d Th]
Seat 1: judith.f (small blind) folded before Flop
Seat 2: treytaylor20 (big blind) folded before Flop
Seat 3: 812b4 folded before Flop (didn't bet)
Seat 4: jcarlos.vale folded before Flop (didn't bet)
Seat 5: phantofant folded on the Flop
Seat 6: Izunna folded before Flop (didn't bet)
Seat 7: GutPewPew folded before Flop (didn't bet)
Seat 8: had3sssss folded before Flop (didn't bet)
Seat 9: NotHereFish (button) collected (579)



PokerStars Hand #222698294485: Tournament #3099770291, $0.98+$0.12 USD Hold'em No Limit - Level III (25/50) - 2021/01/16 20:28:46 EET [2021/01/16 13:28:46 ET]
Table '3099770291 62' 9-max Seat #1 is the button
Seat 1: judith.f (4855 in chips) 
Seat 2: treytaylor20 (5796 in chips) 
Seat 3: 812b4 (3713 in chips) 
Seat 4: jcarlos.vale (9612 in chips) 
Seat 5: phantofant (4701 in chips) 
Seat 6: Izunna (2385 in chips) 
Seat 7: GutPewPew (5136 in chips) 
Seat 8: had3sssss (7748 in chips) 
Seat 9: NotHereFish (5223 in chips) 
judith.f: posts the ante 6
treytaylor20: posts the ante 6
812b4: posts the ante 6
jcarlos.vale: posts the ante 6
phantofant: posts the ante 6
Izunna: posts the ante 6
GutPewPew: posts the ante 6
had3sssss: posts the ante 6
NotHereFish: posts the ante 6
treytaylor20: posts small blind 25
812b4: posts big blind 50
*** HOLE CARDS ***
Dealt to jcarlos.vale [Kd 9h]
jcarlos.vale: folds 
phantofant: raises 50 to 100
Izunna: raises 250 to 350
GutPewPew: calls 350
had3sssss: folds 
NotHereFish: folds 
judith.f: folds 
treytaylor20: folds 
812b4: folds 
phantofant: calls 250
*** FLOP *** [Tc 5c 5h]
phantofant: bets 50
Izunna: raises 358 to 408
GutPewPew: calls 408
phantofant: folds 
*** TURN *** [Tc 5c 5h] [5d]
Izunna: bets 1621 and is all-in
GutPewPew: calls 1621
*** RIVER *** [Tc 5c 5h 5d] [6h]
*** SHOW DOWN ***
Izunna: shows [Ac Ks] (three of a kind, Fives)
GutPewPew: shows [Ah Qc] (three of a kind, Fives - lower kicker)
Izunna collected 5287 from pot
*** SUMMARY ***
Total pot 5287 | Rake 0 
Board [Tc 5c 5h 5d 6h]
Seat 1: judith.f (button) folded before Flop (didn't bet)
Seat 2: treytaylor20 (small blind) folded before Flop
Seat 3: 812b4 (big blind) folded before Flop
Seat 4: jcarlos.vale folded before Flop (didn't bet)
Seat 5: phantofant folded on the Flop
Seat 6: Izunna showed [Ac Ks] and won (5287) with three of a kind, Fives
Seat 7: GutPewPew showed [Ah Qc] and lost with three of a kind, Fives
Seat 8: had3sssss folded before Flop (didn't bet)
Seat 9: NotHereFish folded before Flop (didn't bet)



PokerStars Hand #222698367652: Tournament #3099770291, $0.98+$0.12 USD Hold'em No Limit - Level IV (30/60) - 2021/01/16 20:30:14 EET [2021/01/16 13:30:14 ET]
Table '3099770291 62' 9-max Seat #2 is the button
Seat 1: judith.f (4849 in chips) 
Seat 2: treytaylor20 (5765 in chips) 
Seat 3: 812b4 (3657 in chips) 
Seat 4: jcarlos.vale (9606 in chips) 
Seat 5: phantofant (4295 in chips) 
Seat 6: Izunna (5287 in chips) 
Seat 7: GutPewPew (2751 in chips) 
Seat 8: had3sssss (7742 in chips) 
Seat 9: NotHereFish (5217 in chips) 
judith.f: posts the ante 8
treytaylor20: posts the ante 8
812b4: posts the ante 8
jcarlos.vale: posts the ante 8
phantofant: posts the ante 8
Izunna: posts the ante 8
GutPewPew: posts the ante 8
had3sssss: posts the ante 8
NotHereFish: posts the ante 8
812b4: posts small blind 30
jcarlos.vale: posts big blind 60
*** HOLE CARDS ***
Dealt to jcarlos.vale [9c 8c]
phantofant: folds 
Izunna: folds 
GutPewPew: folds 
had3sssss: folds 
NotHereFish: folds 
judith.f: raises 78 to 138
treytaylor20: folds 
812b4: folds 
jcarlos.vale: calls 78
*** FLOP *** [7c 6h 4c]
jcarlos.vale: bets 120
judith.f: folds 
Uncalled bet (120) returned to jcarlos.vale
jcarlos.vale collected 378 from pot
jcarlos.vale: doesn't show hand 
*** SUMMARY ***
Total pot 378 | Rake 0 
Board [7c 6h 4c]
Seat 1: judith.f folded on the Flop
Seat 2: treytaylor20 (button) folded before Flop (didn't bet)
Seat 3: 812b4 (small blind) folded before Flop
Seat 4: jcarlos.vale (big blind) collected (378)
Seat 5: phantofant folded before Flop (didn't bet)
Seat 6: Izunna folded before Flop (didn't bet)
Seat 7: GutPewPew folded before Flop (didn't bet)
Seat 8: had3sssss folded before Flop (didn't bet)
Seat 9: NotHereFish folded before Flop (didn't bet)



PokerStars Hand #222698403766: Tournament #3099770291, $0.98+$0.12 USD Hold'em No Limit - Level IV (30/60) - 2021/01/16 20:30:58 EET [2021/01/16 13:30:58 ET]
Table '3099770291 62' 9-max Seat #3 is the button
Seat 1: judith.f (4703 in chips) 
Seat 3: 812b4 (3619 in chips) 
Seat 4: jcarlos.vale (9838 in chips) 
Seat 5: phantofant (4287 in chips) 
Seat 6: Izunna (5279 in chips) 
Seat 7: GutPewPew (2743 in chips) 
Seat 8: had3sssss (7734 in chips) 
Seat 9: NotHereFish (5209 in chips) 
judith.f: posts the ante 8
812b4: posts the ante 8
jcarlos.vale: posts the ante 8
phantofant: posts the ante 8
Izunna: posts the ante 8
GutPewPew: posts the ante 8
had3sssss: posts the ante 8
NotHereFish: posts the ante 8
jcarlos.vale: posts small blind 30
phantofant: posts big blind 60
*** HOLE CARDS ***
Dealt to jcarlos.vale [Qc Th]
Izunna: folds 
GutPewPew: raises 90 to 150
had3sssss: calls 150
NotHereFish: folds 
judith.f: raises 604 to 754
812b4: folds 
jcarlos.vale: folds 
phantofant: folds 
GutPewPew: calls 604
had3sssss: calls 604
*** FLOP *** [Ad 5s 2d]
GutPewPew: checks 
had3sssss: checks 
judith.f: checks 
*** TURN *** [Ad 5s 2d] [Td]
GutPewPew: checks 
had3sssss: bets 1619
judith.f: folds 
GutPewPew: raises 362 to 1981 and is all-in
had3sssss: calls 362
*** RIVER *** [Ad 5s 2d Td] [9c]
*** SHOW DOWN ***
GutPewPew: shows [Ac Jd] (a pair of Aces)
had3sssss: shows [5h 5c] (three of a kind, Fives)
had3sssss collected 6378 from pot
GutPewPew finished the tournament
*** SUMMARY ***
Total pot 6378 | Rake 0 
Board [Ad 5s 2d Td 9c]
Seat 1: judith.f folded on the Turn
Seat 3: 812b4 (button) folded before Flop (didn't bet)
Seat 4: jcarlos.vale (small blind) folded before Flop
Seat 5: phantofant (big blind) folded before Flop
Seat 6: Izunna folded before Flop (didn't bet)
Seat 7: GutPewPew showed [Ac Jd] and lost with a pair of Aces
Seat 8: had3sssss showed [5h 5c] and won (6378) with three of a kind, Fives
Seat 9: NotHereFish folded before Flop (didn't bet)



PokerStars Hand #222698462816: Tournament #3099770291, $0.98+$0.12 USD Hold'em No Limit - Level IV (30/60) - 2021/01/16 20:32:08 EET [2021/01/16 13:32:08 ET]
Table '3099770291 62' 9-max Seat #4 is the button
Seat 1: judith.f (3941 in chips) 
Seat 2: Ebzhd (5000 in chips) 
Seat 3: 812b4 (3611 in chips) 
Seat 4: jcarlos.vale (9800 in chips) 
Seat 5: phantofant (4219 in chips) 
Seat 6: Izunna (5271 in chips) 
Seat 8: had3sssss (11369 in chips) 
Seat 9: NotHereFish (5201 in chips) 
judith.f: posts the ante 8
Ebzhd: posts the ante 8
812b4: posts the ante 8
jcarlos.vale: posts the ante 8
phantofant: posts the ante 8
Izunna: posts the ante 8
had3sssss: posts the ante 8
NotHereFish: posts the ante 8
phantofant: posts small blind 30
Izunna: posts big blind 60
*** HOLE CARDS ***
Dealt to jcarlos.vale [Ah Qh]
had3sssss: folds 
NotHereFish: folds 
judith.f: folds 
Ebzhd: raises 60 to 120
812b4: raises 394 to 514
jcarlos.vale: folds 
phantofant: folds 
Izunna: folds 
Ebzhd: folds 
Uncalled bet (394) returned to 812b4
812b4 collected 394 from pot
812b4: doesn't show hand 
*** SUMMARY ***
Total pot 394 | Rake 0 
Seat 1: judith.f folded before Flop (didn't bet)
Seat 2: Ebzhd folded before Flop
Seat 3: 812b4 collected (394)
Seat 4: jcarlos.vale (button) folded before Flop (didn't bet)
Seat 5: phantofant (small blind) folded before Flop
Seat 6: Izunna (big blind) folded before Flop
Seat 8: had3sssss folded before Flop (didn't bet)
Seat 9: NotHereFish folded before Flop (didn't bet)



PokerStars Hand #222698493905: Tournament #3099770291, $0.98+$0.12 USD Hold'em No Limit - Level IV (30/60) - 2021/01/16 20:32:45 EET [2021/01/16 13:32:45 ET]
Table '3099770291 62' 9-max Seat #5 is the button
Seat 1: judith.f (3933 in chips) 
Seat 2: Ebzhd (4872 in chips) 
Seat 3: 812b4 (3877 in chips) 
Seat 4: jcarlos.vale (9792 in chips) 
Seat 5: phantofant (4181 in chips) 
Seat 6: Izunna (5203 in chips) 
Seat 7: MWCHESS (5000 in chips) 
Seat 8: had3sssss (11361 in chips) 
Seat 9: NotHereFish (5193 in chips) 
judith.f: posts the ante 8
Ebzhd: posts the ante 8
812b4: posts the ante 8
jcarlos.vale: posts the ante 8
phantofant: posts the ante 8
Izunna: posts the ante 8
MWCHESS: posts the ante 8
had3sssss: posts the ante 8
NotHereFish: posts the ante 8
Izunna: posts small blind 30
MWCHESS: posts big blind 60
*** HOLE CARDS ***
Dealt to jcarlos.vale [2h 3d]
had3sssss: raises 90 to 150
NotHereFish: folds 
judith.f: folds 
Ebzhd: raises 390 to 540
812b4: folds 
jcarlos.vale: folds 
phantofant: folds 
Izunna: folds 
MWCHESS: folds 
had3sssss: raises 10813 to 11353 and is all-in
Ebzhd: calls 4324 and is all-in
Uncalled bet (6489) returned to had3sssss
*** FLOP *** [4c Th Qc]
*** TURN *** [4c Th Qc] [2s]
*** RIVER *** [4c Th Qc 2s] [Ac]
*** SHOW DOWN ***
had3sssss: shows [Kc Ad] (a pair of Aces)
Ebzhd: shows [Jh Js] (a pair of Jacks)
had3sssss collected 9890 from pot
Ebzhd finished the tournament
*** SUMMARY ***
Total pot 9890 | Rake 0 
Board [4c Th Qc 2s Ac]
Seat 1: judith.f folded before Flop (didn't bet)
Seat 2: Ebzhd showed [Jh Js] and lost with a pair of Jacks
Seat 3: 812b4 folded before Flop (didn't bet)
Seat 4: jcarlos.vale folded before Flop (didn't bet)
Seat 5: phantofant (button) folded before Flop (didn't bet)
Seat 6: Izunna (small blind) folded before Flop
Seat 7: MWCHESS (big blind) folded before Flop
Seat 8: had3sssss showed [Kc Ad] and won (9890) with a pair of Aces
Seat 9: NotHereFish folded before Flop (didn't bet)



PokerStars Hand #222698544683: Tournament #3099770291, $0.98+$0.12 USD Hold'em No Limit - Level IV (30/60) - 2021/01/16 20:33:45 EET [2021/01/16 13:33:45 ET]
Table '3099770291 62' 9-max Seat #6 is the button
Seat 1: judith.f (3925 in chips) 
Seat 3: 812b4 (3869 in chips) 
Seat 4: jcarlos.vale (9784 in chips) 
Seat 5: phantofant (4173 in chips) 
Seat 6: Izunna (5165 in chips) 
Seat 7: MWCHESS (4932 in chips) 
Seat 8: had3sssss (16379 in chips) 
Seat 9: NotHereFish (5185 in chips) 
judith.f: posts the ante 8
812b4: posts the ante 8
jcarlos.vale: posts the ante 8
phantofant: posts the ante 8
Izunna: posts the ante 8
MWCHESS: posts the ante 8
had3sssss: posts the ante 8
NotHereFish: posts the ante 8
MWCHESS: posts small blind 30
had3sssss: posts big blind 60
*** HOLE CARDS ***
Dealt to jcarlos.vale [Kd Ah]
NotHereFish: folds 
judith.f: folds 
812b4: raises 300 to 360
jcarlos.vale: folds 
phantofant: folds 
Izunna: folds 
MWCHESS: folds 
had3sssss: folds 
Uncalled bet (300) returned to 812b4
812b4 collected 214 from pot
812b4: doesn't show hand 
*** SUMMARY ***
Total pot 214 | Rake 0 
Seat 1: judith.f folded before Flop (didn't bet)
Seat 3: 812b4 collected (214)
Seat 4: jcarlos.vale folded before Flop (didn't bet)
Seat 5: phantofant folded before Flop (didn't bet)
Seat 6: Izunna (button) folded before Flop (didn't bet)
Seat 7: MWCHESS (small blind) folded before Flop
Seat 8: had3sssss (big blind) folded before Flop
Seat 9: NotHereFish folded before Flop (didn't bet)



PokerStars Hand #222698574745: Tournament #3099770291, $0.98+$0.12 USD Hold'em No Limit - Level IV (30/60) - 2021/01/16 20:34:21 EET [2021/01/16 13:34:21 ET]
Table '3099770291 62' 9-max Seat #7 is the button
Seat 1: judith.f (3917 in chips) 
Seat 2: trueJamaican (5000 in chips) 
Seat 3: 812b4 (4015 in chips) 
Seat 4: jcarlos.vale (9776 in chips) 
Seat 5: phantofant (4165 in chips) 
Seat 6: Izunna (5157 in chips) 
Seat 7: MWCHESS (4894 in chips) 
Seat 8: had3sssss (16311 in chips) 
Seat 9: NotHereFish (5177 in chips) 
judith.f: posts the ante 8
trueJamaican: posts the ante 8
812b4: posts the ante 8
jcarlos.vale: posts the ante 8
phantofant: posts the ante 8
Izunna: posts the ante 8
MWCHESS: posts the ante 8
had3sssss: posts the ante 8
NotHereFish: posts the ante 8
had3sssss: posts small blind 30
NotHereFish: posts big blind 60
*** HOLE CARDS ***
Dealt to jcarlos.vale [Jc Kc]
judith.f: raises 78 to 138
trueJamaican: folds 
812b4: folds 
jcarlos.vale: folds 
phantofant: folds 
Izunna: folds 
MWCHESS: folds 
had3sssss: folds 
NotHereFish: folds 
Uncalled bet (78) returned to judith.f
judith.f collected 222 from pot
judith.f: doesn't show hand 
*** SUMMARY ***
Total pot 222 | Rake 0 
Seat 1: judith.f collected (222)
Seat 2: trueJamaican folded before Flop (didn't bet)
Seat 3: 812b4 folded before Flop (didn't bet)
Seat 4: jcarlos.vale folded before Flop (didn't bet)
Seat 5: phantofant folded before Flop (didn't bet)
Seat 6: Izunna folded before Flop (didn't bet)
Seat 7: MWCHESS (button) folded before Flop (didn't bet)
Seat 8: had3sssss (small blind) folded before Flop
Seat 9: NotHereFish (big blind) folded before Flop



PokerStars Hand #222698600451: Tournament #3099770291, $0.98+$0.12 USD Hold'em No Limit - Level IV (30/60) - 2021/01/16 20:34:52 EET [2021/01/16 13:34:52 ET]
Table '3099770291 62' 9-max Seat #8 is the button
Seat 1: judith.f (4071 in chips) 
Seat 2: trueJamaican (4992 in chips) 
Seat 3: 812b4 (4007 in chips) 
Seat 4: jcarlos.vale (9768 in chips) 
Seat 5: phantofant (4157 in chips) 
Seat 6: Izunna (5149 in chips) 
Seat 7: MWCHESS (4886 in chips) 
Seat 8: had3sssss (16273 in chips) 
Seat 9: NotHereFish (5109 in chips) 
judith.f: posts the ante 8
trueJamaican: posts the ante 8
812b4: posts the ante 8
jcarlos.vale: posts the ante 8
phantofant: posts the ante 8
Izunna: posts the ante 8
MWCHESS: posts the ante 8
had3sssss: posts the ante 8
NotHereFish: posts the ante 8
NotHereFish: posts small blind 30
judith.f: posts big blind 60
*** HOLE CARDS ***
Dealt to jcarlos.vale [6h Th]
trueJamaican: folds 
812b4: folds 
jcarlos.vale: folds 
phantofant: folds 
Izunna: folds 
MWCHESS: folds 
had3sssss: raises 72 to 132
NotHereFish: raises 318 to 450
judith.f: folds 
had3sssss: folds 
Uncalled bet (318) returned to NotHereFish
NotHereFish collected 396 from pot
NotHereFish: doesn't show hand 
*** SUMMARY ***
Total pot 396 | Rake 0 
Seat 1: judith.f (big blind) folded before Flop
Seat 2: trueJamaican folded before Flop (didn't bet)
Seat 3: 812b4 folded before Flop (didn't bet)
Seat 4: jcarlos.vale folded before Flop (didn't bet)
Seat 5: phantofant folded before Flop (didn't bet)
Seat 6: Izunna folded before Flop (didn't bet)
Seat 7: MWCHESS folded before Flop (didn't bet)
Seat 8: had3sssss (button) folded before Flop
Seat 9: NotHereFish (small blind) collected (396)



PokerStars Hand #222698635307: Tournament #3099770291, $0.98+$0.12 USD Hold'em No Limit - Level IV (30/60) - 2021/01/16 20:35:33 EET [2021/01/16 13:35:33 ET]
Table '3099770291 62' 9-max Seat #9 is the button
Seat 1: judith.f (4003 in chips) 
Seat 2: trueJamaican (4984 in chips) 
Seat 3: 812b4 (3999 in chips) 
Seat 4: jcarlos.vale (9760 in chips) 
Seat 5: phantofant (4149 in chips) 
Seat 6: Izunna (5141 in chips) 
Seat 7: MWCHESS (4878 in chips) 
Seat 8: had3sssss (16133 in chips) 
Seat 9: NotHereFish (5365 in chips) 
judith.f: posts the ante 8
trueJamaican: posts the ante 8
812b4: posts the ante 8
jcarlos.vale: posts the ante 8
phantofant: posts the ante 8
Izunna: posts the ante 8
MWCHESS: posts the ante 8
had3sssss: posts the ante 8
NotHereFish: posts the ante 8
judith.f: posts small blind 30
trueJamaican: posts big blind 60
*** HOLE CARDS ***
Dealt to jcarlos.vale [Ac 6d]
812b4: raises 60 to 120
jcarlos.vale: folds 
phantofant: calls 120
Izunna: folds 
MWCHESS: raises 369 to 489
had3sssss: folds 
NotHereFish: folds 
judith.f: folds 
trueJamaican: folds 
812b4 said, "soory..I.m slow..beacu I,m cooking"
812b4: calls 369
phantofant: folds 
*** FLOP *** [7d Tc 4h]
812b4: checks 
MWCHESS: bets 416
812b4: calls 416
*** TURN *** [7d Tc 4h] [2d]
812b4: checks 
MWCHESS: bets 1046
812b4: folds 
Uncalled bet (1046) returned to MWCHESS
MWCHESS collected 2092 from pot
MWCHESS: doesn't show hand 
*** SUMMARY ***
Total pot 2092 | Rake 0 
Board [7d Tc 4h 2d]
Seat 1: judith.f (small blind) folded before Flop
Seat 2: trueJamaican (big blind) folded before Flop
Seat 3: 812b4 folded on the Turn
Seat 4: jcarlos.vale folded before Flop (didn't bet)
Seat 5: phantofant folded before Flop
Seat 6: Izunna folded before Flop (didn't bet)
Seat 7: MWCHESS collected (2092)
Seat 8: had3sssss folded before Flop (didn't bet)
Seat 9: NotHereFish (button) folded before Flop (didn't bet)



PokerStars Hand #222698712117: Tournament #3099770291, $0.98+$0.12 USD Hold'em No Limit - Level IV (30/60) - 2021/01/16 20:37:05 EET [2021/01/16 13:37:05 ET]
Table '3099770291 62' 9-max Seat #1 is the button
Seat 1: judith.f (3965 in chips) 
Seat 2: trueJamaican (4916 in chips) 
Seat 3: 812b4 (3086 in chips) 
Seat 4: jcarlos.vale (9752 in chips) 
Seat 5: phantofant (4021 in chips) 
Seat 7: MWCHESS (6057 in chips) 
Seat 8: had3sssss (16125 in chips) 
Seat 9: NotHereFish (5357 in chips) 
judith.f: posts the ante 8
trueJamaican: posts the ante 8
812b4: posts the ante 8
jcarlos.vale: posts the ante 8
phantofant: posts the ante 8
MWCHESS: posts the ante 8
had3sssss: posts the ante 8
NotHereFish: posts the ante 8
trueJamaican: posts small blind 30
812b4: posts big blind 60
*** HOLE CARDS ***
Dealt to jcarlos.vale [6s 6d]
jcarlos.vale: raises 96 to 156
phantofant: folds 
MWCHESS: folds 
had3sssss: folds 
NotHereFish: folds 
judith.f: folds 
trueJamaican: folds 
812b4: calls 96
*** FLOP *** [2h 9s 3c]
812b4: checks 
jcarlos.vale: bets 120
812b4: folds 
Uncalled bet (120) returned to jcarlos.vale
jcarlos.vale collected 406 from pot
jcarlos.vale: doesn't show hand 
*** SUMMARY ***
Total pot 406 | Rake 0 
Board [2h 9s 3c]
Seat 1: judith.f (button) folded before Flop (didn't bet)
Seat 2: trueJamaican (small blind) folded before Flop
Seat 3: 812b4 (big blind) folded on the Flop
Seat 4: jcarlos.vale collected (406)
Seat 5: phantofant folded before Flop (didn't bet)
Seat 7: MWCHESS folded before Flop (didn't bet)
Seat 8: had3sssss folded before Flop (didn't bet)
Seat 9: NotHereFish folded before Flop (didn't bet)



PokerStars Hand #222698743115: Tournament #3099770291, $0.98+$0.12 USD Hold'em No Limit - Level IV (30/60) - 2021/01/16 20:37:41 EET [2021/01/16 13:37:41 ET]
Table '3099770291 62' 9-max Seat #2 is the button
Seat 1: judith.f (3957 in chips) 
Seat 2: trueJamaican (4878 in chips) 
Seat 3: 812b4 (2922 in chips) 
Seat 4: jcarlos.vale (9994 in chips) 
Seat 5: phantofant (4013 in chips) 
Seat 6: uht25 (5000 in chips) 
Seat 7: MWCHESS (6049 in chips) 
Seat 8: had3sssss (16117 in chips) 
Seat 9: NotHereFish (5349 in chips) 
judith.f: posts the ante 8
trueJamaican: posts the ante 8
812b4: posts the ante 8
jcarlos.vale: posts the ante 8
phantofant: posts the ante 8
uht25: posts the ante 8
MWCHESS: posts the ante 8
had3sssss: posts the ante 8
NotHereFish: posts the ante 8
812b4: posts small blind 30
jcarlos.vale: posts big blind 60
*** HOLE CARDS ***
Dealt to jcarlos.vale [9c Ts]
phantofant: calls 60
uht25: folds 
MWCHESS: folds 
had3sssss: folds 
NotHereFish: folds 
judith.f: raises 180 to 240
trueJamaican: folds 
812b4: calls 210
jcarlos.vale: folds 
phantofant: calls 180
*** FLOP *** [3s Ac Td]
812b4: checks 
phantofant: bets 60
judith.f: raises 486 to 546
812b4: calls 546
phantofant: folds 
*** TURN *** [3s Ac Td] [2d]
812b4: checks 
judith.f: bets 2160
812b4: calls 2128 and is all-in
Uncalled bet (32) returned to judith.f
*** RIVER *** [3s Ac Td 2d] [4h]
*** SHOW DOWN ***
812b4: shows [6d Ad] (a pair of Aces)
judith.f: shows [Qs As] (a pair of Aces - Queen kicker)
judith.f collected 6260 from pot
812b4 finished the tournament
*** SUMMARY ***
Total pot 6260 | Rake 0 
Board [3s Ac Td 2d 4h]
Seat 1: judith.f showed [Qs As] and won (6260) with a pair of Aces
Seat 2: trueJamaican (button) folded before Flop (didn't bet)
Seat 3: 812b4 (small blind) showed [6d Ad] and lost with a pair of Aces
Seat 4: jcarlos.vale (big blind) folded before Flop
Seat 5: phantofant folded on the Flop
Seat 6: uht25 folded before Flop (didn't bet)
Seat 7: MWCHESS folded before Flop (didn't bet)
Seat 8: had3sssss folded before Flop (didn't bet)
Seat 9: NotHereFish folded before Flop (didn't bet)



PokerStars Hand #222698794168: Tournament #3099770291, $0.98+$0.12 USD Hold'em No Limit - Level IV (30/60) - 2021/01/16 20:38:39 EET [2021/01/16 13:38:39 ET]
Table '3099770291 62' 9-max Seat #4 is the button
Seat 1: judith.f (7295 in chips) 
Seat 2: trueJamaican (4870 in chips) 
Seat 4: jcarlos.vale (9926 in chips) 
Seat 5: phantofant (3705 in chips) 
Seat 6: uht25 (4992 in chips) 
Seat 7: MWCHESS (6041 in chips) 
Seat 8: had3sssss (16109 in chips) 
Seat 9: NotHereFish (5341 in chips) 
judith.f: posts the ante 8
trueJamaican: posts the ante 8
jcarlos.vale: posts the ante 8
phantofant: posts the ante 8
uht25: posts the ante 8
MWCHESS: posts the ante 8
had3sssss: posts the ante 8
NotHereFish: posts the ante 8
phantofant: posts small blind 30
uht25: posts big blind 60
*** HOLE CARDS ***
Dealt to jcarlos.vale [Kc 8d]
MWCHESS: folds 
had3sssss: folds 
NotHereFish: folds 
judith.f: folds 
trueJamaican: raises 60 to 120
jcarlos.vale: folds 
phantofant: raises 60 to 180
uht25: folds 
trueJamaican: calls 60
*** FLOP *** [7s Jh 6c]
phantofant: checks 
trueJamaican: checks 
*** TURN *** [7s Jh 6c] [Ad]
phantofant: bets 180
trueJamaican: folds 
Uncalled bet (180) returned to phantofant
phantofant collected 484 from pot
phantofant: doesn't show hand 
*** SUMMARY ***
Total pot 484 | Rake 0 
Board [7s Jh 6c Ad]
Seat 1: judith.f folded before Flop (didn't bet)
Seat 2: trueJamaican folded on the Turn
Seat 4: jcarlos.vale (button) folded before Flop (didn't bet)
Seat 5: phantofant (small blind) collected (484)
Seat 6: uht25 (big blind) folded before Flop
Seat 7: MWCHESS folded before Flop (didn't bet)
Seat 8: had3sssss folded before Flop (didn't bet)
Seat 9: NotHereFish folded before Flop (didn't bet)



PokerStars Hand #222698839405: Tournament #3099770291, $0.98+$0.12 USD Hold'em No Limit - Level IV (30/60) - 2021/01/16 20:39:33 EET [2021/01/16 13:39:33 ET]
Table '3099770291 62' 9-max Seat #5 is the button
Seat 1: judith.f (7287 in chips) 
Seat 2: trueJamaican (4682 in chips) 
Seat 3: bolemanyi54 (5000 in chips) 
Seat 4: jcarlos.vale (9918 in chips) 
Seat 5: phantofant (4001 in chips) 
Seat 6: uht25 (4924 in chips) 
Seat 7: MWCHESS (6033 in chips) 
Seat 8: had3sssss (16101 in chips) 
Seat 9: NotHereFish (5333 in chips) 
judith.f: posts the ante 8
trueJamaican: posts the ante 8
bolemanyi54: posts the ante 8
jcarlos.vale: posts the ante 8
phantofant: posts the ante 8
uht25: posts the ante 8
MWCHESS: posts the ante 8
had3sssss: posts the ante 8
NotHereFish: posts the ante 8
uht25: posts small blind 30
MWCHESS: posts big blind 60
*** HOLE CARDS ***
Dealt to jcarlos.vale [Jh 6c]
had3sssss: folds 
NotHereFish: folds 
judith.f: folds 
trueJamaican: raises 60 to 120
bolemanyi54: calls 120
jcarlos.vale: folds 
phantofant: folds 
uht25: calls 90
MWCHESS: folds 
*** FLOP *** [2h 6h Ks]
uht25: checks 
trueJamaican: checks 
bolemanyi54: bets 180
uht25: folds 
trueJamaican: folds 
Uncalled bet (180) returned to bolemanyi54
bolemanyi54 collected 492 from pot
bolemanyi54: doesn't show hand 
*** SUMMARY ***
Total pot 492 | Rake 0 
Board [2h 6h Ks]
Seat 1: judith.f folded before Flop (didn't bet)
Seat 2: trueJamaican folded on the Flop
Seat 3: bolemanyi54 collected (492)
Seat 4: jcarlos.vale folded before Flop (didn't bet)
Seat 5: phantofant (button) folded before Flop (didn't bet)
Seat 6: uht25 (small blind) folded on the Flop
Seat 7: MWCHESS (big blind) folded before Flop
Seat 8: had3sssss folded before Flop (didn't bet)
Seat 9: NotHereFish folded before Flop (didn't bet)



PokerStars Hand #222698884409: Tournament #3099770291, $0.98+$0.12 USD Hold'em No Limit - Level V (40/80) - 2021/01/16 20:40:26 EET [2021/01/16 13:40:26 ET]
Table '3099770291 62' 9-max Seat #6 is the button
Seat 1: judith.f (7279 in chips) 
Seat 2: trueJamaican (4554 in chips) 
Seat 3: bolemanyi54 (5364 in chips) 
Seat 4: jcarlos.vale (9910 in chips) 
Seat 5: phantofant (3993 in chips) 
Seat 6: uht25 (4796 in chips) 
Seat 7: MWCHESS (5965 in chips) 
Seat 9: NotHereFish (5325 in chips) 
judith.f: posts the ante 9
trueJamaican: posts the ante 9
bolemanyi54: posts the ante 9
jcarlos.vale: posts the ante 9
phantofant: posts the ante 9
uht25: posts the ante 9
MWCHESS: posts the ante 9
NotHereFish: posts the ante 9
MWCHESS: posts small blind 40
NotHereFish: posts big blind 80
*** HOLE CARDS ***
Dealt to jcarlos.vale [2c As]
judith.f: folds 
trueJamaican: folds 
bolemanyi54: calls 80
jcarlos.vale: folds 
phantofant: calls 80
uht25: raises 184 to 264
MWCHESS: raises 936 to 1200
NotHereFish: folds 
bolemanyi54: folds 
phantofant: folds 
uht25: calls 936
*** FLOP *** [7d 6s Td]
MWCHESS: bets 895
uht25: calls 895
*** TURN *** [7d 6s Td] [9h]
MWCHESS: bets 3861 and is all-in
uht25: calls 2692 and is all-in
Uncalled bet (1169) returned to MWCHESS
*** RIVER *** [7d 6s Td 9h] [Ts]
*** SHOW DOWN ***
MWCHESS: shows [Qh Ac] (a pair of Tens)
uht25: shows [Jh Js] (two pair, Jacks and Tens)
uht25 collected 9886 from pot
*** SUMMARY ***
Total pot 9886 | Rake 0 
Board [7d 6s Td 9h Ts]
Seat 1: judith.f folded before Flop (didn't bet)
Seat 2: trueJamaican folded before Flop (didn't bet)
Seat 3: bolemanyi54 folded before Flop
Seat 4: jcarlos.vale folded before Flop (didn't bet)
Seat 5: phantofant folded before Flop
Seat 6: uht25 (button) showed [Jh Js] and won (9886) with two pair, Jacks and Tens
Seat 7: MWCHESS (small blind) showed [Qh Ac] and lost with a pair of Tens
Seat 9: NotHereFish (big blind) folded before Flop



PokerStars Hand #222698929198: Tournament #3099770291, $0.98+$0.12 USD Hold'em No Limit - Level V (40/80) - 2021/01/16 20:41:20 EET [2021/01/16 13:41:20 ET]
Table '3099770291 62' 9-max Seat #7 is the button
Seat 1: judith.f (7270 in chips) 
Seat 2: trueJamaican (4545 in chips) 
Seat 3: bolemanyi54 (5275 in chips) 
Seat 4: jcarlos.vale (9901 in chips) 
Seat 5: phantofant (3904 in chips) 
Seat 6: uht25 (9886 in chips) 
Seat 7: MWCHESS (1169 in chips) 
Seat 8: Louuuu2k (5000 in chips) out of hand (moved from another table into small blind)
Seat 9: NotHereFish (5236 in chips) 
Louuuu2k will be allowed to play after the button
judith.f: posts the ante 9
trueJamaican: posts the ante 9
bolemanyi54: posts the ante 9
jcarlos.vale: posts the ante 9
phantofant: posts the ante 9
uht25: posts the ante 9
MWCHESS: posts the ante 9
NotHereFish: posts the ante 9
NotHereFish: posts small blind 40
judith.f: posts big blind 80
*** HOLE CARDS ***
Dealt to jcarlos.vale [4h Qd]
trueJamaican: folds 
bolemanyi54: folds 
jcarlos.vale: folds 
phantofant: calls 80
uht25: calls 80
MWCHESS: folds 
NotHereFish: calls 40
judith.f: checks 
*** FLOP *** [Ad 7c Jc]
NotHereFish: checks 
judith.f: checks 
phantofant: bets 80
uht25: folds 
NotHereFish: folds 
judith.f: folds 
Uncalled bet (80) returned to phantofant
phantofant collected 392 from pot
phantofant: doesn't show hand 
*** SUMMARY ***
Total pot 392 | Rake 0 
Board [Ad 7c Jc]
Seat 1: judith.f (big blind) folded on the Flop
Seat 2: trueJamaican folded before Flop (didn't bet)
Seat 3: bolemanyi54 folded before Flop (didn't bet)
Seat 4: jcarlos.vale folded before Flop (didn't bet)
Seat 5: phantofant collected (392)
Seat 6: uht25 folded on the Flop
Seat 7: MWCHESS (button) folded before Flop (didn't bet)
Seat 9: NotHereFish (small blind) folded on the Flop



PokerStars Hand #222698967075: Tournament #3099770291, $0.98+$0.12 USD Hold'em No Limit - Level V (40/80) - 2021/01/16 20:42:05 EET [2021/01/16 13:42:05 ET]
Table '3099770291 62' 9-max Seat #9 is the button
Seat 1: judith.f (7181 in chips) 
Seat 2: trueJamaican (4536 in chips) 
Seat 3: bolemanyi54 (5266 in chips) 
Seat 4: jcarlos.vale (9892 in chips) 
Seat 5: phantofant (4207 in chips) 
Seat 6: uht25 (9797 in chips) 
Seat 7: MWCHESS (1160 in chips) 
Seat 8: Louuuu2k (5000 in chips) 
Seat 9: NotHereFish (5147 in chips) 
judith.f: posts the ante 9
trueJamaican: posts the ante 9
bolemanyi54: posts the ante 9
jcarlos.vale: posts the ante 9
phantofant: posts the ante 9
uht25: posts the ante 9
MWCHESS: posts the ante 9
Louuuu2k: posts the ante 9
NotHereFish: posts the ante 9
judith.f: posts small blind 40
trueJamaican: posts big blind 80
*** HOLE CARDS ***
Dealt to jcarlos.vale [Js 4h]
bolemanyi54: folds 
jcarlos.vale: folds 
phantofant: raises 80 to 160
uht25: folds 
MWCHESS: folds 
Louuuu2k: folds 
NotHereFish: folds 
judith.f: folds 
trueJamaican: calls 80
*** FLOP *** [8d 2s 8h]
trueJamaican: checks 
phantofant: bets 80
trueJamaican: calls 80
*** TURN *** [8d 2s 8h] [Ad]
trueJamaican: checks 
phantofant: bets 80
trueJamaican: raises 335 to 415
phantofant: calls 335
*** RIVER *** [8d 2s 8h Ad] [5s]
trueJamaican: bets 630
phantofant: calls 630
*** SHOW DOWN ***
trueJamaican: shows [3h Ah] (two pair, Aces and Eights)
phantofant: mucks hand 
trueJamaican collected 2691 from pot
*** SUMMARY ***
Total pot 2691 | Rake 0 
Board [8d 2s 8h Ad 5s]
Seat 1: judith.f (small blind) folded before Flop
Seat 2: trueJamaican (big blind) showed [3h Ah] and won (2691) with two pair, Aces and Eights
Seat 3: bolemanyi54 folded before Flop (didn't bet)
Seat 4: jcarlos.vale folded before Flop (didn't bet)
Seat 5: phantofant mucked [Td Kd]
Seat 6: uht25 folded before Flop (didn't bet)
Seat 7: MWCHESS folded before Flop (didn't bet)
Seat 8: Louuuu2k folded before Flop (didn't bet)
Seat 9: NotHereFish (button) folded before Flop (didn't bet)



PokerStars Hand #222699007694: Tournament #3099770291, $0.98+$0.12 USD Hold'em No Limit - Level V (40/80) - 2021/01/16 20:42:53 EET [2021/01/16 13:42:53 ET]
Table '3099770291 62' 9-max Seat #1 is the button
Seat 1: judith.f (7132 in chips) 
Seat 2: trueJamaican (5933 in chips) 
Seat 3: bolemanyi54 (5257 in chips) 
Seat 4: jcarlos.vale (9883 in chips) 
Seat 5: phantofant (2913 in chips) 
Seat 6: uht25 (9788 in chips) 
Seat 7: MWCHESS (1151 in chips) 
Seat 8: Louuuu2k (4991 in chips) 
Seat 9: NotHereFish (5138 in chips) 
judith.f: posts the ante 9
trueJamaican: posts the ante 9
bolemanyi54: posts the ante 9
jcarlos.vale: posts the ante 9
phantofant: posts the ante 9
uht25: posts the ante 9
MWCHESS: posts the ante 9
Louuuu2k: posts the ante 9
NotHereFish: posts the ante 9
trueJamaican: posts small blind 40
bolemanyi54: posts big blind 80
*** HOLE CARDS ***
Dealt to jcarlos.vale [4d 3d]
jcarlos.vale: folds 
phantofant: calls 80
uht25: folds 
MWCHESS: folds 
Louuuu2k: folds 
NotHereFish: folds 
judith.f: folds 
trueJamaican: raises 160 to 240
bolemanyi54: calls 160
phantofant: calls 160
*** FLOP *** [Jh 8c 6c]
trueJamaican: bets 352
bolemanyi54: raises 352 to 704
phantofant: folds 
trueJamaican: calls 352
*** TURN *** [Jh 8c 6c] [2d]
trueJamaican: checks 
bolemanyi54: bets 480
trueJamaican: calls 480
*** RIVER *** [Jh 8c 6c 2d] [Js]
trueJamaican: bets 1394
bolemanyi54: raises 2430 to 3824 and is all-in
trueJamaican: calls 2430
*** SHOW DOWN ***
bolemanyi54: shows [3c Jc] (three of a kind, Jacks)
trueJamaican: shows [Kc Jd] (three of a kind, Jacks - King kicker)
trueJamaican collected 10817 from pot
bolemanyi54 finished the tournament
*** SUMMARY ***
Total pot 10817 | Rake 0 
Board [Jh 8c 6c 2d Js]
Seat 1: judith.f (button) folded before Flop (didn't bet)
Seat 2: trueJamaican (small blind) showed [Kc Jd] and won (10817) with three of a kind, Jacks
Seat 3: bolemanyi54 (big blind) showed [3c Jc] and lost with three of a kind, Jacks
Seat 4: jcarlos.vale folded before Flop (didn't bet)
Seat 5: phantofant folded on the Flop
Seat 6: uht25 folded before Flop (didn't bet)
Seat 7: MWCHESS folded before Flop (didn't bet)
Seat 8: Louuuu2k folded before Flop (didn't bet)
Seat 9: NotHereFish folded before Flop (didn't bet)



PokerStars Hand #222699082169: Tournament #3099770291, $0.98+$0.12 USD Hold'em No Limit - Level V (40/80) - 2021/01/16 20:44:22 EET [2021/01/16 13:44:22 ET]
Table '3099770291 62' 9-max Seat #2 is the button
Seat 1: judith.f (7123 in chips) 
Seat 2: trueJamaican (11493 in chips) 
Seat 4: jcarlos.vale (9874 in chips) 
Seat 5: phantofant (2664 in chips) 
Seat 6: uht25 (9779 in chips) 
Seat 7: MWCHESS (1142 in chips) 
Seat 8: Louuuu2k (4982 in chips) 
Seat 9: NotHereFish (5129 in chips) 
judith.f: posts the ante 9
trueJamaican: posts the ante 9
jcarlos.vale: posts the ante 9
phantofant: posts the ante 9
uht25: posts the ante 9
MWCHESS: posts the ante 9
Louuuu2k: posts the ante 9
NotHereFish: posts the ante 9
jcarlos.vale: posts small blind 40
phantofant: posts big blind 80
*** HOLE CARDS ***
Dealt to jcarlos.vale [Th Jh]
uht25: folds 
MWCHESS: folds 
Louuuu2k: folds 
NotHereFish: folds 
judith.f: raises 104 to 184
trueJamaican: folds 
jcarlos.vale: calls 144
phantofant: calls 104
*** FLOP *** [Qs Kd 4c]
jcarlos.vale: bets 160
phantofant: calls 160
judith.f: calls 160
*** TURN *** [Qs Kd 4c] [4d]
jcarlos.vale: bets 160
phantofant: calls 160
judith.f: folds 
*** RIVER *** [Qs Kd 4c 4d] [Qc]
jcarlos.vale: checks 
phantofant: checks 
*** SHOW DOWN ***
jcarlos.vale: shows [Th Jh] (two pair, Queens and Fours)
phantofant: shows [6d Jd] (two pair, Queens and Fours)
jcarlos.vale collected 712 from pot
phantofant collected 712 from pot
*** SUMMARY ***
Total pot 1424 | Rake 0 
Board [Qs Kd 4c 4d Qc]
Seat 1: judith.f folded on the Turn
Seat 2: trueJamaican (button) folded before Flop (didn't bet)
Seat 4: jcarlos.vale (small blind) showed [Th Jh] and won (712) with two pair, Queens and Fours
Seat 5: phantofant (big blind) showed [6d Jd] and won (712) with two pair, Queens and Fours
Seat 6: uht25 folded before Flop (didn't bet)
Seat 7: MWCHESS folded before Flop (didn't bet)
Seat 8: Louuuu2k folded before Flop (didn't bet)
Seat 9: NotHereFish folded before Flop (didn't bet)



PokerStars Hand #222699130648: Tournament #3099770291, $0.98+$0.12 USD Hold'em No Limit - Level V (40/80) - 2021/01/16 20:45:20 EET [2021/01/16 13:45:20 ET]
Table '3099770291 62' 9-max Seat #4 is the button
Seat 1: judith.f (6770 in chips) 
Seat 2: trueJamaican (11484 in chips) 
Seat 4: jcarlos.vale (10073 in chips) 
Seat 5: phantofant (2863 in chips) 
Seat 6: uht25 (9770 in chips) 
Seat 7: MWCHESS (1133 in chips) 
Seat 8: Louuuu2k (4973 in chips) 
Seat 9: NotHereFish (5120 in chips) 
judith.f: posts the ante 9
trueJamaican: posts the ante 9
jcarlos.vale: posts the ante 9
phantofant: posts the ante 9
uht25: posts the ante 9
MWCHESS: posts the ante 9
Louuuu2k: posts the ante 9
NotHereFish: posts the ante 9
phantofant: posts small blind 40
uht25: posts big blind 80
*** HOLE CARDS ***
Dealt to jcarlos.vale [4s Tc]
MWCHESS: folds 
Louuuu2k: folds 
NotHereFish: folds 
judith.f: folds 
trueJamaican: raises 80 to 160
jcarlos.vale: folds 
phantofant: folds 
uht25: folds 
Uncalled bet (80) returned to trueJamaican
trueJamaican collected 272 from pot
*** SUMMARY ***
Total pot 272 | Rake 0 
Seat 1: judith.f folded before Flop (didn't bet)
Seat 2: trueJamaican collected (272)
Seat 4: jcarlos.vale (button) folded before Flop (didn't bet)
Seat 5: phantofant (small blind) folded before Flop
Seat 6: uht25 (big blind) folded before Flop
Seat 7: MWCHESS folded before Flop (didn't bet)
Seat 8: Louuuu2k folded before Flop (didn't bet)
Seat 9: NotHereFish folded before Flop (didn't bet)



PokerStars Hand #222699147476: Tournament #3099770291, $0.98+$0.12 USD Hold'em No Limit - Level V (40/80) - 2021/01/16 20:45:40 EET [2021/01/16 13:45:40 ET]
Table '3099770291 62' 9-max Seat #5 is the button
Seat 1: judith.f (6761 in chips) 
Seat 2: trueJamaican (11667 in chips) 
Seat 3: dow_jones4 (5000 in chips) 
Seat 4: jcarlos.vale (10064 in chips) 
Seat 5: phantofant (2814 in chips) 
Seat 6: uht25 (9681 in chips) 
Seat 7: MWCHESS (1124 in chips) 
Seat 8: Louuuu2k (4964 in chips) 
Seat 9: NotHereFish (5111 in chips) 
judith.f: posts the ante 9
trueJamaican: posts the ante 9
dow_jones4: posts the ante 9
jcarlos.vale: posts the ante 9
phantofant: posts the ante 9
uht25: posts the ante 9
MWCHESS: posts the ante 9
Louuuu2k: posts the ante 9
NotHereFish: posts the ante 9
uht25: posts small blind 40
MWCHESS: posts big blind 80
*** HOLE CARDS ***
Dealt to jcarlos.vale [Ah Qd]
Louuuu2k: folds 
NotHereFish: folds 
judith.f: folds 
trueJamaican: folds 
dow_jones4: raises 120 to 200
jcarlos.vale: calls 200
phantofant: folds 
uht25: folds 
MWCHESS: calls 120
*** FLOP *** [Ks 5d 2h]
MWCHESS: checks 
dow_jones4: bets 238
jcarlos.vale: folds 
MWCHESS: folds 
Uncalled bet (238) returned to dow_jones4
dow_jones4 collected 721 from pot
dow_jones4: doesn't show hand 
*** SUMMARY ***
Total pot 721 | Rake 0 
Board [Ks 5d 2h]
Seat 1: judith.f folded before Flop (didn't bet)
Seat 2: trueJamaican folded before Flop (didn't bet)
Seat 3: dow_jones4 collected (721)
Seat 4: jcarlos.vale folded on the Flop
Seat 5: phantofant (button) folded before Flop (didn't bet)
Seat 6: uht25 (small blind) folded before Flop
Seat 7: MWCHESS (big blind) folded on the Flop
Seat 8: Louuuu2k folded before Flop (didn't bet)
Seat 9: NotHereFish folded before Flop (didn't bet)



PokerStars Hand #222699187852: Tournament #3099770291, $0.98+$0.12 USD Hold'em No Limit - Level V (40/80) - 2021/01/16 20:46:28 EET [2021/01/16 13:46:28 ET]
Table '3099770291 62' 9-max Seat #6 is the button
Seat 1: judith.f (6752 in chips) 
Seat 2: trueJamaican (11658 in chips) 
Seat 3: dow_jones4 (5512 in chips) 
Seat 4: jcarlos.vale (9855 in chips) 
Seat 5: phantofant (2805 in chips) 
Seat 6: uht25 (9632 in chips) 
Seat 7: MWCHESS (915 in chips) 
Seat 8: Louuuu2k (4955 in chips) 
Seat 9: NotHereFish (5102 in chips) 
judith.f: posts the ante 9
trueJamaican: posts the ante 9
dow_jones4: posts the ante 9
jcarlos.vale: posts the ante 9
phantofant: posts the ante 9
uht25: posts the ante 9
MWCHESS: posts the ante 9
Louuuu2k: posts the ante 9
NotHereFish: posts the ante 9
MWCHESS: posts small blind 40
Louuuu2k: posts big blind 80
*** HOLE CARDS ***
Dealt to jcarlos.vale [Qd Ks]
NotHereFish: folds 
judith.f: folds 
trueJamaican: folds 
dow_jones4: folds 
jcarlos.vale: raises 128 to 208
phantofant: folds 
uht25: folds 
MWCHESS: folds 
Louuuu2k: calls 128
*** FLOP *** [7h 8h 9h]
Louuuu2k: checks 
jcarlos.vale: checks 
*** TURN *** [7h 8h 9h] [5h]
Louuuu2k: checks 
jcarlos.vale: checks 
*** RIVER *** [7h 8h 9h 5h] [9s]
Louuuu2k: checks 
jcarlos.vale: checks 
*** SHOW DOWN ***
Louuuu2k: shows [8s Ac] (two pair, Nines and Eights)
jcarlos.vale: mucks hand 
Louuuu2k collected 537 from pot
*** SUMMARY ***
Total pot 537 | Rake 0 
Board [7h 8h 9h 5h 9s]
Seat 1: judith.f folded before Flop (didn't bet)
Seat 2: trueJamaican folded before Flop (didn't bet)
Seat 3: dow_jones4 folded before Flop (didn't bet)
Seat 4: jcarlos.vale mucked [Qd Ks]
Seat 5: phantofant folded before Flop (didn't bet)
Seat 6: uht25 (button) folded before Flop (didn't bet)
Seat 7: MWCHESS (small blind) folded before Flop
Seat 8: Louuuu2k (big blind) showed [8s Ac] and won (537) with two pair, Nines and Eights
Seat 9: NotHereFish folded before Flop (didn't bet)



PokerStars Hand #222699222885: Tournament #3099770291, $0.98+$0.12 USD Hold'em No Limit - Level V (40/80) - 2021/01/16 20:47:10 EET [2021/01/16 13:47:10 ET]
Table '3099770291 62' 9-max Seat #7 is the button
Seat 1: judith.f (6743 in chips) 
Seat 2: trueJamaican (11649 in chips) 
Seat 3: dow_jones4 (5503 in chips) 
Seat 4: jcarlos.vale (9638 in chips) 
Seat 5: phantofant (2796 in chips) 
Seat 6: uht25 (9623 in chips) 
Seat 7: MWCHESS (866 in chips) 
Seat 8: Louuuu2k (5275 in chips) 
Seat 9: NotHereFish (5093 in chips) 
judith.f: posts the ante 9
trueJamaican: posts the ante 9
dow_jones4: posts the ante 9
jcarlos.vale: posts the ante 9
phantofant: posts the ante 9
uht25: posts the ante 9
MWCHESS: posts the ante 9
Louuuu2k: posts the ante 9
NotHereFish: posts the ante 9
Louuuu2k: posts small blind 40
NotHereFish: posts big blind 80
*** HOLE CARDS ***
Dealt to jcarlos.vale [7d Qd]
judith.f: folds 
trueJamaican: folds 
dow_jones4: folds 
jcarlos.vale: folds 
phantofant: calls 80
uht25: folds 
MWCHESS: folds 
Louuuu2k: calls 40
NotHereFish: raises 240 to 320
phantofant: folds 
Louuuu2k: calls 240
*** FLOP *** [6h Kc Js]
Louuuu2k: checks 
NotHereFish: bets 200
Louuuu2k: raises 396 to 596
NotHereFish: calls 396
*** TURN *** [6h Kc Js] [2c]
Louuuu2k: bets 1200
NotHereFish: calls 1200
*** RIVER *** [6h Kc Js 2c] [4c]
Louuuu2k: checks 
NotHereFish: checks 
*** SHOW DOWN ***
Louuuu2k: shows [Jc Ts] (a pair of Jacks)
NotHereFish: shows [Qh Kh] (a pair of Kings)
NotHereFish collected 4393 from pot
*** SUMMARY ***
Total pot 4393 | Rake 0 
Board [6h Kc Js 2c 4c]
Seat 1: judith.f folded before Flop (didn't bet)
Seat 2: trueJamaican folded before Flop (didn't bet)
Seat 3: dow_jones4 folded before Flop (didn't bet)
Seat 4: jcarlos.vale folded before Flop (didn't bet)
Seat 5: phantofant folded before Flop
Seat 6: uht25 folded before Flop (didn't bet)
Seat 7: MWCHESS (button) folded before Flop (didn't bet)
Seat 8: Louuuu2k (small blind) showed [Jc Ts] and lost with a pair of Jacks
Seat 9: NotHereFish (big blind) showed [Qh Kh] and won (4393) with a pair of Kings



PokerStars Hand #222699287936: Tournament #3099770291, $0.98+$0.12 USD Hold'em No Limit - Level V (40/80) - 2021/01/16 20:48:27 EET [2021/01/16 13:48:27 ET]
Table '3099770291 62' 9-max Seat #8 is the button
Seat 1: judith.f (6734 in chips) 
Seat 2: trueJamaican (11640 in chips) 
Seat 3: dow_jones4 (5494 in chips) 
Seat 4: jcarlos.vale (9629 in chips) 
Seat 5: phantofant (2707 in chips) 
Seat 6: uht25 (9614 in chips) 
Seat 7: MWCHESS (857 in chips) 
Seat 8: Louuuu2k (3150 in chips) 
Seat 9: NotHereFish (7361 in chips) 
judith.f: posts the ante 9
trueJamaican: posts the ante 9
dow_jones4: posts the ante 9
jcarlos.vale: posts the ante 9
phantofant: posts the ante 9
uht25: posts the ante 9
MWCHESS: posts the ante 9
Louuuu2k: posts the ante 9
NotHereFish: posts the ante 9
NotHereFish: posts small blind 40
judith.f: posts big blind 80
*** HOLE CARDS ***
Dealt to jcarlos.vale [Td 5s]
trueJamaican: raises 80 to 160
dow_jones4: folds 
jcarlos.vale: folds 
phantofant: calls 160
uht25: folds 
MWCHESS: folds 
Louuuu2k: folds 
NotHereFish: calls 120
judith.f: folds 
*** FLOP *** [6d Jh Qd]
NotHereFish: checks 
trueJamaican: bets 282
phantofant: raises 282 to 564
NotHereFish: folds 
trueJamaican: calls 282
*** TURN *** [6d Jh Qd] [8s]
trueJamaican: checks 
phantofant: checks 
*** RIVER *** [6d Jh Qd 8s] [4s]
trueJamaican: bets 778
phantofant: calls 778
*** SHOW DOWN ***
trueJamaican: shows [Qs Kh] (a pair of Queens)
phantofant: mucks hand 
trueJamaican collected 3325 from pot
*** SUMMARY ***
Total pot 3325 | Rake 0 
Board [6d Jh Qd 8s 4s]
Seat 1: judith.f (big blind) folded before Flop
Seat 2: trueJamaican showed [Qs Kh] and won (3325) with a pair of Queens
Seat 3: dow_jones4 folded before Flop (didn't bet)
Seat 4: jcarlos.vale folded before Flop (didn't bet)
Seat 5: phantofant mucked [Jd 2d]
Seat 6: uht25 folded before Flop (didn't bet)
Seat 7: MWCHESS folded before Flop (didn't bet)
Seat 8: Louuuu2k (button) folded before Flop (didn't bet)
Seat 9: NotHereFish (small blind) folded on the Flop



PokerStars Hand #222699331212: Tournament #3099770291, $0.98+$0.12 USD Hold'em No Limit - Level V (40/80) - 2021/01/16 20:49:19 EET [2021/01/16 13:49:19 ET]
Table '3099770291 62' 9-max Seat #9 is the button
Seat 1: judith.f (6645 in chips) 
Seat 3: dow_jones4 (5485 in chips) 
Seat 4: jcarlos.vale (9620 in chips) 
Seat 5: phantofant (1196 in chips) 
Seat 6: uht25 (9605 in chips) 
Seat 7: MWCHESS (848 in chips) 
Seat 8: Louuuu2k (3141 in chips) 
Seat 9: NotHereFish (7192 in chips) 
judith.f: posts the ante 9
dow_jones4: posts the ante 9
jcarlos.vale: posts the ante 9
phantofant: posts the ante 9
uht25: posts the ante 9
MWCHESS: posts the ante 9
Louuuu2k: posts the ante 9
NotHereFish: posts the ante 9
judith.f: posts small blind 40
dow_jones4: posts big blind 80
*** HOLE CARDS ***
Dealt to jcarlos.vale [3h 6h]
jcarlos.vale: folds 
phantofant: calls 80
uht25: folds 
MWCHESS: folds 
Louuuu2k: folds 
NotHereFish: folds 
judith.f: folds 
dow_jones4: checks 
*** FLOP *** [Ts 5d 7d]
dow_jones4: checks 
phantofant: checks 
*** TURN *** [Ts 5d 7d] [Ac]
dow_jones4: checks 
phantofant: bets 240
dow_jones4: folds 
Uncalled bet (240) returned to phantofant
phantofant collected 272 from pot
phantofant: doesn't show hand 
*** SUMMARY ***
Total pot 272 | Rake 0 
Board [Ts 5d 7d Ac]
Seat 1: judith.f (small blind) folded before Flop
Seat 3: dow_jones4 (big blind) folded on the Turn
Seat 4: jcarlos.vale folded before Flop (didn't bet)
Seat 5: phantofant collected (272)
Seat 6: uht25 folded before Flop (didn't bet)
Seat 7: MWCHESS folded before Flop (didn't bet)
Seat 8: Louuuu2k folded before Flop (didn't bet)
Seat 9: NotHereFish (button) folded before Flop (didn't bet)



PokerStars Hand #222699397593: Tournament #3099770291, $0.98+$0.12 USD Hold'em No Limit - Level VI (50/100) - 2021/01/16 20:50:39 EET [2021/01/16 13:50:39 ET]
Table '3099770291 62' 9-max Seat #1 is the button
Seat 1: judith.f (6596 in chips) 
Seat 2: Burton Feingold (5000 in chips) out of hand (moved from another table into small blind)
Seat 3: dow_jones4 (5396 in chips) 
Seat 4: jcarlos.vale (9611 in chips) 
Seat 5: phantofant (1379 in chips) 
Seat 6: uht25 (9596 in chips) 
Seat 7: MWCHESS (839 in chips) 
Seat 8: Louuuu2k (3132 in chips) 
Seat 9: NotHereFish (7183 in chips) 
Burton Feingold will be allowed to play after the button
judith.f: posts the ante 10
dow_jones4: posts the ante 10
jcarlos.vale: posts the ante 10
phantofant: posts the ante 10
uht25: posts the ante 10
MWCHESS: posts the ante 10
Louuuu2k: posts the ante 10
NotHereFish: posts the ante 10
dow_jones4: posts small blind 50
jcarlos.vale: posts big blind 100
*** HOLE CARDS ***
Dealt to jcarlos.vale [Qc 4h]
phantofant: folds 
uht25: folds 
MWCHESS: raises 729 to 829 and is all-in
Louuuu2k: folds 
NotHereFish: folds 
judith.f: folds 
dow_jones4: calls 779
jcarlos.vale: folds 
*** FLOP *** [Kh Ac Js]
*** TURN *** [Kh Ac Js] [Qs]
*** RIVER *** [Kh Ac Js Qs] [6c]
*** SHOW DOWN ***
dow_jones4: shows [5c 5d] (a pair of Fives)
MWCHESS: shows [7d 7c] (a pair of Sevens)
MWCHESS collected 1838 from pot
*** SUMMARY ***
Total pot 1838 | Rake 0 
Board [Kh Ac Js Qs 6c]
Seat 1: judith.f (button) folded before Flop (didn't bet)
Seat 3: dow_jones4 (small blind) showed [5c 5d] and lost with a pair of Fives
Seat 4: jcarlos.vale (big blind) folded before Flop
Seat 5: phantofant folded before Flop (didn't bet)
Seat 6: uht25 folded before Flop (didn't bet)
Seat 7: MWCHESS showed [7d 7c] and won (1838) with a pair of Sevens
Seat 8: Louuuu2k folded before Flop (didn't bet)
Seat 9: NotHereFish folded before Flop (didn't bet)



PokerStars Hand #222699429523: Tournament #3099770291, $0.98+$0.12 USD Hold'em No Limit - Level VI (50/100) - 2021/01/16 20:51:17 EET [2021/01/16 13:51:17 ET]
Table '3099770291 62' 9-max Seat #3 is the button
Seat 1: judith.f (6586 in chips) 
Seat 2: Burton Feingold (5000 in chips) 
Seat 3: dow_jones4 (4557 in chips) 
Seat 4: jcarlos.vale (9501 in chips) 
Seat 5: phantofant (1369 in chips) 
Seat 6: uht25 (9586 in chips) 
Seat 7: MWCHESS (1838 in chips) 
Seat 8: Louuuu2k (3122 in chips) 
Seat 9: NotHereFish (7173 in chips) 
judith.f: posts the ante 10
Burton Feingold: posts the ante 10
dow_jones4: posts the ante 10
jcarlos.vale: posts the ante 10
phantofant: posts the ante 10
uht25: posts the ante 10
MWCHESS: posts the ante 10
Louuuu2k: posts the ante 10
NotHereFish: posts the ante 10
jcarlos.vale: posts small blind 50
phantofant: posts big blind 100
*** HOLE CARDS ***
Dealt to jcarlos.vale [9c 7h]
uht25: folds 
MWCHESS: folds 
Louuuu2k: folds 
NotHereFish: raises 100 to 200
judith.f: folds 
Burton Feingold: folds 
dow_jones4: raises 450 to 650
jcarlos.vale: folds 
phantofant: folds 
NotHereFish: folds 
Uncalled bet (450) returned to dow_jones4
dow_jones4 collected 640 from pot
dow_jones4: doesn't show hand 
*** SUMMARY ***
Total pot 640 | Rake 0 
Seat 1: judith.f folded before Flop (didn't bet)
Seat 2: Burton Feingold folded before Flop (didn't bet)
Seat 3: dow_jones4 (button) collected (640)
Seat 4: jcarlos.vale (small blind) folded before Flop
Seat 5: phantofant (big blind) folded before Flop
Seat 6: uht25 folded before Flop (didn't bet)
Seat 7: MWCHESS folded before Flop (didn't bet)
Seat 8: Louuuu2k folded before Flop (didn't bet)
Seat 9: NotHereFish folded before Flop



PokerStars Hand #222699462124: Tournament #3099770291, $0.98+$0.12 USD Hold'em No Limit - Level VI (50/100) - 2021/01/16 20:51:57 EET [2021/01/16 13:51:57 ET]
Table '3099770291 62' 9-max Seat #4 is the button
Seat 1: judith.f (6576 in chips) 
Seat 2: Burton Feingold (4990 in chips) 
Seat 3: dow_jones4 (4987 in chips) 
Seat 4: jcarlos.vale (9441 in chips) 
Seat 5: phantofant (1259 in chips) 
Seat 6: uht25 (9576 in chips) 
Seat 7: MWCHESS (1828 in chips) 
Seat 8: Louuuu2k (3112 in chips) 
Seat 9: NotHereFish (6963 in chips) 
judith.f: posts the ante 10
Burton Feingold: posts the ante 10
dow_jones4: posts the ante 10
jcarlos.vale: posts the ante 10
phantofant: posts the ante 10
uht25: posts the ante 10
MWCHESS: posts the ante 10
Louuuu2k: posts the ante 10
NotHereFish: posts the ante 10
phantofant: posts small blind 50
uht25: posts big blind 100
*** HOLE CARDS ***
Dealt to jcarlos.vale [6h 5d]
MWCHESS: folds 
Louuuu2k: folds 
NotHereFish: raises 100 to 200
judith.f: folds 
Burton Feingold: folds 
dow_jones4: raises 450 to 650
jcarlos.vale: folds 
phantofant: folds 
uht25: folds 
NotHereFish: raises 1050 to 1700
dow_jones4: folds 
Uncalled bet (1050) returned to NotHereFish
NotHereFish collected 1540 from pot
NotHereFish: doesn't show hand 
*** SUMMARY ***
Total pot 1540 | Rake 0 
Seat 1: judith.f folded before Flop (didn't bet)
Seat 2: Burton Feingold folded before Flop (didn't bet)
Seat 3: dow_jones4 folded before Flop
Seat 4: jcarlos.vale (button) folded before Flop (didn't bet)
Seat 5: phantofant (small blind) folded before Flop
Seat 6: uht25 (big blind) folded before Flop
Seat 7: MWCHESS folded before Flop (didn't bet)
Seat 8: Louuuu2k folded before Flop (didn't bet)
Seat 9: NotHereFish collected (1540)



PokerStars Hand #222699495702: Tournament #3099770291, $0.98+$0.12 USD Hold'em No Limit - Level VI (50/100) - 2021/01/16 20:52:37 EET [2021/01/16 13:52:37 ET]
Table '3099770291 62' 9-max Seat #5 is the button
Seat 1: judith.f (6566 in chips) 
Seat 2: Burton Feingold (4980 in chips) 
Seat 3: dow_jones4 (4327 in chips) 
Seat 4: jcarlos.vale (9431 in chips) 
Seat 5: phantofant (1199 in chips) 
Seat 6: uht25 (9466 in chips) 
Seat 7: MWCHESS (1818 in chips) 
Seat 8: Louuuu2k (3102 in chips) 
Seat 9: NotHereFish (7843 in chips) 
judith.f: posts the ante 10
Burton Feingold: posts the ante 10
dow_jones4: posts the ante 10
jcarlos.vale: posts the ante 10
phantofant: posts the ante 10
uht25: posts the ante 10
MWCHESS: posts the ante 10
Louuuu2k: posts the ante 10
NotHereFish: posts the ante 10
uht25: posts small blind 50
MWCHESS: posts big blind 100
*** HOLE CARDS ***
Dealt to jcarlos.vale [Ad 5c]
Louuuu2k: folds 
NotHereFish: folds 
judith.f: folds 
Burton Feingold: folds 
dow_jones4: folds 
jcarlos.vale: folds 
phantofant: folds 
uht25: calls 50
MWCHESS: checks 
*** FLOP *** [Ts 9s Jc]
uht25: bets 100
MWCHESS: folds 
Uncalled bet (100) returned to uht25
uht25 collected 290 from pot
uht25: doesn't show hand 
*** SUMMARY ***
Total pot 290 | Rake 0 
Board [Ts 9s Jc]
Seat 1: judith.f folded before Flop (didn't bet)
Seat 2: Burton Feingold folded before Flop (didn't bet)
Seat 3: dow_jones4 folded before Flop (didn't bet)
Seat 4: jcarlos.vale folded before Flop (didn't bet)
Seat 5: phantofant (button) folded before Flop (didn't bet)
Seat 6: uht25 (small blind) collected (290)
Seat 7: MWCHESS (big blind) folded on the Flop
Seat 8: Louuuu2k folded before Flop (didn't bet)
Seat 9: NotHereFish folded before Flop (didn't bet)



PokerStars Hand #222699530311: Tournament #3099770291, $0.98+$0.12 USD Hold'em No Limit - Level VI (50/100) - 2021/01/16 20:53:19 EET [2021/01/16 13:53:19 ET]
Table '3099770291 62' 9-max Seat #6 is the button
Seat 1: judith.f (6556 in chips) 
Seat 2: Burton Feingold (4970 in chips) 
Seat 3: dow_jones4 (4317 in chips) 
Seat 4: jcarlos.vale (9421 in chips) 
Seat 5: phantofant (1189 in chips) 
Seat 6: uht25 (9646 in chips) 
Seat 7: MWCHESS (1708 in chips) 
Seat 8: Louuuu2k (3092 in chips) 
Seat 9: NotHereFish (7833 in chips) 
judith.f: posts the ante 10
Burton Feingold: posts the ante 10
dow_jones4: posts the ante 10
jcarlos.vale: posts the ante 10
phantofant: posts the ante 10
uht25: posts the ante 10
MWCHESS: posts the ante 10
Louuuu2k: posts the ante 10
NotHereFish: posts the ante 10
MWCHESS: posts small blind 50
Louuuu2k: posts big blind 100
*** HOLE CARDS ***
Dealt to jcarlos.vale [8c 9c]
NotHereFish: folds 
judith.f: folds 
Burton Feingold: folds 
dow_jones4: folds 
jcarlos.vale: calls 100
phantofant: calls 100
uht25: folds 
MWCHESS: calls 50
Louuuu2k: checks 
*** FLOP *** [4s Jh Js]
MWCHESS: checks 
Louuuu2k: checks 
jcarlos.vale: checks 
phantofant: checks 
*** TURN *** [4s Jh Js] [6d]
MWCHESS: checks 
Louuuu2k: checks 
jcarlos.vale: checks 
phantofant: checks 
*** RIVER *** [4s Jh Js 6d] [As]
MWCHESS: checks 
Louuuu2k: checks 
jcarlos.vale: checks 
phantofant: bets 100
MWCHESS: folds 
Louuuu2k: folds 
jcarlos.vale: folds 
Uncalled bet (100) returned to phantofant
phantofant collected 490 from pot
phantofant: doesn't show hand 
*** SUMMARY ***
Total pot 490 | Rake 0 
Board [4s Jh Js 6d As]
Seat 1: judith.f folded before Flop (didn't bet)
Seat 2: Burton Feingold folded before Flop (didn't bet)
Seat 3: dow_jones4 folded before Flop (didn't bet)
Seat 4: jcarlos.vale folded on the River
Seat 5: phantofant collected (490)
Seat 6: uht25 (button) folded before Flop (didn't bet)
Seat 7: MWCHESS (small blind) folded on the River
Seat 8: Louuuu2k (big blind) folded on the River
Seat 9: NotHereFish folded before Flop (didn't bet)



PokerStars Hand #222699594106: Tournament #3099770291, $0.98+$0.12 USD Hold'em No Limit - Level VI (50/100) - 2021/01/16 20:54:35 EET [2021/01/16 13:54:35 ET]
Table '3099770291 62' 9-max Seat #7 is the button
Seat 1: judith.f (6546 in chips) 
Seat 2: Burton Feingold (4960 in chips) 
Seat 3: dow_jones4 (4307 in chips) 
Seat 4: jcarlos.vale (9311 in chips) 
Seat 5: phantofant (1569 in chips) 
Seat 6: uht25 (9636 in chips) 
Seat 7: MWCHESS (1598 in chips) 
Seat 8: Louuuu2k (2982 in chips) 
Seat 9: NotHereFish (7823 in chips) 
judith.f: posts the ante 10
Burton Feingold: posts the ante 10
dow_jones4: posts the ante 10
jcarlos.vale: posts the ante 10
phantofant: posts the ante 10
uht25: posts the ante 10
MWCHESS: posts the ante 10
Louuuu2k: posts the ante 10
NotHereFish: posts the ante 10
Louuuu2k: posts small blind 50
NotHereFish: posts big blind 100
*** HOLE CARDS ***
Dealt to jcarlos.vale [Qc Ad]
judith.f: folds 
Burton Feingold: folds 
dow_jones4: folds 
jcarlos.vale: raises 160 to 260
phantofant: folds 
uht25: folds 
MWCHESS: folds 
Louuuu2k: folds 
NotHereFish: calls 160
*** FLOP *** [9h 3s 4h]
NotHereFish: checks 
jcarlos.vale: checks 
*** TURN *** [9h 3s 4h] [Kd]
NotHereFish: checks 
jcarlos.vale: checks 
*** RIVER *** [9h 3s 4h Kd] [5s]
NotHereFish: checks 
jcarlos.vale: checks 
*** SHOW DOWN ***
NotHereFish: shows [Ah Jc] (high card Ace)
jcarlos.vale: shows [Qc Ad] (high card Ace - King+Queen kicker)
jcarlos.vale collected 660 from pot
*** SUMMARY ***
Total pot 660 | Rake 0 
Board [9h 3s 4h Kd 5s]
Seat 1: judith.f folded before Flop (didn't bet)
Seat 2: Burton Feingold folded before Flop (didn't bet)
Seat 3: dow_jones4 folded before Flop (didn't bet)
Seat 4: jcarlos.vale showed [Qc Ad] and won (660) with high card Ace
Seat 5: phantofant folded before Flop (didn't bet)
Seat 6: uht25 folded before Flop (didn't bet)
Seat 7: MWCHESS (button) folded before Flop (didn't bet)
Seat 8: Louuuu2k (small blind) folded before Flop
Seat 9: NotHereFish (big blind) showed [Ah Jc] and lost with high card Ace



PokerStars Hand #222699875694: Tournament #3099770291, $0.98+$0.12 USD Hold'em No Limit - Level VI (50/100) - 2021/01/16 21:02:26 EET [2021/01/16 14:02:26 ET]
Table '3099770291 62' 9-max Seat #8 is the button
Seat 1: judith.f (6536 in chips) 
Seat 2: Burton Feingold (4950 in chips) 
Seat 3: dow_jones4 (4297 in chips) 
Seat 4: jcarlos.vale (9701 in chips) 
Seat 5: phantofant (1559 in chips) 
Seat 6: uht25 (9626 in chips) 
Seat 7: MWCHESS (1588 in chips) 
Seat 8: Louuuu2k (2922 in chips) 
Seat 9: NotHereFish (7553 in chips) 
judith.f: posts the ante 10
Burton Feingold: posts the ante 10
dow_jones4: posts the ante 10
jcarlos.vale: posts the ante 10
phantofant: posts the ante 10
uht25: posts the ante 10
MWCHESS: posts the ante 10
Louuuu2k: posts the ante 10
NotHereFish: posts the ante 10
NotHereFish: posts small blind 50
judith.f: posts big blind 100
*** HOLE CARDS ***
Dealt to jcarlos.vale [Kd Td]
Burton Feingold: folds 
dow_jones4: folds 
jcarlos.vale: calls 100
phantofant: calls 100
uht25: folds 
MWCHESS: folds 
Louuuu2k: folds 
NotHereFish: folds 
judith.f: checks 
*** FLOP *** [5d 4d Qd]
judith.f: checks 
jcarlos.vale: bets 100
phantofant: calls 100
judith.f: folds 
*** TURN *** [5d 4d Qd] [7s]
jcarlos.vale: bets 100
phantofant: calls 100
*** RIVER *** [5d 4d Qd 7s] [3c]
jcarlos.vale: bets 300
phantofant: folds 
Uncalled bet (300) returned to jcarlos.vale
jcarlos.vale collected 840 from pot
jcarlos.vale: doesn't show hand 
*** SUMMARY ***
Total pot 840 | Rake 0 
Board [5d 4d Qd 7s 3c]
Seat 1: judith.f (big blind) folded on the Flop
Seat 2: Burton Feingold folded before Flop (didn't bet)
Seat 3: dow_jones4 folded before Flop (didn't bet)
Seat 4: jcarlos.vale collected (840)
Seat 5: phantofant folded on the River
Seat 6: uht25 folded before Flop (didn't bet)
Seat 7: MWCHESS folded before Flop (didn't bet)
Seat 8: Louuuu2k (button) folded before Flop (didn't bet)
Seat 9: NotHereFish (small blind) folded before Flop



PokerStars Hand #222699932081: Tournament #3099770291, $0.98+$0.12 USD Hold'em No Limit - Level VI (50/100) - 2021/01/16 21:03:33 EET [2021/01/16 14:03:33 ET]
Table '3099770291 62' 9-max Seat #9 is the button
Seat 1: judith.f (6426 in chips) 
Seat 2: Burton Feingold (4940 in chips) 
Seat 3: dow_jones4 (4287 in chips) 
Seat 4: jcarlos.vale (10231 in chips) 
Seat 5: phantofant (1249 in chips) 
Seat 6: uht25 (9616 in chips) 
Seat 7: MWCHESS (1578 in chips) 
Seat 8: Louuuu2k (2912 in chips) 
Seat 9: NotHereFish (7493 in chips) 
judith.f: posts the ante 10
Burton Feingold: posts the ante 10
dow_jones4: posts the ante 10
jcarlos.vale: posts the ante 10
phantofant: posts the ante 10
uht25: posts the ante 10
MWCHESS: posts the ante 10
Louuuu2k: posts the ante 10
NotHereFish: posts the ante 10
judith.f: posts small blind 50
Burton Feingold: posts big blind 100
*** HOLE CARDS ***
Dealt to jcarlos.vale [5c As]
dow_jones4: folds 
jcarlos.vale: folds 
phantofant: folds 
uht25: folds 
MWCHESS: folds 
Louuuu2k: folds 
NotHereFish: raises 100 to 200
judith.f: folds 
Burton Feingold: folds 
Uncalled bet (100) returned to NotHereFish
NotHereFish collected 340 from pot
NotHereFish: doesn't show hand 
*** SUMMARY ***
Total pot 340 | Rake 0 
Seat 1: judith.f (small blind) folded before Flop
Seat 2: Burton Feingold (big blind) folded before Flop
Seat 3: dow_jones4 folded before Flop (didn't bet)
Seat 4: jcarlos.vale folded before Flop (didn't bet)
Seat 5: phantofant folded before Flop (didn't bet)
Seat 6: uht25 folded before Flop (didn't bet)
Seat 7: MWCHESS folded before Flop (didn't bet)
Seat 8: Louuuu2k folded before Flop (didn't bet)
Seat 9: NotHereFish (button) collected (340)



PokerStars Hand #222699961450: Tournament #3099770291, $0.98+$0.12 USD Hold'em No Limit - Level VI (50/100) - 2021/01/16 21:04:07 EET [2021/01/16 14:04:07 ET]
Table '3099770291 62' 9-max Seat #1 is the button
Seat 1: judith.f (6366 in chips) 
Seat 2: Burton Feingold (4830 in chips) 
Seat 3: dow_jones4 (4277 in chips) 
Seat 4: jcarlos.vale (10221 in chips) 
Seat 5: phantofant (1239 in chips) 
Seat 6: uht25 (9606 in chips) 
Seat 7: MWCHESS (1568 in chips) 
Seat 8: Louuuu2k (2902 in chips) 
Seat 9: NotHereFish (7723 in chips) 
judith.f: posts the ante 10
Burton Feingold: posts the ante 10
dow_jones4: posts the ante 10
jcarlos.vale: posts the ante 10
phantofant: posts the ante 10
uht25: posts the ante 10
MWCHESS: posts the ante 10
Louuuu2k: posts the ante 10
NotHereFish: posts the ante 10
Burton Feingold: posts small blind 50
dow_jones4: posts big blind 100
*** HOLE CARDS ***
Dealt to jcarlos.vale [Jh Js]
jcarlos.vale: raises 160 to 260
phantofant: folds 
uht25: folds 
MWCHESS: folds 
Louuuu2k: folds 
NotHereFish: folds 
judith.f: folds 
Burton Feingold: folds 
dow_jones4: calls 160
*** FLOP *** [4s Ac 5c]
dow_jones4: checks 
jcarlos.vale: bets 200
dow_jones4: folds 
Uncalled bet (200) returned to jcarlos.vale
jcarlos.vale collected 660 from pot
jcarlos.vale: doesn't show hand 
*** SUMMARY ***
Total pot 660 | Rake 0 
Board [4s Ac 5c]
Seat 1: judith.f (button) folded before Flop (didn't bet)
Seat 2: Burton Feingold (small blind) folded before Flop
Seat 3: dow_jones4 (big blind) folded on the Flop
Seat 4: jcarlos.vale collected (660)
Seat 5: phantofant folded before Flop (didn't bet)
Seat 6: uht25 folded before Flop (didn't bet)
Seat 7: MWCHESS folded before Flop (didn't bet)
Seat 8: Louuuu2k folded before Flop (didn't bet)
Seat 9: NotHereFish folded before Flop (didn't bet)



PokerStars Hand #222700003945: Tournament #3099770291, $0.98+$0.12 USD Hold'em No Limit - Level VI (50/100) - 2021/01/16 21:04:57 EET [2021/01/16 14:04:57 ET]
Table '3099770291 62' 9-max Seat #2 is the button
Seat 1: judith.f (6356 in chips) 
Seat 2: Burton Feingold (4770 in chips) 
Seat 3: dow_jones4 (4007 in chips) 
Seat 4: jcarlos.vale (10611 in chips) 
Seat 5: phantofant (1229 in chips) 
Seat 6: uht25 (9596 in chips) 
Seat 7: MWCHESS (1558 in chips) 
Seat 8: Louuuu2k (2892 in chips) 
Seat 9: NotHereFish (7713 in chips) 
judith.f: posts the ante 10
Burton Feingold: posts the ante 10
dow_jones4: posts the ante 10
jcarlos.vale: posts the ante 10
phantofant: posts the ante 10
uht25: posts the ante 10
MWCHESS: posts the ante 10
Louuuu2k: posts the ante 10
NotHereFish: posts the ante 10
dow_jones4: posts small blind 50
jcarlos.vale: posts big blind 100
*** HOLE CARDS ***
Dealt to jcarlos.vale [Ah 8c]
phantofant: calls 100
uht25: folds 
MWCHESS: folds 
Louuuu2k: folds 
NotHereFish: folds 
judith.f: folds 
Burton Feingold: folds 
dow_jones4: folds 
jcarlos.vale: checks 
*** FLOP *** [Js 3s 5h]
jcarlos.vale: checks 
phantofant: checks 
*** TURN *** [Js 3s 5h] [2c]
jcarlos.vale: checks 
phantofant: checks 
*** RIVER *** [Js 3s 5h 2c] [4c]
jcarlos.vale: bets 200
phantofant: folds 
Uncalled bet (200) returned to jcarlos.vale
jcarlos.vale collected 340 from pot
jcarlos.vale: doesn't show hand 
*** SUMMARY ***
Total pot 340 | Rake 0 
Board [Js 3s 5h 2c 4c]
Seat 1: judith.f folded before Flop (didn't bet)
Seat 2: Burton Feingold (button) folded before Flop (didn't bet)
Seat 3: dow_jones4 (small blind) folded before Flop
Seat 4: jcarlos.vale (big blind) collected (340)
Seat 5: phantofant folded on the River
Seat 6: uht25 folded before Flop (didn't bet)
Seat 7: MWCHESS folded before Flop (didn't bet)
Seat 8: Louuuu2k folded before Flop (didn't bet)
Seat 9: NotHereFish folded before Flop (didn't bet)



PokerStars Hand #222700071373: Tournament #3099770291, $0.98+$0.12 USD Hold'em No Limit - Level VI (50/100) - 2021/01/16 21:06:14 EET [2021/01/16 14:06:14 ET]
Table '3099770291 62' 9-max Seat #3 is the button
Seat 1: judith.f (6346 in chips) 
Seat 2: Burton Feingold (4760 in chips) 
Seat 3: dow_jones4 (3947 in chips) 
Seat 4: jcarlos.vale (10841 in chips) 
Seat 5: phantofant (1119 in chips) 
Seat 6: uht25 (9586 in chips) 
Seat 7: MWCHESS (1548 in chips) 
Seat 8: Louuuu2k (2882 in chips) 
Seat 9: NotHereFish (7703 in chips) 
judith.f: posts the ante 10
Burton Feingold: posts the ante 10
dow_jones4: posts the ante 10
jcarlos.vale: posts the ante 10
phantofant: posts the ante 10
uht25: posts the ante 10
MWCHESS: posts the ante 10
Louuuu2k: posts the ante 10
NotHereFish: posts the ante 10
jcarlos.vale: posts small blind 50
phantofant: posts big blind 100
*** HOLE CARDS ***
Dealt to jcarlos.vale [3d 5c]
uht25: folds 
MWCHESS: folds 
Louuuu2k: folds 
NotHereFish: raises 100 to 200
judith.f: folds 
Burton Feingold: folds 
dow_jones4: folds 
jcarlos.vale: folds 
phantofant: folds 
Uncalled bet (100) returned to NotHereFish
NotHereFish collected 340 from pot
NotHereFish: doesn't show hand 
*** SUMMARY ***
Total pot 340 | Rake 0 
Seat 1: judith.f folded before Flop (didn't bet)
Seat 2: Burton Feingold folded before Flop (didn't bet)
Seat 3: dow_jones4 (button) folded before Flop (didn't bet)
Seat 4: jcarlos.vale (small blind) folded before Flop
Seat 5: phantofant (big blind) folded before Flop
Seat 6: uht25 folded before Flop (didn't bet)
Seat 7: MWCHESS folded before Flop (didn't bet)
Seat 8: Louuuu2k folded before Flop (didn't bet)
Seat 9: NotHereFish collected (340)



PokerStars Hand #222700096983: Tournament #3099770291, $0.98+$0.12 USD Hold'em No Limit - Level VI (50/100) - 2021/01/16 21:06:44 EET [2021/01/16 14:06:44 ET]
Table '3099770291 62' 9-max Seat #4 is the button
Seat 1: judith.f (6336 in chips) 
Seat 2: Burton Feingold (4750 in chips) 
Seat 3: dow_jones4 (3937 in chips) 
Seat 4: jcarlos.vale (10781 in chips) 
Seat 5: phantofant (1009 in chips) 
Seat 6: uht25 (9576 in chips) 
Seat 7: MWCHESS (1538 in chips) 
Seat 8: Louuuu2k (2872 in chips) 
Seat 9: NotHereFish (7933 in chips) 
judith.f: posts the ante 10
Burton Feingold: posts the ante 10
dow_jones4: posts the ante 10
jcarlos.vale: posts the ante 10
phantofant: posts the ante 10
uht25: posts the ante 10
MWCHESS: posts the ante 10
Louuuu2k: posts the ante 10
NotHereFish: posts the ante 10
phantofant: posts small blind 50
uht25: posts big blind 100
*** HOLE CARDS ***
Dealt to jcarlos.vale [6c 3c]
MWCHESS: raises 100 to 200
Louuuu2k: raises 400 to 600
NotHereFish: folds 
judith.f: folds 
Burton Feingold: folds 
dow_jones4: folds 
jcarlos.vale: folds 
phantofant: folds 
uht25: calls 500
MWCHESS: raises 928 to 1528 and is all-in
Louuuu2k: folds 
uht25: calls 928
*** FLOP *** [4s 3h 7c]
*** TURN *** [4s 3h 7c] [Ac]
*** RIVER *** [4s 3h 7c Ac] [8h]
*** SHOW DOWN ***
uht25: shows [Js Jc] (a pair of Jacks)
MWCHESS: shows [Kd Ks] (a pair of Kings)
MWCHESS collected 3796 from pot
*** SUMMARY ***
Total pot 3796 | Rake 0 
Board [4s 3h 7c Ac 8h]
Seat 1: judith.f folded before Flop (didn't bet)
Seat 2: Burton Feingold folded before Flop (didn't bet)
Seat 3: dow_jones4 folded before Flop (didn't bet)
Seat 4: jcarlos.vale (button) folded before Flop (didn't bet)
Seat 5: phantofant (small blind) folded before Flop
Seat 6: uht25 (big blind) showed [Js Jc] and lost with a pair of Jacks
Seat 7: MWCHESS showed [Kd Ks] and won (3796) with a pair of Kings
Seat 8: Louuuu2k folded before Flop
Seat 9: NotHereFish folded before Flop (didn't bet)



PokerStars Hand #222700141396: Tournament #3099770291, $0.98+$0.12 USD Hold'em No Limit - Level VII (60/120) - 2021/01/16 21:07:35 EET [2021/01/16 14:07:35 ET]
Table '3099770291 62' 9-max Seat #5 is the button
Seat 1: judith.f (6326 in chips) 
Seat 2: Burton Feingold (4740 in chips) 
Seat 3: dow_jones4 (3927 in chips) 
Seat 4: jcarlos.vale (10771 in chips) 
Seat 5: phantofant (949 in chips) 
Seat 6: uht25 (8038 in chips) 
Seat 7: MWCHESS (3796 in chips) 
Seat 8: Louuuu2k (2262 in chips) 
Seat 9: NotHereFish (7923 in chips) 
judith.f: posts the ante 12
Burton Feingold: posts the ante 12
dow_jones4: posts the ante 12
jcarlos.vale: posts the ante 12
phantofant: posts the ante 12
uht25: posts the ante 12
MWCHESS: posts the ante 12
Louuuu2k: posts the ante 12
NotHereFish: posts the ante 12
uht25: posts small blind 60
MWCHESS: posts big blind 120
*** HOLE CARDS ***
Dealt to jcarlos.vale [Ac Qs]
Louuuu2k: folds 
NotHereFish: folds 
judith.f: folds 
Burton Feingold: folds 
dow_jones4: raises 120 to 240
jcarlos.vale: calls 240
phantofant: folds 
uht25: folds 
MWCHESS: calls 120
*** FLOP *** [2h Ad 7h]
MWCHESS: checks 
dow_jones4: checks 
jcarlos.vale: bets 666
MWCHESS: folds 
dow_jones4: folds 
Uncalled bet (666) returned to jcarlos.vale
jcarlos.vale collected 888 from pot
jcarlos.vale: doesn't show hand 
*** SUMMARY ***
Total pot 888 | Rake 0 
Board [2h Ad 7h]
Seat 1: judith.f folded before Flop (didn't bet)
Seat 2: Burton Feingold folded before Flop (didn't bet)
Seat 3: dow_jones4 folded on the Flop
Seat 4: jcarlos.vale collected (888)
Seat 5: phantofant (button) folded before Flop (didn't bet)
Seat 6: uht25 (small blind) folded before Flop
Seat 7: MWCHESS (big blind) folded on the Flop
Seat 8: Louuuu2k folded before Flop (didn't bet)
Seat 9: NotHereFish folded before Flop (didn't bet)



PokerStars Hand #222700205378: Tournament #3099770291, $0.98+$0.12 USD Hold'em No Limit - Level VII (60/120) - 2021/01/16 21:08:42 EET [2021/01/16 14:08:42 ET]
Table '3099770291 62' 9-max Seat #6 is the button
Seat 1: judith.f (6314 in chips) 
Seat 2: Burton Feingold (4728 in chips) 
Seat 3: dow_jones4 (3675 in chips) 
Seat 4: jcarlos.vale (11407 in chips) 
Seat 5: phantofant (937 in chips) 
Seat 6: uht25 (7966 in chips) 
Seat 7: MWCHESS (3544 in chips) 
Seat 8: Louuuu2k (2250 in chips) 
Seat 9: NotHereFish (7911 in chips) 
judith.f: posts the ante 12
Burton Feingold: posts the ante 12
dow_jones4: posts the ante 12
jcarlos.vale: posts the ante 12
phantofant: posts the ante 12
uht25: posts the ante 12
MWCHESS: posts the ante 12
Louuuu2k: posts the ante 12
NotHereFish: posts the ante 12
MWCHESS: posts small blind 60
Louuuu2k: posts big blind 120
*** HOLE CARDS ***
Dealt to jcarlos.vale [8s 6h]
NotHereFish: raises 120 to 240
judith.f: calls 240
Burton Feingold: folds 
dow_jones4: folds 
jcarlos.vale: folds 
phantofant: calls 240
uht25: folds 
MWCHESS: folds 
Louuuu2k: raises 1998 to 2238 and is all-in
NotHereFish: folds 
judith.f: folds 
phantofant: calls 685 and is all-in
Uncalled bet (1313) returned to Louuuu2k
*** FLOP *** [3c Qc Kh]
*** TURN *** [3c Qc Kh] [7h]
*** RIVER *** [3c Qc Kh 7h] [2h]
*** SHOW DOWN ***
Louuuu2k: shows [As Tc] (high card Ace)
phantofant: shows [Ks Qh] (two pair, Kings and Queens)
phantofant collected 2498 from pot
*** SUMMARY ***
Total pot 2498 | Rake 0 
Board [3c Qc Kh 7h 2h]
Seat 1: judith.f folded before Flop
Seat 2: Burton Feingold folded before Flop (didn't bet)
Seat 3: dow_jones4 folded before Flop (didn't bet)
Seat 4: jcarlos.vale folded before Flop (didn't bet)
Seat 5: phantofant showed [Ks Qh] and won (2498) with two pair, Kings and Queens
Seat 6: uht25 (button) folded before Flop (didn't bet)
Seat 7: MWCHESS (small blind) folded before Flop
Seat 8: Louuuu2k (big blind) showed [As Tc] and lost with high card Ace
Seat 9: NotHereFish folded before Flop



PokerStars Hand #222700250022: Tournament #3099770291, $0.98+$0.12 USD Hold'em No Limit - Level VII (60/120) - 2021/01/16 21:09:34 EET [2021/01/16 14:09:34 ET]
Table '3099770291 62' 9-max Seat #7 is the button
Seat 1: judith.f (6062 in chips) 
Seat 2: Burton Feingold (4716 in chips) 
Seat 3: dow_jones4 (3663 in chips) 
Seat 4: jcarlos.vale (11395 in chips) 
Seat 5: phantofant (2498 in chips) 
Seat 6: uht25 (7954 in chips) 
Seat 7: MWCHESS (3472 in chips) 
Seat 8: Louuuu2k (1313 in chips) 
Seat 9: NotHereFish (7659 in chips) 
judith.f: posts the ante 12
Burton Feingold: posts the ante 12
dow_jones4: posts the ante 12
jcarlos.vale: posts the ante 12
phantofant: posts the ante 12
uht25: posts the ante 12
MWCHESS: posts the ante 12
Louuuu2k: posts the ante 12
NotHereFish: posts the ante 12
Louuuu2k: posts small blind 60
NotHereFish: posts big blind 120
*** HOLE CARDS ***
Dealt to jcarlos.vale [6h 6d]
judith.f: folds 
Burton Feingold: folds 
dow_jones4: folds 
jcarlos.vale: raises 192 to 312
phantofant: folds 
uht25: folds 
MWCHESS: folds 
Louuuu2k: raises 989 to 1301 and is all-in
NotHereFish: folds 
jcarlos.vale: folds 
Uncalled bet (989) returned to Louuuu2k
Louuuu2k collected 852 from pot
Louuuu2k: doesn't show hand 
*** SUMMARY ***
Total pot 852 | Rake 0 
Seat 1: judith.f folded before Flop (didn't bet)
Seat 2: Burton Feingold folded before Flop (didn't bet)
Seat 3: dow_jones4 folded before Flop (didn't bet)
Seat 4: jcarlos.vale folded before Flop
Seat 5: phantofant folded before Flop (didn't bet)
Seat 6: uht25 folded before Flop (didn't bet)
Seat 7: MWCHESS (button) folded before Flop (didn't bet)
Seat 8: Louuuu2k (small blind) collected (852)
Seat 9: NotHereFish (big blind) folded before Flop



PokerStars Hand #222700285351: Tournament #3099770291, $0.98+$0.12 USD Hold'em No Limit - Level VII (60/120) - 2021/01/16 21:10:14 EET [2021/01/16 14:10:14 ET]
Table '3099770291 62' 9-max Seat #8 is the button
Seat 1: judith.f (6050 in chips) 
Seat 2: Burton Feingold (4704 in chips) 
Seat 3: dow_jones4 (3651 in chips) 
Seat 4: jcarlos.vale (11071 in chips) 
Seat 5: phantofant (2486 in chips) 
Seat 6: uht25 (7942 in chips) 
Seat 7: MWCHESS (3460 in chips) 
Seat 8: Louuuu2k (1841 in chips) 
Seat 9: NotHereFish (7527 in chips) 
judith.f: posts the ante 12
Burton Feingold: posts the ante 12
dow_jones4: posts the ante 12
jcarlos.vale: posts the ante 12
phantofant: posts the ante 12
uht25: posts the ante 12
MWCHESS: posts the ante 12
Louuuu2k: posts the ante 12
NotHereFish: posts the ante 12
NotHereFish: posts small blind 60
judith.f: posts big blind 120
*** HOLE CARDS ***
Dealt to jcarlos.vale [Kd 3d]
Burton Feingold: folds 
dow_jones4: folds 
jcarlos.vale: folds 
phantofant: folds 
uht25: raises 144 to 264
MWCHESS: folds 
Louuuu2k: folds 
NotHereFish: folds 
judith.f: calls 144
*** FLOP *** [6s Qc 5h]
judith.f: checks 
uht25: bets 464
judith.f: calls 464
*** TURN *** [6s Qc 5h] [Ks]
judith.f: checks 
uht25: bets 540
judith.f: folds 
Uncalled bet (540) returned to uht25
uht25 collected 1624 from pot
uht25: doesn't show hand 
*** SUMMARY ***
Total pot 1624 | Rake 0 
Board [6s Qc 5h Ks]
Seat 1: judith.f (big blind) folded on the Turn
Seat 2: Burton Feingold folded before Flop (didn't bet)
Seat 3: dow_jones4 folded before Flop (didn't bet)
Seat 4: jcarlos.vale folded before Flop (didn't bet)
Seat 5: phantofant folded before Flop (didn't bet)
Seat 6: uht25 collected (1624)
Seat 7: MWCHESS folded before Flop (didn't bet)
Seat 8: Louuuu2k (button) folded before Flop (didn't bet)
Seat 9: NotHereFish (small blind) folded before Flop



PokerStars Hand #222700322749: Tournament #3099770291, $0.98+$0.12 USD Hold'em No Limit - Level VII (60/120) - 2021/01/16 21:10:57 EET [2021/01/16 14:10:57 ET]
Table '3099770291 62' 9-max Seat #9 is the button
Seat 1: judith.f (5310 in chips) 
Seat 2: Burton Feingold (4692 in chips) 
Seat 3: dow_jones4 (3639 in chips) 
Seat 4: jcarlos.vale (11059 in chips) 
Seat 5: phantofant (2474 in chips) 
Seat 6: uht25 (8826 in chips) 
Seat 7: MWCHESS (3448 in chips) 
Seat 8: Louuuu2k (1829 in chips) 
Seat 9: NotHereFish (7455 in chips) 
judith.f: posts the ante 12
Burton Feingold: posts the ante 12
dow_jones4: posts the ante 12
jcarlos.vale: posts the ante 12
phantofant: posts the ante 12
uht25: posts the ante 12
MWCHESS: posts the ante 12
Louuuu2k: posts the ante 12
NotHereFish: posts the ante 12
judith.f: posts small blind 60
Burton Feingold: posts big blind 120
*** HOLE CARDS ***
Dealt to jcarlos.vale [3d 9c]
dow_jones4: folds 
jcarlos.vale: folds 
phantofant: folds 
uht25: folds 
MWCHESS: folds 
Louuuu2k: folds 
NotHereFish: folds 
judith.f: raises 156 to 276
Burton Feingold: folds 
Uncalled bet (156) returned to judith.f
judith.f collected 348 from pot
judith.f: doesn't show hand 
*** SUMMARY ***
Total pot 348 | Rake 0 
Seat 1: judith.f (small blind) collected (348)
Seat 2: Burton Feingold (big blind) folded before Flop
Seat 3: dow_jones4 folded before Flop (didn't bet)
Seat 4: jcarlos.vale folded before Flop (didn't bet)
Seat 5: phantofant folded before Flop (didn't bet)
Seat 6: uht25 folded before Flop (didn't bet)
Seat 7: MWCHESS folded before Flop (didn't bet)
Seat 8: Louuuu2k folded before Flop (didn't bet)
Seat 9: NotHereFish (button) folded before Flop (didn't bet)



PokerStars Hand #222700342502: Tournament #3099770291, $0.98+$0.12 USD Hold'em No Limit - Level VII (60/120) - 2021/01/16 21:11:20 EET [2021/01/16 14:11:20 ET]
Table '3099770291 62' 9-max Seat #1 is the button
Seat 1: judith.f (5526 in chips) 
Seat 2: Burton Feingold (4560 in chips) 
Seat 3: dow_jones4 (3627 in chips) 
Seat 4: jcarlos.vale (11047 in chips) 
Seat 5: phantofant (2462 in chips) 
Seat 6: uht25 (8814 in chips) 
Seat 7: MWCHESS (3436 in chips) 
Seat 8: Louuuu2k (1817 in chips) 
Seat 9: NotHereFish (7443 in chips) 
judith.f: posts the ante 12
Burton Feingold: posts the ante 12
dow_jones4: posts the ante 12
jcarlos.vale: posts the ante 12
phantofant: posts the ante 12
uht25: posts the ante 12
MWCHESS: posts the ante 12
Louuuu2k: posts the ante 12
NotHereFish: posts the ante 12
Burton Feingold: posts small blind 60
dow_jones4: posts big blind 120
*** HOLE CARDS ***
Dealt to jcarlos.vale [3c 7d]
jcarlos.vale: folds 
phantofant: folds 
uht25: folds 
MWCHESS: folds 
Louuuu2k: folds 
NotHereFish: folds 
judith.f: raises 156 to 276
Burton Feingold: calls 216
dow_jones4: folds 
*** FLOP *** [Ac 4c 2s]
Burton Feingold: bets 390
judith.f: folds 
Uncalled bet (390) returned to Burton Feingold
Burton Feingold collected 780 from pot
Burton Feingold: doesn't show hand 
*** SUMMARY ***
Total pot 780 | Rake 0 
Board [Ac 4c 2s]
Seat 1: judith.f (button) folded on the Flop
Seat 2: Burton Feingold (small blind) collected (780)
Seat 3: dow_jones4 (big blind) folded before Flop
Seat 4: jcarlos.vale folded before Flop (didn't bet)
Seat 5: phantofant folded before Flop (didn't bet)
Seat 6: uht25 folded before Flop (didn't bet)
Seat 7: MWCHESS folded before Flop (didn't bet)
Seat 8: Louuuu2k folded before Flop (didn't bet)
Seat 9: NotHereFish folded before Flop (didn't bet)



PokerStars Hand #222700368909: Tournament #3099770291, $0.98+$0.12 USD Hold'em No Limit - Level VII (60/120) - 2021/01/16 21:11:51 EET [2021/01/16 14:11:51 ET]
Table '3099770291 62' 9-max Seat #2 is the button
Seat 1: judith.f (5238 in chips) 
Seat 2: Burton Feingold (5052 in chips) 
Seat 3: dow_jones4 (3495 in chips) 
Seat 4: jcarlos.vale (11035 in chips) 
Seat 5: phantofant (2450 in chips) 
Seat 6: uht25 (8802 in chips) 
Seat 7: MWCHESS (3424 in chips) 
Seat 8: Louuuu2k (1805 in chips) 
Seat 9: NotHereFish (7431 in chips) 
judith.f: posts the ante 12
Burton Feingold: posts the ante 12
dow_jones4: posts the ante 12
jcarlos.vale: posts the ante 12
phantofant: posts the ante 12
uht25: posts the ante 12
MWCHESS: posts the ante 12
Louuuu2k: posts the ante 12
NotHereFish: posts the ante 12
dow_jones4: posts small blind 60
jcarlos.vale: posts big blind 120
*** HOLE CARDS ***
Dealt to jcarlos.vale [5c 9d]
phantofant: calls 120
uht25: folds 
MWCHESS: folds 
Louuuu2k: folds 
NotHereFish: raises 300 to 420
judith.f: calls 420
Burton Feingold: folds 
dow_jones4 is disconnected 
dow_jones4 has timed out while disconnected
dow_jones4: folds 
dow_jones4 is sitting out
jcarlos.vale: folds 
phantofant: calls 300
*** FLOP *** [As 6s Ah]
phantofant: bets 360
NotHereFish: folds 
judith.f: folds 
Uncalled bet (360) returned to phantofant
phantofant collected 1548 from pot
phantofant: doesn't show hand 
*** SUMMARY ***
Total pot 1548 | Rake 0 
Board [As 6s Ah]
Seat 1: judith.f folded on the Flop
Seat 2: Burton Feingold (button) folded before Flop (didn't bet)
Seat 3: dow_jones4 (small blind) folded before Flop
Seat 4: jcarlos.vale (big blind) folded before Flop
Seat 5: phantofant collected (1548)
Seat 6: uht25 folded before Flop (didn't bet)
Seat 7: MWCHESS folded before Flop (didn't bet)
Seat 8: Louuuu2k folded before Flop (didn't bet)
Seat 9: NotHereFish folded on the Flop



PokerStars Hand #222700423082: Tournament #3099770291, $0.98+$0.12 USD Hold'em No Limit - Level VII (60/120) - 2021/01/16 21:12:53 EET [2021/01/16 14:12:53 ET]
Table '3099770291 62' 9-max Seat #3 is the button
Seat 1: judith.f (4806 in chips) 
Seat 2: Burton Feingold (5040 in chips) 
Seat 3: dow_jones4 (3423 in chips) is sitting out
Seat 4: jcarlos.vale (10903 in chips) 
Seat 5: phantofant (3566 in chips) 
Seat 6: uht25 (8790 in chips) 
Seat 7: MWCHESS (3412 in chips) 
Seat 8: Louuuu2k (1793 in chips) 
Seat 9: NotHereFish (6999 in chips) 
judith.f: posts the ante 12
Burton Feingold: posts the ante 12
dow_jones4: posts the ante 12
jcarlos.vale: posts the ante 12
phantofant: posts the ante 12
uht25: posts the ante 12
MWCHESS: posts the ante 12
Louuuu2k: posts the ante 12
NotHereFish: posts the ante 12
jcarlos.vale: posts small blind 60
phantofant: posts big blind 120
*** HOLE CARDS ***
Dealt to jcarlos.vale [2s 2h]
uht25: folds 
MWCHESS: folds 
Louuuu2k: raises 1661 to 1781 and is all-in
NotHereFish: calls 1781
judith.f: folds 
Burton Feingold: folds 
dow_jones4: folds 
jcarlos.vale: folds 
phantofant: folds 
*** FLOP *** [5d 8h 9s]
*** TURN *** [5d 8h 9s] [8s]
*** RIVER *** [5d 8h 9s 8s] [4d]
*** SHOW DOWN ***
Louuuu2k: shows [7s 7c] (two pair, Eights and Sevens)
NotHereFish: shows [Qd Jd] (a pair of Eights)
Louuuu2k collected 3850 from pot
*** SUMMARY ***
Total pot 3850 | Rake 0 
Board [5d 8h 9s 8s 4d]
Seat 1: judith.f folded before Flop (didn't bet)
Seat 2: Burton Feingold folded before Flop (didn't bet)
Seat 3: dow_jones4 (button) folded before Flop (didn't bet)
Seat 4: jcarlos.vale (small blind) folded before Flop
Seat 5: phantofant (big blind) folded before Flop
Seat 6: uht25 folded before Flop (didn't bet)
Seat 7: MWCHESS folded before Flop (didn't bet)
Seat 8: Louuuu2k showed [7s 7c] and won (3850) with two pair, Eights and Sevens
Seat 9: NotHereFish showed [Qd Jd] and lost with a pair of Eights



PokerStars Hand #222700453616: Tournament #3099770291, $0.98+$0.12 USD Hold'em No Limit - Level VII (60/120) - 2021/01/16 21:13:29 EET [2021/01/16 14:13:29 ET]
Table '3099770291 62' 9-max Seat #4 is the button
Seat 1: judith.f (4794 in chips) 
Seat 2: Burton Feingold (5028 in chips) 
Seat 3: dow_jones4 (3411 in chips) is sitting out
Seat 4: jcarlos.vale (10831 in chips) 
Seat 5: phantofant (3434 in chips) 
Seat 6: uht25 (8778 in chips) 
Seat 7: MWCHESS (3400 in chips) 
Seat 8: Louuuu2k (3850 in chips) 
Seat 9: NotHereFish (5206 in chips) 
judith.f: posts the ante 12
Burton Feingold: posts the ante 12
dow_jones4: posts the ante 12
jcarlos.vale: posts the ante 12
phantofant: posts the ante 12
uht25: posts the ante 12
MWCHESS: posts the ante 12
Louuuu2k: posts the ante 12
NotHereFish: posts the ante 12
phantofant: posts small blind 60
uht25: posts big blind 120
*** HOLE CARDS ***
Dealt to jcarlos.vale [7c Ac]
MWCHESS: folds 
Louuuu2k: folds 
NotHereFish: raises 120 to 240
judith.f: folds 
Burton Feingold: calls 240
dow_jones4: folds 
jcarlos.vale: folds 
phantofant: calls 180
uht25: calls 120
*** FLOP *** [7s 2d As]
phantofant: bets 120
uht25: folds 
NotHereFish: calls 120
Burton Feingold: folds 
*** TURN *** [7s 2d As] [4h]
phantofant: bets 360
NotHereFish: folds 
Uncalled bet (360) returned to phantofant
phantofant collected 1308 from pot
phantofant: doesn't show hand 
*** SUMMARY ***
Total pot 1308 | Rake 0 
Board [7s 2d As 4h]
Seat 1: judith.f folded before Flop (didn't bet)
Seat 2: Burton Feingold folded on the Flop
Seat 3: dow_jones4 folded before Flop (didn't bet)
Seat 4: jcarlos.vale (button) folded before Flop (didn't bet)
Seat 5: phantofant (small blind) collected (1308)
Seat 6: uht25 (big blind) folded on the Flop
Seat 7: MWCHESS folded before Flop (didn't bet)
Seat 8: Louuuu2k folded before Flop (didn't bet)
Seat 9: NotHereFish folded on the Turn



PokerStars Hand #222700518123: Tournament #3099770291, $0.98+$0.12 USD Hold'em No Limit - Level VII (60/120) - 2021/01/16 21:14:43 EET [2021/01/16 14:14:43 ET]
Table '3099770291 62' 9-max Seat #5 is the button
Seat 1: judith.f (4782 in chips) 
Seat 2: Burton Feingold (4776 in chips) 
Seat 3: dow_jones4 (3399 in chips) is sitting out
Seat 4: jcarlos.vale (10819 in chips) 
Seat 5: phantofant (4370 in chips) 
Seat 6: uht25 (8526 in chips) 
Seat 7: MWCHESS (3388 in chips) 
Seat 8: Louuuu2k (3838 in chips) 
Seat 9: NotHereFish (4834 in chips) 
judith.f: posts the ante 12
Burton Feingold: posts the ante 12
dow_jones4: posts the ante 12
jcarlos.vale: posts the ante 12
phantofant: posts the ante 12
uht25: posts the ante 12
MWCHESS: posts the ante 12
Louuuu2k: posts the ante 12
NotHereFish: posts the ante 12
uht25: posts small blind 60
MWCHESS: posts big blind 120
*** HOLE CARDS ***
Dealt to jcarlos.vale [5d Qh]
Louuuu2k: folds 
NotHereFish: folds 
judith.f: raises 156 to 276
Burton Feingold: folds 
dow_jones4: folds 
jcarlos.vale: folds 
phantofant: calls 276
uht25: folds 
MWCHESS: calls 156
*** FLOP *** [3h Jc Ks]
dow_jones4 has returned
MWCHESS: checks 
judith.f: bets 720
phantofant: folds 
MWCHESS: folds 
Uncalled bet (720) returned to judith.f
judith.f collected 996 from pot
judith.f: doesn't show hand 
*** SUMMARY ***
Total pot 996 | Rake 0 
Board [3h Jc Ks]
Seat 1: judith.f collected (996)
Seat 2: Burton Feingold folded before Flop (didn't bet)
Seat 3: dow_jones4 folded before Flop (didn't bet)
Seat 4: jcarlos.vale folded before Flop (didn't bet)
Seat 5: phantofant (button) folded on the Flop
Seat 6: uht25 (small blind) folded before Flop
Seat 7: MWCHESS (big blind) folded on the Flop
Seat 8: Louuuu2k folded before Flop (didn't bet)
Seat 9: NotHereFish folded before Flop (didn't bet)



PokerStars Hand #222700556085: Tournament #3099770291, $0.98+$0.12 USD Hold'em No Limit - Level VII (60/120) - 2021/01/16 21:15:27 EET [2021/01/16 14:15:27 ET]
Table '3099770291 62' 9-max Seat #6 is the button
Seat 1: judith.f (5490 in chips) 
Seat 2: Burton Feingold (4764 in chips) 
Seat 3: dow_jones4 (3387 in chips) 
Seat 4: jcarlos.vale (10807 in chips) 
Seat 5: phantofant (4082 in chips) 
Seat 6: uht25 (8454 in chips) 
Seat 7: MWCHESS (3100 in chips) 
Seat 8: Louuuu2k (3826 in chips) 
Seat 9: NotHereFish (4822 in chips) 
judith.f: posts the ante 12
Burton Feingold: posts the ante 12
dow_jones4: posts the ante 12
jcarlos.vale: posts the ante 12
phantofant: posts the ante 12
uht25: posts the ante 12
MWCHESS: posts the ante 12
Louuuu2k: posts the ante 12
NotHereFish: posts the ante 12
MWCHESS: posts small blind 60
Louuuu2k: posts big blind 120
*** HOLE CARDS ***
Dealt to jcarlos.vale [Qc 6c]
NotHereFish: folds 
judith.f: folds 
Burton Feingold: folds 
dow_jones4: folds 
jcarlos.vale: folds 
phantofant: calls 120
uht25: folds 
MWCHESS: folds 
Louuuu2k: raises 480 to 600
phantofant: calls 480
*** FLOP *** [2c 6s 7s]
Louuuu2k: bets 451
phantofant: folds 
Uncalled bet (451) returned to Louuuu2k
Louuuu2k collected 1368 from pot
Louuuu2k: doesn't show hand 
*** SUMMARY ***
Total pot 1368 | Rake 0 
Board [2c 6s 7s]
Seat 1: judith.f folded before Flop (didn't bet)
Seat 2: Burton Feingold folded before Flop (didn't bet)
Seat 3: dow_jones4 folded before Flop (didn't bet)
Seat 4: jcarlos.vale folded before Flop (didn't bet)
Seat 5: phantofant folded on the Flop
Seat 6: uht25 (button) folded before Flop (didn't bet)
Seat 7: MWCHESS (small blind) folded before Flop
Seat 8: Louuuu2k (big blind) collected (1368)
Seat 9: NotHereFish folded before Flop (didn't bet)



PokerStars Hand #222700597153: Tournament #3099770291, $0.98+$0.12 USD Hold'em No Limit - Level VII (60/120) - 2021/01/16 21:16:14 EET [2021/01/16 14:16:14 ET]
Table '3099770291 62' 9-max Seat #7 is the button
Seat 1: judith.f (5478 in chips) 
Seat 2: Burton Feingold (4752 in chips) 
Seat 3: dow_jones4 (3375 in chips) 
Seat 4: jcarlos.vale (10795 in chips) 
Seat 5: phantofant (3470 in chips) 
Seat 6: uht25 (8442 in chips) 
Seat 7: MWCHESS (3028 in chips) 
Seat 8: Louuuu2k (4582 in chips) 
Seat 9: NotHereFish (4810 in chips) 
judith.f: posts the ante 12
Burton Feingold: posts the ante 12
dow_jones4: posts the ante 12
jcarlos.vale: posts the ante 12
phantofant: posts the ante 12
uht25: posts the ante 12
MWCHESS: posts the ante 12
Louuuu2k: posts the ante 12
NotHereFish: posts the ante 12
Louuuu2k: posts small blind 60
NotHereFish: posts big blind 120
*** HOLE CARDS ***
Dealt to jcarlos.vale [9s Qs]
judith.f: folds 
Burton Feingold: calls 120
dow_jones4: folds 
jcarlos.vale: calls 120
phantofant: folds 
uht25: folds 
MWCHESS: folds 
Louuuu2k: folds 
NotHereFish: raises 600 to 720
Burton Feingold: calls 600
jcarlos.vale: folds 
*** FLOP *** [5c 2h Td]
NotHereFish: bets 600
Burton Feingold: folds 
Uncalled bet (600) returned to NotHereFish
NotHereFish collected 1728 from pot
NotHereFish: doesn't show hand 
*** SUMMARY ***
Total pot 1728 | Rake 0 
Board [5c 2h Td]
Seat 1: judith.f folded before Flop (didn't bet)
Seat 2: Burton Feingold folded on the Flop
Seat 3: dow_jones4 folded before Flop (didn't bet)
Seat 4: jcarlos.vale folded before Flop
Seat 5: phantofant folded before Flop (didn't bet)
Seat 6: uht25 folded before Flop (didn't bet)
Seat 7: MWCHESS (button) folded before Flop (didn't bet)
Seat 8: Louuuu2k (small blind) folded before Flop
Seat 9: NotHereFish (big blind) collected (1728)



PokerStars Hand #222700650504: Tournament #3099770291, $0.98+$0.12 USD Hold'em No Limit - Level VII (60/120) - 2021/01/16 21:17:16 EET [2021/01/16 14:17:16 ET]
Table '3099770291 62' 9-max Seat #8 is the button
Seat 1: judith.f (5466 in chips) 
Seat 2: Burton Feingold (4020 in chips) 
Seat 3: dow_jones4 (3363 in chips) 
Seat 4: jcarlos.vale (10663 in chips) 
Seat 5: phantofant (3458 in chips) 
Seat 6: uht25 (8430 in chips) 
Seat 7: MWCHESS (3016 in chips) 
Seat 8: Louuuu2k (4510 in chips) 
Seat 9: NotHereFish (5806 in chips) 
judith.f: posts the ante 12
Burton Feingold: posts the ante 12
dow_jones4: posts the ante 12
jcarlos.vale: posts the ante 12
phantofant: posts the ante 12
uht25: posts the ante 12
MWCHESS: posts the ante 12
Louuuu2k: posts the ante 12
NotHereFish: posts the ante 12
NotHereFish: posts small blind 60
judith.f: posts big blind 120
*** HOLE CARDS ***
Dealt to jcarlos.vale [3c Ts]
Burton Feingold: raises 120 to 240
dow_jones4: folds 
jcarlos.vale: folds 
phantofant: folds 
uht25: folds 
MWCHESS: calls 240
Louuuu2k: folds 
NotHereFish: folds 
judith.f: folds 
*** FLOP *** [3h 2d Ah]
Burton Feingold: bets 384
MWCHESS: calls 384
*** TURN *** [3h 2d Ah] [2c]
Burton Feingold: bets 480
MWCHESS: calls 480
*** RIVER *** [3h 2d Ah 2c] [6h]
Burton Feingold: checks 
MWCHESS: checks 
*** SHOW DOWN ***
Burton Feingold: shows [Td Tc] (two pair, Tens and Deuces)
MWCHESS: shows [Ac 4c] (two pair, Aces and Deuces)
MWCHESS collected 2496 from pot
*** SUMMARY ***
Total pot 2496 | Rake 0 
Board [3h 2d Ah 2c 6h]
Seat 1: judith.f (big blind) folded before Flop
Seat 2: Burton Feingold showed [Td Tc] and lost with two pair, Tens and Deuces
Seat 3: dow_jones4 folded before Flop (didn't bet)
Seat 4: jcarlos.vale folded before Flop (didn't bet)
Seat 5: phantofant folded before Flop (didn't bet)
Seat 6: uht25 folded before Flop (didn't bet)
Seat 7: MWCHESS showed [Ac 4c] and won (2496) with two pair, Aces and Deuces
Seat 8: Louuuu2k (button) folded before Flop (didn't bet)
Seat 9: NotHereFish (small blind) folded before Flop



PokerStars Hand #222700708888: Tournament #3099770291, $0.98+$0.12 USD Hold'em No Limit - Level VIII (75/150) - 2021/01/16 21:18:23 EET [2021/01/16 14:18:23 ET]
Table '3099770291 62' 9-max Seat #9 is the button
Seat 1: judith.f (5334 in chips) 
Seat 2: Burton Feingold (2904 in chips) 
Seat 3: dow_jones4 (3351 in chips) 
Seat 4: jcarlos.vale (10651 in chips) 
Seat 5: phantofant (3446 in chips) 
Seat 6: uht25 (8418 in chips) 
Seat 7: MWCHESS (4396 in chips) 
Seat 8: Louuuu2k (4498 in chips) 
Seat 9: NotHereFish (5734 in chips) 
judith.f: posts the ante 15
Burton Feingold: posts the ante 15
dow_jones4: posts the ante 15
jcarlos.vale: posts the ante 15
phantofant: posts the ante 15
uht25: posts the ante 15
MWCHESS: posts the ante 15
Louuuu2k: posts the ante 15
NotHereFish: posts the ante 15
judith.f: posts small blind 75
Burton Feingold: posts big blind 150
*** HOLE CARDS ***
Dealt to jcarlos.vale [4s 7d]
dow_jones4 is disconnected 
dow_jones4 has timed out while disconnected
dow_jones4: folds 
dow_jones4 is sitting out
jcarlos.vale: folds 
phantofant: calls 150
uht25: folds 
MWCHESS: folds 
Louuuu2k: folds 
NotHereFish: folds 
judith.f: folds 
Burton Feingold: checks 
*** FLOP *** [9d 2c 2d]
Burton Feingold: bets 510
phantofant: folds 
Uncalled bet (510) returned to Burton Feingold
Burton Feingold collected 510 from pot
Burton Feingold: doesn't show hand 
*** SUMMARY ***
Total pot 510 | Rake 0 
Board [9d 2c 2d]
Seat 1: judith.f (small blind) folded before Flop
Seat 2: Burton Feingold (big blind) collected (510)
Seat 3: dow_jones4 folded before Flop (didn't bet)
Seat 4: jcarlos.vale folded before Flop (didn't bet)
Seat 5: phantofant folded on the Flop
Seat 6: uht25 folded before Flop (didn't bet)
Seat 7: MWCHESS folded before Flop (didn't bet)
Seat 8: Louuuu2k folded before Flop (didn't bet)
Seat 9: NotHereFish (button) folded before Flop (didn't bet)



PokerStars Hand #222700736034: Tournament #3099770291, $0.98+$0.12 USD Hold'em No Limit - Level VIII (75/150) - 2021/01/16 21:18:55 EET [2021/01/16 14:18:55 ET]
Table '3099770291 62' 9-max Seat #1 is the button
Seat 1: judith.f (5244 in chips) 
Seat 2: Burton Feingold (3249 in chips) 
Seat 3: dow_jones4 (3336 in chips) is sitting out
Seat 4: jcarlos.vale (10636 in chips) 
Seat 5: phantofant (3281 in chips) 
Seat 6: uht25 (8403 in chips) 
Seat 7: MWCHESS (4381 in chips) 
Seat 8: Louuuu2k (4483 in chips) 
Seat 9: NotHereFish (5719 in chips) 
judith.f: posts the ante 15
Burton Feingold: posts the ante 15
dow_jones4: posts the ante 15
jcarlos.vale: posts the ante 15
phantofant: posts the ante 15
uht25: posts the ante 15
MWCHESS: posts the ante 15
Louuuu2k: posts the ante 15
NotHereFish: posts the ante 15
Burton Feingold: posts small blind 75
dow_jones4: posts big blind 150
*** HOLE CARDS ***
Dealt to jcarlos.vale [3c 4d]
jcarlos.vale: folds 
phantofant: calls 150
uht25: folds 
MWCHESS: folds 
dow_jones4 is disconnected 
Louuuu2k: raises 375 to 525
NotHereFish: folds 
judith.f: folds 
Burton Feingold: folds 
dow_jones4: folds 
phantofant: calls 375
*** FLOP *** [Js 2d 6c]
phantofant: checks 
Louuuu2k: bets 465
phantofant: folds 
Uncalled bet (465) returned to Louuuu2k
Louuuu2k collected 1410 from pot
Louuuu2k: doesn't show hand 
*** SUMMARY ***
Total pot 1410 | Rake 0 
Board [Js 2d 6c]
Seat 1: judith.f (button) folded before Flop (didn't bet)
Seat 2: Burton Feingold (small blind) folded before Flop
Seat 3: dow_jones4 (big blind) folded before Flop
Seat 4: jcarlos.vale folded before Flop (didn't bet)
Seat 5: phantofant folded on the Flop
Seat 6: uht25 folded before Flop (didn't bet)
Seat 7: MWCHESS folded before Flop (didn't bet)
Seat 8: Louuuu2k collected (1410)
Seat 9: NotHereFish folded before Flop (didn't bet)



PokerStars Hand #222700771466: Tournament #3099770291, $0.98+$0.12 USD Hold'em No Limit - Level VIII (75/150) - 2021/01/16 21:19:36 EET [2021/01/16 14:19:36 ET]
Table '3099770291 62' 9-max Seat #2 is the button
Seat 1: judith.f (5229 in chips) 
Seat 2: Burton Feingold (3159 in chips) 
Seat 3: dow_jones4 (3171 in chips) is sitting out
Seat 4: jcarlos.vale (10621 in chips) 
Seat 5: phantofant (2741 in chips) 
Seat 6: uht25 (8388 in chips) 
Seat 7: MWCHESS (4366 in chips) 
Seat 8: Louuuu2k (5353 in chips) 
Seat 9: NotHereFish (5704 in chips) 
judith.f: posts the ante 15
Burton Feingold: posts the ante 15
dow_jones4: posts the ante 15
jcarlos.vale: posts the ante 15
phantofant: posts the ante 15
uht25: posts the ante 15
MWCHESS: posts the ante 15
Louuuu2k: posts the ante 15
NotHereFish: posts the ante 15
dow_jones4: posts small blind 75
jcarlos.vale: posts big blind 150
*** HOLE CARDS ***
Dealt to jcarlos.vale [2d 7s]
phantofant: folds 
uht25: raises 180 to 330
MWCHESS: folds 
Louuuu2k: folds 
NotHereFish: folds 
judith.f: folds 
Burton Feingold: folds 
dow_jones4: folds 
jcarlos.vale: folds 
Uncalled bet (180) returned to uht25
uht25 collected 510 from pot
uht25: doesn't show hand 
*** SUMMARY ***
Total pot 510 | Rake 0 
Seat 1: judith.f folded before Flop (didn't bet)
Seat 2: Burton Feingold (button) folded before Flop (didn't bet)
Seat 3: dow_jones4 (small blind) folded before Flop
Seat 4: jcarlos.vale (big blind) folded before Flop
Seat 5: phantofant folded before Flop (didn't bet)
Seat 6: uht25 collected (510)
Seat 7: MWCHESS folded before Flop (didn't bet)
Seat 8: Louuuu2k folded before Flop (didn't bet)
Seat 9: NotHereFish folded before Flop (didn't bet)



PokerStars Hand #222700796673: Tournament #3099770291, $0.98+$0.12 USD Hold'em No Limit - Level VIII (75/150) - 2021/01/16 21:20:05 EET [2021/01/16 14:20:05 ET]
Table '3099770291 62' 9-max Seat #3 is the button
Seat 1: judith.f (5214 in chips) 
Seat 2: Burton Feingold (3144 in chips) 
Seat 3: dow_jones4 (3081 in chips) is sitting out
Seat 4: jcarlos.vale (10456 in chips) 
Seat 5: phantofant (2726 in chips) 
Seat 6: uht25 (8733 in chips) 
Seat 7: MWCHESS (4351 in chips) 
Seat 8: Louuuu2k (5338 in chips) 
Seat 9: NotHereFish (5689 in chips) 
judith.f: posts the ante 15
Burton Feingold: posts the ante 15
dow_jones4: posts the ante 15
jcarlos.vale: posts the ante 15
phantofant: posts the ante 15
uht25: posts the ante 15
MWCHESS: posts the ante 15
Louuuu2k: posts the ante 15
NotHereFish: posts the ante 15
jcarlos.vale: posts small blind 75
phantofant: posts big blind 150
*** HOLE CARDS ***
Dealt to jcarlos.vale [2h 2c]
uht25: folds 
MWCHESS: folds 
Louuuu2k: folds 
NotHereFish: folds 
judith.f: folds 
Burton Feingold: raises 150 to 300
dow_jones4: folds 
jcarlos.vale: folds 
phantofant: calls 150
*** FLOP *** [Qh Qs Jc]
phantofant: checks 
Burton Feingold: bets 405
phantofant: folds 
Uncalled bet (405) returned to Burton Feingold
Burton Feingold collected 810 from pot
Burton Feingold: doesn't show hand 
*** SUMMARY ***
Total pot 810 | Rake 0 
Board [Qh Qs Jc]
Seat 1: judith.f folded before Flop (didn't bet)
Seat 2: Burton Feingold collected (810)
Seat 3: dow_jones4 (button) folded before Flop (didn't bet)
Seat 4: jcarlos.vale (small blind) folded before Flop
Seat 5: phantofant (big blind) folded on the Flop
Seat 6: uht25 folded before Flop (didn't bet)
Seat 7: MWCHESS folded before Flop (didn't bet)
Seat 8: Louuuu2k folded before Flop (didn't bet)
Seat 9: NotHereFish folded before Flop (didn't bet)



PokerStars Hand #222700830993: Tournament #3099770291, $0.98+$0.12 USD Hold'em No Limit - Level VIII (75/150) - 2021/01/16 21:20:45 EET [2021/01/16 14:20:45 ET]
Table '3099770291 62' 9-max Seat #4 is the button
Seat 1: judith.f (5199 in chips) 
Seat 2: Burton Feingold (3639 in chips) 
Seat 3: dow_jones4 (3066 in chips) is sitting out
Seat 4: jcarlos.vale (10366 in chips) 
Seat 5: phantofant (2411 in chips) 
Seat 6: uht25 (8718 in chips) 
Seat 7: MWCHESS (4336 in chips) 
Seat 8: Louuuu2k (5323 in chips) 
Seat 9: NotHereFish (5674 in chips) 
judith.f: posts the ante 15
Burton Feingold: posts the ante 15
dow_jones4: posts the ante 15
jcarlos.vale: posts the ante 15
phantofant: posts the ante 15
uht25: posts the ante 15
MWCHESS: posts the ante 15
Louuuu2k: posts the ante 15
NotHereFish: posts the ante 15
phantofant: posts small blind 75
uht25: posts big blind 150
*** HOLE CARDS ***
Dealt to jcarlos.vale [Ad 2s]
MWCHESS: folds 
Louuuu2k: folds 
NotHereFish: folds 
judith.f: folds 
Burton Feingold: folds 
dow_jones4: folds 
jcarlos.vale: folds 
phantofant: folds 
Uncalled bet (75) returned to uht25
uht25 collected 285 from pot
uht25: doesn't show hand 
*** SUMMARY ***
Total pot 285 | Rake 0 
Seat 1: judith.f folded before Flop (didn't bet)
Seat 2: Burton Feingold folded before Flop (didn't bet)
Seat 3: dow_jones4 folded before Flop (didn't bet)
Seat 4: jcarlos.vale (button) folded before Flop (didn't bet)
Seat 5: phantofant (small blind) folded before Flop
Seat 6: uht25 (big blind) collected (285)
Seat 7: MWCHESS folded before Flop (didn't bet)
Seat 8: Louuuu2k folded before Flop (didn't bet)
Seat 9: NotHereFish folded before Flop (didn't bet)



PokerStars Hand #222700844463: Tournament #3099770291, $0.98+$0.12 USD Hold'em No Limit - Level VIII (75/150) - 2021/01/16 21:21:01 EET [2021/01/16 14:21:01 ET]
Table '3099770291 62' 9-max Seat #5 is the button
Seat 1: judith.f (5184 in chips) 
Seat 2: Burton Feingold (3624 in chips) 
Seat 3: dow_jones4 (3051 in chips) is sitting out
Seat 4: jcarlos.vale (10351 in chips) 
Seat 5: phantofant (2321 in chips) 
Seat 6: uht25 (8913 in chips) 
Seat 7: MWCHESS (4321 in chips) 
Seat 8: Louuuu2k (5308 in chips) 
Seat 9: NotHereFish (5659 in chips) 
judith.f: posts the ante 15
Burton Feingold: posts the ante 15
dow_jones4: posts the ante 15
jcarlos.vale: posts the ante 15
phantofant: posts the ante 15
uht25: posts the ante 15
MWCHESS: posts the ante 15
Louuuu2k: posts the ante 15
NotHereFish: posts the ante 15
uht25: posts small blind 75
MWCHESS: posts big blind 150
*** HOLE CARDS ***
Dealt to jcarlos.vale [Jh As]
Louuuu2k: folds 
NotHereFish: folds 
judith.f: folds 
Burton Feingold: raises 150 to 300
dow_jones4: folds 
jcarlos.vale: calls 300
phantofant: folds 
dow_jones4 has returned
uht25: folds 
MWCHESS: calls 150
*** FLOP *** [6s 9d 8s]
MWCHESS: checks 
Burton Feingold: bets 555
jcarlos.vale: folds 
MWCHESS: folds 
Uncalled bet (555) returned to Burton Feingold
Burton Feingold collected 1110 from pot
Burton Feingold: doesn't show hand 
*** SUMMARY ***
Total pot 1110 | Rake 0 
Board [6s 9d 8s]
Seat 1: judith.f folded before Flop (didn't bet)
Seat 2: Burton Feingold collected (1110)
Seat 3: dow_jones4 folded before Flop (didn't bet)
Seat 4: jcarlos.vale folded on the Flop
Seat 5: phantofant (button) folded before Flop (didn't bet)
Seat 6: uht25 (small blind) folded before Flop
Seat 7: MWCHESS (big blind) folded on the Flop
Seat 8: Louuuu2k folded before Flop (didn't bet)
Seat 9: NotHereFish folded before Flop (didn't bet)



PokerStars Hand #222700872672: Tournament #3099770291, $0.98+$0.12 USD Hold'em No Limit - Level VIII (75/150) - 2021/01/16 21:21:34 EET [2021/01/16 14:21:34 ET]
Table '3099770291 62' 9-max Seat #6 is the button
Seat 1: judith.f (5169 in chips) 
Seat 2: Burton Feingold (4419 in chips) 
Seat 3: dow_jones4 (3036 in chips) 
Seat 4: jcarlos.vale (10036 in chips) 
Seat 5: phantofant (2306 in chips) 
Seat 6: uht25 (8823 in chips) 
Seat 7: MWCHESS (4006 in chips) 
Seat 8: Louuuu2k (5293 in chips) 
Seat 9: NotHereFish (5644 in chips) 
judith.f: posts the ante 15
Burton Feingold: posts the ante 15
dow_jones4: posts the ante 15
jcarlos.vale: posts the ante 15
phantofant: posts the ante 15
uht25: posts the ante 15
MWCHESS: posts the ante 15
Louuuu2k: posts the ante 15
NotHereFish: posts the ante 15
MWCHESS: posts small blind 75
Louuuu2k: posts big blind 150
*** HOLE CARDS ***
Dealt to jcarlos.vale [Jc 5s]
NotHereFish: raises 150 to 300
dow_jones4 is disconnected 
judith.f: folds 
Burton Feingold: folds 
dow_jones4 is connected 
dow_jones4: folds 
jcarlos.vale: folds 
phantofant: calls 300
uht25: folds 
MWCHESS: folds 
Louuuu2k: folds 
*** FLOP *** [Js Ac 6s]
NotHereFish: bets 346
phantofant: calls 346
*** TURN *** [Js Ac 6s] [5c]
NotHereFish: checks 
phantofant: checks 
*** RIVER *** [Js Ac 6s 5c] [3h]
NotHereFish: checks 
phantofant: checks 
*** SHOW DOWN ***
NotHereFish: shows [Kc Ks] (a pair of Kings)
phantofant: mucks hand 
NotHereFish collected 1652 from pot
*** SUMMARY ***
Total pot 1652 | Rake 0 
Board [Js Ac 6s 5c 3h]
Seat 1: judith.f folded before Flop (didn't bet)
Seat 2: Burton Feingold folded before Flop (didn't bet)
Seat 3: dow_jones4 folded before Flop (didn't bet)
Seat 4: jcarlos.vale folded before Flop (didn't bet)
Seat 5: phantofant mucked [Kh Th]
Seat 6: uht25 (button) folded before Flop (didn't bet)
Seat 7: MWCHESS (small blind) folded before Flop
Seat 8: Louuuu2k (big blind) folded before Flop
Seat 9: NotHereFish showed [Kc Ks] and won (1652) with a pair of Kings



PokerStars Hand #222700928468: Tournament #3099770291, $0.98+$0.12 USD Hold'em No Limit - Level VIII (75/150) - 2021/01/16 21:22:32 EET [2021/01/16 14:22:32 ET]
Table '3099770291 62' 9-max Seat #7 is the button
Seat 1: judith.f (5154 in chips) 
Seat 2: Burton Feingold (4404 in chips) 
Seat 3: dow_jones4 (3021 in chips) 
Seat 4: jcarlos.vale (10021 in chips) 
Seat 5: phantofant (1645 in chips) 
Seat 6: uht25 (8808 in chips) 
Seat 7: MWCHESS (3916 in chips) 
Seat 8: Louuuu2k (5128 in chips) 
Seat 9: NotHereFish (6635 in chips) 
judith.f: posts the ante 15
Burton Feingold: posts the ante 15
dow_jones4: posts the ante 15
jcarlos.vale: posts the ante 15
phantofant: posts the ante 15
uht25: posts the ante 15
MWCHESS: posts the ante 15
Louuuu2k: posts the ante 15
NotHereFish: posts the ante 15
Louuuu2k: posts small blind 75
NotHereFish: posts big blind 150
*** HOLE CARDS ***
Dealt to jcarlos.vale [6h 6c]
judith.f: folds 
Burton Feingold: folds 
dow_jones4: folds 
jcarlos.vale: raises 240 to 390
phantofant: folds 
uht25: calls 390
MWCHESS: folds 
Louuuu2k: folds 
NotHereFish: folds 
*** FLOP *** [Qd 5c As]
jcarlos.vale: bets 300
uht25: calls 300
*** TURN *** [Qd 5c As] [4d]
jcarlos.vale: checks 
uht25: checks 
*** RIVER *** [Qd 5c As 4d] [Kh]
jcarlos.vale: checks 
uht25: bets 1160
jcarlos.vale: folds 
Uncalled bet (1160) returned to uht25
uht25 collected 1740 from pot
uht25: doesn't show hand 
*** SUMMARY ***
Total pot 1740 | Rake 0 
Board [Qd 5c As 4d Kh]
Seat 1: judith.f folded before Flop (didn't bet)
Seat 2: Burton Feingold folded before Flop (didn't bet)
Seat 3: dow_jones4 folded before Flop (didn't bet)
Seat 4: jcarlos.vale folded on the River
Seat 5: phantofant folded before Flop (didn't bet)
Seat 6: uht25 collected (1740)
Seat 7: MWCHESS (button) folded before Flop (didn't bet)
Seat 8: Louuuu2k (small blind) folded before Flop
Seat 9: NotHereFish (big blind) folded before Flop



PokerStars Hand #222700966724: Tournament #3099770291, $0.98+$0.12 USD Hold'em No Limit - Level VIII (75/150) - 2021/01/16 21:23:17 EET [2021/01/16 14:23:17 ET]
Table '3099770291 62' 9-max Seat #8 is the button
Seat 1: judith.f (5139 in chips) 
Seat 2: Burton Feingold (4389 in chips) 
Seat 3: dow_jones4 (3006 in chips) 
Seat 4: jcarlos.vale (9316 in chips) 
Seat 5: phantofant (1630 in chips) 
Seat 6: uht25 (9843 in chips) 
Seat 7: MWCHESS (3901 in chips) 
Seat 8: Louuuu2k (5038 in chips) 
Seat 9: NotHereFish (6470 in chips) 
judith.f: posts the ante 15
Burton Feingold: posts the ante 15
dow_jones4: posts the ante 15
jcarlos.vale: posts the ante 15
phantofant: posts the ante 15
uht25: posts the ante 15
MWCHESS: posts the ante 15
Louuuu2k: posts the ante 15
NotHereFish: posts the ante 15
NotHereFish: posts small blind 75
judith.f: posts big blind 150
*** HOLE CARDS ***
Dealt to jcarlos.vale [Qc Td]
Burton Feingold: calls 150
dow_jones4: folds 
jcarlos.vale: folds 
phantofant: folds 
uht25: folds 
MWCHESS: folds 
Louuuu2k: folds 
judith.f is disconnected 
NotHereFish: calls 75
judith.f has timed out while disconnected
judith.f: checks 
*** FLOP *** [5c 7h 6d]
NotHereFish: checks 
judith.f has timed out while disconnected
judith.f: checks 
Burton Feingold: bets 300
NotHereFish: folds 
judith.f: folds 
Uncalled bet (300) returned to Burton Feingold
Burton Feingold collected 585 from pot
Burton Feingold: doesn't show hand 
*** SUMMARY ***
Total pot 585 | Rake 0 
Board [5c 7h 6d]
Seat 1: judith.f (big blind) folded on the Flop
Seat 2: Burton Feingold collected (585)
Seat 3: dow_jones4 folded before Flop (didn't bet)
Seat 4: jcarlos.vale folded before Flop (didn't bet)
Seat 5: phantofant folded before Flop (didn't bet)
Seat 6: uht25 folded before Flop (didn't bet)
Seat 7: MWCHESS folded before Flop (didn't bet)
Seat 8: Louuuu2k (button) folded before Flop (didn't bet)
Seat 9: NotHereFish (small blind) folded on the Flop



PokerStars Hand #222701052256: Tournament #3099770291, $0.98+$0.12 USD Hold'em No Limit - Level VIII (75/150) - 2021/01/16 21:24:57 EET [2021/01/16 14:24:57 ET]
Table '3099770291 62' 9-max Seat #9 is the button
Seat 1: judith.f (4974 in chips) 
Seat 2: Burton Feingold (4809 in chips) 
Seat 3: dow_jones4 (2991 in chips) 
Seat 4: jcarlos.vale (9301 in chips) 
Seat 5: phantofant (1615 in chips) 
Seat 6: uht25 (9828 in chips) 
Seat 7: MWCHESS (3886 in chips) 
Seat 8: Louuuu2k (5023 in chips) 
Seat 9: NotHereFish (6305 in chips) 
judith.f: posts the ante 15
Burton Feingold: posts the ante 15
dow_jones4: posts the ante 15
jcarlos.vale: posts the ante 15
phantofant: posts the ante 15
uht25: posts the ante 15
MWCHESS: posts the ante 15
Louuuu2k: posts the ante 15
NotHereFish: posts the ante 15
judith.f: posts small blind 75
Burton Feingold: posts big blind 150
*** HOLE CARDS ***
Dealt to jcarlos.vale [Kd Jc]
dow_jones4: folds 
jcarlos.vale: raises 240 to 390
phantofant: folds 
uht25: calls 390
MWCHESS: folds 
Louuuu2k: folds 
NotHereFish: folds 
judith.f: folds 
Burton Feingold: folds 
*** FLOP *** [Kc 9c 7c]
jcarlos.vale: checks 
uht25: bets 225
jcarlos.vale: calls 225
*** TURN *** [Kc 9c 7c] [Kh]
jcarlos.vale: checks 
uht25: checks 
*** RIVER *** [Kc 9c 7c Kh] [Ks]
jcarlos.vale: bets 450
uht25: folds 
Uncalled bet (450) returned to jcarlos.vale
jcarlos.vale collected 1590 from pot
jcarlos.vale: doesn't show hand 
*** SUMMARY ***
Total pot 1590 | Rake 0 
Board [Kc 9c 7c Kh Ks]
Seat 1: judith.f (small blind) folded before Flop
Seat 2: Burton Feingold (big blind) folded before Flop
Seat 3: dow_jones4 folded before Flop (didn't bet)
Seat 4: jcarlos.vale collected (1590)
Seat 5: phantofant folded before Flop (didn't bet)
Seat 6: uht25 folded on the River
Seat 7: MWCHESS folded before Flop (didn't bet)
Seat 8: Louuuu2k folded before Flop (didn't bet)
Seat 9: NotHereFish (button) folded before Flop (didn't bet)



PokerStars Hand #222701095021: Tournament #3099770291, $0.98+$0.12 USD Hold'em No Limit - Level VIII (75/150) - 2021/01/16 21:25:48 EET [2021/01/16 14:25:48 ET]
Table '3099770291 62' 9-max Seat #1 is the button
Seat 1: judith.f (4884 in chips) 
Seat 2: Burton Feingold (4644 in chips) 
Seat 3: dow_jones4 (2976 in chips) 
Seat 4: jcarlos.vale (10261 in chips) 
Seat 5: phantofant (1600 in chips) 
Seat 6: uht25 (9198 in chips) 
Seat 7: MWCHESS (3871 in chips) 
Seat 8: Louuuu2k (5008 in chips) 
Seat 9: NotHereFish (6290 in chips) 
judith.f: posts the ante 15
Burton Feingold: posts the ante 15
dow_jones4: posts the ante 15
jcarlos.vale: posts the ante 15
phantofant: posts the ante 15
uht25: posts the ante 15
MWCHESS: posts the ante 15
Louuuu2k: posts the ante 15
NotHereFish: posts the ante 15
Burton Feingold: posts small blind 75
dow_jones4: posts big blind 150
*** HOLE CARDS ***
Dealt to jcarlos.vale [5c 9d]
jcarlos.vale: folds 
phantofant: calls 150
uht25: folds 
MWCHESS: folds 
Louuuu2k: folds 
NotHereFish: raises 300 to 450
judith.f: raises 4419 to 4869 and is all-in
Burton Feingold: folds 
dow_jones4: folds 
phantofant: folds 
NotHereFish: folds 
Uncalled bet (4419) returned to judith.f
judith.f collected 1410 from pot
judith.f: doesn't show hand 
*** SUMMARY ***
Total pot 1410 | Rake 0 
Seat 1: judith.f (button) collected (1410)
Seat 2: Burton Feingold (small blind) folded before Flop
Seat 3: dow_jones4 (big blind) folded before Flop
Seat 4: jcarlos.vale folded before Flop (didn't bet)
Seat 5: phantofant folded before Flop
Seat 6: uht25 folded before Flop (didn't bet)
Seat 7: MWCHESS folded before Flop (didn't bet)
Seat 8: Louuuu2k folded before Flop (didn't bet)
Seat 9: NotHereFish folded before Flop



PokerStars Hand #222701117991: Tournament #3099770291, $0.98+$0.12 USD Hold'em No Limit - Level VIII (75/150) - 2021/01/16 21:26:15 EET [2021/01/16 14:26:15 ET]
Table '3099770291 62' 9-max Seat #2 is the button
Seat 1: judith.f (5829 in chips) 
Seat 2: Burton Feingold (4554 in chips) 
Seat 3: dow_jones4 (2811 in chips) 
Seat 4: jcarlos.vale (10246 in chips) 
Seat 5: phantofant (1435 in chips) 
Seat 6: uht25 (9183 in chips) 
Seat 7: MWCHESS (3856 in chips) 
Seat 8: Louuuu2k (4993 in chips) 
Seat 9: NotHereFish (5825 in chips) 
judith.f: posts the ante 15
Burton Feingold: posts the ante 15
dow_jones4: posts the ante 15
jcarlos.vale: posts the ante 15
phantofant: posts the ante 15
uht25: posts the ante 15
MWCHESS: posts the ante 15
Louuuu2k: posts the ante 15
NotHereFish: posts the ante 15
dow_jones4: posts small blind 75
jcarlos.vale: posts big blind 150
*** HOLE CARDS ***
Dealt to jcarlos.vale [Qd Js]
phantofant: folds 
uht25: raises 180 to 330
MWCHESS: folds 
Louuuu2k: folds 
NotHereFish: folds 
judith.f: folds 
Burton Feingold: folds 
dow_jones4: folds 
jcarlos.vale: folds 
Uncalled bet (180) returned to uht25
uht25 collected 510 from pot
uht25: doesn't show hand 
*** SUMMARY ***
Total pot 510 | Rake 0 
Seat 1: judith.f folded before Flop (didn't bet)
Seat 2: Burton Feingold (button) folded before Flop (didn't bet)
Seat 3: dow_jones4 (small blind) folded before Flop
Seat 4: jcarlos.vale (big blind) folded before Flop
Seat 5: phantofant folded before Flop (didn't bet)
Seat 6: uht25 collected (510)
Seat 7: MWCHESS folded before Flop (didn't bet)
Seat 8: Louuuu2k folded before Flop (didn't bet)
Seat 9: NotHereFish folded before Flop (didn't bet)



PokerStars Hand #222701139070: Tournament #3099770291, $0.98+$0.12 USD Hold'em No Limit - Level VIII (75/150) - 2021/01/16 21:26:40 EET [2021/01/16 14:26:40 ET]
Table '3099770291 62' 9-max Seat #3 is the button
Seat 1: judith.f (5814 in chips) 
Seat 2: Burton Feingold (4539 in chips) 
Seat 3: dow_jones4 (2721 in chips) 
Seat 4: jcarlos.vale (10081 in chips) 
Seat 5: phantofant (1420 in chips) 
Seat 6: uht25 (9528 in chips) 
Seat 7: MWCHESS (3841 in chips) 
Seat 8: Louuuu2k (4978 in chips) 
Seat 9: NotHereFish (5810 in chips) 
judith.f: posts the ante 15
Burton Feingold: posts the ante 15
dow_jones4: posts the ante 15
jcarlos.vale: posts the ante 15
phantofant: posts the ante 15
uht25: posts the ante 15
MWCHESS: posts the ante 15
Louuuu2k: posts the ante 15
NotHereFish: posts the ante 15
jcarlos.vale: posts small blind 75
phantofant: posts big blind 150
*** HOLE CARDS ***
Dealt to jcarlos.vale [Kh As]
uht25: folds 
MWCHESS: folds 
Louuuu2k: raises 162 to 312
NotHereFish: folds 
judith.f: folds 
Burton Feingold: folds 
dow_jones4: folds 
jcarlos.vale: calls 237
phantofant: folds 
*** FLOP *** [4d 3c 4h]
jcarlos.vale: checks 
Louuuu2k: bets 300
jcarlos.vale: folds 
Uncalled bet (300) returned to Louuuu2k
Louuuu2k collected 909 from pot
Louuuu2k: doesn't show hand 
*** SUMMARY ***
Total pot 909 | Rake 0 
Board [4d 3c 4h]
Seat 1: judith.f folded before Flop (didn't bet)
Seat 2: Burton Feingold folded before Flop (didn't bet)
Seat 3: dow_jones4 (button) folded before Flop (didn't bet)
Seat 4: jcarlos.vale (small blind) folded on the Flop
Seat 5: phantofant (big blind) folded before Flop
Seat 6: uht25 folded before Flop (didn't bet)
Seat 7: MWCHESS folded before Flop (didn't bet)
Seat 8: Louuuu2k collected (909)
Seat 9: NotHereFish folded before Flop (didn't bet)



PokerStars Hand #222701188146: Tournament #3099770291, $0.98+$0.12 USD Hold'em No Limit - Level IX (100/200) - 2021/01/16 21:27:38 EET [2021/01/16 14:27:38 ET]
Table '3099770291 62' 9-max Seat #4 is the button
Seat 1: judith.f (5799 in chips) 
Seat 2: Burton Feingold (4524 in chips) 
Seat 3: dow_jones4 (2706 in chips) 
Seat 4: jcarlos.vale (9754 in chips) 
Seat 5: phantofant (1255 in chips) 
Seat 6: uht25 (9513 in chips) 
Seat 7: MWCHESS (3826 in chips) 
Seat 8: Louuuu2k (5560 in chips) 
Seat 9: NotHereFish (5795 in chips) 
judith.f: posts the ante 18
Burton Feingold: posts the ante 18
dow_jones4: posts the ante 18
jcarlos.vale: posts the ante 18
phantofant: posts the ante 18
uht25: posts the ante 18
MWCHESS: posts the ante 18
Louuuu2k: posts the ante 18
NotHereFish: posts the ante 18
phantofant: posts small blind 100
uht25: posts big blind 200
*** HOLE CARDS ***
Dealt to jcarlos.vale [Qh 8c]
MWCHESS: folds 
Louuuu2k: raises 216 to 416
NotHereFish: folds 
judith.f: folds 
Burton Feingold: folds 
dow_jones4: raises 2272 to 2688 and is all-in
jcarlos.vale: folds 
phantofant: calls 1137 and is all-in
uht25: folds 
Louuuu2k: calls 2272
*** FLOP *** [Td Jd 9d]
*** TURN *** [Td Jd 9d] [4c]
*** RIVER *** [Td Jd 9d 4c] [Jc]
*** SHOW DOWN ***
Louuuu2k: shows [Ah Qc] (a pair of Jacks)
dow_jones4: shows [Ac Kc] (a pair of Jacks - Ace+King kicker)
dow_jones4 collected 2902 from side pot
phantofant: shows [Tc As] (two pair, Jacks and Tens)
phantofant collected 4073 from main pot
*** SUMMARY ***
Total pot 6975 Main pot 4073. Side pot 2902. | Rake 0 
Board [Td Jd 9d 4c Jc]
Seat 1: judith.f folded before Flop (didn't bet)
Seat 2: Burton Feingold folded before Flop (didn't bet)
Seat 3: dow_jones4 showed [Ac Kc] and won (2902) with a pair of Jacks
Seat 4: jcarlos.vale (button) folded before Flop (didn't bet)
Seat 5: phantofant (small blind) showed [Tc As] and won (4073) with two pair, Jacks and Tens
Seat 6: uht25 (big blind) folded before Flop
Seat 7: MWCHESS folded before Flop (didn't bet)
Seat 8: Louuuu2k showed [Ah Qc] and lost with a pair of Jacks
Seat 9: NotHereFish folded before Flop (didn't bet)



PokerStars Hand #222701211652: Tournament #3099770291, $0.98+$0.12 USD Hold'em No Limit - Level IX (100/200) - 2021/01/16 21:28:05 EET [2021/01/16 14:28:05 ET]
Table '3099770291 62' 9-max Seat #5 is the button
Seat 1: judith.f (5781 in chips) 
Seat 2: Burton Feingold (4506 in chips) 
Seat 3: dow_jones4 (2902 in chips) 
Seat 4: jcarlos.vale (9736 in chips) 
Seat 5: phantofant (4073 in chips) 
Seat 6: uht25 (9295 in chips) 
Seat 7: MWCHESS (3808 in chips) 
Seat 8: Louuuu2k (2854 in chips) 
Seat 9: NotHereFish (5777 in chips) 
judith.f: posts the ante 18
Burton Feingold: posts the ante 18
dow_jones4: posts the ante 18
jcarlos.vale: posts the ante 18
phantofant: posts the ante 18
uht25: posts the ante 18
MWCHESS: posts the ante 18
Louuuu2k: posts the ante 18
NotHereFish: posts the ante 18
uht25: posts small blind 100
MWCHESS: posts big blind 200
*** HOLE CARDS ***
Dealt to jcarlos.vale [Kd 7s]
Louuuu2k: folds 
NotHereFish: raises 200 to 400
judith.f: folds 
Burton Feingold: folds 
dow_jones4: folds 
jcarlos.vale: folds 
phantofant: folds 
uht25: raises 900 to 1300
MWCHESS: folds 
NotHereFish: raises 4459 to 5759 and is all-in
uht25: calls 4459
*** FLOP *** [6d 2s Js]
*** TURN *** [6d 2s Js] [9d]
*** RIVER *** [6d 2s Js 9d] [7c]
*** SHOW DOWN ***
uht25: shows [As Kc] (high card Ace)
NotHereFish: shows [Ac Qs] (high card Ace - lower kicker)
uht25 collected 11880 from pot
NotHereFish finished the tournament
*** SUMMARY ***
Total pot 11880 | Rake 0 
Board [6d 2s Js 9d 7c]
Seat 1: judith.f folded before Flop (didn't bet)
Seat 2: Burton Feingold folded before Flop (didn't bet)
Seat 3: dow_jones4 folded before Flop (didn't bet)
Seat 4: jcarlos.vale folded before Flop (didn't bet)
Seat 5: phantofant (button) folded before Flop (didn't bet)
Seat 6: uht25 (small blind) showed [As Kc] and won (11880) with high card Ace
Seat 7: MWCHESS (big blind) folded before Flop
Seat 8: Louuuu2k folded before Flop (didn't bet)
Seat 9: NotHereFish showed [Ac Qs] and lost with high card Ace



PokerStars Hand #222701246231: Tournament #3099770291, $0.98+$0.12 USD Hold'em No Limit - Level IX (100/200) - 2021/01/16 21:28:47 EET [2021/01/16 14:28:47 ET]
Table '3099770291 62' 9-max Seat #6 is the button
Seat 1: judith.f (5763 in chips) 
Seat 2: Burton Feingold (4488 in chips) 
Seat 3: dow_jones4 (2884 in chips) 
Seat 4: jcarlos.vale (9718 in chips) 
Seat 5: phantofant (4055 in chips) 
Seat 6: uht25 (15398 in chips) 
Seat 7: MWCHESS (3590 in chips) 
Seat 8: Louuuu2k (2836 in chips) 
judith.f: posts the ante 18
Burton Feingold: posts the ante 18
dow_jones4: posts the ante 18
jcarlos.vale: posts the ante 18
phantofant: posts the ante 18
uht25: posts the ante 18
MWCHESS: posts the ante 18
Louuuu2k: posts the ante 18
MWCHESS: posts small blind 100
Louuuu2k: posts big blind 200
*** HOLE CARDS ***
Dealt to jcarlos.vale [5c 8s]
judith.f: folds 
Burton Feingold: folds 
dow_jones4 has timed out
dow_jones4: folds 
dow_jones4 is sitting out
jcarlos.vale: folds 
phantofant: calls 200
uht25: calls 200
MWCHESS: raises 3372 to 3572 and is all-in
Louuuu2k: folds 
dow_jones4 is disconnected 
phantofant: folds 
uht25: folds 
Uncalled bet (3372) returned to MWCHESS
MWCHESS collected 944 from pot
MWCHESS: doesn't show hand 
*** SUMMARY ***
Total pot 944 | Rake 0 
Seat 1: judith.f folded before Flop (didn't bet)
Seat 2: Burton Feingold folded before Flop (didn't bet)
Seat 3: dow_jones4 folded before Flop (didn't bet)
Seat 4: jcarlos.vale folded before Flop (didn't bet)
Seat 5: phantofant folded before Flop
Seat 6: uht25 (button) folded before Flop
Seat 7: MWCHESS (small blind) collected (944)
Seat 8: Louuuu2k (big blind) folded before Flop



PokerStars Hand #222701299250: Tournament #3099770291, $0.98+$0.12 USD Hold'em No Limit - Level IX (100/200) - 2021/01/16 21:29:50 EET [2021/01/16 14:29:50 ET]
Table '3099770291 62' 9-max Seat #7 is the button
Seat 1: judith.f (5745 in chips) 
Seat 2: Burton Feingold (4470 in chips) 
Seat 3: dow_jones4 (2866 in chips) is sitting out
Seat 4: jcarlos.vale (9700 in chips) 
Seat 5: phantofant (3837 in chips) 
Seat 6: uht25 (15180 in chips) 
Seat 7: MWCHESS (4316 in chips) 
Seat 8: Louuuu2k (2618 in chips) 
judith.f: posts the ante 18
Burton Feingold: posts the ante 18
dow_jones4: posts the ante 18
jcarlos.vale: posts the ante 18
phantofant: posts the ante 18
uht25: posts the ante 18
MWCHESS: posts the ante 18
Louuuu2k: posts the ante 18
Louuuu2k: posts small blind 100
judith.f: posts big blind 200
*** HOLE CARDS ***
Dealt to jcarlos.vale [Td Js]
Burton Feingold: folds 
dow_jones4: folds 
jcarlos.vale: folds 
dow_jones4 has returned
phantofant: raises 200 to 400
uht25: folds 
MWCHESS: folds 
Louuuu2k: folds 
judith.f: calls 200
*** FLOP *** [Qs 3c Qc]
judith.f: checks 
phantofant: bets 200
judith.f: folds 
Uncalled bet (200) returned to phantofant
phantofant collected 1044 from pot
phantofant: doesn't show hand 
*** SUMMARY ***
Total pot 1044 | Rake 0 
Board [Qs 3c Qc]
Seat 1: judith.f (big blind) folded on the Flop
Seat 2: Burton Feingold folded before Flop (didn't bet)
Seat 3: dow_jones4 folded before Flop (didn't bet)
Seat 4: jcarlos.vale folded before Flop (didn't bet)
Seat 5: phantofant collected (1044)
Seat 6: uht25 folded before Flop (didn't bet)
Seat 7: MWCHESS (button) folded before Flop (didn't bet)
Seat 8: Louuuu2k (small blind) folded before Flop



PokerStars Hand #222701328193: Tournament #3099770291, $0.98+$0.12 USD Hold'em No Limit - Level IX (100/200) - 2021/01/16 21:30:23 EET [2021/01/16 14:30:23 ET]
Table '3099770291 62' 9-max Seat #8 is the button
Seat 1: judith.f (5327 in chips) 
Seat 2: Burton Feingold (4452 in chips) 
Seat 3: dow_jones4 (2848 in chips) 
Seat 4: jcarlos.vale (9682 in chips) 
Seat 5: phantofant (4463 in chips) 
Seat 6: uht25 (15162 in chips) 
Seat 7: MWCHESS (4298 in chips) 
Seat 8: Louuuu2k (2500 in chips) 
Seat 9: gucio51 (5000 in chips) out of hand (moved from another table into small blind)
gucio51 will be allowed to play after the button
judith.f: posts the ante 18
Burton Feingold: posts the ante 18
dow_jones4: posts the ante 18
jcarlos.vale: posts the ante 18
phantofant: posts the ante 18
uht25: posts the ante 18
MWCHESS: posts the ante 18
Louuuu2k: posts the ante 18
judith.f: posts small blind 100
Burton Feingold: posts big blind 200
*** HOLE CARDS ***
Dealt to jcarlos.vale [As 5s]
dow_jones4: folds 
jcarlos.vale: folds 
phantofant: calls 200
uht25: raises 240 to 440
MWCHESS: folds 
Louuuu2k: folds 
judith.f: folds 
Burton Feingold: calls 240
phantofant: folds 
*** FLOP *** [7h Tc 2c]
Burton Feingold: checks 
uht25: bets 500
Burton Feingold: folds 
Uncalled bet (500) returned to uht25
uht25 collected 1324 from pot
uht25: doesn't show hand 
*** SUMMARY ***
Total pot 1324 | Rake 0 
Board [7h Tc 2c]
Seat 1: judith.f (small blind) folded before Flop
Seat 2: Burton Feingold (big blind) folded on the Flop
Seat 3: dow_jones4 folded before Flop (didn't bet)
Seat 4: jcarlos.vale folded before Flop (didn't bet)
Seat 5: phantofant folded before Flop
Seat 6: uht25 collected (1324)
Seat 7: MWCHESS folded before Flop (didn't bet)
Seat 8: Louuuu2k (button) folded before Flop (didn't bet)



PokerStars Hand #222701372412: Tournament #3099770291, $0.98+$0.12 USD Hold'em No Limit - Level IX (100/200) - 2021/01/16 21:31:16 EET [2021/01/16 14:31:16 ET]
Table '3099770291 62' 9-max Seat #1 is the button
Seat 1: judith.f (5209 in chips) 
Seat 2: Burton Feingold (3994 in chips) 
Seat 3: dow_jones4 (2830 in chips) 
Seat 4: jcarlos.vale (9664 in chips) 
Seat 5: phantofant (4245 in chips) 
Seat 6: uht25 (16028 in chips) 
Seat 7: MWCHESS (4280 in chips) 
Seat 8: Louuuu2k (2482 in chips) 
Seat 9: gucio51 (5000 in chips) 
judith.f: posts the ante 18
Burton Feingold: posts the ante 18
dow_jones4: posts the ante 18
jcarlos.vale: posts the ante 18
phantofant: posts the ante 18
uht25: posts the ante 18
MWCHESS: posts the ante 18
Louuuu2k: posts the ante 18
gucio51: posts the ante 18
Burton Feingold: posts small blind 100
dow_jones4: posts big blind 200
*** HOLE CARDS ***
Dealt to jcarlos.vale [8c Kh]
jcarlos.vale: folds 
phantofant: folds 
uht25: folds 
MWCHESS: folds 
Louuuu2k: folds 
gucio51: calls 200
judith.f: folds 
Burton Feingold: calls 100
dow_jones4: checks 
*** FLOP *** [6c 4c 2h]
Burton Feingold: checks 
dow_jones4: checks 
gucio51: checks 
*** TURN *** [6c 4c 2h] [8d]
Burton Feingold: bets 381
dow_jones4: folds 
gucio51: calls 381
*** RIVER *** [6c 4c 2h 8d] [Jh]
Burton Feingold: bets 762
gucio51: folds 
Uncalled bet (762) returned to Burton Feingold
Burton Feingold collected 1524 from pot
Burton Feingold: doesn't show hand 
*** SUMMARY ***
Total pot 1524 | Rake 0 
Board [6c 4c 2h 8d Jh]
Seat 1: judith.f (button) folded before Flop (didn't bet)
Seat 2: Burton Feingold (small blind) collected (1524)
Seat 3: dow_jones4 (big blind) folded on the Turn
Seat 4: jcarlos.vale folded before Flop (didn't bet)
Seat 5: phantofant folded before Flop (didn't bet)
Seat 6: uht25 folded before Flop (didn't bet)
Seat 7: MWCHESS folded before Flop (didn't bet)
Seat 8: Louuuu2k folded before Flop (didn't bet)
Seat 9: gucio51 folded on the River



PokerStars Hand #222701419717: Tournament #3099770291, $0.98+$0.12 USD Hold'em No Limit - Level IX (100/200) - 2021/01/16 21:32:11 EET [2021/01/16 14:32:11 ET]
Table '3099770291 62' 9-max Seat #2 is the button
Seat 1: judith.f (5191 in chips) 
Seat 2: Burton Feingold (4919 in chips) 
Seat 3: dow_jones4 (2612 in chips) 
Seat 4: jcarlos.vale (9646 in chips) 
Seat 5: phantofant (4227 in chips) 
Seat 6: uht25 (16010 in chips) 
Seat 7: MWCHESS (4262 in chips) 
Seat 8: Louuuu2k (2464 in chips) 
Seat 9: gucio51 (4401 in chips) 
judith.f: posts the ante 18
Burton Feingold: posts the ante 18
dow_jones4: posts the ante 18
jcarlos.vale: posts the ante 18
phantofant: posts the ante 18
uht25: posts the ante 18
MWCHESS: posts the ante 18
Louuuu2k: posts the ante 18
gucio51: posts the ante 18
dow_jones4: posts small blind 100
jcarlos.vale: posts big blind 200
*** HOLE CARDS ***
Dealt to jcarlos.vale [6c 7d]
phantofant: folds 
uht25: folds 
MWCHESS: folds 
Louuuu2k: folds 
gucio51: folds 
judith.f: folds 
Burton Feingold: calls 200
dow_jones4 is disconnected 
dow_jones4 is connected 
dow_jones4: folds 
jcarlos.vale: checks 
*** FLOP *** [Ac Tc Td]
jcarlos.vale: checks 
Burton Feingold: bets 200
jcarlos.vale: folds 
Uncalled bet (200) returned to Burton Feingold
Burton Feingold collected 662 from pot
Burton Feingold: doesn't show hand 
*** SUMMARY ***
Total pot 662 | Rake 0 
Board [Ac Tc Td]
Seat 1: judith.f folded before Flop (didn't bet)
Seat 2: Burton Feingold (button) collected (662)
Seat 3: dow_jones4 (small blind) folded before Flop
Seat 4: jcarlos.vale (big blind) folded on the Flop
Seat 5: phantofant folded before Flop (didn't bet)
Seat 6: uht25 folded before Flop (didn't bet)
Seat 7: MWCHESS folded before Flop (didn't bet)
Seat 8: Louuuu2k folded before Flop (didn't bet)
Seat 9: gucio51 folded before Flop (didn't bet)



PokerStars Hand #222701467066: Tournament #3099770291, $0.98+$0.12 USD Hold'em No Limit - Level IX (100/200) - 2021/01/16 21:33:06 EET [2021/01/16 14:33:06 ET]
Table '3099770291 62' 9-max Seat #3 is the button
Seat 1: judith.f (5173 in chips) 
Seat 2: Burton Feingold (5363 in chips) 
Seat 3: dow_jones4 (2494 in chips) 
Seat 4: jcarlos.vale (9428 in chips) 
Seat 5: phantofant (4209 in chips) 
Seat 6: uht25 (15992 in chips) 
Seat 7: MWCHESS (4244 in chips) 
Seat 8: Louuuu2k (2446 in chips) 
Seat 9: gucio51 (4383 in chips) 
judith.f: posts the ante 18
Burton Feingold: posts the ante 18
dow_jones4: posts the ante 18
jcarlos.vale: posts the ante 18
phantofant: posts the ante 18
uht25: posts the ante 18
MWCHESS: posts the ante 18
Louuuu2k: posts the ante 18
gucio51: posts the ante 18
jcarlos.vale: posts small blind 100
phantofant: posts big blind 200
*** HOLE CARDS ***
Dealt to jcarlos.vale [4s Kh]
dow_jones4 is disconnected 
uht25: folds 
MWCHESS: raises 200 to 400
Louuuu2k: folds 
gucio51: folds 
judith.f: folds 
Burton Feingold: folds 
dow_jones4 has timed out while disconnected
dow_jones4: folds 
dow_jones4 is sitting out
jcarlos.vale: folds 
phantofant: folds 
Uncalled bet (200) returned to MWCHESS
MWCHESS collected 662 from pot
MWCHESS: doesn't show hand 
*** SUMMARY ***
Total pot 662 | Rake 0 
Seat 1: judith.f folded before Flop (didn't bet)
Seat 2: Burton Feingold folded before Flop (didn't bet)
Seat 3: dow_jones4 (button) folded before Flop (didn't bet)
Seat 4: jcarlos.vale (small blind) folded before Flop
Seat 5: phantofant (big blind) folded before Flop
Seat 6: uht25 folded before Flop (didn't bet)
Seat 7: MWCHESS collected (662)
Seat 8: Louuuu2k folded before Flop (didn't bet)
Seat 9: gucio51 folded before Flop (didn't bet)



PokerStars Hand #222701498960: Tournament #3099770291, $0.98+$0.12 USD Hold'em No Limit - Level IX (100/200) - 2021/01/16 21:33:44 EET [2021/01/16 14:33:44 ET]
Table '3099770291 62' 9-max Seat #4 is the button
Seat 1: judith.f (5155 in chips) 
Seat 2: Burton Feingold (5345 in chips) 
Seat 3: dow_jones4 (2476 in chips) is sitting out
Seat 4: jcarlos.vale (9310 in chips) 
Seat 5: phantofant (3991 in chips) 
Seat 6: uht25 (15974 in chips) 
Seat 7: MWCHESS (4688 in chips) 
Seat 8: Louuuu2k (2428 in chips) 
Seat 9: gucio51 (4365 in chips) 
judith.f: posts the ante 18
Burton Feingold: posts the ante 18
dow_jones4: posts the ante 18
jcarlos.vale: posts the ante 18
phantofant: posts the ante 18
uht25: posts the ante 18
MWCHESS: posts the ante 18
Louuuu2k: posts the ante 18
gucio51: posts the ante 18
phantofant: posts small blind 100
uht25: posts big blind 200
*** HOLE CARDS ***
Dealt to jcarlos.vale [5h 7s]
MWCHESS: folds 
Louuuu2k: folds 
gucio51: folds 
judith.f: folds 
Burton Feingold: folds 
dow_jones4: folds 
jcarlos.vale: folds 
phantofant: calls 100
uht25: checks 
*** FLOP *** [4d 8d 6d]
phantofant: checks 
uht25: bets 200
phantofant: calls 200
*** TURN *** [4d 8d 6d] [Kh]
dow_jones4 has returned
phantofant: checks 
uht25: checks 
*** RIVER *** [4d 8d 6d Kh] [Qs]
phantofant: checks 
uht25: checks 
*** SHOW DOWN ***
phantofant: shows [5s 8h] (a pair of Eights)
uht25: mucks hand 
phantofant collected 962 from pot
*** SUMMARY ***
Total pot 962 | Rake 0 
Board [4d 8d 6d Kh Qs]
Seat 1: judith.f folded before Flop (didn't bet)
Seat 2: Burton Feingold folded before Flop (didn't bet)
Seat 3: dow_jones4 folded before Flop (didn't bet)
Seat 4: jcarlos.vale (button) folded before Flop (didn't bet)
Seat 5: phantofant (small blind) showed [5s 8h] and won (962) with a pair of Eights
Seat 6: uht25 (big blind) mucked [Td 6c]
Seat 7: MWCHESS folded before Flop (didn't bet)
Seat 8: Louuuu2k folded before Flop (didn't bet)
Seat 9: gucio51 folded before Flop (didn't bet)



PokerStars Hand #222701548247: Tournament #3099770291, $0.98+$0.12 USD Hold'em No Limit - Level IX (100/200) - 2021/01/16 21:34:42 EET [2021/01/16 14:34:42 ET]
Table '3099770291 62' 9-max Seat #5 is the button
Seat 1: judith.f (5137 in chips) 
Seat 2: Burton Feingold (5327 in chips) 
Seat 3: dow_jones4 (2458 in chips) 
Seat 4: jcarlos.vale (9292 in chips) 
Seat 5: phantofant (4535 in chips) 
Seat 6: uht25 (15556 in chips) 
Seat 7: MWCHESS (4670 in chips) 
Seat 8: Louuuu2k (2410 in chips) 
Seat 9: gucio51 (4347 in chips) 
judith.f: posts the ante 18
Burton Feingold: posts the ante 18
dow_jones4: posts the ante 18
jcarlos.vale: posts the ante 18
phantofant: posts the ante 18
uht25: posts the ante 18
MWCHESS: posts the ante 18
Louuuu2k: posts the ante 18
gucio51: posts the ante 18
uht25: posts small blind 100
MWCHESS: posts big blind 200
*** HOLE CARDS ***
Dealt to jcarlos.vale [9s 8h]
Louuuu2k: folds 
gucio51: folds 
judith.f: raises 260 to 460
Burton Feingold: calls 460
dow_jones4: folds 
jcarlos.vale: folds 
phantofant: folds 
uht25: folds 
MWCHESS: folds 
*** FLOP *** [9c 3c 4c]
judith.f: checks 
Burton Feingold: bets 691
judith.f: folds 
Uncalled bet (691) returned to Burton Feingold
Burton Feingold collected 1382 from pot
Burton Feingold: doesn't show hand 
*** SUMMARY ***
Total pot 1382 | Rake 0 
Board [9c 3c 4c]
Seat 1: judith.f folded on the Flop
Seat 2: Burton Feingold collected (1382)
Seat 3: dow_jones4 folded before Flop (didn't bet)
Seat 4: jcarlos.vale folded before Flop (didn't bet)
Seat 5: phantofant (button) folded before Flop (didn't bet)
Seat 6: uht25 (small blind) folded before Flop
Seat 7: MWCHESS (big blind) folded before Flop
Seat 8: Louuuu2k folded before Flop (didn't bet)
Seat 9: gucio51 folded before Flop (didn't bet)



PokerStars Hand #222701600970: Tournament #3099770291, $0.98+$0.12 USD Hold'em No Limit - Level IX (100/200) - 2021/01/16 21:35:44 EET [2021/01/16 14:35:44 ET]
Table '3099770291 62' 9-max Seat #6 is the button
Seat 1: judith.f (4659 in chips) 
Seat 2: Burton Feingold (6231 in chips) 
Seat 3: dow_jones4 (2440 in chips) 
Seat 4: jcarlos.vale (9274 in chips) 
Seat 5: phantofant (4517 in chips) 
Seat 6: uht25 (15438 in chips) 
Seat 7: MWCHESS (4452 in chips) 
Seat 8: Louuuu2k (2392 in chips) 
Seat 9: gucio51 (4329 in chips) 
judith.f: posts the ante 18
Burton Feingold: posts the ante 18
dow_jones4: posts the ante 18
jcarlos.vale: posts the ante 18
phantofant: posts the ante 18
uht25: posts the ante 18
MWCHESS: posts the ante 18
Louuuu2k: posts the ante 18
gucio51: posts the ante 18
MWCHESS: posts small blind 100
Louuuu2k: posts big blind 200
*** HOLE CARDS ***
Dealt to jcarlos.vale [Ts Jh]
gucio51: folds 
judith.f: folds 
Burton Feingold: folds 
dow_jones4: folds 
jcarlos.vale: folds 
phantofant: folds 
phantofant is sitting out
uht25: folds 
MWCHESS: calls 100
Louuuu2k: checks 
*** FLOP *** [Th 9h Qh]
MWCHESS: checks 
Louuuu2k: bets 2174 and is all-in
MWCHESS: folds 
Uncalled bet (2174) returned to Louuuu2k
Louuuu2k collected 562 from pot
Louuuu2k: doesn't show hand 
*** SUMMARY ***
Total pot 562 | Rake 0 
Board [Th 9h Qh]
Seat 1: judith.f folded before Flop (didn't bet)
Seat 2: Burton Feingold folded before Flop (didn't bet)
Seat 3: dow_jones4 folded before Flop (didn't bet)
Seat 4: jcarlos.vale folded before Flop (didn't bet)
Seat 5: phantofant folded before Flop (didn't bet)
Seat 6: uht25 (button) folded before Flop (didn't bet)
Seat 7: MWCHESS (small blind) folded on the Flop
Seat 8: Louuuu2k (big blind) collected (562)
Seat 9: gucio51 folded before Flop (didn't bet)



PokerStars Hand #222701634427: Tournament #3099770291, $0.98+$0.12 USD Hold'em No Limit - Level IX (100/200) - 2021/01/16 21:36:23 EET [2021/01/16 14:36:23 ET]
Table '3099770291 62' 9-max Seat #7 is the button
Seat 1: judith.f (4641 in chips) 
Seat 2: Burton Feingold (6213 in chips) 
Seat 3: dow_jones4 (2422 in chips) 
Seat 4: jcarlos.vale (9256 in chips) 
Seat 5: phantofant (4499 in chips) is sitting out
Seat 6: uht25 (15420 in chips) 
Seat 7: MWCHESS (4234 in chips) 
Seat 8: Louuuu2k (2736 in chips) 
Seat 9: gucio51 (4311 in chips) 
judith.f: posts the ante 18
Burton Feingold: posts the ante 18
dow_jones4: posts the ante 18
jcarlos.vale: posts the ante 18
phantofant: posts the ante 18
uht25: posts the ante 18
MWCHESS: posts the ante 18
Louuuu2k: posts the ante 18
gucio51: posts the ante 18
Louuuu2k: posts small blind 100
gucio51: posts big blind 200
*** HOLE CARDS ***
Dealt to jcarlos.vale [Jc 6c]
judith.f: folds 
Burton Feingold: folds 
dow_jones4: folds 
jcarlos.vale: folds 
phantofant: folds 
phantofant has returned
uht25: folds 
MWCHESS: raises 200 to 400
Louuuu2k: folds 
gucio51: folds 
Uncalled bet (200) returned to MWCHESS
MWCHESS collected 662 from pot
MWCHESS: doesn't show hand 
*** SUMMARY ***
Total pot 662 | Rake 0 
Seat 1: judith.f folded before Flop (didn't bet)
Seat 2: Burton Feingold folded before Flop (didn't bet)
Seat 3: dow_jones4 folded before Flop (didn't bet)
Seat 4: jcarlos.vale folded before Flop (didn't bet)
Seat 5: phantofant folded before Flop (didn't bet)
Seat 6: uht25 folded before Flop (didn't bet)
Seat 7: MWCHESS (button) collected (662)
Seat 8: Louuuu2k (small blind) folded before Flop
Seat 9: gucio51 (big blind) folded before Flop



PokerStars Hand #222701670369: Tournament #3099770291, $0.98+$0.12 USD Hold'em No Limit - Level IX (100/200) - 2021/01/16 21:37:05 EET [2021/01/16 14:37:05 ET]
Table '3099770291 62' 9-max Seat #8 is the button
Seat 1: judith.f (4623 in chips) 
Seat 2: Burton Feingold (6195 in chips) 
Seat 3: dow_jones4 (2404 in chips) 
Seat 4: jcarlos.vale (9238 in chips) 
Seat 5: phantofant (4481 in chips) 
Seat 6: uht25 (15402 in chips) 
Seat 7: MWCHESS (4678 in chips) 
Seat 8: Louuuu2k (2618 in chips) 
Seat 9: gucio51 (4093 in chips) 
judith.f: posts the ante 18
Burton Feingold: posts the ante 18
dow_jones4: posts the ante 18
jcarlos.vale: posts the ante 18
phantofant: posts the ante 18
uht25: posts the ante 18
MWCHESS: posts the ante 18
Louuuu2k: posts the ante 18
gucio51: posts the ante 18
gucio51: posts small blind 100
judith.f: posts big blind 200
*** HOLE CARDS ***
Dealt to jcarlos.vale [2h Jc]
Burton Feingold: folds 
dow_jones4 has timed out
dow_jones4: folds 
dow_jones4 is sitting out
jcarlos.vale: folds 
phantofant: folds 
uht25: folds 
MWCHESS: folds 
Louuuu2k: folds 
gucio51: folds 
Uncalled bet (100) returned to judith.f
judith.f collected 362 from pot
judith.f: doesn't show hand 
*** SUMMARY ***
Total pot 362 | Rake 0 
Seat 1: judith.f (big blind) collected (362)
Seat 2: Burton Feingold folded before Flop (didn't bet)
Seat 3: dow_jones4 folded before Flop (didn't bet)
Seat 4: jcarlos.vale folded before Flop (didn't bet)
Seat 5: phantofant folded before Flop (didn't bet)
Seat 6: uht25 folded before Flop (didn't bet)
Seat 7: MWCHESS folded before Flop (didn't bet)
Seat 8: Louuuu2k (button) folded before Flop (didn't bet)
Seat 9: gucio51 (small blind) folded before Flop



PokerStars Hand #222701704828: Tournament #3099770291, $0.98+$0.12 USD Hold'em No Limit - Level X (125/250) - 2021/01/16 21:37:45 EET [2021/01/16 14:37:45 ET]
Table '3099770291 62' 9-max Seat #9 is the button
Seat 1: judith.f (4867 in chips) 
Seat 2: Burton Feingold (6177 in chips) 
Seat 3: dow_jones4 (2386 in chips) is sitting out
Seat 4: jcarlos.vale (9220 in chips) 
Seat 5: phantofant (4463 in chips) 
Seat 6: uht25 (15384 in chips) 
Seat 7: MWCHESS (4660 in chips) 
Seat 8: Louuuu2k (2600 in chips) 
Seat 9: gucio51 (3975 in chips) 
judith.f: posts the ante 20
Burton Feingold: posts the ante 20
dow_jones4: posts the ante 20
jcarlos.vale: posts the ante 20
phantofant: posts the ante 20
uht25: posts the ante 20
MWCHESS: posts the ante 20
Louuuu2k: posts the ante 20
gucio51: posts the ante 20
judith.f: posts small blind 125
Burton Feingold: posts big blind 250
*** HOLE CARDS ***
Dealt to jcarlos.vale [6h Ah]
dow_jones4: folds 
jcarlos.vale: folds 
phantofant: folds 
uht25: raises 300 to 550
MWCHESS: raises 4090 to 4640 and is all-in
Louuuu2k: folds 
gucio51: folds 
judith.f: folds 
Burton Feingold: folds 
uht25: folds 
Uncalled bet (4090) returned to MWCHESS
MWCHESS collected 1655 from pot
MWCHESS: doesn't show hand 
dow_jones4 has returned
*** SUMMARY ***
Total pot 1655 | Rake 0 
Seat 1: judith.f (small blind) folded before Flop
Seat 2: Burton Feingold (big blind) folded before Flop
Seat 3: dow_jones4 folded before Flop (didn't bet)
Seat 4: jcarlos.vale folded before Flop (didn't bet)
Seat 5: phantofant folded before Flop (didn't bet)
Seat 6: uht25 folded before Flop
Seat 7: MWCHESS collected (1655)
Seat 8: Louuuu2k folded before Flop (didn't bet)
Seat 9: gucio51 (button) folded before Flop (didn't bet)



PokerStars Hand #222701732585: Tournament #3099770291, $0.98+$0.12 USD Hold'em No Limit - Level X (125/250) - 2021/01/16 21:38:18 EET [2021/01/16 14:38:18 ET]
Table '3099770291 62' 9-max Seat #1 is the button
Seat 1: judith.f (4722 in chips) 
Seat 2: Burton Feingold (5907 in chips) 
Seat 3: dow_jones4 (2366 in chips) 
Seat 4: jcarlos.vale (9200 in chips) 
Seat 5: phantofant (4443 in chips) 
Seat 6: uht25 (14814 in chips) 
Seat 7: MWCHESS (5745 in chips) 
Seat 8: Louuuu2k (2580 in chips) 
Seat 9: gucio51 (3955 in chips) 
judith.f: posts the ante 20
Burton Feingold: posts the ante 20
dow_jones4: posts the ante 20
jcarlos.vale: posts the ante 20
phantofant: posts the ante 20
uht25: posts the ante 20
MWCHESS: posts the ante 20
Louuuu2k: posts the ante 20
gucio51: posts the ante 20
Burton Feingold: posts small blind 125
dow_jones4: posts big blind 250
*** HOLE CARDS ***
Dealt to jcarlos.vale [Jc Ac]
jcarlos.vale: raises 400 to 650
phantofant: folds 
uht25: folds 
MWCHESS: folds 
Louuuu2k: folds 
gucio51: folds 
judith.f: folds 
Burton Feingold: calls 525
dow_jones4: folds 
*** FLOP *** [5s Qh 4h]
Burton Feingold: checks 
jcarlos.vale: checks 
*** TURN *** [5s Qh 4h] [9s]
Burton Feingold: checks 
jcarlos.vale: checks 
*** RIVER *** [5s Qh 4h 9s] [Tc]
Burton Feingold: bets 865
jcarlos.vale: folds 
Uncalled bet (865) returned to Burton Feingold
Burton Feingold collected 1730 from pot
Burton Feingold: doesn't show hand 
*** SUMMARY ***
Total pot 1730 | Rake 0 
Board [5s Qh 4h 9s Tc]
Seat 1: judith.f (button) folded before Flop (didn't bet)
Seat 2: Burton Feingold (small blind) collected (1730)
Seat 3: dow_jones4 (big blind) folded before Flop
Seat 4: jcarlos.vale folded on the River
Seat 5: phantofant folded before Flop (didn't bet)
Seat 6: uht25 folded before Flop (didn't bet)
Seat 7: MWCHESS folded before Flop (didn't bet)
Seat 8: Louuuu2k folded before Flop (didn't bet)
Seat 9: gucio51 folded before Flop (didn't bet)



PokerStars Hand #222701781163: Tournament #3099770291, $0.98+$0.12 USD Hold'em No Limit - Level X (125/250) - 2021/01/16 21:39:12 EET [2021/01/16 14:39:12 ET]
Table '3099770291 62' 9-max Seat #2 is the button
Seat 1: judith.f (4702 in chips) 
Seat 2: Burton Feingold (6967 in chips) 
Seat 3: dow_jones4 (2096 in chips) 
Seat 4: jcarlos.vale (8530 in chips) 
Seat 5: phantofant (4423 in chips) 
Seat 6: uht25 (14794 in chips) 
Seat 7: MWCHESS (5725 in chips) 
Seat 8: Louuuu2k (2560 in chips) 
Seat 9: gucio51 (3935 in chips) 
judith.f: posts the ante 20
Burton Feingold: posts the ante 20
dow_jones4: posts the ante 20
jcarlos.vale: posts the ante 20
phantofant: posts the ante 20
uht25: posts the ante 20
MWCHESS: posts the ante 20
Louuuu2k: posts the ante 20
gucio51: posts the ante 20
dow_jones4: posts small blind 125
jcarlos.vale: posts big blind 250
*** HOLE CARDS ***
Dealt to jcarlos.vale [6d Kc]
phantofant: calls 250
uht25: folds 
MWCHESS: calls 250
Louuuu2k: folds 
gucio51: folds 
judith.f: folds 
Burton Feingold: calls 250
dow_jones4: calls 125
jcarlos.vale: checks 
*** FLOP *** [7c 4s 2d]
dow_jones4: bets 1826 and is all-in
jcarlos.vale: folds 
phantofant: folds 
MWCHESS: folds 
Burton Feingold: folds 
Uncalled bet (1826) returned to dow_jones4
dow_jones4 collected 1430 from pot
dow_jones4: doesn't show hand 
*** SUMMARY ***
Total pot 1430 | Rake 0 
Board [7c 4s 2d]
Seat 1: judith.f folded before Flop (didn't bet)
Seat 2: Burton Feingold (button) folded on the Flop
Seat 3: dow_jones4 (small blind) collected (1430)
Seat 4: jcarlos.vale (big blind) folded on the Flop
Seat 5: phantofant folded on the Flop
Seat 6: uht25 folded before Flop (didn't bet)
Seat 7: MWCHESS folded on the Flop
Seat 8: Louuuu2k folded before Flop (didn't bet)
Seat 9: gucio51 folded before Flop (didn't bet)



PokerStars Hand #222701825041: Tournament #3099770291, $0.98+$0.12 USD Hold'em No Limit - Level X (125/250) - 2021/01/16 21:40:03 EET [2021/01/16 14:40:03 ET]
Table '3099770291 62' 9-max Seat #3 is the button
Seat 1: judith.f (4682 in chips) 
Seat 2: Burton Feingold (6697 in chips) 
Seat 3: dow_jones4 (3256 in chips) 
Seat 4: jcarlos.vale (8260 in chips) 
Seat 5: phantofant (4153 in chips) 
Seat 6: uht25 (14774 in chips) 
Seat 7: MWCHESS (5455 in chips) 
Seat 8: Louuuu2k (2540 in chips) 
Seat 9: gucio51 (3915 in chips) 
judith.f: posts the ante 20
Burton Feingold: posts the ante 20
dow_jones4: posts the ante 20
jcarlos.vale: posts the ante 20
phantofant: posts the ante 20
uht25: posts the ante 20
MWCHESS: posts the ante 20
Louuuu2k: posts the ante 20
gucio51: posts the ante 20
jcarlos.vale: posts small blind 125
phantofant: posts big blind 250
*** HOLE CARDS ***
Dealt to jcarlos.vale [3s 5s]
uht25: folds 
MWCHESS: raises 250 to 500
Louuuu2k: folds 
gucio51: folds 
judith.f: folds 
Burton Feingold: folds 
dow_jones4: folds 
jcarlos.vale: folds 
phantofant: folds 
Uncalled bet (250) returned to MWCHESS
MWCHESS collected 805 from pot
MWCHESS: doesn't show hand 
*** SUMMARY ***
Total pot 805 | Rake 0 
Seat 1: judith.f folded before Flop (didn't bet)
Seat 2: Burton Feingold folded before Flop (didn't bet)
Seat 3: dow_jones4 (button) folded before Flop (didn't bet)
Seat 4: jcarlos.vale (small blind) folded before Flop
Seat 5: phantofant (big blind) folded before Flop
Seat 6: uht25 folded before Flop (didn't bet)
Seat 7: MWCHESS collected (805)
Seat 8: Louuuu2k folded before Flop (didn't bet)
Seat 9: gucio51 folded before Flop (didn't bet)



PokerStars Hand #222701840945: Tournament #3099770291, $0.98+$0.12 USD Hold'em No Limit - Level X (125/250) - 2021/01/16 21:40:22 EET [2021/01/16 14:40:22 ET]
Table '3099770291 62' 9-max Seat #4 is the button
Seat 1: judith.f (4662 in chips) 
Seat 2: Burton Feingold (6677 in chips) 
Seat 3: dow_jones4 (3236 in chips) 
Seat 4: jcarlos.vale (8115 in chips) 
Seat 5: phantofant (3883 in chips) 
Seat 6: uht25 (14754 in chips) 
Seat 7: MWCHESS (5990 in chips) 
Seat 8: Louuuu2k (2520 in chips) 
Seat 9: gucio51 (3895 in chips) 
judith.f: posts the ante 20
Burton Feingold: posts the ante 20
dow_jones4: posts the ante 20
jcarlos.vale: posts the ante 20
phantofant: posts the ante 20
uht25: posts the ante 20
MWCHESS: posts the ante 20
Louuuu2k: posts the ante 20
gucio51: posts the ante 20
phantofant: posts small blind 125
uht25: posts big blind 250
*** HOLE CARDS ***
Dealt to jcarlos.vale [Tc 7c]
MWCHESS: folds 
Louuuu2k: folds 
gucio51: folds 
judith.f: raises 325 to 575
Burton Feingold: folds 
dow_jones4: folds 
jcarlos.vale: folds 
phantofant: folds 
uht25: folds 
Uncalled bet (325) returned to judith.f
judith.f collected 805 from pot
judith.f: doesn't show hand 
*** SUMMARY ***
Total pot 805 | Rake 0 
Seat 1: judith.f collected (805)
Seat 2: Burton Feingold folded before Flop (didn't bet)
Seat 3: dow_jones4 folded before Flop (didn't bet)
Seat 4: jcarlos.vale (button) folded before Flop (didn't bet)
Seat 5: phantofant (small blind) folded before Flop
Seat 6: uht25 (big blind) folded before Flop
Seat 7: MWCHESS folded before Flop (didn't bet)
Seat 8: Louuuu2k folded before Flop (didn't bet)
Seat 9: gucio51 folded before Flop (didn't bet)



PokerStars Hand #222701861160: Tournament #3099770291, $0.98+$0.12 USD Hold'em No Limit - Level X (125/250) - 2021/01/16 21:40:46 EET [2021/01/16 14:40:46 ET]
Table '3099770291 62' 9-max Seat #5 is the button
Seat 1: judith.f (5197 in chips) 
Seat 2: Burton Feingold (6657 in chips) 
Seat 3: dow_jones4 (3216 in chips) 
Seat 4: jcarlos.vale (8095 in chips) 
Seat 5: phantofant (3738 in chips) 
Seat 6: uht25 (14484 in chips) 
Seat 7: MWCHESS (5970 in chips) 
Seat 8: Louuuu2k (2500 in chips) 
Seat 9: gucio51 (3875 in chips) 
judith.f: posts the ante 20
Burton Feingold: posts the ante 20
dow_jones4: posts the ante 20
jcarlos.vale: posts the ante 20
phantofant: posts the ante 20
uht25: posts the ante 20
MWCHESS: posts the ante 20
Louuuu2k: posts the ante 20
gucio51: posts the ante 20
uht25: posts small blind 125
MWCHESS: posts big blind 250
*** HOLE CARDS ***
Dealt to jcarlos.vale [4c 3c]
Louuuu2k: folds 
gucio51: folds 
judith.f: folds 
Burton Feingold: folds 
dow_jones4: folds 
jcarlos.vale: folds 
phantofant: calls 250
uht25: folds 
MWCHESS: checks 
*** FLOP *** [8d Th 7s]
MWCHESS: checks 
phantofant: checks 
*** TURN *** [8d Th 7s] [Kc]
MWCHESS: checks 
phantofant: bets 250
MWCHESS: folds 
Uncalled bet (250) returned to phantofant
phantofant collected 805 from pot
phantofant: doesn't show hand 
*** SUMMARY ***
Total pot 805 | Rake 0 
Board [8d Th 7s Kc]
Seat 1: judith.f folded before Flop (didn't bet)
Seat 2: Burton Feingold folded before Flop (didn't bet)
Seat 3: dow_jones4 folded before Flop (didn't bet)
Seat 4: jcarlos.vale folded before Flop (didn't bet)
Seat 5: phantofant (button) collected (805)
Seat 6: uht25 (small blind) folded before Flop
Seat 7: MWCHESS (big blind) folded on the Turn
Seat 8: Louuuu2k folded before Flop (didn't bet)
Seat 9: gucio51 folded before Flop (didn't bet)



PokerStars Hand #222701901690: Tournament #3099770291, $0.98+$0.12 USD Hold'em No Limit - Level X (125/250) - 2021/01/16 21:41:34 EET [2021/01/16 14:41:34 ET]
Table '3099770291 62' 9-max Seat #6 is the button
Seat 1: judith.f (5177 in chips) 
Seat 2: Burton Feingold (6637 in chips) 
Seat 3: dow_jones4 (3196 in chips) 
Seat 4: jcarlos.vale (8075 in chips) 
Seat 5: phantofant (4273 in chips) 
Seat 6: uht25 (14339 in chips) 
Seat 7: MWCHESS (5700 in chips) 
Seat 8: Louuuu2k (2480 in chips) 
Seat 9: gucio51 (3855 in chips) 
judith.f: posts the ante 20
Burton Feingold: posts the ante 20
dow_jones4: posts the ante 20
jcarlos.vale: posts the ante 20
phantofant: posts the ante 20
uht25: posts the ante 20
MWCHESS: posts the ante 20
Louuuu2k: posts the ante 20
gucio51: posts the ante 20
MWCHESS: posts small blind 125
Louuuu2k: posts big blind 250
*** HOLE CARDS ***
Dealt to jcarlos.vale [As Kd]
gucio51: folds 
judith.f: folds 
Burton Feingold: raises 250 to 500
dow_jones4: folds 
jcarlos.vale: calls 500
phantofant: folds 
uht25: folds 
MWCHESS: raises 5180 to 5680 and is all-in
Louuuu2k: folds 
phantofant is sitting out
Burton Feingold: folds 
jcarlos.vale: folds 
Uncalled bet (5180) returned to MWCHESS
MWCHESS collected 1930 from pot
MWCHESS: doesn't show hand 
*** SUMMARY ***
Total pot 1930 | Rake 0 
Seat 1: judith.f folded before Flop (didn't bet)
Seat 2: Burton Feingold folded before Flop
Seat 3: dow_jones4 folded before Flop (didn't bet)
Seat 4: jcarlos.vale folded before Flop
Seat 5: phantofant folded before Flop (didn't bet)
Seat 6: uht25 (button) folded before Flop (didn't bet)
Seat 7: MWCHESS (small blind) collected (1930)
Seat 8: Louuuu2k (big blind) folded before Flop
Seat 9: gucio51 folded before Flop (didn't bet)



PokerStars Hand #222701930944: Tournament #3099770291, $0.98+$0.12 USD Hold'em No Limit - Level X (125/250) - 2021/01/16 21:42:08 EET [2021/01/16 14:42:08 ET]
Table '3099770291 62' 9-max Seat #7 is the button
Seat 1: judith.f (5157 in chips) 
Seat 2: Burton Feingold (6117 in chips) 
Seat 3: dow_jones4 (3176 in chips) 
Seat 4: jcarlos.vale (7555 in chips) 
Seat 5: phantofant (4253 in chips) is sitting out
Seat 6: uht25 (14319 in chips) 
Seat 7: MWCHESS (7110 in chips) 
Seat 8: Louuuu2k (2210 in chips) 
Seat 9: gucio51 (3835 in chips) 
judith.f: posts the ante 20
Burton Feingold: posts the ante 20
dow_jones4: posts the ante 20
jcarlos.vale: posts the ante 20
phantofant: posts the ante 20
uht25: posts the ante 20
MWCHESS: posts the ante 20
Louuuu2k: posts the ante 20
gucio51: posts the ante 20
Louuuu2k: posts small blind 125
gucio51: posts big blind 250
*** HOLE CARDS ***
Dealt to jcarlos.vale [Kh 7h]
judith.f: raises 325 to 575
Burton Feingold: folds 
dow_jones4: folds 
jcarlos.vale: folds 
phantofant: folds 
uht25: folds 
MWCHESS: folds 
Louuuu2k: folds 
gucio51: calls 325
*** FLOP *** [7d 3s Kd]
gucio51: checks 
judith.f: bets 480
gucio51: calls 480
*** TURN *** [7d 3s Kd] [9c]
gucio51: checks 
judith.f: checks 
*** RIVER *** [7d 3s Kd 9c] [7c]
gucio51: checks 
judith.f: checks 
*** SHOW DOWN ***
gucio51: shows [Ac 4s] (a pair of Sevens)
judith.f: shows [Jc Js] (two pair, Jacks and Sevens)
judith.f collected 2415 from pot
*** SUMMARY ***
Total pot 2415 | Rake 0 
Board [7d 3s Kd 9c 7c]
Seat 1: judith.f showed [Jc Js] and won (2415) with two pair, Jacks and Sevens
Seat 2: Burton Feingold folded before Flop (didn't bet)
Seat 3: dow_jones4 folded before Flop (didn't bet)
Seat 4: jcarlos.vale folded before Flop (didn't bet)
Seat 5: phantofant folded before Flop (didn't bet)
Seat 6: uht25 folded before Flop (didn't bet)
Seat 7: MWCHESS (button) folded before Flop (didn't bet)
Seat 8: Louuuu2k (small blind) folded before Flop
Seat 9: gucio51 (big blind) showed [Ac 4s] and lost with a pair of Sevens



PokerStars Hand #222701970015: Tournament #3099770291, $0.98+$0.12 USD Hold'em No Limit - Level X (125/250) - 2021/01/16 21:42:54 EET [2021/01/16 14:42:54 ET]
Table '3099770291 62' 9-max Seat #8 is the button
Seat 1: judith.f (6497 in chips) 
Seat 2: Burton Feingold (6097 in chips) 
Seat 3: dow_jones4 (3156 in chips) 
Seat 4: jcarlos.vale (7535 in chips) 
Seat 5: phantofant (4233 in chips) is sitting out
Seat 6: uht25 (14299 in chips) 
Seat 7: MWCHESS (7090 in chips) 
Seat 8: Louuuu2k (2065 in chips) 
Seat 9: gucio51 (2760 in chips) 
judith.f: posts the ante 20
Burton Feingold: posts the ante 20
dow_jones4: posts the ante 20
jcarlos.vale: posts the ante 20
phantofant: posts the ante 20
uht25: posts the ante 20
MWCHESS: posts the ante 20
Louuuu2k: posts the ante 20
gucio51: posts the ante 20
gucio51: posts small blind 125
judith.f: posts big blind 250
*** HOLE CARDS ***
Dealt to jcarlos.vale [8h 3c]
Burton Feingold: calls 250
dow_jones4: folds 
jcarlos.vale: folds 
phantofant: folds 
uht25: raises 300 to 550
MWCHESS: folds 
Louuuu2k: raises 1495 to 2045 and is all-in
gucio51: calls 1920
judith.f: folds 
Burton Feingold: folds 
uht25: raises 1495 to 3540
gucio51: calls 695 and is all-in
Uncalled bet (800) returned to uht25
*** FLOP *** [Qs Td 5d]
*** TURN *** [Qs Td 5d] [4h]
*** RIVER *** [Qs Td 5d 4h] [6h]
*** SHOW DOWN ***
gucio51: shows [Jc Jh] (a pair of Jacks)
uht25: shows [Kc Qc] (a pair of Queens)
uht25 collected 1390 from side pot
Louuuu2k: shows [Ts Tc] (three of a kind, Tens)
Louuuu2k collected 6815 from main pot
gucio51 finished the tournament
*** SUMMARY ***
Total pot 8205 Main pot 6815. Side pot 1390. | Rake 0 
Board [Qs Td 5d 4h 6h]
Seat 1: judith.f (big blind) folded before Flop
Seat 2: Burton Feingold folded before Flop
Seat 3: dow_jones4 folded before Flop (didn't bet)
Seat 4: jcarlos.vale folded before Flop (didn't bet)
Seat 5: phantofant folded before Flop (didn't bet)
Seat 6: uht25 showed [Kc Qc] and won (1390) with a pair of Queens
Seat 7: MWCHESS folded before Flop (didn't bet)
Seat 8: Louuuu2k (button) showed [Ts Tc] and won (6815) with three of a kind, Tens
Seat 9: gucio51 (small blind) showed [Jc Jh] and lost with a pair of Jacks



PokerStars Hand #222702015145: Tournament #3099770291, $0.98+$0.12 USD Hold'em No Limit - Level X (125/250) - 2021/01/16 21:43:48 EET [2021/01/16 14:43:48 ET]
Table '3099770291 62' 9-max Seat #1 is the button
Seat 1: judith.f (6227 in chips) 
Seat 2: Burton Feingold (5827 in chips) 
Seat 3: dow_jones4 (3136 in chips) 
Seat 4: jcarlos.vale (7515 in chips) 
Seat 5: phantofant (4213 in chips) is sitting out
Seat 6: uht25 (12929 in chips) 
Seat 7: MWCHESS (7070 in chips) 
Seat 8: Louuuu2k (6815 in chips) 
judith.f: posts the ante 20
Burton Feingold: posts the ante 20
dow_jones4: posts the ante 20
jcarlos.vale: posts the ante 20
phantofant: posts the ante 20
uht25: posts the ante 20
MWCHESS: posts the ante 20
Louuuu2k: posts the ante 20
Burton Feingold: posts small blind 125
dow_jones4: posts big blind 250
*** HOLE CARDS ***
Dealt to jcarlos.vale [Jc Kh]
jcarlos.vale: raises 400 to 650
phantofant: folds 
uht25: folds 
MWCHESS: folds 
Louuuu2k: folds 
judith.f: folds 
Burton Feingold: folds 
dow_jones4: folds 
Uncalled bet (400) returned to jcarlos.vale
jcarlos.vale collected 785 from pot
jcarlos.vale: doesn't show hand 
*** SUMMARY ***
Total pot 785 | Rake 0 
Seat 1: judith.f (button) folded before Flop (didn't bet)
Seat 2: Burton Feingold (small blind) folded before Flop
Seat 3: dow_jones4 (big blind) folded before Flop
Seat 4: jcarlos.vale collected (785)
Seat 5: phantofant folded before Flop (didn't bet)
Seat 6: uht25 folded before Flop (didn't bet)
Seat 7: MWCHESS folded before Flop (didn't bet)
Seat 8: Louuuu2k folded before Flop (didn't bet)



PokerStars Hand #222702027257: Tournament #3099770291, $0.98+$0.12 USD Hold'em No Limit - Level X (125/250) - 2021/01/16 21:44:02 EET [2021/01/16 14:44:02 ET]
Table '3099770291 62' 9-max Seat #2 is the button
Seat 1: judith.f (6207 in chips) 
Seat 2: Burton Feingold (5682 in chips) 
Seat 3: dow_jones4 (2866 in chips) 
Seat 4: jcarlos.vale (8030 in chips) 
Seat 5: phantofant (4193 in chips) is sitting out
Seat 6: uht25 (12909 in chips) 
Seat 7: MWCHESS (7050 in chips) 
Seat 8: Louuuu2k (6795 in chips) 
judith.f: posts the ante 20
Burton Feingold: posts the ante 20
dow_jones4: posts the ante 20
jcarlos.vale: posts the ante 20
phantofant: posts the ante 20
uht25: posts the ante 20
MWCHESS: posts the ante 20
Louuuu2k: posts the ante 20
dow_jones4: posts small blind 125
jcarlos.vale: posts big blind 250
*** HOLE CARDS ***
Dealt to jcarlos.vale [5s 8s]
phantofant: folds 
uht25: folds 
MWCHESS: folds 
Louuuu2k: folds 
judith.f: folds 
Burton Feingold: folds 
dow_jones4: raises 2596 to 2846 and is all-in
jcarlos.vale: folds 
Uncalled bet (2596) returned to dow_jones4
dow_jones4 collected 660 from pot
dow_jones4: doesn't show hand 
*** SUMMARY ***
Total pot 660 | Rake 0 
Seat 1: judith.f folded before Flop (didn't bet)
Seat 2: Burton Feingold (button) folded before Flop (didn't bet)
Seat 3: dow_jones4 (small blind) collected (660)
Seat 4: jcarlos.vale (big blind) folded before Flop
Seat 5: phantofant folded before Flop (didn't bet)
Seat 6: uht25 folded before Flop (didn't bet)
Seat 7: MWCHESS folded before Flop (didn't bet)
Seat 8: Louuuu2k folded before Flop (didn't bet)



PokerStars Hand #222702049408: Tournament #3099770291, $0.98+$0.12 USD Hold'em No Limit - Level X (125/250) - 2021/01/16 21:44:29 EET [2021/01/16 14:44:29 ET]
Table '3099770291 62' 9-max Seat #3 is the button
Seat 1: judith.f (6187 in chips) 
Seat 2: Burton Feingold (5662 in chips) 
Seat 3: dow_jones4 (3256 in chips) 
Seat 4: jcarlos.vale (7760 in chips) 
Seat 5: phantofant (4173 in chips) is sitting out
Seat 6: uht25 (12889 in chips) 
Seat 7: MWCHESS (7030 in chips) 
Seat 8: Louuuu2k (6775 in chips) 
Seat 9: yana11169 (5000 in chips) 
judith.f: posts the ante 20
Burton Feingold: posts the ante 20
dow_jones4: posts the ante 20
jcarlos.vale: posts the ante 20
phantofant: posts the ante 20
uht25: posts the ante 20
MWCHESS: posts the ante 20
Louuuu2k: posts the ante 20
yana11169: posts the ante 20
jcarlos.vale: posts small blind 125
phantofant: posts big blind 250
*** HOLE CARDS ***
Dealt to jcarlos.vale [Ks Kh]
uht25: folds 
MWCHESS: folds 
Louuuu2k: folds 
yana11169: folds 
judith.f: folds 
Burton Feingold: raises 250 to 500
dow_jones4: folds 
jcarlos.vale: raises 750 to 1250
phantofant: folds 
phantofant has returned
Burton Feingold: calls 750
*** FLOP *** [2s 3h 8d]
jcarlos.vale: checks 
Burton Feingold: bets 1465
jcarlos.vale: calls 1465
*** TURN *** [2s 3h 8d] [Ah]
jcarlos.vale: bets 4395
Burton Feingold: folds 
Uncalled bet (4395) returned to jcarlos.vale
jcarlos.vale collected 5860 from pot
jcarlos.vale: doesn't show hand 
*** SUMMARY ***
Total pot 5860 | Rake 0 
Board [2s 3h 8d Ah]
Seat 1: judith.f folded before Flop (didn't bet)
Seat 2: Burton Feingold folded on the Turn
Seat 3: dow_jones4 (button) folded before Flop (didn't bet)
Seat 4: jcarlos.vale (small blind) collected (5860)
Seat 5: phantofant (big blind) folded before Flop
Seat 6: uht25 folded before Flop (didn't bet)
Seat 7: MWCHESS folded before Flop (didn't bet)
Seat 8: Louuuu2k folded before Flop (didn't bet)
Seat 9: yana11169 folded before Flop (didn't bet)



PokerStars Hand #222702098905: Tournament #3099770291, $0.98+$0.12 USD Hold'em No Limit - Level X (125/250) - 2021/01/16 21:45:27 EET [2021/01/16 14:45:27 ET]
Table '3099770291 62' 9-max Seat #4 is the button
Seat 1: judith.f (6167 in chips) 
Seat 2: Burton Feingold (2927 in chips) 
Seat 3: dow_jones4 (3236 in chips) 
Seat 4: jcarlos.vale (10885 in chips) 
Seat 5: phantofant (3903 in chips) 
Seat 6: uht25 (12869 in chips) 
Seat 7: MWCHESS (7010 in chips) 
Seat 8: Louuuu2k (6755 in chips) 
Seat 9: yana11169 (4980 in chips) 
judith.f: posts the ante 20
Burton Feingold: posts the ante 20
dow_jones4: posts the ante 20
jcarlos.vale: posts the ante 20
phantofant: posts the ante 20
uht25: posts the ante 20
MWCHESS: posts the ante 20
Louuuu2k: posts the ante 20
yana11169: posts the ante 20
phantofant: posts small blind 125
uht25: posts big blind 250
*** HOLE CARDS ***
Dealt to jcarlos.vale [Td 4c]
MWCHESS: folds 
Louuuu2k: folds 
yana11169: folds 
judith.f: folds 
Burton Feingold: folds 
dow_jones4 has timed out
dow_jones4: folds 
dow_jones4 is sitting out
jcarlos.vale: folds 
phantofant: folds 
Uncalled bet (125) returned to uht25
uht25 collected 430 from pot
uht25: doesn't show hand 
*** SUMMARY ***
Total pot 430 | Rake 0 
Seat 1: judith.f folded before Flop (didn't bet)
Seat 2: Burton Feingold folded before Flop (didn't bet)
Seat 3: dow_jones4 folded before Flop (didn't bet)
Seat 4: jcarlos.vale (button) folded before Flop (didn't bet)
Seat 5: phantofant (small blind) folded before Flop
Seat 6: uht25 (big blind) collected (430)
Seat 7: MWCHESS folded before Flop (didn't bet)
Seat 8: Louuuu2k folded before Flop (didn't bet)
Seat 9: yana11169 folded before Flop (didn't bet)



PokerStars Hand #222702129444: Tournament #3099770291, $0.98+$0.12 USD Hold'em No Limit - Level X (125/250) - 2021/01/16 21:46:03 EET [2021/01/16 14:46:03 ET]
Table '3099770291 62' 9-max Seat #5 is the button
Seat 1: judith.f (6147 in chips) 
Seat 2: Burton Feingold (2907 in chips) 
Seat 3: dow_jones4 (3216 in chips) is sitting out
Seat 4: jcarlos.vale (10865 in chips) 
Seat 5: phantofant (3758 in chips) 
Seat 6: uht25 (13154 in chips) 
Seat 8: Louuuu2k (6735 in chips) 
Seat 9: yana11169 (4960 in chips) 
judith.f: posts the ante 20
Burton Feingold: posts the ante 20
dow_jones4: posts the ante 20
jcarlos.vale: posts the ante 20
phantofant: posts the ante 20
uht25: posts the ante 20
Louuuu2k: posts the ante 20
yana11169: posts the ante 20
uht25: posts small blind 125
Louuuu2k: posts big blind 250
*** HOLE CARDS ***
Dealt to jcarlos.vale [Qc Ac]
yana11169: raises 4690 to 4940 and is all-in
judith.f: folds 
Burton Feingold: folds 
dow_jones4: folds 
jcarlos.vale: folds 
phantofant: folds 
dow_jones4 is disconnected 
uht25: folds 
Louuuu2k: folds 
Uncalled bet (4690) returned to yana11169
yana11169 collected 785 from pot
yana11169: doesn't show hand 
*** SUMMARY ***
Total pot 785 | Rake 0 
Seat 1: judith.f folded before Flop (didn't bet)
Seat 2: Burton Feingold folded before Flop (didn't bet)
Seat 3: dow_jones4 folded before Flop (didn't bet)
Seat 4: jcarlos.vale folded before Flop (didn't bet)
Seat 5: phantofant (button) folded before Flop (didn't bet)
Seat 6: uht25 (small blind) folded before Flop
Seat 8: Louuuu2k (big blind) folded before Flop
Seat 9: yana11169 collected (785)



PokerStars Hand #222702146441: Tournament #3099770291, $0.98+$0.12 USD Hold'em No Limit - Level X (125/250) - 2021/01/16 21:46:23 EET [2021/01/16 14:46:23 ET]
Table '3099770291 62' 9-max Seat #6 is the button
Seat 1: judith.f (6127 in chips) 
Seat 2: Burton Feingold (2887 in chips) 
Seat 3: dow_jones4 (3196 in chips) is sitting out
Seat 4: jcarlos.vale (10845 in chips) 
Seat 5: phantofant (3738 in chips) 
Seat 6: uht25 (13009 in chips) 
Seat 7: parker1818 (11670 in chips) out of hand (moved from another table into small blind)
Seat 8: Louuuu2k (6465 in chips) 
Seat 9: yana11169 (5475 in chips) 
parker1818 will be allowed to play after the button
judith.f: posts the ante 20
Burton Feingold: posts the ante 20
dow_jones4: posts the ante 20
jcarlos.vale: posts the ante 20
phantofant: posts the ante 20
uht25: posts the ante 20
Louuuu2k: posts the ante 20
yana11169: posts the ante 20
Louuuu2k: posts small blind 125
yana11169: posts big blind 250
*** HOLE CARDS ***
Dealt to jcarlos.vale [5h Tc]
judith.f: folds 
Burton Feingold: folds 
dow_jones4: folds 
jcarlos.vale: folds 
phantofant: folds 
dow_jones4 has returned
uht25: calls 250
Louuuu2k: raises 750 to 1000
yana11169: folds 
uht25: folds 
Uncalled bet (750) returned to Louuuu2k
Louuuu2k collected 910 from pot
Louuuu2k: doesn't show hand 
*** SUMMARY ***
Total pot 910 | Rake 0 
Seat 1: judith.f folded before Flop (didn't bet)
Seat 2: Burton Feingold folded before Flop (didn't bet)
Seat 3: dow_jones4 folded before Flop (didn't bet)
Seat 4: jcarlos.vale folded before Flop (didn't bet)
Seat 5: phantofant folded before Flop (didn't bet)
Seat 6: uht25 (button) folded before Flop
Seat 8: Louuuu2k (small blind) collected (910)
Seat 9: yana11169 (big blind) folded before Flop



PokerStars Hand #222702173732: Tournament #3099770291, $0.98+$0.12 USD Hold'em No Limit - Level X (125/250) - 2021/01/16 21:46:55 EET [2021/01/16 14:46:55 ET]
Table '3099770291 62' 9-max Seat #8 is the button
Seat 1: judith.f (6107 in chips) 
Seat 2: Burton Feingold (2867 in chips) 
Seat 3: dow_jones4 (3176 in chips) 
Seat 4: jcarlos.vale (10825 in chips) 
Seat 5: phantofant (3718 in chips) 
Seat 6: uht25 (12739 in chips) 
Seat 7: parker1818 (11670 in chips) 
Seat 8: Louuuu2k (7105 in chips) 
Seat 9: yana11169 (5205 in chips) 
judith.f: posts the ante 20
Burton Feingold: posts the ante 20
dow_jones4: posts the ante 20
jcarlos.vale: posts the ante 20
phantofant: posts the ante 20
uht25: posts the ante 20
parker1818: posts the ante 20
Louuuu2k: posts the ante 20
yana11169: posts the ante 20
yana11169: posts small blind 125
judith.f: posts big blind 250
*** HOLE CARDS ***
Dealt to jcarlos.vale [3c 7h]
Burton Feingold: folds 
dow_jones4: folds 
jcarlos.vale: folds 
phantofant: folds 
uht25: folds 
parker1818: raises 250 to 500
Louuuu2k: folds 
yana11169: folds 
judith.f: folds 
Uncalled bet (250) returned to parker1818
parker1818 collected 805 from pot
parker1818: doesn't show hand 
*** SUMMARY ***
Total pot 805 | Rake 0 
Seat 1: judith.f (big blind) folded before Flop
Seat 2: Burton Feingold folded before Flop (didn't bet)
Seat 3: dow_jones4 folded before Flop (didn't bet)
Seat 4: jcarlos.vale folded before Flop (didn't bet)
Seat 5: phantofant folded before Flop (didn't bet)
Seat 6: uht25 folded before Flop (didn't bet)
Seat 7: parker1818 collected (805)
Seat 8: Louuuu2k (button) folded before Flop (didn't bet)
Seat 9: yana11169 (small blind) folded before Flop



PokerStars Hand #222702215410: Tournament #3099770291, $0.98+$0.12 USD Hold'em No Limit - Level XI (150/300) - 2021/01/16 21:47:38 EET [2021/01/16 14:47:38 ET]
Table '3099770291 62' 9-max Seat #9 is the button
Seat 1: judith.f (5837 in chips) 
Seat 2: Burton Feingold (2847 in chips) 
Seat 3: dow_jones4 (3156 in chips) 
Seat 4: jcarlos.vale (10805 in chips) 
Seat 5: phantofant (3698 in chips) 
Seat 6: uht25 (12719 in chips) 
Seat 7: parker1818 (12205 in chips) 
Seat 8: Louuuu2k (7085 in chips) 
Seat 9: yana11169 (5060 in chips) 
judith.f: posts the ante 22
Burton Feingold: posts the ante 22
dow_jones4: posts the ante 22
jcarlos.vale: posts the ante 22
phantofant: posts the ante 22
uht25: posts the ante 22
parker1818: posts the ante 22
Louuuu2k: posts the ante 22
yana11169: posts the ante 22
judith.f: posts small blind 150
Burton Feingold: posts big blind 300
*** HOLE CARDS ***
Dealt to jcarlos.vale [Kh Qs]
dow_jones4: calls 300
jcarlos.vale: folds 
phantofant: calls 300
uht25: folds 
parker1818: folds 
Louuuu2k: folds 
yana11169: folds 
judith.f: folds 
Burton Feingold: raises 2525 to 2825 and is all-in
dow_jones4: folds 
phantofant: folds 
Uncalled bet (2525) returned to Burton Feingold
Burton Feingold collected 1248 from pot
Burton Feingold: doesn't show hand 
*** SUMMARY ***
Total pot 1248 | Rake 0 
Seat 1: judith.f (small blind) folded before Flop
Seat 2: Burton Feingold (big blind) collected (1248)
Seat 3: dow_jones4 folded before Flop
Seat 4: jcarlos.vale folded before Flop (didn't bet)
Seat 5: phantofant folded before Flop
Seat 6: uht25 folded before Flop (didn't bet)
Seat 7: parker1818 folded before Flop (didn't bet)
Seat 8: Louuuu2k folded before Flop (didn't bet)
Seat 9: yana11169 (button) folded before Flop (didn't bet)



PokerStars Hand #222702248394: Tournament #3099770291, $0.98+$0.12 USD Hold'em No Limit - Level XI (150/300) - 2021/01/16 21:48:17 EET [2021/01/16 14:48:17 ET]
Table '3099770291 62' 9-max Seat #1 is the button
Seat 1: judith.f (5665 in chips) 
Seat 2: Burton Feingold (3773 in chips) 
Seat 3: dow_jones4 (2834 in chips) 
Seat 4: jcarlos.vale (10783 in chips) 
Seat 5: phantofant (3376 in chips) 
Seat 6: uht25 (12697 in chips) 
Seat 7: parker1818 (12183 in chips) 
Seat 8: Louuuu2k (7063 in chips) 
Seat 9: yana11169 (5038 in chips) 
judith.f: posts the ante 22
Burton Feingold: posts the ante 22
dow_jones4: posts the ante 22
jcarlos.vale: posts the ante 22
phantofant: posts the ante 22
uht25: posts the ante 22
parker1818: posts the ante 22
Louuuu2k: posts the ante 22
yana11169: posts the ante 22
Burton Feingold: posts small blind 150
dow_jones4: posts big blind 300
*** HOLE CARDS ***
Dealt to jcarlos.vale [6c 5h]
jcarlos.vale: folds 
phantofant: folds 
uht25: folds 
parker1818: raises 300 to 600
Louuuu2k: folds 
yana11169: folds 
judith.f: folds 
Burton Feingold: calls 450
dow_jones4: raises 2212 to 2812 and is all-in
parker1818: calls 2212
Burton Feingold: calls 2212
*** FLOP *** [Ac 3d 6d]
Burton Feingold: checks 
parker1818: bets 1200
Burton Feingold: folds 
Uncalled bet (1200) returned to parker1818
*** TURN *** [Ac 3d 6d] [Qd]
*** RIVER *** [Ac 3d 6d Qd] [8h]
*** SHOW DOWN ***
dow_jones4: shows [Jd Ad] (a flush, Ace high)
parker1818: shows [Qh Ah] (two pair, Aces and Queens)
dow_jones4 collected 8634 from pot
*** SUMMARY ***
Total pot 8634 | Rake 0 
Board [Ac 3d 6d Qd 8h]
Seat 1: judith.f (button) folded before Flop (didn't bet)
Seat 2: Burton Feingold (small blind) folded on the Flop
Seat 3: dow_jones4 (big blind) showed [Jd Ad] and won (8634) with a flush, Ace high
Seat 4: jcarlos.vale folded before Flop (didn't bet)
Seat 5: phantofant folded before Flop (didn't bet)
Seat 6: uht25 folded before Flop (didn't bet)
Seat 7: parker1818 showed [Qh Ah] and lost with two pair, Aces and Queens
Seat 8: Louuuu2k folded before Flop (didn't bet)
Seat 9: yana11169 folded before Flop (didn't bet)



PokerStars Hand #222702299099: Tournament #3099770291, $0.98+$0.12 USD Hold'em No Limit - Level XI (150/300) - 2021/01/16 21:49:16 EET [2021/01/16 14:49:16 ET]
Table '3099770291 62' 9-max Seat #2 is the button
Seat 1: judith.f (5643 in chips) 
Seat 2: Burton Feingold (939 in chips) 
Seat 3: dow_jones4 (8634 in chips) 
Seat 4: jcarlos.vale (10761 in chips) 
Seat 5: phantofant (3354 in chips) 
Seat 6: uht25 (12675 in chips) 
Seat 7: parker1818 (9349 in chips) 
Seat 8: Louuuu2k (7041 in chips) 
Seat 9: yana11169 (5016 in chips) 
judith.f: posts the ante 22
Burton Feingold: posts the ante 22
dow_jones4: posts the ante 22
jcarlos.vale: posts the ante 22
phantofant: posts the ante 22
uht25: posts the ante 22
parker1818: posts the ante 22
Louuuu2k: posts the ante 22
yana11169: posts the ante 22
dow_jones4: posts small blind 150
jcarlos.vale: posts big blind 300
*** HOLE CARDS ***
Dealt to jcarlos.vale [4s 2d]
phantofant: folds 
uht25: folds 
parker1818: folds 
Louuuu2k: folds 
yana11169: raises 600 to 900
judith.f: folds 
Burton Feingold: folds 
dow_jones4: folds 
jcarlos.vale: folds 
Uncalled bet (600) returned to yana11169
yana11169 collected 948 from pot
yana11169: doesn't show hand 
*** SUMMARY ***
Total pot 948 | Rake 0 
Seat 1: judith.f folded before Flop (didn't bet)
Seat 2: Burton Feingold (button) folded before Flop (didn't bet)
Seat 3: dow_jones4 (small blind) folded before Flop
Seat 4: jcarlos.vale (big blind) folded before Flop
Seat 5: phantofant folded before Flop (didn't bet)
Seat 6: uht25 folded before Flop (didn't bet)
Seat 7: parker1818 folded before Flop (didn't bet)
Seat 8: Louuuu2k folded before Flop (didn't bet)
Seat 9: yana11169 collected (948)



PokerStars Hand #222702331336: Tournament #3099770291, $0.98+$0.12 USD Hold'em No Limit - Level XI (150/300) - 2021/01/16 21:49:54 EET [2021/01/16 14:49:54 ET]
Table '3099770291 62' 9-max Seat #3 is the button
Seat 1: judith.f (5621 in chips) 
Seat 2: Burton Feingold (917 in chips) 
Seat 3: dow_jones4 (8462 in chips) 
Seat 4: jcarlos.vale (10439 in chips) 
Seat 5: phantofant (3332 in chips) 
Seat 6: uht25 (12653 in chips) 
Seat 7: parker1818 (9327 in chips) 
Seat 8: Louuuu2k (7019 in chips) 
Seat 9: yana11169 (5642 in chips) 
judith.f: posts the ante 22
Burton Feingold: posts the ante 22
dow_jones4: posts the ante 22
jcarlos.vale: posts the ante 22
phantofant: posts the ante 22
uht25: posts the ante 22
parker1818: posts the ante 22
Louuuu2k: posts the ante 22
yana11169: posts the ante 22
jcarlos.vale: posts small blind 150
phantofant: posts big blind 300
*** HOLE CARDS ***
Dealt to jcarlos.vale [6s 4d]
uht25: folds 
parker1818 has timed out
parker1818: folds 
parker1818 is sitting out
Louuuu2k: folds 
yana11169: folds 
parker1818 has returned
judith.f: raises 390 to 690
Burton Feingold: folds 
dow_jones4: folds 
jcarlos.vale: folds 
phantofant: folds 
Uncalled bet (390) returned to judith.f
judith.f collected 948 from pot
judith.f: doesn't show hand 
*** SUMMARY ***
Total pot 948 | Rake 0 
Seat 1: judith.f collected (948)
Seat 2: Burton Feingold folded before Flop (didn't bet)
Seat 3: dow_jones4 (button) folded before Flop (didn't bet)
Seat 4: jcarlos.vale (small blind) folded before Flop
Seat 5: phantofant (big blind) folded before Flop
Seat 6: uht25 folded before Flop (didn't bet)
Seat 7: parker1818 folded before Flop (didn't bet)
Seat 8: Louuuu2k folded before Flop (didn't bet)
Seat 9: yana11169 folded before Flop (didn't bet)



PokerStars Hand #222702364054: Tournament #3099770291, $0.98+$0.12 USD Hold'em No Limit - Level XI (150/300) - 2021/01/16 21:50:33 EET [2021/01/16 14:50:33 ET]
Table '3099770291 62' 9-max Seat #4 is the button
Seat 1: judith.f (6247 in chips) 
Seat 2: Burton Feingold (895 in chips) 
Seat 3: dow_jones4 (8440 in chips) 
Seat 4: jcarlos.vale (10267 in chips) 
Seat 5: phantofant (3010 in chips) 
Seat 6: uht25 (12631 in chips) 
Seat 7: parker1818 (9305 in chips) 
Seat 8: Louuuu2k (6997 in chips) 
Seat 9: yana11169 (5620 in chips) 
judith.f: posts the ante 22
Burton Feingold: posts the ante 22
dow_jones4: posts the ante 22
jcarlos.vale: posts the ante 22
phantofant: posts the ante 22
uht25: posts the ante 22
parker1818: posts the ante 22
Louuuu2k: posts the ante 22
yana11169: posts the ante 22
phantofant: posts small blind 150
uht25: posts big blind 300
*** HOLE CARDS ***
Dealt to jcarlos.vale [Kd Jd]
parker1818: calls 300
Louuuu2k: folds 
yana11169: folds 
judith.f: folds 
Burton Feingold: raises 573 to 873 and is all-in
dow_jones4: folds 
jcarlos.vale: calls 873
phantofant: folds 
uht25: folds 
judith.f is disconnected 
parker1818: calls 573
*** FLOP *** [Ks 3d Td]
parker1818: bets 600
jcarlos.vale: calls 600
*** TURN *** [Ks 3d Td] [Js]
parker1818: checks 
jcarlos.vale: bets 2234
parker1818: folds 
Uncalled bet (2234) returned to jcarlos.vale
*** RIVER *** [Ks 3d Td Js] [Qc]
*** SHOW DOWN ***
jcarlos.vale: shows [Kd Jd] (two pair, Kings and Jacks)
jcarlos.vale collected 1200 from side pot
Burton Feingold: shows [Ah 9s] (a straight, Ten to Ace)
Burton Feingold collected 3267 from main pot
*** SUMMARY ***
Total pot 4467 Main pot 3267. Side pot 1200. | Rake 0 
Board [Ks 3d Td Js Qc]
Seat 1: judith.f folded before Flop (didn't bet)
Seat 2: Burton Feingold showed [Ah 9s] and won (3267) with a straight, Ten to Ace
Seat 3: dow_jones4 folded before Flop (didn't bet)
Seat 4: jcarlos.vale (button) showed [Kd Jd] and won (1200) with two pair, Kings and Jacks
Seat 5: phantofant (small blind) folded before Flop
Seat 6: uht25 (big blind) folded before Flop
Seat 7: parker1818 folded on the Turn
Seat 8: Louuuu2k folded before Flop (didn't bet)
Seat 9: yana11169 folded before Flop (didn't bet)



PokerStars Hand #222702430243: Tournament #3099770291, $0.98+$0.12 USD Hold'em No Limit - Level XI (150/300) - 2021/01/16 21:51:52 EET [2021/01/16 14:51:52 ET]
Table '3099770291 62' 9-max Seat #5 is the button
Seat 1: judith.f (6225 in chips) 
Seat 2: Burton Feingold (3267 in chips) 
Seat 3: dow_jones4 (8418 in chips) 
Seat 4: jcarlos.vale (9972 in chips) 
Seat 5: phantofant (2838 in chips) 
Seat 6: uht25 (12309 in chips) 
Seat 7: parker1818 (7810 in chips) 
Seat 8: Louuuu2k (6975 in chips) 
Seat 9: yana11169 (5598 in chips) 
judith.f: posts the ante 22
Burton Feingold: posts the ante 22
dow_jones4: posts the ante 22
jcarlos.vale: posts the ante 22
phantofant: posts the ante 22
uht25: posts the ante 22
parker1818: posts the ante 22
Louuuu2k: posts the ante 22
yana11169: posts the ante 22
uht25: posts small blind 150
parker1818: posts big blind 300
*** HOLE CARDS ***
Dealt to jcarlos.vale [5h 4s]
Louuuu2k: folds 
yana11169: folds 
judith.f has timed out while disconnected
judith.f: folds 
judith.f is sitting out
Burton Feingold: folds 
judith.f has returned
dow_jones4: folds 
jcarlos.vale: folds 
phantofant: folds 
uht25: folds 
Uncalled bet (150) returned to parker1818
parker1818 collected 498 from pot
parker1818: doesn't show hand 
*** SUMMARY ***
Total pot 498 | Rake 0 
Seat 1: judith.f folded before Flop (didn't bet)
Seat 2: Burton Feingold folded before Flop (didn't bet)
Seat 3: dow_jones4 folded before Flop (didn't bet)
Seat 4: jcarlos.vale folded before Flop (didn't bet)
Seat 5: phantofant (button) folded before Flop (didn't bet)
Seat 6: uht25 (small blind) folded before Flop
Seat 7: parker1818 (big blind) collected (498)
Seat 8: Louuuu2k folded before Flop (didn't bet)
Seat 9: yana11169 folded before Flop (didn't bet)



PokerStars Hand #222702460681: Tournament #3099770291, $0.98+$0.12 USD Hold'em No Limit - Level XI (150/300) - 2021/01/16 21:52:28 EET [2021/01/16 14:52:28 ET]
Table '3099770291 62' 9-max Seat #6 is the button
Seat 1: judith.f (6203 in chips) 
Seat 2: Burton Feingold (3245 in chips) 
Seat 3: dow_jones4 (8396 in chips) 
Seat 4: jcarlos.vale (9950 in chips) 
Seat 5: phantofant (2816 in chips) 
Seat 6: uht25 (12137 in chips) 
Seat 7: parker1818 (8136 in chips) 
Seat 8: Louuuu2k (6953 in chips) 
Seat 9: yana11169 (5576 in chips) 
judith.f: posts the ante 22
Burton Feingold: posts the ante 22
dow_jones4: posts the ante 22
jcarlos.vale: posts the ante 22
phantofant: posts the ante 22
uht25: posts the ante 22
parker1818: posts the ante 22
Louuuu2k: posts the ante 22
yana11169: posts the ante 22
parker1818: posts small blind 150
Louuuu2k: posts big blind 300
*** HOLE CARDS ***
Dealt to jcarlos.vale [Ks 3s]
yana11169: folds 
judith.f: folds 
Burton Feingold: calls 300
dow_jones4 is disconnected 
dow_jones4 has timed out
dow_jones4: folds 
dow_jones4 is sitting out
jcarlos.vale: folds 
phantofant: folds 
uht25: folds 
parker1818: calls 150
Louuuu2k: checks 
*** FLOP *** [6s 8h Kh]
parker1818: checks 
Louuuu2k: bets 362
dow_jones4 has returned
yana11169 is disconnected 
Burton Feingold: folds 
parker1818: folds 
Uncalled bet (362) returned to Louuuu2k
Louuuu2k collected 1098 from pot
Louuuu2k: doesn't show hand 
*** SUMMARY ***
Total pot 1098 | Rake 0 
Board [6s 8h Kh]
Seat 1: judith.f folded before Flop (didn't bet)
Seat 2: Burton Feingold folded on the Flop
Seat 3: dow_jones4 folded before Flop (didn't bet)
Seat 4: jcarlos.vale folded before Flop (didn't bet)
Seat 5: phantofant folded before Flop (didn't bet)
Seat 6: uht25 (button) folded before Flop (didn't bet)
Seat 7: parker1818 (small blind) folded on the Flop
Seat 8: Louuuu2k (big blind) collected (1098)
Seat 9: yana11169 folded before Flop (didn't bet)



PokerStars Hand #222702529842: Tournament #3099770291, $0.98+$0.12 USD Hold'em No Limit - Level XI (150/300) - 2021/01/16 21:53:51 EET [2021/01/16 14:53:51 ET]
Table '3099770291 62' 9-max Seat #7 is the button
Seat 1: judith.f (6181 in chips) 
Seat 2: Burton Feingold (2923 in chips) 
Seat 3: dow_jones4 (8374 in chips) 
Seat 4: jcarlos.vale (9928 in chips) 
Seat 5: phantofant (2794 in chips) 
Seat 6: uht25 (12115 in chips) 
Seat 7: parker1818 (7814 in chips) 
Seat 8: Louuuu2k (7729 in chips) 
Seat 9: yana11169 (5554 in chips) 
judith.f: posts the ante 22
Burton Feingold: posts the ante 22
dow_jones4: posts the ante 22
jcarlos.vale: posts the ante 22
phantofant: posts the ante 22
uht25: posts the ante 22
parker1818: posts the ante 22
Louuuu2k: posts the ante 22
yana11169: posts the ante 22
Louuuu2k: posts small blind 150
yana11169: posts big blind 300
*** HOLE CARDS ***
Dealt to jcarlos.vale [2h Qh]
judith.f: folds 
Burton Feingold: folds 
dow_jones4: raises 300 to 600
jcarlos.vale: folds 
phantofant: folds 
uht25: folds 
parker1818: folds 
Louuuu2k: folds 
yana11169 has timed out while disconnected
yana11169: folds 
yana11169 is sitting out
Uncalled bet (300) returned to dow_jones4
dow_jones4 collected 948 from pot
*** SUMMARY ***
Total pot 948 | Rake 0 
Seat 1: judith.f folded before Flop (didn't bet)
Seat 2: Burton Feingold folded before Flop (didn't bet)
Seat 3: dow_jones4 collected (948)
Seat 4: jcarlos.vale folded before Flop (didn't bet)
Seat 5: phantofant folded before Flop (didn't bet)
Seat 6: uht25 folded before Flop (didn't bet)
Seat 7: parker1818 (button) folded before Flop (didn't bet)
Seat 8: Louuuu2k (small blind) folded before Flop
Seat 9: yana11169 (big blind) folded before Flop



PokerStars Hand #222702556605: Tournament #3099770291, $0.98+$0.12 USD Hold'em No Limit - Level XI (150/300) - 2021/01/16 21:54:23 EET [2021/01/16 14:54:23 ET]
Table '3099770291 62' 9-max Seat #8 is the button
Seat 1: judith.f (6159 in chips) 
Seat 2: Burton Feingold (2901 in chips) 
Seat 3: dow_jones4 (9000 in chips) 
Seat 4: jcarlos.vale (9906 in chips) 
Seat 5: phantofant (2772 in chips) 
Seat 6: uht25 (12093 in chips) 
Seat 7: parker1818 (7792 in chips) 
Seat 8: Louuuu2k (7557 in chips) 
Seat 9: yana11169 (5232 in chips) is sitting out
judith.f: posts the ante 22
Burton Feingold: posts the ante 22
dow_jones4: posts the ante 22
jcarlos.vale: posts the ante 22
phantofant: posts the ante 22
uht25: posts the ante 22
parker1818: posts the ante 22
Louuuu2k: posts the ante 22
yana11169: posts the ante 22
yana11169: posts small blind 150
judith.f: posts big blind 300
*** HOLE CARDS ***
Dealt to jcarlos.vale [3h 6d]
Burton Feingold: folds 
dow_jones4: folds 
jcarlos.vale: folds 
phantofant: calls 300
uht25: folds 
parker1818 has timed out
parker1818: folds 
parker1818 is sitting out
Louuuu2k: folds 
yana11169: folds 
parker1818 has returned
judith.f: checks 
*** FLOP *** [Jc 6h 3d]
yana11169 has returned
judith.f: checks 
phantofant: bets 300
judith.f: folds 
Uncalled bet (300) returned to phantofant
phantofant collected 948 from pot
phantofant: doesn't show hand 
*** SUMMARY ***
Total pot 948 | Rake 0 
Board [Jc 6h 3d]
Seat 1: judith.f (big blind) folded on the Flop
Seat 2: Burton Feingold folded before Flop (didn't bet)
Seat 3: dow_jones4 folded before Flop (didn't bet)
Seat 4: jcarlos.vale folded before Flop (didn't bet)
Seat 5: phantofant collected (948)
Seat 6: uht25 folded before Flop (didn't bet)
Seat 7: parker1818 folded before Flop (didn't bet)
Seat 8: Louuuu2k (button) folded before Flop (didn't bet)
Seat 9: yana11169 (small blind) folded before Flop



PokerStars Hand #222702584530: Tournament #3099770291, $0.98+$0.12 USD Hold'em No Limit - Level XI (150/300) - 2021/01/16 21:54:56 EET [2021/01/16 14:54:56 ET]
Table '3099770291 62' 9-max Seat #9 is the button
Seat 1: judith.f (5837 in chips) 
Seat 2: Burton Feingold (2879 in chips) 
Seat 3: dow_jones4 (8978 in chips) 
Seat 4: jcarlos.vale (9884 in chips) 
Seat 5: phantofant (3398 in chips) 
Seat 6: uht25 (12071 in chips) 
Seat 7: parker1818 (7770 in chips) 
Seat 8: Louuuu2k (7535 in chips) 
Seat 9: yana11169 (5060 in chips) 
judith.f: posts the ante 22
Burton Feingold: posts the ante 22
dow_jones4: posts the ante 22
jcarlos.vale: posts the ante 22
phantofant: posts the ante 22
uht25: posts the ante 22
parker1818: posts the ante 22
Louuuu2k: posts the ante 22
yana11169: posts the ante 22
judith.f: posts small blind 150
Burton Feingold: posts big blind 300
*** HOLE CARDS ***
Dealt to jcarlos.vale [5s Js]
dow_jones4: folds 
jcarlos.vale: folds 
phantofant: folds 
uht25: folds 
parker1818: folds 
Louuuu2k: folds 
yana11169: folds 
judith.f: folds 
Uncalled bet (150) returned to Burton Feingold
Burton Feingold collected 498 from pot
Burton Feingold: doesn't show hand 
*** SUMMARY ***
Total pot 498 | Rake 0 
Seat 1: judith.f (small blind) folded before Flop
Seat 2: Burton Feingold (big blind) collected (498)
Seat 3: dow_jones4 folded before Flop (didn't bet)
Seat 4: jcarlos.vale folded before Flop (didn't bet)
Seat 5: phantofant folded before Flop (didn't bet)
Seat 6: uht25 folded before Flop (didn't bet)
Seat 7: parker1818 folded before Flop (didn't bet)
Seat 8: Louuuu2k folded before Flop (didn't bet)
Seat 9: yana11169 (button) folded before Flop (didn't bet)



PokerStars Hand #222702935448: Tournament #3099770291, $0.98+$0.12 USD Hold'em No Limit - Level XI (150/300) - 2021/01/16 22:03:42 EET [2021/01/16 15:03:42 ET]
Table '3099770291 62' 9-max Seat #1 is the button
Seat 1: judith.f (5665 in chips) 
Seat 2: Burton Feingold (3205 in chips) 
Seat 3: dow_jones4 (8956 in chips) 
Seat 4: jcarlos.vale (9862 in chips) 
Seat 5: phantofant (3376 in chips) 
Seat 6: uht25 (12049 in chips) 
Seat 7: parker1818 (7748 in chips) 
Seat 8: Louuuu2k (7513 in chips) 
Seat 9: yana11169 (5038 in chips) 
judith.f: posts the ante 22
Burton Feingold: posts the ante 22
dow_jones4: posts the ante 22
jcarlos.vale: posts the ante 22
phantofant: posts the ante 22
uht25: posts the ante 22
parker1818: posts the ante 22
Louuuu2k: posts the ante 22
yana11169: posts the ante 22
Burton Feingold: posts small blind 150
dow_jones4: posts big blind 300
*** HOLE CARDS ***
Dealt to jcarlos.vale [Js Kh]
jcarlos.vale: raises 480 to 780
phantofant: folds 
uht25: folds 
parker1818: folds 
Louuuu2k: folds 
yana11169: calls 780
judith.f: folds 
Burton Feingold: folds 
dow_jones4: folds 
*** FLOP *** [3c 7h Ah]
jcarlos.vale: bets 600
yana11169: raises 3636 to 4236 and is all-in
jcarlos.vale: folds 
Uncalled bet (3636) returned to yana11169
yana11169 collected 3408 from pot
yana11169: doesn't show hand 
*** SUMMARY ***
Total pot 3408 | Rake 0 
Board [3c 7h Ah]
Seat 1: judith.f (button) folded before Flop (didn't bet)
Seat 2: Burton Feingold (small blind) folded before Flop
Seat 3: dow_jones4 (big blind) folded before Flop
Seat 4: jcarlos.vale folded on the Flop
Seat 5: phantofant folded before Flop (didn't bet)
Seat 6: uht25 folded before Flop (didn't bet)
Seat 7: parker1818 folded before Flop (didn't bet)
Seat 8: Louuuu2k folded before Flop (didn't bet)
Seat 9: yana11169 collected (3408)



PokerStars Hand #222702972865: Tournament #3099770291, $0.98+$0.12 USD Hold'em No Limit - Level XI (150/300) - 2021/01/16 22:04:24 EET [2021/01/16 15:04:24 ET]
Table '3099770291 62' 9-max Seat #2 is the button
Seat 1: judith.f (5643 in chips) 
Seat 2: Burton Feingold (3033 in chips) 
Seat 3: dow_jones4 (8634 in chips) 
Seat 4: jcarlos.vale (8460 in chips) 
Seat 5: phantofant (3354 in chips) 
Seat 6: uht25 (12027 in chips) 
Seat 7: parker1818 (7726 in chips) 
Seat 8: Louuuu2k (7491 in chips) 
Seat 9: yana11169 (7044 in chips) 
judith.f: posts the ante 22
Burton Feingold: posts the ante 22
dow_jones4: posts the ante 22
jcarlos.vale: posts the ante 22
phantofant: posts the ante 22
uht25: posts the ante 22
parker1818: posts the ante 22
Louuuu2k: posts the ante 22
yana11169: posts the ante 22
dow_jones4: posts small blind 150
jcarlos.vale: posts big blind 300
*** HOLE CARDS ***
Dealt to jcarlos.vale [Ad Ts]
phantofant: folds 
uht25: folds 
parker1818: folds 
Louuuu2k: folds 
yana11169: folds 
judith.f: folds 
Burton Feingold: folds 
dow_jones4: raises 600 to 900
jcarlos.vale: calls 600
*** FLOP *** [5s 7c 2s]
dow_jones4: bets 659
jcarlos.vale: calls 659
*** TURN *** [5s 7c 2s] [Jh]
dow_jones4 has timed out
dow_jones4: checks 
jcarlos.vale: bets 679
dow_jones4 is disconnected 
dow_jones4 has timed out while being disconnected
dow_jones4: folds 
dow_jones4 is sitting out
Uncalled bet (679) returned to jcarlos.vale
jcarlos.vale collected 3316 from pot
jcarlos.vale: doesn't show hand 
*** SUMMARY ***
Total pot 3316 | Rake 0 
Board [5s 7c 2s Jh]
Seat 1: judith.f folded before Flop (didn't bet)
Seat 2: Burton Feingold (button) folded before Flop (didn't bet)
Seat 3: dow_jones4 (small blind) folded on the Turn
Seat 4: jcarlos.vale (big blind) collected (3316)
Seat 5: phantofant folded before Flop (didn't bet)
Seat 6: uht25 folded before Flop (didn't bet)
Seat 7: parker1818 folded before Flop (didn't bet)
Seat 8: Louuuu2k folded before Flop (didn't bet)
Seat 9: yana11169 folded before Flop (didn't bet)



PokerStars Hand #222703086403: Tournament #3099770291, $0.98+$0.12 USD Hold'em No Limit - Level XII (200/400) - 2021/01/16 22:06:16 EET [2021/01/16 15:06:16 ET]
Table '3099770291 62' 9-max Seat #3 is the button
Seat 1: judith.f (5621 in chips) 
Seat 2: Burton Feingold (3011 in chips) 
Seat 3: dow_jones4 (7053 in chips) is sitting out
Seat 4: jcarlos.vale (10195 in chips) 
Seat 5: phantofant (3332 in chips) 
Seat 6: uht25 (12005 in chips) 
Seat 7: parker1818 (7704 in chips) 
Seat 8: Louuuu2k (7469 in chips) 
Seat 9: yana11169 (7022 in chips) 
judith.f: posts the ante 25
Burton Feingold: posts the ante 25
dow_jones4: posts the ante 25
jcarlos.vale: posts the ante 25
phantofant: posts the ante 25
uht25: posts the ante 25
parker1818: posts the ante 25
Louuuu2k: posts the ante 25
yana11169: posts the ante 25
jcarlos.vale: posts small blind 200
phantofant: posts big blind 400
*** HOLE CARDS ***
Dealt to jcarlos.vale [Tc 2d]
uht25: folds 
parker1818: folds 
Louuuu2k: folds 
yana11169: folds 
judith.f: raises 5196 to 5596 and is all-in
Burton Feingold: calls 2986 and is all-in
dow_jones4: folds 
dow_jones4 is disconnected 
jcarlos.vale: folds 
phantofant: folds 
Uncalled bet (2610) returned to judith.f
*** FLOP *** [7d 6c Ah]
*** TURN *** [7d 6c Ah] [Js]
*** RIVER *** [7d 6c Ah Js] [4c]
*** SHOW DOWN ***
judith.f: shows [3d 3h] (a pair of Threes)
Burton Feingold: shows [Ac Jh] (two pair, Aces and Jacks)
Burton Feingold collected 6797 from pot
*** SUMMARY ***
Total pot 6797 | Rake 0 
Board [7d 6c Ah Js 4c]
Seat 1: judith.f showed [3d 3h] and lost with a pair of Threes
Seat 2: Burton Feingold showed [Ac Jh] and won (6797) with two pair, Aces and Jacks
Seat 3: dow_jones4 (button) folded before Flop (didn't bet)
Seat 4: jcarlos.vale (small blind) folded before Flop
Seat 5: phantofant (big blind) folded before Flop
Seat 6: uht25 folded before Flop (didn't bet)
Seat 7: parker1818 folded before Flop (didn't bet)
Seat 8: Louuuu2k folded before Flop (didn't bet)
Seat 9: yana11169 folded before Flop (didn't bet)



PokerStars Hand #222703135936: Tournament #3099770291, $0.98+$0.12 USD Hold'em No Limit - Level XII (200/400) - 2021/01/16 22:07:10 EET [2021/01/16 15:07:10 ET]
Table '3099770291 62' 9-max Seat #4 is the button
Seat 1: judith.f (2610 in chips) 
Seat 2: Burton Feingold (6797 in chips) 
Seat 3: dow_jones4 (7028 in chips) is sitting out
Seat 4: jcarlos.vale (9970 in chips) 
Seat 5: phantofant (2907 in chips) 
Seat 6: uht25 (11980 in chips) 
Seat 7: parker1818 (7679 in chips) 
Seat 8: Louuuu2k (7444 in chips) 
Seat 9: yana11169 (6997 in chips) 
judith.f: posts the ante 25
Burton Feingold: posts the ante 25
dow_jones4: posts the ante 25
jcarlos.vale: posts the ante 25
phantofant: posts the ante 25
uht25: posts the ante 25
parker1818: posts the ante 25
Louuuu2k: posts the ante 25
yana11169: posts the ante 25
phantofant: posts small blind 200
uht25: posts big blind 400
*** HOLE CARDS ***
Dealt to jcarlos.vale [7c Qc]
parker1818: folds 
Louuuu2k: folds 
yana11169: folds 
judith.f: folds 
dow_jones4 has returned
Burton Feingold: calls 400
dow_jones4: folds 
jcarlos.vale: folds 
phantofant: calls 200
uht25: checks 
*** FLOP *** [Ac 5h 5c]
phantofant: checks 
uht25: checks 
Burton Feingold: bets 400
phantofant: folds 
uht25: folds 
Uncalled bet (400) returned to Burton Feingold
Burton Feingold collected 1425 from pot
Burton Feingold: doesn't show hand 
*** SUMMARY ***
Total pot 1425 | Rake 0 
Board [Ac 5h 5c]
Seat 1: judith.f folded before Flop (didn't bet)
Seat 2: Burton Feingold collected (1425)
Seat 3: dow_jones4 folded before Flop (didn't bet)
Seat 4: jcarlos.vale (button) folded before Flop (didn't bet)
Seat 5: phantofant (small blind) folded on the Flop
Seat 6: uht25 (big blind) folded on the Flop
Seat 7: parker1818 folded before Flop (didn't bet)
Seat 8: Louuuu2k folded before Flop (didn't bet)
Seat 9: yana11169 folded before Flop (didn't bet)



PokerStars Hand #222703184623: Tournament #3099770291, $0.98+$0.12 USD Hold'em No Limit - Level XII (200/400) - 2021/01/16 22:08:03 EET [2021/01/16 15:08:03 ET]
Table '3099770291 62' 9-max Seat #5 is the button
Seat 1: judith.f (2585 in chips) 
Seat 2: Burton Feingold (7797 in chips) 
Seat 3: dow_jones4 (7003 in chips) 
Seat 4: jcarlos.vale (9945 in chips) 
Seat 5: phantofant (2482 in chips) 
Seat 6: uht25 (11555 in chips) 
Seat 7: parker1818 (7654 in chips) 
Seat 8: Louuuu2k (7419 in chips) 
Seat 9: yana11169 (6972 in chips) 
judith.f: posts the ante 25
Burton Feingold: posts the ante 25
dow_jones4: posts the ante 25
jcarlos.vale: posts the ante 25
phantofant: posts the ante 25
uht25: posts the ante 25
parker1818: posts the ante 25
Louuuu2k: posts the ante 25
yana11169: posts the ante 25
uht25: posts small blind 200
parker1818: posts big blind 400
*** HOLE CARDS ***
Dealt to jcarlos.vale [2h Kh]
Louuuu2k: folds 
yana11169: folds 
judith.f: folds 
Burton Feingold: folds 
dow_jones4 has timed out
dow_jones4: folds 
dow_jones4 is sitting out
jcarlos.vale: folds 
phantofant: calls 400
dow_jones4 is disconnected 
uht25: calls 200
parker1818: checks 
*** FLOP *** [6d Qs 3s]
uht25: checks 
parker1818: bets 400
phantofant: calls 400
dow_jones4 has returned
uht25: folds 
*** TURN *** [6d Qs 3s] [4h]
parker1818: checks 
phantofant: checks 
*** RIVER *** [6d Qs 3s 4h] [Ks]
parker1818: checks 
phantofant: checks 
*** SHOW DOWN ***
parker1818: shows [As 3h] (a pair of Threes)
phantofant: shows [Ah Ad] (a pair of Aces)
phantofant collected 2225 from pot
*** SUMMARY ***
Total pot 2225 | Rake 0 
Board [6d Qs 3s 4h Ks]
Seat 1: judith.f folded before Flop (didn't bet)
Seat 2: Burton Feingold folded before Flop (didn't bet)
Seat 3: dow_jones4 folded before Flop (didn't bet)
Seat 4: jcarlos.vale folded before Flop (didn't bet)
Seat 5: phantofant (button) showed [Ah Ad] and won (2225) with a pair of Aces
Seat 6: uht25 (small blind) folded on the Flop
Seat 7: parker1818 (big blind) showed [As 3h] and lost with a pair of Threes
Seat 8: Louuuu2k folded before Flop (didn't bet)
Seat 9: yana11169 folded before Flop (didn't bet)



PokerStars Hand #222703253710: Tournament #3099770291, $0.98+$0.12 USD Hold'em No Limit - Level XII (200/400) - 2021/01/16 22:09:18 EET [2021/01/16 15:09:18 ET]
Table '3099770291 62' 9-max Seat #6 is the button
Seat 1: judith.f (2560 in chips) 
Seat 2: Burton Feingold (7772 in chips) 
Seat 3: dow_jones4 (6978 in chips) 
Seat 4: jcarlos.vale (9920 in chips) 
Seat 5: phantofant (3882 in chips) 
Seat 6: uht25 (11130 in chips) 
Seat 7: parker1818 (6829 in chips) 
Seat 8: Louuuu2k (7394 in chips) 
Seat 9: yana11169 (6947 in chips) 
judith.f: posts the ante 25
Burton Feingold: posts the ante 25
dow_jones4: posts the ante 25
jcarlos.vale: posts the ante 25
phantofant: posts the ante 25
uht25: posts the ante 25
parker1818: posts the ante 25
Louuuu2k: posts the ante 25
yana11169: posts the ante 25
parker1818: posts small blind 200
Louuuu2k: posts big blind 400
*** HOLE CARDS ***
Dealt to jcarlos.vale [Kc 5s]
yana11169: folds 
judith.f: folds 
Burton Feingold: folds 
dow_jones4: raises 400 to 800
jcarlos.vale: folds 
phantofant: folds 
uht25: folds 
parker1818: folds 
Louuuu2k: folds 
Uncalled bet (400) returned to dow_jones4
dow_jones4 collected 1225 from pot
dow_jones4: doesn't show hand 
*** SUMMARY ***
Total pot 1225 | Rake 0 
Seat 1: judith.f folded before Flop (didn't bet)
Seat 2: Burton Feingold folded before Flop (didn't bet)
Seat 3: dow_jones4 collected (1225)
Seat 4: jcarlos.vale folded before Flop (didn't bet)
Seat 5: phantofant folded before Flop (didn't bet)
Seat 6: uht25 (button) folded before Flop (didn't bet)
Seat 7: parker1818 (small blind) folded before Flop
Seat 8: Louuuu2k (big blind) folded before Flop
Seat 9: yana11169 folded before Flop (didn't bet)



PokerStars Hand #222703279012: Tournament #3099770291, $0.98+$0.12 USD Hold'em No Limit - Level XII (200/400) - 2021/01/16 22:09:45 EET [2021/01/16 15:09:45 ET]
Table '3099770291 62' 9-max Seat #7 is the button
Seat 1: judith.f (2535 in chips) 
Seat 2: Burton Feingold (7747 in chips) 
Seat 3: dow_jones4 (7778 in chips) 
Seat 4: jcarlos.vale (9895 in chips) 
Seat 5: phantofant (3857 in chips) 
Seat 6: uht25 (11105 in chips) 
Seat 7: parker1818 (6604 in chips) 
Seat 8: Louuuu2k (6969 in chips) 
Seat 9: yana11169 (6922 in chips) 
judith.f: posts the ante 25
Burton Feingold: posts the ante 25
dow_jones4: posts the ante 25
jcarlos.vale: posts the ante 25
phantofant: posts the ante 25
uht25: posts the ante 25
parker1818: posts the ante 25
Louuuu2k: posts the ante 25
yana11169: posts the ante 25
Louuuu2k: posts small blind 200
yana11169: posts big blind 400
*** HOLE CARDS ***
Dealt to jcarlos.vale [8s 7s]
judith.f: folds 
Burton Feingold: calls 400
dow_jones4: folds 
jcarlos.vale: folds 
phantofant: calls 400
uht25: folds 
parker1818: folds 
Louuuu2k: folds 
yana11169: checks 
*** FLOP *** [7c 9h Ah]
yana11169: checks 
Burton Feingold: bets 400
phantofant: calls 400
yana11169: folds 
*** TURN *** [7c 9h Ah] [6d]
Burton Feingold: checks 
phantofant: checks 
*** RIVER *** [7c 9h Ah 6d] [9s]
Burton Feingold: bets 1213
phantofant: calls 1213
*** SHOW DOWN ***
Burton Feingold: shows [Ks Jc] (a pair of Nines)
phantofant: shows [3s 3c] (two pair, Nines and Threes)
phantofant collected 4851 from pot
*** SUMMARY ***
Total pot 4851 | Rake 0 
Board [7c 9h Ah 6d 9s]
Seat 1: judith.f folded before Flop (didn't bet)
Seat 2: Burton Feingold showed [Ks Jc] and lost with a pair of Nines
Seat 3: dow_jones4 folded before Flop (didn't bet)
Seat 4: jcarlos.vale folded before Flop (didn't bet)
Seat 5: phantofant showed [3s 3c] and won (4851) with two pair, Nines and Threes
Seat 6: uht25 folded before Flop (didn't bet)
Seat 7: parker1818 (button) folded before Flop (didn't bet)
Seat 8: Louuuu2k (small blind) folded before Flop
Seat 9: yana11169 (big blind) folded on the Flop



PokerStars Hand #222703352262: Tournament #3099770291, $0.98+$0.12 USD Hold'em No Limit - Level XII (200/400) - 2021/01/16 22:11:05 EET [2021/01/16 15:11:05 ET]
Table '3099770291 62' 9-max Seat #8 is the button
Seat 1: judith.f (2510 in chips) 
Seat 2: Burton Feingold (5709 in chips) 
Seat 3: dow_jones4 (7753 in chips) 
Seat 4: jcarlos.vale (9870 in chips) 
Seat 5: phantofant (6670 in chips) 
Seat 6: uht25 (11080 in chips) 
Seat 7: parker1818 (6579 in chips) 
Seat 8: Louuuu2k (6744 in chips) 
Seat 9: yana11169 (6497 in chips) 
judith.f: posts the ante 25
Burton Feingold: posts the ante 25
dow_jones4: posts the ante 25
jcarlos.vale: posts the ante 25
phantofant: posts the ante 25
uht25: posts the ante 25
parker1818: posts the ante 25
Louuuu2k: posts the ante 25
yana11169: posts the ante 25
yana11169: posts small blind 200
judith.f: posts big blind 400
*** HOLE CARDS ***
Dealt to jcarlos.vale [Ad Ts]
Burton Feingold: calls 400
dow_jones4: folds 
jcarlos.vale: folds 
phantofant: calls 400
uht25: calls 400
parker1818: raises 6154 to 6554 and is all-in
Louuuu2k: folds 
yana11169: folds 
judith.f: folds 
Burton Feingold: folds 
phantofant: folds 
uht25: folds 
Uncalled bet (6154) returned to parker1818
parker1818 collected 2425 from pot
parker1818: doesn't show hand 
*** SUMMARY ***
Total pot 2425 | Rake 0 
Seat 1: judith.f (big blind) folded before Flop
Seat 2: Burton Feingold folded before Flop
Seat 3: dow_jones4 folded before Flop (didn't bet)
Seat 4: jcarlos.vale folded before Flop (didn't bet)
Seat 5: phantofant folded before Flop
Seat 6: uht25 folded before Flop
Seat 7: parker1818 collected (2425)
Seat 8: Louuuu2k (button) folded before Flop (didn't bet)
Seat 9: yana11169 (small blind) folded before Flop



PokerStars Hand #222703386487: Tournament #3099770291, $0.98+$0.12 USD Hold'em No Limit - Level XII (200/400) - 2021/01/16 22:11:41 EET [2021/01/16 15:11:41 ET]
Table '3099770291 62' 9-max Seat #9 is the button
Seat 1: judith.f (2085 in chips) 
Seat 2: Burton Feingold (5284 in chips) 
Seat 3: dow_jones4 (7728 in chips) 
Seat 4: jcarlos.vale (9845 in chips) 
Seat 5: phantofant (6245 in chips) 
Seat 6: uht25 (10655 in chips) 
Seat 7: parker1818 (8579 in chips) 
Seat 8: Louuuu2k (6719 in chips) 
Seat 9: yana11169 (6272 in chips) 
judith.f: posts the ante 25
Burton Feingold: posts the ante 25
dow_jones4: posts the ante 25
jcarlos.vale: posts the ante 25
phantofant: posts the ante 25
uht25: posts the ante 25
parker1818: posts the ante 25
Louuuu2k: posts the ante 25
yana11169: posts the ante 25
judith.f: posts small blind 200
Burton Feingold: posts big blind 400
*** HOLE CARDS ***
Dealt to jcarlos.vale [5d Qd]
dow_jones4: folds 
jcarlos.vale: folds 
phantofant: calls 400
uht25: folds 
parker1818: raises 400 to 800
Louuuu2k: folds 
yana11169: folds 
judith.f: calls 600
Burton Feingold: folds 
phantofant: folds 
*** FLOP *** [3c Qc 8s]
judith.f: checks 
parker1818: bets 400
judith.f: folds 
Uncalled bet (400) returned to parker1818
parker1818 collected 2625 from pot
parker1818: doesn't show hand 
*** SUMMARY ***
Total pot 2625 | Rake 0 
Board [3c Qc 8s]
Seat 1: judith.f (small blind) folded on the Flop
Seat 2: Burton Feingold (big blind) folded before Flop
Seat 3: dow_jones4 folded before Flop (didn't bet)
Seat 4: jcarlos.vale folded before Flop (didn't bet)
Seat 5: phantofant folded before Flop
Seat 6: uht25 folded before Flop (didn't bet)
Seat 7: parker1818 collected (2625)
Seat 8: Louuuu2k folded before Flop (didn't bet)
Seat 9: yana11169 (button) folded before Flop (didn't bet)



PokerStars Hand #222703443717: Tournament #3099770291, $0.98+$0.12 USD Hold'em No Limit - Level XII (200/400) - 2021/01/16 22:12:43 EET [2021/01/16 15:12:43 ET]
Table '3099770291 62' 9-max Seat #1 is the button
Seat 1: judith.f (1260 in chips) 
Seat 2: Burton Feingold (4859 in chips) 
Seat 3: dow_jones4 (7703 in chips) 
Seat 4: jcarlos.vale (9820 in chips) 
Seat 5: phantofant (5820 in chips) 
Seat 6: uht25 (10630 in chips) 
Seat 7: parker1818 (10379 in chips) 
Seat 8: Louuuu2k (6694 in chips) 
Seat 9: yana11169 (6247 in chips) 
judith.f: posts the ante 25
Burton Feingold: posts the ante 25
dow_jones4: posts the ante 25
jcarlos.vale: posts the ante 25
phantofant: posts the ante 25
uht25: posts the ante 25
parker1818: posts the ante 25
Louuuu2k: posts the ante 25
yana11169: posts the ante 25
Burton Feingold: posts small blind 200
dow_jones4: posts big blind 400
*** HOLE CARDS ***
Dealt to jcarlos.vale [Qs 5h]
jcarlos.vale: folds 
phantofant: folds 
uht25: calls 400
parker1818: folds 
Louuuu2k: folds 
yana11169: folds 
judith.f: raises 835 to 1235 and is all-in
Burton Feingold: folds 
dow_jones4: raises 6443 to 7678 and is all-in
uht25: folds 
Uncalled bet (6443) returned to dow_jones4
*** FLOP *** [Jc 4s Kd]
*** TURN *** [Jc 4s Kd] [8d]
*** RIVER *** [Jc 4s Kd 8d] [6c]
*** SHOW DOWN ***
dow_jones4: shows [Kc As] (a pair of Kings)
judith.f: shows [Td Ad] (high card Ace)
dow_jones4 collected 3295 from pot
judith.f finished the tournament in 1224th place
*** SUMMARY ***
Total pot 3295 | Rake 0 
Board [Jc 4s Kd 8d 6c]
Seat 1: judith.f (button) showed [Td Ad] and lost with high card Ace
Seat 2: Burton Feingold (small blind) folded before Flop
Seat 3: dow_jones4 (big blind) showed [Kc As] and won (3295) with a pair of Kings
Seat 4: jcarlos.vale folded before Flop (didn't bet)
Seat 5: phantofant folded before Flop (didn't bet)
Seat 6: uht25 folded before Flop
Seat 7: parker1818 folded before Flop (didn't bet)
Seat 8: Louuuu2k folded before Flop (didn't bet)
Seat 9: yana11169 folded before Flop (didn't bet)



PokerStars Hand #222703480597: Tournament #3099770291, $0.98+$0.12 USD Hold'em No Limit - Level XII (200/400) - 2021/01/16 22:13:23 EET [2021/01/16 15:13:23 ET]
Table '3099770291 62' 9-max Seat #2 is the button
Seat 2: Burton Feingold (4634 in chips) 
Seat 3: dow_jones4 (9738 in chips) 
Seat 4: jcarlos.vale (9795 in chips) 
Seat 5: phantofant (5795 in chips) 
Seat 6: uht25 (10205 in chips) 
Seat 7: parker1818 (10354 in chips) 
Seat 8: Louuuu2k (6669 in chips) 
Seat 9: yana11169 (6222 in chips) 
Burton Feingold: posts the ante 25
dow_jones4: posts the ante 25
jcarlos.vale: posts the ante 25
phantofant: posts the ante 25
uht25: posts the ante 25
parker1818: posts the ante 25
Louuuu2k: posts the ante 25
yana11169: posts the ante 25
dow_jones4: posts small blind 200
jcarlos.vale: posts big blind 400
*** HOLE CARDS ***
Dealt to jcarlos.vale [Ac 4s]
phantofant: folds 
uht25: folds 
parker1818: folds 
Louuuu2k: raises 400 to 800
yana11169: folds 
Burton Feingold: folds 
dow_jones4: folds 
jcarlos.vale: folds 
Uncalled bet (400) returned to Louuuu2k
Louuuu2k collected 1200 from pot
Louuuu2k: doesn't show hand 
*** SUMMARY ***
Total pot 1200 | Rake 0 
Seat 2: Burton Feingold (button) folded before Flop (didn't bet)
Seat 3: dow_jones4 (small blind) folded before Flop
Seat 4: jcarlos.vale (big blind) folded before Flop
Seat 5: phantofant folded before Flop (didn't bet)
Seat 6: uht25 folded before Flop (didn't bet)
Seat 7: parker1818 folded before Flop (didn't bet)
Seat 8: Louuuu2k collected (1200)
Seat 9: yana11169 folded before Flop (didn't bet)



PokerStars Hand #222703502261: Tournament #3099770291, $0.98+$0.12 USD Hold'em No Limit - Level XII (200/400) - 2021/01/16 22:13:46 EET [2021/01/16 15:13:46 ET]
Table '3099770291 62' 9-max Seat #3 is the button
Seat 1: dregan1 (10498 in chips) 
Seat 2: Burton Feingold (4609 in chips) 
Seat 3: dow_jones4 (9513 in chips) 
Seat 4: jcarlos.vale (9370 in chips) 
Seat 5: phantofant (5770 in chips) 
Seat 6: uht25 (10180 in chips) 
Seat 7: parker1818 (10329 in chips) 
Seat 8: Louuuu2k (7444 in chips) 
Seat 9: yana11169 (6197 in chips) 
dregan1: posts the ante 25
Burton Feingold: posts the ante 25
dow_jones4: posts the ante 25
jcarlos.vale: posts the ante 25
phantofant: posts the ante 25
uht25: posts the ante 25
parker1818: posts the ante 25
Louuuu2k: posts the ante 25
yana11169: posts the ante 25
jcarlos.vale: posts small blind 200
phantofant: posts big blind 400
*** HOLE CARDS ***
Dealt to jcarlos.vale [Th Jh]
uht25: folds 
parker1818: raises 400 to 800
Louuuu2k: folds 
yana11169: folds 
dregan1: folds 
Burton Feingold: folds 
dow_jones4: folds 
jcarlos.vale: calls 600
phantofant: folds 
*** FLOP *** [2c Td 5s]
jcarlos.vale: bets 1669
parker1818: folds 
Uncalled bet (1669) returned to jcarlos.vale
jcarlos.vale collected 2225 from pot
jcarlos.vale: doesn't show hand 
*** SUMMARY ***
Total pot 2225 | Rake 0 
Board [2c Td 5s]
Seat 1: dregan1 folded before Flop (didn't bet)
Seat 2: Burton Feingold folded before Flop (didn't bet)
Seat 3: dow_jones4 (button) folded before Flop (didn't bet)
Seat 4: jcarlos.vale (small blind) collected (2225)
Seat 5: phantofant (big blind) folded before Flop
Seat 6: uht25 folded before Flop (didn't bet)
Seat 7: parker1818 folded on the Flop
Seat 8: Louuuu2k folded before Flop (didn't bet)
Seat 9: yana11169 folded before Flop (didn't bet)



PokerStars Hand #222703543263: Tournament #3099770291, $0.98+$0.12 USD Hold'em No Limit - Level XII (200/400) - 2021/01/16 22:14:30 EET [2021/01/16 15:14:30 ET]
Table '3099770291 62' 9-max Seat #4 is the button
Seat 1: dregan1 (10473 in chips) 
Seat 2: Burton Feingold (4584 in chips) 
Seat 3: dow_jones4 (9488 in chips) 
Seat 4: jcarlos.vale (10770 in chips) 
Seat 5: phantofant (5345 in chips) 
Seat 6: uht25 (10155 in chips) 
Seat 7: parker1818 (9504 in chips) 
Seat 8: Louuuu2k (7419 in chips) 
Seat 9: yana11169 (6172 in chips) 
dregan1: posts the ante 25
Burton Feingold: posts the ante 25
dow_jones4: posts the ante 25
jcarlos.vale: posts the ante 25
phantofant: posts the ante 25
uht25: posts the ante 25
parker1818: posts the ante 25
Louuuu2k: posts the ante 25
yana11169: posts the ante 25
phantofant: posts small blind 200
uht25: posts big blind 400
*** HOLE CARDS ***
Dealt to jcarlos.vale [3s Kc]
parker1818: calls 400
Louuuu2k: raises 800 to 1200
yana11169: folds 
dregan1: folds 
Burton Feingold: calls 1200
dow_jones4: folds 
jcarlos.vale: folds 
phantofant: folds 
uht25: calls 800
parker1818: folds 
*** FLOP *** [7c Td 8d]
uht25: checks 
Louuuu2k: checks 
Burton Feingold: bets 2213
uht25: folds 
Louuuu2k: raises 2213 to 4426
Burton Feingold: calls 1146 and is all-in
Uncalled bet (1067) returned to Louuuu2k
*** TURN *** [7c Td 8d] [Js]
*** RIVER *** [7c Td 8d Js] [Kh]
*** SHOW DOWN ***
Louuuu2k: shows [Ad Jc] (a pair of Jacks)
Burton Feingold: shows [3h 3c] (a pair of Threes)
Louuuu2k collected 11143 from pot
Burton Feingold finished the tournament in 1178th place
*** SUMMARY ***
Total pot 11143 | Rake 0 
Board [7c Td 8d Js Kh]
Seat 1: dregan1 folded before Flop (didn't bet)
Seat 2: Burton Feingold showed [3h 3c] and lost with a pair of Threes
Seat 3: dow_jones4 folded before Flop (didn't bet)
Seat 4: jcarlos.vale (button) folded before Flop (didn't bet)
Seat 5: phantofant (small blind) folded before Flop
Seat 6: uht25 (big blind) folded on the Flop
Seat 7: parker1818 folded before Flop
Seat 8: Louuuu2k showed [Ad Jc] and won (11143) with a pair of Jacks
Seat 9: yana11169 folded before Flop (didn't bet)



PokerStars Hand #222703608537: Tournament #3099770291, $0.98+$0.12 USD Hold'em No Limit - Level XII (200/400) - 2021/01/16 22:15:39 EET [2021/01/16 15:15:39 ET]
Table '3099770291 62' 9-max Seat #5 is the button
Seat 1: dregan1 (10448 in chips) 
Seat 3: dow_jones4 (9463 in chips) 
Seat 4: jcarlos.vale (10745 in chips) 
Seat 5: phantofant (5120 in chips) 
Seat 6: uht25 (8930 in chips) 
Seat 7: parker1818 (9079 in chips) 
Seat 8: Louuuu2k (13978 in chips) 
Seat 9: yana11169 (6147 in chips) 
dregan1: posts the ante 25
dow_jones4: posts the ante 25
jcarlos.vale: posts the ante 25
phantofant: posts the ante 25
uht25: posts the ante 25
parker1818: posts the ante 25
Louuuu2k: posts the ante 25
yana11169: posts the ante 25
uht25: posts small blind 200
parker1818: posts big blind 400
*** HOLE CARDS ***
Dealt to jcarlos.vale [3s Ts]
Louuuu2k: raises 472 to 872
yana11169: folds 
dregan1: folds 
dow_jones4: folds 
jcarlos.vale: folds 
phantofant: folds 
uht25: folds 
parker1818: folds 
Uncalled bet (472) returned to Louuuu2k
Louuuu2k collected 1200 from pot
Louuuu2k: doesn't show hand 
*** SUMMARY ***
Total pot 1200 | Rake 0 
Seat 1: dregan1 folded before Flop (didn't bet)
Seat 3: dow_jones4 folded before Flop (didn't bet)
Seat 4: jcarlos.vale folded before Flop (didn't bet)
Seat 5: phantofant (button) folded before Flop (didn't bet)
Seat 6: uht25 (small blind) folded before Flop
Seat 7: parker1818 (big blind) folded before Flop
Seat 8: Louuuu2k collected (1200)
Seat 9: yana11169 folded before Flop (didn't bet)



PokerStars Hand #222703630662: Tournament #3099770291, $0.98+$0.12 USD Hold'em No Limit - Level XII (200/400) - 2021/01/16 22:16:03 EET [2021/01/16 15:16:03 ET]
Table '3099770291 62' 9-max Seat #6 is the button
Seat 1: dregan1 (10423 in chips) 
Seat 2: Ajinak (26170 in chips) 
Seat 3: dow_jones4 (9438 in chips) 
Seat 4: jcarlos.vale (10720 in chips) 
Seat 5: phantofant (5095 in chips) 
Seat 6: uht25 (8705 in chips) 
Seat 7: parker1818 (8654 in chips) 
Seat 8: Louuuu2k (14753 in chips) 
Seat 9: yana11169 (6122 in chips) 
dregan1: posts the ante 25
Ajinak: posts the ante 25
dow_jones4: posts the ante 25
jcarlos.vale: posts the ante 25
phantofant: posts the ante 25
uht25: posts the ante 25
parker1818: posts the ante 25
Louuuu2k: posts the ante 25
yana11169: posts the ante 25
parker1818: posts small blind 200
Louuuu2k: posts big blind 400
*** HOLE CARDS ***
Dealt to jcarlos.vale [Th 2c]
yana11169: folds 
dregan1: folds 
Ajinak: folds 
dow_jones4: folds 
jcarlos.vale: folds 
phantofant: calls 400
uht25: folds 
parker1818: raises 8229 to 8629 and is all-in
Louuuu2k: folds 
phantofant: folds 
Uncalled bet (8229) returned to parker1818
parker1818 collected 1425 from pot
parker1818: doesn't show hand 
*** SUMMARY ***
Total pot 1425 | Rake 0 
Seat 1: dregan1 folded before Flop (didn't bet)
Seat 2: Ajinak folded before Flop (didn't bet)
Seat 3: dow_jones4 folded before Flop (didn't bet)
Seat 4: jcarlos.vale folded before Flop (didn't bet)
Seat 5: phantofant folded before Flop
Seat 6: uht25 (button) folded before Flop (didn't bet)
Seat 7: parker1818 (small blind) collected (1425)
Seat 8: Louuuu2k (big blind) folded before Flop
Seat 9: yana11169 folded before Flop (didn't bet)



PokerStars Hand #222703662526: Tournament #3099770291, $0.98+$0.12 USD Hold'em No Limit - Level XIII (250/500) - 2021/01/16 22:16:37 EET [2021/01/16 15:16:37 ET]
Table '3099770291 62' 9-max Seat #7 is the button
Seat 1: dregan1 (10398 in chips) 
Seat 2: Ajinak (26145 in chips) 
Seat 3: dow_jones4 (9413 in chips) 
Seat 4: jcarlos.vale (10695 in chips) 
Seat 5: phantofant (4670 in chips) 
Seat 6: uht25 (8680 in chips) 
Seat 7: parker1818 (9654 in chips) 
Seat 8: Louuuu2k (14328 in chips) 
Seat 9: yana11169 (6097 in chips) 
dregan1: posts the ante 30
Ajinak: posts the ante 30
dow_jones4: posts the ante 30
jcarlos.vale: posts the ante 30
phantofant: posts the ante 30
uht25: posts the ante 30
parker1818: posts the ante 30
Louuuu2k: posts the ante 30
yana11169: posts the ante 30
Louuuu2k: posts small blind 250
yana11169: posts big blind 500
*** HOLE CARDS ***
Dealt to jcarlos.vale [6d 6s]
dregan1: folds 
Ajinak: raises 600 to 1100
dow_jones4: folds 
jcarlos.vale: folds 
phantofant: calls 1100
uht25: folds 
parker1818: folds 
Louuuu2k: folds 
yana11169: folds 
*** FLOP *** [Qc 3d Qd]
Ajinak: bets 2500
phantofant: folds 
Uncalled bet (2500) returned to Ajinak
Ajinak collected 3220 from pot
*** SUMMARY ***
Total pot 3220 | Rake 0 
Board [Qc 3d Qd]
Seat 1: dregan1 folded before Flop (didn't bet)
Seat 2: Ajinak collected (3220)
Seat 3: dow_jones4 folded before Flop (didn't bet)
Seat 4: jcarlos.vale folded before Flop (didn't bet)
Seat 5: phantofant folded on the Flop
Seat 6: uht25 folded before Flop (didn't bet)
Seat 7: parker1818 (button) folded before Flop (didn't bet)
Seat 8: Louuuu2k (small blind) folded before Flop
Seat 9: yana11169 (big blind) folded before Flop



PokerStars Hand #222703703457: Tournament #3099770291, $0.98+$0.12 USD Hold'em No Limit - Level XIII (250/500) - 2021/01/16 22:17:21 EET [2021/01/16 15:17:21 ET]
Table '3099770291 62' 9-max Seat #8 is the button
Seat 1: dregan1 (10368 in chips) 
Seat 2: Ajinak (28235 in chips) 
Seat 3: dow_jones4 (9383 in chips) 
Seat 4: jcarlos.vale (10665 in chips) 
Seat 5: phantofant (3540 in chips) 
Seat 6: uht25 (8650 in chips) 
Seat 7: parker1818 (9624 in chips) 
Seat 8: Louuuu2k (14048 in chips) 
Seat 9: yana11169 (5567 in chips) 
dregan1: posts the ante 30
Ajinak: posts the ante 30
dow_jones4: posts the ante 30
jcarlos.vale: posts the ante 30
phantofant: posts the ante 30
uht25: posts the ante 30
parker1818: posts the ante 30
Louuuu2k: posts the ante 30
yana11169: posts the ante 30
yana11169: posts small blind 250
dregan1: posts big blind 500
*** HOLE CARDS ***
Dealt to jcarlos.vale [Ah 2h]
Ajinak: folds 
dow_jones4: folds 
jcarlos.vale: folds 
phantofant: calls 500
uht25: folds 
parker1818: calls 500
Louuuu2k: folds 
yana11169: folds 
dregan1: checks 
*** FLOP *** [Jc 2s 5h]
dregan1: checks 
phantofant: checks 
parker1818: checks 
*** TURN *** [Jc 2s 5h] [6s]
dregan1: checks 
phantofant: checks 
parker1818: checks 
*** RIVER *** [Jc 2s 5h 6s] [Kd]
dregan1: checks 
phantofant: bets 500
parker1818: folds 
dregan1: folds 
Uncalled bet (500) returned to phantofant
phantofant collected 2020 from pot
phantofant: doesn't show hand 
*** SUMMARY ***
Total pot 2020 | Rake 0 
Board [Jc 2s 5h 6s Kd]
Seat 1: dregan1 (big blind) folded on the River
Seat 2: Ajinak folded before Flop (didn't bet)
Seat 3: dow_jones4 folded before Flop (didn't bet)
Seat 4: jcarlos.vale folded before Flop (didn't bet)
Seat 5: phantofant collected (2020)
Seat 6: uht25 folded before Flop (didn't bet)
Seat 7: parker1818 folded on the River
Seat 8: Louuuu2k (button) folded before Flop (didn't bet)
Seat 9: yana11169 (small blind) folded before Flop



PokerStars Hand #222703742109: Tournament #3099770291, $0.98+$0.12 USD Hold'em No Limit - Level XIII (250/500) - 2021/01/16 22:18:02 EET [2021/01/16 15:18:02 ET]
Table '3099770291 62' 9-max Seat #9 is the button
Seat 1: dregan1 (9838 in chips) 
Seat 2: Ajinak (28205 in chips) 
Seat 3: dow_jones4 (9353 in chips) 
Seat 4: jcarlos.vale (10635 in chips) 
Seat 5: phantofant (5030 in chips) 
Seat 6: uht25 (8620 in chips) 
Seat 7: parker1818 (9094 in chips) 
Seat 8: Louuuu2k (14018 in chips) 
Seat 9: yana11169 (5287 in chips) 
dregan1: posts the ante 30
Ajinak: posts the ante 30
dow_jones4: posts the ante 30
jcarlos.vale: posts the ante 30
phantofant: posts the ante 30
uht25: posts the ante 30
parker1818: posts the ante 30
Louuuu2k: posts the ante 30
yana11169: posts the ante 30
dregan1: posts small blind 250
Ajinak: posts big blind 500
*** HOLE CARDS ***
Dealt to jcarlos.vale [Qc 8s]
dow_jones4: raises 500 to 1000
jcarlos.vale: folds 
phantofant: folds 
uht25: folds 
parker1818: calls 1000
Louuuu2k: folds 
yana11169: folds 
dregan1: folds 
Ajinak: calls 500
*** FLOP *** [7s 9s Jd]
Ajinak: checks 
dow_jones4: checks 
parker1818: checks 
*** TURN *** [7s 9s Jd] [Th]
Ajinak: checks 
dow_jones4: bets 2218
parker1818: folds 
Ajinak: raises 24957 to 27175 and is all-in
dow_jones4: calls 6105 and is all-in
Uncalled bet (18852) returned to Ajinak
*** RIVER *** [7s 9s Jd Th] [4h]
*** SHOW DOWN ***
Ajinak: shows [7d Ts] (two pair, Tens and Sevens)
dow_jones4: shows [8c Ac] (a straight, Seven to Jack)
dow_jones4 collected 20166 from pot
*** SUMMARY ***
Total pot 20166 | Rake 0 
Board [7s 9s Jd Th 4h]
Seat 1: dregan1 (small blind) folded before Flop
Seat 2: Ajinak (big blind) showed [7d Ts] and lost with two pair, Tens and Sevens
Seat 3: dow_jones4 showed [8c Ac] and won (20166) with a straight, Seven to Jack
Seat 4: jcarlos.vale folded before Flop (didn't bet)
Seat 5: phantofant folded before Flop (didn't bet)
Seat 6: uht25 folded before Flop (didn't bet)
Seat 7: parker1818 folded on the Turn
Seat 8: Louuuu2k folded before Flop (didn't bet)
Seat 9: yana11169 (button) folded before Flop (didn't bet)



PokerStars Hand #222703798006: Tournament #3099770291, $0.98+$0.12 USD Hold'em No Limit - Level XIII (250/500) - 2021/01/16 22:19:02 EET [2021/01/16 15:19:02 ET]
Table '3099770291 62' 9-max Seat #1 is the button
Seat 1: dregan1 (9558 in chips) 
Seat 2: Ajinak (18852 in chips) 
Seat 3: dow_jones4 (20166 in chips) 
Seat 4: jcarlos.vale (10605 in chips) 
Seat 5: phantofant (5000 in chips) 
Seat 6: uht25 (8590 in chips) 
Seat 7: parker1818 (8064 in chips) 
Seat 8: Louuuu2k (13988 in chips) 
Seat 9: yana11169 (5257 in chips) 
dregan1: posts the ante 30
Ajinak: posts the ante 30
dow_jones4: posts the ante 30
jcarlos.vale: posts the ante 30
phantofant: posts the ante 30
uht25: posts the ante 30
parker1818: posts the ante 30
Louuuu2k: posts the ante 30
yana11169: posts the ante 30
Ajinak: posts small blind 250
dow_jones4: posts big blind 500
*** HOLE CARDS ***
Dealt to jcarlos.vale [9c Qs]
jcarlos.vale: folds 
phantofant: calls 500
uht25: folds 
parker1818: folds 
Louuuu2k: folds 
yana11169: raises 4727 to 5227 and is all-in
dregan1: folds 
Ajinak: folds 
dow_jones4: folds 
phantofant: folds 
Uncalled bet (4727) returned to yana11169
yana11169 collected 2020 from pot
yana11169: doesn't show hand 
*** SUMMARY ***
Total pot 2020 | Rake 0 
Seat 1: dregan1 (button) folded before Flop (didn't bet)
Seat 2: Ajinak (small blind) folded before Flop
Seat 3: dow_jones4 (big blind) folded before Flop
Seat 4: jcarlos.vale folded before Flop (didn't bet)
Seat 5: phantofant folded before Flop
Seat 6: uht25 folded before Flop (didn't bet)
Seat 7: parker1818 folded before Flop (didn't bet)
Seat 8: Louuuu2k folded before Flop (didn't bet)
Seat 9: yana11169 collected (2020)



PokerStars Hand #222703818616: Tournament #3099770291, $0.98+$0.12 USD Hold'em No Limit - Level XIII (250/500) - 2021/01/16 22:19:24 EET [2021/01/16 15:19:24 ET]
Table '3099770291 62' 9-max Seat #2 is the button
Seat 1: dregan1 (9528 in chips) 
Seat 2: Ajinak (18572 in chips) 
Seat 3: dow_jones4 (19636 in chips) 
Seat 4: jcarlos.vale (10575 in chips) 
Seat 5: phantofant (4470 in chips) 
Seat 6: uht25 (8560 in chips) 
Seat 7: parker1818 (8034 in chips) 
Seat 8: Louuuu2k (13958 in chips) 
Seat 9: yana11169 (6747 in chips) 
dregan1: posts the ante 30
Ajinak: posts the ante 30
dow_jones4: posts the ante 30
jcarlos.vale: posts the ante 30
phantofant: posts the ante 30
uht25: posts the ante 30
parker1818: posts the ante 30
Louuuu2k: posts the ante 30
yana11169: posts the ante 30
dow_jones4: posts small blind 250
jcarlos.vale: posts big blind 500
*** HOLE CARDS ***
Dealt to jcarlos.vale [Ks Qd]
phantofant: calls 500
uht25: folds 
parker1818: folds 
Louuuu2k: folds 
yana11169: folds 
dregan1: folds 
Ajinak: folds 
dow_jones4: folds 
jcarlos.vale: checks 
*** FLOP *** [4c 5h Jd]
jcarlos.vale: checks 
phantofant: checks 
*** TURN *** [4c 5h Jd] [Js]
jcarlos.vale: checks 
phantofant: bets 500
jcarlos.vale: calls 500
*** RIVER *** [4c 5h Jd Js] [6h]
jcarlos.vale: checks 
phantofant: bets 3440 and is all-in
jcarlos.vale: folds 
Uncalled bet (3440) returned to phantofant
phantofant collected 2520 from pot
phantofant: doesn't show hand 
*** SUMMARY ***
Total pot 2520 | Rake 0 
Board [4c 5h Jd Js 6h]
Seat 1: dregan1 folded before Flop (didn't bet)
Seat 2: Ajinak (button) folded before Flop (didn't bet)
Seat 3: dow_jones4 (small blind) folded before Flop
Seat 4: jcarlos.vale (big blind) folded on the River
Seat 5: phantofant collected (2520)
Seat 6: uht25 folded before Flop (didn't bet)
Seat 7: parker1818 folded before Flop (didn't bet)
Seat 8: Louuuu2k folded before Flop (didn't bet)
Seat 9: yana11169 folded before Flop (didn't bet)



PokerStars Hand #222703874252: Tournament #3099770291, $0.98+$0.12 USD Hold'em No Limit - Level XIII (250/500) - 2021/01/16 22:20:23 EET [2021/01/16 15:20:23 ET]
Table '3099770291 62' 9-max Seat #3 is the button
Seat 1: dregan1 (9498 in chips) 
Seat 2: Ajinak (18542 in chips) 
Seat 3: dow_jones4 (19356 in chips) 
Seat 4: jcarlos.vale (9545 in chips) 
Seat 5: phantofant (5960 in chips) 
Seat 6: uht25 (8530 in chips) 
Seat 7: parker1818 (8004 in chips) 
Seat 8: Louuuu2k (13928 in chips) 
Seat 9: yana11169 (6717 in chips) 
dregan1: posts the ante 30
Ajinak: posts the ante 30
dow_jones4: posts the ante 30
jcarlos.vale: posts the ante 30
phantofant: posts the ante 30
uht25: posts the ante 30
parker1818: posts the ante 30
Louuuu2k: posts the ante 30
yana11169: posts the ante 30
jcarlos.vale: posts small blind 250
phantofant: posts big blind 500
*** HOLE CARDS ***
Dealt to jcarlos.vale [7c 4s]
uht25: folds 
parker1818: folds 
Louuuu2k: folds 
yana11169: folds 
dregan1: folds 
Ajinak: folds 
dow_jones4: folds 
jcarlos.vale: folds 
Uncalled bet (250) returned to phantofant
phantofant collected 770 from pot
phantofant: doesn't show hand 
*** SUMMARY ***
Total pot 770 | Rake 0 
Seat 1: dregan1 folded before Flop (didn't bet)
Seat 2: Ajinak folded before Flop (didn't bet)
Seat 3: dow_jones4 (button) folded before Flop (didn't bet)
Seat 4: jcarlos.vale (small blind) folded before Flop
Seat 5: phantofant (big blind) collected (770)
Seat 6: uht25 folded before Flop (didn't bet)
Seat 7: parker1818 folded before Flop (didn't bet)
Seat 8: Louuuu2k folded before Flop (didn't bet)
Seat 9: yana11169 folded before Flop (didn't bet)



PokerStars Hand #222703902924: Tournament #3099770291, $0.98+$0.12 USD Hold'em No Limit - Level XIII (250/500) - 2021/01/16 22:20:53 EET [2021/01/16 15:20:53 ET]
Table '3099770291 62' 9-max Seat #4 is the button
Seat 1: dregan1 (9468 in chips) 
Seat 2: Ajinak (18512 in chips) 
Seat 3: dow_jones4 (19326 in chips) 
Seat 4: jcarlos.vale (9265 in chips) 
Seat 5: phantofant (6450 in chips) 
Seat 6: uht25 (8500 in chips) 
Seat 7: parker1818 (7974 in chips) 
Seat 8: Louuuu2k (13898 in chips) 
Seat 9: yana11169 (6687 in chips) 
dregan1: posts the ante 30
Ajinak: posts the ante 30
dow_jones4: posts the ante 30
jcarlos.vale: posts the ante 30
phantofant: posts the ante 30
uht25: posts the ante 30
parker1818: posts the ante 30
Louuuu2k: posts the ante 30
yana11169: posts the ante 30
phantofant: posts small blind 250
uht25: posts big blind 500
*** HOLE CARDS ***
Dealt to jcarlos.vale [4d 8c]
parker1818: folds 
Louuuu2k: folds 
yana11169: folds 
dregan1: raises 1000 to 1500
Ajinak: folds 
dow_jones4: folds 
jcarlos.vale: folds 
phantofant: folds 
uht25: folds 
Uncalled bet (1000) returned to dregan1
dregan1 collected 1520 from pot
dregan1: doesn't show hand 
*** SUMMARY ***
Total pot 1520 | Rake 0 
Seat 1: dregan1 collected (1520)
Seat 2: Ajinak folded before Flop (didn't bet)
Seat 3: dow_jones4 folded before Flop (didn't bet)
Seat 4: jcarlos.vale (button) folded before Flop (didn't bet)
Seat 5: phantofant (small blind) folded before Flop
Seat 6: uht25 (big blind) folded before Flop
Seat 7: parker1818 folded before Flop (didn't bet)
Seat 8: Louuuu2k folded before Flop (didn't bet)
Seat 9: yana11169 folded before Flop (didn't bet)



PokerStars Hand #222703931575: Tournament #3099770291, $0.98+$0.12 USD Hold'em No Limit - Level XIII (250/500) - 2021/01/16 22:21:24 EET [2021/01/16 15:21:24 ET]
Table '3099770291 62' 9-max Seat #5 is the button
Seat 1: dregan1 (10458 in chips) 
Seat 2: Ajinak (18482 in chips) 
Seat 3: dow_jones4 (19296 in chips) 
Seat 4: jcarlos.vale (9235 in chips) 
Seat 5: phantofant (6170 in chips) 
Seat 6: uht25 (7970 in chips) 
Seat 7: parker1818 (7944 in chips) 
Seat 8: Louuuu2k (13868 in chips) 
Seat 9: yana11169 (6657 in chips) 
dregan1: posts the ante 30
Ajinak: posts the ante 30
dow_jones4: posts the ante 30
jcarlos.vale: posts the ante 30
phantofant: posts the ante 30
uht25: posts the ante 30
parker1818: posts the ante 30
Louuuu2k: posts the ante 30
yana11169: posts the ante 30
uht25: posts small blind 250
parker1818: posts big blind 500
*** HOLE CARDS ***
Dealt to jcarlos.vale [4s 7s]
Louuuu2k: folds 
yana11169: folds 
dregan1: folds 
Ajinak: folds 
dow_jones4: folds 
jcarlos.vale: folds 
phantofant: folds 
uht25: calls 250
parker1818: checks 
*** FLOP *** [6c 8s 2s]
uht25: checks 
parker1818: bets 500
uht25: folds 
Uncalled bet (500) returned to parker1818
parker1818 collected 1270 from pot
parker1818: doesn't show hand 
*** SUMMARY ***
Total pot 1270 | Rake 0 
Board [6c 8s 2s]
Seat 1: dregan1 folded before Flop (didn't bet)
Seat 2: Ajinak folded before Flop (didn't bet)
Seat 3: dow_jones4 folded before Flop (didn't bet)
Seat 4: jcarlos.vale folded before Flop (didn't bet)
Seat 5: phantofant (button) folded before Flop (didn't bet)
Seat 6: uht25 (small blind) folded on the Flop
Seat 7: parker1818 (big blind) collected (1270)
Seat 8: Louuuu2k folded before Flop (didn't bet)
Seat 9: yana11169 folded before Flop (didn't bet)



PokerStars Hand #222703971167: Tournament #3099770291, $0.98+$0.12 USD Hold'em No Limit - Level XIII (250/500) - 2021/01/16 22:22:05 EET [2021/01/16 15:22:05 ET]
Table '3099770291 62' 9-max Seat #6 is the button
Seat 1: dregan1 (10428 in chips) 
Seat 2: Ajinak (18452 in chips) 
Seat 3: dow_jones4 (19266 in chips) 
Seat 4: jcarlos.vale (9205 in chips) 
Seat 5: phantofant (6140 in chips) 
Seat 6: uht25 (7440 in chips) 
Seat 7: parker1818 (8684 in chips) 
Seat 8: Louuuu2k (13838 in chips) 
Seat 9: yana11169 (6627 in chips) 
dregan1: posts the ante 30
Ajinak: posts the ante 30
dow_jones4: posts the ante 30
jcarlos.vale: posts the ante 30
phantofant: posts the ante 30
uht25: posts the ante 30
parker1818: posts the ante 30
Louuuu2k: posts the ante 30
yana11169: posts the ante 30
parker1818: posts small blind 250
Louuuu2k: posts big blind 500
*** HOLE CARDS ***
Dealt to jcarlos.vale [9h 4s]
yana11169: folds 
dregan1: folds 
Ajinak: folds 
dow_jones4: raises 750 to 1250
jcarlos.vale: folds 
phantofant: folds 
uht25: folds 
parker1818: raises 7404 to 8654 and is all-in
Louuuu2k: folds 
dow_jones4: folds 
Uncalled bet (7404) returned to parker1818
parker1818 collected 3270 from pot
parker1818: doesn't show hand 
*** SUMMARY ***
Total pot 3270 | Rake 0 
Seat 1: dregan1 folded before Flop (didn't bet)
Seat 2: Ajinak folded before Flop (didn't bet)
Seat 3: dow_jones4 folded before Flop
Seat 4: jcarlos.vale folded before Flop (didn't bet)
Seat 5: phantofant folded before Flop (didn't bet)
Seat 6: uht25 (button) folded before Flop (didn't bet)
Seat 7: parker1818 (small blind) collected (3270)
Seat 8: Louuuu2k (big blind) folded before Flop
Seat 9: yana11169 folded before Flop (didn't bet)



PokerStars Hand #222704033061: Tournament #3099770291, $0.98+$0.12 USD Hold'em No Limit - Level XIII (250/500) - 2021/01/16 22:23:11 EET [2021/01/16 15:23:11 ET]
Table '3099770291 62' 9-max Seat #7 is the button
Seat 1: dregan1 (10398 in chips) 
Seat 2: Ajinak (18422 in chips) 
Seat 3: dow_jones4 (17986 in chips) 
Seat 4: jcarlos.vale (9175 in chips) 
Seat 5: phantofant (6110 in chips) 
Seat 6: uht25 (7410 in chips) 
Seat 7: parker1818 (10674 in chips) 
Seat 8: Louuuu2k (13308 in chips) 
Seat 9: yana11169 (6597 in chips) 
dregan1: posts the ante 30
Ajinak: posts the ante 30
dow_jones4: posts the ante 30
jcarlos.vale: posts the ante 30
phantofant: posts the ante 30
uht25: posts the ante 30
parker1818: posts the ante 30
Louuuu2k: posts the ante 30
yana11169: posts the ante 30
Louuuu2k: posts small blind 250
yana11169: posts big blind 500
*** HOLE CARDS ***
Dealt to jcarlos.vale [9h Kh]
dregan1: folds 
Ajinak: folds 
dow_jones4: raises 500 to 1000
jcarlos.vale: folds 
phantofant: folds 
uht25: folds 
parker1818: calls 1000
Louuuu2k: folds 
yana11169: folds 
*** FLOP *** [Js Th 7h]
dow_jones4: checks 
parker1818: bets 1812
dow_jones4: calls 1812
*** TURN *** [Js Th 7h] [9c]
dow_jones4: checks 
parker1818: checks 
*** RIVER *** [Js Th 7h 9c] [Qs]
dow_jones4: checks 
parker1818: bets 3986
dow_jones4: raises 11158 to 15144 and is all-in
parker1818: calls 3846 and is all-in
Uncalled bet (7312) returned to dow_jones4
*** SHOW DOWN ***
dow_jones4: shows [Td Kd] (a straight, Nine to King)
parker1818: shows [Qh Kc] (a straight, Nine to King)
dow_jones4 collected 11154 from pot
parker1818 collected 11154 from pot
*** SUMMARY ***
Total pot 22308 | Rake 0 
Board [Js Th 7h 9c Qs]
Seat 1: dregan1 folded before Flop (didn't bet)
Seat 2: Ajinak folded before Flop (didn't bet)
Seat 3: dow_jones4 showed [Td Kd] and won (11154) with a straight, Nine to King
Seat 4: jcarlos.vale folded before Flop (didn't bet)
Seat 5: phantofant folded before Flop (didn't bet)
Seat 6: uht25 folded before Flop (didn't bet)
Seat 7: parker1818 (button) showed [Qh Kc] and won (11154) with a straight, Nine to King
Seat 8: Louuuu2k (small blind) folded before Flop
Seat 9: yana11169 (big blind) folded before Flop



PokerStars Hand #222704117136: Tournament #3099770291, $0.98+$0.12 USD Hold'em No Limit - Level XIII (250/500) - 2021/01/16 22:24:40 EET [2021/01/16 15:24:40 ET]
Table '3099770291 62' 9-max Seat #8 is the button
Seat 1: dregan1 (10368 in chips) 
Seat 2: Ajinak (18392 in chips) 
Seat 3: dow_jones4 (18466 in chips) 
Seat 4: jcarlos.vale (9145 in chips) 
Seat 5: phantofant (6080 in chips) 
Seat 6: uht25 (7380 in chips) 
Seat 7: parker1818 (11154 in chips) 
Seat 8: Louuuu2k (13028 in chips) 
Seat 9: yana11169 (6067 in chips) 
dregan1: posts the ante 30
Ajinak: posts the ante 30
dow_jones4: posts the ante 30
jcarlos.vale: posts the ante 30
phantofant: posts the ante 30
uht25: posts the ante 30
parker1818: posts the ante 30
Louuuu2k: posts the ante 30
yana11169: posts the ante 30
yana11169: posts small blind 250
dregan1: posts big blind 500
*** HOLE CARDS ***
Dealt to jcarlos.vale [6c 8h]
Ajinak: raises 600 to 1100
dow_jones4: folds 
jcarlos.vale: folds 
phantofant: folds 
uht25: calls 1100
parker1818: calls 1100
Louuuu2k: folds 
yana11169: folds 
dregan1: folds 
*** FLOP *** [6d 4d 2c]
Ajinak: bets 1500
uht25: folds 
parker1818: folds 
Uncalled bet (1500) returned to Ajinak
Ajinak collected 4320 from pot
*** SUMMARY ***
Total pot 4320 | Rake 0 
Board [6d 4d 2c]
Seat 1: dregan1 (big blind) folded before Flop
Seat 2: Ajinak collected (4320)
Seat 3: dow_jones4 folded before Flop (didn't bet)
Seat 4: jcarlos.vale folded before Flop (didn't bet)
Seat 5: phantofant folded before Flop (didn't bet)
Seat 6: uht25 folded on the Flop
Seat 7: parker1818 folded on the Flop
Seat 8: Louuuu2k (button) folded before Flop (didn't bet)
Seat 9: yana11169 (small blind) folded before Flop



PokerStars Hand #222704176753: Tournament #3099770291, $0.98+$0.12 USD Hold'em No Limit - Level XIII (250/500) - 2021/01/16 22:25:44 EET [2021/01/16 15:25:44 ET]
Table '3099770291 62' 9-max Seat #9 is the button
Seat 1: dregan1 (9838 in chips) 
Seat 2: Ajinak (21582 in chips) 
Seat 3: dow_jones4 (18436 in chips) 
Seat 4: jcarlos.vale (9115 in chips) 
Seat 5: phantofant (6050 in chips) 
Seat 6: uht25 (6250 in chips) 
Seat 7: parker1818 (10024 in chips) 
Seat 8: Louuuu2k (12998 in chips) 
Seat 9: yana11169 (5787 in chips) 
dregan1: posts the ante 30
Ajinak: posts the ante 30
dow_jones4: posts the ante 30
jcarlos.vale: posts the ante 30
phantofant: posts the ante 30
uht25: posts the ante 30
parker1818: posts the ante 30
Louuuu2k: posts the ante 30
yana11169: posts the ante 30
dregan1: posts small blind 250
Ajinak: posts big blind 500
*** HOLE CARDS ***
Dealt to jcarlos.vale [2c Jh]
dow_jones4: folds 
jcarlos.vale: folds 
phantofant: calls 500
uht25: folds 
parker1818: folds 
Louuuu2k: folds 
yana11169: folds 
dregan1: folds 
Ajinak: checks 
*** FLOP *** [2d 6s 5s]
Ajinak: checks 
phantofant: checks 
*** TURN *** [2d 6s 5s] [As]
Ajinak: checks 
phantofant: checks 
*** RIVER *** [2d 6s 5s As] [5d]
Ajinak: checks 
phantofant: checks 
*** SHOW DOWN ***
Ajinak: shows [Jc 9c] (a pair of Fives)
phantofant: shows [Kd 3c] (a pair of Fives - Ace+King kicker)
phantofant collected 1520 from pot
*** SUMMARY ***
Total pot 1520 | Rake 0 
Board [2d 6s 5s As 5d]
Seat 1: dregan1 (small blind) folded before Flop
Seat 2: Ajinak (big blind) showed [Jc 9c] and lost with a pair of Fives
Seat 3: dow_jones4 folded before Flop (didn't bet)
Seat 4: jcarlos.vale folded before Flop (didn't bet)
Seat 5: phantofant showed [Kd 3c] and won (1520) with a pair of Fives
Seat 6: uht25 folded before Flop (didn't bet)
Seat 7: parker1818 folded before Flop (didn't bet)
Seat 8: Louuuu2k folded before Flop (didn't bet)
Seat 9: yana11169 (button) folded before Flop (didn't bet)



PokerStars Hand #222704236158: Tournament #3099770291, $0.98+$0.12 USD Hold'em No Limit - Level XIV (300/600) - 2021/01/16 22:26:47 EET [2021/01/16 15:26:47 ET]
Table '3099770291 62' 9-max Seat #1 is the button
Seat 1: dregan1 (9558 in chips) 
Seat 2: Ajinak (21052 in chips) 
Seat 3: dow_jones4 (18406 in chips) 
Seat 4: jcarlos.vale (9085 in chips) 
Seat 5: phantofant (7040 in chips) 
Seat 6: uht25 (6220 in chips) 
Seat 7: parker1818 (9994 in chips) 
Seat 8: Louuuu2k (12968 in chips) 
Seat 9: yana11169 (5757 in chips) 
dregan1: posts the ante 40
Ajinak: posts the ante 40
dow_jones4: posts the ante 40
jcarlos.vale: posts the ante 40
phantofant: posts the ante 40
uht25: posts the ante 40
parker1818: posts the ante 40
Louuuu2k: posts the ante 40
yana11169: posts the ante 40
Ajinak: posts small blind 300
dow_jones4: posts big blind 600
*** HOLE CARDS ***
Dealt to jcarlos.vale [6h 7s]
jcarlos.vale: folds 
phantofant: calls 600
uht25: folds 
parker1818: calls 600
Louuuu2k: raises 1800 to 2400
yana11169: folds 
dregan1: folds 
Ajinak: folds 
dow_jones4: folds 
phantofant: calls 1800
parker1818: folds 
*** FLOP *** [Ah 2d Js]
phantofant: checks 
Louuuu2k: bets 1800
phantofant: folds 
Uncalled bet (1800) returned to Louuuu2k
Louuuu2k collected 6660 from pot
Louuuu2k: doesn't show hand 
*** SUMMARY ***
Total pot 6660 | Rake 0 
Board [Ah 2d Js]
Seat 1: dregan1 (button) folded before Flop (didn't bet)
Seat 2: Ajinak (small blind) folded before Flop
Seat 3: dow_jones4 (big blind) folded before Flop
Seat 4: jcarlos.vale folded before Flop (didn't bet)
Seat 5: phantofant folded on the Flop
Seat 6: uht25 folded before Flop (didn't bet)
Seat 7: parker1818 folded before Flop
Seat 8: Louuuu2k collected (6660)
Seat 9: yana11169 folded before Flop (didn't bet)



PokerStars Hand #222704306384: Tournament #3099770291, $0.98+$0.12 USD Hold'em No Limit - Level XIV (300/600) - 2021/01/16 22:28:02 EET [2021/01/16 15:28:02 ET]
Table '3099770291 62' 9-max Seat #2 is the button
Seat 1: dregan1 (9518 in chips) 
Seat 2: Ajinak (20712 in chips) 
Seat 3: dow_jones4 (17766 in chips) 
Seat 4: jcarlos.vale (9045 in chips) 
Seat 5: phantofant (4600 in chips) 
Seat 6: uht25 (6180 in chips) 
Seat 7: parker1818 (9354 in chips) 
Seat 8: Louuuu2k (17188 in chips) 
Seat 9: yana11169 (5717 in chips) 
dregan1: posts the ante 40
Ajinak: posts the ante 40
dow_jones4: posts the ante 40
jcarlos.vale: posts the ante 40
phantofant: posts the ante 40
uht25: posts the ante 40
parker1818: posts the ante 40
Louuuu2k: posts the ante 40
yana11169: posts the ante 40
dow_jones4: posts small blind 300
jcarlos.vale: posts big blind 600
*** HOLE CARDS ***
Dealt to jcarlos.vale [7d 4s]
phantofant: folds 
uht25: folds 
parker1818: folds 
Louuuu2k: raises 648 to 1248
yana11169: folds 
dregan1: folds 
Ajinak: calls 1248
dow_jones4 has timed out
dow_jones4: folds 
dow_jones4 is sitting out
jcarlos.vale: folds 
*** FLOP *** [As Ks 6h]
dow_jones4 has returned
Louuuu2k: checks 
Ajinak: checks 
*** TURN *** [As Ks 6h] [Js]
Louuuu2k: bets 1239
Ajinak: calls 1239
*** RIVER *** [As Ks 6h Js] [Kd]
Louuuu2k: bets 4177
Ajinak: calls 4177
*** SHOW DOWN ***
Louuuu2k: shows [Kc Ac] (a full house, Kings full of Aces)
Ajinak: mucks hand 
Louuuu2k collected 14588 from pot
*** SUMMARY ***
Total pot 14588 | Rake 0 
Board [As Ks 6h Js Kd]
Seat 1: dregan1 folded before Flop (didn't bet)
Seat 2: Ajinak (button) mucked [Tc Ad]
Seat 3: dow_jones4 (small blind) folded before Flop
Seat 4: jcarlos.vale (big blind) folded before Flop
Seat 5: phantofant folded before Flop (didn't bet)
Seat 6: uht25 folded before Flop (didn't bet)
Seat 7: parker1818 folded before Flop (didn't bet)
Seat 8: Louuuu2k showed [Kc Ac] and won (14588) with a full house, Kings full of Aces
Seat 9: yana11169 folded before Flop (didn't bet)



PokerStars Hand #222704362421: Tournament #3099770291, $0.98+$0.12 USD Hold'em No Limit - Level XIV (300/600) - 2021/01/16 22:29:02 EET [2021/01/16 15:29:02 ET]
Table '3099770291 62' 9-max Seat #3 is the button
Seat 1: dregan1 (9478 in chips) 
Seat 2: Ajinak (14008 in chips) 
Seat 3: dow_jones4 (17426 in chips) 
Seat 4: jcarlos.vale (8405 in chips) 
Seat 5: phantofant (4560 in chips) 
Seat 6: uht25 (6140 in chips) 
Seat 7: parker1818 (9314 in chips) 
Seat 8: Louuuu2k (25072 in chips) 
Seat 9: yana11169 (5677 in chips) 
dregan1: posts the ante 40
Ajinak: posts the ante 40
dow_jones4: posts the ante 40
jcarlos.vale: posts the ante 40
phantofant: posts the ante 40
uht25: posts the ante 40
parker1818: posts the ante 40
Louuuu2k: posts the ante 40
yana11169: posts the ante 40
jcarlos.vale: posts small blind 300
phantofant: posts big blind 600
*** HOLE CARDS ***
Dealt to jcarlos.vale [Qd 4c]
uht25: folds 
parker1818: folds 
Louuuu2k: folds 
yana11169: folds 
dregan1: folds 
Ajinak: raises 13368 to 13968 and is all-in
dow_jones4: folds 
jcarlos.vale: folds 
phantofant: folds 
Uncalled bet (13368) returned to Ajinak
Ajinak collected 1860 from pot
*** SUMMARY ***
Total pot 1860 | Rake 0 
Seat 1: dregan1 folded before Flop (didn't bet)
Seat 2: Ajinak collected (1860)
Seat 3: dow_jones4 (button) folded before Flop (didn't bet)
Seat 4: jcarlos.vale (small blind) folded before Flop
Seat 5: phantofant (big blind) folded before Flop
Seat 6: uht25 folded before Flop (didn't bet)
Seat 7: parker1818 folded before Flop (didn't bet)
Seat 8: Louuuu2k folded before Flop (didn't bet)
Seat 9: yana11169 folded before Flop (didn't bet)



PokerStars Hand #222704388693: Tournament #3099770291, $0.98+$0.12 USD Hold'em No Limit - Level XIV (300/600) - 2021/01/16 22:29:31 EET [2021/01/16 15:29:31 ET]
Table '3099770291 62' 9-max Seat #4 is the button
Seat 1: dregan1 (9438 in chips) 
Seat 2: Ajinak (15228 in chips) 
Seat 3: dow_jones4 (17386 in chips) 
Seat 4: jcarlos.vale (8065 in chips) 
Seat 5: phantofant (3920 in chips) 
Seat 6: uht25 (6100 in chips) 
Seat 7: parker1818 (9274 in chips) 
Seat 8: Louuuu2k (25032 in chips) 
Seat 9: yana11169 (5637 in chips) 
dregan1: posts the ante 40
Ajinak: posts the ante 40
dow_jones4: posts the ante 40
jcarlos.vale: posts the ante 40
phantofant: posts the ante 40
uht25: posts the ante 40
parker1818: posts the ante 40
Louuuu2k: posts the ante 40
yana11169: posts the ante 40
phantofant: posts small blind 300
uht25: posts big blind 600
*** HOLE CARDS ***
Dealt to jcarlos.vale [Ts 7h]
parker1818: raises 8634 to 9234 and is all-in
Louuuu2k: folds 
yana11169: folds 
dregan1: folds 
Ajinak: folds 
dow_jones4: folds 
jcarlos.vale: folds 
phantofant: folds 
uht25: folds 
Uncalled bet (8634) returned to parker1818
parker1818 collected 1860 from pot
parker1818: doesn't show hand 
*** SUMMARY ***
Total pot 1860 | Rake 0 
Seat 1: dregan1 folded before Flop (didn't bet)
Seat 2: Ajinak folded before Flop (didn't bet)
Seat 3: dow_jones4 folded before Flop (didn't bet)
Seat 4: jcarlos.vale (button) folded before Flop (didn't bet)
Seat 5: phantofant (small blind) folded before Flop
Seat 6: uht25 (big blind) folded before Flop
Seat 7: parker1818 collected (1860)
Seat 8: Louuuu2k folded before Flop (didn't bet)
Seat 9: yana11169 folded before Flop (didn't bet)



PokerStars Hand #222704413529: Tournament #3099770291, $0.98+$0.12 USD Hold'em No Limit - Level XIV (300/600) - 2021/01/16 22:29:58 EET [2021/01/16 15:29:58 ET]
Table '3099770291 62' 9-max Seat #5 is the button
Seat 1: dregan1 (9398 in chips) 
Seat 2: Ajinak (15188 in chips) 
Seat 3: dow_jones4 (17346 in chips) 
Seat 4: jcarlos.vale (8025 in chips) 
Seat 5: phantofant (3580 in chips) 
Seat 6: uht25 (5460 in chips) 
Seat 7: parker1818 (10494 in chips) 
Seat 8: Louuuu2k (24992 in chips) 
Seat 9: yana11169 (5597 in chips) 
dregan1: posts the ante 40
Ajinak: posts the ante 40
dow_jones4: posts the ante 40
jcarlos.vale: posts the ante 40
phantofant: posts the ante 40
uht25: posts the ante 40
parker1818: posts the ante 40
Louuuu2k: posts the ante 40
yana11169: posts the ante 40
uht25: posts small blind 300
parker1818: posts big blind 600
*** HOLE CARDS ***
Dealt to jcarlos.vale [6c Ad]
Louuuu2k: raises 600 to 1200
yana11169: folds 
dregan1: folds 
Ajinak: folds 
dow_jones4: folds 
jcarlos.vale: folds 
phantofant: folds 
uht25: folds 
parker1818: folds 
Uncalled bet (600) returned to Louuuu2k
Louuuu2k collected 1860 from pot
Louuuu2k: doesn't show hand 
*** SUMMARY ***
Total pot 1860 | Rake 0 
Seat 1: dregan1 folded before Flop (didn't bet)
Seat 2: Ajinak folded before Flop (didn't bet)
Seat 3: dow_jones4 folded before Flop (didn't bet)
Seat 4: jcarlos.vale folded before Flop (didn't bet)
Seat 5: phantofant (button) folded before Flop (didn't bet)
Seat 6: uht25 (small blind) folded before Flop
Seat 7: parker1818 (big blind) folded before Flop
Seat 8: Louuuu2k collected (1860)
Seat 9: yana11169 folded before Flop (didn't bet)



PokerStars Hand #222704431943: Tournament #3099770291, $0.98+$0.12 USD Hold'em No Limit - Level XIV (300/600) - 2021/01/16 22:30:17 EET [2021/01/16 15:30:17 ET]
Table '3099770291 62' 9-max Seat #6 is the button
Seat 1: dregan1 (9358 in chips) 
Seat 2: Ajinak (15148 in chips) 
Seat 3: dow_jones4 (17306 in chips) 
Seat 4: jcarlos.vale (7985 in chips) 
Seat 5: phantofant (3540 in chips) 
Seat 6: uht25 (5120 in chips) 
Seat 7: parker1818 (9854 in chips) 
Seat 8: Louuuu2k (26212 in chips) 
Seat 9: yana11169 (5557 in chips) 
dregan1: posts the ante 40
Ajinak: posts the ante 40
dow_jones4: posts the ante 40
jcarlos.vale: posts the ante 40
phantofant: posts the ante 40
uht25: posts the ante 40
parker1818: posts the ante 40
Louuuu2k: posts the ante 40
yana11169: posts the ante 40
parker1818: posts small blind 300
Louuuu2k: posts big blind 600
*** HOLE CARDS ***
Dealt to jcarlos.vale [2h 4h]
yana11169: folds 
dregan1: folds 
Ajinak: folds 
dow_jones4: raises 600 to 1200
jcarlos.vale: folds 
phantofant: calls 1200
uht25: folds 
parker1818: folds 
Louuuu2k: calls 600
*** FLOP *** [Ts Kc 4s]
Louuuu2k: checks 
dow_jones4: bets 1406
phantofant: folds 
Louuuu2k: calls 1406
*** TURN *** [Ts Kc 4s] [3c]
Louuuu2k: checks 
dow_jones4: bets 4455
Louuuu2k: folds 
Uncalled bet (4455) returned to dow_jones4
dow_jones4 collected 7072 from pot
dow_jones4: doesn't show hand 
*** SUMMARY ***
Total pot 7072 | Rake 0 
Board [Ts Kc 4s 3c]
Seat 1: dregan1 folded before Flop (didn't bet)
Seat 2: Ajinak folded before Flop (didn't bet)
Seat 3: dow_jones4 collected (7072)
Seat 4: jcarlos.vale folded before Flop (didn't bet)
Seat 5: phantofant folded on the Flop
Seat 6: uht25 (button) folded before Flop (didn't bet)
Seat 7: parker1818 (small blind) folded before Flop
Seat 8: Louuuu2k (big blind) folded on the Turn
Seat 9: yana11169 folded before Flop (didn't bet)



PokerStars Hand #222704491049: Tournament #3099770291, $0.98+$0.12 USD Hold'em No Limit - Level XIV (300/600) - 2021/01/16 22:31:19 EET [2021/01/16 15:31:19 ET]
Table '3099770291 62' 9-max Seat #7 is the button
Seat 1: dregan1 (9318 in chips) 
Seat 2: Ajinak (15108 in chips) 
Seat 3: dow_jones4 (21732 in chips) 
Seat 4: jcarlos.vale (7945 in chips) 
Seat 5: phantofant (2300 in chips) 
Seat 6: uht25 (5080 in chips) 
Seat 7: parker1818 (9514 in chips) 
Seat 8: Louuuu2k (23566 in chips) 
Seat 9: yana11169 (5517 in chips) 
dregan1: posts the ante 40
Ajinak: posts the ante 40
dow_jones4: posts the ante 40
jcarlos.vale: posts the ante 40
phantofant: posts the ante 40
uht25: posts the ante 40
parker1818: posts the ante 40
Louuuu2k: posts the ante 40
yana11169: posts the ante 40
Louuuu2k: posts small blind 300
yana11169: posts big blind 600
*** HOLE CARDS ***
Dealt to jcarlos.vale [3d 6h]
dregan1: folds 
Ajinak: folds 
dow_jones4: folds 
jcarlos.vale: folds 
phantofant: folds 
uht25: folds 
parker1818: folds 
Louuuu2k: raises 1200 to 1800
yana11169: folds 
Uncalled bet (1200) returned to Louuuu2k
Louuuu2k collected 1560 from pot
Louuuu2k: doesn't show hand 
*** SUMMARY ***
Total pot 1560 | Rake 0 
Seat 1: dregan1 folded before Flop (didn't bet)
Seat 2: Ajinak folded before Flop (didn't bet)
Seat 3: dow_jones4 folded before Flop (didn't bet)
Seat 4: jcarlos.vale folded before Flop (didn't bet)
Seat 5: phantofant folded before Flop (didn't bet)
Seat 6: uht25 folded before Flop (didn't bet)
Seat 7: parker1818 (button) folded before Flop (didn't bet)
Seat 8: Louuuu2k (small blind) collected (1560)
Seat 9: yana11169 (big blind) folded before Flop



PokerStars Hand #222704534567: Tournament #3099770291, $0.98+$0.12 USD Hold'em No Limit - Level XIV (300/600) - 2021/01/16 22:32:05 EET [2021/01/16 15:32:05 ET]
Table '3099770291 62' 9-max Seat #8 is the button
Seat 1: dregan1 (9278 in chips) 
Seat 2: Ajinak (15068 in chips) 
Seat 3: dow_jones4 (21692 in chips) 
Seat 4: jcarlos.vale (7905 in chips) 
Seat 5: phantofant (2260 in chips) 
Seat 6: uht25 (5040 in chips) 
Seat 7: parker1818 (9474 in chips) 
Seat 8: Louuuu2k (24486 in chips) 
Seat 9: yana11169 (4877 in chips) 
dregan1: posts the ante 40
Ajinak: posts the ante 40
dow_jones4: posts the ante 40
jcarlos.vale: posts the ante 40
phantofant: posts the ante 40
uht25: posts the ante 40
parker1818: posts the ante 40
Louuuu2k: posts the ante 40
yana11169: posts the ante 40
yana11169: posts small blind 300
dregan1: posts big blind 600
*** HOLE CARDS ***
Dealt to jcarlos.vale [Qs 4d]
Ajinak: folds 
dow_jones4: folds 
jcarlos.vale: folds 
phantofant: calls 600
uht25: folds 
parker1818: folds 
Louuuu2k: folds 
yana11169: folds 
dregan1: checks 
*** FLOP *** [Ks Kh Th]
dregan1: checks 
phantofant: bets 600
dregan1: raises 1800 to 2400
phantofant: calls 1020 and is all-in
Uncalled bet (780) returned to dregan1
*** TURN *** [Ks Kh Th] [2s]
*** RIVER *** [Ks Kh Th 2s] [Ad]
*** SHOW DOWN ***
dregan1: shows [Qd Td] (two pair, Kings and Tens)
phantofant: shows [5h 5c] (two pair, Kings and Fives)
dregan1 collected 5100 from pot
phantofant finished the tournament in 858th place
*** SUMMARY ***
Total pot 5100 | Rake 0 
Board [Ks Kh Th 2s Ad]
Seat 1: dregan1 (big blind) showed [Qd Td] and won (5100) with two pair, Kings and Tens
Seat 2: Ajinak folded before Flop (didn't bet)
Seat 3: dow_jones4 folded before Flop (didn't bet)
Seat 4: jcarlos.vale folded before Flop (didn't bet)
Seat 5: phantofant showed [5h 5c] and lost with two pair, Kings and Fives
Seat 6: uht25 folded before Flop (didn't bet)
Seat 7: parker1818 folded before Flop (didn't bet)
Seat 8: Louuuu2k (button) folded before Flop (didn't bet)
Seat 9: yana11169 (small blind) folded before Flop



PokerStars Hand #222704580777: Tournament #3099770291, $0.98+$0.12 USD Hold'em No Limit - Level XIV (300/600) - 2021/01/16 22:32:54 EET [2021/01/16 15:32:54 ET]
Table '3099770291 62' 9-max Seat #9 is the button
Seat 1: dregan1 (12118 in chips) 
Seat 2: Ajinak (15028 in chips) 
Seat 3: dow_jones4 (21652 in chips) 
Seat 4: jcarlos.vale (7865 in chips) 
Seat 6: uht25 (5000 in chips) 
Seat 7: parker1818 (9434 in chips) 
Seat 8: Louuuu2k (24446 in chips) 
Seat 9: yana11169 (4537 in chips) 
dregan1: posts the ante 40
Ajinak: posts the ante 40
dow_jones4: posts the ante 40
jcarlos.vale: posts the ante 40
uht25: posts the ante 40
parker1818: posts the ante 40
Louuuu2k: posts the ante 40
yana11169: posts the ante 40
dregan1: posts small blind 300
Ajinak: posts big blind 600
*** HOLE CARDS ***
Dealt to jcarlos.vale [Jd 5s]
dow_jones4: raises 600 to 1200
jcarlos.vale: folds 
uht25: folds 
parker1818: folds 
Louuuu2k: folds 
yana11169: folds 
dregan1: folds 
Ajinak: calls 600
*** FLOP *** [2h 8c 3h]
Ajinak: checks 
dow_jones4: bets 1419
Ajinak: folds 
Uncalled bet (1419) returned to dow_jones4
dow_jones4 collected 3020 from pot
*** SUMMARY ***
Total pot 3020 | Rake 0 
Board [2h 8c 3h]
Seat 1: dregan1 (small blind) folded before Flop
Seat 2: Ajinak (big blind) folded on the Flop
Seat 3: dow_jones4 collected (3020)
Seat 4: jcarlos.vale folded before Flop (didn't bet)
Seat 6: uht25 folded before Flop (didn't bet)
Seat 7: parker1818 folded before Flop (didn't bet)
Seat 8: Louuuu2k folded before Flop (didn't bet)
Seat 9: yana11169 (button) folded before Flop (didn't bet)



PokerStars Hand #222704613450: Tournament #3099770291, $0.98+$0.12 USD Hold'em No Limit - Level XIV (300/600) - 2021/01/16 22:33:29 EET [2021/01/16 15:33:29 ET]
Table '3099770291 62' 9-max Seat #1 is the button
Seat 1: dregan1 (11778 in chips) 
Seat 2: Ajinak (13788 in chips) 
Seat 3: dow_jones4 (23432 in chips) 
Seat 4: jcarlos.vale (7825 in chips) 
Seat 5: Switc4 (5717 in chips) 
Seat 6: uht25 (4960 in chips) 
Seat 7: parker1818 (9394 in chips) 
Seat 8: Louuuu2k (24406 in chips) 
Seat 9: yana11169 (4497 in chips) 
dregan1: posts the ante 40
Ajinak: posts the ante 40
dow_jones4: posts the ante 40
jcarlos.vale: posts the ante 40
Switc4: posts the ante 40
uht25: posts the ante 40
parker1818: posts the ante 40
Louuuu2k: posts the ante 40
yana11169: posts the ante 40
Ajinak: posts small blind 300
dow_jones4: posts big blind 600
*** HOLE CARDS ***
Dealt to jcarlos.vale [8h 7h]
jcarlos.vale: folds 
Switc4: folds 
uht25: folds 
parker1818: folds 
Louuuu2k: folds 
yana11169: folds 
dregan1: folds 
Ajinak: calls 300
dow_jones4 has timed out
dow_jones4: checks 
*** FLOP *** [2s 8c 4s]
Ajinak: checks 
dow_jones4: bets 600
Ajinak: folds 
Uncalled bet (600) returned to dow_jones4
dow_jones4 collected 1560 from pot
dow_jones4: doesn't show hand 
*** SUMMARY ***
Total pot 1560 | Rake 0 
Board [2s 8c 4s]
Seat 1: dregan1 (button) folded before Flop (didn't bet)
Seat 2: Ajinak (small blind) folded on the Flop
Seat 3: dow_jones4 (big blind) collected (1560)
Seat 4: jcarlos.vale folded before Flop (didn't bet)
Seat 5: Switc4 folded before Flop (didn't bet)
Seat 6: uht25 folded before Flop (didn't bet)
Seat 7: parker1818 folded before Flop (didn't bet)
Seat 8: Louuuu2k folded before Flop (didn't bet)
Seat 9: yana11169 folded before Flop (didn't bet)



PokerStars Hand #222704696344: Tournament #3099770291, $0.98+$0.12 USD Hold'em No Limit - Level XIV (300/600) - 2021/01/16 22:34:54 EET [2021/01/16 15:34:54 ET]
Table '3099770291 62' 9-max Seat #2 is the button
Seat 1: dregan1 (11738 in chips) 
Seat 2: Ajinak (13148 in chips) 
Seat 3: dow_jones4 (24352 in chips) 
Seat 4: jcarlos.vale (7785 in chips) 
Seat 5: Switc4 (5677 in chips) 
Seat 6: uht25 (4920 in chips) 
Seat 7: parker1818 (9354 in chips) 
Seat 8: Louuuu2k (24366 in chips) 
Seat 9: yana11169 (4457 in chips) 
dregan1: posts the ante 40
Ajinak: posts the ante 40
dow_jones4: posts the ante 40
jcarlos.vale: posts the ante 40
Switc4: posts the ante 40
uht25: posts the ante 40
parker1818: posts the ante 40
Louuuu2k: posts the ante 40
yana11169: posts the ante 40
dow_jones4: posts small blind 300
jcarlos.vale: posts big blind 600
*** HOLE CARDS ***
Dealt to jcarlos.vale [As 3h]
Switc4: folds 
uht25: folds 
parker1818: folds 
Louuuu2k: folds 
yana11169: folds 
dregan1: folds 
Ajinak: folds 
dow_jones4: calls 300
jcarlos.vale: raises 7145 to 7745 and is all-in
dow_jones4: folds 
Uncalled bet (7145) returned to jcarlos.vale
jcarlos.vale collected 1560 from pot
jcarlos.vale: doesn't show hand 
*** SUMMARY ***
Total pot 1560 | Rake 0 
Seat 1: dregan1 folded before Flop (didn't bet)
Seat 2: Ajinak (button) folded before Flop (didn't bet)
Seat 3: dow_jones4 (small blind) folded before Flop
Seat 4: jcarlos.vale (big blind) collected (1560)
Seat 5: Switc4 folded before Flop (didn't bet)
Seat 6: uht25 folded before Flop (didn't bet)
Seat 7: parker1818 folded before Flop (didn't bet)
Seat 8: Louuuu2k folded before Flop (didn't bet)
Seat 9: yana11169 folded before Flop (didn't bet)



PokerStars Hand #222704750392: Tournament #3099770291, $0.98+$0.12 USD Hold'em No Limit - Level XIV (300/600) - 2021/01/16 22:35:52 EET [2021/01/16 15:35:52 ET]
Table '3099770291 62' 9-max Seat #3 is the button
Seat 1: dregan1 (11698 in chips) 
Seat 2: Ajinak (13108 in chips) 
Seat 3: dow_jones4 (23712 in chips) 
Seat 4: jcarlos.vale (8705 in chips) 
Seat 5: Switc4 (5637 in chips) 
Seat 6: uht25 (4880 in chips) 
Seat 7: parker1818 (9314 in chips) 
Seat 8: Louuuu2k (24326 in chips) 
Seat 9: yana11169 (4417 in chips) 
dregan1: posts the ante 40
Ajinak: posts the ante 40
dow_jones4: posts the ante 40
jcarlos.vale: posts the ante 40
Switc4: posts the ante 40
uht25: posts the ante 40
parker1818: posts the ante 40
Louuuu2k: posts the ante 40
yana11169: posts the ante 40
jcarlos.vale: posts small blind 300
Switc4: posts big blind 600
*** HOLE CARDS ***
Dealt to jcarlos.vale [5c Qd]
uht25: folds 
parker1818: raises 8674 to 9274 and is all-in
Louuuu2k: folds 
yana11169: folds 
dregan1: folds 
Ajinak: folds 
dow_jones4: folds 
jcarlos.vale: folds 
Switc4: folds 
Uncalled bet (8674) returned to parker1818
parker1818 collected 1860 from pot
parker1818: doesn't show hand 
*** SUMMARY ***
Total pot 1860 | Rake 0 
Seat 1: dregan1 folded before Flop (didn't bet)
Seat 2: Ajinak folded before Flop (didn't bet)
Seat 3: dow_jones4 (button) folded before Flop (didn't bet)
Seat 4: jcarlos.vale (small blind) folded before Flop
Seat 5: Switc4 (big blind) folded before Flop
Seat 6: uht25 folded before Flop (didn't bet)
Seat 7: parker1818 collected (1860)
Seat 8: Louuuu2k folded before Flop (didn't bet)
Seat 9: yana11169 folded before Flop (didn't bet)



PokerStars Hand #222704782098: Tournament #3099770291, $0.98+$0.12 USD Hold'em No Limit - Level XV (350/700) - 2021/01/16 22:36:26 EET [2021/01/16 15:36:26 ET]
Table '3099770291 62' 9-max Seat #4 is the button
Seat 1: dregan1 (11658 in chips) 
Seat 2: Ajinak (13068 in chips) 
Seat 3: dow_jones4 (23672 in chips) 
Seat 4: jcarlos.vale (8365 in chips) 
Seat 5: Switc4 (4997 in chips) 
Seat 6: uht25 (4840 in chips) 
Seat 7: parker1818 (10534 in chips) 
Seat 8: Louuuu2k (24286 in chips) 
Seat 9: yana11169 (4377 in chips) 
dregan1: posts the ante 50
Ajinak: posts the ante 50
dow_jones4: posts the ante 50
jcarlos.vale: posts the ante 50
Switc4: posts the ante 50
uht25: posts the ante 50
parker1818: posts the ante 50
Louuuu2k: posts the ante 50
yana11169: posts the ante 50
Switc4: posts small blind 350
uht25: posts big blind 700
*** HOLE CARDS ***
Dealt to jcarlos.vale [Qh Jh]
parker1818: folds 
Louuuu2k: folds 
yana11169: raises 3627 to 4327 and is all-in
dregan1: folds 
Ajinak: folds 
dow_jones4: folds 
jcarlos.vale: folds 
Switc4: raises 620 to 4947 and is all-in
uht25: folds 
Uncalled bet (620) returned to Switc4
*** FLOP *** [4h 2h Qd]
*** TURN *** [4h 2h Qd] [6d]
*** RIVER *** [4h 2h Qd 6d] [As]
*** SHOW DOWN ***
Switc4: shows [Qs 7s] (a pair of Queens)
yana11169: shows [Ac 9h] (a pair of Aces)
yana11169 collected 9804 from pot
*** SUMMARY ***
Total pot 9804 | Rake 0 
Board [4h 2h Qd 6d As]
Seat 1: dregan1 folded before Flop (didn't bet)
Seat 2: Ajinak folded before Flop (didn't bet)
Seat 3: dow_jones4 folded before Flop (didn't bet)
Seat 4: jcarlos.vale (button) folded before Flop (didn't bet)
Seat 5: Switc4 (small blind) showed [Qs 7s] and lost with a pair of Queens
Seat 6: uht25 (big blind) folded before Flop
Seat 7: parker1818 folded before Flop (didn't bet)
Seat 8: Louuuu2k folded before Flop (didn't bet)
Seat 9: yana11169 showed [Ac 9h] and won (9804) with a pair of Aces



PokerStars Hand #222704820369: Tournament #3099770291, $0.98+$0.12 USD Hold'em No Limit - Level XV (350/700) - 2021/01/16 22:37:07 EET [2021/01/16 15:37:07 ET]
Table '3099770291 62' 9-max Seat #5 is the button
Seat 1: dregan1 (11608 in chips) 
Seat 2: Ajinak (13018 in chips) 
Seat 3: dow_jones4 (23622 in chips) 
Seat 4: jcarlos.vale (8315 in chips) 
Seat 5: Switc4 (620 in chips) 
Seat 6: uht25 (4090 in chips) 
Seat 7: parker1818 (10484 in chips) 
Seat 8: Louuuu2k (24236 in chips) 
Seat 9: yana11169 (9804 in chips) 
dregan1: posts the ante 50
Ajinak: posts the ante 50
dow_jones4: posts the ante 50
jcarlos.vale: posts the ante 50
Switc4: posts the ante 50
uht25: posts the ante 50
parker1818: posts the ante 50
Louuuu2k: posts the ante 50
yana11169: posts the ante 50
uht25: posts small blind 350
parker1818: posts big blind 700
*** HOLE CARDS ***
Dealt to jcarlos.vale [Jc 4d]
Louuuu2k: folds 
yana11169: folds 
dregan1: folds 
Ajinak: folds 
dow_jones4: folds 
jcarlos.vale: folds 
Switc4: calls 570 and is all-in
uht25: calls 350
parker1818 has timed out
parker1818: checks 
*** FLOP *** [Jd 7s Ad]
uht25: checks 
parker1818: bets 9734 and is all-in
uht25: folds 
Uncalled bet (9734) returned to parker1818
*** TURN *** [Jd 7s Ad] [Ac]
*** RIVER *** [Jd 7s Ad Ac] [5h]
*** SHOW DOWN ***
parker1818: shows [Ah Ks] (three of a kind, Aces)
parker1818 collected 260 from side pot
Switc4: shows [8c Ts] (a pair of Aces)
parker1818 collected 2160 from main pot
Switc4 finished the tournament in 793rd place
*** SUMMARY ***
Total pot 2420 Main pot 2160. Side pot 260. | Rake 0 
Board [Jd 7s Ad Ac 5h]
Seat 1: dregan1 folded before Flop (didn't bet)
Seat 2: Ajinak folded before Flop (didn't bet)
Seat 3: dow_jones4 folded before Flop (didn't bet)
Seat 4: jcarlos.vale folded before Flop (didn't bet)
Seat 5: Switc4 (button) showed [8c Ts] and lost with a pair of Aces
Seat 6: uht25 (small blind) folded on the Flop
Seat 7: parker1818 (big blind) showed [Ah Ks] and won (2420) with three of a kind, Aces
Seat 8: Louuuu2k folded before Flop (didn't bet)
Seat 9: yana11169 folded before Flop (didn't bet)



PokerStars Hand #222704912006: Tournament #3099770291, $0.98+$0.12 USD Hold'em No Limit - Level XV (350/700) - 2021/01/16 22:38:38 EET [2021/01/16 15:38:38 ET]
Table '3099770291 22' 9-max Seat #4 is the button
Seat 1: Borameumlk (7926 in chips) 
Seat 2: dvlteams (13979 in chips) 
Seat 3: gazeezy264 (13454 in chips) 
Seat 4: Mightypool2020 (38927 in chips) is sitting out
Seat 5: stefani3112 (13045 in chips) is sitting out
Seat 6: Edyard1000 (31560 in chips) 
Seat 7: callvera63 (14528 in chips) 
Seat 8: ekleraki1918 (36919 in chips) 
Seat 9: jcarlos.vale (8265 in chips) 
Borameumlk: posts the ante 50
dvlteams: posts the ante 50
gazeezy264: posts the ante 50
Mightypool2020: posts the ante 50
stefani3112: posts the ante 50
Edyard1000: posts the ante 50
callvera63: posts the ante 50
ekleraki1918: posts the ante 50
jcarlos.vale: posts the ante 50
stefani3112: posts small blind 350
Edyard1000: posts big blind 700
*** HOLE CARDS ***
Dealt to jcarlos.vale [Ks Qd]
callvera63: folds 
ekleraki1918: folds 
jcarlos.vale: raises 7515 to 8215 and is all-in
Borameumlk: folds 
dvlteams: folds 
gazeezy264: folds 
Mightypool2020: folds 
stefani3112: folds 
Edyard1000: folds 
Uncalled bet (7515) returned to jcarlos.vale
jcarlos.vale collected 2200 from pot
jcarlos.vale: doesn't show hand 
*** SUMMARY ***
Total pot 2200 | Rake 0 
Seat 1: Borameumlk folded before Flop (didn't bet)
Seat 2: dvlteams folded before Flop (didn't bet)
Seat 3: gazeezy264 folded before Flop (didn't bet)
Seat 4: Mightypool2020 (button) folded before Flop (didn't bet)
Seat 5: stefani3112 (small blind) folded before Flop
Seat 6: Edyard1000 (big blind) folded before Flop
Seat 7: callvera63 folded before Flop (didn't bet)
Seat 8: ekleraki1918 folded before Flop (didn't bet)
Seat 9: jcarlos.vale collected (2200)



PokerStars Hand #222704937950: Tournament #3099770291, $0.98+$0.12 USD Hold'em No Limit - Level XV (350/700) - 2021/01/16 22:39:06 EET [2021/01/16 15:39:06 ET]
Table '3099770291 22' 9-max Seat #5 is the button
Seat 1: Borameumlk (7876 in chips) 
Seat 2: dvlteams (13929 in chips) 
Seat 3: gazeezy264 (13404 in chips) 
Seat 4: Mightypool2020 (38877 in chips) is sitting out
Seat 5: stefani3112 (12645 in chips) is sitting out
Seat 6: Edyard1000 (30810 in chips) 
Seat 7: callvera63 (14478 in chips) 
Seat 8: ekleraki1918 (36869 in chips) 
Seat 9: jcarlos.vale (9715 in chips) 
Borameumlk: posts the ante 50
dvlteams: posts the ante 50
gazeezy264: posts the ante 50
Mightypool2020: posts the ante 50
stefani3112: posts the ante 50
Edyard1000: posts the ante 50
callvera63: posts the ante 50
ekleraki1918: posts the ante 50
jcarlos.vale: posts the ante 50
Edyard1000: posts small blind 350
callvera63: posts big blind 700
*** HOLE CARDS ***
Dealt to jcarlos.vale [7s 2d]
ekleraki1918: calls 700
jcarlos.vale: folds 
Mightypool2020 has returned
Borameumlk: folds 
dvlteams: raises 1400 to 2100
gazeezy264: folds 
Mightypool2020: folds 
stefani3112: folds 
Edyard1000: folds 
callvera63: folds 
ekleraki1918: calls 1400
*** FLOP *** [3h 7c 8c]
ekleraki1918: checks 
dvlteams: checks 
*** TURN *** [3h 7c 8c] [6s]
ekleraki1918: checks 
dvlteams: bets 3500
ekleraki1918: folds 
Uncalled bet (3500) returned to dvlteams
dvlteams collected 5700 from pot
*** SUMMARY ***
Total pot 5700 | Rake 0 
Board [3h 7c 8c 6s]
Seat 1: Borameumlk folded before Flop (didn't bet)
Seat 2: dvlteams collected (5700)
Seat 3: gazeezy264 folded before Flop (didn't bet)
Seat 4: Mightypool2020 folded before Flop (didn't bet)
Seat 5: stefani3112 (button) folded before Flop (didn't bet)
Seat 6: Edyard1000 (small blind) folded before Flop
Seat 7: callvera63 (big blind) folded before Flop
Seat 8: ekleraki1918 folded on the Turn
Seat 9: jcarlos.vale folded before Flop (didn't bet)



PokerStars Hand #222704989375: Tournament #3099770291, $0.98+$0.12 USD Hold'em No Limit - Level XV (350/700) - 2021/01/16 22:40:02 EET [2021/01/16 15:40:02 ET]
Table '3099770291 22' 9-max Seat #6 is the button
Seat 1: Borameumlk (7826 in chips) 
Seat 2: dvlteams (17479 in chips) 
Seat 3: gazeezy264 (13354 in chips) 
Seat 4: Mightypool2020 (38827 in chips) 
Seat 5: stefani3112 (12595 in chips) is sitting out
Seat 6: Edyard1000 (30410 in chips) 
Seat 7: callvera63 (13728 in chips) 
Seat 8: ekleraki1918 (34719 in chips) 
Seat 9: jcarlos.vale (9665 in chips) 
Borameumlk: posts the ante 50
dvlteams: posts the ante 50
gazeezy264: posts the ante 50
Mightypool2020: posts the ante 50
stefani3112: posts the ante 50
Edyard1000: posts the ante 50
callvera63: posts the ante 50
ekleraki1918: posts the ante 50
jcarlos.vale: posts the ante 50
callvera63: posts small blind 350
ekleraki1918: posts big blind 700
*** HOLE CARDS ***
Dealt to jcarlos.vale [3s 8s]
jcarlos.vale: folds 
Borameumlk: folds 
dvlteams: folds 
gazeezy264: folds 
Mightypool2020: folds 
stefani3112: folds 
Edyard1000: raises 826 to 1526
callvera63: folds 
ekleraki1918: calls 826
*** FLOP *** [Jc Jh 6h]
ekleraki1918: checks 
Edyard1000: bets 2080
ekleraki1918: calls 2080
*** TURN *** [Jc Jh 6h] [6c]
ekleraki1918: checks 
Edyard1000: checks 
*** RIVER *** [Jc Jh 6h 6c] [3h]
ekleraki1918: bets 2800
Edyard1000: raises 10500 to 13300
ekleraki1918: calls 10500
*** SHOW DOWN ***
Edyard1000: shows [Jd Ad] (a full house, Jacks full of Sixes)
ekleraki1918: mucks hand 
Edyard1000 collected 34612 from pot
*** SUMMARY ***
Total pot 34612 | Rake 0 
Board [Jc Jh 6h 6c 3h]
Seat 1: Borameumlk folded before Flop (didn't bet)
Seat 2: dvlteams folded before Flop (didn't bet)
Seat 3: gazeezy264 folded before Flop (didn't bet)
Seat 4: Mightypool2020 folded before Flop (didn't bet)
Seat 5: stefani3112 folded before Flop (didn't bet)
Seat 6: Edyard1000 (button) showed [Jd Ad] and won (34612) with a full house, Jacks full of Sixes
Seat 7: callvera63 (small blind) folded before Flop
Seat 8: ekleraki1918 (big blind) mucked [Ah 7h]
Seat 9: jcarlos.vale folded before Flop (didn't bet)



PokerStars Hand #222705059871: Tournament #3099770291, $0.98+$0.12 USD Hold'em No Limit - Level XV (350/700) - 2021/01/16 22:41:19 EET [2021/01/16 15:41:19 ET]
Table '3099770291 22' 9-max Seat #7 is the button
Seat 1: Borameumlk (7776 in chips) 
Seat 2: dvlteams (17429 in chips) 
Seat 3: gazeezy264 (13304 in chips) 
Seat 4: Mightypool2020 (38777 in chips) 
Seat 5: stefani3112 (12545 in chips) is sitting out
Seat 6: Edyard1000 (48066 in chips) 
Seat 7: callvera63 (13328 in chips) 
Seat 8: ekleraki1918 (17763 in chips) 
Seat 9: jcarlos.vale (9615 in chips) 
Borameumlk: posts the ante 50
dvlteams: posts the ante 50
gazeezy264: posts the ante 50
Mightypool2020: posts the ante 50
stefani3112: posts the ante 50
Edyard1000: posts the ante 50
callvera63: posts the ante 50
ekleraki1918: posts the ante 50
jcarlos.vale: posts the ante 50
ekleraki1918: posts small blind 350
jcarlos.vale: posts big blind 700
*** HOLE CARDS ***
Dealt to jcarlos.vale [Qh Jd]
Borameumlk: raises 7026 to 7726 and is all-in
dvlteams: folds 
gazeezy264: folds 
Mightypool2020: folds 
stefani3112: folds 
Edyard1000: folds 
callvera63: folds 
ekleraki1918: folds 
jcarlos.vale: folds 
Uncalled bet (7026) returned to Borameumlk
Borameumlk collected 2200 from pot
Borameumlk: doesn't show hand 
*** SUMMARY ***
Total pot 2200 | Rake 0 
Seat 1: Borameumlk collected (2200)
Seat 2: dvlteams folded before Flop (didn't bet)
Seat 3: gazeezy264 folded before Flop (didn't bet)
Seat 4: Mightypool2020 folded before Flop (didn't bet)
Seat 5: stefani3112 folded before Flop (didn't bet)
Seat 6: Edyard1000 folded before Flop (didn't bet)
Seat 7: callvera63 (button) folded before Flop (didn't bet)
Seat 8: ekleraki1918 (small blind) folded before Flop
Seat 9: jcarlos.vale (big blind) folded before Flop



PokerStars Hand #222705090841: Tournament #3099770291, $0.98+$0.12 USD Hold'em No Limit - Level XV (350/700) - 2021/01/16 22:41:53 EET [2021/01/16 15:41:53 ET]
Table '3099770291 22' 9-max Seat #8 is the button
Seat 1: Borameumlk (9226 in chips) 
Seat 2: dvlteams (17379 in chips) 
Seat 3: gazeezy264 (13254 in chips) 
Seat 4: Mightypool2020 (38727 in chips) 
Seat 5: stefani3112 (12495 in chips) is sitting out
Seat 6: Edyard1000 (48016 in chips) 
Seat 7: callvera63 (13278 in chips) 
Seat 8: ekleraki1918 (17363 in chips) 
Seat 9: jcarlos.vale (8865 in chips) 
Borameumlk: posts the ante 50
dvlteams: posts the ante 50
gazeezy264: posts the ante 50
Mightypool2020: posts the ante 50
stefani3112: posts the ante 50
Edyard1000: posts the ante 50
callvera63: posts the ante 50
ekleraki1918: posts the ante 50
jcarlos.vale: posts the ante 50
jcarlos.vale: posts small blind 350
Borameumlk: posts big blind 700
*** HOLE CARDS ***
Dealt to jcarlos.vale [As 4s]
dvlteams: folds 
gazeezy264: folds 
Mightypool2020: folds 
stefani3112: folds 
Edyard1000: folds 
callvera63: folds 
ekleraki1918: calls 700
jcarlos.vale: calls 350
Borameumlk: raises 8476 to 9176 and is all-in
ekleraki1918: folds 
jcarlos.vale: folds 
Uncalled bet (8476) returned to Borameumlk
Borameumlk collected 2550 from pot
*** SUMMARY ***
Total pot 2550 | Rake 0 
Seat 1: Borameumlk (big blind) collected (2550)
Seat 2: dvlteams folded before Flop (didn't bet)
Seat 3: gazeezy264 folded before Flop (didn't bet)
Seat 4: Mightypool2020 folded before Flop (didn't bet)
Seat 5: stefani3112 folded before Flop (didn't bet)
Seat 6: Edyard1000 folded before Flop (didn't bet)
Seat 7: callvera63 folded before Flop (didn't bet)
Seat 8: ekleraki1918 (button) folded before Flop
Seat 9: jcarlos.vale (small blind) folded before Flop



PokerStars Hand #222705132248: Tournament #3099770291, $0.98+$0.12 USD Hold'em No Limit - Level XV (350/700) - 2021/01/16 22:42:38 EET [2021/01/16 15:42:38 ET]
Table '3099770291 22' 9-max Seat #9 is the button
Seat 1: Borameumlk (11026 in chips) 
Seat 2: dvlteams (17329 in chips) 
Seat 3: gazeezy264 (13204 in chips) 
Seat 4: Mightypool2020 (38677 in chips) 
Seat 5: stefani3112 (12445 in chips) is sitting out
Seat 6: Edyard1000 (47966 in chips) 
Seat 7: callvera63 (13228 in chips) 
Seat 8: ekleraki1918 (16613 in chips) 
Seat 9: jcarlos.vale (8115 in chips) 
Borameumlk: posts the ante 50
dvlteams: posts the ante 50
gazeezy264: posts the ante 50
Mightypool2020: posts the ante 50
stefani3112: posts the ante 50
Edyard1000: posts the ante 50
callvera63: posts the ante 50
ekleraki1918: posts the ante 50
jcarlos.vale: posts the ante 50
Borameumlk: posts small blind 350
dvlteams: posts big blind 700
*** HOLE CARDS ***
Dealt to jcarlos.vale [Jd Td]
gazeezy264: folds 
Mightypool2020: folds 
stefani3112: folds 
Edyard1000: folds 
callvera63: folds 
ekleraki1918: calls 700
jcarlos.vale: raises 7365 to 8065 and is all-in
Borameumlk: folds 
dvlteams: folds 
ekleraki1918: calls 7365
*** FLOP *** [Ac Jc 2h]
*** TURN *** [Ac Jc 2h] [6c]
*** RIVER *** [Ac Jc 2h 6c] [3s]
*** SHOW DOWN ***
ekleraki1918: shows [6s Ah] (two pair, Aces and Sixes)
jcarlos.vale: shows [Jd Td] (a pair of Jacks)
ekleraki1918 collected 17630 from pot
jcarlos.vale finished the tournament in 738th place
*** SUMMARY ***
Total pot 17630 | Rake 0 
Board [Ac Jc 2h 6c 3s]
Seat 1: Borameumlk (small blind) folded before Flop
Seat 2: dvlteams (big blind) folded before Flop
Seat 3: gazeezy264 folded before Flop (didn't bet)
Seat 4: Mightypool2020 folded before Flop (didn't bet)
Seat 5: stefani3112 folded before Flop (didn't bet)
Seat 6: Edyard1000 folded before Flop (didn't bet)
Seat 7: callvera63 folded before Flop (didn't bet)
Seat 8: ekleraki1918 showed [6s Ah] and won (17630) with two pair, Aces and Sixes
Seat 9: jcarlos.vale (button) showed [Jd Td] and lost with a pair of Jacks



