PokerStars Hand #220856815323: Tournament #3060068759, $0.23+$0.02 USD Hold'em No Limit - Level I (10/20) - 2020/11/28 0:08:56 EET [2020/11/27 17:08:56 ET]
Table '3060068759 4' 9-max Seat #1 is the button
Seat 1: birdiesmoker (1500 in chips) 
Seat 2: RapHood (1500 in chips) 
Seat 3: Jaacck6 (1500 in chips) 
Seat 4: JokerTonyT (1500 in chips) 
Seat 5: jcarlos.vale (1500 in chips) 
Seat 6: EuroKeeper I (1500 in chips) 
Seat 7: clonharek704 (1500 in chips) 
Seat 8: AyrtonAA95 (1500 in chips) 
Seat 9: (ANEKDOT)777 (1500 in chips) 
birdiesmoker: posts the ante 3
RapHood: posts the ante 3
Jaacck6: posts the ante 3
JokerTonyT: posts the ante 3
jcarlos.vale: posts the ante 3
EuroKeeper I: posts the ante 3
clonharek704: posts the ante 3
AyrtonAA95: posts the ante 3
(ANEKDOT)777: posts the ante 3
RapHood: posts small blind 10
Jaacck6: posts big blind 20
*** HOLE CARDS ***
Dealt to jcarlos.vale [6s Jh]
(ANEKDOT)777 is disconnected 
JokerTonyT: folds 
jcarlos.vale: folds 
EuroKeeper I: folds 
clonharek704: folds 
AyrtonAA95: folds 
(ANEKDOT)777: folds 
birdiesmoker: raises 40 to 60
RapHood: folds 
Jaacck6: calls 40
*** FLOP *** [Js Kh Ac]
Jaacck6: bets 20
birdiesmoker: raises 61 to 81
Jaacck6: raises 319 to 400
birdiesmoker: raises 1037 to 1437 and is all-in
Jaacck6: calls 1037 and is all-in
*** TURN *** [Js Kh Ac] [Kd]
*** RIVER *** [Js Kh Ac Kd] [5c]
*** SHOW DOWN ***
Jaacck6: shows [Jc Ks] (a full house, Kings full of Jacks)
birdiesmoker: shows [As 2h] (two pair, Aces and Kings)
Jaacck6 collected 3031 from pot
birdiesmoker finished the tournament in 45th place
*** SUMMARY ***
Total pot 3031 | Rake 0 
Board [Js Kh Ac Kd 5c]
Seat 1: birdiesmoker (button) showed [As 2h] and lost with two pair, Aces and Kings
Seat 2: RapHood (small blind) folded before Flop
Seat 3: Jaacck6 (big blind) showed [Jc Ks] and won (3031) with a full house, Kings full of Jacks
Seat 4: JokerTonyT folded before Flop (didn't bet)
Seat 5: jcarlos.vale folded before Flop (didn't bet)
Seat 6: EuroKeeper I folded before Flop (didn't bet)
Seat 7: clonharek704 folded before Flop (didn't bet)
Seat 8: AyrtonAA95 folded before Flop (didn't bet)
Seat 9: (ANEKDOT)777 folded before Flop (didn't bet)



PokerStars Hand #220856877000: Tournament #3060068759, $0.23+$0.02 USD Hold'em No Limit - Level I (10/20) - 2020/11/28 0:10:19 EET [2020/11/27 17:10:19 ET]
Table '3060068759 4' 9-max Seat #2 is the button
Seat 2: RapHood (1487 in chips) 
Seat 3: Jaacck6 (3031 in chips) 
Seat 4: JokerTonyT (1497 in chips) 
Seat 5: jcarlos.vale (1497 in chips) 
Seat 6: EuroKeeper I (1497 in chips) 
Seat 7: clonharek704 (1497 in chips) 
Seat 8: AyrtonAA95 (1497 in chips) 
Seat 9: (ANEKDOT)777 (1497 in chips) 
RapHood: posts the ante 3
Jaacck6: posts the ante 3
JokerTonyT: posts the ante 3
jcarlos.vale: posts the ante 3
EuroKeeper I: posts the ante 3
clonharek704: posts the ante 3
AyrtonAA95: posts the ante 3
(ANEKDOT)777: posts the ante 3
Jaacck6: posts small blind 10
JokerTonyT: posts big blind 20
*** HOLE CARDS ***
Dealt to jcarlos.vale [4d Qd]
jcarlos.vale: folds 
EuroKeeper I: folds 
clonharek704: folds 
AyrtonAA95: folds 
(ANEKDOT)777: folds 
RapHood: calls 20
Jaacck6: raises 20 to 40
JokerTonyT: calls 20
RapHood: raises 20 to 60
Jaacck6: calls 20
JokerTonyT: calls 20
*** FLOP *** [6s Qh Jd]
Jaacck6: bets 204
JokerTonyT: folds 
RapHood: calls 204
*** TURN *** [6s Qh Jd] [7h]
Jaacck6: bets 20
RapHood: raises 20 to 40
Jaacck6: calls 20
*** RIVER *** [6s Qh Jd 7h] [Ac]
Jaacck6: bets 692
RapHood said, "kkkkkkkkkkkkkkkkkk"
RapHood: raises 488 to 1180 and is all-in
Jaacck6: calls 488
*** SHOW DOWN ***
RapHood: shows [Ad Ah] (three of a kind, Aces)
Jaacck6: shows [Th As] (a pair of Aces)
RapHood collected 3052 from pot
*** SUMMARY ***
Total pot 3052 | Rake 0 
Board [6s Qh Jd 7h Ac]
Seat 2: RapHood (button) showed [Ad Ah] and won (3052) with three of a kind, Aces
Seat 3: Jaacck6 (small blind) showed [Th As] and lost with a pair of Aces
Seat 4: JokerTonyT (big blind) folded on the Flop
Seat 5: jcarlos.vale folded before Flop (didn't bet)
Seat 6: EuroKeeper I folded before Flop (didn't bet)
Seat 7: clonharek704 folded before Flop (didn't bet)
Seat 8: AyrtonAA95 folded before Flop (didn't bet)
Seat 9: (ANEKDOT)777 folded before Flop (didn't bet)



PokerStars Hand #220856966984: Tournament #3060068759, $0.23+$0.02 USD Hold'em No Limit - Level I (10/20) - 2020/11/28 0:12:14 EET [2020/11/27 17:12:14 ET]
Table '3060068759 4' 9-max Seat #3 is the button
Seat 2: RapHood (3052 in chips) 
Seat 3: Jaacck6 (1544 in chips) 
Seat 4: JokerTonyT (1434 in chips) 
Seat 5: jcarlos.vale (1494 in chips) 
Seat 6: EuroKeeper I (1494 in chips) 
Seat 7: clonharek704 (1494 in chips) 
Seat 8: AyrtonAA95 (1494 in chips) 
Seat 9: (ANEKDOT)777 (1494 in chips) 
RapHood: posts the ante 3
Jaacck6: posts the ante 3
JokerTonyT: posts the ante 3
jcarlos.vale: posts the ante 3
EuroKeeper I: posts the ante 3
clonharek704: posts the ante 3
AyrtonAA95: posts the ante 3
(ANEKDOT)777: posts the ante 3
JokerTonyT: posts small blind 10
jcarlos.vale: posts big blind 20
*** HOLE CARDS ***
Dealt to jcarlos.vale [9c Td]
RapHood said, "kkkkkkkkkkkkkkkkkkkkkkkk"
EuroKeeper I: folds 
clonharek704: folds 
AyrtonAA95: folds 
AyrtonAA95 said, "muy amigo"
AyrtonAA95 said, "hahahaha"
(ANEKDOT)777: raises 40 to 60
RapHood said, "chupa q uva"
RapHood: folds 
Jaacck6: folds 
JokerTonyT: folds 
jcarlos.vale: folds 
Uncalled bet (40) returned to (ANEKDOT)777
(ANEKDOT)777 collected 74 from pot
(ANEKDOT)777: doesn't show hand 
*** SUMMARY ***
Total pot 74 | Rake 0 
Seat 2: RapHood folded before Flop (didn't bet)
Seat 3: Jaacck6 (button) folded before Flop (didn't bet)
Seat 4: JokerTonyT (small blind) folded before Flop
Seat 5: jcarlos.vale (big blind) folded before Flop
Seat 6: EuroKeeper I folded before Flop (didn't bet)
Seat 7: clonharek704 folded before Flop (didn't bet)
Seat 8: AyrtonAA95 folded before Flop (didn't bet)
Seat 9: (ANEKDOT)777 collected (74)



PokerStars Hand #220857007300: Tournament #3060068759, $0.23+$0.02 USD Hold'em No Limit - Level I (10/20) - 2020/11/28 0:13:09 EET [2020/11/27 17:13:09 ET]
Table '3060068759 4' 9-max Seat #4 is the button
Seat 2: RapHood (3049 in chips) 
Seat 3: Jaacck6 (1541 in chips) 
Seat 4: JokerTonyT (1421 in chips) 
Seat 5: jcarlos.vale (1471 in chips) 
Seat 6: EuroKeeper I (1491 in chips) 
Seat 7: clonharek704 (1491 in chips) 
Seat 8: AyrtonAA95 (1491 in chips) 
Seat 9: (ANEKDOT)777 (1545 in chips) 
RapHood: posts the ante 3
Jaacck6: posts the ante 3
JokerTonyT: posts the ante 3
jcarlos.vale: posts the ante 3
EuroKeeper I: posts the ante 3
clonharek704: posts the ante 3
AyrtonAA95: posts the ante 3
(ANEKDOT)777: posts the ante 3
jcarlos.vale: posts small blind 10
EuroKeeper I: posts big blind 20
*** HOLE CARDS ***
Dealt to jcarlos.vale [8s 2d]
clonharek704: folds 
AyrtonAA95: folds 
(ANEKDOT)777: folds 
RapHood: folds 
Jaacck6: folds 
JokerTonyT: raises 30 to 50
jcarlos.vale: folds 
EuroKeeper I: calls 30
*** FLOP *** [7s 6d 5c]
EuroKeeper I: checks 
JokerTonyT: bets 44
EuroKeeper I: raises 136 to 180
JokerTonyT: calls 136
*** TURN *** [7s 6d 5c] [2h]
EuroKeeper I: bets 380
JokerTonyT: folds 
Uncalled bet (380) returned to EuroKeeper I
EuroKeeper I collected 494 from pot
EuroKeeper I: doesn't show hand 
*** SUMMARY ***
Total pot 494 | Rake 0 
Board [7s 6d 5c 2h]
Seat 2: RapHood folded before Flop (didn't bet)
Seat 3: Jaacck6 folded before Flop (didn't bet)
Seat 4: JokerTonyT (button) folded on the Turn
Seat 5: jcarlos.vale (small blind) folded before Flop
Seat 6: EuroKeeper I (big blind) collected (494)
Seat 7: clonharek704 folded before Flop (didn't bet)
Seat 8: AyrtonAA95 folded before Flop (didn't bet)
Seat 9: (ANEKDOT)777 folded before Flop (didn't bet)



PokerStars Hand #220857062013: Tournament #3060068759, $0.23+$0.02 USD Hold'em No Limit - Level I (10/20) - 2020/11/28 0:14:23 EET [2020/11/27 17:14:23 ET]
Table '3060068759 4' 9-max Seat #5 is the button
Seat 2: RapHood (3046 in chips) 
Seat 3: Jaacck6 (1538 in chips) 
Seat 4: JokerTonyT (1188 in chips) 
Seat 5: jcarlos.vale (1458 in chips) 
Seat 6: EuroKeeper I (1752 in chips) 
Seat 7: clonharek704 (1488 in chips) 
Seat 8: AyrtonAA95 (1488 in chips) 
Seat 9: (ANEKDOT)777 (1542 in chips) 
RapHood: posts the ante 3
Jaacck6: posts the ante 3
JokerTonyT: posts the ante 3
jcarlos.vale: posts the ante 3
EuroKeeper I: posts the ante 3
clonharek704: posts the ante 3
AyrtonAA95: posts the ante 3
(ANEKDOT)777: posts the ante 3
EuroKeeper I: posts small blind 10
clonharek704: posts big blind 20
*** HOLE CARDS ***
Dealt to jcarlos.vale [Jc 2s]
AyrtonAA95: folds 
(ANEKDOT)777: folds 
RapHood: calls 20
Jaacck6: folds 
JokerTonyT: folds 
jcarlos.vale: folds 
EuroKeeper I: folds 
clonharek704: checks 
*** FLOP *** [6d Kd 7d]
clonharek704: checks 
RapHood: checks 
*** TURN *** [6d Kd 7d] [6c]
clonharek704: checks 
RapHood: checks 
*** RIVER *** [6d Kd 7d 6c] [Ts]
clonharek704: checks 
RapHood: checks 
*** SHOW DOWN ***
clonharek704: shows [Kh 5c] (two pair, Kings and Sixes)
RapHood: mucks hand 
clonharek704 collected 74 from pot
*** SUMMARY ***
Total pot 74 | Rake 0 
Board [6d Kd 7d 6c Ts]
Seat 2: RapHood mucked [Ah Td]
Seat 3: Jaacck6 folded before Flop (didn't bet)
Seat 4: JokerTonyT folded before Flop (didn't bet)
Seat 5: jcarlos.vale (button) folded before Flop (didn't bet)
Seat 6: EuroKeeper I (small blind) folded before Flop
Seat 7: clonharek704 (big blind) showed [Kh 5c] and won (74) with two pair, Kings and Sixes
Seat 8: AyrtonAA95 folded before Flop (didn't bet)
Seat 9: (ANEKDOT)777 folded before Flop (didn't bet)



PokerStars Hand #220857116748: Tournament #3060068759, $0.23+$0.02 USD Hold'em No Limit - Level I (10/20) - 2020/11/28 0:15:37 EET [2020/11/27 17:15:37 ET]
Table '3060068759 4' 9-max Seat #6 is the button
Seat 2: RapHood (3023 in chips) 
Seat 3: Jaacck6 (1535 in chips) 
Seat 4: JokerTonyT (1185 in chips) 
Seat 5: jcarlos.vale (1455 in chips) 
Seat 6: EuroKeeper I (1739 in chips) 
Seat 7: clonharek704 (1539 in chips) 
Seat 8: AyrtonAA95 (1485 in chips) 
Seat 9: (ANEKDOT)777 (1539 in chips) 
RapHood: posts the ante 3
Jaacck6: posts the ante 3
JokerTonyT: posts the ante 3
jcarlos.vale: posts the ante 3
EuroKeeper I: posts the ante 3
clonharek704: posts the ante 3
AyrtonAA95: posts the ante 3
(ANEKDOT)777: posts the ante 3
clonharek704: posts small blind 10
AyrtonAA95: posts big blind 20
*** HOLE CARDS ***
Dealt to jcarlos.vale [7h 4h]
(ANEKDOT)777: folds 
RapHood: folds 
Jaacck6: folds 
JokerTonyT: folds 
jcarlos.vale: folds 
EuroKeeper I: folds 
clonharek704: folds 
Uncalled bet (10) returned to AyrtonAA95
AyrtonAA95 collected 44 from pot
AyrtonAA95: doesn't show hand 
*** SUMMARY ***
Total pot 44 | Rake 0 
Seat 2: RapHood folded before Flop (didn't bet)
Seat 3: Jaacck6 folded before Flop (didn't bet)
Seat 4: JokerTonyT folded before Flop (didn't bet)
Seat 5: jcarlos.vale folded before Flop (didn't bet)
Seat 6: EuroKeeper I (button) folded before Flop (didn't bet)
Seat 7: clonharek704 (small blind) folded before Flop
Seat 8: AyrtonAA95 (big blind) collected (44)
Seat 9: (ANEKDOT)777 folded before Flop (didn't bet)



PokerStars Hand #220857151075: Tournament #3060068759, $0.23+$0.02 USD Hold'em No Limit - Level I (10/20) - 2020/11/28 0:16:24 EET [2020/11/27 17:16:24 ET]
Table '3060068759 4' 9-max Seat #7 is the button
Seat 2: RapHood (3020 in chips) 
Seat 3: Jaacck6 (1532 in chips) 
Seat 4: JokerTonyT (1182 in chips) 
Seat 5: jcarlos.vale (1452 in chips) 
Seat 6: EuroKeeper I (1736 in chips) 
Seat 7: clonharek704 (1526 in chips) 
Seat 8: AyrtonAA95 (1516 in chips) 
Seat 9: (ANEKDOT)777 (1536 in chips) 
RapHood: posts the ante 3
Jaacck6: posts the ante 3
JokerTonyT: posts the ante 3
jcarlos.vale: posts the ante 3
EuroKeeper I: posts the ante 3
clonharek704: posts the ante 3
AyrtonAA95: posts the ante 3
(ANEKDOT)777: posts the ante 3
AyrtonAA95: posts small blind 10
(ANEKDOT)777: posts big blind 20
*** HOLE CARDS ***
Dealt to jcarlos.vale [Kc Qh]
RapHood: folds 
Jaacck6: folds 
JokerTonyT: folds 
jcarlos.vale: folds 
EuroKeeper I: raises 40 to 60
clonharek704: folds 
AyrtonAA95: folds 
(ANEKDOT)777: folds 
Uncalled bet (40) returned to EuroKeeper I
EuroKeeper I collected 74 from pot
EuroKeeper I: doesn't show hand 
*** SUMMARY ***
Total pot 74 | Rake 0 
Seat 2: RapHood folded before Flop (didn't bet)
Seat 3: Jaacck6 folded before Flop (didn't bet)
Seat 4: JokerTonyT folded before Flop (didn't bet)
Seat 5: jcarlos.vale folded before Flop (didn't bet)
Seat 6: EuroKeeper I collected (74)
Seat 7: clonharek704 (button) folded before Flop (didn't bet)
Seat 8: AyrtonAA95 (small blind) folded before Flop
Seat 9: (ANEKDOT)777 (big blind) folded before Flop



PokerStars Hand #220857178936: Tournament #3060068759, $0.23+$0.02 USD Hold'em No Limit - Level I (10/20) - 2020/11/28 0:17:02 EET [2020/11/27 17:17:02 ET]
Table '3060068759 4' 9-max Seat #8 is the button
Seat 2: RapHood (3017 in chips) 
Seat 3: Jaacck6 (1529 in chips) 
Seat 4: JokerTonyT (1179 in chips) 
Seat 5: jcarlos.vale (1449 in chips) 
Seat 6: EuroKeeper I (1787 in chips) 
Seat 7: clonharek704 (1523 in chips) 
Seat 8: AyrtonAA95 (1503 in chips) 
Seat 9: (ANEKDOT)777 (1513 in chips) 
RapHood: posts the ante 3
Jaacck6: posts the ante 3
JokerTonyT: posts the ante 3
jcarlos.vale: posts the ante 3
EuroKeeper I: posts the ante 3
clonharek704: posts the ante 3
AyrtonAA95: posts the ante 3
(ANEKDOT)777: posts the ante 3
(ANEKDOT)777: posts small blind 10
RapHood: posts big blind 20
*** HOLE CARDS ***
Dealt to jcarlos.vale [7d 3h]
Jaacck6: folds 
JokerTonyT: raises 30 to 50
jcarlos.vale: folds 
EuroKeeper I: folds 
clonharek704: folds 
AyrtonAA95: folds 
(ANEKDOT)777: folds 
RapHood: folds 
Uncalled bet (30) returned to JokerTonyT
JokerTonyT collected 74 from pot
JokerTonyT: doesn't show hand 
*** SUMMARY ***
Total pot 74 | Rake 0 
Seat 2: RapHood (big blind) folded before Flop
Seat 3: Jaacck6 folded before Flop (didn't bet)
Seat 4: JokerTonyT collected (74)
Seat 5: jcarlos.vale folded before Flop (didn't bet)
Seat 6: EuroKeeper I folded before Flop (didn't bet)
Seat 7: clonharek704 folded before Flop (didn't bet)
Seat 8: AyrtonAA95 (button) folded before Flop (didn't bet)
Seat 9: (ANEKDOT)777 (small blind) folded before Flop



PokerStars Hand #220857211799: Tournament #3060068759, $0.23+$0.02 USD Hold'em No Limit - Level I (10/20) - 2020/11/28 0:17:46 EET [2020/11/27 17:17:46 ET]
Table '3060068759 4' 9-max Seat #9 is the button
Seat 2: RapHood (2994 in chips) 
Seat 3: Jaacck6 (1526 in chips) 
Seat 4: JokerTonyT (1230 in chips) 
Seat 5: jcarlos.vale (1446 in chips) 
Seat 6: EuroKeeper I (1784 in chips) 
Seat 7: clonharek704 (1520 in chips) 
Seat 8: AyrtonAA95 (1500 in chips) 
Seat 9: (ANEKDOT)777 (1500 in chips) 
RapHood: posts the ante 3
Jaacck6: posts the ante 3
JokerTonyT: posts the ante 3
jcarlos.vale: posts the ante 3
EuroKeeper I: posts the ante 3
clonharek704: posts the ante 3
AyrtonAA95: posts the ante 3
(ANEKDOT)777: posts the ante 3
RapHood: posts small blind 10
Jaacck6: posts big blind 20
*** HOLE CARDS ***
Dealt to jcarlos.vale [Qh 6c]
JokerTonyT: folds 
jcarlos.vale: folds 
EuroKeeper I: folds 
clonharek704: folds 
AyrtonAA95: folds 
(ANEKDOT)777: folds 
RapHood: folds 
Uncalled bet (10) returned to Jaacck6
Jaacck6 collected 44 from pot
Jaacck6: doesn't show hand 
*** SUMMARY ***
Total pot 44 | Rake 0 
Seat 2: RapHood (small blind) folded before Flop
Seat 3: Jaacck6 (big blind) collected (44)
Seat 4: JokerTonyT folded before Flop (didn't bet)
Seat 5: jcarlos.vale folded before Flop (didn't bet)
Seat 6: EuroKeeper I folded before Flop (didn't bet)
Seat 7: clonharek704 folded before Flop (didn't bet)
Seat 8: AyrtonAA95 folded before Flop (didn't bet)
Seat 9: (ANEKDOT)777 (button) folded before Flop (didn't bet)



PokerStars Hand #220857232871: Tournament #3060068759, $0.23+$0.02 USD Hold'em No Limit - Level I (10/20) - 2020/11/28 0:18:15 EET [2020/11/27 17:18:15 ET]
Table '3060068759 4' 9-max Seat #2 is the button
Seat 2: RapHood (2981 in chips) 
Seat 3: Jaacck6 (1557 in chips) 
Seat 4: JokerTonyT (1227 in chips) 
Seat 5: jcarlos.vale (1443 in chips) 
Seat 6: EuroKeeper I (1781 in chips) 
Seat 7: clonharek704 (1517 in chips) 
Seat 8: AyrtonAA95 (1497 in chips) 
Seat 9: (ANEKDOT)777 (1497 in chips) 
RapHood: posts the ante 3
Jaacck6: posts the ante 3
JokerTonyT: posts the ante 3
jcarlos.vale: posts the ante 3
EuroKeeper I: posts the ante 3
clonharek704: posts the ante 3
AyrtonAA95: posts the ante 3
(ANEKDOT)777: posts the ante 3
Jaacck6: posts small blind 10
JokerTonyT: posts big blind 20
*** HOLE CARDS ***
Dealt to jcarlos.vale [7h Qd]
jcarlos.vale: folds 
EuroKeeper I: folds 
clonharek704: folds 
AyrtonAA95: folds 
(ANEKDOT)777: folds 
RapHood: folds 
Jaacck6: calls 10
JokerTonyT: checks 
*** FLOP *** [Ks 2c 5c]
Jaacck6: checks 
JokerTonyT: bets 21
Jaacck6: calls 21
*** TURN *** [Ks 2c 5c] [As]
Jaacck6: checks 
JokerTonyT: bets 66
Jaacck6: folds 
Uncalled bet (66) returned to JokerTonyT
JokerTonyT collected 106 from pot
JokerTonyT: doesn't show hand 
*** SUMMARY ***
Total pot 106 | Rake 0 
Board [Ks 2c 5c As]
Seat 2: RapHood (button) folded before Flop (didn't bet)
Seat 3: Jaacck6 (small blind) folded on the Turn
Seat 4: JokerTonyT (big blind) collected (106)
Seat 5: jcarlos.vale folded before Flop (didn't bet)
Seat 6: EuroKeeper I folded before Flop (didn't bet)
Seat 7: clonharek704 folded before Flop (didn't bet)
Seat 8: AyrtonAA95 folded before Flop (didn't bet)
Seat 9: (ANEKDOT)777 folded before Flop (didn't bet)



PokerStars Hand #220857336587: Tournament #3060068759, $0.23+$0.02 USD Hold'em No Limit - Level II (15/30) - 2020/11/28 0:20:37 EET [2020/11/27 17:20:37 ET]
Table '3060068759 4' 9-max Seat #3 is the button
Seat 2: RapHood (2978 in chips) 
Seat 3: Jaacck6 (1513 in chips) 
Seat 4: JokerTonyT (1289 in chips) 
Seat 5: jcarlos.vale (1440 in chips) 
Seat 6: EuroKeeper I (1778 in chips) 
Seat 7: clonharek704 (1514 in chips) 
Seat 8: AyrtonAA95 (1494 in chips) 
Seat 9: (ANEKDOT)777 (1494 in chips) 
RapHood: posts the ante 4
Jaacck6: posts the ante 4
JokerTonyT: posts the ante 4
jcarlos.vale: posts the ante 4
EuroKeeper I: posts the ante 4
clonharek704: posts the ante 4
AyrtonAA95: posts the ante 4
(ANEKDOT)777: posts the ante 4
JokerTonyT: posts small blind 15
jcarlos.vale: posts big blind 30
*** HOLE CARDS ***
Dealt to jcarlos.vale [Ts Jd]
EuroKeeper I: folds 
clonharek704: folds 
AyrtonAA95: raises 60 to 90
(ANEKDOT)777: folds 
RapHood: folds 
Jaacck6: calls 90
JokerTonyT: folds 
jcarlos.vale: folds 
*** FLOP *** [3s 2c Qc]
AyrtonAA95: bets 170
Jaacck6: folds 
Uncalled bet (170) returned to AyrtonAA95
AyrtonAA95 collected 257 from pot
AyrtonAA95: doesn't show hand 
*** SUMMARY ***
Total pot 257 | Rake 0 
Board [3s 2c Qc]
Seat 2: RapHood folded before Flop (didn't bet)
Seat 3: Jaacck6 (button) folded on the Flop
Seat 4: JokerTonyT (small blind) folded before Flop
Seat 5: jcarlos.vale (big blind) folded before Flop
Seat 6: EuroKeeper I folded before Flop (didn't bet)
Seat 7: clonharek704 folded before Flop (didn't bet)
Seat 8: AyrtonAA95 collected (257)
Seat 9: (ANEKDOT)777 folded before Flop (didn't bet)



PokerStars Hand #220857377827: Tournament #3060068759, $0.23+$0.02 USD Hold'em No Limit - Level II (15/30) - 2020/11/28 0:21:33 EET [2020/11/27 17:21:33 ET]
Table '3060068759 4' 9-max Seat #4 is the button
Seat 2: RapHood (2974 in chips) 
Seat 3: Jaacck6 (1419 in chips) 
Seat 4: JokerTonyT (1270 in chips) 
Seat 5: jcarlos.vale (1406 in chips) 
Seat 6: EuroKeeper I (1774 in chips) 
Seat 7: clonharek704 (1510 in chips) 
Seat 8: AyrtonAA95 (1657 in chips) 
Seat 9: (ANEKDOT)777 (1490 in chips) 
RapHood: posts the ante 4
Jaacck6: posts the ante 4
JokerTonyT: posts the ante 4
jcarlos.vale: posts the ante 4
EuroKeeper I: posts the ante 4
clonharek704: posts the ante 4
AyrtonAA95: posts the ante 4
(ANEKDOT)777: posts the ante 4
jcarlos.vale: posts small blind 15
EuroKeeper I: posts big blind 30
*** HOLE CARDS ***
Dealt to jcarlos.vale [Tc 3c]
clonharek704: folds 
AyrtonAA95: folds 
(ANEKDOT)777: folds 
RapHood: folds 
Jaacck6: calls 30
JokerTonyT: calls 30
jcarlos.vale: calls 15
EuroKeeper I: checks 
*** FLOP *** [Qc 8c Jc]
jcarlos.vale: bets 114
EuroKeeper I: folds 
Jaacck6: folds 
JokerTonyT: folds 
Uncalled bet (114) returned to jcarlos.vale
jcarlos.vale collected 152 from pot
jcarlos.vale: doesn't show hand 
*** SUMMARY ***
Total pot 152 | Rake 0 
Board [Qc 8c Jc]
Seat 2: RapHood folded before Flop (didn't bet)
Seat 3: Jaacck6 folded on the Flop
Seat 4: JokerTonyT (button) folded on the Flop
Seat 5: jcarlos.vale (small blind) collected (152)
Seat 6: EuroKeeper I (big blind) folded on the Flop
Seat 7: clonharek704 folded before Flop (didn't bet)
Seat 8: AyrtonAA95 folded before Flop (didn't bet)
Seat 9: (ANEKDOT)777 folded before Flop (didn't bet)



PokerStars Hand #220857436651: Tournament #3060068759, $0.23+$0.02 USD Hold'em No Limit - Level II (15/30) - 2020/11/28 0:22:54 EET [2020/11/27 17:22:54 ET]
Table '3060068759 4' 9-max Seat #5 is the button
Seat 2: RapHood (2970 in chips) 
Seat 3: Jaacck6 (1385 in chips) 
Seat 4: JokerTonyT (1236 in chips) 
Seat 5: jcarlos.vale (1524 in chips) 
Seat 6: EuroKeeper I (1740 in chips) 
Seat 7: clonharek704 (1506 in chips) 
Seat 8: AyrtonAA95 (1653 in chips) 
Seat 9: (ANEKDOT)777 (1486 in chips) 
RapHood: posts the ante 4
Jaacck6: posts the ante 4
JokerTonyT: posts the ante 4
jcarlos.vale: posts the ante 4
EuroKeeper I: posts the ante 4
clonharek704: posts the ante 4
AyrtonAA95: posts the ante 4
(ANEKDOT)777: posts the ante 4
EuroKeeper I: posts small blind 15
clonharek704: posts big blind 30
*** HOLE CARDS ***
Dealt to jcarlos.vale [Qh 5s]
AyrtonAA95: folds 
(ANEKDOT)777: folds 
RapHood: folds 
Jaacck6: folds 
JokerTonyT: folds 
jcarlos.vale: folds 
EuroKeeper I: calls 15
clonharek704: checks 
*** FLOP *** [Js 2s 6d]
EuroKeeper I: bets 43
clonharek704: calls 43
*** TURN *** [Js 2s 6d] [3d]
EuroKeeper I: checks 
clonharek704: bets 89
EuroKeeper I: folds 
Uncalled bet (89) returned to clonharek704
clonharek704 collected 178 from pot
*** SUMMARY ***
Total pot 178 | Rake 0 
Board [Js 2s 6d 3d]
Seat 2: RapHood folded before Flop (didn't bet)
Seat 3: Jaacck6 folded before Flop (didn't bet)
Seat 4: JokerTonyT folded before Flop (didn't bet)
Seat 5: jcarlos.vale (button) folded before Flop (didn't bet)
Seat 6: EuroKeeper I (small blind) folded on the Turn
Seat 7: clonharek704 (big blind) collected (178)
Seat 8: AyrtonAA95 folded before Flop (didn't bet)
Seat 9: (ANEKDOT)777 folded before Flop (didn't bet)



PokerStars Hand #220857481129: Tournament #3060068759, $0.23+$0.02 USD Hold'em No Limit - Level II (15/30) - 2020/11/28 0:23:56 EET [2020/11/27 17:23:56 ET]
Table '3060068759 4' 9-max Seat #6 is the button
Seat 2: RapHood (2966 in chips) 
Seat 3: Jaacck6 (1381 in chips) 
Seat 4: JokerTonyT (1232 in chips) 
Seat 5: jcarlos.vale (1520 in chips) 
Seat 6: EuroKeeper I (1663 in chips) 
Seat 7: clonharek704 (1607 in chips) 
Seat 8: AyrtonAA95 (1649 in chips) 
Seat 9: (ANEKDOT)777 (1482 in chips) 
RapHood: posts the ante 4
Jaacck6: posts the ante 4
JokerTonyT: posts the ante 4
jcarlos.vale: posts the ante 4
EuroKeeper I: posts the ante 4
clonharek704: posts the ante 4
AyrtonAA95: posts the ante 4
(ANEKDOT)777: posts the ante 4
clonharek704: posts small blind 15
AyrtonAA95: posts big blind 30
*** HOLE CARDS ***
Dealt to jcarlos.vale [9h 4d]
(ANEKDOT)777: raises 60 to 90
RapHood: folds 
Jaacck6: folds 
JokerTonyT: calls 90
jcarlos.vale: folds 
EuroKeeper I: folds 
clonharek704: folds 
AyrtonAA95: raises 210 to 300
(ANEKDOT)777: folds 
JokerTonyT: folds 
Uncalled bet (210) returned to AyrtonAA95
AyrtonAA95 collected 317 from pot
AyrtonAA95: doesn't show hand 
*** SUMMARY ***
Total pot 317 | Rake 0 
Seat 2: RapHood folded before Flop (didn't bet)
Seat 3: Jaacck6 folded before Flop (didn't bet)
Seat 4: JokerTonyT folded before Flop
Seat 5: jcarlos.vale folded before Flop (didn't bet)
Seat 6: EuroKeeper I (button) folded before Flop (didn't bet)
Seat 7: clonharek704 (small blind) folded before Flop
Seat 8: AyrtonAA95 (big blind) collected (317)
Seat 9: (ANEKDOT)777 folded before Flop



PokerStars Hand #220857523023: Tournament #3060068759, $0.23+$0.02 USD Hold'em No Limit - Level II (15/30) - 2020/11/28 0:24:54 EET [2020/11/27 17:24:54 ET]
Table '3060068759 4' 9-max Seat #7 is the button
Seat 2: RapHood (2962 in chips) 
Seat 3: Jaacck6 (1377 in chips) 
Seat 4: JokerTonyT (1138 in chips) 
Seat 5: jcarlos.vale (1516 in chips) 
Seat 6: EuroKeeper I (1659 in chips) 
Seat 7: clonharek704 (1588 in chips) 
Seat 8: AyrtonAA95 (1872 in chips) 
Seat 9: (ANEKDOT)777 (1388 in chips) 
RapHood: posts the ante 4
Jaacck6: posts the ante 4
JokerTonyT: posts the ante 4
jcarlos.vale: posts the ante 4
EuroKeeper I: posts the ante 4
clonharek704: posts the ante 4
AyrtonAA95: posts the ante 4
(ANEKDOT)777: posts the ante 4
AyrtonAA95: posts small blind 15
(ANEKDOT)777: posts big blind 30
*** HOLE CARDS ***
Dealt to jcarlos.vale [3d Qs]
RapHood: folds 
Jaacck6: folds 
JokerTonyT: raises 36 to 66
jcarlos.vale: folds 
EuroKeeper I: folds 
clonharek704: folds 
AyrtonAA95: folds 
(ANEKDOT)777: folds 
Uncalled bet (36) returned to JokerTonyT
JokerTonyT collected 107 from pot
JokerTonyT: doesn't show hand 
*** SUMMARY ***
Total pot 107 | Rake 0 
Seat 2: RapHood folded before Flop (didn't bet)
Seat 3: Jaacck6 folded before Flop (didn't bet)
Seat 4: JokerTonyT collected (107)
Seat 5: jcarlos.vale folded before Flop (didn't bet)
Seat 6: EuroKeeper I folded before Flop (didn't bet)
Seat 7: clonharek704 (button) folded before Flop (didn't bet)
Seat 8: AyrtonAA95 (small blind) folded before Flop
Seat 9: (ANEKDOT)777 (big blind) folded before Flop



PokerStars Hand #220857553101: Tournament #3060068759, $0.23+$0.02 USD Hold'em No Limit - Level II (15/30) - 2020/11/28 0:25:35 EET [2020/11/27 17:25:35 ET]
Table '3060068759 4' 9-max Seat #8 is the button
Seat 2: RapHood (2958 in chips) 
Seat 3: Jaacck6 (1373 in chips) 
Seat 4: JokerTonyT (1211 in chips) 
Seat 5: jcarlos.vale (1512 in chips) 
Seat 6: EuroKeeper I (1655 in chips) 
Seat 7: clonharek704 (1584 in chips) 
Seat 8: AyrtonAA95 (1853 in chips) 
Seat 9: (ANEKDOT)777 (1354 in chips) 
RapHood: posts the ante 4
Jaacck6: posts the ante 4
JokerTonyT: posts the ante 4
jcarlos.vale: posts the ante 4
EuroKeeper I: posts the ante 4
clonharek704: posts the ante 4
AyrtonAA95: posts the ante 4
(ANEKDOT)777: posts the ante 4
(ANEKDOT)777: posts small blind 15
RapHood: posts big blind 30
*** HOLE CARDS ***
Dealt to jcarlos.vale [As 2c]
Jaacck6: folds 
JokerTonyT: raises 45 to 75
jcarlos.vale: folds 
EuroKeeper I: folds 
clonharek704: folds 
AyrtonAA95: folds 
(ANEKDOT)777: folds 
RapHood: calls 45
*** FLOP *** [3c 2s 8s]
RapHood: checks 
JokerTonyT: bets 87
RapHood: folds 
Uncalled bet (87) returned to JokerTonyT
JokerTonyT collected 197 from pot
JokerTonyT: doesn't show hand 
*** SUMMARY ***
Total pot 197 | Rake 0 
Board [3c 2s 8s]
Seat 2: RapHood (big blind) folded on the Flop
Seat 3: Jaacck6 folded before Flop (didn't bet)
Seat 4: JokerTonyT collected (197)
Seat 5: jcarlos.vale folded before Flop (didn't bet)
Seat 6: EuroKeeper I folded before Flop (didn't bet)
Seat 7: clonharek704 folded before Flop (didn't bet)
Seat 8: AyrtonAA95 (button) folded before Flop (didn't bet)
Seat 9: (ANEKDOT)777 (small blind) folded before Flop



PokerStars Hand #220857600357: Tournament #3060068759, $0.23+$0.02 USD Hold'em No Limit - Level II (15/30) - 2020/11/28 0:26:41 EET [2020/11/27 17:26:41 ET]
Table '3060068759 4' 9-max Seat #9 is the button
Seat 2: RapHood (2879 in chips) 
Seat 3: Jaacck6 (1369 in chips) 
Seat 4: JokerTonyT (1329 in chips) 
Seat 5: jcarlos.vale (1508 in chips) 
Seat 6: EuroKeeper I (1651 in chips) 
Seat 7: clonharek704 (1580 in chips) 
Seat 8: AyrtonAA95 (1849 in chips) 
Seat 9: (ANEKDOT)777 (1335 in chips) 
RapHood: posts the ante 4
Jaacck6: posts the ante 4
JokerTonyT: posts the ante 4
jcarlos.vale: posts the ante 4
EuroKeeper I: posts the ante 4
clonharek704: posts the ante 4
AyrtonAA95: posts the ante 4
(ANEKDOT)777: posts the ante 4
RapHood: posts small blind 15
Jaacck6: posts big blind 30
*** HOLE CARDS ***
Dealt to jcarlos.vale [7d 6d]
JokerTonyT: folds 
jcarlos.vale: folds 
EuroKeeper I: folds 
clonharek704: folds 
AyrtonAA95: folds 
(ANEKDOT)777: raises 30 to 60
RapHood: folds 
Jaacck6: calls 30
*** FLOP *** [7h Kh Ad]
Jaacck6: checks 
(ANEKDOT)777: bets 60
Jaacck6: calls 60
*** TURN *** [7h Kh Ad] [5s]
Jaacck6: checks 
(ANEKDOT)777: bets 60
Jaacck6: calls 60
*** RIVER *** [7h Kh Ad 5s] [Jh]
Jaacck6: checks 
(ANEKDOT)777: checks 
*** SHOW DOWN ***
Jaacck6: shows [2s Kc] (a pair of Kings)
(ANEKDOT)777: shows [Ks 9d] (a pair of Kings - Ace+Jack+Nine kicker)
(ANEKDOT)777 collected 407 from pot
*** SUMMARY ***
Total pot 407 | Rake 0 
Board [7h Kh Ad 5s Jh]
Seat 2: RapHood (small blind) folded before Flop
Seat 3: Jaacck6 (big blind) showed [2s Kc] and lost with a pair of Kings
Seat 4: JokerTonyT folded before Flop (didn't bet)
Seat 5: jcarlos.vale folded before Flop (didn't bet)
Seat 6: EuroKeeper I folded before Flop (didn't bet)
Seat 7: clonharek704 folded before Flop (didn't bet)
Seat 8: AyrtonAA95 folded before Flop (didn't bet)
Seat 9: (ANEKDOT)777 (button) showed [Ks 9d] and won (407) with a pair of Kings



PokerStars Hand #220857647430: Tournament #3060068759, $0.23+$0.02 USD Hold'em No Limit - Level II (15/30) - 2020/11/28 0:27:47 EET [2020/11/27 17:27:47 ET]
Table '3060068759 4' 9-max Seat #2 is the button
Seat 2: RapHood (2860 in chips) 
Seat 3: Jaacck6 (1185 in chips) 
Seat 4: JokerTonyT (1325 in chips) 
Seat 5: jcarlos.vale (1504 in chips) 
Seat 6: EuroKeeper I (1647 in chips) 
Seat 7: clonharek704 (1576 in chips) 
Seat 8: AyrtonAA95 (1845 in chips) 
Seat 9: (ANEKDOT)777 (1558 in chips) 
RapHood: posts the ante 4
Jaacck6: posts the ante 4
JokerTonyT: posts the ante 4
jcarlos.vale: posts the ante 4
EuroKeeper I: posts the ante 4
clonharek704: posts the ante 4
AyrtonAA95: posts the ante 4
(ANEKDOT)777: posts the ante 4
Jaacck6: posts small blind 15
JokerTonyT: posts big blind 30
*** HOLE CARDS ***
Dealt to jcarlos.vale [9c Jh]
jcarlos.vale: folds 
EuroKeeper I: folds 
clonharek704: folds 
AyrtonAA95: raises 60 to 90
(ANEKDOT)777: folds 
RapHood: folds 
Jaacck6: folds 
JokerTonyT: calls 60
*** FLOP *** [2h Tc Jc]
JokerTonyT: checks 
AyrtonAA95: bets 75
JokerTonyT: folds 
Uncalled bet (75) returned to AyrtonAA95
AyrtonAA95 collected 227 from pot
AyrtonAA95: doesn't show hand 
*** SUMMARY ***
Total pot 227 | Rake 0 
Board [2h Tc Jc]
Seat 2: RapHood (button) folded before Flop (didn't bet)
Seat 3: Jaacck6 (small blind) folded before Flop
Seat 4: JokerTonyT (big blind) folded on the Flop
Seat 5: jcarlos.vale folded before Flop (didn't bet)
Seat 6: EuroKeeper I folded before Flop (didn't bet)
Seat 7: clonharek704 folded before Flop (didn't bet)
Seat 8: AyrtonAA95 collected (227)
Seat 9: (ANEKDOT)777 folded before Flop (didn't bet)



PokerStars Hand #220857697808: Tournament #3060068759, $0.23+$0.02 USD Hold'em No Limit - Level II (15/30) - 2020/11/28 0:28:57 EET [2020/11/27 17:28:57 ET]
Table '3060068759 4' 9-max Seat #3 is the button
Seat 2: RapHood (2856 in chips) 
Seat 3: Jaacck6 (1166 in chips) 
Seat 4: JokerTonyT (1231 in chips) 
Seat 5: jcarlos.vale (1500 in chips) 
Seat 6: EuroKeeper I (1643 in chips) 
Seat 7: clonharek704 (1572 in chips) 
Seat 8: AyrtonAA95 (1978 in chips) 
Seat 9: (ANEKDOT)777 (1554 in chips) 
RapHood: posts the ante 4
Jaacck6: posts the ante 4
JokerTonyT: posts the ante 4
jcarlos.vale: posts the ante 4
EuroKeeper I: posts the ante 4
clonharek704: posts the ante 4
AyrtonAA95: posts the ante 4
(ANEKDOT)777: posts the ante 4
JokerTonyT: posts small blind 15
jcarlos.vale: posts big blind 30
*** HOLE CARDS ***
Dealt to jcarlos.vale [4d Qh]
EuroKeeper I: folds 
clonharek704: folds 
AyrtonAA95: folds 
(ANEKDOT)777: raises 60 to 90
RapHood: folds 
Jaacck6: folds 
JokerTonyT: raises 270 to 360
jcarlos.vale: folds 
(ANEKDOT)777: folds 
Uncalled bet (270) returned to JokerTonyT
JokerTonyT collected 242 from pot
JokerTonyT: doesn't show hand 
*** SUMMARY ***
Total pot 242 | Rake 0 
Seat 2: RapHood folded before Flop (didn't bet)
Seat 3: Jaacck6 (button) folded before Flop (didn't bet)
Seat 4: JokerTonyT (small blind) collected (242)
Seat 5: jcarlos.vale (big blind) folded before Flop
Seat 6: EuroKeeper I folded before Flop (didn't bet)
Seat 7: clonharek704 folded before Flop (didn't bet)
Seat 8: AyrtonAA95 folded before Flop (didn't bet)
Seat 9: (ANEKDOT)777 folded before Flop



PokerStars Hand #220857741521: Tournament #3060068759, $0.23+$0.02 USD Hold'em No Limit - Level III (25/50) - 2020/11/28 0:29:58 EET [2020/11/27 17:29:58 ET]
Table '3060068759 4' 9-max Seat #4 is the button
Seat 2: RapHood (2852 in chips) 
Seat 3: Jaacck6 (1162 in chips) 
Seat 4: JokerTonyT (1379 in chips) 
Seat 5: jcarlos.vale (1466 in chips) 
Seat 6: EuroKeeper I (1639 in chips) 
Seat 7: clonharek704 (1568 in chips) 
Seat 8: AyrtonAA95 (1974 in chips) 
Seat 9: (ANEKDOT)777 (1460 in chips) 
RapHood: posts the ante 6
Jaacck6: posts the ante 6
JokerTonyT: posts the ante 6
jcarlos.vale: posts the ante 6
EuroKeeper I: posts the ante 6
clonharek704: posts the ante 6
AyrtonAA95: posts the ante 6
(ANEKDOT)777: posts the ante 6
jcarlos.vale: posts small blind 25
EuroKeeper I: posts big blind 50
*** HOLE CARDS ***
Dealt to jcarlos.vale [Jd 2s]
clonharek704: folds 
AyrtonAA95: folds 
(ANEKDOT)777: folds 
RapHood: folds 
Jaacck6: folds 
JokerTonyT: raises 75 to 125
jcarlos.vale: folds 
EuroKeeper I: calls 75
*** FLOP *** [Kh Ts Th]
EuroKeeper I: checks 
JokerTonyT: bets 107
EuroKeeper I: folds 
Uncalled bet (107) returned to JokerTonyT
JokerTonyT collected 323 from pot
JokerTonyT: doesn't show hand 
*** SUMMARY ***
Total pot 323 | Rake 0 
Board [Kh Ts Th]
Seat 2: RapHood folded before Flop (didn't bet)
Seat 3: Jaacck6 folded before Flop (didn't bet)
Seat 4: JokerTonyT (button) collected (323)
Seat 5: jcarlos.vale (small blind) folded before Flop
Seat 6: EuroKeeper I (big blind) folded on the Flop
Seat 7: clonharek704 folded before Flop (didn't bet)
Seat 8: AyrtonAA95 folded before Flop (didn't bet)
Seat 9: (ANEKDOT)777 folded before Flop (didn't bet)



PokerStars Hand #220857789376: Tournament #3060068759, $0.23+$0.02 USD Hold'em No Limit - Level III (25/50) - 2020/11/28 0:31:05 EET [2020/11/27 17:31:05 ET]
Table '3060068759 4' 9-max Seat #5 is the button
Seat 2: RapHood (2846 in chips) 
Seat 3: Jaacck6 (1156 in chips) 
Seat 4: JokerTonyT (1571 in chips) 
Seat 5: jcarlos.vale (1435 in chips) 
Seat 6: EuroKeeper I (1508 in chips) 
Seat 7: clonharek704 (1562 in chips) 
Seat 8: AyrtonAA95 (1968 in chips) 
Seat 9: (ANEKDOT)777 (1454 in chips) 
RapHood: posts the ante 6
Jaacck6: posts the ante 6
JokerTonyT: posts the ante 6
jcarlos.vale: posts the ante 6
EuroKeeper I: posts the ante 6
clonharek704: posts the ante 6
AyrtonAA95: posts the ante 6
(ANEKDOT)777: posts the ante 6
EuroKeeper I: posts small blind 25
clonharek704: posts big blind 50
*** HOLE CARDS ***
Dealt to jcarlos.vale [Ah 2c]
AyrtonAA95: folds 
(ANEKDOT)777: folds 
RapHood: folds 
Jaacck6: folds 
JokerTonyT: raises 60 to 110
jcarlos.vale: folds 
EuroKeeper I: folds 
clonharek704: raises 1446 to 1556 and is all-in
JokerTonyT: folds 
Uncalled bet (1446) returned to clonharek704
clonharek704 collected 293 from pot
*** SUMMARY ***
Total pot 293 | Rake 0 
Seat 2: RapHood folded before Flop (didn't bet)
Seat 3: Jaacck6 folded before Flop (didn't bet)
Seat 4: JokerTonyT folded before Flop
Seat 5: jcarlos.vale (button) folded before Flop (didn't bet)
Seat 6: EuroKeeper I (small blind) folded before Flop
Seat 7: clonharek704 (big blind) collected (293)
Seat 8: AyrtonAA95 folded before Flop (didn't bet)
Seat 9: (ANEKDOT)777 folded before Flop (didn't bet)



PokerStars Hand #220857816620: Tournament #3060068759, $0.23+$0.02 USD Hold'em No Limit - Level III (25/50) - 2020/11/28 0:31:44 EET [2020/11/27 17:31:44 ET]
Table '3060068759 4' 9-max Seat #6 is the button
Seat 2: RapHood (2840 in chips) 
Seat 4: JokerTonyT (1455 in chips) 
Seat 5: jcarlos.vale (1429 in chips) 
Seat 6: EuroKeeper I (1477 in chips) 
Seat 7: clonharek704 (1739 in chips) 
Seat 8: AyrtonAA95 (1962 in chips) 
Seat 9: (ANEKDOT)777 (1448 in chips) 
RapHood: posts the ante 6
JokerTonyT: posts the ante 6
jcarlos.vale: posts the ante 6
EuroKeeper I: posts the ante 6
clonharek704: posts the ante 6
AyrtonAA95: posts the ante 6
(ANEKDOT)777: posts the ante 6
clonharek704: posts small blind 25
AyrtonAA95: posts big blind 50
*** HOLE CARDS ***
Dealt to jcarlos.vale [7s 9c]
(ANEKDOT)777: folds 
RapHood: folds 
JokerTonyT: folds 
jcarlos.vale: folds 
EuroKeeper I: folds 
clonharek704: raises 100 to 150
AyrtonAA95: calls 100
*** FLOP *** [As Kh Qs]
clonharek704: bets 150
AyrtonAA95: calls 150
*** TURN *** [As Kh Qs] [2s]
clonharek704: checks 
AyrtonAA95: bets 212
clonharek704: calls 212
*** RIVER *** [As Kh Qs 2s] [9d]
clonharek704: checks 
AyrtonAA95: checks 
*** SHOW DOWN ***
clonharek704: shows [3d 5s] (high card Ace)
AyrtonAA95: shows [7h Ah] (a pair of Aces)
AyrtonAA95 collected 1066 from pot
*** SUMMARY ***
Total pot 1066 | Rake 0 
Board [As Kh Qs 2s 9d]
Seat 2: RapHood folded before Flop (didn't bet)
Seat 4: JokerTonyT folded before Flop (didn't bet)
Seat 5: jcarlos.vale folded before Flop (didn't bet)
Seat 6: EuroKeeper I (button) folded before Flop (didn't bet)
Seat 7: clonharek704 (small blind) showed [3d 5s] and lost with high card Ace
Seat 8: AyrtonAA95 (big blind) showed [7h Ah] and won (1066) with a pair of Aces
Seat 9: (ANEKDOT)777 folded before Flop (didn't bet)



PokerStars Hand #220857870281: Tournament #3060068759, $0.23+$0.02 USD Hold'em No Limit - Level III (25/50) - 2020/11/28 0:32:59 EET [2020/11/27 17:32:59 ET]
Table '3060068759 4' 9-max Seat #7 is the button
Seat 1: aconteceu (7265 in chips) 
Seat 2: RapHood (2834 in chips) 
Seat 3: dimYLiaK (1292 in chips) 
Seat 4: JokerTonyT (1449 in chips) 
Seat 5: jcarlos.vale (1423 in chips) 
Seat 6: EuroKeeper I (1471 in chips) 
Seat 7: clonharek704 (1221 in chips) 
Seat 8: AyrtonAA95 (2510 in chips) 
Seat 9: (ANEKDOT)777 (1442 in chips) 
aconteceu: posts the ante 6
RapHood: posts the ante 6
dimYLiaK: posts the ante 6
JokerTonyT: posts the ante 6
jcarlos.vale: posts the ante 6
EuroKeeper I: posts the ante 6
clonharek704: posts the ante 6
AyrtonAA95: posts the ante 6
(ANEKDOT)777: posts the ante 6
AyrtonAA95: posts small blind 25
(ANEKDOT)777: posts big blind 50
*** HOLE CARDS ***
Dealt to jcarlos.vale [2h 7d]
aconteceu: raises 50 to 100
RapHood: folds 
dimYLiaK: folds 
JokerTonyT: folds 
jcarlos.vale: folds 
EuroKeeper I: folds 
clonharek704: folds 
AyrtonAA95: folds 
(ANEKDOT)777: raises 1336 to 1436 and is all-in
aconteceu: folds 
Uncalled bet (1336) returned to (ANEKDOT)777
(ANEKDOT)777 collected 279 from pot
(ANEKDOT)777: doesn't show hand 
*** SUMMARY ***
Total pot 279 | Rake 0 
Seat 1: aconteceu folded before Flop
Seat 2: RapHood folded before Flop (didn't bet)
Seat 3: dimYLiaK folded before Flop (didn't bet)
Seat 4: JokerTonyT folded before Flop (didn't bet)
Seat 5: jcarlos.vale folded before Flop (didn't bet)
Seat 6: EuroKeeper I folded before Flop (didn't bet)
Seat 7: clonharek704 (button) folded before Flop (didn't bet)
Seat 8: AyrtonAA95 (small blind) folded before Flop
Seat 9: (ANEKDOT)777 (big blind) collected (279)



PokerStars Hand #220857915187: Tournament #3060068759, $0.23+$0.02 USD Hold'em No Limit - Level III (25/50) - 2020/11/28 0:34:02 EET [2020/11/27 17:34:02 ET]
Table '3060068759 4' 9-max Seat #8 is the button
Seat 1: aconteceu (7159 in chips) 
Seat 2: RapHood (2828 in chips) 
Seat 3: dimYLiaK (1286 in chips) 
Seat 4: JokerTonyT (1443 in chips) 
Seat 5: jcarlos.vale (1417 in chips) 
Seat 6: EuroKeeper I (1465 in chips) 
Seat 7: clonharek704 (1215 in chips) 
Seat 8: AyrtonAA95 (2479 in chips) 
Seat 9: (ANEKDOT)777 (1615 in chips) 
aconteceu: posts the ante 6
RapHood: posts the ante 6
dimYLiaK: posts the ante 6
JokerTonyT: posts the ante 6
jcarlos.vale: posts the ante 6
EuroKeeper I: posts the ante 6
clonharek704: posts the ante 6
AyrtonAA95: posts the ante 6
(ANEKDOT)777: posts the ante 6
(ANEKDOT)777: posts small blind 25
aconteceu: posts big blind 50
*** HOLE CARDS ***
Dealt to jcarlos.vale [3h 9h]
RapHood: folds 
dimYLiaK: folds 
JokerTonyT: folds 
jcarlos.vale: folds 
EuroKeeper I: folds 
clonharek704: folds 
AyrtonAA95: raises 75 to 125
(ANEKDOT)777: folds 
aconteceu: calls 75
*** FLOP *** [Ac 5h 6h]
aconteceu: bets 165
AyrtonAA95: folds 
Uncalled bet (165) returned to aconteceu
aconteceu collected 329 from pot
*** SUMMARY ***
Total pot 329 | Rake 0 
Board [Ac 5h 6h]
Seat 1: aconteceu (big blind) collected (329)
Seat 2: RapHood folded before Flop (didn't bet)
Seat 3: dimYLiaK folded before Flop (didn't bet)
Seat 4: JokerTonyT folded before Flop (didn't bet)
Seat 5: jcarlos.vale folded before Flop (didn't bet)
Seat 6: EuroKeeper I folded before Flop (didn't bet)
Seat 7: clonharek704 folded before Flop (didn't bet)
Seat 8: AyrtonAA95 (button) folded on the Flop
Seat 9: (ANEKDOT)777 (small blind) folded before Flop



PokerStars Hand #220857964134: Tournament #3060068759, $0.23+$0.02 USD Hold'em No Limit - Level III (25/50) - 2020/11/28 0:35:11 EET [2020/11/27 17:35:11 ET]
Table '3060068759 4' 9-max Seat #9 is the button
Seat 1: aconteceu (7357 in chips) 
Seat 2: RapHood (2822 in chips) 
Seat 3: dimYLiaK (1280 in chips) 
Seat 4: JokerTonyT (1437 in chips) 
Seat 5: jcarlos.vale (1411 in chips) 
Seat 6: EuroKeeper I (1459 in chips) 
Seat 7: clonharek704 (1209 in chips) 
Seat 8: AyrtonAA95 (2348 in chips) 
Seat 9: (ANEKDOT)777 (1584 in chips) 
aconteceu: posts the ante 6
RapHood: posts the ante 6
dimYLiaK: posts the ante 6
JokerTonyT: posts the ante 6
jcarlos.vale: posts the ante 6
EuroKeeper I: posts the ante 6
clonharek704: posts the ante 6
AyrtonAA95: posts the ante 6
(ANEKDOT)777: posts the ante 6
aconteceu: posts small blind 25
RapHood: posts big blind 50
*** HOLE CARDS ***
Dealt to jcarlos.vale [7s 3c]
dimYLiaK: folds 
JokerTonyT: folds 
jcarlos.vale: folds 
EuroKeeper I: raises 50 to 100
clonharek704: folds 
AyrtonAA95: folds 
(ANEKDOT)777: folds 
aconteceu: folds 
RapHood: folds 
Uncalled bet (50) returned to EuroKeeper I
EuroKeeper I collected 179 from pot
EuroKeeper I: doesn't show hand 
*** SUMMARY ***
Total pot 179 | Rake 0 
Seat 1: aconteceu (small blind) folded before Flop
Seat 2: RapHood (big blind) folded before Flop
Seat 3: dimYLiaK folded before Flop (didn't bet)
Seat 4: JokerTonyT folded before Flop (didn't bet)
Seat 5: jcarlos.vale folded before Flop (didn't bet)
Seat 6: EuroKeeper I collected (179)
Seat 7: clonharek704 folded before Flop (didn't bet)
Seat 8: AyrtonAA95 folded before Flop (didn't bet)
Seat 9: (ANEKDOT)777 (button) folded before Flop (didn't bet)



PokerStars Hand #220858004024: Tournament #3060068759, $0.23+$0.02 USD Hold'em No Limit - Level III (25/50) - 2020/11/28 0:36:09 EET [2020/11/27 17:36:09 ET]
Table '3060068759 4' 9-max Seat #1 is the button
Seat 1: aconteceu (7326 in chips) 
Seat 2: RapHood (2766 in chips) 
Seat 3: dimYLiaK (1274 in chips) 
Seat 5: jcarlos.vale (1405 in chips) 
Seat 6: EuroKeeper I (1582 in chips) 
Seat 7: clonharek704 (1203 in chips) 
Seat 8: AyrtonAA95 (2342 in chips) 
Seat 9: (ANEKDOT)777 (1578 in chips) 
aconteceu: posts the ante 6
RapHood: posts the ante 6
dimYLiaK: posts the ante 6
jcarlos.vale: posts the ante 6
EuroKeeper I: posts the ante 6
clonharek704: posts the ante 6
AyrtonAA95: posts the ante 6
(ANEKDOT)777: posts the ante 6
RapHood: posts small blind 25
dimYLiaK: posts big blind 50
*** HOLE CARDS ***
Dealt to jcarlos.vale [2d 8d]
jcarlos.vale: folds 
EuroKeeper I: folds 
clonharek704: raises 75 to 125
AyrtonAA95: folds 
(ANEKDOT)777: folds 
aconteceu: folds 
RapHood: folds 
dimYLiaK: calls 75
*** FLOP *** [5s 9d 4h]
dimYLiaK: checks 
clonharek704: bets 150
dimYLiaK: folds 
Uncalled bet (150) returned to clonharek704
clonharek704 collected 323 from pot
*** SUMMARY ***
Total pot 323 | Rake 0 
Board [5s 9d 4h]
Seat 1: aconteceu (button) folded before Flop (didn't bet)
Seat 2: RapHood (small blind) folded before Flop
Seat 3: dimYLiaK (big blind) folded on the Flop
Seat 5: jcarlos.vale folded before Flop (didn't bet)
Seat 6: EuroKeeper I folded before Flop (didn't bet)
Seat 7: clonharek704 collected (323)
Seat 8: AyrtonAA95 folded before Flop (didn't bet)
Seat 9: (ANEKDOT)777 folded before Flop (didn't bet)



PokerStars Hand #220858051872: Tournament #3060068759, $0.23+$0.02 USD Hold'em No Limit - Level III (25/50) - 2020/11/28 0:37:15 EET [2020/11/27 17:37:15 ET]
Table '3060068759 4' 9-max Seat #2 is the button
Seat 1: aconteceu (7320 in chips) 
Seat 2: RapHood (2735 in chips) 
Seat 3: dimYLiaK (1143 in chips) 
Seat 5: jcarlos.vale (1399 in chips) 
Seat 6: EuroKeeper I (1576 in chips) 
Seat 7: clonharek704 (1395 in chips) 
Seat 8: AyrtonAA95 (2336 in chips) 
Seat 9: (ANEKDOT)777 (1572 in chips) 
aconteceu: posts the ante 6
RapHood: posts the ante 6
dimYLiaK: posts the ante 6
jcarlos.vale: posts the ante 6
EuroKeeper I: posts the ante 6
clonharek704: posts the ante 6
AyrtonAA95: posts the ante 6
(ANEKDOT)777: posts the ante 6
dimYLiaK: posts small blind 25
jcarlos.vale: posts big blind 50
*** HOLE CARDS ***
Dealt to jcarlos.vale [7d Ah]
EuroKeeper I: raises 50 to 100
clonharek704: folds 
AyrtonAA95: folds 
(ANEKDOT)777: folds 
aconteceu: folds 
RapHood: folds 
dimYLiaK: folds 
jcarlos.vale: folds 
Uncalled bet (50) returned to EuroKeeper I
EuroKeeper I collected 173 from pot
EuroKeeper I: doesn't show hand 
*** SUMMARY ***
Total pot 173 | Rake 0 
Seat 1: aconteceu folded before Flop (didn't bet)
Seat 2: RapHood (button) folded before Flop (didn't bet)
Seat 3: dimYLiaK (small blind) folded before Flop
Seat 5: jcarlos.vale (big blind) folded before Flop
Seat 6: EuroKeeper I collected (173)
Seat 7: clonharek704 folded before Flop (didn't bet)
Seat 8: AyrtonAA95 folded before Flop (didn't bet)
Seat 9: (ANEKDOT)777 folded before Flop (didn't bet)



PokerStars Hand #220858071083: Tournament #3060068759, $0.23+$0.02 USD Hold'em No Limit - Level III (25/50) - 2020/11/28 0:37:43 EET [2020/11/27 17:37:43 ET]
Table '3060068759 4' 9-max Seat #3 is the button
Seat 1: aconteceu (7314 in chips) 
Seat 2: RapHood (2729 in chips) 
Seat 3: dimYLiaK (1112 in chips) 
Seat 5: jcarlos.vale (1343 in chips) 
Seat 6: EuroKeeper I (1693 in chips) 
Seat 7: clonharek704 (1389 in chips) 
Seat 8: AyrtonAA95 (2330 in chips) 
Seat 9: (ANEKDOT)777 (1566 in chips) 
aconteceu: posts the ante 6
RapHood: posts the ante 6
dimYLiaK: posts the ante 6
jcarlos.vale: posts the ante 6
EuroKeeper I: posts the ante 6
clonharek704: posts the ante 6
AyrtonAA95: posts the ante 6
(ANEKDOT)777: posts the ante 6
jcarlos.vale: posts small blind 25
EuroKeeper I: posts big blind 50
*** HOLE CARDS ***
Dealt to jcarlos.vale [Kh Qc]
clonharek704: folds 
AyrtonAA95: folds 
(ANEKDOT)777: folds 
aconteceu: raises 50 to 100
RapHood has timed out
RapHood: folds 
RapHood is sitting out
dimYLiaK: folds 
jcarlos.vale: folds 
EuroKeeper I: folds 
Uncalled bet (50) returned to aconteceu
aconteceu collected 173 from pot
*** SUMMARY ***
Total pot 173 | Rake 0 
Seat 1: aconteceu collected (173)
Seat 2: RapHood folded before Flop (didn't bet)
Seat 3: dimYLiaK (button) folded before Flop (didn't bet)
Seat 5: jcarlos.vale (small blind) folded before Flop
Seat 6: EuroKeeper I (big blind) folded before Flop
Seat 7: clonharek704 folded before Flop (didn't bet)
Seat 8: AyrtonAA95 folded before Flop (didn't bet)
Seat 9: (ANEKDOT)777 folded before Flop (didn't bet)



PokerStars Hand #220858120289: Tournament #3060068759, $0.23+$0.02 USD Hold'em No Limit - Level III (25/50) - 2020/11/28 0:38:54 EET [2020/11/27 17:38:54 ET]
Table '3060068759 4' 9-max Seat #5 is the button
Seat 1: aconteceu (7431 in chips) 
Seat 2: RapHood (2723 in chips) is sitting out
Seat 3: dimYLiaK (1106 in chips) 
Seat 5: jcarlos.vale (1312 in chips) 
Seat 6: EuroKeeper I (1637 in chips) 
Seat 7: clonharek704 (1383 in chips) 
Seat 8: AyrtonAA95 (2324 in chips) 
Seat 9: (ANEKDOT)777 (1560 in chips) 
aconteceu: posts the ante 6
RapHood: posts the ante 6
dimYLiaK: posts the ante 6
jcarlos.vale: posts the ante 6
EuroKeeper I: posts the ante 6
clonharek704: posts the ante 6
AyrtonAA95: posts the ante 6
(ANEKDOT)777: posts the ante 6
EuroKeeper I: posts small blind 25
clonharek704: posts big blind 50
*** HOLE CARDS ***
Dealt to jcarlos.vale [8d Ah]
AyrtonAA95: folds 
(ANEKDOT)777: folds 
RapHood has returned
aconteceu: folds 
RapHood: calls 50
dimYLiaK: folds 
jcarlos.vale: folds 
EuroKeeper I: folds 
clonharek704: checks 
*** FLOP *** [8c 3c 5s]
clonharek704: checks 
RapHood: checks 
*** TURN *** [8c 3c 5s] [4c]
clonharek704: checks 
RapHood: checks 
*** RIVER *** [8c 3c 5s 4c] [Qs]
clonharek704: checks 
RapHood: bets 173
clonharek704: folds 
Uncalled bet (173) returned to RapHood
RapHood collected 173 from pot
*** SUMMARY ***
Total pot 173 | Rake 0 
Board [8c 3c 5s 4c Qs]
Seat 1: aconteceu folded before Flop (didn't bet)
Seat 2: RapHood collected (173)
Seat 3: dimYLiaK folded before Flop (didn't bet)
Seat 5: jcarlos.vale (button) folded before Flop (didn't bet)
Seat 6: EuroKeeper I (small blind) folded before Flop
Seat 7: clonharek704 (big blind) folded on the River
Seat 8: AyrtonAA95 folded before Flop (didn't bet)
Seat 9: (ANEKDOT)777 folded before Flop (didn't bet)



PokerStars Hand #220858166025: Tournament #3060068759, $0.23+$0.02 USD Hold'em No Limit - Level IV (40/80) - 2020/11/28 0:40:00 EET [2020/11/27 17:40:00 ET]
Table '3060068759 4' 9-max Seat #6 is the button
Seat 1: aconteceu (7425 in chips) 
Seat 2: RapHood (2840 in chips) 
Seat 3: dimYLiaK (1100 in chips) 
Seat 5: jcarlos.vale (1306 in chips) 
Seat 6: EuroKeeper I (1606 in chips) 
Seat 7: clonharek704 (1327 in chips) 
Seat 8: AyrtonAA95 (2318 in chips) 
Seat 9: (ANEKDOT)777 (1554 in chips) 
aconteceu: posts the ante 10
RapHood: posts the ante 10
dimYLiaK: posts the ante 10
jcarlos.vale: posts the ante 10
EuroKeeper I: posts the ante 10
clonharek704: posts the ante 10
AyrtonAA95: posts the ante 10
(ANEKDOT)777: posts the ante 10
clonharek704: posts small blind 40
AyrtonAA95: posts big blind 80
*** HOLE CARDS ***
Dealt to jcarlos.vale [Jh 9s]
(ANEKDOT)777: folds 
aconteceu: folds 
RapHood: folds 
dimYLiaK: raises 80 to 160
jcarlos.vale: folds 
EuroKeeper I: folds 
clonharek704: folds 
AyrtonAA95: calls 80
*** FLOP *** [2h 2s 6h]
AyrtonAA95: checks 
dimYLiaK: bets 930 and is all-in
AyrtonAA95: folds 
Uncalled bet (930) returned to dimYLiaK
dimYLiaK collected 440 from pot
dimYLiaK: doesn't show hand 
*** SUMMARY ***
Total pot 440 | Rake 0 
Board [2h 2s 6h]
Seat 1: aconteceu folded before Flop (didn't bet)
Seat 2: RapHood folded before Flop (didn't bet)
Seat 3: dimYLiaK collected (440)
Seat 5: jcarlos.vale folded before Flop (didn't bet)
Seat 6: EuroKeeper I (button) folded before Flop (didn't bet)
Seat 7: clonharek704 (small blind) folded before Flop
Seat 8: AyrtonAA95 (big blind) folded on the Flop
Seat 9: (ANEKDOT)777 folded before Flop (didn't bet)



PokerStars Hand #220858199006: Tournament #3060068759, $0.23+$0.02 USD Hold'em No Limit - Level IV (40/80) - 2020/11/28 0:40:34 EET [2020/11/27 17:40:34 ET]
Table '3060068759 4' 9-max Seat #7 is the button
Seat 1: aconteceu (7415 in chips) 
Seat 2: RapHood (2830 in chips) 
Seat 3: dimYLiaK (1370 in chips) 
Seat 5: jcarlos.vale (1296 in chips) 
Seat 6: EuroKeeper I (1596 in chips) 
Seat 7: clonharek704 (1277 in chips) 
Seat 8: AyrtonAA95 (2148 in chips) 
Seat 9: (ANEKDOT)777 (1544 in chips) 
aconteceu: posts the ante 10
RapHood: posts the ante 10
dimYLiaK: posts the ante 10
jcarlos.vale: posts the ante 10
EuroKeeper I: posts the ante 10
clonharek704: posts the ante 10
AyrtonAA95: posts the ante 10
(ANEKDOT)777: posts the ante 10
AyrtonAA95: posts small blind 40
(ANEKDOT)777: posts big blind 80
*** HOLE CARDS ***
Dealt to jcarlos.vale [7c 7d]
aconteceu: folds 
RapHood: folds 
dimYLiaK: folds 
jcarlos.vale: raises 1206 to 1286 and is all-in
EuroKeeper I: folds 
clonharek704: folds 
AyrtonAA95: folds 
(ANEKDOT)777: folds 
Uncalled bet (1206) returned to jcarlos.vale
jcarlos.vale collected 280 from pot
jcarlos.vale: doesn't show hand 
*** SUMMARY ***
Total pot 280 | Rake 0 
Seat 1: aconteceu folded before Flop (didn't bet)
Seat 2: RapHood folded before Flop (didn't bet)
Seat 3: dimYLiaK folded before Flop (didn't bet)
Seat 5: jcarlos.vale collected (280)
Seat 6: EuroKeeper I folded before Flop (didn't bet)
Seat 7: clonharek704 (button) folded before Flop (didn't bet)
Seat 8: AyrtonAA95 (small blind) folded before Flop
Seat 9: (ANEKDOT)777 (big blind) folded before Flop



PokerStars Hand #220858218956: Tournament #3060068759, $0.23+$0.02 USD Hold'em No Limit - Level IV (40/80) - 2020/11/28 0:41:02 EET [2020/11/27 17:41:02 ET]
Table '3060068759 4' 9-max Seat #8 is the button
Seat 1: aconteceu (7405 in chips) 
Seat 2: RapHood (2820 in chips) 
Seat 3: dimYLiaK (1360 in chips) 
Seat 5: jcarlos.vale (1486 in chips) 
Seat 6: EuroKeeper I (1586 in chips) 
Seat 7: clonharek704 (1267 in chips) 
Seat 8: AyrtonAA95 (2098 in chips) 
Seat 9: (ANEKDOT)777 (1454 in chips) 
aconteceu: posts the ante 10
RapHood: posts the ante 10
dimYLiaK: posts the ante 10
jcarlos.vale: posts the ante 10
EuroKeeper I: posts the ante 10
clonharek704: posts the ante 10
AyrtonAA95: posts the ante 10
(ANEKDOT)777: posts the ante 10
(ANEKDOT)777: posts small blind 40
aconteceu: posts big blind 80
*** HOLE CARDS ***
Dealt to jcarlos.vale [7c Ac]
RapHood: folds 
dimYLiaK: folds 
jcarlos.vale: raises 128 to 208
EuroKeeper I: folds 
clonharek704: folds 
AyrtonAA95: calls 208
(ANEKDOT)777: folds 
aconteceu: folds 
*** FLOP *** [Qs 6h 5d]
jcarlos.vale: checks 
AyrtonAA95: bets 203
jcarlos.vale: folds 
Uncalled bet (203) returned to AyrtonAA95
AyrtonAA95 collected 616 from pot
AyrtonAA95: doesn't show hand 
*** SUMMARY ***
Total pot 616 | Rake 0 
Board [Qs 6h 5d]
Seat 1: aconteceu (big blind) folded before Flop
Seat 2: RapHood folded before Flop (didn't bet)
Seat 3: dimYLiaK folded before Flop (didn't bet)
Seat 5: jcarlos.vale folded on the Flop
Seat 6: EuroKeeper I folded before Flop (didn't bet)
Seat 7: clonharek704 folded before Flop (didn't bet)
Seat 8: AyrtonAA95 (button) collected (616)
Seat 9: (ANEKDOT)777 (small blind) folded before Flop



PokerStars Hand #220858251627: Tournament #3060068759, $0.23+$0.02 USD Hold'em No Limit - Level IV (40/80) - 2020/11/28 0:41:50 EET [2020/11/27 17:41:50 ET]
Table '3060068759 4' 9-max Seat #9 is the button
Seat 1: aconteceu (7315 in chips) 
Seat 2: RapHood (2810 in chips) 
Seat 3: dimYLiaK (1350 in chips) 
Seat 5: jcarlos.vale (1268 in chips) 
Seat 6: EuroKeeper I (1576 in chips) 
Seat 7: clonharek704 (1257 in chips) 
Seat 8: AyrtonAA95 (2496 in chips) 
Seat 9: (ANEKDOT)777 (1404 in chips) 
aconteceu: posts the ante 10
RapHood: posts the ante 10
dimYLiaK: posts the ante 10
jcarlos.vale: posts the ante 10
EuroKeeper I: posts the ante 10
clonharek704: posts the ante 10
AyrtonAA95: posts the ante 10
(ANEKDOT)777: posts the ante 10
aconteceu: posts small blind 40
RapHood: posts big blind 80
*** HOLE CARDS ***
Dealt to jcarlos.vale [Kh 4h]
dimYLiaK: folds 
jcarlos.vale: folds 
EuroKeeper I: folds 
clonharek704: raises 80 to 160
AyrtonAA95: folds 
(ANEKDOT)777: folds 
aconteceu: folds 
RapHood: folds 
Uncalled bet (80) returned to clonharek704
clonharek704 collected 280 from pot
*** SUMMARY ***
Total pot 280 | Rake 0 
Seat 1: aconteceu (small blind) folded before Flop
Seat 2: RapHood (big blind) folded before Flop
Seat 3: dimYLiaK folded before Flop (didn't bet)
Seat 5: jcarlos.vale folded before Flop (didn't bet)
Seat 6: EuroKeeper I folded before Flop (didn't bet)
Seat 7: clonharek704 collected (280)
Seat 8: AyrtonAA95 folded before Flop (didn't bet)
Seat 9: (ANEKDOT)777 (button) folded before Flop (didn't bet)



PokerStars Hand #220858281289: Tournament #3060068759, $0.23+$0.02 USD Hold'em No Limit - Level IV (40/80) - 2020/11/28 0:42:33 EET [2020/11/27 17:42:33 ET]
Table '3060068759 4' 9-max Seat #1 is the button
Seat 1: aconteceu (7265 in chips) 
Seat 2: RapHood (2720 in chips) 
Seat 3: dimYLiaK (1340 in chips) 
Seat 5: jcarlos.vale (1258 in chips) 
Seat 6: EuroKeeper I (1566 in chips) 
Seat 7: clonharek704 (1447 in chips) 
Seat 8: AyrtonAA95 (2486 in chips) 
Seat 9: (ANEKDOT)777 (1394 in chips) 
aconteceu: posts the ante 10
RapHood: posts the ante 10
dimYLiaK: posts the ante 10
jcarlos.vale: posts the ante 10
EuroKeeper I: posts the ante 10
clonharek704: posts the ante 10
AyrtonAA95: posts the ante 10
(ANEKDOT)777: posts the ante 10
RapHood: posts small blind 40
dimYLiaK: posts big blind 80
*** HOLE CARDS ***
Dealt to jcarlos.vale [Ts 5s]
jcarlos.vale: folds 
EuroKeeper I: folds 
clonharek704: folds 
AyrtonAA95: raises 80 to 160
(ANEKDOT)777: raises 1224 to 1384 and is all-in
aconteceu: folds 
RapHood: folds 
dimYLiaK: folds 
AyrtonAA95: folds 
Uncalled bet (1224) returned to (ANEKDOT)777
(ANEKDOT)777 collected 520 from pot
(ANEKDOT)777: doesn't show hand 
*** SUMMARY ***
Total pot 520 | Rake 0 
Seat 1: aconteceu (button) folded before Flop (didn't bet)
Seat 2: RapHood (small blind) folded before Flop
Seat 3: dimYLiaK (big blind) folded before Flop
Seat 5: jcarlos.vale folded before Flop (didn't bet)
Seat 6: EuroKeeper I folded before Flop (didn't bet)
Seat 7: clonharek704 folded before Flop (didn't bet)
Seat 8: AyrtonAA95 folded before Flop
Seat 9: (ANEKDOT)777 collected (520)



PokerStars Hand #220858320215: Tournament #3060068759, $0.23+$0.02 USD Hold'em No Limit - Level IV (40/80) - 2020/11/28 0:43:30 EET [2020/11/27 17:43:30 ET]
Table '3060068759 4' 9-max Seat #2 is the button
Seat 1: aconteceu (7255 in chips) 
Seat 2: RapHood (2670 in chips) 
Seat 3: dimYLiaK (1250 in chips) 
Seat 5: jcarlos.vale (1248 in chips) 
Seat 6: EuroKeeper I (1556 in chips) 
Seat 7: clonharek704 (1437 in chips) 
Seat 8: AyrtonAA95 (2316 in chips) 
Seat 9: (ANEKDOT)777 (1744 in chips) 
aconteceu: posts the ante 10
RapHood: posts the ante 10
dimYLiaK: posts the ante 10
jcarlos.vale: posts the ante 10
EuroKeeper I: posts the ante 10
clonharek704: posts the ante 10
AyrtonAA95: posts the ante 10
(ANEKDOT)777: posts the ante 10
dimYLiaK: posts small blind 40
jcarlos.vale: posts big blind 80
*** HOLE CARDS ***
Dealt to jcarlos.vale [8d 5c]
EuroKeeper I: raises 80 to 160
clonharek704: folds 
AyrtonAA95: folds 
(ANEKDOT)777: folds 
aconteceu: folds 
RapHood: folds 
dimYLiaK: folds 
jcarlos.vale: folds 
Uncalled bet (80) returned to EuroKeeper I
EuroKeeper I collected 280 from pot
EuroKeeper I: doesn't show hand 
*** SUMMARY ***
Total pot 280 | Rake 0 
Seat 1: aconteceu folded before Flop (didn't bet)
Seat 2: RapHood (button) folded before Flop (didn't bet)
Seat 3: dimYLiaK (small blind) folded before Flop
Seat 5: jcarlos.vale (big blind) folded before Flop
Seat 6: EuroKeeper I collected (280)
Seat 7: clonharek704 folded before Flop (didn't bet)
Seat 8: AyrtonAA95 folded before Flop (didn't bet)
Seat 9: (ANEKDOT)777 folded before Flop (didn't bet)



PokerStars Hand #220858338798: Tournament #3060068759, $0.23+$0.02 USD Hold'em No Limit - Level IV (40/80) - 2020/11/28 0:43:57 EET [2020/11/27 17:43:57 ET]
Table '3060068759 4' 9-max Seat #3 is the button
Seat 1: aconteceu (7245 in chips) 
Seat 2: RapHood (2660 in chips) 
Seat 3: dimYLiaK (1200 in chips) 
Seat 5: jcarlos.vale (1158 in chips) 
Seat 6: EuroKeeper I (1746 in chips) 
Seat 7: clonharek704 (1427 in chips) 
Seat 8: AyrtonAA95 (2306 in chips) 
Seat 9: (ANEKDOT)777 (1734 in chips) 
aconteceu: posts the ante 10
RapHood: posts the ante 10
dimYLiaK: posts the ante 10
jcarlos.vale: posts the ante 10
EuroKeeper I: posts the ante 10
clonharek704: posts the ante 10
AyrtonAA95: posts the ante 10
(ANEKDOT)777: posts the ante 10
jcarlos.vale: posts small blind 40
EuroKeeper I: posts big blind 80
*** HOLE CARDS ***
Dealt to jcarlos.vale [5d Ac]
clonharek704: folds 
AyrtonAA95: folds 
(ANEKDOT)777: folds 
aconteceu: folds 
RapHood: calls 80
dimYLiaK: folds 
jcarlos.vale: raises 1068 to 1148 and is all-in
EuroKeeper I: folds 
RapHood: folds 
Uncalled bet (1068) returned to jcarlos.vale
jcarlos.vale collected 320 from pot
jcarlos.vale: doesn't show hand 
*** SUMMARY ***
Total pot 320 | Rake 0 
Seat 1: aconteceu folded before Flop (didn't bet)
Seat 2: RapHood folded before Flop
Seat 3: dimYLiaK (button) folded before Flop (didn't bet)
Seat 5: jcarlos.vale (small blind) collected (320)
Seat 6: EuroKeeper I (big blind) folded before Flop
Seat 7: clonharek704 folded before Flop (didn't bet)
Seat 8: AyrtonAA95 folded before Flop (didn't bet)
Seat 9: (ANEKDOT)777 folded before Flop (didn't bet)



PokerStars Hand #220858379968: Tournament #3060068759, $0.23+$0.02 USD Hold'em No Limit - Level IV (40/80) - 2020/11/28 0:44:57 EET [2020/11/27 17:44:57 ET]
Table '3060068759 4' 9-max Seat #5 is the button
Seat 1: aconteceu (7235 in chips) 
Seat 3: dimYLiaK (1190 in chips) 
Seat 5: jcarlos.vale (1388 in chips) 
Seat 6: EuroKeeper I (1656 in chips) 
Seat 7: clonharek704 (1417 in chips) 
Seat 8: AyrtonAA95 (2296 in chips) 
Seat 9: (ANEKDOT)777 (1724 in chips) 
aconteceu: posts the ante 10
dimYLiaK: posts the ante 10
jcarlos.vale: posts the ante 10
EuroKeeper I: posts the ante 10
clonharek704: posts the ante 10
AyrtonAA95: posts the ante 10
(ANEKDOT)777: posts the ante 10
EuroKeeper I: posts small blind 40
clonharek704: posts big blind 80
*** HOLE CARDS ***
Dealt to jcarlos.vale [5d 4c]
AyrtonAA95: folds 
(ANEKDOT)777: folds 
aconteceu: calls 80
dimYLiaK: folds 
jcarlos.vale: folds 
EuroKeeper I: folds 
clonharek704: checks 
*** FLOP *** [7s 3d Th]
clonharek704: checks 
aconteceu: checks 
*** TURN *** [7s 3d Th] [Qs]
clonharek704: checks 
aconteceu: checks 
*** RIVER *** [7s 3d Th Qs] [2c]
clonharek704: checks 
aconteceu: bets 240
clonharek704: folds 
Uncalled bet (240) returned to aconteceu
aconteceu collected 270 from pot
*** SUMMARY ***
Total pot 270 | Rake 0 
Board [7s 3d Th Qs 2c]
Seat 1: aconteceu collected (270)
Seat 3: dimYLiaK folded before Flop (didn't bet)
Seat 5: jcarlos.vale (button) folded before Flop (didn't bet)
Seat 6: EuroKeeper I (small blind) folded before Flop
Seat 7: clonharek704 (big blind) folded on the River
Seat 8: AyrtonAA95 folded before Flop (didn't bet)
Seat 9: (ANEKDOT)777 folded before Flop (didn't bet)



PokerStars Hand #220858426161: Tournament #3060068759, $0.23+$0.02 USD Hold'em No Limit - Level IV (40/80) - 2020/11/28 0:46:06 EET [2020/11/27 17:46:06 ET]
Table '3060068759 4' 9-max Seat #6 is the button
Seat 1: aconteceu (7415 in chips) 
Seat 2: hazardlab (1316 in chips) 
Seat 3: dimYLiaK (1180 in chips) 
Seat 4: Jaacck6 (2450 in chips) 
Seat 5: jcarlos.vale (1378 in chips) 
Seat 6: EuroKeeper I (1606 in chips) 
Seat 7: clonharek704 (1327 in chips) 
Seat 8: AyrtonAA95 (2286 in chips) 
Seat 9: (ANEKDOT)777 (1714 in chips) 
aconteceu: posts the ante 10
hazardlab: posts the ante 10
dimYLiaK: posts the ante 10
Jaacck6: posts the ante 10
jcarlos.vale: posts the ante 10
EuroKeeper I: posts the ante 10
clonharek704: posts the ante 10
AyrtonAA95: posts the ante 10
(ANEKDOT)777: posts the ante 10
clonharek704: posts small blind 40
AyrtonAA95: posts big blind 80
*** HOLE CARDS ***
Dealt to jcarlos.vale [4s 3s]
(ANEKDOT)777: folds 
aconteceu: raises 290 to 370
hazardlab: folds 
dimYLiaK: folds 
Jaacck6: folds 
jcarlos.vale: folds 
EuroKeeper I: folds 
clonharek704: folds 
AyrtonAA95: calls 290
*** FLOP *** [3h As Qd]
AyrtonAA95: checks 
aconteceu: bets 435
AyrtonAA95: calls 435
*** TURN *** [3h As Qd] [2h]
AyrtonAA95: checks 
aconteceu: bets 870
AyrtonAA95: raises 601 to 1471 and is all-in
aconteceu: calls 601
*** RIVER *** [3h As Qd 2h] [7c]
*** SHOW DOWN ***
AyrtonAA95: shows [Ad Kc] (a pair of Aces)
aconteceu: shows [Ac Jh] (a pair of Aces - lower kicker)
AyrtonAA95 collected 4682 from pot
AyrtonAA95 said, "valeu"
*** SUMMARY ***
Total pot 4682 | Rake 0 
Board [3h As Qd 2h 7c]
Seat 1: aconteceu showed [Ac Jh] and lost with a pair of Aces
Seat 2: hazardlab folded before Flop (didn't bet)
Seat 3: dimYLiaK folded before Flop (didn't bet)
Seat 4: Jaacck6 folded before Flop (didn't bet)
Seat 5: jcarlos.vale folded before Flop (didn't bet)
Seat 6: EuroKeeper I (button) folded before Flop (didn't bet)
Seat 7: clonharek704 (small blind) folded before Flop
Seat 8: AyrtonAA95 (big blind) showed [Ad Kc] and won (4682) with a pair of Aces
Seat 9: (ANEKDOT)777 folded before Flop (didn't bet)



PokerStars Hand #220858486057: Tournament #3060068759, $0.23+$0.02 USD Hold'em No Limit - Level IV (40/80) - 2020/11/28 0:47:34 EET [2020/11/27 17:47:34 ET]
Table '3060068759 4' 9-max Seat #7 is the button
Seat 1: aconteceu (5129 in chips) 
Seat 2: hazardlab (1306 in chips) 
Seat 3: dimYLiaK (1170 in chips) 
Seat 4: Jaacck6 (2440 in chips) 
Seat 5: jcarlos.vale (1368 in chips) 
Seat 6: EuroKeeper I (1596 in chips) 
Seat 7: clonharek704 (1277 in chips) 
Seat 8: AyrtonAA95 (4682 in chips) 
Seat 9: (ANEKDOT)777 (1704 in chips) 
aconteceu: posts the ante 10
hazardlab: posts the ante 10
dimYLiaK: posts the ante 10
Jaacck6: posts the ante 10
jcarlos.vale: posts the ante 10
EuroKeeper I: posts the ante 10
clonharek704: posts the ante 10
AyrtonAA95: posts the ante 10
(ANEKDOT)777: posts the ante 10
AyrtonAA95: posts small blind 40
(ANEKDOT)777: posts big blind 80
*** HOLE CARDS ***
Dealt to jcarlos.vale [3s Ah]
aconteceu: folds 
hazardlab: raises 80 to 160
dimYLiaK: folds 
Jaacck6: raises 80 to 240
jcarlos.vale: folds 
EuroKeeper I: folds 
clonharek704: folds 
AyrtonAA95: folds 
(ANEKDOT)777: folds 
hazardlab: calls 80
*** FLOP *** [Qd Kd 6h]
hazardlab: checks 
Jaacck6: checks 
*** TURN *** [Qd Kd 6h] [5d]
hazardlab: bets 80
Jaacck6: calls 80
*** RIVER *** [Qd Kd 6h 5d] [Td]
hazardlab: bets 80
Jaacck6: raises 2030 to 2110 and is all-in
hazardlab: calls 896 and is all-in
Uncalled bet (1134) returned to Jaacck6
*** SHOW DOWN ***
Jaacck6: shows [4h 4d] (a flush, King high)
hazardlab: shows [Jd Qh] (a flush, King high - Jack higher)
hazardlab collected 2802 from pot
*** SUMMARY ***
Total pot 2802 | Rake 0 
Board [Qd Kd 6h 5d Td]
Seat 1: aconteceu folded before Flop (didn't bet)
Seat 2: hazardlab showed [Jd Qh] and won (2802) with a flush, King high
Seat 3: dimYLiaK folded before Flop (didn't bet)
Seat 4: Jaacck6 showed [4h 4d] and lost with a flush, King high
Seat 5: jcarlos.vale folded before Flop (didn't bet)
Seat 6: EuroKeeper I folded before Flop (didn't bet)
Seat 7: clonharek704 (button) folded before Flop (didn't bet)
Seat 8: AyrtonAA95 (small blind) folded before Flop
Seat 9: (ANEKDOT)777 (big blind) folded before Flop



PokerStars Hand #220858537374: Tournament #3060068759, $0.23+$0.02 USD Hold'em No Limit - Level IV (40/80) - 2020/11/28 0:48:39 EET [2020/11/27 17:48:39 ET]
Table '3060068759 4' 9-max Seat #8 is the button
Seat 1: aconteceu (5119 in chips) 
Seat 2: hazardlab (2802 in chips) 
Seat 3: dimYLiaK (1160 in chips) 
Seat 4: Jaacck6 (1134 in chips) 
Seat 5: jcarlos.vale (1358 in chips) 
Seat 6: EuroKeeper I (1586 in chips) 
Seat 7: clonharek704 (1267 in chips) 
Seat 8: AyrtonAA95 (4632 in chips) 
Seat 9: (ANEKDOT)777 (1614 in chips) 
aconteceu: posts the ante 10
hazardlab: posts the ante 10
dimYLiaK: posts the ante 10
Jaacck6: posts the ante 10
jcarlos.vale: posts the ante 10
EuroKeeper I: posts the ante 10
clonharek704: posts the ante 10
AyrtonAA95: posts the ante 10
(ANEKDOT)777: posts the ante 10
(ANEKDOT)777: posts small blind 40
aconteceu: posts big blind 80
*** HOLE CARDS ***
Dealt to jcarlos.vale [7d Th]
hazardlab: calls 80
dimYLiaK: folds 
Jaacck6: folds 
jcarlos.vale: folds 
EuroKeeper I: folds 
clonharek704: folds 
AyrtonAA95: folds 
(ANEKDOT)777: raises 1524 to 1604 and is all-in
aconteceu: raises 1524 to 3128
hazardlab: folds 
Uncalled bet (1524) returned to aconteceu
*** FLOP *** [6s Kh Kc]
*** TURN *** [6s Kh Kc] [3d]
*** RIVER *** [6s Kh Kc 3d] [Qd]
*** SHOW DOWN ***
(ANEKDOT)777: shows [Qs Qc] (a full house, Queens full of Kings)
aconteceu: shows [9h 9s] (two pair, Kings and Nines)
(ANEKDOT)777 collected 3378 from pot
*** SUMMARY ***
Total pot 3378 | Rake 0 
Board [6s Kh Kc 3d Qd]
Seat 1: aconteceu (big blind) showed [9h 9s] and lost with two pair, Kings and Nines
Seat 2: hazardlab folded before Flop
Seat 3: dimYLiaK folded before Flop (didn't bet)
Seat 4: Jaacck6 folded before Flop (didn't bet)
Seat 5: jcarlos.vale folded before Flop (didn't bet)
Seat 6: EuroKeeper I folded before Flop (didn't bet)
Seat 7: clonharek704 folded before Flop (didn't bet)
Seat 8: AyrtonAA95 (button) folded before Flop (didn't bet)
Seat 9: (ANEKDOT)777 (small blind) showed [Qs Qc] and won (3378) with a full house, Queens full of Kings



PokerStars Hand #220858566639: Tournament #3060068759, $0.23+$0.02 USD Hold'em No Limit - Level V (60/120) - 2020/11/28 0:49:22 EET [2020/11/27 17:49:22 ET]
Table '3060068759 4' 9-max Seat #9 is the button
Seat 1: aconteceu (3505 in chips) 
Seat 2: hazardlab (2712 in chips) 
Seat 3: dimYLiaK (1150 in chips) 
Seat 4: Jaacck6 (1124 in chips) 
Seat 5: jcarlos.vale (1348 in chips) 
Seat 6: EuroKeeper I (1576 in chips) 
Seat 7: clonharek704 (1257 in chips) 
Seat 8: AyrtonAA95 (4622 in chips) 
Seat 9: (ANEKDOT)777 (3378 in chips) 
aconteceu: posts the ante 15
hazardlab: posts the ante 15
dimYLiaK: posts the ante 15
Jaacck6: posts the ante 15
jcarlos.vale: posts the ante 15
EuroKeeper I: posts the ante 15
clonharek704: posts the ante 15
AyrtonAA95: posts the ante 15
(ANEKDOT)777: posts the ante 15
aconteceu: posts small blind 60
hazardlab: posts big blind 120
*** HOLE CARDS ***
Dealt to jcarlos.vale [6c Qd]
dimYLiaK: folds 
Jaacck6: folds 
jcarlos.vale: folds 
EuroKeeper I: folds 
clonharek704: folds 
AyrtonAA95: raises 120 to 240
(ANEKDOT)777: folds 
aconteceu: folds 
hazardlab: folds 
Uncalled bet (120) returned to AyrtonAA95
AyrtonAA95 collected 435 from pot
AyrtonAA95: doesn't show hand 
*** SUMMARY ***
Total pot 435 | Rake 0 
Seat 1: aconteceu (small blind) folded before Flop
Seat 2: hazardlab (big blind) folded before Flop
Seat 3: dimYLiaK folded before Flop (didn't bet)
Seat 4: Jaacck6 folded before Flop (didn't bet)
Seat 5: jcarlos.vale folded before Flop (didn't bet)
Seat 6: EuroKeeper I folded before Flop (didn't bet)
Seat 7: clonharek704 folded before Flop (didn't bet)
Seat 8: AyrtonAA95 collected (435)
Seat 9: (ANEKDOT)777 (button) folded before Flop (didn't bet)



PokerStars Hand #220858583312: Tournament #3060068759, $0.23+$0.02 USD Hold'em No Limit - Level V (60/120) - 2020/11/28 0:49:47 EET [2020/11/27 17:49:47 ET]
Table '3060068759 4' 9-max Seat #1 is the button
Seat 1: aconteceu (3430 in chips) 
Seat 2: hazardlab (2577 in chips) 
Seat 3: dimYLiaK (1135 in chips) 
Seat 4: Jaacck6 (1109 in chips) 
Seat 5: jcarlos.vale (1333 in chips) 
Seat 6: EuroKeeper I (1561 in chips) 
Seat 7: clonharek704 (1242 in chips) 
Seat 8: AyrtonAA95 (4922 in chips) 
Seat 9: (ANEKDOT)777 (3363 in chips) 
aconteceu: posts the ante 15
hazardlab: posts the ante 15
dimYLiaK: posts the ante 15
Jaacck6: posts the ante 15
jcarlos.vale: posts the ante 15
EuroKeeper I: posts the ante 15
clonharek704: posts the ante 15
AyrtonAA95: posts the ante 15
(ANEKDOT)777: posts the ante 15
hazardlab: posts small blind 60
dimYLiaK: posts big blind 120
*** HOLE CARDS ***
Dealt to jcarlos.vale [Kc 8c]
Jaacck6: folds 
jcarlos.vale: folds 
EuroKeeper I: raises 1426 to 1546 and is all-in
clonharek704: folds 
AyrtonAA95: folds 
(ANEKDOT)777: folds 
aconteceu: folds 
hazardlab: folds 
dimYLiaK: folds 
Uncalled bet (1426) returned to EuroKeeper I
EuroKeeper I collected 435 from pot
EuroKeeper I: doesn't show hand 
*** SUMMARY ***
Total pot 435 | Rake 0 
Seat 1: aconteceu (button) folded before Flop (didn't bet)
Seat 2: hazardlab (small blind) folded before Flop
Seat 3: dimYLiaK (big blind) folded before Flop
Seat 4: Jaacck6 folded before Flop (didn't bet)
Seat 5: jcarlos.vale folded before Flop (didn't bet)
Seat 6: EuroKeeper I collected (435)
Seat 7: clonharek704 folded before Flop (didn't bet)
Seat 8: AyrtonAA95 folded before Flop (didn't bet)
Seat 9: (ANEKDOT)777 folded before Flop (didn't bet)



PokerStars Hand #220858616273: Tournament #3060068759, $0.23+$0.02 USD Hold'em No Limit - Level V (60/120) - 2020/11/28 0:50:37 EET [2020/11/27 17:50:37 ET]
Table '3060068759 4' 9-max Seat #2 is the button
Seat 1: aconteceu (3415 in chips) 
Seat 2: hazardlab (2502 in chips) 
Seat 3: dimYLiaK (1000 in chips) 
Seat 5: jcarlos.vale (1318 in chips) 
Seat 6: EuroKeeper I (1861 in chips) 
Seat 7: clonharek704 (1227 in chips) 
Seat 8: AyrtonAA95 (4907 in chips) 
Seat 9: (ANEKDOT)777 (3348 in chips) 
aconteceu: posts the ante 15
hazardlab: posts the ante 15
dimYLiaK: posts the ante 15
jcarlos.vale: posts the ante 15
EuroKeeper I: posts the ante 15
clonharek704: posts the ante 15
AyrtonAA95: posts the ante 15
(ANEKDOT)777: posts the ante 15
dimYLiaK: posts small blind 60
jcarlos.vale: posts big blind 120
*** HOLE CARDS ***
Dealt to jcarlos.vale [Jh Kd]
EuroKeeper I: folds 
clonharek704: folds 
AyrtonAA95: raises 120 to 240
(ANEKDOT)777: folds 
aconteceu: calls 240
hazardlab: folds 
dimYLiaK: folds 
jcarlos.vale: folds 
*** FLOP *** [Kc 8d Jd]
AyrtonAA95: bets 515
aconteceu: folds 
Uncalled bet (515) returned to AyrtonAA95
AyrtonAA95 collected 780 from pot
AyrtonAA95: doesn't show hand 
*** SUMMARY ***
Total pot 780 | Rake 0 
Board [Kc 8d Jd]
Seat 1: aconteceu folded on the Flop
Seat 2: hazardlab (button) folded before Flop (didn't bet)
Seat 3: dimYLiaK (small blind) folded before Flop
Seat 5: jcarlos.vale (big blind) folded before Flop
Seat 6: EuroKeeper I folded before Flop (didn't bet)
Seat 7: clonharek704 folded before Flop (didn't bet)
Seat 8: AyrtonAA95 collected (780)
Seat 9: (ANEKDOT)777 folded before Flop (didn't bet)



PokerStars Hand #220858644748: Tournament #3060068759, $0.23+$0.02 USD Hold'em No Limit - Level V (60/120) - 2020/11/28 0:51:19 EET [2020/11/27 17:51:19 ET]
Table '3060068759 4' 9-max Seat #3 is the button
Seat 1: aconteceu (3160 in chips) 
Seat 2: hazardlab (2487 in chips) 
Seat 3: dimYLiaK (925 in chips) 
Seat 5: jcarlos.vale (1183 in chips) 
Seat 6: EuroKeeper I (1846 in chips) 
Seat 7: clonharek704 (1212 in chips) 
Seat 8: AyrtonAA95 (5432 in chips) 
Seat 9: (ANEKDOT)777 (3333 in chips) 
aconteceu: posts the ante 15
hazardlab: posts the ante 15
dimYLiaK: posts the ante 15
jcarlos.vale: posts the ante 15
EuroKeeper I: posts the ante 15
clonharek704: posts the ante 15
AyrtonAA95: posts the ante 15
(ANEKDOT)777: posts the ante 15
jcarlos.vale: posts small blind 60
EuroKeeper I: posts big blind 120
*** HOLE CARDS ***
Dealt to jcarlos.vale [Qh Td]
clonharek704: folds 
AyrtonAA95: folds 
(ANEKDOT)777: folds 
aconteceu: folds 
hazardlab: folds 
dimYLiaK: raises 790 to 910 and is all-in
jcarlos.vale: folds 
EuroKeeper I: folds 
Uncalled bet (790) returned to dimYLiaK
dimYLiaK collected 420 from pot
dimYLiaK: doesn't show hand 
*** SUMMARY ***
Total pot 420 | Rake 0 
Seat 1: aconteceu folded before Flop (didn't bet)
Seat 2: hazardlab folded before Flop (didn't bet)
Seat 3: dimYLiaK (button) collected (420)
Seat 5: jcarlos.vale (small blind) folded before Flop
Seat 6: EuroKeeper I (big blind) folded before Flop
Seat 7: clonharek704 folded before Flop (didn't bet)
Seat 8: AyrtonAA95 folded before Flop (didn't bet)
Seat 9: (ANEKDOT)777 folded before Flop (didn't bet)



PokerStars Hand #220858663570: Tournament #3060068759, $0.23+$0.02 USD Hold'em No Limit - Level V (60/120) - 2020/11/28 0:51:48 EET [2020/11/27 17:51:48 ET]
Table '3060068759 4' 9-max Seat #5 is the button
Seat 1: aconteceu (3145 in chips) 
Seat 2: hazardlab (2472 in chips) 
Seat 3: dimYLiaK (1210 in chips) 
Seat 5: jcarlos.vale (1108 in chips) 
Seat 6: EuroKeeper I (1711 in chips) 
Seat 7: clonharek704 (1197 in chips) 
Seat 8: AyrtonAA95 (5417 in chips) 
Seat 9: (ANEKDOT)777 (3318 in chips) 
aconteceu: posts the ante 15
hazardlab: posts the ante 15
dimYLiaK: posts the ante 15
jcarlos.vale: posts the ante 15
EuroKeeper I: posts the ante 15
clonharek704: posts the ante 15
AyrtonAA95: posts the ante 15
(ANEKDOT)777: posts the ante 15
EuroKeeper I: posts small blind 60
clonharek704: posts big blind 120
*** HOLE CARDS ***
Dealt to jcarlos.vale [Jd 3d]
AyrtonAA95: folds 
(ANEKDOT)777: folds 
aconteceu: folds 
hazardlab: folds 
dimYLiaK: raises 1075 to 1195 and is all-in
jcarlos.vale: folds 
EuroKeeper I: folds 
clonharek704: folds 
Uncalled bet (1075) returned to dimYLiaK
dimYLiaK collected 420 from pot
dimYLiaK: doesn't show hand 
*** SUMMARY ***
Total pot 420 | Rake 0 
Seat 1: aconteceu folded before Flop (didn't bet)
Seat 2: hazardlab folded before Flop (didn't bet)
Seat 3: dimYLiaK collected (420)
Seat 5: jcarlos.vale (button) folded before Flop (didn't bet)
Seat 6: EuroKeeper I (small blind) folded before Flop
Seat 7: clonharek704 (big blind) folded before Flop
Seat 8: AyrtonAA95 folded before Flop (didn't bet)
Seat 9: (ANEKDOT)777 folded before Flop (didn't bet)



PokerStars Hand #220858681506: Tournament #3060068759, $0.23+$0.02 USD Hold'em No Limit - Level V (60/120) - 2020/11/28 0:52:15 EET [2020/11/27 17:52:15 ET]
Table '3060068759 4' 9-max Seat #6 is the button
Seat 1: aconteceu (3130 in chips) 
Seat 2: hazardlab (2457 in chips) 
Seat 3: dimYLiaK (1495 in chips) 
Seat 5: jcarlos.vale (1093 in chips) 
Seat 6: EuroKeeper I (1636 in chips) 
Seat 7: clonharek704 (1062 in chips) 
Seat 8: AyrtonAA95 (5402 in chips) 
Seat 9: (ANEKDOT)777 (3303 in chips) 
aconteceu: posts the ante 15
hazardlab: posts the ante 15
dimYLiaK: posts the ante 15
jcarlos.vale: posts the ante 15
EuroKeeper I: posts the ante 15
clonharek704: posts the ante 15
AyrtonAA95: posts the ante 15
(ANEKDOT)777: posts the ante 15
clonharek704: posts small blind 60
AyrtonAA95: posts big blind 120
*** HOLE CARDS ***
Dealt to jcarlos.vale [7c Tc]
(ANEKDOT)777: folds 
aconteceu: raises 360 to 480
hazardlab: folds 
dimYLiaK: folds 
jcarlos.vale: folds 
EuroKeeper I: folds 
clonharek704: folds 
AyrtonAA95: folds 
Uncalled bet (360) returned to aconteceu
aconteceu collected 420 from pot
aconteceu: shows [Kd Kh] (a pair of Kings)
*** SUMMARY ***
Total pot 420 | Rake 0 
Seat 1: aconteceu collected (420)
Seat 2: hazardlab folded before Flop (didn't bet)
Seat 3: dimYLiaK folded before Flop (didn't bet)
Seat 5: jcarlos.vale folded before Flop (didn't bet)
Seat 6: EuroKeeper I (button) folded before Flop (didn't bet)
Seat 7: clonharek704 (small blind) folded before Flop
Seat 8: AyrtonAA95 (big blind) folded before Flop
Seat 9: (ANEKDOT)777 folded before Flop (didn't bet)



PokerStars Hand #220858717959: Tournament #3060068759, $0.23+$0.02 USD Hold'em No Limit - Level V (60/120) - 2020/11/28 0:53:10 EET [2020/11/27 17:53:10 ET]
Table '3060068759 4' 9-max Seat #7 is the button
Seat 1: aconteceu (3415 in chips) 
Seat 2: hazardlab (2442 in chips) 
Seat 3: dimYLiaK (1480 in chips) 
Seat 5: jcarlos.vale (1078 in chips) 
Seat 6: EuroKeeper I (1621 in chips) 
Seat 7: clonharek704 (987 in chips) 
Seat 8: AyrtonAA95 (5267 in chips) 
Seat 9: (ANEKDOT)777 (3288 in chips) 
aconteceu: posts the ante 15
hazardlab: posts the ante 15
dimYLiaK: posts the ante 15
jcarlos.vale: posts the ante 15
EuroKeeper I: posts the ante 15
clonharek704: posts the ante 15
AyrtonAA95: posts the ante 15
(ANEKDOT)777: posts the ante 15
AyrtonAA95: posts small blind 60
(ANEKDOT)777: posts big blind 120
*** HOLE CARDS ***
Dealt to jcarlos.vale [6d 4d]
aconteceu: raises 120 to 240
hazardlab: folds 
dimYLiaK: folds 
jcarlos.vale: folds 
EuroKeeper I: folds 
clonharek704: folds 
AyrtonAA95: folds 
(ANEKDOT)777: folds 
Uncalled bet (120) returned to aconteceu
aconteceu collected 420 from pot
*** SUMMARY ***
Total pot 420 | Rake 0 
Seat 1: aconteceu collected (420)
Seat 2: hazardlab folded before Flop (didn't bet)
Seat 3: dimYLiaK folded before Flop (didn't bet)
Seat 5: jcarlos.vale folded before Flop (didn't bet)
Seat 6: EuroKeeper I folded before Flop (didn't bet)
Seat 7: clonharek704 (button) folded before Flop (didn't bet)
Seat 8: AyrtonAA95 (small blind) folded before Flop
Seat 9: (ANEKDOT)777 (big blind) folded before Flop



PokerStars Hand #220858737149: Tournament #3060068759, $0.23+$0.02 USD Hold'em No Limit - Level V (60/120) - 2020/11/28 0:53:39 EET [2020/11/27 17:53:39 ET]
Table '3060068759 4' 9-max Seat #8 is the button
Seat 1: aconteceu (3700 in chips) 
Seat 2: hazardlab (2427 in chips) 
Seat 3: dimYLiaK (1465 in chips) 
Seat 5: jcarlos.vale (1063 in chips) 
Seat 6: EuroKeeper I (1606 in chips) 
Seat 7: clonharek704 (972 in chips) 
Seat 8: AyrtonAA95 (5192 in chips) 
Seat 9: (ANEKDOT)777 (3153 in chips) 
aconteceu: posts the ante 15
hazardlab: posts the ante 15
dimYLiaK: posts the ante 15
jcarlos.vale: posts the ante 15
EuroKeeper I: posts the ante 15
clonharek704: posts the ante 15
AyrtonAA95: posts the ante 15
(ANEKDOT)777: posts the ante 15
(ANEKDOT)777: posts small blind 60
aconteceu: posts big blind 120
*** HOLE CARDS ***
Dealt to jcarlos.vale [5s Qs]
hazardlab: folds 
dimYLiaK: folds 
jcarlos.vale: folds 
EuroKeeper I: folds 
clonharek704: raises 837 to 957 and is all-in
AyrtonAA95: folds 
(ANEKDOT)777: folds 
aconteceu: calls 837
*** FLOP *** [7c 3d 4c]
*** TURN *** [7c 3d 4c] [Qh]
*** RIVER *** [7c 3d 4c Qh] [7h]
*** SHOW DOWN ***
aconteceu: shows [Kh 9h] (a pair of Sevens)
clonharek704: shows [Tc Qc] (two pair, Queens and Sevens)
clonharek704 collected 2094 from pot
*** SUMMARY ***
Total pot 2094 | Rake 0 
Board [7c 3d 4c Qh 7h]
Seat 1: aconteceu (big blind) showed [Kh 9h] and lost with a pair of Sevens
Seat 2: hazardlab folded before Flop (didn't bet)
Seat 3: dimYLiaK folded before Flop (didn't bet)
Seat 5: jcarlos.vale folded before Flop (didn't bet)
Seat 6: EuroKeeper I folded before Flop (didn't bet)
Seat 7: clonharek704 showed [Tc Qc] and won (2094) with two pair, Queens and Sevens
Seat 8: AyrtonAA95 (button) folded before Flop (didn't bet)
Seat 9: (ANEKDOT)777 (small blind) folded before Flop



PokerStars Hand #220858766364: Tournament #3060068759, $0.23+$0.02 USD Hold'em No Limit - Level V (60/120) - 2020/11/28 0:54:24 EET [2020/11/27 17:54:24 ET]
Table '3060068759 4' 9-max Seat #9 is the button
Seat 1: aconteceu (2728 in chips) 
Seat 2: hazardlab (2412 in chips) 
Seat 3: dimYLiaK (1450 in chips) 
Seat 5: jcarlos.vale (1048 in chips) 
Seat 6: EuroKeeper I (1591 in chips) 
Seat 7: clonharek704 (2094 in chips) 
Seat 8: AyrtonAA95 (5177 in chips) 
Seat 9: (ANEKDOT)777 (3078 in chips) 
aconteceu: posts the ante 15
hazardlab: posts the ante 15
dimYLiaK: posts the ante 15
jcarlos.vale: posts the ante 15
EuroKeeper I: posts the ante 15
clonharek704: posts the ante 15
AyrtonAA95: posts the ante 15
(ANEKDOT)777: posts the ante 15
aconteceu: posts small blind 60
hazardlab: posts big blind 120
*** HOLE CARDS ***
Dealt to jcarlos.vale [Jh 5s]
dimYLiaK: raises 120 to 240
jcarlos.vale: folds 
EuroKeeper I: folds 
clonharek704: folds 
AyrtonAA95: folds 
(ANEKDOT)777: folds 
aconteceu: folds 
hazardlab: calls 120
*** FLOP *** [9d 6h 5c]
hazardlab: bets 660
dimYLiaK: raises 535 to 1195 and is all-in
hazardlab: calls 535
*** TURN *** [9d 6h 5c] [Kc]
*** RIVER *** [9d 6h 5c Kc] [Jc]
*** SHOW DOWN ***
hazardlab: shows [9s As] (a pair of Nines)
dimYLiaK: shows [Qh Qd] (a pair of Queens)
dimYLiaK collected 3050 from pot
*** SUMMARY ***
Total pot 3050 | Rake 0 
Board [9d 6h 5c Kc Jc]
Seat 1: aconteceu (small blind) folded before Flop
Seat 2: hazardlab (big blind) showed [9s As] and lost with a pair of Nines
Seat 3: dimYLiaK showed [Qh Qd] and won (3050) with a pair of Queens
Seat 5: jcarlos.vale folded before Flop (didn't bet)
Seat 6: EuroKeeper I folded before Flop (didn't bet)
Seat 7: clonharek704 folded before Flop (didn't bet)
Seat 8: AyrtonAA95 folded before Flop (didn't bet)
Seat 9: (ANEKDOT)777 (button) folded before Flop (didn't bet)



PokerStars Hand #220858790264: Tournament #3060068759, $0.23+$0.02 USD Hold'em No Limit - Level V (60/120) - 2020/11/28 0:55:01 EET [2020/11/27 17:55:01 ET]
Table '3060068759 4' 9-max Seat #1 is the button
Seat 1: aconteceu (2653 in chips) 
Seat 2: hazardlab (962 in chips) 
Seat 3: dimYLiaK (3050 in chips) 
Seat 5: jcarlos.vale (1033 in chips) 
Seat 6: EuroKeeper I (1576 in chips) 
Seat 7: clonharek704 (2079 in chips) 
Seat 8: AyrtonAA95 (5162 in chips) 
Seat 9: (ANEKDOT)777 (3063 in chips) 
aconteceu: posts the ante 15
hazardlab: posts the ante 15
dimYLiaK: posts the ante 15
jcarlos.vale: posts the ante 15
EuroKeeper I: posts the ante 15
clonharek704: posts the ante 15
AyrtonAA95: posts the ante 15
(ANEKDOT)777: posts the ante 15
hazardlab: posts small blind 60
dimYLiaK: posts big blind 120
*** HOLE CARDS ***
Dealt to jcarlos.vale [8s 2c]
jcarlos.vale: folds 
EuroKeeper I: folds 
clonharek704: folds 
AyrtonAA95: raises 120 to 240
(ANEKDOT)777: folds 
aconteceu: calls 240
hazardlab: folds 
dimYLiaK: folds 
*** FLOP *** [8c Th 7s]
AyrtonAA95: bets 515
aconteceu: calls 515
*** TURN *** [8c Th 7s] [3c]
AyrtonAA95: bets 4392 and is all-in
aconteceu: calls 1883 and is all-in
Uncalled bet (2509) returned to AyrtonAA95
*** RIVER *** [8c Th 7s 3c] [8h]
*** SHOW DOWN ***
AyrtonAA95: shows [Qs Qc] (two pair, Queens and Eights)
aconteceu: shows [Kc 7c] (two pair, Eights and Sevens)
AyrtonAA95 collected 5576 from pot
aconteceu finished the tournament in 23rd place
*** SUMMARY ***
Total pot 5576 | Rake 0 
Board [8c Th 7s 3c 8h]
Seat 1: aconteceu (button) showed [Kc 7c] and lost with two pair, Eights and Sevens
Seat 2: hazardlab (small blind) folded before Flop
Seat 3: dimYLiaK (big blind) folded before Flop
Seat 5: jcarlos.vale folded before Flop (didn't bet)
Seat 6: EuroKeeper I folded before Flop (didn't bet)
Seat 7: clonharek704 folded before Flop (didn't bet)
Seat 8: AyrtonAA95 showed [Qs Qc] and won (5576) with two pair, Queens and Eights
Seat 9: (ANEKDOT)777 folded before Flop (didn't bet)



PokerStars Hand #220858978381: Tournament #3060068759, $0.23+$0.02 USD Hold'em No Limit - Level V (60/120) - 2020/11/28 1:01:09 EET [2020/11/27 18:01:09 ET]
Table '3060068759 4' 9-max Seat #2 is the button
Seat 2: hazardlab (887 in chips) 
Seat 3: dimYLiaK (2915 in chips) 
Seat 5: jcarlos.vale (1018 in chips) 
Seat 6: EuroKeeper I (1561 in chips) 
Seat 7: clonharek704 (2064 in chips) 
Seat 8: AyrtonAA95 (8085 in chips) 
Seat 9: (ANEKDOT)777 (3048 in chips) 
hazardlab: posts the ante 15
dimYLiaK: posts the ante 15
jcarlos.vale: posts the ante 15
EuroKeeper I: posts the ante 15
clonharek704: posts the ante 15
AyrtonAA95: posts the ante 15
(ANEKDOT)777: posts the ante 15
dimYLiaK: posts small blind 60
jcarlos.vale: posts big blind 120
*** HOLE CARDS ***
Dealt to jcarlos.vale [Kh 9s]
EuroKeeper I: folds 
clonharek704 has timed out
clonharek704: folds 
clonharek704 is sitting out
AyrtonAA95: raises 120 to 240
(ANEKDOT)777: folds 
(ANEKDOT)777 is sitting out
hazardlab: folds 
(ANEKDOT)777 has returned
dimYLiaK: folds 
jcarlos.vale: folds 
Uncalled bet (120) returned to AyrtonAA95
AyrtonAA95 collected 405 from pot
AyrtonAA95: doesn't show hand 
*** SUMMARY ***
Total pot 405 | Rake 0 
Seat 2: hazardlab (button) folded before Flop (didn't bet)
Seat 3: dimYLiaK (small blind) folded before Flop
Seat 5: jcarlos.vale (big blind) folded before Flop
Seat 6: EuroKeeper I folded before Flop (didn't bet)
Seat 7: clonharek704 folded before Flop (didn't bet)
Seat 8: AyrtonAA95 collected (405)
Seat 9: (ANEKDOT)777 folded before Flop (didn't bet)



PokerStars Hand #220859047691: Tournament #3060068759, $0.23+$0.02 USD Hold'em No Limit - Level V (60/120) - 2020/11/28 1:02:59 EET [2020/11/27 18:02:59 ET]
Table '3060068759 4' 9-max Seat #3 is the button
Seat 2: hazardlab (872 in chips) 
Seat 3: dimYLiaK (2840 in chips) 
Seat 5: jcarlos.vale (883 in chips) 
Seat 6: EuroKeeper I (1546 in chips) 
Seat 7: clonharek704 (2049 in chips) is sitting out
Seat 8: AyrtonAA95 (8355 in chips) 
Seat 9: (ANEKDOT)777 (3033 in chips) 
hazardlab: posts the ante 15
dimYLiaK: posts the ante 15
jcarlos.vale: posts the ante 15
EuroKeeper I: posts the ante 15
clonharek704: posts the ante 15
AyrtonAA95: posts the ante 15
(ANEKDOT)777: posts the ante 15
jcarlos.vale: posts small blind 60
EuroKeeper I: posts big blind 120
*** HOLE CARDS ***
Dealt to jcarlos.vale [7s 3d]
clonharek704: folds 
AyrtonAA95: folds 
(ANEKDOT)777: folds 
hazardlab: folds 
clonharek704 has returned
dimYLiaK: calls 120
jcarlos.vale: calls 60
EuroKeeper I: checks 
*** FLOP *** [Ad 8d 8c]
jcarlos.vale: checks 
EuroKeeper I: checks 
dimYLiaK: bets 120
jcarlos.vale: folds 
EuroKeeper I: folds 
Uncalled bet (120) returned to dimYLiaK
dimYLiaK collected 465 from pot
dimYLiaK: doesn't show hand 
*** SUMMARY ***
Total pot 465 | Rake 0 
Board [Ad 8d 8c]
Seat 2: hazardlab folded before Flop (didn't bet)
Seat 3: dimYLiaK (button) collected (465)
Seat 5: jcarlos.vale (small blind) folded on the Flop
Seat 6: EuroKeeper I (big blind) folded on the Flop
Seat 7: clonharek704 folded before Flop (didn't bet)
Seat 8: AyrtonAA95 folded before Flop (didn't bet)
Seat 9: (ANEKDOT)777 folded before Flop (didn't bet)



PokerStars Hand #220859081388: Tournament #3060068759, $0.23+$0.02 USD Hold'em No Limit - Level V (60/120) - 2020/11/28 1:03:51 EET [2020/11/27 18:03:51 ET]
Table '3060068759 4' 9-max Seat #5 is the button
Seat 2: hazardlab (857 in chips) 
Seat 3: dimYLiaK (3170 in chips) 
Seat 5: jcarlos.vale (748 in chips) 
Seat 6: EuroKeeper I (1411 in chips) 
Seat 7: clonharek704 (2034 in chips) 
Seat 8: AyrtonAA95 (8340 in chips) 
Seat 9: (ANEKDOT)777 (3018 in chips) 
hazardlab: posts the ante 15
dimYLiaK: posts the ante 15
jcarlos.vale: posts the ante 15
EuroKeeper I: posts the ante 15
clonharek704: posts the ante 15
AyrtonAA95: posts the ante 15
(ANEKDOT)777: posts the ante 15
EuroKeeper I: posts small blind 60
clonharek704: posts big blind 120
*** HOLE CARDS ***
Dealt to jcarlos.vale [Qd Kd]
AyrtonAA95: folds 
(ANEKDOT)777: folds 
hazardlab: folds 
dimYLiaK: folds 
jcarlos.vale: raises 613 to 733 and is all-in
EuroKeeper I: folds 
clonharek704: folds 
Uncalled bet (613) returned to jcarlos.vale
jcarlos.vale collected 405 from pot
jcarlos.vale: doesn't show hand 
*** SUMMARY ***
Total pot 405 | Rake 0 
Seat 2: hazardlab folded before Flop (didn't bet)
Seat 3: dimYLiaK folded before Flop (didn't bet)
Seat 5: jcarlos.vale (button) collected (405)
Seat 6: EuroKeeper I (small blind) folded before Flop
Seat 7: clonharek704 (big blind) folded before Flop
Seat 8: AyrtonAA95 folded before Flop (didn't bet)
Seat 9: (ANEKDOT)777 folded before Flop (didn't bet)



PokerStars Hand #220859108542: Tournament #3060068759, $0.23+$0.02 USD Hold'em No Limit - Level V (60/120) - 2020/11/28 1:04:33 EET [2020/11/27 18:04:33 ET]
Table '3060068759 4' 9-max Seat #6 is the button
Seat 2: hazardlab (842 in chips) 
Seat 3: dimYLiaK (3155 in chips) 
Seat 5: jcarlos.vale (1018 in chips) 
Seat 6: EuroKeeper I (1336 in chips) 
Seat 7: clonharek704 (1899 in chips) 
Seat 8: AyrtonAA95 (8325 in chips) 
Seat 9: (ANEKDOT)777 (3003 in chips) 
hazardlab: posts the ante 15
dimYLiaK: posts the ante 15
jcarlos.vale: posts the ante 15
EuroKeeper I: posts the ante 15
clonharek704: posts the ante 15
AyrtonAA95: posts the ante 15
(ANEKDOT)777: posts the ante 15
clonharek704: posts small blind 60
AyrtonAA95: posts big blind 120
*** HOLE CARDS ***
Dealt to jcarlos.vale [Jc Ad]
(ANEKDOT)777: folds 
hazardlab: folds 
dimYLiaK: folds 
jcarlos.vale: raises 883 to 1003 and is all-in
EuroKeeper I: folds 
clonharek704: folds 
AyrtonAA95: folds 
Uncalled bet (883) returned to jcarlos.vale
jcarlos.vale collected 405 from pot
jcarlos.vale: doesn't show hand 
*** SUMMARY ***
Total pot 405 | Rake 0 
Seat 2: hazardlab folded before Flop (didn't bet)
Seat 3: dimYLiaK folded before Flop (didn't bet)
Seat 5: jcarlos.vale collected (405)
Seat 6: EuroKeeper I (button) folded before Flop (didn't bet)
Seat 7: clonharek704 (small blind) folded before Flop
Seat 8: AyrtonAA95 (big blind) folded before Flop
Seat 9: (ANEKDOT)777 folded before Flop (didn't bet)



PokerStars Hand #220859136285: Tournament #3060068759, $0.23+$0.02 USD Hold'em No Limit - Level VI (80/160) - 2020/11/28 1:05:16 EET [2020/11/27 18:05:16 ET]
Table '3060068759 4' 9-max Seat #7 is the button
Seat 2: hazardlab (827 in chips) 
Seat 3: dimYLiaK (3140 in chips) 
Seat 5: jcarlos.vale (1288 in chips) 
Seat 6: EuroKeeper I (1321 in chips) 
Seat 7: clonharek704 (1824 in chips) 
Seat 8: AyrtonAA95 (8190 in chips) 
Seat 9: (ANEKDOT)777 (2988 in chips) 
hazardlab: posts the ante 20
dimYLiaK: posts the ante 20
jcarlos.vale: posts the ante 20
EuroKeeper I: posts the ante 20
clonharek704: posts the ante 20
AyrtonAA95: posts the ante 20
(ANEKDOT)777: posts the ante 20
AyrtonAA95: posts small blind 80
(ANEKDOT)777: posts big blind 160
*** HOLE CARDS ***
Dealt to jcarlos.vale [8d 5s]
hazardlab: folds 
dimYLiaK: folds 
jcarlos.vale: folds 
EuroKeeper I: raises 1141 to 1301 and is all-in
clonharek704: raises 503 to 1804 and is all-in
AyrtonAA95: folds 
(ANEKDOT)777: folds 
Uncalled bet (503) returned to clonharek704
*** FLOP *** [Kc 8c 6s]
*** TURN *** [Kc 8c 6s] [Qd]
*** RIVER *** [Kc 8c 6s Qd] [8s]
*** SHOW DOWN ***
EuroKeeper I: shows [7h 7d] (two pair, Eights and Sevens)
clonharek704: shows [Qh Ah] (two pair, Queens and Eights)
clonharek704 collected 2982 from pot
EuroKeeper I finished the tournament in 21st place
*** SUMMARY ***
Total pot 2982 | Rake 0 
Board [Kc 8c 6s Qd 8s]
Seat 2: hazardlab folded before Flop (didn't bet)
Seat 3: dimYLiaK folded before Flop (didn't bet)
Seat 5: jcarlos.vale folded before Flop (didn't bet)
Seat 6: EuroKeeper I showed [7h 7d] and lost with two pair, Eights and Sevens
Seat 7: clonharek704 (button) showed [Qh Ah] and won (2982) with two pair, Queens and Eights
Seat 8: AyrtonAA95 (small blind) folded before Flop
Seat 9: (ANEKDOT)777 (big blind) folded before Flop



PokerStars Hand #220859172436: Tournament #3060068759, $0.23+$0.02 USD Hold'em No Limit - Level VI (80/160) - 2020/11/28 1:06:12 EET [2020/11/27 18:06:12 ET]
Table '3060068759 4' 9-max Seat #8 is the button
Seat 2: hazardlab (807 in chips) 
Seat 3: dimYLiaK (3120 in chips) 
Seat 5: jcarlos.vale (1268 in chips) 
Seat 7: clonharek704 (3485 in chips) 
Seat 8: AyrtonAA95 (8090 in chips) 
Seat 9: (ANEKDOT)777 (2808 in chips) 
hazardlab: posts the ante 20
dimYLiaK: posts the ante 20
jcarlos.vale: posts the ante 20
clonharek704: posts the ante 20
AyrtonAA95: posts the ante 20
(ANEKDOT)777: posts the ante 20
(ANEKDOT)777: posts small blind 80
hazardlab: posts big blind 160
*** HOLE CARDS ***
Dealt to jcarlos.vale [5c 8h]
dimYLiaK: calls 160
jcarlos.vale: folds 
clonharek704: folds 
AyrtonAA95: folds 
(ANEKDOT)777: calls 80
hazardlab: checks 
*** FLOP *** [9s Tc Td]
(ANEKDOT)777: checks 
hazardlab: checks 
dimYLiaK: checks 
*** TURN *** [9s Tc Td] [Ad]
(ANEKDOT)777: checks 
hazardlab: checks 
dimYLiaK: checks 
*** RIVER *** [9s Tc Td Ad] [Jh]
(ANEKDOT)777: checks 
hazardlab: checks 
dimYLiaK: bets 640
(ANEKDOT)777: folds 
hazardlab: calls 627 and is all-in
Uncalled bet (13) returned to dimYLiaK
*** SHOW DOWN ***
dimYLiaK: shows [Kh Qs] (a straight, Ten to Ace)
hazardlab: shows [5s Ac] (two pair, Aces and Tens)
dimYLiaK collected 1854 from pot
hazardlab finished the tournament in 20th place
*** SUMMARY ***
Total pot 1854 | Rake 0 
Board [9s Tc Td Ad Jh]
Seat 2: hazardlab (big blind) showed [5s Ac] and lost with two pair, Aces and Tens
Seat 3: dimYLiaK showed [Kh Qs] and won (1854) with a straight, Ten to Ace
Seat 5: jcarlos.vale folded before Flop (didn't bet)
Seat 7: clonharek704 folded before Flop (didn't bet)
Seat 8: AyrtonAA95 (button) folded before Flop (didn't bet)
Seat 9: (ANEKDOT)777 (small blind) folded on the River



PokerStars Hand #220859209006: Tournament #3060068759, $0.23+$0.02 USD Hold'em No Limit - Level VI (80/160) - 2020/11/28 1:07:08 EET [2020/11/27 18:07:08 ET]
Table '3060068759 4' 9-max Seat #9 is the button
Seat 3: dimYLiaK (4167 in chips) 
Seat 5: jcarlos.vale (1248 in chips) 
Seat 7: clonharek704 (3465 in chips) 
Seat 8: AyrtonAA95 (8070 in chips) 
Seat 9: (ANEKDOT)777 (2628 in chips) 
dimYLiaK: posts the ante 20
jcarlos.vale: posts the ante 20
clonharek704: posts the ante 20
AyrtonAA95: posts the ante 20
(ANEKDOT)777: posts the ante 20
dimYLiaK: posts small blind 80
jcarlos.vale: posts big blind 160
*** HOLE CARDS ***
Dealt to jcarlos.vale [6d Qs]
clonharek704: folds 
AyrtonAA95: folds 
(ANEKDOT)777: folds 
dimYLiaK: folds 
Uncalled bet (80) returned to jcarlos.vale
jcarlos.vale collected 260 from pot
jcarlos.vale: doesn't show hand 
*** SUMMARY ***
Total pot 260 | Rake 0 
Seat 3: dimYLiaK (small blind) folded before Flop
Seat 5: jcarlos.vale (big blind) collected (260)
Seat 7: clonharek704 folded before Flop (didn't bet)
Seat 8: AyrtonAA95 folded before Flop (didn't bet)
Seat 9: (ANEKDOT)777 (button) folded before Flop (didn't bet)



PokerStars Hand #220859218117: Tournament #3060068759, $0.23+$0.02 USD Hold'em No Limit - Level VI (80/160) - 2020/11/28 1:07:23 EET [2020/11/27 18:07:23 ET]
Table '3060068759 4' 9-max Seat #3 is the button
Seat 3: dimYLiaK (4067 in chips) 
Seat 5: jcarlos.vale (1408 in chips) 
Seat 7: clonharek704 (3445 in chips) 
Seat 8: AyrtonAA95 (8050 in chips) 
Seat 9: (ANEKDOT)777 (2608 in chips) 
dimYLiaK: posts the ante 20
jcarlos.vale: posts the ante 20
clonharek704: posts the ante 20
AyrtonAA95: posts the ante 20
(ANEKDOT)777: posts the ante 20
jcarlos.vale: posts small blind 80
clonharek704: posts big blind 160
*** HOLE CARDS ***
Dealt to jcarlos.vale [Jh 5d]
AyrtonAA95: folds 
(ANEKDOT)777: folds 
dimYLiaK: folds 
jcarlos.vale: folds 
Uncalled bet (80) returned to clonharek704
clonharek704 collected 260 from pot
*** SUMMARY ***
Total pot 260 | Rake 0 
Seat 3: dimYLiaK (button) folded before Flop (didn't bet)
Seat 5: jcarlos.vale (small blind) folded before Flop
Seat 7: clonharek704 (big blind) collected (260)
Seat 8: AyrtonAA95 folded before Flop (didn't bet)
Seat 9: (ANEKDOT)777 folded before Flop (didn't bet)



PokerStars Hand #220859240531: Tournament #3060068759, $0.23+$0.02 USD Hold'em No Limit - Level VI (80/160) - 2020/11/28 1:07:50 EET [2020/11/27 18:07:50 ET]
Table '3060068759 4' 9-max Seat #5 is the button
Seat 3: dimYLiaK (4047 in chips) 
Seat 4: andrey pyatkin (2324 in chips) 
Seat 5: jcarlos.vale (1308 in chips) 
Seat 7: clonharek704 (3605 in chips) 
Seat 8: AyrtonAA95 (8030 in chips) 
Seat 9: (ANEKDOT)777 (2588 in chips) 
dimYLiaK: posts the ante 20
andrey pyatkin: posts the ante 20
jcarlos.vale: posts the ante 20
clonharek704: posts the ante 20
AyrtonAA95: posts the ante 20
(ANEKDOT)777: posts the ante 20
clonharek704: posts small blind 80
AyrtonAA95: posts big blind 160
*** HOLE CARDS ***
Dealt to jcarlos.vale [6c 7c]
(ANEKDOT)777: folds 
dimYLiaK: folds 
andrey pyatkin: calls 160
jcarlos.vale said, "F?!"
jcarlos.vale: raises 1128 to 1288 and is all-in
clonharek704: folds 
AyrtonAA95: folds 
andrey pyatkin: folds 
Uncalled bet (1128) returned to jcarlos.vale
jcarlos.vale collected 680 from pot
jcarlos.vale: doesn't show hand 
*** SUMMARY ***
Total pot 680 | Rake 0 
Seat 3: dimYLiaK folded before Flop (didn't bet)
Seat 4: andrey pyatkin folded before Flop
Seat 5: jcarlos.vale (button) collected (680)
Seat 7: clonharek704 (small blind) folded before Flop
Seat 8: AyrtonAA95 (big blind) folded before Flop
Seat 9: (ANEKDOT)777 folded before Flop (didn't bet)



PokerStars Hand #220859267157: Tournament #3060068759, $0.23+$0.02 USD Hold'em No Limit - Level VI (80/160) - 2020/11/28 1:08:31 EET [2020/11/27 18:08:31 ET]
Table '3060068759 4' 9-max Seat #7 is the button
Seat 3: dimYLiaK (4027 in chips) 
Seat 4: andrey pyatkin (2144 in chips) 
Seat 5: jcarlos.vale (1808 in chips) 
Seat 7: clonharek704 (3505 in chips) 
Seat 8: AyrtonAA95 (7850 in chips) 
Seat 9: (ANEKDOT)777 (2568 in chips) 
dimYLiaK: posts the ante 20
andrey pyatkin: posts the ante 20
jcarlos.vale: posts the ante 20
clonharek704: posts the ante 20
AyrtonAA95: posts the ante 20
(ANEKDOT)777: posts the ante 20
AyrtonAA95: posts small blind 80
(ANEKDOT)777: posts big blind 160
*** HOLE CARDS ***
Dealt to jcarlos.vale [6c 7s]
dimYLiaK: folds 
andrey pyatkin: folds 
jcarlos.vale: folds 
clonharek704: folds 
AyrtonAA95: calls 80
(ANEKDOT)777: checks 
*** FLOP *** [2s 4s 2d]
AyrtonAA95: bets 160
(ANEKDOT)777: calls 160
*** TURN *** [2s 4s 2d] [9d]
AyrtonAA95: bets 502
(ANEKDOT)777: calls 502
*** RIVER *** [2s 4s 2d 9d] [Kc]
AyrtonAA95: checks 
(ANEKDOT)777: checks 
*** SHOW DOWN ***
AyrtonAA95: shows [9c Jh] (two pair, Nines and Deuces)
(ANEKDOT)777: shows [9s 6s] (two pair, Nines and Deuces)
AyrtonAA95 collected 882 from pot
(ANEKDOT)777 collected 882 from pot
*** SUMMARY ***
Total pot 1764 | Rake 0 
Board [2s 4s 2d 9d Kc]
Seat 3: dimYLiaK folded before Flop (didn't bet)
Seat 4: andrey pyatkin folded before Flop (didn't bet)
Seat 5: jcarlos.vale folded before Flop (didn't bet)
Seat 7: clonharek704 (button) folded before Flop (didn't bet)
Seat 8: AyrtonAA95 (small blind) showed [9c Jh] and won (882) with two pair, Nines and Deuces
Seat 9: (ANEKDOT)777 (big blind) showed [9s 6s] and won (882) with two pair, Nines and Deuces



PokerStars Hand #220859323746: Tournament #3060068759, $0.23+$0.02 USD Hold'em No Limit - Level VI (80/160) - 2020/11/28 1:09:59 EET [2020/11/27 18:09:59 ET]
Table '3060068759 4' 9-max Seat #8 is the button
Seat 3: dimYLiaK (4007 in chips) 
Seat 4: andrey pyatkin (2124 in chips) 
Seat 5: jcarlos.vale (1788 in chips) 
Seat 7: clonharek704 (3485 in chips) 
Seat 8: AyrtonAA95 (7890 in chips) 
Seat 9: (ANEKDOT)777 (2608 in chips) 
dimYLiaK: posts the ante 20
andrey pyatkin: posts the ante 20
jcarlos.vale: posts the ante 20
clonharek704: posts the ante 20
AyrtonAA95: posts the ante 20
(ANEKDOT)777: posts the ante 20
(ANEKDOT)777: posts small blind 80
dimYLiaK: posts big blind 160
*** HOLE CARDS ***
Dealt to jcarlos.vale [9c 6d]
andrey pyatkin: folds 
jcarlos.vale: folds 
clonharek704: raises 160 to 320
AyrtonAA95: folds 
(ANEKDOT)777: raises 2268 to 2588 and is all-in
dimYLiaK: folds 
clonharek704: folds 
Uncalled bet (2268) returned to (ANEKDOT)777
(ANEKDOT)777 collected 920 from pot
(ANEKDOT)777: doesn't show hand 
*** SUMMARY ***
Total pot 920 | Rake 0 
Seat 3: dimYLiaK (big blind) folded before Flop
Seat 4: andrey pyatkin folded before Flop (didn't bet)
Seat 5: jcarlos.vale folded before Flop (didn't bet)
Seat 7: clonharek704 folded before Flop
Seat 8: AyrtonAA95 (button) folded before Flop (didn't bet)
Seat 9: (ANEKDOT)777 (small blind) collected (920)



PokerStars Hand #220859356480: Tournament #3060068759, $0.23+$0.02 USD Hold'em No Limit - Level VI (80/160) - 2020/11/28 1:10:51 EET [2020/11/27 18:10:51 ET]
Table '3060068759 4' 9-max Seat #9 is the button
Seat 3: dimYLiaK (3827 in chips) 
Seat 4: andrey pyatkin (2104 in chips) 
Seat 5: jcarlos.vale (1768 in chips) 
Seat 7: clonharek704 (3145 in chips) 
Seat 8: AyrtonAA95 (7870 in chips) 
Seat 9: (ANEKDOT)777 (3188 in chips) 
dimYLiaK: posts the ante 20
andrey pyatkin: posts the ante 20
jcarlos.vale: posts the ante 20
clonharek704: posts the ante 20
AyrtonAA95: posts the ante 20
(ANEKDOT)777: posts the ante 20
dimYLiaK: posts small blind 80
andrey pyatkin: posts big blind 160
*** HOLE CARDS ***
Dealt to jcarlos.vale [4c 3h]
jcarlos.vale: folds 
clonharek704: folds 
AyrtonAA95: raises 160 to 320
(ANEKDOT)777: folds 
dimYLiaK: folds 
andrey pyatkin: folds 
Uncalled bet (160) returned to AyrtonAA95
AyrtonAA95 collected 520 from pot
AyrtonAA95: doesn't show hand 
*** SUMMARY ***
Total pot 520 | Rake 0 
Seat 3: dimYLiaK (small blind) folded before Flop
Seat 4: andrey pyatkin (big blind) folded before Flop
Seat 5: jcarlos.vale folded before Flop (didn't bet)
Seat 7: clonharek704 folded before Flop (didn't bet)
Seat 8: AyrtonAA95 collected (520)
Seat 9: (ANEKDOT)777 (button) folded before Flop (didn't bet)



PokerStars Hand #220859386253: Tournament #3060068759, $0.23+$0.02 USD Hold'em No Limit - Level VI (80/160) - 2020/11/28 1:11:38 EET [2020/11/27 18:11:38 ET]
Table '3060068759 4' 9-max Seat #3 is the button
Seat 3: dimYLiaK (3727 in chips) 
Seat 4: andrey pyatkin (1924 in chips) 
Seat 5: jcarlos.vale (1748 in chips) 
Seat 7: clonharek704 (3125 in chips) 
Seat 8: AyrtonAA95 (8210 in chips) 
Seat 9: (ANEKDOT)777 (3168 in chips) 
dimYLiaK: posts the ante 20
andrey pyatkin: posts the ante 20
jcarlos.vale: posts the ante 20
clonharek704: posts the ante 20
AyrtonAA95: posts the ante 20
(ANEKDOT)777: posts the ante 20
andrey pyatkin: posts small blind 80
jcarlos.vale: posts big blind 160
*** HOLE CARDS ***
Dealt to jcarlos.vale [Kh 4d]
clonharek704: folds 
AyrtonAA95: folds 
(ANEKDOT)777: folds 
dimYLiaK: folds 
andrey pyatkin: calls 80
jcarlos.vale: checks 
*** FLOP *** [Kc 8s Qh]
andrey pyatkin: checks 
jcarlos.vale: bets 330
andrey pyatkin: calls 330
*** TURN *** [Kc 8s Qh] [Kd]
andrey pyatkin: checks 
jcarlos.vale: bets 825
andrey pyatkin: folds 
Uncalled bet (825) returned to jcarlos.vale
jcarlos.vale collected 1100 from pot
jcarlos.vale: doesn't show hand 
*** SUMMARY ***
Total pot 1100 | Rake 0 
Board [Kc 8s Qh Kd]
Seat 3: dimYLiaK (button) folded before Flop (didn't bet)
Seat 4: andrey pyatkin (small blind) folded on the Turn
Seat 5: jcarlos.vale (big blind) collected (1100)
Seat 7: clonharek704 folded before Flop (didn't bet)
Seat 8: AyrtonAA95 folded before Flop (didn't bet)
Seat 9: (ANEKDOT)777 folded before Flop (didn't bet)



PokerStars Hand #220859417919: Tournament #3060068759, $0.23+$0.02 USD Hold'em No Limit - Level VI (80/160) - 2020/11/28 1:12:28 EET [2020/11/27 18:12:28 ET]
Table '3060068759 4' 9-max Seat #4 is the button
Seat 3: dimYLiaK (3707 in chips) 
Seat 4: andrey pyatkin (1414 in chips) 
Seat 5: jcarlos.vale (2338 in chips) 
Seat 7: clonharek704 (3105 in chips) 
Seat 8: AyrtonAA95 (8190 in chips) 
Seat 9: (ANEKDOT)777 (3148 in chips) 
dimYLiaK: posts the ante 20
andrey pyatkin: posts the ante 20
jcarlos.vale: posts the ante 20
clonharek704: posts the ante 20
AyrtonAA95: posts the ante 20
(ANEKDOT)777: posts the ante 20
jcarlos.vale: posts small blind 80
clonharek704: posts big blind 160
*** HOLE CARDS ***
Dealt to jcarlos.vale [4h Ah]
AyrtonAA95: raises 160 to 320
(ANEKDOT)777: folds 
dimYLiaK: folds 
andrey pyatkin: folds 
jcarlos.vale: folds 
clonharek704: folds 
Uncalled bet (160) returned to AyrtonAA95
AyrtonAA95 collected 520 from pot
AyrtonAA95: doesn't show hand 
*** SUMMARY ***
Total pot 520 | Rake 0 
Seat 3: dimYLiaK folded before Flop (didn't bet)
Seat 4: andrey pyatkin (button) folded before Flop (didn't bet)
Seat 5: jcarlos.vale (small blind) folded before Flop
Seat 7: clonharek704 (big blind) folded before Flop
Seat 8: AyrtonAA95 collected (520)
Seat 9: (ANEKDOT)777 folded before Flop (didn't bet)



PokerStars Hand #220859431235: Tournament #3060068759, $0.23+$0.02 USD Hold'em No Limit - Level VI (80/160) - 2020/11/28 1:12:49 EET [2020/11/27 18:12:49 ET]
Table '3060068759 4' 9-max Seat #5 is the button
Seat 3: dimYLiaK (3687 in chips) 
Seat 4: andrey pyatkin (1394 in chips) 
Seat 5: jcarlos.vale (2238 in chips) 
Seat 7: clonharek704 (2925 in chips) 
Seat 8: AyrtonAA95 (8530 in chips) 
Seat 9: (ANEKDOT)777 (3128 in chips) 
dimYLiaK: posts the ante 20
andrey pyatkin: posts the ante 20
jcarlos.vale: posts the ante 20
clonharek704: posts the ante 20
AyrtonAA95: posts the ante 20
(ANEKDOT)777: posts the ante 20
clonharek704: posts small blind 80
AyrtonAA95: posts big blind 160
*** HOLE CARDS ***
Dealt to jcarlos.vale [4h 3h]
(ANEKDOT)777: folds 
dimYLiaK: folds 
andrey pyatkin: folds 
jcarlos.vale: folds 
clonharek704: folds 
Uncalled bet (80) returned to AyrtonAA95
AyrtonAA95 collected 280 from pot
AyrtonAA95: doesn't show hand 
*** SUMMARY ***
Total pot 280 | Rake 0 
Seat 3: dimYLiaK folded before Flop (didn't bet)
Seat 4: andrey pyatkin folded before Flop (didn't bet)
Seat 5: jcarlos.vale (button) folded before Flop (didn't bet)
Seat 7: clonharek704 (small blind) folded before Flop
Seat 8: AyrtonAA95 (big blind) collected (280)
Seat 9: (ANEKDOT)777 folded before Flop (didn't bet)



PokerStars Hand #220859450855: Tournament #3060068759, $0.23+$0.02 USD Hold'em No Limit - Level VI (80/160) - 2020/11/28 1:13:20 EET [2020/11/27 18:13:20 ET]
Table '3060068759 4' 9-max Seat #7 is the button
Seat 3: dimYLiaK (3667 in chips) 
Seat 4: andrey pyatkin (1374 in chips) 
Seat 5: jcarlos.vale (2218 in chips) 
Seat 7: clonharek704 (2825 in chips) 
Seat 8: AyrtonAA95 (8710 in chips) 
Seat 9: (ANEKDOT)777 (3108 in chips) 
dimYLiaK: posts the ante 20
andrey pyatkin: posts the ante 20
jcarlos.vale: posts the ante 20
clonharek704: posts the ante 20
AyrtonAA95: posts the ante 20
(ANEKDOT)777: posts the ante 20
AyrtonAA95: posts small blind 80
(ANEKDOT)777: posts big blind 160
*** HOLE CARDS ***
Dealt to jcarlos.vale [5h Ad]
dimYLiaK: folds 
andrey pyatkin: calls 160
jcarlos.vale: folds 
clonharek704: folds 
AyrtonAA95: folds 
(ANEKDOT)777: checks 
*** FLOP *** [5c Ks 9d]
(ANEKDOT)777: checks 
andrey pyatkin: checks 
*** TURN *** [5c Ks 9d] [6c]
(ANEKDOT)777: bets 320
andrey pyatkin: folds 
Uncalled bet (320) returned to (ANEKDOT)777
(ANEKDOT)777 collected 520 from pot
(ANEKDOT)777: doesn't show hand 
*** SUMMARY ***
Total pot 520 | Rake 0 
Board [5c Ks 9d 6c]
Seat 3: dimYLiaK folded before Flop (didn't bet)
Seat 4: andrey pyatkin folded on the Turn
Seat 5: jcarlos.vale folded before Flop (didn't bet)
Seat 7: clonharek704 (button) folded before Flop (didn't bet)
Seat 8: AyrtonAA95 (small blind) folded before Flop
Seat 9: (ANEKDOT)777 (big blind) collected (520)



PokerStars Hand #220859476361: Tournament #3060068759, $0.23+$0.02 USD Hold'em No Limit - Level VI (80/160) - 2020/11/28 1:14:01 EET [2020/11/27 18:14:01 ET]
Table '3060068759 4' 9-max Seat #8 is the button
Seat 3: dimYLiaK (3647 in chips) 
Seat 4: andrey pyatkin (1194 in chips) 
Seat 5: jcarlos.vale (2198 in chips) 
Seat 7: clonharek704 (2805 in chips) 
Seat 8: AyrtonAA95 (8610 in chips) 
Seat 9: (ANEKDOT)777 (3448 in chips) 
dimYLiaK: posts the ante 20
andrey pyatkin: posts the ante 20
jcarlos.vale: posts the ante 20
clonharek704: posts the ante 20
AyrtonAA95: posts the ante 20
(ANEKDOT)777: posts the ante 20
(ANEKDOT)777: posts small blind 80
dimYLiaK: posts big blind 160
*** HOLE CARDS ***
Dealt to jcarlos.vale [3h 5s]
andrey pyatkin: calls 160
jcarlos.vale: folds 
clonharek704: raises 2625 to 2785 and is all-in
AyrtonAA95: folds 
(ANEKDOT)777: raises 643 to 3428 and is all-in
dimYLiaK: folds 
andrey pyatkin: folds 
Uncalled bet (643) returned to (ANEKDOT)777
*** FLOP *** [Td 6c Ah]
*** TURN *** [Td 6c Ah] [Ts]
*** RIVER *** [Td 6c Ah Ts] [4h]
*** SHOW DOWN ***
(ANEKDOT)777: shows [Jd Jh] (two pair, Jacks and Tens)
clonharek704: shows [Ks As] (two pair, Aces and Tens)
clonharek704 collected 6010 from pot
*** SUMMARY ***
Total pot 6010 | Rake 0 
Board [Td 6c Ah Ts 4h]
Seat 3: dimYLiaK (big blind) folded before Flop
Seat 4: andrey pyatkin folded before Flop
Seat 5: jcarlos.vale folded before Flop (didn't bet)
Seat 7: clonharek704 showed [Ks As] and won (6010) with two pair, Aces and Tens
Seat 8: AyrtonAA95 (button) folded before Flop (didn't bet)
Seat 9: (ANEKDOT)777 (small blind) showed [Jd Jh] and lost with two pair, Jacks and Tens



PokerStars Hand #220859513960: Tournament #3060068759, $0.23+$0.02 USD Hold'em No Limit - Level VI (80/160) - 2020/11/28 1:15:01 EET [2020/11/27 18:15:01 ET]
Table '3060068759 4' 9-max Seat #9 is the button
Seat 3: dimYLiaK (3467 in chips) 
Seat 4: andrey pyatkin (1014 in chips) 
Seat 5: jcarlos.vale (2178 in chips) 
Seat 7: clonharek704 (6010 in chips) 
Seat 8: AyrtonAA95 (8590 in chips) 
Seat 9: (ANEKDOT)777 (643 in chips) 
dimYLiaK: posts the ante 20
andrey pyatkin: posts the ante 20
jcarlos.vale: posts the ante 20
clonharek704: posts the ante 20
AyrtonAA95: posts the ante 20
(ANEKDOT)777: posts the ante 20
dimYLiaK: posts small blind 80
andrey pyatkin: posts big blind 160
*** HOLE CARDS ***
Dealt to jcarlos.vale [Jd Kd]
jcarlos.vale: raises 1998 to 2158 and is all-in
clonharek704: folds 
AyrtonAA95: folds 
(ANEKDOT)777: folds 
dimYLiaK: folds 
andrey pyatkin: folds 
Uncalled bet (1998) returned to jcarlos.vale
jcarlos.vale collected 520 from pot
jcarlos.vale: doesn't show hand 
*** SUMMARY ***
Total pot 520 | Rake 0 
Seat 3: dimYLiaK (small blind) folded before Flop
Seat 4: andrey pyatkin (big blind) folded before Flop
Seat 5: jcarlos.vale collected (520)
Seat 7: clonharek704 folded before Flop (didn't bet)
Seat 8: AyrtonAA95 folded before Flop (didn't bet)
Seat 9: (ANEKDOT)777 (button) folded before Flop (didn't bet)



PokerStars Hand #220859530288: Tournament #3060068759, $0.23+$0.02 USD Hold'em No Limit - Level VII (100/200) - 2020/11/28 1:15:27 EET [2020/11/27 18:15:27 ET]
Table '3060068759 4' 9-max Seat #3 is the button
Seat 3: dimYLiaK (3367 in chips) 
Seat 4: andrey pyatkin (834 in chips) 
Seat 5: jcarlos.vale (2518 in chips) 
Seat 7: clonharek704 (5990 in chips) 
Seat 8: AyrtonAA95 (8570 in chips) 
Seat 9: (ANEKDOT)777 (623 in chips) 
dimYLiaK: posts the ante 25
andrey pyatkin: posts the ante 25
jcarlos.vale: posts the ante 25
clonharek704: posts the ante 25
AyrtonAA95: posts the ante 25
(ANEKDOT)777: posts the ante 25
andrey pyatkin: posts small blind 100
jcarlos.vale: posts big blind 200
*** HOLE CARDS ***
Dealt to jcarlos.vale [Kh Ad]
clonharek704: folds 
AyrtonAA95: folds 
(ANEKDOT)777: folds 
dimYLiaK: folds 
andrey pyatkin: folds 
Uncalled bet (100) returned to jcarlos.vale
jcarlos.vale collected 350 from pot
jcarlos.vale: doesn't show hand 
*** SUMMARY ***
Total pot 350 | Rake 0 
Seat 3: dimYLiaK (button) folded before Flop (didn't bet)
Seat 4: andrey pyatkin (small blind) folded before Flop
Seat 5: jcarlos.vale (big blind) collected (350)
Seat 7: clonharek704 folded before Flop (didn't bet)
Seat 8: AyrtonAA95 folded before Flop (didn't bet)
Seat 9: (ANEKDOT)777 folded before Flop (didn't bet)



PokerStars Hand #220859540887: Tournament #3060068759, $0.23+$0.02 USD Hold'em No Limit - Level VII (100/200) - 2020/11/28 1:15:45 EET [2020/11/27 18:15:45 ET]
Table '3060068759 4' 9-max Seat #4 is the button
Seat 3: dimYLiaK (3342 in chips) 
Seat 4: andrey pyatkin (709 in chips) 
Seat 5: jcarlos.vale (2743 in chips) 
Seat 7: clonharek704 (5965 in chips) 
Seat 8: AyrtonAA95 (8545 in chips) 
Seat 9: (ANEKDOT)777 (598 in chips) 
dimYLiaK: posts the ante 25
andrey pyatkin: posts the ante 25
jcarlos.vale: posts the ante 25
clonharek704: posts the ante 25
AyrtonAA95: posts the ante 25
(ANEKDOT)777: posts the ante 25
jcarlos.vale: posts small blind 100
clonharek704: posts big blind 200
*** HOLE CARDS ***
Dealt to jcarlos.vale [8s 3c]
AyrtonAA95: folds 
(ANEKDOT)777: raises 373 to 573 and is all-in
dimYLiaK: folds 
andrey pyatkin: folds 
jcarlos.vale: folds 
clonharek704: calls 373
*** FLOP *** [8c Jd Td]
*** TURN *** [8c Jd Td] [5c]
*** RIVER *** [8c Jd Td 5c] [9d]
*** SHOW DOWN ***
clonharek704: shows [3d Kh] (high card King)
(ANEKDOT)777: shows [2d 2h] (a pair of Deuces)
(ANEKDOT)777 collected 1396 from pot
*** SUMMARY ***
Total pot 1396 | Rake 0 
Board [8c Jd Td 5c 9d]
Seat 3: dimYLiaK folded before Flop (didn't bet)
Seat 4: andrey pyatkin (button) folded before Flop (didn't bet)
Seat 5: jcarlos.vale (small blind) folded before Flop
Seat 7: clonharek704 (big blind) showed [3d Kh] and lost with high card King
Seat 8: AyrtonAA95 folded before Flop (didn't bet)
Seat 9: (ANEKDOT)777 showed [2d 2h] and won (1396) with a pair of Deuces



PokerStars Hand #220859559690: Tournament #3060068759, $0.23+$0.02 USD Hold'em No Limit - Level VII (100/200) - 2020/11/28 1:16:15 EET [2020/11/27 18:16:15 ET]
Table '3060068759 4' 9-max Seat #5 is the button
Seat 3: dimYLiaK (3317 in chips) 
Seat 4: andrey pyatkin (684 in chips) 
Seat 5: jcarlos.vale (2618 in chips) 
Seat 7: clonharek704 (5367 in chips) 
Seat 8: AyrtonAA95 (8520 in chips) 
Seat 9: (ANEKDOT)777 (1396 in chips) 
dimYLiaK: posts the ante 25
andrey pyatkin: posts the ante 25
jcarlos.vale: posts the ante 25
clonharek704: posts the ante 25
AyrtonAA95: posts the ante 25
(ANEKDOT)777: posts the ante 25
clonharek704: posts small blind 100
AyrtonAA95: posts big blind 200
*** HOLE CARDS ***
Dealt to jcarlos.vale [4d As]
(ANEKDOT)777: folds 
dimYLiaK: folds 
andrey pyatkin: folds 
jcarlos.vale: folds 
clonharek704: folds 
Uncalled bet (100) returned to AyrtonAA95
AyrtonAA95 collected 350 from pot
AyrtonAA95: doesn't show hand 
*** SUMMARY ***
Total pot 350 | Rake 0 
Seat 3: dimYLiaK folded before Flop (didn't bet)
Seat 4: andrey pyatkin folded before Flop (didn't bet)
Seat 5: jcarlos.vale (button) folded before Flop (didn't bet)
Seat 7: clonharek704 (small blind) folded before Flop
Seat 8: AyrtonAA95 (big blind) collected (350)
Seat 9: (ANEKDOT)777 folded before Flop (didn't bet)



PokerStars Hand #220859569577: Tournament #3060068759, $0.23+$0.02 USD Hold'em No Limit - Level VII (100/200) - 2020/11/28 1:16:31 EET [2020/11/27 18:16:31 ET]
Table '3060068759 4' 9-max Seat #7 is the button
Seat 3: dimYLiaK (3292 in chips) 
Seat 4: andrey pyatkin (659 in chips) 
Seat 5: jcarlos.vale (2593 in chips) 
Seat 7: clonharek704 (5242 in chips) 
Seat 8: AyrtonAA95 (8745 in chips) 
Seat 9: (ANEKDOT)777 (1371 in chips) 
dimYLiaK: posts the ante 25
andrey pyatkin: posts the ante 25
jcarlos.vale: posts the ante 25
clonharek704: posts the ante 25
AyrtonAA95: posts the ante 25
(ANEKDOT)777: posts the ante 25
AyrtonAA95: posts small blind 100
(ANEKDOT)777: posts big blind 200
*** HOLE CARDS ***
Dealt to jcarlos.vale [9d Ks]
dimYLiaK: folds 
andrey pyatkin: folds 
jcarlos.vale: folds 
clonharek704: folds 
AyrtonAA95: folds 
Uncalled bet (100) returned to (ANEKDOT)777
(ANEKDOT)777 collected 350 from pot
(ANEKDOT)777: doesn't show hand 
*** SUMMARY ***
Total pot 350 | Rake 0 
Seat 3: dimYLiaK folded before Flop (didn't bet)
Seat 4: andrey pyatkin folded before Flop (didn't bet)
Seat 5: jcarlos.vale folded before Flop (didn't bet)
Seat 7: clonharek704 (button) folded before Flop (didn't bet)
Seat 8: AyrtonAA95 (small blind) folded before Flop
Seat 9: (ANEKDOT)777 (big blind) collected (350)



PokerStars Hand #220859585341: Tournament #3060068759, $0.23+$0.02 USD Hold'em No Limit - Level VII (100/200) - 2020/11/28 1:16:56 EET [2020/11/27 18:16:56 ET]
Table '3060068759 4' 9-max Seat #8 is the button
Seat 1: FlyingButche (1023 in chips) 
Seat 2: tEddy-KBG 77 (334 in chips) is sitting out
Seat 3: dimYLiaK (3267 in chips) 
Seat 4: andrey pyatkin (634 in chips) 
Seat 5: jcarlos.vale (2568 in chips) 
Seat 6: ErickSayajin (12526 in chips) 
Seat 7: clonharek704 (5217 in chips) 
Seat 8: AyrtonAA95 (8620 in chips) 
Seat 9: (ANEKDOT)777 (1596 in chips) 
FlyingButche: posts the ante 25
tEddy-KBG 77: posts the ante 25
dimYLiaK: posts the ante 25
andrey pyatkin: posts the ante 25
jcarlos.vale: posts the ante 25
ErickSayajin: posts the ante 25
clonharek704: posts the ante 25
AyrtonAA95: posts the ante 25
(ANEKDOT)777: posts the ante 25
(ANEKDOT)777: posts small blind 100
FlyingButche: posts big blind 200
*** HOLE CARDS ***
Dealt to jcarlos.vale [9d Ts]
tEddy-KBG 77: folds 
dimYLiaK: folds 
andrey pyatkin: raises 409 to 609 and is all-in
jcarlos.vale: folds 
ErickSayajin: raises 409 to 1018
clonharek704: folds 
AyrtonAA95: folds 
(ANEKDOT)777: folds 
FlyingButche: calls 798 and is all-in
Uncalled bet (20) returned to ErickSayajin
*** FLOP *** [Jh Th Qs]
*** TURN *** [Jh Th Qs] [4h]
*** RIVER *** [Jh Th Qs 4h] [3d]
*** SHOW DOWN ***
FlyingButche: shows [Ad Qh] (a pair of Queens)
ErickSayajin: shows [3h Ah] (a flush, Ace high)
ErickSayajin collected 778 from side pot
andrey pyatkin: shows [8s Kd] (high card King)
jcarlos.vale said, "kraio Erck"
ErickSayajin collected 2152 from main pot
FlyingButche finished the tournament in 16th place
andrey pyatkin finished the tournament in 17th place
jcarlos.vale said, "que oconta"
*** SUMMARY ***
Total pot 2930 Main pot 2152. Side pot 778. | Rake 0 
Board [Jh Th Qs 4h 3d]
Seat 1: FlyingButche (big blind) showed [Ad Qh] and lost with a pair of Queens
Seat 2: tEddy-KBG 77 folded before Flop (didn't bet)
Seat 3: dimYLiaK folded before Flop (didn't bet)
Seat 4: andrey pyatkin showed [8s Kd] and lost with high card King
Seat 5: jcarlos.vale folded before Flop (didn't bet)
Seat 6: ErickSayajin showed [3h Ah] and won (2930) with a flush, Ace high
Seat 7: clonharek704 folded before Flop (didn't bet)
Seat 8: AyrtonAA95 (button) folded before Flop (didn't bet)
Seat 9: (ANEKDOT)777 (small blind) folded before Flop



PokerStars Hand #220859611915: Tournament #3060068759, $0.23+$0.02 USD Hold'em No Limit - Level VII (100/200) - 2020/11/28 1:17:39 EET [2020/11/27 18:17:39 ET]
Table '3060068759 4' 9-max Seat #9 is the button
Seat 2: tEddy-KBG 77 (309 in chips) is sitting out
Seat 3: dimYLiaK (3242 in chips) 
Seat 5: jcarlos.vale (2543 in chips) 
Seat 6: ErickSayajin (14433 in chips) 
Seat 7: clonharek704 (5192 in chips) 
Seat 8: AyrtonAA95 (8595 in chips) 
Seat 9: (ANEKDOT)777 (1471 in chips) 
tEddy-KBG 77: posts the ante 25
dimYLiaK: posts the ante 25
jcarlos.vale: posts the ante 25
ErickSayajin: posts the ante 25
clonharek704: posts the ante 25
AyrtonAA95: posts the ante 25
(ANEKDOT)777: posts the ante 25
tEddy-KBG 77: posts small blind 100
dimYLiaK: posts big blind 200
*** HOLE CARDS ***
Dealt to jcarlos.vale [6s Jc]
jcarlos.vale said, "que conta"
jcarlos.vale: folds 
ErickSayajin: raises 400 to 600
clonharek704: folds 
AyrtonAA95: folds 
(ANEKDOT)777: folds 
tEddy-KBG 77: folds 
dimYLiaK: folds 
Uncalled bet (400) returned to ErickSayajin
ErickSayajin collected 675 from pot
ErickSayajin: doesn't show hand 
*** SUMMARY ***
Total pot 675 | Rake 0 
Seat 2: tEddy-KBG 77 (small blind) folded before Flop
Seat 3: dimYLiaK (big blind) folded before Flop
Seat 5: jcarlos.vale folded before Flop (didn't bet)
Seat 6: ErickSayajin collected (675)
Seat 7: clonharek704 folded before Flop (didn't bet)
Seat 8: AyrtonAA95 folded before Flop (didn't bet)
Seat 9: (ANEKDOT)777 (button) folded before Flop (didn't bet)



PokerStars Hand #220859627709: Tournament #3060068759, $0.23+$0.02 USD Hold'em No Limit - Level VII (100/200) - 2020/11/28 1:18:04 EET [2020/11/27 18:18:04 ET]
Table '3060068759 4' 9-max Seat #2 is the button
Seat 2: tEddy-KBG 77 (184 in chips) is sitting out
Seat 3: dimYLiaK (3017 in chips) 
Seat 5: jcarlos.vale (2518 in chips) 
Seat 6: ErickSayajin (14883 in chips) 
Seat 7: clonharek704 (5167 in chips) 
Seat 8: AyrtonAA95 (8570 in chips) 
Seat 9: (ANEKDOT)777 (1446 in chips) 
tEddy-KBG 77: posts the ante 25
dimYLiaK: posts the ante 25
jcarlos.vale: posts the ante 25
ErickSayajin: posts the ante 25
clonharek704: posts the ante 25
AyrtonAA95: posts the ante 25
(ANEKDOT)777: posts the ante 25
dimYLiaK: posts small blind 100
jcarlos.vale: posts big blind 200
*** HOLE CARDS ***
Dealt to jcarlos.vale [5d 8s]
ErickSayajin: raises 400 to 600
clonharek704: folds 
AyrtonAA95 has timed out
AyrtonAA95: folds 
AyrtonAA95 is sitting out
(ANEKDOT)777: folds 
tEddy-KBG 77: folds 
dimYLiaK: folds 
jcarlos.vale: folds 
Uncalled bet (400) returned to ErickSayajin
ErickSayajin collected 675 from pot
ErickSayajin: doesn't show hand 
*** SUMMARY ***
Total pot 675 | Rake 0 
Seat 2: tEddy-KBG 77 (button) folded before Flop (didn't bet)
Seat 3: dimYLiaK (small blind) folded before Flop
Seat 5: jcarlos.vale (big blind) folded before Flop
Seat 6: ErickSayajin collected (675)
Seat 7: clonharek704 folded before Flop (didn't bet)
Seat 8: AyrtonAA95 folded before Flop (didn't bet)
Seat 9: (ANEKDOT)777 folded before Flop (didn't bet)



PokerStars Hand #220859683502: Tournament #3060068759, $0.23+$0.02 USD Hold'em No Limit - Level VII (100/200) - 2020/11/28 1:19:35 EET [2020/11/27 18:19:35 ET]
Table '3060068759 4' 9-max Seat #3 is the button
Seat 2: tEddy-KBG 77 (159 in chips) is sitting out
Seat 3: dimYLiaK (2892 in chips) 
Seat 5: jcarlos.vale (2293 in chips) 
Seat 6: ErickSayajin (15333 in chips) 
Seat 7: clonharek704 (5142 in chips) 
Seat 8: AyrtonAA95 (8545 in chips) is sitting out
Seat 9: (ANEKDOT)777 (1421 in chips) 
tEddy-KBG 77: posts the ante 25
dimYLiaK: posts the ante 25
jcarlos.vale: posts the ante 25
ErickSayajin: posts the ante 25
clonharek704: posts the ante 25
AyrtonAA95: posts the ante 25
(ANEKDOT)777: posts the ante 25
jcarlos.vale: posts small blind 100
ErickSayajin: posts big blind 200
*** HOLE CARDS ***
Dealt to jcarlos.vale [Ah Td]
clonharek704: folds 
AyrtonAA95: folds 
(ANEKDOT)777: folds 
tEddy-KBG 77: folds 
dimYLiaK: folds 
jcarlos.vale: raises 2068 to 2268 and is all-in
ErickSayajin: calls 2068
*** FLOP *** [Qs 6h Tc]
*** TURN *** [Qs 6h Tc] [Kc]
*** RIVER *** [Qs 6h Tc Kc] [Kd]
*** SHOW DOWN ***
jcarlos.vale: shows [Ah Td] (two pair, Kings and Tens)
ErickSayajin: shows [Ts 9s] (two pair, Kings and Tens - lower kicker)
jcarlos.vale collected 4711 from pot
*** SUMMARY ***
Total pot 4711 | Rake 0 
Board [Qs 6h Tc Kc Kd]
Seat 2: tEddy-KBG 77 folded before Flop (didn't bet)
Seat 3: dimYLiaK (button) folded before Flop (didn't bet)
Seat 5: jcarlos.vale (small blind) showed [Ah Td] and won (4711) with two pair, Kings and Tens
Seat 6: ErickSayajin (big blind) showed [Ts 9s] and lost with two pair, Kings and Tens
Seat 7: clonharek704 folded before Flop (didn't bet)
Seat 8: AyrtonAA95 folded before Flop (didn't bet)
Seat 9: (ANEKDOT)777 folded before Flop (didn't bet)



PokerStars Hand #220859710293: Tournament #3060068759, $0.23+$0.02 USD Hold'em No Limit - Level VII (100/200) - 2020/11/28 1:20:19 EET [2020/11/27 18:20:19 ET]
Table '3060068759 4' 9-max Seat #5 is the button
Seat 2: tEddy-KBG 77 (134 in chips) is sitting out
Seat 3: dimYLiaK (2867 in chips) 
Seat 5: jcarlos.vale (4711 in chips) 
Seat 6: ErickSayajin (13040 in chips) 
Seat 7: clonharek704 (5117 in chips) 
Seat 8: AyrtonAA95 (8520 in chips) is sitting out
Seat 9: (ANEKDOT)777 (1396 in chips) 
tEddy-KBG 77: posts the ante 25
dimYLiaK: posts the ante 25
jcarlos.vale: posts the ante 25
ErickSayajin: posts the ante 25
clonharek704: posts the ante 25
AyrtonAA95: posts the ante 25
(ANEKDOT)777: posts the ante 25
ErickSayajin: posts small blind 100
clonharek704: posts big blind 200
*** HOLE CARDS ***
Dealt to jcarlos.vale [9d Ac]
AyrtonAA95: folds 
(ANEKDOT)777: folds 
tEddy-KBG 77: folds 
dimYLiaK: folds 
ErickSayajin said, "eae de novo jcarlo"
jcarlos.vale: folds 
ErickSayajin: calls 100
jcarlos.vale said, "fala ae"
clonharek704: checks 
*** FLOP *** [Kh 8h 7h]
ErickSayajin: checks 
clonharek704: bets 200
ErickSayajin: folds 
Uncalled bet (200) returned to clonharek704
clonharek704 collected 575 from pot
*** SUMMARY ***
Total pot 575 | Rake 0 
Board [Kh 8h 7h]
Seat 2: tEddy-KBG 77 folded before Flop (didn't bet)
Seat 3: dimYLiaK folded before Flop (didn't bet)
Seat 5: jcarlos.vale (button) folded before Flop (didn't bet)
Seat 6: ErickSayajin (small blind) folded on the Flop
Seat 7: clonharek704 (big blind) collected (575)
Seat 8: AyrtonAA95 folded before Flop (didn't bet)
Seat 9: (ANEKDOT)777 folded before Flop (didn't bet)



PokerStars Hand #220859730451: Tournament #3060068759, $0.23+$0.02 USD Hold'em No Limit - Level VII (100/200) - 2020/11/28 1:20:51 EET [2020/11/27 18:20:51 ET]
Table '3060068759 4' 9-max Seat #6 is the button
Seat 2: tEddy-KBG 77 (109 in chips) is sitting out
Seat 3: dimYLiaK (2842 in chips) 
Seat 5: jcarlos.vale (4686 in chips) 
Seat 6: ErickSayajin (12815 in chips) 
Seat 7: clonharek704 (5467 in chips) 
Seat 8: AyrtonAA95 (8495 in chips) is sitting out
Seat 9: (ANEKDOT)777 (1371 in chips) 
tEddy-KBG 77: posts the ante 25
dimYLiaK: posts the ante 25
jcarlos.vale: posts the ante 25
ErickSayajin: posts the ante 25
clonharek704: posts the ante 25
AyrtonAA95: posts the ante 25
(ANEKDOT)777: posts the ante 25
clonharek704: posts small blind 100
AyrtonAA95: posts big blind 200
*** HOLE CARDS ***
Dealt to jcarlos.vale [3s 5s]
(ANEKDOT)777: folds 
tEddy-KBG 77: folds 
dimYLiaK: folds 
jcarlos.vale: folds 
ErickSayajin: folds 
AyrtonAA95 is disconnected 
clonharek704: raises 200 to 400
AyrtonAA95: folds 
Uncalled bet (200) returned to clonharek704
clonharek704 collected 575 from pot
*** SUMMARY ***
Total pot 575 | Rake 0 
Seat 2: tEddy-KBG 77 folded before Flop (didn't bet)
Seat 3: dimYLiaK folded before Flop (didn't bet)
Seat 5: jcarlos.vale folded before Flop (didn't bet)
Seat 6: ErickSayajin (button) folded before Flop (didn't bet)
Seat 7: clonharek704 (small blind) collected (575)
Seat 8: AyrtonAA95 (big blind) folded before Flop
Seat 9: (ANEKDOT)777 folded before Flop (didn't bet)



PokerStars Hand #220859751014: Tournament #3060068759, $0.23+$0.02 USD Hold'em No Limit - Level VII (100/200) - 2020/11/28 1:21:19 EET [2020/11/27 18:21:19 ET]
Table '3060068759 4' 9-max Seat #7 is the button
Seat 2: tEddy-KBG 77 (84 in chips) is sitting out
Seat 3: dimYLiaK (2817 in chips) 
Seat 5: jcarlos.vale (4661 in chips) 
Seat 6: ErickSayajin (12790 in chips) 
Seat 7: clonharek704 (5817 in chips) 
Seat 8: AyrtonAA95 (8270 in chips) is sitting out
Seat 9: (ANEKDOT)777 (1346 in chips) 
tEddy-KBG 77: posts the ante 25
dimYLiaK: posts the ante 25
jcarlos.vale: posts the ante 25
ErickSayajin: posts the ante 25
clonharek704: posts the ante 25
AyrtonAA95: posts the ante 25
(ANEKDOT)777: posts the ante 25
AyrtonAA95: posts small blind 100
(ANEKDOT)777: posts big blind 200
*** HOLE CARDS ***
Dealt to jcarlos.vale [Qs 3h]
tEddy-KBG 77: folds 
dimYLiaK: folds 
jcarlos.vale: folds 
ErickSayajin: calls 200
clonharek704: calls 200
AyrtonAA95: folds 
(ANEKDOT)777: checks 
*** FLOP *** [Ad As 9h]
(ANEKDOT)777: checks 
ErickSayajin: bets 600
clonharek704: folds 
(ANEKDOT)777: folds 
Uncalled bet (600) returned to ErickSayajin
ErickSayajin collected 875 from pot
ErickSayajin: doesn't show hand 
*** SUMMARY ***
Total pot 875 | Rake 0 
Board [Ad As 9h]
Seat 2: tEddy-KBG 77 folded before Flop (didn't bet)
Seat 3: dimYLiaK folded before Flop (didn't bet)
Seat 5: jcarlos.vale folded before Flop (didn't bet)
Seat 6: ErickSayajin collected (875)
Seat 7: clonharek704 (button) folded on the Flop
Seat 8: AyrtonAA95 (small blind) folded before Flop
Seat 9: (ANEKDOT)777 (big blind) folded on the Flop



PokerStars Hand #220859772487: Tournament #3060068759, $0.23+$0.02 USD Hold'em No Limit - Level VII (100/200) - 2020/11/28 1:21:53 EET [2020/11/27 18:21:53 ET]
Table '3060068759 4' 9-max Seat #8 is the button
Seat 2: tEddy-KBG 77 (59 in chips) is sitting out
Seat 3: dimYLiaK (2792 in chips) 
Seat 5: jcarlos.vale (4636 in chips) 
Seat 6: ErickSayajin (13440 in chips) 
Seat 7: clonharek704 (5592 in chips) 
Seat 8: AyrtonAA95 (8145 in chips) is sitting out
Seat 9: (ANEKDOT)777 (1121 in chips) 
tEddy-KBG 77: posts the ante 25
dimYLiaK: posts the ante 25
jcarlos.vale: posts the ante 25
ErickSayajin: posts the ante 25
clonharek704: posts the ante 25
AyrtonAA95: posts the ante 25
(ANEKDOT)777: posts the ante 25
(ANEKDOT)777: posts small blind 100
tEddy-KBG 77: posts big blind 34 and is all-in
*** HOLE CARDS ***
Dealt to jcarlos.vale [Qc 5s]
dimYLiaK: folds 
jcarlos.vale: folds 
ErickSayajin: folds 
clonharek704: folds 
AyrtonAA95: folds 
tEddy-KBG 77: folds 
Uncalled bet (66) returned to (ANEKDOT)777
(ANEKDOT)777 collected 243 from pot
tEddy-KBG 77 finished the tournament in 14th place
(ANEKDOT)777: doesn't show hand 
*** SUMMARY ***
Total pot 243 | Rake 0 
Seat 2: tEddy-KBG 77 (big blind) folded before Flop
Seat 3: dimYLiaK folded before Flop (didn't bet)
Seat 5: jcarlos.vale folded before Flop (didn't bet)
Seat 6: ErickSayajin folded before Flop (didn't bet)
Seat 7: clonharek704 folded before Flop (didn't bet)
Seat 8: AyrtonAA95 (button) folded before Flop (didn't bet)
Seat 9: (ANEKDOT)777 (small blind) collected (243)



PokerStars Hand #220859783263: Tournament #3060068759, $0.23+$0.02 USD Hold'em No Limit - Level VII (100/200) - 2020/11/28 1:22:11 EET [2020/11/27 18:22:11 ET]
Table '3060068759 4' 9-max Seat #9 is the button
Seat 3: dimYLiaK (2767 in chips) 
Seat 5: jcarlos.vale (4611 in chips) 
Seat 6: ErickSayajin (13415 in chips) 
Seat 7: clonharek704 (5567 in chips) 
Seat 8: AyrtonAA95 (8120 in chips) is sitting out
Seat 9: (ANEKDOT)777 (1305 in chips) 
dimYLiaK: posts the ante 25
jcarlos.vale: posts the ante 25
ErickSayajin: posts the ante 25
clonharek704: posts the ante 25
AyrtonAA95: posts the ante 25
(ANEKDOT)777: posts the ante 25
dimYLiaK: posts small blind 100
jcarlos.vale: posts big blind 200
*** HOLE CARDS ***
Dealt to jcarlos.vale [Qc Js]
ErickSayajin: folds 
clonharek704: raises 200 to 400
AyrtonAA95: folds 
(ANEKDOT)777: folds 
dimYLiaK: folds 
jcarlos.vale: calls 200
*** FLOP *** [7c Kd 6d]
jcarlos.vale: checks 
clonharek704: bets 400
jcarlos.vale: folds 
Uncalled bet (400) returned to clonharek704
clonharek704 collected 1050 from pot
*** SUMMARY ***
Total pot 1050 | Rake 0 
Board [7c Kd 6d]
Seat 3: dimYLiaK (small blind) folded before Flop
Seat 5: jcarlos.vale (big blind) folded on the Flop
Seat 6: ErickSayajin folded before Flop (didn't bet)
Seat 7: clonharek704 collected (1050)
Seat 8: AyrtonAA95 folded before Flop (didn't bet)
Seat 9: (ANEKDOT)777 (button) folded before Flop (didn't bet)



PokerStars Hand #220859807022: Tournament #3060068759, $0.23+$0.02 USD Hold'em No Limit - Level VII (100/200) - 2020/11/28 1:22:50 EET [2020/11/27 18:22:50 ET]
Table '3060068759 4' 9-max Seat #3 is the button
Seat 3: dimYLiaK (2642 in chips) 
Seat 5: jcarlos.vale (4186 in chips) 
Seat 6: ErickSayajin (13390 in chips) 
Seat 7: clonharek704 (6192 in chips) 
Seat 8: AyrtonAA95 (8095 in chips) is sitting out
Seat 9: (ANEKDOT)777 (1280 in chips) 
dimYLiaK: posts the ante 25
jcarlos.vale: posts the ante 25
ErickSayajin: posts the ante 25
clonharek704: posts the ante 25
AyrtonAA95: posts the ante 25
(ANEKDOT)777: posts the ante 25
jcarlos.vale: posts small blind 100
ErickSayajin: posts big blind 200
*** HOLE CARDS ***
Dealt to jcarlos.vale [3h 6s]
clonharek704: folds 
AyrtonAA95: folds 
(ANEKDOT)777: folds 
dimYLiaK: folds 
jcarlos.vale: folds 
Uncalled bet (100) returned to ErickSayajin
ErickSayajin collected 350 from pot
ErickSayajin: doesn't show hand 
*** SUMMARY ***
Total pot 350 | Rake 0 
Seat 3: dimYLiaK (button) folded before Flop (didn't bet)
Seat 5: jcarlos.vale (small blind) folded before Flop
Seat 6: ErickSayajin (big blind) collected (350)
Seat 7: clonharek704 folded before Flop (didn't bet)
Seat 8: AyrtonAA95 folded before Flop (didn't bet)
Seat 9: (ANEKDOT)777 folded before Flop (didn't bet)



PokerStars Hand #220859819877: Tournament #3060068759, $0.23+$0.02 USD Hold'em No Limit - Level VII (100/200) - 2020/11/28 1:23:11 EET [2020/11/27 18:23:11 ET]
Table '3060068759 4' 9-max Seat #5 is the button
Seat 3: dimYLiaK (2617 in chips) 
Seat 5: jcarlos.vale (4061 in chips) 
Seat 6: ErickSayajin (13615 in chips) 
Seat 7: clonharek704 (6167 in chips) 
Seat 8: AyrtonAA95 (8070 in chips) is sitting out
Seat 9: (ANEKDOT)777 (1255 in chips) 
dimYLiaK: posts the ante 25
jcarlos.vale: posts the ante 25
ErickSayajin: posts the ante 25
clonharek704: posts the ante 25
AyrtonAA95: posts the ante 25
(ANEKDOT)777: posts the ante 25
ErickSayajin: posts small blind 100
clonharek704: posts big blind 200
*** HOLE CARDS ***
Dealt to jcarlos.vale [9d 9s]
AyrtonAA95: folds 
(ANEKDOT)777: folds 
dimYLiaK: folds 
jcarlos.vale: raises 3836 to 4036 and is all-in
ErickSayajin: folds 
clonharek704: folds 
Uncalled bet (3836) returned to jcarlos.vale
jcarlos.vale collected 650 from pot
jcarlos.vale: doesn't show hand 
*** SUMMARY ***
Total pot 650 | Rake 0 
Seat 3: dimYLiaK folded before Flop (didn't bet)
Seat 5: jcarlos.vale (button) collected (650)
Seat 6: ErickSayajin (small blind) folded before Flop
Seat 7: clonharek704 (big blind) folded before Flop
Seat 8: AyrtonAA95 folded before Flop (didn't bet)
Seat 9: (ANEKDOT)777 folded before Flop (didn't bet)



PokerStars Hand #220859835915: Tournament #3060068759, $0.23+$0.02 USD Hold'em No Limit - Level VII (100/200) - 2020/11/28 1:23:38 EET [2020/11/27 18:23:38 ET]
Table '3060068759 4' 9-max Seat #6 is the button
Seat 3: dimYLiaK (2592 in chips) 
Seat 5: jcarlos.vale (4486 in chips) 
Seat 6: ErickSayajin (13490 in chips) 
Seat 7: clonharek704 (5942 in chips) 
Seat 8: AyrtonAA95 (8045 in chips) is sitting out
Seat 9: (ANEKDOT)777 (1230 in chips) 
dimYLiaK: posts the ante 25
jcarlos.vale: posts the ante 25
ErickSayajin: posts the ante 25
clonharek704: posts the ante 25
AyrtonAA95: posts the ante 25
(ANEKDOT)777: posts the ante 25
clonharek704: posts small blind 100
AyrtonAA95: posts big blind 200
*** HOLE CARDS ***
Dealt to jcarlos.vale [Ac Jh]
(ANEKDOT)777: folds 
dimYLiaK: folds 
jcarlos.vale: raises 4261 to 4461 and is all-in
ErickSayajin: folds 
clonharek704 has timed out
clonharek704: folds 
clonharek704 is sitting out
AyrtonAA95: folds 
Uncalled bet (4261) returned to jcarlos.vale
jcarlos.vale collected 650 from pot
jcarlos.vale: doesn't show hand 
*** SUMMARY ***
Total pot 650 | Rake 0 
Seat 3: dimYLiaK folded before Flop (didn't bet)
Seat 5: jcarlos.vale collected (650)
Seat 6: ErickSayajin (button) folded before Flop (didn't bet)
Seat 7: clonharek704 (small blind) folded before Flop
Seat 8: AyrtonAA95 (big blind) folded before Flop
Seat 9: (ANEKDOT)777 folded before Flop (didn't bet)



PokerStars Hand #220859860834: Tournament #3060068759, $0.23+$0.02 USD Hold'em No Limit - Level VII (100/200) - 2020/11/28 1:24:19 EET [2020/11/27 18:24:19 ET]
Table '3060068759 4' 9-max Seat #7 is the button
Seat 3: dimYLiaK (2567 in chips) 
Seat 5: jcarlos.vale (4911 in chips) 
Seat 6: ErickSayajin (13465 in chips) 
Seat 7: clonharek704 (5817 in chips) is sitting out
Seat 8: AyrtonAA95 (7820 in chips) is sitting out
Seat 9: (ANEKDOT)777 (1205 in chips) 
dimYLiaK: posts the ante 25
jcarlos.vale: posts the ante 25
ErickSayajin: posts the ante 25
clonharek704: posts the ante 25
AyrtonAA95: posts the ante 25
(ANEKDOT)777: posts the ante 25
AyrtonAA95: posts small blind 100
(ANEKDOT)777: posts big blind 200
*** HOLE CARDS ***
Dealt to jcarlos.vale [7h Kc]
dimYLiaK: calls 200
jcarlos.vale: folds 
clonharek704 has returned
ErickSayajin: folds 
clonharek704: folds 
AyrtonAA95: folds 
(ANEKDOT)777: checks 
*** FLOP *** [4s 2s Td]
(ANEKDOT)777: bets 980 and is all-in
dimYLiaK: calls 980
*** TURN *** [4s 2s Td] [Qs]
*** RIVER *** [4s 2s Td Qs] [Th]
*** SHOW DOWN ***
(ANEKDOT)777: shows [6d 4d] (two pair, Tens and Fours)
dimYLiaK: shows [As 5s] (a flush, Ace high)
dimYLiaK collected 2610 from pot
(ANEKDOT)777 finished the tournament in 12th place
*** SUMMARY ***
Total pot 2610 | Rake 0 
Board [4s 2s Td Qs Th]
Seat 3: dimYLiaK showed [As 5s] and won (2610) with a flush, Ace high
Seat 5: jcarlos.vale folded before Flop (didn't bet)
Seat 6: ErickSayajin folded before Flop (didn't bet)
Seat 7: clonharek704 (button) folded before Flop (didn't bet)
Seat 8: AyrtonAA95 (small blind) folded before Flop
Seat 9: (ANEKDOT)777 (big blind) showed [6d 4d] and lost with two pair, Tens and Fours



PokerStars Hand #220859890891: Tournament #3060068759, $0.23+$0.02 USD Hold'em No Limit - Level VIII (150/300) - 2020/11/28 1:25:09 EET [2020/11/27 18:25:09 ET]
Table '3060068759 4' 9-max Seat #8 is the button
Seat 3: dimYLiaK (3972 in chips) 
Seat 5: jcarlos.vale (4886 in chips) 
Seat 6: ErickSayajin (13440 in chips) 
Seat 7: clonharek704 (5792 in chips) 
Seat 8: AyrtonAA95 (7695 in chips) is sitting out
dimYLiaK: posts the ante 25
jcarlos.vale: posts the ante 25
ErickSayajin: posts the ante 25
clonharek704: posts the ante 25
AyrtonAA95: posts the ante 25
dimYLiaK: posts small blind 150
jcarlos.vale: posts big blind 300
*** HOLE CARDS ***
Dealt to jcarlos.vale [Tc 2d]
ErickSayajin: folds 
clonharek704: folds 
AyrtonAA95: folds 
dimYLiaK: folds 
Uncalled bet (150) returned to jcarlos.vale
jcarlos.vale collected 425 from pot
jcarlos.vale: doesn't show hand 
*** SUMMARY ***
Total pot 425 | Rake 0 
Seat 3: dimYLiaK (small blind) folded before Flop
Seat 5: jcarlos.vale (big blind) collected (425)
Seat 6: ErickSayajin folded before Flop (didn't bet)
Seat 7: clonharek704 folded before Flop (didn't bet)
Seat 8: AyrtonAA95 (button) folded before Flop (didn't bet)



PokerStars Hand #220859900872: Tournament #3060068759, $0.23+$0.02 USD Hold'em No Limit - Level VIII (150/300) - 2020/11/28 1:25:25 EET [2020/11/27 18:25:25 ET]
Table '3060068759 4' 9-max Seat #3 is the button
Seat 3: dimYLiaK (3797 in chips) 
Seat 5: jcarlos.vale (5136 in chips) 
Seat 6: ErickSayajin (13415 in chips) 
Seat 7: clonharek704 (5767 in chips) 
Seat 8: AyrtonAA95 (7670 in chips) is sitting out
dimYLiaK: posts the ante 25
jcarlos.vale: posts the ante 25
ErickSayajin: posts the ante 25
clonharek704: posts the ante 25
AyrtonAA95: posts the ante 25
jcarlos.vale: posts small blind 150
ErickSayajin: posts big blind 300
*** HOLE CARDS ***
Dealt to jcarlos.vale [7s Kh]
clonharek704: folds 
AyrtonAA95: folds 
dimYLiaK: folds 
AyrtonAA95 has returned
jcarlos.vale: folds 
Uncalled bet (150) returned to ErickSayajin
ErickSayajin collected 425 from pot
ErickSayajin: doesn't show hand 
*** SUMMARY ***
Total pot 425 | Rake 0 
Seat 3: dimYLiaK (button) folded before Flop (didn't bet)
Seat 5: jcarlos.vale (small blind) folded before Flop
Seat 6: ErickSayajin (big blind) collected (425)
Seat 7: clonharek704 folded before Flop (didn't bet)
Seat 8: AyrtonAA95 folded before Flop (didn't bet)



PokerStars Hand #220859909968: Tournament #3060068759, $0.23+$0.02 USD Hold'em No Limit - Level VIII (150/300) - 2020/11/28 1:25:41 EET [2020/11/27 18:25:41 ET]
Table '3060068759 4' 9-max Seat #5 is the button
Seat 3: dimYLiaK (3772 in chips) 
Seat 5: jcarlos.vale (4961 in chips) 
Seat 6: ErickSayajin (13665 in chips) 
Seat 7: clonharek704 (5742 in chips) 
Seat 8: AyrtonAA95 (7645 in chips) 
dimYLiaK: posts the ante 25
jcarlos.vale: posts the ante 25
ErickSayajin: posts the ante 25
clonharek704: posts the ante 25
AyrtonAA95: posts the ante 25
ErickSayajin: posts small blind 150
clonharek704: posts big blind 300
*** HOLE CARDS ***
Dealt to jcarlos.vale [3c Qc]
AyrtonAA95: folds 
dimYLiaK: folds 
jcarlos.vale: folds 
ErickSayajin: calls 150
clonharek704: checks 
*** FLOP *** [7c 9d 7s]
ErickSayajin: bets 900
clonharek704: folds 
Uncalled bet (900) returned to ErickSayajin
ErickSayajin collected 725 from pot
ErickSayajin: doesn't show hand 
*** SUMMARY ***
Total pot 725 | Rake 0 
Board [7c 9d 7s]
Seat 3: dimYLiaK folded before Flop (didn't bet)
Seat 5: jcarlos.vale (button) folded before Flop (didn't bet)
Seat 6: ErickSayajin (small blind) collected (725)
Seat 7: clonharek704 (big blind) folded on the Flop
Seat 8: AyrtonAA95 folded before Flop (didn't bet)



PokerStars Hand #220859939956: Tournament #3060068759, $0.23+$0.02 USD Hold'em No Limit - Level VIII (150/300) - 2020/11/28 1:26:30 EET [2020/11/27 18:26:30 ET]
Table '3060068759 4' 9-max Seat #6 is the button
Seat 3: dimYLiaK (3747 in chips) 
Seat 5: jcarlos.vale (4936 in chips) 
Seat 6: ErickSayajin (14065 in chips) 
Seat 7: clonharek704 (5417 in chips) 
Seat 8: AyrtonAA95 (7620 in chips) 
dimYLiaK: posts the ante 25
jcarlos.vale: posts the ante 25
ErickSayajin: posts the ante 25
clonharek704: posts the ante 25
AyrtonAA95: posts the ante 25
clonharek704: posts small blind 150
AyrtonAA95: posts big blind 300
*** HOLE CARDS ***
Dealt to jcarlos.vale [Ks Qd]
dimYLiaK: folds 
jcarlos.vale: raises 4611 to 4911 and is all-in
ErickSayajin: folds 
clonharek704: folds 
AyrtonAA95: folds 
Uncalled bet (4611) returned to jcarlos.vale
jcarlos.vale collected 875 from pot
jcarlos.vale: doesn't show hand 
*** SUMMARY ***
Total pot 875 | Rake 0 
Seat 3: dimYLiaK folded before Flop (didn't bet)
Seat 5: jcarlos.vale collected (875)
Seat 6: ErickSayajin (button) folded before Flop (didn't bet)
Seat 7: clonharek704 (small blind) folded before Flop
Seat 8: AyrtonAA95 (big blind) folded before Flop



PokerStars Hand #220859954384: Tournament #3060068759, $0.23+$0.02 USD Hold'em No Limit - Level VIII (150/300) - 2020/11/28 1:26:54 EET [2020/11/27 18:26:54 ET]
Table '3060068759 4' 9-max Seat #7 is the button
Seat 3: dimYLiaK (3722 in chips) 
Seat 5: jcarlos.vale (5486 in chips) 
Seat 6: ErickSayajin (14040 in chips) 
Seat 7: clonharek704 (5242 in chips) 
Seat 8: AyrtonAA95 (7295 in chips) 
dimYLiaK: posts the ante 25
jcarlos.vale: posts the ante 25
ErickSayajin: posts the ante 25
clonharek704: posts the ante 25
AyrtonAA95: posts the ante 25
AyrtonAA95: posts small blind 150
dimYLiaK: posts big blind 300
*** HOLE CARDS ***
Dealt to jcarlos.vale [Jd Ad]
jcarlos.vale: raises 5161 to 5461 and is all-in
ErickSayajin: folds 
clonharek704: folds 
AyrtonAA95: folds 
dimYLiaK: folds 
Uncalled bet (5161) returned to jcarlos.vale
jcarlos.vale collected 875 from pot
jcarlos.vale: doesn't show hand 
ErickSayajin said, "uÃ© dando all win toda hora,vou pagar heim kk"
*** SUMMARY ***
Total pot 875 | Rake 0 
Seat 3: dimYLiaK (big blind) folded before Flop
Seat 5: jcarlos.vale collected (875)
Seat 6: ErickSayajin folded before Flop (didn't bet)
Seat 7: clonharek704 (button) folded before Flop (didn't bet)
Seat 8: AyrtonAA95 (small blind) folded before Flop



PokerStars Hand #220859970806: Tournament #3060068759, $0.23+$0.02 USD Hold'em No Limit - Level VIII (150/300) - 2020/11/28 1:27:22 EET [2020/11/27 18:27:22 ET]
Table '3060068759 4' 9-max Seat #8 is the button
Seat 3: dimYLiaK (3397 in chips) 
Seat 5: jcarlos.vale (6036 in chips) 
Seat 6: ErickSayajin (14015 in chips) 
Seat 7: clonharek704 (5217 in chips) 
Seat 8: AyrtonAA95 (7120 in chips) 
dimYLiaK: posts the ante 25
jcarlos.vale: posts the ante 25
ErickSayajin: posts the ante 25
clonharek704: posts the ante 25
AyrtonAA95: posts the ante 25
dimYLiaK: posts small blind 150
jcarlos.vale: posts big blind 300
*** HOLE CARDS ***
Dealt to jcarlos.vale [4d Ks]
ErickSayajin: raises 600 to 900
clonharek704: folds 
AyrtonAA95: folds 
dimYLiaK: folds 
jcarlos.vale: folds 
Uncalled bet (600) returned to ErickSayajin
ErickSayajin collected 875 from pot
ErickSayajin: doesn't show hand 
*** SUMMARY ***
Total pot 875 | Rake 0 
Seat 3: dimYLiaK (small blind) folded before Flop
Seat 5: jcarlos.vale (big blind) folded before Flop
Seat 6: ErickSayajin collected (875)
Seat 7: clonharek704 folded before Flop (didn't bet)
Seat 8: AyrtonAA95 (button) folded before Flop (didn't bet)



PokerStars Hand #220859984678: Tournament #3060068759, $0.23+$0.02 USD Hold'em No Limit - Level VIII (150/300) - 2020/11/28 1:27:45 EET [2020/11/27 18:27:45 ET]
Table '3060068759 4' 9-max Seat #3 is the button
Seat 3: dimYLiaK (3222 in chips) 
Seat 5: jcarlos.vale (5711 in chips) 
Seat 6: ErickSayajin (14565 in chips) 
Seat 7: clonharek704 (5192 in chips) 
Seat 8: AyrtonAA95 (7095 in chips) 
dimYLiaK: posts the ante 25
jcarlos.vale: posts the ante 25
ErickSayajin: posts the ante 25
clonharek704: posts the ante 25
AyrtonAA95: posts the ante 25
jcarlos.vale: posts small blind 150
ErickSayajin: posts big blind 300
*** HOLE CARDS ***
Dealt to jcarlos.vale [Kd 3c]
clonharek704: folds 
AyrtonAA95: folds 
dimYLiaK: folds 
jcarlos.vale: folds 
Uncalled bet (150) returned to ErickSayajin
ErickSayajin collected 425 from pot
ErickSayajin: doesn't show hand 
*** SUMMARY ***
Total pot 425 | Rake 0 
Seat 3: dimYLiaK (button) folded before Flop (didn't bet)
Seat 5: jcarlos.vale (small blind) folded before Flop
Seat 6: ErickSayajin (big blind) collected (425)
Seat 7: clonharek704 folded before Flop (didn't bet)
Seat 8: AyrtonAA95 folded before Flop (didn't bet)



PokerStars Hand #220860004579: Tournament #3060068759, $0.23+$0.02 USD Hold'em No Limit - Level VIII (150/300) - 2020/11/28 1:28:19 EET [2020/11/27 18:28:19 ET]
Table '3060068759 4' 9-max Seat #5 is the button
Seat 3: dimYLiaK (3197 in chips) 
Seat 5: jcarlos.vale (5536 in chips) 
Seat 6: ErickSayajin (14815 in chips) 
Seat 7: clonharek704 (5167 in chips) 
Seat 8: AyrtonAA95 (7070 in chips) 
dimYLiaK: posts the ante 25
jcarlos.vale: posts the ante 25
ErickSayajin: posts the ante 25
clonharek704: posts the ante 25
AyrtonAA95: posts the ante 25
ErickSayajin: posts small blind 150
clonharek704: posts big blind 300
*** HOLE CARDS ***
Dealt to jcarlos.vale [7c 8d]
AyrtonAA95: folds 
dimYLiaK: folds 
jcarlos.vale: folds 
ErickSayajin: calls 150
clonharek704: checks 
*** FLOP *** [Ts Jc 5c]
ErickSayajin: checks 
clonharek704: checks 
*** TURN *** [Ts Jc 5c] [Td]
ErickSayajin: bets 363
clonharek704: folds 
Uncalled bet (363) returned to ErickSayajin
ErickSayajin collected 725 from pot
ErickSayajin: doesn't show hand 
*** SUMMARY ***
Total pot 725 | Rake 0 
Board [Ts Jc 5c Td]
Seat 3: dimYLiaK folded before Flop (didn't bet)
Seat 5: jcarlos.vale (button) folded before Flop (didn't bet)
Seat 6: ErickSayajin (small blind) collected (725)
Seat 7: clonharek704 (big blind) folded on the Turn
Seat 8: AyrtonAA95 folded before Flop (didn't bet)



PokerStars Hand #220860031197: Tournament #3060068759, $0.23+$0.02 USD Hold'em No Limit - Level VIII (150/300) - 2020/11/28 1:29:03 EET [2020/11/27 18:29:03 ET]
Table '3060068759 4' 9-max Seat #6 is the button
Seat 3: dimYLiaK (3172 in chips) 
Seat 5: jcarlos.vale (5511 in chips) 
Seat 6: ErickSayajin (15215 in chips) 
Seat 7: clonharek704 (4842 in chips) 
Seat 8: AyrtonAA95 (7045 in chips) 
dimYLiaK: posts the ante 25
jcarlos.vale: posts the ante 25
ErickSayajin: posts the ante 25
clonharek704: posts the ante 25
AyrtonAA95: posts the ante 25
clonharek704: posts small blind 150
AyrtonAA95: posts big blind 300
*** HOLE CARDS ***
Dealt to jcarlos.vale [Kc Ac]
dimYLiaK: folds 
jcarlos.vale: raises 5186 to 5486 and is all-in
ErickSayajin: folds 
clonharek704: folds 
AyrtonAA95: folds 
Uncalled bet (5186) returned to jcarlos.vale
jcarlos.vale collected 875 from pot
jcarlos.vale: doesn't show hand 
*** SUMMARY ***
Total pot 875 | Rake 0 
Seat 3: dimYLiaK folded before Flop (didn't bet)
Seat 5: jcarlos.vale collected (875)
Seat 6: ErickSayajin (button) folded before Flop (didn't bet)
Seat 7: clonharek704 (small blind) folded before Flop
Seat 8: AyrtonAA95 (big blind) folded before Flop



PokerStars Hand #220860040877: Tournament #3060068759, $0.23+$0.02 USD Hold'em No Limit - Level VIII (150/300) - 2020/11/28 1:29:20 EET [2020/11/27 18:29:20 ET]
Table '3060068759 4' 9-max Seat #7 is the button
Seat 3: dimYLiaK (3147 in chips) 
Seat 5: jcarlos.vale (6061 in chips) 
Seat 6: ErickSayajin (15190 in chips) 
Seat 7: clonharek704 (4667 in chips) 
Seat 8: AyrtonAA95 (6720 in chips) 
dimYLiaK: posts the ante 25
jcarlos.vale: posts the ante 25
ErickSayajin: posts the ante 25
clonharek704: posts the ante 25
AyrtonAA95: posts the ante 25
AyrtonAA95: posts small blind 150
dimYLiaK: posts big blind 300
*** HOLE CARDS ***
Dealt to jcarlos.vale [7d Ah]
jcarlos.vale: folds 
ErickSayajin: folds 
clonharek704: folds 
AyrtonAA95: folds 
Uncalled bet (150) returned to dimYLiaK
dimYLiaK collected 425 from pot
dimYLiaK: doesn't show hand 
*** SUMMARY ***
Total pot 425 | Rake 0 
Seat 3: dimYLiaK (big blind) collected (425)
Seat 5: jcarlos.vale folded before Flop (didn't bet)
Seat 6: ErickSayajin folded before Flop (didn't bet)
Seat 7: clonharek704 (button) folded before Flop (didn't bet)
Seat 8: AyrtonAA95 (small blind) folded before Flop



PokerStars Hand #220860053584: Tournament #3060068759, $0.23+$0.02 USD Hold'em No Limit - Level VIII (150/300) - 2020/11/28 1:29:41 EET [2020/11/27 18:29:41 ET]
Table '3060068759 4' 9-max Seat #8 is the button
Seat 3: dimYLiaK (3397 in chips) 
Seat 5: jcarlos.vale (6036 in chips) 
Seat 6: ErickSayajin (15165 in chips) 
Seat 7: clonharek704 (4642 in chips) 
Seat 8: AyrtonAA95 (6545 in chips) 
dimYLiaK: posts the ante 25
jcarlos.vale: posts the ante 25
ErickSayajin: posts the ante 25
clonharek704: posts the ante 25
AyrtonAA95: posts the ante 25
dimYLiaK: posts small blind 150
jcarlos.vale: posts big blind 300
*** HOLE CARDS ***
Dealt to jcarlos.vale [8s 2d]
ErickSayajin: folds 
clonharek704: folds 
AyrtonAA95: raises 300 to 600
dimYLiaK: folds 
jcarlos.vale: folds 
Uncalled bet (300) returned to AyrtonAA95
AyrtonAA95 collected 875 from pot
AyrtonAA95: doesn't show hand 
*** SUMMARY ***
Total pot 875 | Rake 0 
Seat 3: dimYLiaK (small blind) folded before Flop
Seat 5: jcarlos.vale (big blind) folded before Flop
Seat 6: ErickSayajin folded before Flop (didn't bet)
Seat 7: clonharek704 folded before Flop (didn't bet)
Seat 8: AyrtonAA95 (button) collected (875)



PokerStars Hand #220860065153: Tournament #3060068759, $0.23+$0.02 USD Hold'em No Limit - Level VIII (150/300) - 2020/11/28 1:30:01 EET [2020/11/27 18:30:01 ET]
Table '3060068759 4' 9-max Seat #3 is the button
Seat 3: dimYLiaK (3222 in chips) 
Seat 5: jcarlos.vale (5711 in chips) 
Seat 6: ErickSayajin (15140 in chips) 
Seat 7: clonharek704 (4617 in chips) 
Seat 8: AyrtonAA95 (7095 in chips) 
dimYLiaK: posts the ante 25
jcarlos.vale: posts the ante 25
ErickSayajin: posts the ante 25
clonharek704: posts the ante 25
AyrtonAA95: posts the ante 25
jcarlos.vale: posts small blind 150
ErickSayajin: posts big blind 300
*** HOLE CARDS ***
Dealt to jcarlos.vale [Qc 2s]
clonharek704: raises 300 to 600
AyrtonAA95: folds 
dimYLiaK: folds 
jcarlos.vale: folds 
ErickSayajin: calls 300
*** FLOP *** [Ah 9s 7d]
ErickSayajin: bets 738
clonharek704: folds 
Uncalled bet (738) returned to ErickSayajin
ErickSayajin collected 1475 from pot
ErickSayajin: doesn't show hand 
*** SUMMARY ***
Total pot 1475 | Rake 0 
Board [Ah 9s 7d]
Seat 3: dimYLiaK (button) folded before Flop (didn't bet)
Seat 5: jcarlos.vale (small blind) folded before Flop
Seat 6: ErickSayajin (big blind) collected (1475)
Seat 7: clonharek704 folded on the Flop
Seat 8: AyrtonAA95 folded before Flop (didn't bet)



PokerStars Hand #220860087172: Tournament #3060068759, $0.23+$0.02 USD Hold'em No Limit - Level VIII (150/300) - 2020/11/28 1:30:34 EET [2020/11/27 18:30:34 ET]
Table '3060068759 4' 9-max Seat #5 is the button
Seat 3: dimYLiaK (3197 in chips) 
Seat 5: jcarlos.vale (5536 in chips) 
Seat 6: ErickSayajin (15990 in chips) 
Seat 7: clonharek704 (3992 in chips) 
Seat 8: AyrtonAA95 (7070 in chips) 
dimYLiaK: posts the ante 25
jcarlos.vale: posts the ante 25
ErickSayajin: posts the ante 25
clonharek704: posts the ante 25
AyrtonAA95: posts the ante 25
ErickSayajin: posts small blind 150
clonharek704: posts big blind 300
*** HOLE CARDS ***
Dealt to jcarlos.vale [Kh 4d]
AyrtonAA95: folds 
dimYLiaK: folds 
jcarlos.vale: folds 
ErickSayajin: calls 150
clonharek704: checks 
*** FLOP *** [Ts 2d Tc]
ErickSayajin: checks 
clonharek704: checks 
*** TURN *** [Ts 2d Tc] [7h]
ErickSayajin: checks 
clonharek704: checks 
*** RIVER *** [Ts 2d Tc 7h] [4c]
ErickSayajin: bets 900
clonharek704: folds 
Uncalled bet (900) returned to ErickSayajin
ErickSayajin collected 725 from pot
ErickSayajin: doesn't show hand 
*** SUMMARY ***
Total pot 725 | Rake 0 
Board [Ts 2d Tc 7h 4c]
Seat 3: dimYLiaK folded before Flop (didn't bet)
Seat 5: jcarlos.vale (button) folded before Flop (didn't bet)
Seat 6: ErickSayajin (small blind) collected (725)
Seat 7: clonharek704 (big blind) folded on the River
Seat 8: AyrtonAA95 folded before Flop (didn't bet)



PokerStars Hand #220860111716: Tournament #3060068759, $0.23+$0.02 USD Hold'em No Limit - Level VIII (150/300) - 2020/11/28 1:31:14 EET [2020/11/27 18:31:14 ET]
Table '3060068759 4' 9-max Seat #6 is the button
Seat 3: dimYLiaK (3172 in chips) 
Seat 5: jcarlos.vale (5511 in chips) 
Seat 6: ErickSayajin (16390 in chips) 
Seat 7: clonharek704 (3667 in chips) 
Seat 8: AyrtonAA95 (7045 in chips) 
dimYLiaK: posts the ante 25
jcarlos.vale: posts the ante 25
ErickSayajin: posts the ante 25
clonharek704: posts the ante 25
AyrtonAA95: posts the ante 25
clonharek704: posts small blind 150
AyrtonAA95: posts big blind 300
*** HOLE CARDS ***
Dealt to jcarlos.vale [Kc 9s]
dimYLiaK: calls 300
jcarlos.vale: folds 
ErickSayajin: folds 
clonharek704: folds 
AyrtonAA95: checks 
*** FLOP *** [Ad 4h 4s]
AyrtonAA95: checks 
dimYLiaK: bets 2847 and is all-in
AyrtonAA95: folds 
Uncalled bet (2847) returned to dimYLiaK
dimYLiaK collected 875 from pot
dimYLiaK: doesn't show hand 
*** SUMMARY ***
Total pot 875 | Rake 0 
Board [Ad 4h 4s]
Seat 3: dimYLiaK collected (875)
Seat 5: jcarlos.vale folded before Flop (didn't bet)
Seat 6: ErickSayajin (button) folded before Flop (didn't bet)
Seat 7: clonharek704 (small blind) folded before Flop
Seat 8: AyrtonAA95 (big blind) folded on the Flop



PokerStars Hand #220860128953: Tournament #3060068759, $0.23+$0.02 USD Hold'em No Limit - Level VIII (150/300) - 2020/11/28 1:31:43 EET [2020/11/27 18:31:43 ET]
Table '3060068759 4' 9-max Seat #7 is the button
Seat 3: dimYLiaK (3722 in chips) 
Seat 5: jcarlos.vale (5486 in chips) 
Seat 6: ErickSayajin (16365 in chips) 
Seat 7: clonharek704 (3492 in chips) 
Seat 8: AyrtonAA95 (6720 in chips) 
dimYLiaK: posts the ante 25
jcarlos.vale: posts the ante 25
ErickSayajin: posts the ante 25
clonharek704: posts the ante 25
AyrtonAA95: posts the ante 25
AyrtonAA95: posts small blind 150
dimYLiaK: posts big blind 300
*** HOLE CARDS ***
Dealt to jcarlos.vale [Jc 6h]
jcarlos.vale: folds 
ErickSayajin: folds 
clonharek704: folds 
AyrtonAA95: raises 300 to 600
dimYLiaK: folds 
Uncalled bet (300) returned to AyrtonAA95
AyrtonAA95 collected 725 from pot
AyrtonAA95: doesn't show hand 
*** SUMMARY ***
Total pot 725 | Rake 0 
Seat 3: dimYLiaK (big blind) folded before Flop
Seat 5: jcarlos.vale folded before Flop (didn't bet)
Seat 6: ErickSayajin folded before Flop (didn't bet)
Seat 7: clonharek704 (button) folded before Flop (didn't bet)
Seat 8: AyrtonAA95 (small blind) collected (725)



PokerStars Hand #220860141692: Tournament #3060068759, $0.23+$0.02 USD Hold'em No Limit - Level VIII (150/300) - 2020/11/28 1:32:04 EET [2020/11/27 18:32:04 ET]
Table '3060068759 4' 9-max Seat #8 is the button
Seat 3: dimYLiaK (3397 in chips) 
Seat 5: jcarlos.vale (5461 in chips) 
Seat 6: ErickSayajin (16340 in chips) 
Seat 7: clonharek704 (3467 in chips) 
Seat 8: AyrtonAA95 (7120 in chips) 
dimYLiaK: posts the ante 25
jcarlos.vale: posts the ante 25
ErickSayajin: posts the ante 25
clonharek704: posts the ante 25
AyrtonAA95: posts the ante 25
dimYLiaK: posts small blind 150
jcarlos.vale: posts big blind 300
*** HOLE CARDS ***
Dealt to jcarlos.vale [2s 7c]
ErickSayajin: folds 
clonharek704: folds 
AyrtonAA95: folds 
dimYLiaK: folds 
Uncalled bet (150) returned to jcarlos.vale
jcarlos.vale collected 425 from pot
jcarlos.vale: doesn't show hand 
*** SUMMARY ***
Total pot 425 | Rake 0 
Seat 3: dimYLiaK (small blind) folded before Flop
Seat 5: jcarlos.vale (big blind) collected (425)
Seat 6: ErickSayajin folded before Flop (didn't bet)
Seat 7: clonharek704 folded before Flop (didn't bet)
Seat 8: AyrtonAA95 (button) folded before Flop (didn't bet)



PokerStars Hand #220860152466: Tournament #3060068759, $0.23+$0.02 USD Hold'em No Limit - Level VIII (150/300) - 2020/11/28 1:32:22 EET [2020/11/27 18:32:22 ET]
Table '3060068759 4' 9-max Seat #3 is the button
Seat 3: dimYLiaK (3222 in chips) 
Seat 5: jcarlos.vale (5711 in chips) 
Seat 6: ErickSayajin (16315 in chips) 
Seat 7: clonharek704 (3442 in chips) 
Seat 8: AyrtonAA95 (7095 in chips) 
dimYLiaK: posts the ante 25
jcarlos.vale: posts the ante 25
ErickSayajin: posts the ante 25
clonharek704: posts the ante 25
AyrtonAA95: posts the ante 25
jcarlos.vale: posts small blind 150
ErickSayajin: posts big blind 300
*** HOLE CARDS ***
Dealt to jcarlos.vale [As Kc]
clonharek704: folds 
AyrtonAA95: folds 
dimYLiaK: folds 
jcarlos.vale: raises 5386 to 5686 and is all-in
ErickSayajin: folds 
Uncalled bet (5386) returned to jcarlos.vale
jcarlos.vale collected 725 from pot
jcarlos.vale: doesn't show hand 
*** SUMMARY ***
Total pot 725 | Rake 0 
Seat 3: dimYLiaK (button) folded before Flop (didn't bet)
Seat 5: jcarlos.vale (small blind) collected (725)
Seat 6: ErickSayajin (big blind) folded before Flop
Seat 7: clonharek704 folded before Flop (didn't bet)
Seat 8: AyrtonAA95 folded before Flop (didn't bet)



PokerStars Hand #220860170185: Tournament #3060068759, $0.23+$0.02 USD Hold'em No Limit - Level VIII (150/300) - 2020/11/28 1:32:51 EET [2020/11/27 18:32:51 ET]
Table '3060068759 4' 9-max Seat #5 is the button
Seat 3: dimYLiaK (3197 in chips) 
Seat 5: jcarlos.vale (6111 in chips) 
Seat 6: ErickSayajin (15990 in chips) 
Seat 7: clonharek704 (3417 in chips) 
Seat 8: AyrtonAA95 (7070 in chips) 
dimYLiaK: posts the ante 25
jcarlos.vale: posts the ante 25
ErickSayajin: posts the ante 25
clonharek704: posts the ante 25
AyrtonAA95: posts the ante 25
ErickSayajin: posts small blind 150
clonharek704: posts big blind 300
*** HOLE CARDS ***
Dealt to jcarlos.vale [3s 6d]
AyrtonAA95: raises 300 to 600
dimYLiaK: calls 600
jcarlos.vale: folds 
ErickSayajin: folds 
clonharek704: folds 
*** FLOP *** [Kh Td 4h]
AyrtonAA95: bets 586
dimYLiaK: raises 1986 to 2572 and is all-in
AyrtonAA95: calls 1986
*** TURN *** [Kh Td 4h] [4c]
*** RIVER *** [Kh Td 4h 4c] [3d]
*** SHOW DOWN ***
AyrtonAA95: shows [Ah Kd] (two pair, Kings and Fours)
dimYLiaK: shows [As Tc] (two pair, Tens and Fours)
AyrtonAA95 collected 6919 from pot
dimYLiaK finished the tournament in 10th place
*** SUMMARY ***
Total pot 6919 | Rake 0 
Board [Kh Td 4h 4c 3d]
Seat 3: dimYLiaK showed [As Tc] and lost with two pair, Tens and Fours
Seat 5: jcarlos.vale (button) folded before Flop (didn't bet)
Seat 6: ErickSayajin (small blind) folded before Flop
Seat 7: clonharek704 (big blind) folded before Flop
Seat 8: AyrtonAA95 showed [Ah Kd] and won (6919) with two pair, Kings and Fours



PokerStars Hand #220860204459: Tournament #3060068759, $0.23+$0.02 USD Hold'em No Limit - Level VIII (150/300) - 2020/11/28 1:33:48 EET [2020/11/27 18:33:48 ET]
Table '3060068759 5' 9-max Seat #3 is the button
Seat 1: clonharek704 (3092 in chips) 
Seat 2: ErickSayajin (15815 in chips) 
Seat 3: pfeife121 (16982 in chips) 
Seat 4: tschepetoo (2642 in chips) 
Seat 5: RapHood (4785 in chips) 
Seat 6: Ingekek (3888 in chips) 
Seat 7: jcarlos.vale (6086 in chips) 
Seat 8: JokerTonyT (3418 in chips) 
Seat 9: AyrtonAA95 (10792 in chips) 
clonharek704: posts the ante 25
ErickSayajin: posts the ante 25
pfeife121: posts the ante 25
tschepetoo: posts the ante 25
RapHood: posts the ante 25
Ingekek: posts the ante 25
jcarlos.vale: posts the ante 25
JokerTonyT: posts the ante 25
AyrtonAA95: posts the ante 25
tschepetoo: posts small blind 150
RapHood: posts big blind 300
*** HOLE CARDS ***
Dealt to jcarlos.vale [Tc 8s]
Ingekek: folds 
jcarlos.vale: folds 
JokerTonyT: folds 
AyrtonAA95: folds 
clonharek704: folds 
ErickSayajin: calls 300
pfeife121: calls 300
tschepetoo: folds 
RapHood: checks 
*** FLOP *** [Ts 9s Qh]
RapHood: checks 
ErickSayajin: checks 
pfeife121: bets 300
RapHood: folds 
ErickSayajin: raises 300 to 600
pfeife121: raises 16057 to 16657 and is all-in
ErickSayajin: folds 
Uncalled bet (16057) returned to pfeife121
pfeife121 collected 2475 from pot
pfeife121: doesn't show hand 
*** SUMMARY ***
Total pot 2475 | Rake 0 
Board [Ts 9s Qh]
Seat 1: clonharek704 folded before Flop (didn't bet)
Seat 2: ErickSayajin folded on the Flop
Seat 3: pfeife121 (button) collected (2475)
Seat 4: tschepetoo (small blind) folded before Flop
Seat 5: RapHood (big blind) folded on the Flop
Seat 6: Ingekek folded before Flop (didn't bet)
Seat 7: jcarlos.vale folded before Flop (didn't bet)
Seat 8: JokerTonyT folded before Flop (didn't bet)
Seat 9: AyrtonAA95 folded before Flop (didn't bet)



PokerStars Hand #220860302190: Tournament #3060068759, $0.23+$0.02 USD Hold'em No Limit - Level IX (200/400) - 2020/11/28 1:36:22 EET [2020/11/27 18:36:22 ET]
Table '3060068759 5' 9-max Seat #4 is the button
Seat 1: clonharek704 (3067 in chips) 
Seat 2: ErickSayajin (14890 in chips) 
Seat 3: pfeife121 (18532 in chips) 
Seat 4: tschepetoo (2467 in chips) 
Seat 5: RapHood (4460 in chips) 
Seat 6: Ingekek (3863 in chips) 
Seat 7: jcarlos.vale (6061 in chips) 
Seat 8: JokerTonyT (3393 in chips) 
Seat 9: AyrtonAA95 (10767 in chips) 
clonharek704: posts the ante 25
ErickSayajin: posts the ante 25
pfeife121: posts the ante 25
tschepetoo: posts the ante 25
RapHood: posts the ante 25
Ingekek: posts the ante 25
jcarlos.vale: posts the ante 25
JokerTonyT: posts the ante 25
AyrtonAA95: posts the ante 25
RapHood: posts small blind 200
Ingekek: posts big blind 400
*** HOLE CARDS ***
Dealt to jcarlos.vale [Jh 3c]
jcarlos.vale: folds 
JokerTonyT: folds 
AyrtonAA95: folds 
clonharek704: folds 
ErickSayajin: folds 
pfeife121: folds 
tschepetoo: raises 2042 to 2442 and is all-in
RapHood: folds 
Ingekek: folds 
Uncalled bet (2042) returned to tschepetoo
tschepetoo collected 1225 from pot
*** SUMMARY ***
Total pot 1225 | Rake 0 
Seat 1: clonharek704 folded before Flop (didn't bet)
Seat 2: ErickSayajin folded before Flop (didn't bet)
Seat 3: pfeife121 folded before Flop (didn't bet)
Seat 4: tschepetoo (button) collected (1225)
Seat 5: RapHood (small blind) folded before Flop
Seat 6: Ingekek (big blind) folded before Flop
Seat 7: jcarlos.vale folded before Flop (didn't bet)
Seat 8: JokerTonyT folded before Flop (didn't bet)
Seat 9: AyrtonAA95 folded before Flop (didn't bet)



PokerStars Hand #220860323769: Tournament #3060068759, $0.23+$0.02 USD Hold'em No Limit - Level IX (200/400) - 2020/11/28 1:36:58 EET [2020/11/27 18:36:58 ET]
Table '3060068759 5' 9-max Seat #5 is the button
Seat 1: clonharek704 (3042 in chips) 
Seat 2: ErickSayajin (14865 in chips) 
Seat 3: pfeife121 (18507 in chips) 
Seat 4: tschepetoo (3267 in chips) 
Seat 5: RapHood (4235 in chips) 
Seat 6: Ingekek (3438 in chips) 
Seat 7: jcarlos.vale (6036 in chips) 
Seat 8: JokerTonyT (3368 in chips) 
Seat 9: AyrtonAA95 (10742 in chips) 
clonharek704: posts the ante 25
ErickSayajin: posts the ante 25
pfeife121: posts the ante 25
tschepetoo: posts the ante 25
RapHood: posts the ante 25
Ingekek: posts the ante 25
jcarlos.vale: posts the ante 25
JokerTonyT: posts the ante 25
AyrtonAA95: posts the ante 25
Ingekek: posts small blind 200
jcarlos.vale: posts big blind 400
*** HOLE CARDS ***
Dealt to jcarlos.vale [Qc 4c]
JokerTonyT: folds 
AyrtonAA95: folds 
clonharek704: folds 
ErickSayajin: folds 
pfeife121: raises 800 to 1200
tschepetoo: folds 
RapHood: folds 
Ingekek: folds 
jcarlos.vale: folds 
Uncalled bet (800) returned to pfeife121
pfeife121 collected 1225 from pot
pfeife121: doesn't show hand 
*** SUMMARY ***
Total pot 1225 | Rake 0 
Seat 1: clonharek704 folded before Flop (didn't bet)
Seat 2: ErickSayajin folded before Flop (didn't bet)
Seat 3: pfeife121 collected (1225)
Seat 4: tschepetoo folded before Flop (didn't bet)
Seat 5: RapHood (button) folded before Flop (didn't bet)
Seat 6: Ingekek (small blind) folded before Flop
Seat 7: jcarlos.vale (big blind) folded before Flop
Seat 8: JokerTonyT folded before Flop (didn't bet)
Seat 9: AyrtonAA95 folded before Flop (didn't bet)



PokerStars Hand #220860346108: Tournament #3060068759, $0.23+$0.02 USD Hold'em No Limit - Level IX (200/400) - 2020/11/28 1:37:36 EET [2020/11/27 18:37:36 ET]
Table '3060068759 5' 9-max Seat #6 is the button
Seat 1: clonharek704 (3017 in chips) 
Seat 2: ErickSayajin (14840 in chips) 
Seat 3: pfeife121 (19307 in chips) 
Seat 4: tschepetoo (3242 in chips) 
Seat 5: RapHood (4210 in chips) 
Seat 6: Ingekek (3213 in chips) 
Seat 7: jcarlos.vale (5611 in chips) 
Seat 8: JokerTonyT (3343 in chips) 
Seat 9: AyrtonAA95 (10717 in chips) 
clonharek704: posts the ante 25
ErickSayajin: posts the ante 25
pfeife121: posts the ante 25
tschepetoo: posts the ante 25
RapHood: posts the ante 25
Ingekek: posts the ante 25
jcarlos.vale: posts the ante 25
JokerTonyT: posts the ante 25
AyrtonAA95: posts the ante 25
jcarlos.vale: posts small blind 200
JokerTonyT: posts big blind 400
*** HOLE CARDS ***
Dealt to jcarlos.vale [7c Tc]
AyrtonAA95: folds 
clonharek704: folds 
ErickSayajin: folds 
pfeife121: folds 
tschepetoo: raises 2817 to 3217 and is all-in
RapHood: folds 
Ingekek: folds 
jcarlos.vale: folds 
JokerTonyT: folds 
Uncalled bet (2817) returned to tschepetoo
tschepetoo collected 1225 from pot
*** SUMMARY ***
Total pot 1225 | Rake 0 
Seat 1: clonharek704 folded before Flop (didn't bet)
Seat 2: ErickSayajin folded before Flop (didn't bet)
Seat 3: pfeife121 folded before Flop (didn't bet)
Seat 4: tschepetoo collected (1225)
Seat 5: RapHood folded before Flop (didn't bet)
Seat 6: Ingekek (button) folded before Flop (didn't bet)
Seat 7: jcarlos.vale (small blind) folded before Flop
Seat 8: JokerTonyT (big blind) folded before Flop
Seat 9: AyrtonAA95 folded before Flop (didn't bet)



PokerStars Hand #220860381910: Tournament #3060068759, $0.23+$0.02 USD Hold'em No Limit - Level IX (200/400) - 2020/11/28 1:38:36 EET [2020/11/27 18:38:36 ET]
Table '3060068759 5' 9-max Seat #7 is the button
Seat 1: clonharek704 (2992 in chips) 
Seat 2: ErickSayajin (14815 in chips) 
Seat 3: pfeife121 (19282 in chips) 
Seat 4: tschepetoo (4042 in chips) 
Seat 5: RapHood (4185 in chips) 
Seat 6: Ingekek (3188 in chips) 
Seat 7: jcarlos.vale (5386 in chips) 
Seat 8: JokerTonyT (2918 in chips) 
Seat 9: AyrtonAA95 (10692 in chips) 
clonharek704: posts the ante 25
ErickSayajin: posts the ante 25
pfeife121: posts the ante 25
tschepetoo: posts the ante 25
RapHood: posts the ante 25
Ingekek: posts the ante 25
jcarlos.vale: posts the ante 25
JokerTonyT: posts the ante 25
AyrtonAA95: posts the ante 25
JokerTonyT: posts small blind 200
AyrtonAA95: posts big blind 400
*** HOLE CARDS ***
Dealt to jcarlos.vale [5h 9s]
clonharek704: folds 
ErickSayajin: folds 
pfeife121: folds 
tschepetoo: folds 
RapHood: folds 
Ingekek: folds 
jcarlos.vale: folds 
JokerTonyT: raises 480 to 880
AyrtonAA95: folds 
Uncalled bet (480) returned to JokerTonyT
JokerTonyT collected 1025 from pot
JokerTonyT: doesn't show hand 
*** SUMMARY ***
Total pot 1025 | Rake 0 
Seat 1: clonharek704 folded before Flop (didn't bet)
Seat 2: ErickSayajin folded before Flop (didn't bet)
Seat 3: pfeife121 folded before Flop (didn't bet)
Seat 4: tschepetoo folded before Flop (didn't bet)
Seat 5: RapHood folded before Flop (didn't bet)
Seat 6: Ingekek folded before Flop (didn't bet)
Seat 7: jcarlos.vale (button) folded before Flop (didn't bet)
Seat 8: JokerTonyT (small blind) collected (1025)
Seat 9: AyrtonAA95 (big blind) folded before Flop



PokerStars Hand #220860406968: Tournament #3060068759, $0.23+$0.02 USD Hold'em No Limit - Level IX (200/400) - 2020/11/28 1:39:19 EET [2020/11/27 18:39:19 ET]
Table '3060068759 5' 9-max Seat #8 is the button
Seat 1: clonharek704 (2967 in chips) 
Seat 2: ErickSayajin (14790 in chips) 
Seat 3: pfeife121 (19257 in chips) 
Seat 4: tschepetoo (4017 in chips) 
Seat 5: RapHood (4160 in chips) 
Seat 6: Ingekek (3163 in chips) 
Seat 7: jcarlos.vale (5361 in chips) 
Seat 8: JokerTonyT (3518 in chips) 
Seat 9: AyrtonAA95 (10267 in chips) 
clonharek704: posts the ante 25
ErickSayajin: posts the ante 25
pfeife121: posts the ante 25
tschepetoo: posts the ante 25
RapHood: posts the ante 25
Ingekek: posts the ante 25
jcarlos.vale: posts the ante 25
JokerTonyT: posts the ante 25
AyrtonAA95: posts the ante 25
AyrtonAA95: posts small blind 200
clonharek704: posts big blind 400
*** HOLE CARDS ***
Dealt to jcarlos.vale [Jd Kd]
ErickSayajin: folds 
pfeife121: raises 400 to 800
tschepetoo: folds 
RapHood: folds 
Ingekek: folds 
jcarlos.vale: raises 4536 to 5336 and is all-in
JokerTonyT: folds 
AyrtonAA95: folds 
clonharek704: folds 
pfeife121: folds 
Uncalled bet (4536) returned to jcarlos.vale
jcarlos.vale collected 2425 from pot
jcarlos.vale: doesn't show hand 
*** SUMMARY ***
Total pot 2425 | Rake 0 
Seat 1: clonharek704 (big blind) folded before Flop
Seat 2: ErickSayajin folded before Flop (didn't bet)
Seat 3: pfeife121 folded before Flop
Seat 4: tschepetoo folded before Flop (didn't bet)
Seat 5: RapHood folded before Flop (didn't bet)
Seat 6: Ingekek folded before Flop (didn't bet)
Seat 7: jcarlos.vale collected (2425)
Seat 8: JokerTonyT (button) folded before Flop (didn't bet)
Seat 9: AyrtonAA95 (small blind) folded before Flop



PokerStars Hand #220860433864: Tournament #3060068759, $0.23+$0.02 USD Hold'em No Limit - Level IX (200/400) - 2020/11/28 1:40:05 EET [2020/11/27 18:40:05 ET]
Table '3060068759 5' 9-max Seat #9 is the button
Seat 1: clonharek704 (2542 in chips) 
Seat 2: ErickSayajin (14765 in chips) 
Seat 3: pfeife121 (18432 in chips) 
Seat 4: tschepetoo (3992 in chips) 
Seat 5: RapHood (4135 in chips) 
Seat 6: Ingekek (3138 in chips) 
Seat 7: jcarlos.vale (6961 in chips) 
Seat 8: JokerTonyT (3493 in chips) 
Seat 9: AyrtonAA95 (10042 in chips) 
clonharek704: posts the ante 25
ErickSayajin: posts the ante 25
pfeife121: posts the ante 25
tschepetoo: posts the ante 25
RapHood: posts the ante 25
Ingekek: posts the ante 25
jcarlos.vale: posts the ante 25
JokerTonyT: posts the ante 25
AyrtonAA95: posts the ante 25
clonharek704: posts small blind 200
ErickSayajin: posts big blind 400
*** HOLE CARDS ***
Dealt to jcarlos.vale [Ac 7s]
pfeife121: folds 
tschepetoo: folds 
RapHood: folds 
Ingekek: folds 
jcarlos.vale: folds 
JokerTonyT: folds 
AyrtonAA95: folds 
clonharek704: raises 2117 to 2517 and is all-in
ErickSayajin: calls 2117
*** FLOP *** [3d 8d As]
*** TURN *** [3d 8d As] [Kc]
*** RIVER *** [3d 8d As Kc] [Qs]
*** SHOW DOWN ***
clonharek704: shows [Qh Ah] (two pair, Aces and Queens)
ErickSayajin: shows [Ad 2c] (a pair of Aces)
clonharek704 collected 5259 from pot
*** SUMMARY ***
Total pot 5259 | Rake 0 
Board [3d 8d As Kc Qs]
Seat 1: clonharek704 (small blind) showed [Qh Ah] and won (5259) with two pair, Aces and Queens
Seat 2: ErickSayajin (big blind) showed [Ad 2c] and lost with a pair of Aces
Seat 3: pfeife121 folded before Flop (didn't bet)
Seat 4: tschepetoo folded before Flop (didn't bet)
Seat 5: RapHood folded before Flop (didn't bet)
Seat 6: Ingekek folded before Flop (didn't bet)
Seat 7: jcarlos.vale folded before Flop (didn't bet)
Seat 8: JokerTonyT folded before Flop (didn't bet)
Seat 9: AyrtonAA95 (button) folded before Flop (didn't bet)



PokerStars Hand #220860462089: Tournament #3060068759, $0.23+$0.02 USD Hold'em No Limit - Level IX (200/400) - 2020/11/28 1:40:54 EET [2020/11/27 18:40:54 ET]
Table '3060068759 5' 9-max Seat #1 is the button
Seat 1: clonharek704 (5259 in chips) 
Seat 2: ErickSayajin (12223 in chips) 
Seat 3: pfeife121 (18407 in chips) 
Seat 4: tschepetoo (3967 in chips) 
Seat 5: RapHood (4110 in chips) 
Seat 6: Ingekek (3113 in chips) 
Seat 7: jcarlos.vale (6936 in chips) 
Seat 8: JokerTonyT (3468 in chips) 
Seat 9: AyrtonAA95 (10017 in chips) 
clonharek704: posts the ante 25
ErickSayajin: posts the ante 25
pfeife121: posts the ante 25
tschepetoo: posts the ante 25
RapHood: posts the ante 25
Ingekek: posts the ante 25
jcarlos.vale: posts the ante 25
JokerTonyT: posts the ante 25
AyrtonAA95: posts the ante 25
ErickSayajin: posts small blind 200
pfeife121: posts big blind 400
*** HOLE CARDS ***
Dealt to jcarlos.vale [Ah Jd]
tschepetoo: folds 
RapHood: folds 
Ingekek: raises 2688 to 3088 and is all-in
jcarlos.vale: folds 
JokerTonyT: folds 
AyrtonAA95: folds 
clonharek704: folds 
ErickSayajin: folds 
pfeife121: calls 2688
*** FLOP *** [8h 8c 5h]
*** TURN *** [8h 8c 5h] [2h]
*** RIVER *** [8h 8c 5h 2h] [5c]
*** SHOW DOWN ***
pfeife121: shows [8s Qs] (a full house, Eights full of Fives)
Ingekek: shows [Qh Ks] (two pair, Eights and Fives)
pfeife121 collected 6601 from pot
Ingekek finished the tournament in 9th place
*** SUMMARY ***
Total pot 6601 | Rake 0 
Board [8h 8c 5h 2h 5c]
Seat 1: clonharek704 (button) folded before Flop (didn't bet)
Seat 2: ErickSayajin (small blind) folded before Flop
Seat 3: pfeife121 (big blind) showed [8s Qs] and won (6601) with a full house, Eights full of Fives
Seat 4: tschepetoo folded before Flop (didn't bet)
Seat 5: RapHood folded before Flop (didn't bet)
Seat 6: Ingekek showed [Qh Ks] and lost with two pair, Eights and Fives
Seat 7: jcarlos.vale folded before Flop (didn't bet)
Seat 8: JokerTonyT folded before Flop (didn't bet)
Seat 9: AyrtonAA95 folded before Flop (didn't bet)



PokerStars Hand #220860500202: Tournament #3060068759, $0.23+$0.02 USD Hold'em No Limit - Level IX (200/400) - 2020/11/28 1:42:00 EET [2020/11/27 18:42:00 ET]
Table '3060068759 5' 9-max Seat #2 is the button
Seat 1: clonharek704 (5234 in chips) 
Seat 2: ErickSayajin (11998 in chips) 
Seat 3: pfeife121 (21895 in chips) 
Seat 4: tschepetoo (3942 in chips) 
Seat 5: RapHood (4085 in chips) 
Seat 7: jcarlos.vale (6911 in chips) 
Seat 8: JokerTonyT (3443 in chips) 
Seat 9: AyrtonAA95 (9992 in chips) 
clonharek704: posts the ante 25
ErickSayajin: posts the ante 25
pfeife121: posts the ante 25
tschepetoo: posts the ante 25
RapHood: posts the ante 25
jcarlos.vale: posts the ante 25
JokerTonyT: posts the ante 25
AyrtonAA95: posts the ante 25
pfeife121: posts small blind 200
tschepetoo: posts big blind 400
*** HOLE CARDS ***
Dealt to jcarlos.vale [6h 6d]
RapHood: folds 
jcarlos.vale: raises 6486 to 6886 and is all-in
JokerTonyT: folds 
AyrtonAA95: folds 
clonharek704: folds 
ErickSayajin: folds 
pfeife121: folds 
tschepetoo: folds 
Uncalled bet (6486) returned to jcarlos.vale
jcarlos.vale collected 1200 from pot
jcarlos.vale: doesn't show hand 
*** SUMMARY ***
Total pot 1200 | Rake 0 
Seat 1: clonharek704 folded before Flop (didn't bet)
Seat 2: ErickSayajin (button) folded before Flop (didn't bet)
Seat 3: pfeife121 (small blind) folded before Flop
Seat 4: tschepetoo (big blind) folded before Flop
Seat 5: RapHood folded before Flop (didn't bet)
Seat 7: jcarlos.vale collected (1200)
Seat 8: JokerTonyT folded before Flop (didn't bet)
Seat 9: AyrtonAA95 folded before Flop (didn't bet)



PokerStars Hand #220860533625: Tournament #3060068759, $0.23+$0.02 USD Hold'em No Limit - Level IX (200/400) - 2020/11/28 1:42:49 EET [2020/11/27 18:42:49 ET]
Table '3060068759 5' 9-max Seat #3 is the button
Seat 1: clonharek704 (5209 in chips) 
Seat 2: ErickSayajin (11973 in chips) 
Seat 3: pfeife121 (21670 in chips) 
Seat 4: tschepetoo (3517 in chips) 
Seat 5: RapHood (4060 in chips) 
Seat 7: jcarlos.vale (7686 in chips) 
Seat 8: JokerTonyT (3418 in chips) 
Seat 9: AyrtonAA95 (9967 in chips) 
clonharek704: posts the ante 25
ErickSayajin: posts the ante 25
pfeife121: posts the ante 25
tschepetoo: posts the ante 25
RapHood: posts the ante 25
jcarlos.vale: posts the ante 25
JokerTonyT: posts the ante 25
AyrtonAA95: posts the ante 25
tschepetoo: posts small blind 200
RapHood: posts big blind 400
*** HOLE CARDS ***
Dealt to jcarlos.vale [Jd Ts]
jcarlos.vale: folds 
JokerTonyT: folds 
AyrtonAA95: folds 
clonharek704: folds 
ErickSayajin: folds 
pfeife121: folds 
tschepetoo: raises 3092 to 3492 and is all-in
RapHood has timed out
RapHood: folds 
RapHood is sitting out
Uncalled bet (3092) returned to tschepetoo
tschepetoo collected 1000 from pot
RapHood has returned
*** SUMMARY ***
Total pot 1000 | Rake 0 
Seat 1: clonharek704 folded before Flop (didn't bet)
Seat 2: ErickSayajin folded before Flop (didn't bet)
Seat 3: pfeife121 (button) folded before Flop (didn't bet)
Seat 4: tschepetoo (small blind) collected (1000)
Seat 5: RapHood (big blind) folded before Flop
Seat 7: jcarlos.vale folded before Flop (didn't bet)
Seat 8: JokerTonyT folded before Flop (didn't bet)
Seat 9: AyrtonAA95 folded before Flop (didn't bet)



PokerStars Hand #220860572842: Tournament #3060068759, $0.23+$0.02 USD Hold'em No Limit - Level IX (200/400) - 2020/11/28 1:43:57 EET [2020/11/27 18:43:57 ET]
Table '3060068759 5' 9-max Seat #4 is the button
Seat 1: clonharek704 (5184 in chips) 
Seat 2: ErickSayajin (11948 in chips) 
Seat 3: pfeife121 (21645 in chips) 
Seat 4: tschepetoo (4092 in chips) 
Seat 5: RapHood (3635 in chips) 
Seat 7: jcarlos.vale (7661 in chips) 
Seat 8: JokerTonyT (3393 in chips) 
Seat 9: AyrtonAA95 (9942 in chips) 
clonharek704: posts the ante 25
ErickSayajin: posts the ante 25
pfeife121: posts the ante 25
tschepetoo: posts the ante 25
RapHood: posts the ante 25
jcarlos.vale: posts the ante 25
JokerTonyT: posts the ante 25
AyrtonAA95: posts the ante 25
RapHood: posts small blind 200
jcarlos.vale: posts big blind 400
*** HOLE CARDS ***
Dealt to jcarlos.vale [9d 5d]
JokerTonyT: raises 2968 to 3368 and is all-in
AyrtonAA95: folds 
clonharek704: folds 
ErickSayajin: folds 
pfeife121: folds 
tschepetoo: folds 
RapHood has timed out
RapHood: folds 
RapHood is sitting out
jcarlos.vale: folds 
Uncalled bet (2968) returned to JokerTonyT
JokerTonyT collected 1200 from pot
JokerTonyT: doesn't show hand 
RapHood has returned
*** SUMMARY ***
Total pot 1200 | Rake 0 
Seat 1: clonharek704 folded before Flop (didn't bet)
Seat 2: ErickSayajin folded before Flop (didn't bet)
Seat 3: pfeife121 folded before Flop (didn't bet)
Seat 4: tschepetoo (button) folded before Flop (didn't bet)
Seat 5: RapHood (small blind) folded before Flop
Seat 7: jcarlos.vale (big blind) folded before Flop
Seat 8: JokerTonyT collected (1200)
Seat 9: AyrtonAA95 folded before Flop (didn't bet)



PokerStars Hand #220860610473: Tournament #3060068759, $0.23+$0.02 USD Hold'em No Limit - Level X (300/600) - 2020/11/28 1:45:03 EET [2020/11/27 18:45:03 ET]
Table '3060068759 5' 9-max Seat #5 is the button
Seat 1: clonharek704 (5159 in chips) 
Seat 2: ErickSayajin (11923 in chips) 
Seat 3: pfeife121 (21620 in chips) 
Seat 4: tschepetoo (4067 in chips) 
Seat 5: RapHood (3410 in chips) 
Seat 7: jcarlos.vale (7236 in chips) 
Seat 8: JokerTonyT (4168 in chips) 
Seat 9: AyrtonAA95 (9917 in chips) 
clonharek704: posts the ante 50
ErickSayajin: posts the ante 50
pfeife121: posts the ante 50
tschepetoo: posts the ante 50
RapHood: posts the ante 50
jcarlos.vale: posts the ante 50
JokerTonyT: posts the ante 50
AyrtonAA95: posts the ante 50
jcarlos.vale: posts small blind 300
JokerTonyT: posts big blind 600
*** HOLE CARDS ***
Dealt to jcarlos.vale [9c Qh]
AyrtonAA95: folds 
clonharek704: folds 
ErickSayajin: folds 
pfeife121: raises 1200 to 1800
tschepetoo: folds 
RapHood: folds 
jcarlos.vale: folds 
JokerTonyT: folds 
Uncalled bet (1200) returned to pfeife121
pfeife121 collected 1900 from pot
pfeife121: doesn't show hand 
*** SUMMARY ***
Total pot 1900 | Rake 0 
Seat 1: clonharek704 folded before Flop (didn't bet)
Seat 2: ErickSayajin folded before Flop (didn't bet)
Seat 3: pfeife121 collected (1900)
Seat 4: tschepetoo folded before Flop (didn't bet)
Seat 5: RapHood (button) folded before Flop (didn't bet)
Seat 7: jcarlos.vale (small blind) folded before Flop
Seat 8: JokerTonyT (big blind) folded before Flop
Seat 9: AyrtonAA95 folded before Flop (didn't bet)



PokerStars Hand #220860622833: Tournament #3060068759, $0.23+$0.02 USD Hold'em No Limit - Level X (300/600) - 2020/11/28 1:45:24 EET [2020/11/27 18:45:24 ET]
Table '3060068759 5' 9-max Seat #7 is the button
Seat 1: clonharek704 (5109 in chips) 
Seat 2: ErickSayajin (11873 in chips) 
Seat 3: pfeife121 (22870 in chips) 
Seat 4: tschepetoo (4017 in chips) 
Seat 5: RapHood (3360 in chips) 
Seat 7: jcarlos.vale (6886 in chips) 
Seat 8: JokerTonyT (3518 in chips) 
Seat 9: AyrtonAA95 (9867 in chips) 
clonharek704: posts the ante 50
ErickSayajin: posts the ante 50
pfeife121: posts the ante 50
tschepetoo: posts the ante 50
RapHood: posts the ante 50
jcarlos.vale: posts the ante 50
JokerTonyT: posts the ante 50
AyrtonAA95: posts the ante 50
JokerTonyT: posts small blind 300
AyrtonAA95: posts big blind 600
*** HOLE CARDS ***
Dealt to jcarlos.vale [5s Jh]
clonharek704: folds 
ErickSayajin: folds 
pfeife121: folds 
tschepetoo: folds 
RapHood: folds 
jcarlos.vale: folds 
JokerTonyT: raises 2868 to 3468 and is all-in
AyrtonAA95: folds 
Uncalled bet (2868) returned to JokerTonyT
JokerTonyT collected 1600 from pot
JokerTonyT: doesn't show hand 
*** SUMMARY ***
Total pot 1600 | Rake 0 
Seat 1: clonharek704 folded before Flop (didn't bet)
Seat 2: ErickSayajin folded before Flop (didn't bet)
Seat 3: pfeife121 folded before Flop (didn't bet)
Seat 4: tschepetoo folded before Flop (didn't bet)
Seat 5: RapHood folded before Flop (didn't bet)
Seat 7: jcarlos.vale (button) folded before Flop (didn't bet)
Seat 8: JokerTonyT (small blind) collected (1600)
Seat 9: AyrtonAA95 (big blind) folded before Flop



PokerStars Hand #220860645375: Tournament #3060068759, $0.23+$0.02 USD Hold'em No Limit - Level X (300/600) - 2020/11/28 1:46:04 EET [2020/11/27 18:46:04 ET]
Table '3060068759 5' 9-max Seat #8 is the button
Seat 1: clonharek704 (5059 in chips) 
Seat 2: ErickSayajin (11823 in chips) 
Seat 3: pfeife121 (22820 in chips) 
Seat 4: tschepetoo (3967 in chips) 
Seat 5: RapHood (3310 in chips) 
Seat 7: jcarlos.vale (6836 in chips) 
Seat 8: JokerTonyT (4468 in chips) 
Seat 9: AyrtonAA95 (9217 in chips) 
clonharek704: posts the ante 50
ErickSayajin: posts the ante 50
pfeife121: posts the ante 50
tschepetoo: posts the ante 50
RapHood: posts the ante 50
jcarlos.vale: posts the ante 50
JokerTonyT: posts the ante 50
AyrtonAA95: posts the ante 50
AyrtonAA95: posts small blind 300
clonharek704: posts big blind 600
*** HOLE CARDS ***
Dealt to jcarlos.vale [6s 8c]
ErickSayajin: folds 
pfeife121: folds 
tschepetoo: folds 
RapHood: folds 
jcarlos.vale: folds 
JokerTonyT: folds 
AyrtonAA95: raises 8567 to 9167 and is all-in
clonharek704: folds [3s 3d]
Uncalled bet (8567) returned to AyrtonAA95
AyrtonAA95 collected 1600 from pot
AyrtonAA95: doesn't show hand 
*** SUMMARY ***
Total pot 1600 | Rake 0 
Seat 1: clonharek704 (big blind) folded before Flop
Seat 2: ErickSayajin folded before Flop (didn't bet)
Seat 3: pfeife121 folded before Flop (didn't bet)
Seat 4: tschepetoo folded before Flop (didn't bet)
Seat 5: RapHood folded before Flop (didn't bet)
Seat 7: jcarlos.vale folded before Flop (didn't bet)
Seat 8: JokerTonyT (button) folded before Flop (didn't bet)
Seat 9: AyrtonAA95 (small blind) collected (1600)



PokerStars Hand #220860672599: Tournament #3060068759, $0.23+$0.02 USD Hold'em No Limit - Level X (300/600) - 2020/11/28 1:46:51 EET [2020/11/27 18:46:51 ET]
Table '3060068759 5' 9-max Seat #9 is the button
Seat 1: clonharek704 (4409 in chips) 
Seat 2: ErickSayajin (11773 in chips) 
Seat 3: pfeife121 (22770 in chips) 
Seat 4: tschepetoo (3917 in chips) 
Seat 5: RapHood (3260 in chips) 
Seat 7: jcarlos.vale (6786 in chips) 
Seat 8: JokerTonyT (4418 in chips) 
Seat 9: AyrtonAA95 (10167 in chips) 
clonharek704: posts the ante 50
ErickSayajin: posts the ante 50
pfeife121: posts the ante 50
tschepetoo: posts the ante 50
RapHood: posts the ante 50
jcarlos.vale: posts the ante 50
JokerTonyT: posts the ante 50
AyrtonAA95: posts the ante 50
clonharek704: posts small blind 300
ErickSayajin: posts big blind 600
*** HOLE CARDS ***
Dealt to jcarlos.vale [3c 8h]
pfeife121: folds 
tschepetoo: folds 
RapHood: folds 
jcarlos.vale: folds 
JokerTonyT: raises 3768 to 4368 and is all-in
AyrtonAA95: folds 
clonharek704: folds 
ErickSayajin: calls 3768
*** FLOP *** [Jc 7d Ks]
*** TURN *** [Jc 7d Ks] [3d]
*** RIVER *** [Jc 7d Ks 3d] [Ah]
*** SHOW DOWN ***
ErickSayajin: shows [9c 9h] (a pair of Nines)
JokerTonyT: shows [5c 5h] (a pair of Fives)
ErickSayajin collected 9436 from pot
JokerTonyT finished the tournament in 8th place
*** SUMMARY ***
Total pot 9436 | Rake 0 
Board [Jc 7d Ks 3d Ah]
Seat 1: clonharek704 (small blind) folded before Flop
Seat 2: ErickSayajin (big blind) showed [9c 9h] and won (9436) with a pair of Nines
Seat 3: pfeife121 folded before Flop (didn't bet)
Seat 4: tschepetoo folded before Flop (didn't bet)
Seat 5: RapHood folded before Flop (didn't bet)
Seat 7: jcarlos.vale folded before Flop (didn't bet)
Seat 8: JokerTonyT showed [5c 5h] and lost with a pair of Fives
Seat 9: AyrtonAA95 (button) folded before Flop (didn't bet)



PokerStars Hand #220860727093: Tournament #3060068759, $0.23+$0.02 USD Hold'em No Limit - Level X (300/600) - 2020/11/28 1:48:25 EET [2020/11/27 18:48:25 ET]
Table '3060068759 5' 9-max Seat #1 is the button
Seat 1: clonharek704 (4059 in chips) 
Seat 2: ErickSayajin (16791 in chips) 
Seat 3: pfeife121 (22720 in chips) 
Seat 4: tschepetoo (3867 in chips) 
Seat 5: RapHood (3210 in chips) 
Seat 7: jcarlos.vale (6736 in chips) 
Seat 9: AyrtonAA95 (10117 in chips) 
clonharek704: posts the ante 50
ErickSayajin: posts the ante 50
pfeife121: posts the ante 50
tschepetoo: posts the ante 50
RapHood: posts the ante 50
jcarlos.vale: posts the ante 50
AyrtonAA95: posts the ante 50
ErickSayajin: posts small blind 300
pfeife121: posts big blind 600
*** HOLE CARDS ***
Dealt to jcarlos.vale [Tc Kd]
tschepetoo: folds 
RapHood: folds 
jcarlos.vale: folds 
AyrtonAA95: folds 
clonharek704: folds 
ErickSayajin: calls 300
pfeife121: raises 1800 to 2400
ErickSayajin: calls 1800
*** FLOP *** [8d 8c Qd]
ErickSayajin: checks 
pfeife121: bets 20270 and is all-in
ErickSayajin: folds 
Uncalled bet (20270) returned to pfeife121
pfeife121 collected 5150 from pot
pfeife121: doesn't show hand 
*** SUMMARY ***
Total pot 5150 | Rake 0 
Board [8d 8c Qd]
Seat 1: clonharek704 (button) folded before Flop (didn't bet)
Seat 2: ErickSayajin (small blind) folded on the Flop
Seat 3: pfeife121 (big blind) collected (5150)
Seat 4: tschepetoo folded before Flop (didn't bet)
Seat 5: RapHood folded before Flop (didn't bet)
Seat 7: jcarlos.vale folded before Flop (didn't bet)
Seat 9: AyrtonAA95 folded before Flop (didn't bet)



PokerStars Hand #220860763567: Tournament #3060068759, $0.23+$0.02 USD Hold'em No Limit - Level X (300/600) - 2020/11/28 1:49:29 EET [2020/11/27 18:49:29 ET]
Table '3060068759 5' 9-max Seat #2 is the button
Seat 1: clonharek704 (4009 in chips) 
Seat 2: ErickSayajin (14341 in chips) 
Seat 3: pfeife121 (25420 in chips) 
Seat 4: tschepetoo (3817 in chips) 
Seat 5: RapHood (3160 in chips) 
Seat 7: jcarlos.vale (6686 in chips) 
Seat 9: AyrtonAA95 (10067 in chips) 
clonharek704: posts the ante 50
ErickSayajin: posts the ante 50
pfeife121: posts the ante 50
tschepetoo: posts the ante 50
RapHood: posts the ante 50
jcarlos.vale: posts the ante 50
AyrtonAA95: posts the ante 50
pfeife121: posts small blind 300
tschepetoo: posts big blind 600
*** HOLE CARDS ***
Dealt to jcarlos.vale [Th 8c]
RapHood: folds 
jcarlos.vale: folds 
AyrtonAA95: folds 
clonharek704: folds 
ErickSayajin: folds 
pfeife121: calls 300
tschepetoo: checks 
*** FLOP *** [Qd Ts Kh]
pfeife121: bets 1550
tschepetoo: folds 
Uncalled bet (1550) returned to pfeife121
pfeife121 collected 1550 from pot
pfeife121: doesn't show hand 
*** SUMMARY ***
Total pot 1550 | Rake 0 
Board [Qd Ts Kh]
Seat 1: clonharek704 folded before Flop (didn't bet)
Seat 2: ErickSayajin (button) folded before Flop (didn't bet)
Seat 3: pfeife121 (small blind) collected (1550)
Seat 4: tschepetoo (big blind) folded on the Flop
Seat 5: RapHood folded before Flop (didn't bet)
Seat 7: jcarlos.vale folded before Flop (didn't bet)
Seat 9: AyrtonAA95 folded before Flop (didn't bet)



PokerStars Hand #220860821344: Tournament #3060068759, $0.23+$0.02 USD Hold'em No Limit - Level X (300/600) - 2020/11/28 1:50:59 EET [2020/11/27 18:50:59 ET]
Table '3060068759 5' 9-max Seat #3 is the button
Seat 1: clonharek704 (3959 in chips) 
Seat 2: ErickSayajin (14291 in chips) 
Seat 3: pfeife121 (26320 in chips) 
Seat 4: tschepetoo (3167 in chips) 
Seat 5: RapHood (3110 in chips) 
Seat 7: jcarlos.vale (6636 in chips) 
Seat 9: AyrtonAA95 (10017 in chips) 
clonharek704: posts the ante 50
ErickSayajin: posts the ante 50
pfeife121: posts the ante 50
tschepetoo: posts the ante 50
RapHood: posts the ante 50
jcarlos.vale: posts the ante 50
AyrtonAA95: posts the ante 50
tschepetoo: posts small blind 300
RapHood: posts big blind 600
*** HOLE CARDS ***
Dealt to jcarlos.vale [5h Js]
jcarlos.vale: folds 
AyrtonAA95: folds 
clonharek704: raises 3309 to 3909 and is all-in
ErickSayajin: folds 
pfeife121: folds 
tschepetoo: folds 
RapHood: folds 
Uncalled bet (3309) returned to clonharek704
clonharek704 collected 1850 from pot
*** SUMMARY ***
Total pot 1850 | Rake 0 
Seat 1: clonharek704 collected (1850)
Seat 2: ErickSayajin folded before Flop (didn't bet)
Seat 3: pfeife121 (button) folded before Flop (didn't bet)
Seat 4: tschepetoo (small blind) folded before Flop
Seat 5: RapHood (big blind) folded before Flop
Seat 7: jcarlos.vale folded before Flop (didn't bet)
Seat 9: AyrtonAA95 folded before Flop (didn't bet)



PokerStars Hand #220860844703: Tournament #3060068759, $0.23+$0.02 USD Hold'em No Limit - Level X (300/600) - 2020/11/28 1:51:41 EET [2020/11/27 18:51:41 ET]
Table '3060068759 5' 9-max Seat #4 is the button
Seat 1: clonharek704 (5159 in chips) 
Seat 2: ErickSayajin (14241 in chips) 
Seat 3: pfeife121 (26270 in chips) 
Seat 4: tschepetoo (2817 in chips) 
Seat 5: RapHood (2460 in chips) 
Seat 7: jcarlos.vale (6586 in chips) 
Seat 9: AyrtonAA95 (9967 in chips) 
clonharek704: posts the ante 50
ErickSayajin: posts the ante 50
pfeife121: posts the ante 50
tschepetoo: posts the ante 50
RapHood: posts the ante 50
jcarlos.vale: posts the ante 50
AyrtonAA95: posts the ante 50
RapHood: posts small blind 300
jcarlos.vale: posts big blind 600
*** HOLE CARDS ***
Dealt to jcarlos.vale [5c Qh]
AyrtonAA95: folds 
clonharek704: folds 
ErickSayajin: folds 
pfeife121: folds 
tschepetoo: raises 1200 to 1800
RapHood: folds 
jcarlos.vale: folds 
Uncalled bet (1200) returned to tschepetoo
tschepetoo collected 1850 from pot
*** SUMMARY ***
Total pot 1850 | Rake 0 
Seat 1: clonharek704 folded before Flop (didn't bet)
Seat 2: ErickSayajin folded before Flop (didn't bet)
Seat 3: pfeife121 folded before Flop (didn't bet)
Seat 4: tschepetoo (button) collected (1850)
Seat 5: RapHood (small blind) folded before Flop
Seat 7: jcarlos.vale (big blind) folded before Flop
Seat 9: AyrtonAA95 folded before Flop (didn't bet)



PokerStars Hand #220860871772: Tournament #3060068759, $0.23+$0.02 USD Hold'em No Limit - Level X (300/600) - 2020/11/28 1:52:29 EET [2020/11/27 18:52:29 ET]
Table '3060068759 5' 9-max Seat #5 is the button
Seat 1: clonharek704 (5109 in chips) 
Seat 2: ErickSayajin (14191 in chips) 
Seat 3: pfeife121 (26220 in chips) 
Seat 4: tschepetoo (4017 in chips) 
Seat 5: RapHood (2110 in chips) 
Seat 7: jcarlos.vale (5936 in chips) 
Seat 9: AyrtonAA95 (9917 in chips) 
clonharek704: posts the ante 50
ErickSayajin: posts the ante 50
pfeife121: posts the ante 50
tschepetoo: posts the ante 50
RapHood: posts the ante 50
jcarlos.vale: posts the ante 50
AyrtonAA95: posts the ante 50
jcarlos.vale: posts small blind 300
AyrtonAA95: posts big blind 600
*** HOLE CARDS ***
Dealt to jcarlos.vale [Kd 8h]
clonharek704: folds 
ErickSayajin: raises 1200 to 1800
pfeife121: calls 1800
tschepetoo: folds 
RapHood said, "kkkkkkkkkkkk"
RapHood: raises 260 to 2060 and is all-in
jcarlos.vale: folds 
AyrtonAA95: folds 
ErickSayajin: calls 260
pfeife121: calls 260
*** FLOP *** [7c 9h 5h]
ErickSayajin: checks 
pfeife121: checks 
*** TURN *** [7c 9h 5h] [5d]
ErickSayajin: bets 1800
pfeife121: folds 
Uncalled bet (1800) returned to ErickSayajin
pfeife121 is sitting out
*** RIVER *** [7c 9h 5h 5d] [Jd]
*** SHOW DOWN ***
ErickSayajin: shows [Ad 6d] (a pair of Fives)
RapHood: shows [Tc As] (a pair of Fives - Ace+Jack+Ten kicker)
RapHood collected 7430 from pot
RapHood said, "chupa"
*** SUMMARY ***
Total pot 7430 | Rake 0 
Board [7c 9h 5h 5d Jd]
Seat 1: clonharek704 folded before Flop (didn't bet)
Seat 2: ErickSayajin showed [Ad 6d] and lost with a pair of Fives
Seat 3: pfeife121 folded on the Turn
Seat 4: tschepetoo folded before Flop (didn't bet)
Seat 5: RapHood (button) showed [Tc As] and won (7430) with a pair of Fives
Seat 7: jcarlos.vale (small blind) folded before Flop
Seat 9: AyrtonAA95 (big blind) folded before Flop



PokerStars Hand #220860910386: Tournament #3060068759, $0.23+$0.02 USD Hold'em No Limit - Level X (300/600) - 2020/11/28 1:53:40 EET [2020/11/27 18:53:40 ET]
Table '3060068759 5' 9-max Seat #7 is the button
Seat 1: clonharek704 (5059 in chips) 
Seat 2: ErickSayajin (12081 in chips) 
Seat 3: pfeife121 (24110 in chips) is sitting out
Seat 4: tschepetoo (3967 in chips) 
Seat 5: RapHood (7430 in chips) 
Seat 7: jcarlos.vale (5586 in chips) 
Seat 9: AyrtonAA95 (9267 in chips) 
clonharek704: posts the ante 50
ErickSayajin: posts the ante 50
pfeife121: posts the ante 50
tschepetoo: posts the ante 50
RapHood: posts the ante 50
jcarlos.vale: posts the ante 50
AyrtonAA95: posts the ante 50
AyrtonAA95: posts small blind 300
clonharek704: posts big blind 600
*** HOLE CARDS ***
Dealt to jcarlos.vale [8c 2s]
jcarlos.vale said, "iuahuiahuia"
ErickSayajin said, "boa kkk"
RapHood said, "e engole"
ErickSayajin: folds 
pfeife121: folds 
jcarlos.vale said, "#climaTenso"
jcarlos.vale said, "vcs sao de onde no BR?"
ErickSayajin said, "Porto alegre"
tschepetoo: folds 
jcarlos.vale said, "massa"
RapHood: folds 
jcarlos.vale: folds 
jcarlos.vale said, "sou do ceara mas to morando na Estonias"
AyrtonAA95: raises 8617 to 9217 and is all-in
clonharek704: folds 
Uncalled bet (8617) returned to AyrtonAA95
AyrtonAA95 collected 1550 from pot
AyrtonAA95: doesn't show hand 
ErickSayajin said, "n conheÃ§o kk"
*** SUMMARY ***
Total pot 1550 | Rake 0 
Seat 1: clonharek704 (big blind) folded before Flop
Seat 2: ErickSayajin folded before Flop (didn't bet)
Seat 3: pfeife121 folded before Flop (didn't bet)
Seat 4: tschepetoo folded before Flop (didn't bet)
Seat 5: RapHood folded before Flop (didn't bet)
Seat 7: jcarlos.vale (button) folded before Flop (didn't bet)
Seat 9: AyrtonAA95 (small blind) collected (1550)



PokerStars Hand #220860948808: Tournament #3060068759, $0.23+$0.02 USD Hold'em No Limit - Level X (300/600) - 2020/11/28 1:54:50 EET [2020/11/27 18:54:50 ET]
Table '3060068759 5' 9-max Seat #9 is the button
Seat 1: clonharek704 (4409 in chips) 
Seat 2: ErickSayajin (12031 in chips) 
Seat 3: pfeife121 (24060 in chips) is sitting out
Seat 4: tschepetoo (3917 in chips) 
Seat 5: RapHood (7380 in chips) 
Seat 7: jcarlos.vale (5536 in chips) 
Seat 9: AyrtonAA95 (10167 in chips) 
clonharek704: posts the ante 50
ErickSayajin: posts the ante 50
pfeife121: posts the ante 50
tschepetoo: posts the ante 50
RapHood: posts the ante 50
jcarlos.vale: posts the ante 50
AyrtonAA95: posts the ante 50
clonharek704: posts small blind 300
ErickSayajin: posts big blind 600
*** HOLE CARDS ***
Dealt to jcarlos.vale [Qh 7d]
pfeife121: folds 
jcarlos.vale said, "tem uma galera de PoA aqui"
AyrtonAA95 said, "vizinho"
jcarlos.vale said, "do lado da Russia"
tschepetoo: folds 
AyrtonAA95 said, "hahaha"
RapHood said, "paris"
RapHood said, "paricidinha"
RapHood has timed out
RapHood: folds 
RapHood is sitting out
jcarlos.vale: folds 
AyrtonAA95: folds 
clonharek704: folds 
Uncalled bet (300) returned to ErickSayajin
RapHood has returned
ErickSayajin collected 950 from pot
*** SUMMARY ***
Total pot 950 | Rake 0 
Seat 1: clonharek704 (small blind) folded before Flop
Seat 2: ErickSayajin (big blind) collected (950)
Seat 3: pfeife121 folded before Flop (didn't bet)
Seat 4: tschepetoo folded before Flop (didn't bet)
Seat 5: RapHood folded before Flop (didn't bet)
Seat 7: jcarlos.vale folded before Flop (didn't bet)
Seat 9: AyrtonAA95 (button) folded before Flop (didn't bet)



PokerStars Hand #220861099940: Tournament #3060068759, $0.23+$0.02 USD Hold'em No Limit - Level XI (400/800) - 2020/11/28 2:00:34 EET [2020/11/27 19:00:34 ET]
Table '3060068759 5' 9-max Seat #1 is the button
Seat 1: clonharek704 (4059 in chips) 
Seat 2: ErickSayajin (12631 in chips) 
Seat 3: pfeife121 (24010 in chips) 
Seat 4: tschepetoo (3867 in chips) 
Seat 5: RapHood (7330 in chips) 
Seat 7: jcarlos.vale (5486 in chips) 
Seat 9: AyrtonAA95 (10117 in chips) 
clonharek704: posts the ante 50
ErickSayajin: posts the ante 50
pfeife121: posts the ante 50
tschepetoo: posts the ante 50
RapHood: posts the ante 50
jcarlos.vale: posts the ante 50
AyrtonAA95: posts the ante 50
ErickSayajin: posts small blind 400
pfeife121: posts big blind 800
*** HOLE CARDS ***
Dealt to jcarlos.vale [Ks Kc]
jcarlos.vale said, "sim"
tschepetoo: folds 
jcarlos.vale said, "moro aqui ha 2 anos"
jcarlos.vale said, "mas tenho q voltar ao BR"
RapHood: folds 
jcarlos.vale: raises 4636 to 5436 and is all-in
AyrtonAA95: folds 
clonharek704: folds 
ErickSayajin: folds 
pfeife121: folds 
Uncalled bet (4636) returned to jcarlos.vale
jcarlos.vale collected 2350 from pot
jcarlos.vale: doesn't show hand 
ErickSayajin said, "caramba"
*** SUMMARY ***
Total pot 2350 | Rake 0 
Seat 1: clonharek704 (button) folded before Flop (didn't bet)
Seat 2: ErickSayajin (small blind) folded before Flop
Seat 3: pfeife121 (big blind) folded before Flop
Seat 4: tschepetoo folded before Flop (didn't bet)
Seat 5: RapHood folded before Flop (didn't bet)
Seat 7: jcarlos.vale collected (2350)
Seat 9: AyrtonAA95 folded before Flop (didn't bet)



PokerStars Hand #220861121010: Tournament #3060068759, $0.23+$0.02 USD Hold'em No Limit - Level XI (400/800) - 2020/11/28 2:01:18 EET [2020/11/27 19:01:18 ET]
Table '3060068759 5' 9-max Seat #2 is the button
Seat 1: clonharek704 (4009 in chips) 
Seat 2: ErickSayajin (12181 in chips) 
Seat 3: pfeife121 (23160 in chips) 
Seat 4: tschepetoo (3817 in chips) 
Seat 5: RapHood (7280 in chips) 
Seat 7: jcarlos.vale (6986 in chips) 
Seat 9: AyrtonAA95 (10067 in chips) 
clonharek704: posts the ante 50
ErickSayajin: posts the ante 50
pfeife121: posts the ante 50
tschepetoo: posts the ante 50
RapHood: posts the ante 50
jcarlos.vale: posts the ante 50
AyrtonAA95: posts the ante 50
pfeife121: posts small blind 400
tschepetoo: posts big blind 800
*** HOLE CARDS ***
Dealt to jcarlos.vale [Th 9d]
RapHood: folds 
jcarlos.vale: folds 
AyrtonAA95: folds 
clonharek704: folds 
ErickSayajin: calls 800
pfeife121: calls 400
jcarlos.vale said, "eh um bom pais, mas eh frio e escuro durante o inverno"
tschepetoo: checks 
*** FLOP *** [2c 5s 7h]
jcarlos.vale said, "4 da tarde ja escurece"
jcarlos.vale said, "rs rs"
pfeife121: bets 800
ErickSayajin said, "ksksks caramba"
jcarlos.vale said, "sei que em PoA o clima eh diferente, mas nao se compara"
tschepetoo: folds 
jcarlos.vale said, "de out ate maio o clima eh frio por aqui"
ErickSayajin said, "sim"
ErickSayajin: calls 800
*** TURN *** [2c 5s 7h] [Ts]
pfeife121: bets 4350
ErickSayajin: folds 
Uncalled bet (4350) returned to pfeife121
jcarlos.vale said, "fui em PoA assitir o ultimo show do Metallica"
pfeife121 collected 4350 from pot
pfeife121: doesn't show hand 
*** SUMMARY ***
Total pot 4350 | Rake 0 
Board [2c 5s 7h Ts]
Seat 1: clonharek704 folded before Flop (didn't bet)
Seat 2: ErickSayajin (button) folded on the Turn
Seat 3: pfeife121 (small blind) collected (4350)
Seat 4: tschepetoo (big blind) folded on the Flop
Seat 5: RapHood folded before Flop (didn't bet)
Seat 7: jcarlos.vale folded before Flop (didn't bet)
Seat 9: AyrtonAA95 folded before Flop (didn't bet)



PokerStars Hand #220861178373: Tournament #3060068759, $0.23+$0.02 USD Hold'em No Limit - Level XI (400/800) - 2020/11/28 2:03:03 EET [2020/11/27 19:03:03 ET]
Table '3060068759 5' 9-max Seat #3 is the button
Seat 1: clonharek704 (3959 in chips) 
Seat 2: ErickSayajin (10531 in chips) 
Seat 3: pfeife121 (25860 in chips) 
Seat 4: tschepetoo (2967 in chips) 
Seat 5: RapHood (7230 in chips) 
Seat 7: jcarlos.vale (6936 in chips) 
Seat 9: AyrtonAA95 (10017 in chips) 
clonharek704: posts the ante 50
ErickSayajin: posts the ante 50
pfeife121: posts the ante 50
tschepetoo: posts the ante 50
RapHood: posts the ante 50
jcarlos.vale: posts the ante 50
AyrtonAA95: posts the ante 50
tschepetoo: posts small blind 400
RapHood: posts big blind 800
*** HOLE CARDS ***
Dealt to jcarlos.vale [7c Kh]
jcarlos.vale: folds 
ErickSayajin said, "se Ã© rico nÃ© kk"
AyrtonAA95: folds 
clonharek704: folds 
jcarlos.vale said, "depois me manda teu contato"
ErickSayajin: folds 
pfeife121: folds 
ErickSayajin said, "como kk"
tschepetoo: folds 
Uncalled bet (400) returned to RapHood
jcarlos.vale said, "meu email eh o meu nick aqui + Gmail"
RapHood collected 1150 from pot
*** SUMMARY ***
Total pot 1150 | Rake 0 
Seat 1: clonharek704 folded before Flop (didn't bet)
Seat 2: ErickSayajin folded before Flop (didn't bet)
Seat 3: pfeife121 (button) folded before Flop (didn't bet)
Seat 4: tschepetoo (small blind) folded before Flop
Seat 5: RapHood (big blind) collected (1150)
Seat 7: jcarlos.vale folded before Flop (didn't bet)
Seat 9: AyrtonAA95 folded before Flop (didn't bet)



PokerStars Hand #220861195231: Tournament #3060068759, $0.23+$0.02 USD Hold'em No Limit - Level XI (400/800) - 2020/11/28 2:03:35 EET [2020/11/27 19:03:35 ET]
Table '3060068759 5' 9-max Seat #4 is the button
Seat 1: clonharek704 (3909 in chips) 
Seat 2: ErickSayajin (10481 in chips) 
Seat 3: pfeife121 (25810 in chips) 
Seat 4: tschepetoo (2517 in chips) 
Seat 5: RapHood (7930 in chips) 
Seat 7: jcarlos.vale (6886 in chips) 
Seat 9: AyrtonAA95 (9967 in chips) 
clonharek704: posts the ante 50
ErickSayajin: posts the ante 50
pfeife121: posts the ante 50
tschepetoo: posts the ante 50
RapHood: posts the ante 50
jcarlos.vale: posts the ante 50
AyrtonAA95: posts the ante 50
RapHood: posts small blind 400
jcarlos.vale: posts big blind 800
*** HOLE CARDS ***
Dealt to jcarlos.vale [5d 7h]
ErickSayajin said, "beleza"
AyrtonAA95: folds 
clonharek704: folds 
ErickSayajin: folds 
pfeife121: raises 800 to 1600
RapHood said, "que romantico"
jcarlos.vale said, "sou rico nao, rs rs"
tschepetoo: folds 
RapHood said, "vai rolar atÃ© namoro no pokerstars"
ErickSayajin said, "to em head sup em outro torneio"
jcarlos.vale said, "conheco o Krisiun e ganheir cortesia"
jcarlos.vale said, "uahuiahua, aihDentru Raphood"
RapHood has timed out
RapHood: folds 
RapHood is sitting out
jcarlos.vale: folds 
Uncalled bet (800) returned to pfeife121
pfeife121 collected 2350 from pot
pfeife121: doesn't show hand 
RapHood has returned
*** SUMMARY ***
Total pot 2350 | Rake 0 
Seat 1: clonharek704 folded before Flop (didn't bet)
Seat 2: ErickSayajin folded before Flop (didn't bet)
Seat 3: pfeife121 collected (2350)
Seat 4: tschepetoo (button) folded before Flop (didn't bet)
Seat 5: RapHood (small blind) folded before Flop
Seat 7: jcarlos.vale (big blind) folded before Flop
Seat 9: AyrtonAA95 folded before Flop (didn't bet)



PokerStars Hand #220861229287: Tournament #3060068759, $0.23+$0.02 USD Hold'em No Limit - Level XI (400/800) - 2020/11/28 2:04:38 EET [2020/11/27 19:04:38 ET]
Table '3060068759 5' 9-max Seat #5 is the button
Seat 1: clonharek704 (3859 in chips) 
Seat 2: ErickSayajin (10431 in chips) 
Seat 3: pfeife121 (27310 in chips) 
Seat 4: tschepetoo (2467 in chips) 
Seat 5: RapHood (7480 in chips) 
Seat 7: jcarlos.vale (6036 in chips) 
Seat 9: AyrtonAA95 (9917 in chips) 
clonharek704: posts the ante 50
ErickSayajin: posts the ante 50
pfeife121: posts the ante 50
tschepetoo: posts the ante 50
RapHood: posts the ante 50
jcarlos.vale: posts the ante 50
AyrtonAA95: posts the ante 50
jcarlos.vale: posts small blind 400
AyrtonAA95: posts big blind 800
*** HOLE CARDS ***
Dealt to jcarlos.vale [6h Qc]
clonharek704: folds 
ErickSayajin: calls 800
pfeife121: calls 800
tschepetoo: folds 
RapHood: folds 
jcarlos.vale: calls 400
AyrtonAA95: checks 
*** FLOP *** [Ts As 3h]
jcarlos.vale: checks 
AyrtonAA95: checks 
ErickSayajin: bets 9581 and is all-in
pfeife121: folds 
jcarlos.vale: folds 
AyrtonAA95: folds 
Uncalled bet (9581) returned to ErickSayajin
ErickSayajin collected 3550 from pot
ErickSayajin: doesn't show hand 
*** SUMMARY ***
Total pot 3550 | Rake 0 
Board [Ts As 3h]
Seat 1: clonharek704 folded before Flop (didn't bet)
Seat 2: ErickSayajin collected (3550)
Seat 3: pfeife121 folded on the Flop
Seat 4: tschepetoo folded before Flop (didn't bet)
Seat 5: RapHood (button) folded before Flop (didn't bet)
Seat 7: jcarlos.vale (small blind) folded on the Flop
Seat 9: AyrtonAA95 (big blind) folded on the Flop



PokerStars Hand #220861256960: Tournament #3060068759, $0.23+$0.02 USD Hold'em No Limit - Level XI (400/800) - 2020/11/28 2:05:29 EET [2020/11/27 19:05:29 ET]
Table '3060068759 5' 9-max Seat #7 is the button
Seat 1: clonharek704 (3809 in chips) 
Seat 2: ErickSayajin (13131 in chips) 
Seat 3: pfeife121 (26460 in chips) 
Seat 4: tschepetoo (2417 in chips) 
Seat 5: RapHood (7430 in chips) 
Seat 7: jcarlos.vale (5186 in chips) 
Seat 9: AyrtonAA95 (9067 in chips) 
clonharek704: posts the ante 50
ErickSayajin: posts the ante 50
pfeife121: posts the ante 50
tschepetoo: posts the ante 50
RapHood: posts the ante 50
jcarlos.vale: posts the ante 50
AyrtonAA95: posts the ante 50
AyrtonAA95: posts small blind 400
clonharek704: posts big blind 800
*** HOLE CARDS ***
Dealt to jcarlos.vale [Kh 3s]
ErickSayajin: folds 
pfeife121: calls 800
tschepetoo: folds 
RapHood: folds 
jcarlos.vale: folds 
AyrtonAA95: folds 
clonharek704: checks 
*** FLOP *** [Th Ks 4d]
clonharek704: checks 
pfeife121: bets 800
clonharek704: folds 
Uncalled bet (800) returned to pfeife121
pfeife121 collected 2350 from pot
pfeife121: doesn't show hand 
*** SUMMARY ***
Total pot 2350 | Rake 0 
Board [Th Ks 4d]
Seat 1: clonharek704 (big blind) folded on the Flop
Seat 2: ErickSayajin folded before Flop (didn't bet)
Seat 3: pfeife121 collected (2350)
Seat 4: tschepetoo folded before Flop (didn't bet)
Seat 5: RapHood folded before Flop (didn't bet)
Seat 7: jcarlos.vale (button) folded before Flop (didn't bet)
Seat 9: AyrtonAA95 (small blind) folded before Flop



PokerStars Hand #220861278657: Tournament #3060068759, $0.23+$0.02 USD Hold'em No Limit - Level XI (400/800) - 2020/11/28 2:06:09 EET [2020/11/27 19:06:09 ET]
Table '3060068759 5' 9-max Seat #9 is the button
Seat 1: clonharek704 (2959 in chips) 
Seat 2: ErickSayajin (13081 in chips) 
Seat 3: pfeife121 (27960 in chips) 
Seat 4: tschepetoo (2367 in chips) 
Seat 5: RapHood (7380 in chips) 
Seat 7: jcarlos.vale (5136 in chips) 
Seat 9: AyrtonAA95 (8617 in chips) 
clonharek704: posts the ante 50
ErickSayajin: posts the ante 50
pfeife121: posts the ante 50
tschepetoo: posts the ante 50
RapHood: posts the ante 50
jcarlos.vale: posts the ante 50
AyrtonAA95: posts the ante 50
clonharek704: posts small blind 400
ErickSayajin: posts big blind 800
*** HOLE CARDS ***
Dealt to jcarlos.vale [9c Tc]
pfeife121: folds 
tschepetoo: folds 
RapHood has timed out
RapHood: folds 
RapHood is sitting out
jcarlos.vale: raises 4286 to 5086 and is all-in
AyrtonAA95: folds 
clonharek704: folds 
ErickSayajin: folds 
Uncalled bet (4286) returned to jcarlos.vale
jcarlos.vale collected 2350 from pot
jcarlos.vale: doesn't show hand 
*** SUMMARY ***
Total pot 2350 | Rake 0 
Seat 1: clonharek704 (small blind) folded before Flop
Seat 2: ErickSayajin (big blind) folded before Flop
Seat 3: pfeife121 folded before Flop (didn't bet)
Seat 4: tschepetoo folded before Flop (didn't bet)
Seat 5: RapHood folded before Flop (didn't bet)
Seat 7: jcarlos.vale collected (2350)
Seat 9: AyrtonAA95 (button) folded before Flop (didn't bet)



PokerStars Hand #220861312166: Tournament #3060068759, $0.23+$0.02 USD Hold'em No Limit - Level XI (400/800) - 2020/11/28 2:07:12 EET [2020/11/27 19:07:12 ET]
Table '3060068759 5' 9-max Seat #1 is the button
Seat 1: clonharek704 (2509 in chips) 
Seat 2: ErickSayajin (12231 in chips) 
Seat 3: pfeife121 (27910 in chips) 
Seat 4: tschepetoo (2317 in chips) 
Seat 5: RapHood (7330 in chips) is sitting out
Seat 7: jcarlos.vale (6636 in chips) 
Seat 9: AyrtonAA95 (8567 in chips) 
clonharek704: posts the ante 50
ErickSayajin: posts the ante 50
pfeife121: posts the ante 50
tschepetoo: posts the ante 50
RapHood: posts the ante 50
jcarlos.vale: posts the ante 50
AyrtonAA95: posts the ante 50
ErickSayajin: posts small blind 400
pfeife121: posts big blind 800
*** HOLE CARDS ***
Dealt to jcarlos.vale [3d Th]
tschepetoo: raises 864 to 1664
RapHood: folds 
jcarlos.vale: folds 
AyrtonAA95: folds 
RapHood has returned
clonharek704: folds 
ErickSayajin: folds 
pfeife121: folds 
Uncalled bet (864) returned to tschepetoo
tschepetoo collected 2350 from pot
*** SUMMARY ***
Total pot 2350 | Rake 0 
Seat 1: clonharek704 (button) folded before Flop (didn't bet)
Seat 2: ErickSayajin (small blind) folded before Flop
Seat 3: pfeife121 (big blind) folded before Flop
Seat 4: tschepetoo collected (2350)
Seat 5: RapHood folded before Flop (didn't bet)
Seat 7: jcarlos.vale folded before Flop (didn't bet)
Seat 9: AyrtonAA95 folded before Flop (didn't bet)



PokerStars Hand #220861328997: Tournament #3060068759, $0.23+$0.02 USD Hold'em No Limit - Level XI (400/800) - 2020/11/28 2:07:43 EET [2020/11/27 19:07:43 ET]
Table '3060068759 5' 9-max Seat #2 is the button
Seat 1: clonharek704 (2459 in chips) 
Seat 2: ErickSayajin (11781 in chips) 
Seat 3: pfeife121 (27060 in chips) 
Seat 4: tschepetoo (3817 in chips) 
Seat 5: RapHood (7280 in chips) 
Seat 7: jcarlos.vale (6586 in chips) 
Seat 9: AyrtonAA95 (8517 in chips) 
clonharek704: posts the ante 50
ErickSayajin: posts the ante 50
pfeife121: posts the ante 50
tschepetoo: posts the ante 50
RapHood: posts the ante 50
jcarlos.vale: posts the ante 50
AyrtonAA95: posts the ante 50
pfeife121: posts small blind 400
tschepetoo: posts big blind 800
*** HOLE CARDS ***
Dealt to jcarlos.vale [Tc Ks]
RapHood: folds 
jcarlos.vale: folds 
AyrtonAA95: folds 
clonharek704: folds 
ErickSayajin: folds 
pfeife121: raises 1600 to 2400
RapHood said, "bora tirar o TSCHEPETOO"
RapHood said, "tschepetoo"
tschepetoo: folds 
Uncalled bet (1600) returned to pfeife121
RapHood said, "faz"
pfeife121 collected 1950 from pot
pfeife121: doesn't show hand 
*** SUMMARY ***
Total pot 1950 | Rake 0 
Seat 1: clonharek704 folded before Flop (didn't bet)
Seat 2: ErickSayajin (button) folded before Flop (didn't bet)
Seat 3: pfeife121 (small blind) collected (1950)
Seat 4: tschepetoo (big blind) folded before Flop
Seat 5: RapHood folded before Flop (didn't bet)
Seat 7: jcarlos.vale folded before Flop (didn't bet)
Seat 9: AyrtonAA95 folded before Flop (didn't bet)



PokerStars Hand #220861360883: Tournament #3060068759, $0.23+$0.02 USD Hold'em No Limit - Level XI (400/800) - 2020/11/28 2:08:43 EET [2020/11/27 19:08:43 ET]
Table '3060068759 5' 9-max Seat #3 is the button
Seat 1: clonharek704 (2409 in chips) 
Seat 2: ErickSayajin (11731 in chips) 
Seat 3: pfeife121 (28160 in chips) 
Seat 4: tschepetoo (2967 in chips) 
Seat 5: RapHood (7230 in chips) 
Seat 7: jcarlos.vale (6536 in chips) 
Seat 9: AyrtonAA95 (8467 in chips) 
clonharek704: posts the ante 50
ErickSayajin: posts the ante 50
pfeife121: posts the ante 50
tschepetoo: posts the ante 50
RapHood: posts the ante 50
jcarlos.vale: posts the ante 50
AyrtonAA95: posts the ante 50
tschepetoo: posts small blind 400
RapHood: posts big blind 800
*** HOLE CARDS ***
Dealt to jcarlos.vale [7h Ts]
RapHood said, "chupetoo"
jcarlos.vale: folds 
AyrtonAA95: folds 
clonharek704: folds 
ErickSayajin: folds 
pfeife121: calls 800
tschepetoo: folds 
jcarlos.vale said, "perigoso eh o CL"
RapHood: checks 
*** FLOP *** [6d 5h 2d]
jcarlos.vale said, "joga bem agessivo"
RapHood: checks 
ErickSayajin said, "Boa terminei a outra em segundo"
pfeife121: bets 2350
RapHood said, "airton"
RapHood said, "gay"
ErickSayajin said, "o cara com 70 bb e eu com 2 impossivel de eu ganhar kk"
RapHood has timed out
RapHood: folds 
RapHood is sitting out
Uncalled bet (2350) returned to pfeife121
pfeife121 collected 2350 from pot
pfeife121: doesn't show hand 
*** SUMMARY ***
Total pot 2350 | Rake 0 
Board [6d 5h 2d]
Seat 1: clonharek704 folded before Flop (didn't bet)
Seat 2: ErickSayajin folded before Flop (didn't bet)
Seat 3: pfeife121 (button) collected (2350)
Seat 4: tschepetoo (small blind) folded before Flop
Seat 5: RapHood (big blind) folded on the Flop
Seat 7: jcarlos.vale folded before Flop (didn't bet)
Seat 9: AyrtonAA95 folded before Flop (didn't bet)



PokerStars Hand #220861408103: Tournament #3060068759, $0.23+$0.02 USD Hold'em No Limit - Level XI (400/800) - 2020/11/28 2:10:13 EET [2020/11/27 19:10:13 ET]
Table '3060068759 5' 9-max Seat #4 is the button
Seat 1: clonharek704 (2359 in chips) 
Seat 2: ErickSayajin (11681 in chips) 
Seat 3: pfeife121 (29660 in chips) 
Seat 4: tschepetoo (2517 in chips) 
Seat 5: RapHood (6380 in chips) is sitting out
Seat 7: jcarlos.vale (6486 in chips) 
Seat 9: AyrtonAA95 (8417 in chips) 
clonharek704: posts the ante 50
ErickSayajin: posts the ante 50
pfeife121: posts the ante 50
tschepetoo: posts the ante 50
RapHood: posts the ante 50
jcarlos.vale: posts the ante 50
AyrtonAA95: posts the ante 50
RapHood: posts small blind 400
jcarlos.vale: posts big blind 800
*** HOLE CARDS ***
Dealt to jcarlos.vale [8c 8h]
RapHood has returned
AyrtonAA95: raises 800 to 1600
clonharek704: folds 
ErickSayajin: raises 800 to 2400
pfeife121: folds 
RapHood said, "erick"
RapHood said, "gaucho"
ErickSayajin said, "oi"
RapHood said, "tambem"
ErickSayajin said, "ai sim"
ErickSayajin said, "tchÃª"
tschepetoo: folds 
RapHood has timed out
RapHood: folds 
RapHood is sitting out
jcarlos.vale: folds 
RapHood has returned
AyrtonAA95: calls 800
*** FLOP *** [Ks 6s Js]
AyrtonAA95: checks 
ErickSayajin: bets 3175
AyrtonAA95: folds 
Uncalled bet (3175) returned to ErickSayajin
ErickSayajin collected 6350 from pot
ErickSayajin: doesn't show hand 
*** SUMMARY ***
Total pot 6350 | Rake 0 
Board [Ks 6s Js]
Seat 1: clonharek704 folded before Flop (didn't bet)
Seat 2: ErickSayajin collected (6350)
Seat 3: pfeife121 folded before Flop (didn't bet)
Seat 4: tschepetoo (button) folded before Flop (didn't bet)
Seat 5: RapHood (small blind) folded before Flop
Seat 7: jcarlos.vale (big blind) folded before Flop
Seat 9: AyrtonAA95 folded on the Flop



PokerStars Hand #220861466949: Tournament #3060068759, $0.23+$0.02 USD Hold'em No Limit - Level XII (500/1000) - 2020/11/28 2:11:57 EET [2020/11/27 19:11:57 ET]
Table '3060068759 5' 9-max Seat #5 is the button
Seat 1: clonharek704 (2309 in chips) 
Seat 2: ErickSayajin (15581 in chips) 
Seat 3: pfeife121 (29610 in chips) 
Seat 4: tschepetoo (2467 in chips) 
Seat 5: RapHood (5930 in chips) 
Seat 7: jcarlos.vale (5636 in chips) 
Seat 9: AyrtonAA95 (5967 in chips) 
clonharek704: posts the ante 60
ErickSayajin: posts the ante 60
pfeife121: posts the ante 60
tschepetoo: posts the ante 60
RapHood: posts the ante 60
jcarlos.vale: posts the ante 60
AyrtonAA95: posts the ante 60
jcarlos.vale: posts small blind 500
AyrtonAA95: posts big blind 1000
*** HOLE CARDS ***
Dealt to jcarlos.vale [3h Jh]
clonharek704: raises 1249 to 2249 and is all-in
ErickSayajin: folds 
pfeife121: folds 
tschepetoo: folds 
RapHood: folds 
jcarlos.vale: folds 
AyrtonAA95: folds 
Uncalled bet (1249) returned to clonharek704
clonharek704 collected 2920 from pot
RapHood said, "par de 2"
*** SUMMARY ***
Total pot 2920 | Rake 0 
Seat 1: clonharek704 collected (2920)
Seat 2: ErickSayajin folded before Flop (didn't bet)
Seat 3: pfeife121 folded before Flop (didn't bet)
Seat 4: tschepetoo folded before Flop (didn't bet)
Seat 5: RapHood (button) folded before Flop (didn't bet)
Seat 7: jcarlos.vale (small blind) folded before Flop
Seat 9: AyrtonAA95 (big blind) folded before Flop



PokerStars Hand #220861485156: Tournament #3060068759, $0.23+$0.02 USD Hold'em No Limit - Level XII (500/1000) - 2020/11/28 2:12:32 EET [2020/11/27 19:12:32 ET]
Table '3060068759 5' 9-max Seat #7 is the button
Seat 1: clonharek704 (4169 in chips) 
Seat 2: ErickSayajin (15521 in chips) 
Seat 3: pfeife121 (29550 in chips) 
Seat 4: tschepetoo (2407 in chips) 
Seat 5: RapHood (5870 in chips) 
Seat 7: jcarlos.vale (5076 in chips) 
Seat 9: AyrtonAA95 (4907 in chips) 
clonharek704: posts the ante 60
ErickSayajin: posts the ante 60
pfeife121: posts the ante 60
tschepetoo: posts the ante 60
RapHood: posts the ante 60
jcarlos.vale: posts the ante 60
AyrtonAA95: posts the ante 60
AyrtonAA95: posts small blind 500
clonharek704: posts big blind 1000
*** HOLE CARDS ***
Dealt to jcarlos.vale [Ks Tc]
ErickSayajin: folds 
pfeife121: folds 
tschepetoo: folds 
RapHood: folds 
jcarlos.vale: raises 4016 to 5016 and is all-in
AyrtonAA95: calls 4347 and is all-in
clonharek704: folds 
Uncalled bet (169) returned to jcarlos.vale
*** FLOP *** [9d 3c Qd]
*** TURN *** [9d 3c Qd] [Qc]
*** RIVER *** [9d 3c Qd Qc] [Ts]
*** SHOW DOWN ***
AyrtonAA95: shows [As Kh] (a pair of Queens)
jcarlos.vale: shows [Ks Tc] (two pair, Queens and Tens)
jcarlos.vale collected 11114 from pot
AyrtonAA95 finished the tournament in 7th place and received $0.36.
jcarlos.vale said, "ops"
*** SUMMARY ***
Total pot 11114 | Rake 0 
Board [9d 3c Qd Qc Ts]
Seat 1: clonharek704 (big blind) folded before Flop
Seat 2: ErickSayajin folded before Flop (didn't bet)
Seat 3: pfeife121 folded before Flop (didn't bet)
Seat 4: tschepetoo folded before Flop (didn't bet)
Seat 5: RapHood folded before Flop (didn't bet)
Seat 7: jcarlos.vale (button) showed [Ks Tc] and won (11114) with two pair, Queens and Tens
Seat 9: AyrtonAA95 (small blind) showed [As Kh] and lost with a pair of Queens



PokerStars Hand #220861517669: Tournament #3060068759, $0.23+$0.02 USD Hold'em No Limit - Level XII (500/1000) - 2020/11/28 2:13:34 EET [2020/11/27 19:13:34 ET]
Table '3060068759 5' 9-max Seat #1 is the button
Seat 1: clonharek704 (3109 in chips) 
Seat 2: ErickSayajin (15461 in chips) 
Seat 3: pfeife121 (29490 in chips) 
Seat 4: tschepetoo (2347 in chips) 
Seat 5: RapHood (5810 in chips) 
Seat 7: jcarlos.vale (11283 in chips) 
clonharek704: posts the ante 60
ErickSayajin: posts the ante 60
pfeife121: posts the ante 60
tschepetoo: posts the ante 60
RapHood: posts the ante 60
jcarlos.vale: posts the ante 60
ErickSayajin: posts small blind 500
pfeife121: posts big blind 1000
*** HOLE CARDS ***
Dealt to jcarlos.vale [2h Ts]
jcarlos.vale said, "aiuahuiahuia"
jcarlos.vale said, "aiuahuiahuia"
ErickSayajin said, "kkkkkk"
ErickSayajin said, "sortudo demais"
tschepetoo: raises 1080 to 2080
jcarlos.vale said, "pelo menos 1x"
RapHood said, "namoro ou amizade?"
RapHood has timed out
RapHood: folds 
RapHood is sitting out
jcarlos.vale: folds 
clonharek704: folds 
RapHood has returned
jcarlos.vale said, "sortudo era aquele BR, o armandinho"
ErickSayajin: calls 1580
pfeife121: folds 
*** FLOP *** [Kd Ac Jh]
ErickSayajin said, "sim kk"
ErickSayajin said, "cai depois dele ainda"
ErickSayajin: bets 2760
jcarlos.vale said, "tu eh de onde RapHood?"
ErickSayajin said, "antes na verdade"
tschepetoo: calls 207 and is all-in
Uncalled bet (2553) returned to ErickSayajin
*** TURN *** [Kd Ac Jh] [Jd]
*** RIVER *** [Kd Ac Jh Jd] [8s]
*** SHOW DOWN ***
ErickSayajin: shows [Qh Ad] (two pair, Aces and Jacks)
tschepetoo: shows [3d 3h] (two pair, Jacks and Threes)
jcarlos.vale said, "doaram"
ErickSayajin collected 5934 from pot
tschepetoo finished the tournament in 6th place and received $0.62.
*** SUMMARY ***
Total pot 5934 | Rake 0 
Board [Kd Ac Jh Jd 8s]
Seat 1: clonharek704 (button) folded before Flop (didn't bet)
Seat 2: ErickSayajin (small blind) showed [Qh Ad] and won (5934) with two pair, Aces and Jacks
Seat 3: pfeife121 (big blind) folded before Flop
Seat 4: tschepetoo showed [3d 3h] and lost with two pair, Jacks and Threes
Seat 5: RapHood folded before Flop (didn't bet)
Seat 7: jcarlos.vale folded before Flop (didn't bet)



PokerStars Hand #220861563842: Tournament #3060068759, $0.23+$0.02 USD Hold'em No Limit - Level XII (500/1000) - 2020/11/28 2:15:03 EET [2020/11/27 19:15:03 ET]
Table '3060068759 5' 9-max Seat #2 is the button
Seat 1: clonharek704 (3049 in chips) 
Seat 2: ErickSayajin (19048 in chips) 
Seat 3: pfeife121 (28430 in chips) 
Seat 5: RapHood (5750 in chips) 
Seat 7: jcarlos.vale (11223 in chips) 
clonharek704: posts the ante 60
ErickSayajin: posts the ante 60
pfeife121: posts the ante 60
RapHood: posts the ante 60
jcarlos.vale: posts the ante 60
pfeife121: posts small blind 500
RapHood: posts big blind 1000
*** HOLE CARDS ***
Dealt to jcarlos.vale [Ah 3h]
ErickSayajin said, "menos 1 hehe"
ErickSayajin said, "menos 1 hehe"
jcarlos.vale: folds 
clonharek704: calls 1000
ErickSayajin: folds 
pfeife121: calls 500
RapHood: checks 
*** FLOP *** [4d Kh 5d]
pfeife121: checks 
jcarlos.vale said, "tanto o alemao qto o russo sao agressivos"
RapHood: bets 1000
clonharek704: raises 989 to 1989 and is all-in
pfeife121: folds 
RapHood: calls 989
*** TURN *** [4d Kh 5d] [Qc]
*** RIVER *** [4d Kh 5d Qc] [2s]
*** SHOW DOWN ***
RapHood: shows [5s Kd] (two pair, Kings and Fives)
clonharek704: shows [Ad Ac] (a pair of Aces)
ErickSayajin said, "e tambem fazem jogadas de doentes kk"
jcarlos.vale said, "bingo!"
RapHood collected 7278 from pot
clonharek704 finished the tournament in 5th place and received $0.93.
RapHood said, "chupa"
*** SUMMARY ***
Total pot 7278 | Rake 0 
Board [4d Kh 5d Qc 2s]
Seat 1: clonharek704 showed [Ad Ac] and lost with a pair of Aces
Seat 2: ErickSayajin (button) folded before Flop (didn't bet)
Seat 3: pfeife121 (small blind) folded on the Flop
Seat 5: RapHood (big blind) showed [5s Kd] and won (7278) with two pair, Kings and Fives
Seat 7: jcarlos.vale folded before Flop (didn't bet)



PokerStars Hand #220861593520: Tournament #3060068759, $0.23+$0.02 USD Hold'em No Limit - Level XII (500/1000) - 2020/11/28 2:15:57 EET [2020/11/27 19:15:57 ET]
Table '3060068759 5' 9-max Seat #3 is the button
Seat 2: ErickSayajin (18988 in chips) 
Seat 3: pfeife121 (27370 in chips) 
Seat 5: RapHood (9979 in chips) 
Seat 7: jcarlos.vale (11163 in chips) 
ErickSayajin: posts the ante 60
pfeife121: posts the ante 60
RapHood: posts the ante 60
jcarlos.vale: posts the ante 60
RapHood: posts small blind 500
jcarlos.vale: posts big blind 1000
*** HOLE CARDS ***
Dealt to jcarlos.vale [6h 8h]
ErickSayajin said, "boa kk"
RapHood said, "e engole"
ErickSayajin: folds 
pfeife121: folds 
RapHood: folds 
Uncalled bet (500) returned to jcarlos.vale
jcarlos.vale collected 1240 from pot
jcarlos.vale: doesn't show hand 
*** SUMMARY ***
Total pot 1240 | Rake 0 
Seat 2: ErickSayajin folded before Flop (didn't bet)
Seat 3: pfeife121 (button) folded before Flop (didn't bet)
Seat 5: RapHood (small blind) folded before Flop
Seat 7: jcarlos.vale (big blind) collected (1240)



PokerStars Hand #220861605063: Tournament #3060068759, $0.23+$0.02 USD Hold'em No Limit - Level XII (500/1000) - 2020/11/28 2:16:19 EET [2020/11/27 19:16:19 ET]
Table '3060068759 5' 9-max Seat #5 is the button
Seat 2: ErickSayajin (18928 in chips) 
Seat 3: pfeife121 (27310 in chips) 
Seat 5: RapHood (9419 in chips) 
Seat 7: jcarlos.vale (11843 in chips) 
ErickSayajin: posts the ante 60
pfeife121: posts the ante 60
RapHood: posts the ante 60
jcarlos.vale: posts the ante 60
jcarlos.vale: posts small blind 500
ErickSayajin: posts big blind 1000
*** HOLE CARDS ***
Dealt to jcarlos.vale [3c 3s]
pfeife121: folds 
RapHood: folds 
jcarlos.vale: raises 1600 to 2600
ErickSayajin: folds 
Uncalled bet (1600) returned to jcarlos.vale
jcarlos.vale collected 2240 from pot
jcarlos.vale: doesn't show hand 
*** SUMMARY ***
Total pot 2240 | Rake 0 
Seat 2: ErickSayajin (big blind) folded before Flop
Seat 3: pfeife121 folded before Flop (didn't bet)
Seat 5: RapHood (button) folded before Flop (didn't bet)
Seat 7: jcarlos.vale (small blind) collected (2240)



PokerStars Hand #220861619946: Tournament #3060068759, $0.23+$0.02 USD Hold'em No Limit - Level XII (500/1000) - 2020/11/28 2:16:48 EET [2020/11/27 19:16:48 ET]
Table '3060068759 5' 9-max Seat #7 is the button
Seat 2: ErickSayajin (17868 in chips) 
Seat 3: pfeife121 (27250 in chips) 
Seat 5: RapHood (9359 in chips) 
Seat 7: jcarlos.vale (13023 in chips) 
ErickSayajin: posts the ante 60
pfeife121: posts the ante 60
RapHood: posts the ante 60
jcarlos.vale: posts the ante 60
ErickSayajin: posts small blind 500
pfeife121: posts big blind 1000
*** HOLE CARDS ***
Dealt to jcarlos.vale [Ks Kh]
RapHood has timed out
RapHood: folds 
RapHood is sitting out
jcarlos.vale: raises 1600 to 2600
ErickSayajin: folds 
pfeife121: calls 1600
*** FLOP *** [Th 3c 7s]
pfeife121: bets 5940
jcarlos.vale: raises 4423 to 10363 and is all-in
RapHood has returned
pfeife121: calls 4423
*** TURN *** [Th 3c 7s] [3d]
*** RIVER *** [Th 3c 7s 3d] [8d]
*** SHOW DOWN ***
pfeife121: shows [Qs Ts] (two pair, Tens and Threes)
jcarlos.vale: shows [Ks Kh] (two pair, Kings and Threes)
ErickSayajin said, "BOA GG KKK"
jcarlos.vale collected 26666 from pot
*** SUMMARY ***
Total pot 26666 | Rake 0 
Board [Th 3c 7s 3d 8d]
Seat 2: ErickSayajin (small blind) folded before Flop
Seat 3: pfeife121 (big blind) showed [Qs Ts] and lost with two pair, Tens and Threes
Seat 5: RapHood folded before Flop (didn't bet)
Seat 7: jcarlos.vale (button) showed [Ks Kh] and won (26666) with two pair, Kings and Threes



PokerStars Hand #220861650541: Tournament #3060068759, $0.23+$0.02 USD Hold'em No Limit - Level XII (500/1000) - 2020/11/28 2:17:47 EET [2020/11/27 19:17:47 ET]
Table '3060068759 5' 9-max Seat #2 is the button
Seat 2: ErickSayajin (17308 in chips) 
Seat 3: pfeife121 (14227 in chips) 
Seat 5: RapHood (9299 in chips) 
Seat 7: jcarlos.vale (26666 in chips) 
ErickSayajin: posts the ante 60
pfeife121: posts the ante 60
RapHood: posts the ante 60
jcarlos.vale: posts the ante 60
pfeife121: posts small blind 500
RapHood: posts big blind 1000
*** HOLE CARDS ***
Dealt to jcarlos.vale [Jh 7d]
RapHood said, "chupa"
jcarlos.vale said, "ele eh agresssivo"
RapHood said, "pfeife"
jcarlos.vale: folds 
ErickSayajin said, "CHUPA ALEMAO DE MIERDDA"
ErickSayajin: folds 
pfeife121: calls 500
RapHood said, "chupa"
RapHood said, "chucrutes"
RapHood: checks 
*** FLOP *** [8d Jd 3d]
pfeife121: checks 
RapHood: checks 
*** TURN *** [8d Jd 3d] [4h]
pfeife121: bets 1000
RapHood: raises 7239 to 8239 and is all-in
pfeife121: folds 
Uncalled bet (7239) returned to RapHood
RapHood collected 4240 from pot
ErickSayajin said, "vamo tirar ele e fazer um spin go"
RapHood said, "chupa otario"
*** SUMMARY ***
Total pot 4240 | Rake 0 
Board [8d Jd 3d 4h]
Seat 2: ErickSayajin (button) folded before Flop (didn't bet)
Seat 3: pfeife121 (small blind) folded on the Turn
Seat 5: RapHood (big blind) collected (4240)
Seat 7: jcarlos.vale folded before Flop (didn't bet)



PokerStars Hand #220861680393: Tournament #3060068759, $0.23+$0.02 USD Hold'em No Limit - Level XII (500/1000) - 2020/11/28 2:18:44 EET [2020/11/27 19:18:44 ET]
Table '3060068759 5' 9-max Seat #3 is the button
Seat 2: ErickSayajin (17248 in chips) 
Seat 3: pfeife121 (12167 in chips) 
Seat 5: RapHood (11479 in chips) 
Seat 7: jcarlos.vale (26606 in chips) 
ErickSayajin: posts the ante 60
pfeife121: posts the ante 60
RapHood: posts the ante 60
jcarlos.vale: posts the ante 60
RapHood: posts small blind 500
jcarlos.vale: posts big blind 1000
*** HOLE CARDS ***
Dealt to jcarlos.vale [4d 9h]
ErickSayajin: raises 2000 to 3000
pfeife121: folds 
RapHood: folds 
jcarlos.vale: folds 
Uncalled bet (2000) returned to ErickSayajin
ErickSayajin collected 2740 from pot
ErickSayajin: doesn't show hand 
*** SUMMARY ***
Total pot 2740 | Rake 0 
Seat 2: ErickSayajin collected (2740)
Seat 3: pfeife121 (button) folded before Flop (didn't bet)
Seat 5: RapHood (small blind) folded before Flop
Seat 7: jcarlos.vale (big blind) folded before Flop



PokerStars Hand #220861691923: Tournament #3060068759, $0.23+$0.02 USD Hold'em No Limit - Level XII (500/1000) - 2020/11/28 2:19:07 EET [2020/11/27 19:19:07 ET]
Table '3060068759 5' 9-max Seat #5 is the button
Seat 2: ErickSayajin (18928 in chips) 
Seat 3: pfeife121 (12107 in chips) 
Seat 5: RapHood (10919 in chips) 
Seat 7: jcarlos.vale (25546 in chips) 
ErickSayajin: posts the ante 60
pfeife121: posts the ante 60
RapHood: posts the ante 60
jcarlos.vale: posts the ante 60
jcarlos.vale: posts small blind 500
ErickSayajin: posts big blind 1000
*** HOLE CARDS ***
Dealt to jcarlos.vale [9s 3d]
pfeife121: folds 
RapHood has timed out
RapHood: folds 
RapHood is sitting out
jcarlos.vale: folds 
Uncalled bet (500) returned to ErickSayajin
ErickSayajin collected 1240 from pot
ErickSayajin: doesn't show hand 
*** SUMMARY ***
Total pot 1240 | Rake 0 
Seat 2: ErickSayajin (big blind) collected (1240)
Seat 3: pfeife121 folded before Flop (didn't bet)
Seat 5: RapHood (button) folded before Flop (didn't bet)
Seat 7: jcarlos.vale (small blind) folded before Flop



PokerStars Hand #220861717671: Tournament #3060068759, $0.23+$0.02 USD Hold'em No Limit - Level XII (500/1000) - 2020/11/28 2:19:46 EET [2020/11/27 19:19:46 ET]
Table '3060068759 5' 9-max Seat #7 is the button
Seat 2: ErickSayajin (19608 in chips) 
Seat 3: pfeife121 (12047 in chips) 
Seat 5: RapHood (10859 in chips) is sitting out
Seat 7: jcarlos.vale (24986 in chips) 
ErickSayajin: posts the ante 60
pfeife121: posts the ante 60
RapHood: posts the ante 60
jcarlos.vale: posts the ante 60
ErickSayajin: posts small blind 500
pfeife121: posts big blind 1000
*** HOLE CARDS ***
Dealt to jcarlos.vale [Kc Jh]
RapHood: folds 
jcarlos.vale: raises 1600 to 2600
RapHood has returned
ErickSayajin: folds 
pfeife121: raises 3400 to 6000
jcarlos.vale: raises 18926 to 24926 and is all-in
pfeife121: calls 5987 and is all-in
Uncalled bet (12939) returned to jcarlos.vale
*** FLOP *** [5s 8h 7d]
*** TURN *** [5s 8h 7d] [2c]
*** RIVER *** [5s 8h 7d 2c] [Kh]
*** SHOW DOWN ***
pfeife121: shows [9h Qs] (high card King)
jcarlos.vale: shows [Kc Jh] (a pair of Kings)
jcarlos.vale collected 24714 from pot
pfeife121 finished the tournament in 4th place and received $1.29.
jcarlos.vale said, "boa"
jcarlos.vale said, "gg"
ErickSayajin said, "chupa kkk"
*** SUMMARY ***
Total pot 24714 | Rake 0 
Board [5s 8h 7d 2c Kh]
Seat 2: ErickSayajin (small blind) folded before Flop
Seat 3: pfeife121 (big blind) showed [9h Qs] and lost with high card King
Seat 5: RapHood folded before Flop (didn't bet)
Seat 7: jcarlos.vale (button) showed [Kc Jh] and won (24714) with a pair of Kings



PokerStars Hand #220861734319: Tournament #3060068759, $0.23+$0.02 USD Hold'em No Limit - Level XII (500/1000) - 2020/11/28 2:20:18 EET [2020/11/27 19:20:18 ET]
Table '3060068759 5' 9-max Seat #2 is the button
Seat 2: ErickSayajin (19048 in chips) 
Seat 5: RapHood (10799 in chips) 
Seat 7: jcarlos.vale (37653 in chips) 
ErickSayajin: posts the ante 60
RapHood: posts the ante 60
jcarlos.vale: posts the ante 60
RapHood: posts small blind 500
jcarlos.vale: posts big blind 1000
*** HOLE CARDS ***
Dealt to jcarlos.vale [Td Js]
jcarlos.vale said, "gl people"
ErickSayajin: folds 
RapHood: calls 500
jcarlos.vale said, "prazer jogar c vcs"
ErickSayajin said, "Sobrou sÃ³ os brabo"
jcarlos.vale: checks 
*** FLOP *** [Qh 2h 6d]
RapHood: checks 
jcarlos.vale: checks 
*** TURN *** [Qh 2h 6d] [Ah]
RapHood said, "valeu"
RapHood: checks 
ErickSayajin said, "que venÃ§a o melhor"
jcarlos.vale said, "qq coisa meu email do gmail eh esse meu nick"
jcarlos.vale: checks 
*** RIVER *** [Qh 2h 6d Ah] [3c]
RapHood said, "trio brazuka"
RapHood: checks 
jcarlos.vale: checks 
*** SHOW DOWN ***
RapHood: shows [Jh Jd] (a pair of Jacks)
jcarlos.vale: mucks hand 
RapHood collected 2180 from pot
ErickSayajin said, "beleza"
*** SUMMARY ***
Total pot 2180 | Rake 0 
Board [Qh 2h 6d Ah 3c]
Seat 2: ErickSayajin (button) folded before Flop (didn't bet)
Seat 5: RapHood (small blind) showed [Jh Jd] and won (2180) with a pair of Jacks
Seat 7: jcarlos.vale (big blind) mucked [Td Js]



PokerStars Hand #220861763617: Tournament #3060068759, $0.23+$0.02 USD Hold'em No Limit - Level XIII (600/1200) - 2020/11/28 2:21:16 EET [2020/11/27 19:21:16 ET]
Table '3060068759 5' 9-max Seat #5 is the button
Seat 2: ErickSayajin (18988 in chips) 
Seat 5: RapHood (11919 in chips) 
Seat 7: jcarlos.vale (36593 in chips) 
ErickSayajin: posts the ante 75
RapHood: posts the ante 75
jcarlos.vale: posts the ante 75
jcarlos.vale: posts small blind 600
ErickSayajin: posts big blind 1200
*** HOLE CARDS ***
Dealt to jcarlos.vale [Ks 7c]
ErickSayajin said, "te chamo la depois"
RapHood: folds 
jcarlos.vale said, "ok"
jcarlos.vale: calls 600
ErickSayajin: checks 
*** FLOP *** [Ac 5d 7d]
jcarlos.vale: checks 
ErickSayajin: checks 
*** TURN *** [Ac 5d 7d] [6c]
jcarlos.vale: bets 2400
ErickSayajin: folds 
Uncalled bet (2400) returned to jcarlos.vale
jcarlos.vale collected 2625 from pot
jcarlos.vale: doesn't show hand 
*** SUMMARY ***
Total pot 2625 | Rake 0 
Board [Ac 5d 7d 6c]
Seat 2: ErickSayajin (big blind) folded on the Turn
Seat 5: RapHood (button) folded before Flop (didn't bet)
Seat 7: jcarlos.vale (small blind) collected (2625)



PokerStars Hand #220861782868: Tournament #3060068759, $0.23+$0.02 USD Hold'em No Limit - Level XIII (600/1200) - 2020/11/28 2:21:54 EET [2020/11/27 19:21:54 ET]
Table '3060068759 5' 9-max Seat #7 is the button
Seat 2: ErickSayajin (17713 in chips) 
Seat 5: RapHood (11844 in chips) 
Seat 7: jcarlos.vale (37943 in chips) 
ErickSayajin: posts the ante 75
RapHood: posts the ante 75
jcarlos.vale: posts the ante 75
ErickSayajin: posts small blind 600
RapHood: posts big blind 1200
*** HOLE CARDS ***
Dealt to jcarlos.vale [5s 8d]
jcarlos.vale: folds 
ErickSayajin: calls 600
RapHood: checks 
*** FLOP *** [8s 3h 9d]
ErickSayajin: checks 
RapHood: checks 
*** TURN *** [8s 3h 9d] [9s]
ErickSayajin: checks 
RapHood: checks 
*** RIVER *** [8s 3h 9d 9s] [3c]
ErickSayajin: bets 3600
RapHood said, "porra"
RapHood said, "nÃ£o sabe brincar"
ErickSayajin said, "jkkkkk"
RapHood has timed out
RapHood: folds 
RapHood is sitting out
Uncalled bet (3600) returned to ErickSayajin
RapHood has returned
ErickSayajin collected 2625 from pot
ErickSayajin: shows [Ac]
*** SUMMARY ***
Total pot 2625 | Rake 0 
Board [8s 3h 9d 9s 3c]
Seat 2: ErickSayajin (small blind) collected (2625)
Seat 5: RapHood (big blind) folded on the River
Seat 7: jcarlos.vale (button) folded before Flop (didn't bet)



PokerStars Hand #220861815357: Tournament #3060068759, $0.23+$0.02 USD Hold'em No Limit - Level XIII (600/1200) - 2020/11/28 2:22:58 EET [2020/11/27 19:22:58 ET]
Table '3060068759 5' 9-max Seat #2 is the button
Seat 2: ErickSayajin (19063 in chips) 
Seat 5: RapHood (10569 in chips) 
Seat 7: jcarlos.vale (37868 in chips) 
ErickSayajin: posts the ante 75
RapHood: posts the ante 75
jcarlos.vale: posts the ante 75
RapHood: posts small blind 600
jcarlos.vale: posts big blind 1200
*** HOLE CARDS ***
Dealt to jcarlos.vale [Kd Jh]
ErickSayajin: folds 
RapHood: folds 
Uncalled bet (600) returned to jcarlos.vale
jcarlos.vale collected 1425 from pot
jcarlos.vale: doesn't show hand 
*** SUMMARY ***
Total pot 1425 | Rake 0 
Seat 2: ErickSayajin (button) folded before Flop (didn't bet)
Seat 5: RapHood (small blind) folded before Flop
Seat 7: jcarlos.vale (big blind) collected (1425)



PokerStars Hand #220861823394: Tournament #3060068759, $0.23+$0.02 USD Hold'em No Limit - Level XIII (600/1200) - 2020/11/28 2:23:14 EET [2020/11/27 19:23:14 ET]
Table '3060068759 5' 9-max Seat #5 is the button
Seat 2: ErickSayajin (18988 in chips) 
Seat 5: RapHood (9894 in chips) 
Seat 7: jcarlos.vale (38618 in chips) 
ErickSayajin: posts the ante 75
RapHood: posts the ante 75
jcarlos.vale: posts the ante 75
jcarlos.vale: posts small blind 600
ErickSayajin: posts big blind 1200
*** HOLE CARDS ***
Dealt to jcarlos.vale [3c 4d]
RapHood has timed out
RapHood: folds 
RapHood is sitting out
jcarlos.vale: folds 
Uncalled bet (600) returned to ErickSayajin
RapHood has returned
ErickSayajin collected 1425 from pot
ErickSayajin: doesn't show hand 
*** SUMMARY ***
Total pot 1425 | Rake 0 
Seat 2: ErickSayajin (big blind) collected (1425)
Seat 5: RapHood (button) folded before Flop (didn't bet)
Seat 7: jcarlos.vale (small blind) folded before Flop



PokerStars Hand #220861842245: Tournament #3060068759, $0.23+$0.02 USD Hold'em No Limit - Level XIII (600/1200) - 2020/11/28 2:23:51 EET [2020/11/27 19:23:51 ET]
Table '3060068759 5' 9-max Seat #7 is the button
Seat 2: ErickSayajin (19738 in chips) 
Seat 5: RapHood (9819 in chips) 
Seat 7: jcarlos.vale (37943 in chips) 
ErickSayajin: posts the ante 75
RapHood: posts the ante 75
jcarlos.vale: posts the ante 75
ErickSayajin: posts small blind 600
RapHood: posts big blind 1200
*** HOLE CARDS ***
Dealt to jcarlos.vale [Ks Td]
jcarlos.vale: raises 1920 to 3120
ErickSayajin: folds 
RapHood: folds 
Uncalled bet (1920) returned to jcarlos.vale
jcarlos.vale collected 3225 from pot
jcarlos.vale: doesn't show hand 
*** SUMMARY ***
Total pot 3225 | Rake 0 
Seat 2: ErickSayajin (small blind) folded before Flop
Seat 5: RapHood (big blind) folded before Flop
Seat 7: jcarlos.vale (button) collected (3225)



PokerStars Hand #220861851378: Tournament #3060068759, $0.23+$0.02 USD Hold'em No Limit - Level XIII (600/1200) - 2020/11/28 2:24:09 EET [2020/11/27 19:24:09 ET]
Table '3060068759 5' 9-max Seat #2 is the button
Seat 2: ErickSayajin (19063 in chips) 
Seat 5: RapHood (8544 in chips) 
Seat 7: jcarlos.vale (39893 in chips) 
ErickSayajin: posts the ante 75
RapHood: posts the ante 75
jcarlos.vale: posts the ante 75
RapHood: posts small blind 600
jcarlos.vale: posts big blind 1200
*** HOLE CARDS ***
Dealt to jcarlos.vale [2c 2d]
ErickSayajin: folds 
RapHood: folds 
Uncalled bet (600) returned to jcarlos.vale
jcarlos.vale collected 1425 from pot
jcarlos.vale: doesn't show hand 
*** SUMMARY ***
Total pot 1425 | Rake 0 
Seat 2: ErickSayajin (button) folded before Flop (didn't bet)
Seat 5: RapHood (small blind) folded before Flop
Seat 7: jcarlos.vale (big blind) collected (1425)



PokerStars Hand #220861862736: Tournament #3060068759, $0.23+$0.02 USD Hold'em No Limit - Level XIII (600/1200) - 2020/11/28 2:24:31 EET [2020/11/27 19:24:31 ET]
Table '3060068759 5' 9-max Seat #5 is the button
Seat 2: ErickSayajin (18988 in chips) 
Seat 5: RapHood (7869 in chips) 
Seat 7: jcarlos.vale (40643 in chips) 
ErickSayajin: posts the ante 75
RapHood: posts the ante 75
jcarlos.vale: posts the ante 75
jcarlos.vale: posts small blind 600
ErickSayajin: posts big blind 1200
*** HOLE CARDS ***
Dealt to jcarlos.vale [5h 3h]
RapHood: folds 
jcarlos.vale: folds 
Uncalled bet (600) returned to ErickSayajin
ErickSayajin collected 1425 from pot
ErickSayajin: doesn't show hand 
*** SUMMARY ***
Total pot 1425 | Rake 0 
Seat 2: ErickSayajin (big blind) collected (1425)
Seat 5: RapHood (button) folded before Flop (didn't bet)
Seat 7: jcarlos.vale (small blind) folded before Flop



PokerStars Hand #220861894563: Tournament #3060068759, $0.23+$0.02 USD Hold'em No Limit - Level XIII (600/1200) - 2020/11/28 2:25:34 EET [2020/11/27 19:25:34 ET]
Table '3060068759 5' 9-max Seat #7 is the button
Seat 2: ErickSayajin (19738 in chips) 
Seat 5: RapHood (7794 in chips) 
Seat 7: jcarlos.vale (39968 in chips) 
ErickSayajin: posts the ante 75
RapHood: posts the ante 75
jcarlos.vale: posts the ante 75
ErickSayajin: posts small blind 600
RapHood: posts big blind 1200
*** HOLE CARDS ***
Dealt to jcarlos.vale [8d 4c]
jcarlos.vale: folds 
ErickSayajin: raises 18463 to 19663 and is all-in
RapHood: folds 
Uncalled bet (18463) returned to ErickSayajin
ErickSayajin collected 2625 from pot
ErickSayajin: doesn't show hand 
*** SUMMARY ***
Total pot 2625 | Rake 0 
Seat 2: ErickSayajin (small blind) collected (2625)
Seat 5: RapHood (big blind) folded before Flop
Seat 7: jcarlos.vale (button) folded before Flop (didn't bet)



PokerStars Hand #220861912132: Tournament #3060068759, $0.23+$0.02 USD Hold'em No Limit - Level XIII (600/1200) - 2020/11/28 2:26:04 EET [2020/11/27 19:26:04 ET]
Table '3060068759 5' 9-max Seat #2 is the button
Seat 2: ErickSayajin (21088 in chips) 
Seat 5: RapHood (6519 in chips) 
Seat 7: jcarlos.vale (39893 in chips) 
ErickSayajin: posts the ante 75
RapHood: posts the ante 75
jcarlos.vale: posts the ante 75
RapHood: posts small blind 600
jcarlos.vale: posts big blind 1200
*** HOLE CARDS ***
Dealt to jcarlos.vale [Kd 6c]
ErickSayajin: folds 
RapHood: calls 600
jcarlos.vale: checks 
*** FLOP *** [As Ts 8c]
RapHood: checks 
jcarlos.vale: checks 
*** TURN *** [As Ts 8c] [3s]
RapHood: checks 
jcarlos.vale: checks 
*** RIVER *** [As Ts 8c 3s] [7s]
RapHood: bets 5244 and is all-in
jcarlos.vale: folds 
Uncalled bet (5244) returned to RapHood
RapHood collected 2625 from pot
*** SUMMARY ***
Total pot 2625 | Rake 0 
Board [As Ts 8c 3s 7s]
Seat 2: ErickSayajin (button) folded before Flop (didn't bet)
Seat 5: RapHood (small blind) collected (2625)
Seat 7: jcarlos.vale (big blind) folded on the River



PokerStars Hand #220861941817: Tournament #3060068759, $0.23+$0.02 USD Hold'em No Limit - Level XIII (600/1200) - 2020/11/28 2:27:04 EET [2020/11/27 19:27:04 ET]
Table '3060068759 5' 9-max Seat #5 is the button
Seat 2: ErickSayajin (21013 in chips) 
Seat 5: RapHood (7869 in chips) 
Seat 7: jcarlos.vale (38618 in chips) 
ErickSayajin: posts the ante 75
RapHood: posts the ante 75
jcarlos.vale: posts the ante 75
jcarlos.vale: posts small blind 600
ErickSayajin: posts big blind 1200
*** HOLE CARDS ***
Dealt to jcarlos.vale [6d 9d]
RapHood said, "kkkkk"
RapHood said, "bundao"
RapHood: folds 
jcarlos.vale: calls 600
ErickSayajin said, "kkkkk"
ErickSayajin: checks 
*** FLOP *** [3c Kc As]
jcarlos.vale: checks 
ErickSayajin: bets 1313
jcarlos.vale: folds 
Uncalled bet (1313) returned to ErickSayajin
ErickSayajin collected 2625 from pot
ErickSayajin: doesn't show hand 
*** SUMMARY ***
Total pot 2625 | Rake 0 
Board [3c Kc As]
Seat 2: ErickSayajin (big blind) collected (2625)
Seat 5: RapHood (button) folded before Flop (didn't bet)
Seat 7: jcarlos.vale (small blind) folded on the Flop



PokerStars Hand #220861955382: Tournament #3060068759, $0.23+$0.02 USD Hold'em No Limit - Level XIII (600/1200) - 2020/11/28 2:27:31 EET [2020/11/27 19:27:31 ET]
Table '3060068759 5' 9-max Seat #7 is the button
Seat 2: ErickSayajin (22363 in chips) 
Seat 5: RapHood (7794 in chips) 
Seat 7: jcarlos.vale (37343 in chips) 
ErickSayajin: posts the ante 75
RapHood: posts the ante 75
jcarlos.vale: posts the ante 75
ErickSayajin: posts small blind 600
RapHood: posts big blind 1200
*** HOLE CARDS ***
Dealt to jcarlos.vale [8s 9s]
jcarlos.vale: raises 1920 to 3120
ErickSayajin: folds 
RapHood: raises 4599 to 7719 and is all-in
jcarlos.vale: calls 4599
*** FLOP *** [Jc 3c Td]
*** TURN *** [Jc 3c Td] [Kc]
*** RIVER *** [Jc 3c Td Kc] [6s]
*** SHOW DOWN ***
RapHood: shows [Jh Ts] (two pair, Jacks and Tens)
jcarlos.vale: shows [8s 9s] (high card King)
RapHood collected 16263 from pot
*** SUMMARY ***
Total pot 16263 | Rake 0 
Board [Jc 3c Td Kc 6s]
Seat 2: ErickSayajin (small blind) folded before Flop
Seat 5: RapHood (big blind) showed [Jh Ts] and won (16263) with two pair, Jacks and Tens
Seat 7: jcarlos.vale (button) showed [8s 9s] and lost with high card King



PokerStars Hand #220861976738: Tournament #3060068759, $0.23+$0.02 USD Hold'em No Limit - Level XIII (600/1200) - 2020/11/28 2:28:14 EET [2020/11/27 19:28:14 ET]
Table '3060068759 5' 9-max Seat #2 is the button
Seat 2: ErickSayajin (21688 in chips) 
Seat 5: RapHood (16263 in chips) 
Seat 7: jcarlos.vale (29549 in chips) 
ErickSayajin: posts the ante 75
RapHood: posts the ante 75
jcarlos.vale: posts the ante 75
RapHood: posts small blind 600
jcarlos.vale: posts big blind 1200
*** HOLE CARDS ***
Dealt to jcarlos.vale [8d 4c]
RapHood said, "chupa"
RapHood said, "se quiser"
ErickSayajin: folds 
RapHood said, "engole"
RapHood said, "kkkk"
ErickSayajin said, "kkkkk"
ErickSayajin said, "raphood renasce das cinzas toda hora"
RapHood has timed out
RapHood: folds 
RapHood is sitting out
Uncalled bet (600) returned to jcarlos.vale
RapHood has returned
jcarlos.vale collected 1425 from pot
jcarlos.vale: doesn't show hand 
*** SUMMARY ***
Total pot 1425 | Rake 0 
Seat 2: ErickSayajin (button) folded before Flop (didn't bet)
Seat 5: RapHood (small blind) folded before Flop
Seat 7: jcarlos.vale (big blind) collected (1425)



PokerStars Hand #220861996930: Tournament #3060068759, $0.23+$0.02 USD Hold'em No Limit - Level XIII (600/1200) - 2020/11/28 2:28:55 EET [2020/11/27 19:28:55 ET]
Table '3060068759 5' 9-max Seat #5 is the button
Seat 2: ErickSayajin (21613 in chips) 
Seat 5: RapHood (15588 in chips) 
Seat 7: jcarlos.vale (30299 in chips) 
ErickSayajin: posts the ante 75
RapHood: posts the ante 75
jcarlos.vale: posts the ante 75
jcarlos.vale: posts small blind 600
ErickSayajin: posts big blind 1200
*** HOLE CARDS ***
Dealt to jcarlos.vale [Td Jh]
RapHood said, "muito tempo"
RapHood said, "pra pouco retorno kkk"
RapHood: calls 1200
ErickSayajin said, "kkkkk"
jcarlos.vale: calls 600
ErickSayajin: checks 
*** FLOP *** [7h Ts Kd]
jcarlos.vale: checks 
ErickSayajin: bets 1913
RapHood: calls 1913
jcarlos.vale: calls 1913
*** TURN *** [7h Ts Kd] [5c]
jcarlos.vale: checks 
ErickSayajin: checks 
RapHood: checks 
*** RIVER *** [7h Ts Kd 5c] [8d]
jcarlos.vale: checks 
ErickSayajin: checks 
RapHood: checks 
*** SHOW DOWN ***
jcarlos.vale: shows [Td Jh] (a pair of Tens)
ErickSayajin: shows [4d 9d] (high card King)
RapHood: mucks hand 
jcarlos.vale collected 9564 from pot
*** SUMMARY ***
Total pot 9564 | Rake 0 
Board [7h Ts Kd 5c 8d]
Seat 2: ErickSayajin (big blind) showed [4d 9d] and lost with high card King
Seat 5: RapHood (button) mucked [Ah Jc]
Seat 7: jcarlos.vale (small blind) showed [Td Jh] and won (9564) with a pair of Tens



PokerStars Hand #220862029874: Tournament #3060068759, $0.23+$0.02 USD Hold'em No Limit - Level XIII (600/1200) - 2020/11/28 2:30:01 EET [2020/11/27 19:30:01 ET]
Table '3060068759 5' 9-max Seat #7 is the button
Seat 2: ErickSayajin (18425 in chips) 
Seat 5: RapHood (12400 in chips) 
Seat 7: jcarlos.vale (36675 in chips) 
ErickSayajin: posts the ante 75
RapHood: posts the ante 75
jcarlos.vale: posts the ante 75
ErickSayajin: posts small blind 600
RapHood: posts big blind 1200
*** HOLE CARDS ***
Dealt to jcarlos.vale [Ah 5d]
jcarlos.vale: raises 1920 to 3120
ErickSayajin: folds 
RapHood: folds 
Uncalled bet (1920) returned to jcarlos.vale
jcarlos.vale said, ">_<"
jcarlos.vale collected 3225 from pot
jcarlos.vale: doesn't show hand 
*** SUMMARY ***
Total pot 3225 | Rake 0 
Seat 2: ErickSayajin (small blind) folded before Flop
Seat 5: RapHood (big blind) folded before Flop
Seat 7: jcarlos.vale (button) collected (3225)



PokerStars Hand #220862037450: Tournament #3060068759, $0.23+$0.02 USD Hold'em No Limit - Level XIII (600/1200) - 2020/11/28 2:30:16 EET [2020/11/27 19:30:16 ET]
Table '3060068759 5' 9-max Seat #2 is the button
Seat 2: ErickSayajin (17750 in chips) 
Seat 5: RapHood (11125 in chips) 
Seat 7: jcarlos.vale (38625 in chips) 
ErickSayajin: posts the ante 75
RapHood: posts the ante 75
jcarlos.vale: posts the ante 75
RapHood: posts small blind 600
jcarlos.vale: posts big blind 1200
*** HOLE CARDS ***
Dealt to jcarlos.vale [6d Qc]
ErickSayajin: folds 
RapHood: raises 9850 to 11050 and is all-in
jcarlos.vale: folds 
Uncalled bet (9850) returned to RapHood
ErickSayajin said, "(^^^)$)"
RapHood collected 2625 from pot
*** SUMMARY ***
Total pot 2625 | Rake 0 
Seat 2: ErickSayajin (button) folded before Flop (didn't bet)
Seat 5: RapHood (small blind) collected (2625)
Seat 7: jcarlos.vale (big blind) folded before Flop



PokerStars Hand #220862047363: Tournament #3060068759, $0.23+$0.02 USD Hold'em No Limit - Level XIV (800/1600) - 2020/11/28 2:30:36 EET [2020/11/27 19:30:36 ET]
Table '3060068759 5' 9-max Seat #5 is the button
Seat 2: ErickSayajin (17675 in chips) 
Seat 5: RapHood (12475 in chips) 
Seat 7: jcarlos.vale (37350 in chips) 
ErickSayajin: posts the ante 75
RapHood: posts the ante 75
jcarlos.vale: posts the ante 75
jcarlos.vale: posts small blind 800
ErickSayajin: posts big blind 1600
*** HOLE CARDS ***
Dealt to jcarlos.vale [4c 5d]
RapHood said, "88"
RapHood: folds 
jcarlos.vale: folds 
Uncalled bet (800) returned to ErickSayajin
ErickSayajin collected 1825 from pot
ErickSayajin: shows [Jh Ad] (high card Ace)
*** SUMMARY ***
Total pot 1825 | Rake 0 
Seat 2: ErickSayajin (big blind) collected (1825)
Seat 5: RapHood (button) folded before Flop (didn't bet)
Seat 7: jcarlos.vale (small blind) folded before Flop



PokerStars Hand #220862054986: Tournament #3060068759, $0.23+$0.02 USD Hold'em No Limit - Level XIV (800/1600) - 2020/11/28 2:30:52 EET [2020/11/27 19:30:52 ET]
Table '3060068759 5' 9-max Seat #7 is the button
Seat 2: ErickSayajin (18625 in chips) 
Seat 5: RapHood (12400 in chips) 
Seat 7: jcarlos.vale (36475 in chips) 
ErickSayajin: posts the ante 75
RapHood: posts the ante 75
jcarlos.vale: posts the ante 75
ErickSayajin: posts small blind 800
RapHood: posts big blind 1600
*** HOLE CARDS ***
Dealt to jcarlos.vale [Kc Ts]
jcarlos.vale: raises 2560 to 4160
ErickSayajin: folds 
RapHood: folds 
Uncalled bet (2560) returned to jcarlos.vale
jcarlos.vale collected 4225 from pot
jcarlos.vale: doesn't show hand 
*** SUMMARY ***
Total pot 4225 | Rake 0 
Seat 2: ErickSayajin (small blind) folded before Flop
Seat 5: RapHood (big blind) folded before Flop
Seat 7: jcarlos.vale (button) collected (4225)



PokerStars Hand #220862067312: Tournament #3060068759, $0.23+$0.02 USD Hold'em No Limit - Level XIV (800/1600) - 2020/11/28 2:31:17 EET [2020/11/27 19:31:17 ET]
Table '3060068759 5' 9-max Seat #2 is the button
Seat 2: ErickSayajin (17750 in chips) 
Seat 5: RapHood (10725 in chips) 
Seat 7: jcarlos.vale (39025 in chips) 
ErickSayajin: posts the ante 75
RapHood: posts the ante 75
jcarlos.vale: posts the ante 75
RapHood: posts small blind 800
jcarlos.vale: posts big blind 1600
*** HOLE CARDS ***
Dealt to jcarlos.vale [Ad Jc]
ErickSayajin: calls 1600
RapHood: folds 
jcarlos.vale: raises 2560 to 4160
ErickSayajin: folds 
Uncalled bet (2560) returned to jcarlos.vale
jcarlos.vale collected 4225 from pot
jcarlos.vale: doesn't show hand 
*** SUMMARY ***
Total pot 4225 | Rake 0 
Seat 2: ErickSayajin (button) folded before Flop
Seat 5: RapHood (small blind) folded before Flop
Seat 7: jcarlos.vale (big blind) collected (4225)



PokerStars Hand #220862085272: Tournament #3060068759, $0.23+$0.02 USD Hold'em No Limit - Level XIV (800/1600) - 2020/11/28 2:31:53 EET [2020/11/27 19:31:53 ET]
Table '3060068759 5' 9-max Seat #5 is the button
Seat 2: ErickSayajin (16075 in chips) 
Seat 5: RapHood (9850 in chips) 
Seat 7: jcarlos.vale (41575 in chips) 
ErickSayajin: posts the ante 75
RapHood: posts the ante 75
jcarlos.vale: posts the ante 75
jcarlos.vale: posts small blind 800
ErickSayajin: posts big blind 1600
*** HOLE CARDS ***
Dealt to jcarlos.vale [2s 7s]
jcarlos.vale said, ":*"
ErickSayajin said, "(fire)"
RapHood: folds 
jcarlos.vale: folds 
Uncalled bet (800) returned to ErickSayajin
ErickSayajin collected 1825 from pot
ErickSayajin: doesn't show hand 
*** SUMMARY ***
Total pot 1825 | Rake 0 
Seat 2: ErickSayajin (big blind) collected (1825)
Seat 5: RapHood (button) folded before Flop (didn't bet)
Seat 7: jcarlos.vale (small blind) folded before Flop



PokerStars Hand #220862102156: Tournament #3060068759, $0.23+$0.02 USD Hold'em No Limit - Level XIV (800/1600) - 2020/11/28 2:32:28 EET [2020/11/27 19:32:28 ET]
Table '3060068759 5' 9-max Seat #7 is the button
Seat 2: ErickSayajin (17025 in chips) 
Seat 5: RapHood (9775 in chips) 
Seat 7: jcarlos.vale (40700 in chips) 
ErickSayajin: posts the ante 75
RapHood: posts the ante 75
jcarlos.vale: posts the ante 75
ErickSayajin: posts small blind 800
RapHood: posts big blind 1600
*** HOLE CARDS ***
Dealt to jcarlos.vale [6h Ac]
jcarlos.vale: raises 2560 to 4160
ErickSayajin: folds 
RapHood: folds 
Uncalled bet (2560) returned to jcarlos.vale
jcarlos.vale collected 4225 from pot
jcarlos.vale: doesn't show hand 
*** SUMMARY ***
Total pot 4225 | Rake 0 
Seat 2: ErickSayajin (small blind) folded before Flop
Seat 5: RapHood (big blind) folded before Flop
Seat 7: jcarlos.vale (button) collected (4225)



PokerStars Hand #220862115718: Tournament #3060068759, $0.23+$0.02 USD Hold'em No Limit - Level XIV (800/1600) - 2020/11/28 2:32:46 EET [2020/11/27 19:32:46 ET]
Table '3060068759 5' 9-max Seat #2 is the button
Seat 2: ErickSayajin (16150 in chips) 
Seat 5: RapHood (8100 in chips) 
Seat 7: jcarlos.vale (43250 in chips) 
ErickSayajin: posts the ante 75
RapHood: posts the ante 75
jcarlos.vale: posts the ante 75
RapHood: posts small blind 800
jcarlos.vale: posts big blind 1600
*** HOLE CARDS ***
Dealt to jcarlos.vale [3c 6d]
ErickSayajin: folds 
RapHood: calls 800
jcarlos.vale: checks 
*** FLOP *** [Qc 4d 9h]
RapHood: checks 
jcarlos.vale: checks 
*** TURN *** [Qc 4d 9h] [5d]
RapHood: checks 
jcarlos.vale: checks 
*** RIVER *** [Qc 4d 9h 5d] [2c]
ErickSayajin said, "jogo de cumadre"
RapHood: checks 
jcarlos.vale: bets 1713
RapHood said, "viado n"
RapHood said, "tem nada"
ErickSayajin said, "kkkk"
RapHood has timed out
RapHood: folds 
RapHood is sitting out
Uncalled bet (1713) returned to jcarlos.vale
RapHood has returned
jcarlos.vale collected 3425 from pot
jcarlos.vale: doesn't show hand 
jcarlos.vale said, "8)"
*** SUMMARY ***
Total pot 3425 | Rake 0 
Board [Qc 4d 9h 5d 2c]
Seat 2: ErickSayajin (button) folded before Flop (didn't bet)
Seat 5: RapHood (small blind) folded on the River
Seat 7: jcarlos.vale (big blind) collected (3425)



PokerStars Hand #220862143759: Tournament #3060068759, $0.23+$0.02 USD Hold'em No Limit - Level XIV (800/1600) - 2020/11/28 2:33:43 EET [2020/11/27 19:33:43 ET]
Table '3060068759 5' 9-max Seat #5 is the button
Seat 2: ErickSayajin (16075 in chips) 
Seat 5: RapHood (6425 in chips) 
Seat 7: jcarlos.vale (45000 in chips) 
ErickSayajin: posts the ante 75
RapHood: posts the ante 75
jcarlos.vale: posts the ante 75
jcarlos.vale: posts small blind 800
ErickSayajin: posts big blind 1600
*** HOLE CARDS ***
Dealt to jcarlos.vale [4h Kh]
ErickSayajin said, "ele bleffo nisso ai"
RapHood: folds 
jcarlos.vale: folds 
Uncalled bet (800) returned to ErickSayajin
ErickSayajin collected 1825 from pot
ErickSayajin: doesn't show hand 
*** SUMMARY ***
Total pot 1825 | Rake 0 
Seat 2: ErickSayajin (big blind) collected (1825)
Seat 5: RapHood (button) folded before Flop (didn't bet)
Seat 7: jcarlos.vale (small blind) folded before Flop



PokerStars Hand #220862155333: Tournament #3060068759, $0.23+$0.02 USD Hold'em No Limit - Level XIV (800/1600) - 2020/11/28 2:34:06 EET [2020/11/27 19:34:06 ET]
Table '3060068759 5' 9-max Seat #7 is the button
Seat 2: ErickSayajin (17025 in chips) 
Seat 5: RapHood (6350 in chips) 
Seat 7: jcarlos.vale (44125 in chips) 
ErickSayajin: posts the ante 75
RapHood: posts the ante 75
jcarlos.vale: posts the ante 75
ErickSayajin: posts small blind 800
RapHood: posts big blind 1600
*** HOLE CARDS ***
Dealt to jcarlos.vale [8c 4c]
jcarlos.vale: folds 
ErickSayajin: folds 
Uncalled bet (800) returned to RapHood
RapHood collected 1825 from pot
RapHood: doesn't show hand 
*** SUMMARY ***
Total pot 1825 | Rake 0 
Seat 2: ErickSayajin (small blind) folded before Flop
Seat 5: RapHood (big blind) collected (1825)
Seat 7: jcarlos.vale (button) folded before Flop (didn't bet)



PokerStars Hand #220862161649: Tournament #3060068759, $0.23+$0.02 USD Hold'em No Limit - Level XIV (800/1600) - 2020/11/28 2:34:19 EET [2020/11/27 19:34:19 ET]
Table '3060068759 5' 9-max Seat #2 is the button
Seat 2: ErickSayajin (16150 in chips) 
Seat 5: RapHood (7300 in chips) 
Seat 7: jcarlos.vale (44050 in chips) 
ErickSayajin: posts the ante 75
RapHood: posts the ante 75
jcarlos.vale: posts the ante 75
RapHood: posts small blind 800
jcarlos.vale: posts big blind 1600
*** HOLE CARDS ***
Dealt to jcarlos.vale [6d 2s]
ErickSayajin: folds 
RapHood: folds 
Uncalled bet (800) returned to jcarlos.vale
jcarlos.vale collected 1825 from pot
jcarlos.vale: doesn't show hand 
*** SUMMARY ***
Total pot 1825 | Rake 0 
Seat 2: ErickSayajin (button) folded before Flop (didn't bet)
Seat 5: RapHood (small blind) folded before Flop
Seat 7: jcarlos.vale (big blind) collected (1825)



PokerStars Hand #220862170247: Tournament #3060068759, $0.23+$0.02 USD Hold'em No Limit - Level XIV (800/1600) - 2020/11/28 2:34:37 EET [2020/11/27 19:34:37 ET]
Table '3060068759 5' 9-max Seat #5 is the button
Seat 2: ErickSayajin (16075 in chips) 
Seat 5: RapHood (6425 in chips) 
Seat 7: jcarlos.vale (45000 in chips) 
ErickSayajin: posts the ante 75
RapHood: posts the ante 75
jcarlos.vale: posts the ante 75
jcarlos.vale: posts small blind 800
ErickSayajin: posts big blind 1600
*** HOLE CARDS ***
Dealt to jcarlos.vale [Kc 9s]
RapHood: folds 
jcarlos.vale: raises 2560 to 4160
ErickSayajin: folds 
Uncalled bet (2560) returned to jcarlos.vale
jcarlos.vale collected 3425 from pot
jcarlos.vale: doesn't show hand 
*** SUMMARY ***
Total pot 3425 | Rake 0 
Seat 2: ErickSayajin (big blind) folded before Flop
Seat 5: RapHood (button) folded before Flop (didn't bet)
Seat 7: jcarlos.vale (small blind) collected (3425)



PokerStars Hand #220862180079: Tournament #3060068759, $0.23+$0.02 USD Hold'em No Limit - Level XIV (800/1600) - 2020/11/28 2:34:57 EET [2020/11/27 19:34:57 ET]
Table '3060068759 5' 9-max Seat #7 is the button
Seat 2: ErickSayajin (14400 in chips) 
Seat 5: RapHood (6350 in chips) 
Seat 7: jcarlos.vale (46750 in chips) 
ErickSayajin: posts the ante 75
RapHood: posts the ante 75
jcarlos.vale: posts the ante 75
ErickSayajin: posts small blind 800
RapHood: posts big blind 1600
*** HOLE CARDS ***
Dealt to jcarlos.vale [4s Kd]
jcarlos.vale: folds 
ErickSayajin: raises 12725 to 14325 and is all-in
RapHood: folds 
Uncalled bet (12725) returned to ErickSayajin
ErickSayajin collected 3425 from pot
ErickSayajin: doesn't show hand 
*** SUMMARY ***
Total pot 3425 | Rake 0 
Seat 2: ErickSayajin (small blind) collected (3425)
Seat 5: RapHood (big blind) folded before Flop
Seat 7: jcarlos.vale (button) folded before Flop (didn't bet)



PokerStars Hand #220862190687: Tournament #3060068759, $0.23+$0.02 USD Hold'em No Limit - Level XIV (800/1600) - 2020/11/28 2:35:18 EET [2020/11/27 19:35:18 ET]
Table '3060068759 5' 9-max Seat #2 is the button
Seat 2: ErickSayajin (16150 in chips) 
Seat 5: RapHood (4675 in chips) 
Seat 7: jcarlos.vale (46675 in chips) 
ErickSayajin: posts the ante 75
RapHood: posts the ante 75
jcarlos.vale: posts the ante 75
RapHood: posts small blind 800
jcarlos.vale: posts big blind 1600
*** HOLE CARDS ***
Dealt to jcarlos.vale [Ks Js]
ErickSayajin said, "rap vai cair pros blind"
ErickSayajin: folds 
RapHood: raises 3000 to 4600 and is all-in
jcarlos.vale: calls 3000
*** FLOP *** [Tc Qh 8s]
*** TURN *** [Tc Qh 8s] [Jd]
*** RIVER *** [Tc Qh 8s Jd] [7d]
RapHood said, "viado kkkkk"
*** SHOW DOWN ***
RapHood: shows [6c 9c] (a straight, Eight to Queen)
jcarlos.vale: shows [Ks Js] (a pair of Jacks)
RapHood collected 9425 from pot
jcarlos.vale said, "kkk"
*** SUMMARY ***
Total pot 9425 | Rake 0 
Board [Tc Qh 8s Jd 7d]
Seat 2: ErickSayajin (button) folded before Flop (didn't bet)
Seat 5: RapHood (small blind) showed [6c 9c] and won (9425) with a straight, Eight to Queen
Seat 7: jcarlos.vale (big blind) showed [Ks Js] and lost with a pair of Jacks



PokerStars Hand #220862208698: Tournament #3060068759, $0.23+$0.02 USD Hold'em No Limit - Level XIV (800/1600) - 2020/11/28 2:35:55 EET [2020/11/27 19:35:55 ET]
Table '3060068759 5' 9-max Seat #5 is the button
Seat 2: ErickSayajin (16075 in chips) 
Seat 5: RapHood (9425 in chips) 
Seat 7: jcarlos.vale (42000 in chips) 
ErickSayajin: posts the ante 75
RapHood: posts the ante 75
jcarlos.vale: posts the ante 75
jcarlos.vale: posts small blind 800
ErickSayajin: posts big blind 1600
*** HOLE CARDS ***
Dealt to jcarlos.vale [9h Qh]
ErickSayajin said, "a nem a pau kk"
RapHood said, "querendo ir embora"
ErickSayajin said, "que conta essa tua kk"
RapHood said, "deixar o casal sozinho"
jcarlos.vale said, "'cei"
RapHood has timed out
RapHood: folds 
RapHood is sitting out
jcarlos.vale: raises 2560 to 4160
RapHood has returned
ErickSayajin: calls 2560
*** FLOP *** [7h Kh 5h]
jcarlos.vale: bets 6409
ErickSayajin: folds 
Uncalled bet (6409) returned to jcarlos.vale
jcarlos.vale collected 8545 from pot
jcarlos.vale: doesn't show hand 
*** SUMMARY ***
Total pot 8545 | Rake 0 
Board [7h Kh 5h]
Seat 2: ErickSayajin (big blind) folded on the Flop
Seat 5: RapHood (button) folded before Flop (didn't bet)
Seat 7: jcarlos.vale (small blind) collected (8545)



PokerStars Hand #220862230481: Tournament #3060068759, $0.23+$0.02 USD Hold'em No Limit - Level XIV (800/1600) - 2020/11/28 2:36:40 EET [2020/11/27 19:36:40 ET]
Table '3060068759 5' 9-max Seat #7 is the button
Seat 2: ErickSayajin (11840 in chips) 
Seat 5: RapHood (9350 in chips) 
Seat 7: jcarlos.vale (46310 in chips) 
ErickSayajin: posts the ante 75
RapHood: posts the ante 75
jcarlos.vale: posts the ante 75
ErickSayajin: posts small blind 800
RapHood: posts big blind 1600
*** HOLE CARDS ***
Dealt to jcarlos.vale [Td 3s]
jcarlos.vale: folds 
RapHood said, "vou passar o gaucho"
ErickSayajin: folds 
Uncalled bet (800) returned to RapHood
RapHood collected 1825 from pot
*** SUMMARY ***
Total pot 1825 | Rake 0 
Seat 2: ErickSayajin (small blind) folded before Flop
Seat 5: RapHood (big blind) collected (1825)
Seat 7: jcarlos.vale (button) folded before Flop (didn't bet)



PokerStars Hand #220862236641: Tournament #3060068759, $0.23+$0.02 USD Hold'em No Limit - Level XIV (800/1600) - 2020/11/28 2:36:53 EET [2020/11/27 19:36:53 ET]
Table '3060068759 5' 9-max Seat #2 is the button
Seat 2: ErickSayajin (10965 in chips) 
Seat 5: RapHood (10300 in chips) 
Seat 7: jcarlos.vale (46235 in chips) 
ErickSayajin: posts the ante 75
RapHood: posts the ante 75
jcarlos.vale: posts the ante 75
RapHood: posts small blind 800
jcarlos.vale: posts big blind 1600
*** HOLE CARDS ***
Dealt to jcarlos.vale [Jd 6c]
ErickSayajin: folds 
RapHood said, "mÃ£o de alface"
RapHood: folds 
Uncalled bet (800) returned to jcarlos.vale
jcarlos.vale collected 1825 from pot
jcarlos.vale: doesn't show hand 
*** SUMMARY ***
Total pot 1825 | Rake 0 
Seat 2: ErickSayajin (button) folded before Flop (didn't bet)
Seat 5: RapHood (small blind) folded before Flop
Seat 7: jcarlos.vale (big blind) collected (1825)



PokerStars Hand #220862245833: Tournament #3060068759, $0.23+$0.02 USD Hold'em No Limit - Level XIV (800/1600) - 2020/11/28 2:37:12 EET [2020/11/27 19:37:12 ET]
Table '3060068759 5' 9-max Seat #5 is the button
Seat 2: ErickSayajin (10890 in chips) 
Seat 5: RapHood (9425 in chips) 
Seat 7: jcarlos.vale (47185 in chips) 
ErickSayajin: posts the ante 75
RapHood: posts the ante 75
jcarlos.vale: posts the ante 75
jcarlos.vale: posts small blind 800
ErickSayajin: posts big blind 1600
*** HOLE CARDS ***
Dealt to jcarlos.vale [Td 5c]
ErickSayajin said, "(poop)"
RapHood: folds 
jcarlos.vale: folds 
Uncalled bet (800) returned to ErickSayajin
ErickSayajin collected 1825 from pot
ErickSayajin: doesn't show hand 
*** SUMMARY ***
Total pot 1825 | Rake 0 
Seat 2: ErickSayajin (big blind) collected (1825)
Seat 5: RapHood (button) folded before Flop (didn't bet)
Seat 7: jcarlos.vale (small blind) folded before Flop



PokerStars Hand #220862251871: Tournament #3060068759, $0.23+$0.02 USD Hold'em No Limit - Level XIV (800/1600) - 2020/11/28 2:37:24 EET [2020/11/27 19:37:24 ET]
Table '3060068759 5' 9-max Seat #7 is the button
Seat 2: ErickSayajin (11840 in chips) 
Seat 5: RapHood (9350 in chips) 
Seat 7: jcarlos.vale (46310 in chips) 
ErickSayajin: posts the ante 75
RapHood: posts the ante 75
jcarlos.vale: posts the ante 75
ErickSayajin: posts small blind 800
RapHood: posts big blind 1600
*** HOLE CARDS ***
Dealt to jcarlos.vale [6s 7h]
jcarlos.vale: folds 
ErickSayajin: raises 10165 to 11765 and is all-in
RapHood: folds 
Uncalled bet (10165) returned to ErickSayajin
ErickSayajin collected 3425 from pot
jcarlos.vale said, "com sono"
ErickSayajin: doesn't show hand 
*** SUMMARY ***
Total pot 3425 | Rake 0 
Seat 2: ErickSayajin (small blind) collected (3425)
Seat 5: RapHood (big blind) folded before Flop
Seat 7: jcarlos.vale (button) folded before Flop (didn't bet)



PokerStars Hand #220862259352: Tournament #3060068759, $0.23+$0.02 USD Hold'em No Limit - Level XIV (800/1600) - 2020/11/28 2:37:39 EET [2020/11/27 19:37:39 ET]
Table '3060068759 5' 9-max Seat #2 is the button
Seat 2: ErickSayajin (13590 in chips) 
Seat 5: RapHood (7675 in chips) 
Seat 7: jcarlos.vale (46235 in chips) 
ErickSayajin: posts the ante 75
RapHood: posts the ante 75
jcarlos.vale: posts the ante 75
RapHood: posts small blind 800
jcarlos.vale: posts big blind 1600
*** HOLE CARDS ***
Dealt to jcarlos.vale [2s 4d]
jcarlos.vale said, "sao 2:30 aqui"
ErickSayajin said, "to cansado de ganha torneio hoje"
ErickSayajin: folds 
jcarlos.vale said, "kkkk, humilde"
ErickSayajin said, "Ã© 21:37 aqui"
RapHood: folds 
Uncalled bet (800) returned to jcarlos.vale
jcarlos.vale collected 1825 from pot
jcarlos.vale: doesn't show hand 
RapHood said, "so diversao"
*** SUMMARY ***
Total pot 1825 | Rake 0 
Seat 2: ErickSayajin (button) folded before Flop (didn't bet)
Seat 5: RapHood (small blind) folded before Flop
Seat 7: jcarlos.vale (big blind) collected (1825)



PokerStars Hand #220862272030: Tournament #3060068759, $0.23+$0.02 USD Hold'em No Limit - Level XIV (800/1600) - 2020/11/28 2:38:05 EET [2020/11/27 19:38:05 ET]
Table '3060068759 5' 9-max Seat #5 is the button
Seat 2: ErickSayajin (13515 in chips) 
Seat 5: RapHood (6800 in chips) 
Seat 7: jcarlos.vale (47185 in chips) 
ErickSayajin: posts the ante 75
RapHood: posts the ante 75
jcarlos.vale: posts the ante 75
jcarlos.vale: posts small blind 800
ErickSayajin: posts big blind 1600
*** HOLE CARDS ***
Dealt to jcarlos.vale [Js 4h]
jcarlos.vale said, "isso, aqui sao +5 BR"
ErickSayajin said, "nem ganhei muito hoje na real"
RapHood said, "ganhei dia inteiro na bolsa"
RapHood said, "bovespa"
ErickSayajin said, "mas sai no lucro pelo menos"
RapHood: raises 5125 to 6725 and is all-in
jcarlos.vale: folds 
ErickSayajin: calls 5125
*** FLOP *** [9d 5d 4d]
*** TURN *** [9d 5d 4d] [7h]
*** RIVER *** [9d 5d 4d 7h] [8s]
jcarlos.vale said, "gg"
*** SHOW DOWN ***
ErickSayajin: shows [Kh Kc] (a pair of Kings)
RapHood: shows [Tc As] (high card Ace)
RapHood said, "gays"
ErickSayajin said, "foi bom jogar com voce"
ErickSayajin collected 14475 from pot
RapHood finished the tournament in 3rd place and received $1.70.
*** SUMMARY ***
Total pot 14475 | Rake 0 
Board [9d 5d 4d 7h 8s]
Seat 2: ErickSayajin (big blind) showed [Kh Kc] and won (14475) with a pair of Kings
Seat 5: RapHood (button) showed [Tc As] and lost with high card Ace
Seat 7: jcarlos.vale (small blind) folded before Flop



PokerStars Hand #220862291694: Tournament #3060068759, $0.23+$0.02 USD Hold'em No Limit - Level XIV (800/1600) - 2020/11/28 2:38:46 EET [2020/11/27 19:38:46 ET]
Table '3060068759 5' 9-max Seat #2 is the button
Seat 2: ErickSayajin (21190 in chips) 
Seat 7: jcarlos.vale (46310 in chips) 
ErickSayajin: posts the ante 75
jcarlos.vale: posts the ante 75
ErickSayajin: posts small blind 800
jcarlos.vale: posts big blind 1600
*** HOLE CARDS ***
Dealt to jcarlos.vale [As Th]
jcarlos.vale said, "gl"
ErickSayajin: folds 
Uncalled bet (800) returned to jcarlos.vale
ErickSayajin said, "gg"
jcarlos.vale collected 1750 from pot
jcarlos.vale: doesn't show hand 
*** SUMMARY ***
Total pot 1750 | Rake 0 
Seat 2: ErickSayajin (button) (small blind) folded before Flop
Seat 7: jcarlos.vale (big blind) collected (1750)



PokerStars Hand #220862297721: Tournament #3060068759, $0.23+$0.02 USD Hold'em No Limit - Level XIV (800/1600) - 2020/11/28 2:38:58 EET [2020/11/27 19:38:58 ET]
Table '3060068759 5' 9-max Seat #7 is the button
Seat 2: ErickSayajin (20315 in chips) 
Seat 7: jcarlos.vale (47185 in chips) 
ErickSayajin: posts the ante 75
jcarlos.vale: posts the ante 75
jcarlos.vale: posts small blind 800
ErickSayajin: posts big blind 1600
*** HOLE CARDS ***
Dealt to jcarlos.vale [Qc 9d]
jcarlos.vale: raises 2560 to 4160
ErickSayajin: folds 
Uncalled bet (2560) returned to jcarlos.vale
jcarlos.vale collected 3350 from pot
jcarlos.vale: doesn't show hand 
ErickSayajin said, "boa sorte kk"
*** SUMMARY ***
Total pot 3350 | Rake 0 
Seat 2: ErickSayajin (big blind) folded before Flop
Seat 7: jcarlos.vale (button) (small blind) collected (3350)



PokerStars Hand #220862314564: Tournament #3060068759, $0.23+$0.02 USD Hold'em No Limit - Level XIV (800/1600) - 2020/11/28 2:39:14 EET [2020/11/27 19:39:14 ET]
Table '3060068759 5' 9-max Seat #2 is the button
Seat 2: ErickSayajin (18640 in chips) 
Seat 7: jcarlos.vale (48860 in chips) 
ErickSayajin: posts the ante 75
jcarlos.vale: posts the ante 75
ErickSayajin: posts small blind 800
jcarlos.vale: posts big blind 1600
*** HOLE CARDS ***
Dealt to jcarlos.vale [4h 2d]
jcarlos.vale said, "ok, vc tb"
ErickSayajin: folds 
Uncalled bet (800) returned to jcarlos.vale
jcarlos.vale collected 1750 from pot
jcarlos.vale: doesn't show hand 
*** SUMMARY ***
Total pot 1750 | Rake 0 
Seat 2: ErickSayajin (button) (small blind) folded before Flop
Seat 7: jcarlos.vale (big blind) collected (1750)



PokerStars Hand #220862319902: Tournament #3060068759, $0.23+$0.02 USD Hold'em No Limit - Level XIV (800/1600) - 2020/11/28 2:39:25 EET [2020/11/27 19:39:25 ET]
Table '3060068759 5' 9-max Seat #7 is the button
Seat 2: ErickSayajin (17765 in chips) 
Seat 7: jcarlos.vale (49735 in chips) 
ErickSayajin: posts the ante 75
jcarlos.vale: posts the ante 75
jcarlos.vale: posts small blind 800
ErickSayajin: posts big blind 1600
*** HOLE CARDS ***
Dealt to jcarlos.vale [4c Kd]
jcarlos.vale: folds 
Uncalled bet (800) returned to ErickSayajin
ErickSayajin collected 1750 from pot
ErickSayajin: doesn't show hand 
*** SUMMARY ***
Total pot 1750 | Rake 0 
Seat 2: ErickSayajin (big blind) collected (1750)
Seat 7: jcarlos.vale (button) (small blind) folded before Flop



PokerStars Hand #220862324685: Tournament #3060068759, $0.23+$0.02 USD Hold'em No Limit - Level XIV (800/1600) - 2020/11/28 2:39:35 EET [2020/11/27 19:39:35 ET]
Table '3060068759 5' 9-max Seat #2 is the button
Seat 2: ErickSayajin (18640 in chips) 
Seat 7: jcarlos.vale (48860 in chips) 
ErickSayajin: posts the ante 75
jcarlos.vale: posts the ante 75
ErickSayajin: posts small blind 800
jcarlos.vale: posts big blind 1600
*** HOLE CARDS ***
Dealt to jcarlos.vale [9h 5c]
ErickSayajin: calls 800
jcarlos.vale: checks 
*** FLOP *** [3h Ad Kh]
jcarlos.vale: checks 
ErickSayajin: bets 1675
jcarlos.vale: folds 
Uncalled bet (1675) returned to ErickSayajin
ErickSayajin collected 3350 from pot
ErickSayajin: doesn't show hand 
*** SUMMARY ***
Total pot 3350 | Rake 0 
Board [3h Ad Kh]
Seat 2: ErickSayajin (button) (small blind) collected (3350)
Seat 7: jcarlos.vale (big blind) folded on the Flop



PokerStars Hand #220862336269: Tournament #3060068759, $0.23+$0.02 USD Hold'em No Limit - Level XIV (800/1600) - 2020/11/28 2:39:59 EET [2020/11/27 19:39:59 ET]
Table '3060068759 5' 9-max Seat #7 is the button
Seat 2: ErickSayajin (20315 in chips) 
Seat 7: jcarlos.vale (47185 in chips) 
ErickSayajin: posts the ante 75
jcarlos.vale: posts the ante 75
jcarlos.vale: posts small blind 800
ErickSayajin: posts big blind 1600
*** HOLE CARDS ***
Dealt to jcarlos.vale [4d 8s]
jcarlos.vale: folds 
Uncalled bet (800) returned to ErickSayajin
ErickSayajin collected 1750 from pot
ErickSayajin: shows [Ac Kd] (high card Ace)
*** SUMMARY ***
Total pot 1750 | Rake 0 
Seat 2: ErickSayajin (big blind) collected (1750)
Seat 7: jcarlos.vale (button) (small blind) folded before Flop



PokerStars Hand #220862341146: Tournament #3060068759, $0.23+$0.02 USD Hold'em No Limit - Level XIV (800/1600) - 2020/11/28 2:40:09 EET [2020/11/27 19:40:09 ET]
Table '3060068759 5' 9-max Seat #2 is the button
Seat 2: ErickSayajin (21190 in chips) 
Seat 7: jcarlos.vale (46310 in chips) 
ErickSayajin: posts the ante 75
jcarlos.vale: posts the ante 75
ErickSayajin: posts small blind 800
jcarlos.vale: posts big blind 1600
*** HOLE CARDS ***
Dealt to jcarlos.vale [4c Qc]
ErickSayajin: calls 800
jcarlos.vale: checks 
*** FLOP *** [3h 4s Th]
jcarlos.vale: bets 2513
ErickSayajin: folds 
Uncalled bet (2513) returned to jcarlos.vale
jcarlos.vale collected 3350 from pot
jcarlos.vale: doesn't show hand 
*** SUMMARY ***
Total pot 3350 | Rake 0 
Board [3h 4s Th]
Seat 2: ErickSayajin (button) (small blind) folded on the Flop
Seat 7: jcarlos.vale (big blind) collected (3350)



PokerStars Hand #220862349739: Tournament #3060068759, $0.23+$0.02 USD Hold'em No Limit - Level XV (1000/2000) - 2020/11/28 2:40:28 EET [2020/11/27 19:40:28 ET]
Table '3060068759 5' 9-max Seat #7 is the button
Seat 2: ErickSayajin (19515 in chips) 
Seat 7: jcarlos.vale (47985 in chips) 
ErickSayajin: posts the ante 100
jcarlos.vale: posts the ante 100
jcarlos.vale: posts small blind 1000
ErickSayajin: posts big blind 2000
*** HOLE CARDS ***
Dealt to jcarlos.vale [Ad 3s]
jcarlos.vale: raises 3200 to 5200
ErickSayajin: folds 
Uncalled bet (3200) returned to jcarlos.vale
jcarlos.vale collected 4200 from pot
jcarlos.vale: doesn't show hand 
*** SUMMARY ***
Total pot 4200 | Rake 0 
Seat 2: ErickSayajin (big blind) folded before Flop
Seat 7: jcarlos.vale (button) (small blind) collected (4200)



PokerStars Hand #220862356202: Tournament #3060068759, $0.23+$0.02 USD Hold'em No Limit - Level XV (1000/2000) - 2020/11/28 2:40:41 EET [2020/11/27 19:40:41 ET]
Table '3060068759 5' 9-max Seat #2 is the button
Seat 2: ErickSayajin (17415 in chips) 
Seat 7: jcarlos.vale (50085 in chips) 
ErickSayajin: posts the ante 100
jcarlos.vale: posts the ante 100
ErickSayajin: posts small blind 1000
jcarlos.vale: posts big blind 2000
*** HOLE CARDS ***
Dealt to jcarlos.vale [Qs 8c]
ErickSayajin: folds 
Uncalled bet (1000) returned to jcarlos.vale
jcarlos.vale collected 2200 from pot
jcarlos.vale: doesn't show hand 
*** SUMMARY ***
Total pot 2200 | Rake 0 
Seat 2: ErickSayajin (button) (small blind) folded before Flop
Seat 7: jcarlos.vale (big blind) collected (2200)



PokerStars Hand #220862361944: Tournament #3060068759, $0.23+$0.02 USD Hold'em No Limit - Level XV (1000/2000) - 2020/11/28 2:40:53 EET [2020/11/27 19:40:53 ET]
Table '3060068759 5' 9-max Seat #7 is the button
Seat 2: ErickSayajin (16315 in chips) 
Seat 7: jcarlos.vale (51185 in chips) 
ErickSayajin: posts the ante 100
jcarlos.vale: posts the ante 100
jcarlos.vale: posts small blind 1000
ErickSayajin: posts big blind 2000
*** HOLE CARDS ***
Dealt to jcarlos.vale [Ac Ah]
jcarlos.vale: raises 3200 to 5200
ErickSayajin: raises 11015 to 16215 and is all-in
jcarlos.vale: calls 11015
*** FLOP *** [Ts 2s 3d]
ErickSayajin said, "gl"
*** TURN *** [Ts 2s 3d] [5s]
*** RIVER *** [Ts 2s 3d 5s] [Th]
jcarlos.vale said, "lol"
*** SHOW DOWN ***
ErickSayajin: shows [Ks Js] (a flush, King high)
jcarlos.vale: shows [Ac Ah] (two pair, Aces and Tens)
ErickSayajin collected 32630 from pot
ErickSayajin said, "kkkkk"
*** SUMMARY ***
Total pot 32630 | Rake 0 
Board [Ts 2s 3d 5s Th]
Seat 2: ErickSayajin (big blind) showed [Ks Js] and won (32630) with a flush, King high
Seat 7: jcarlos.vale (button) (small blind) showed [Ac Ah] and lost with two pair, Aces and Tens



PokerStars Hand #220862376212: Tournament #3060068759, $0.23+$0.02 USD Hold'em No Limit - Level XV (1000/2000) - 2020/11/28 2:41:24 EET [2020/11/27 19:41:24 ET]
Table '3060068759 5' 9-max Seat #2 is the button
Seat 2: ErickSayajin (32630 in chips) 
Seat 7: jcarlos.vale (34870 in chips) 
ErickSayajin: posts the ante 100
jcarlos.vale: posts the ante 100
ErickSayajin: posts small blind 1000
jcarlos.vale: posts big blind 2000
*** HOLE CARDS ***
Dealt to jcarlos.vale [Ac 5c]
ErickSayajin: calls 1000
jcarlos.vale: checks 
*** FLOP *** [Js Ah 8d]
jcarlos.vale: bets 3150
ErickSayajin: raises 5250 to 8400
jcarlos.vale: calls 5250
*** TURN *** [Js Ah 8d] [Th]
jcarlos.vale: checks 
ErickSayajin: checks 
*** RIVER *** [Js Ah 8d Th] [2d]
jcarlos.vale: bets 15750
ErickSayajin: calls 15750
*** SHOW DOWN ***
jcarlos.vale: shows [Ac 5c] (a pair of Aces)
ErickSayajin: shows [Ad 7d] (a pair of Aces)
jcarlos.vale collected 26250 from pot
ErickSayajin collected 26250 from pot
*** SUMMARY ***
Total pot 52500 | Rake 0 
Board [Js Ah 8d Th 2d]
Seat 2: ErickSayajin (button) (small blind) showed [Ad 7d] and won (26250) with a pair of Aces
Seat 7: jcarlos.vale (big blind) showed [Ac 5c] and won (26250) with a pair of Aces



PokerStars Hand #220862389704: Tournament #3060068759, $0.23+$0.02 USD Hold'em No Limit - Level XV (1000/2000) - 2020/11/28 2:41:52 EET [2020/11/27 19:41:52 ET]
Table '3060068759 5' 9-max Seat #7 is the button
Seat 2: ErickSayajin (32630 in chips) 
Seat 7: jcarlos.vale (34870 in chips) 
ErickSayajin: posts the ante 100
jcarlos.vale: posts the ante 100
jcarlos.vale: posts small blind 1000
ErickSayajin: posts big blind 2000
*** HOLE CARDS ***
Dealt to jcarlos.vale [4h 9s]
ErickSayajin said, "hehe boa"
jcarlos.vale: folds 
Uncalled bet (1000) returned to ErickSayajin
ErickSayajin collected 2200 from pot
ErickSayajin: doesn't show hand 
*** SUMMARY ***
Total pot 2200 | Rake 0 
Seat 2: ErickSayajin (big blind) collected (2200)
Seat 7: jcarlos.vale (button) (small blind) folded before Flop



PokerStars Hand #220862394680: Tournament #3060068759, $0.23+$0.02 USD Hold'em No Limit - Level XV (1000/2000) - 2020/11/28 2:42:03 EET [2020/11/27 19:42:03 ET]
Table '3060068759 5' 9-max Seat #2 is the button
Seat 2: ErickSayajin (33730 in chips) 
Seat 7: jcarlos.vale (33770 in chips) 
ErickSayajin: posts the ante 100
jcarlos.vale: posts the ante 100
ErickSayajin: posts small blind 1000
jcarlos.vale: posts big blind 2000
*** HOLE CARDS ***
Dealt to jcarlos.vale [Qd As]
ErickSayajin: calls 1000
jcarlos.vale: raises 3200 to 5200
ErickSayajin: folds 
Uncalled bet (3200) returned to jcarlos.vale
jcarlos.vale collected 4200 from pot
jcarlos.vale: doesn't show hand 
*** SUMMARY ***
Total pot 4200 | Rake 0 
Seat 2: ErickSayajin (button) (small blind) folded before Flop
Seat 7: jcarlos.vale (big blind) collected (4200)



PokerStars Hand #220862402467: Tournament #3060068759, $0.23+$0.02 USD Hold'em No Limit - Level XV (1000/2000) - 2020/11/28 2:42:20 EET [2020/11/27 19:42:20 ET]
Table '3060068759 5' 9-max Seat #7 is the button
Seat 2: ErickSayajin (31630 in chips) 
Seat 7: jcarlos.vale (35870 in chips) 
ErickSayajin: posts the ante 100
jcarlos.vale: posts the ante 100
jcarlos.vale: posts small blind 1000
ErickSayajin: posts big blind 2000
*** HOLE CARDS ***
Dealt to jcarlos.vale [Td 5d]
jcarlos.vale: raises 3200 to 5200
ErickSayajin: folds 
Uncalled bet (3200) returned to jcarlos.vale
jcarlos.vale collected 4200 from pot
jcarlos.vale: doesn't show hand 
*** SUMMARY ***
Total pot 4200 | Rake 0 
Seat 2: ErickSayajin (big blind) folded before Flop
Seat 7: jcarlos.vale (button) (small blind) collected (4200)



PokerStars Hand #220862408410: Tournament #3060068759, $0.23+$0.02 USD Hold'em No Limit - Level XV (1000/2000) - 2020/11/28 2:42:32 EET [2020/11/27 19:42:32 ET]
Table '3060068759 5' 9-max Seat #2 is the button
Seat 2: ErickSayajin (29530 in chips) 
Seat 7: jcarlos.vale (37970 in chips) 
ErickSayajin: posts the ante 100
jcarlos.vale: posts the ante 100
ErickSayajin: posts small blind 1000
jcarlos.vale: posts big blind 2000
*** HOLE CARDS ***
Dealt to jcarlos.vale [3d 5h]
ErickSayajin: raises 4200 to 6200
jcarlos.vale: folds 
Uncalled bet (4200) returned to ErickSayajin
ErickSayajin collected 4200 from pot
ErickSayajin: doesn't show hand 
*** SUMMARY ***
Total pot 4200 | Rake 0 
Seat 2: ErickSayajin (button) (small blind) collected (4200)
Seat 7: jcarlos.vale (big blind) folded before Flop



PokerStars Hand #220862414862: Tournament #3060068759, $0.23+$0.02 USD Hold'em No Limit - Level XV (1000/2000) - 2020/11/28 2:42:46 EET [2020/11/27 19:42:46 ET]
Table '3060068759 5' 9-max Seat #7 is the button
Seat 2: ErickSayajin (31630 in chips) 
Seat 7: jcarlos.vale (35870 in chips) 
ErickSayajin: posts the ante 100
jcarlos.vale: posts the ante 100
jcarlos.vale: posts small blind 1000
ErickSayajin: posts big blind 2000
*** HOLE CARDS ***
Dealt to jcarlos.vale [Jc 7c]
jcarlos.vale: raises 3200 to 5200
ErickSayajin: folds 
Uncalled bet (3200) returned to jcarlos.vale
jcarlos.vale collected 4200 from pot
jcarlos.vale: doesn't show hand 
*** SUMMARY ***
Total pot 4200 | Rake 0 
Seat 2: ErickSayajin (big blind) folded before Flop
Seat 7: jcarlos.vale (button) (small blind) collected (4200)



PokerStars Hand #220862424681: Tournament #3060068759, $0.23+$0.02 USD Hold'em No Limit - Level XV (1000/2000) - 2020/11/28 2:42:58 EET [2020/11/27 19:42:58 ET]
Table '3060068759 5' 9-max Seat #2 is the button
Seat 2: ErickSayajin (29530 in chips) 
Seat 7: jcarlos.vale (37970 in chips) 
ErickSayajin: posts the ante 100
jcarlos.vale: posts the ante 100
ErickSayajin: posts small blind 1000
jcarlos.vale: posts big blind 2000
*** HOLE CARDS ***
Dealt to jcarlos.vale [Ac As]
ErickSayajin: folds 
Uncalled bet (1000) returned to jcarlos.vale
jcarlos.vale collected 2200 from pot
jcarlos.vale: doesn't show hand 
*** SUMMARY ***
Total pot 2200 | Rake 0 
Seat 2: ErickSayajin (button) (small blind) folded before Flop
Seat 7: jcarlos.vale (big blind) collected (2200)



PokerStars Hand #220862429839: Tournament #3060068759, $0.23+$0.02 USD Hold'em No Limit - Level XV (1000/2000) - 2020/11/28 2:43:09 EET [2020/11/27 19:43:09 ET]
Table '3060068759 5' 9-max Seat #7 is the button
Seat 2: ErickSayajin (28430 in chips) 
Seat 7: jcarlos.vale (39070 in chips) 
ErickSayajin: posts the ante 100
jcarlos.vale: posts the ante 100
jcarlos.vale: posts small blind 1000
ErickSayajin: posts big blind 2000
*** HOLE CARDS ***
Dealt to jcarlos.vale [Kd 2s]
jcarlos.vale: folds 
Uncalled bet (1000) returned to ErickSayajin
ErickSayajin collected 2200 from pot
ErickSayajin: doesn't show hand 
*** SUMMARY ***
Total pot 2200 | Rake 0 
Seat 2: ErickSayajin (big blind) collected (2200)
Seat 7: jcarlos.vale (button) (small blind) folded before Flop



PokerStars Hand #220862434599: Tournament #3060068759, $0.23+$0.02 USD Hold'em No Limit - Level XV (1000/2000) - 2020/11/28 2:43:19 EET [2020/11/27 19:43:19 ET]
Table '3060068759 5' 9-max Seat #2 is the button
Seat 2: ErickSayajin (29530 in chips) 
Seat 7: jcarlos.vale (37970 in chips) 
ErickSayajin: posts the ante 100
jcarlos.vale: posts the ante 100
ErickSayajin: posts small blind 1000
jcarlos.vale: posts big blind 2000
*** HOLE CARDS ***
Dealt to jcarlos.vale [2d Ts]
ErickSayajin: raises 2000 to 4000
jcarlos.vale: folds 
Uncalled bet (2000) returned to ErickSayajin
ErickSayajin collected 4200 from pot
ErickSayajin: doesn't show hand 
*** SUMMARY ***
Total pot 4200 | Rake 0 
Seat 2: ErickSayajin (button) (small blind) collected (4200)
Seat 7: jcarlos.vale (big blind) folded before Flop



PokerStars Hand #220862440721: Tournament #3060068759, $0.23+$0.02 USD Hold'em No Limit - Level XV (1000/2000) - 2020/11/28 2:43:32 EET [2020/11/27 19:43:32 ET]
Table '3060068759 5' 9-max Seat #7 is the button
Seat 2: ErickSayajin (31630 in chips) 
Seat 7: jcarlos.vale (35870 in chips) 
ErickSayajin: posts the ante 100
jcarlos.vale: posts the ante 100
jcarlos.vale: posts small blind 1000
ErickSayajin: posts big blind 2000
*** HOLE CARDS ***
Dealt to jcarlos.vale [As 7d]
jcarlos.vale: raises 3200 to 5200
ErickSayajin: folds 
Uncalled bet (3200) returned to jcarlos.vale
jcarlos.vale collected 4200 from pot
jcarlos.vale: doesn't show hand 
*** SUMMARY ***
Total pot 4200 | Rake 0 
Seat 2: ErickSayajin (big blind) folded before Flop
Seat 7: jcarlos.vale (button) (small blind) collected (4200)



PokerStars Hand #220862446805: Tournament #3060068759, $0.23+$0.02 USD Hold'em No Limit - Level XV (1000/2000) - 2020/11/28 2:43:45 EET [2020/11/27 19:43:45 ET]
Table '3060068759 5' 9-max Seat #2 is the button
Seat 2: ErickSayajin (29530 in chips) 
Seat 7: jcarlos.vale (37970 in chips) 
ErickSayajin: posts the ante 100
jcarlos.vale: posts the ante 100
ErickSayajin: posts small blind 1000
jcarlos.vale: posts big blind 2000
*** HOLE CARDS ***
Dealt to jcarlos.vale [8d 6d]
ErickSayajin: folds 
Uncalled bet (1000) returned to jcarlos.vale
jcarlos.vale collected 2200 from pot
jcarlos.vale: doesn't show hand 
*** SUMMARY ***
Total pot 2200 | Rake 0 
Seat 2: ErickSayajin (button) (small blind) folded before Flop
Seat 7: jcarlos.vale (big blind) collected (2200)



PokerStars Hand #220862452118: Tournament #3060068759, $0.23+$0.02 USD Hold'em No Limit - Level XV (1000/2000) - 2020/11/28 2:43:56 EET [2020/11/27 19:43:56 ET]
Table '3060068759 5' 9-max Seat #7 is the button
Seat 2: ErickSayajin (28430 in chips) 
Seat 7: jcarlos.vale (39070 in chips) 
ErickSayajin: posts the ante 100
jcarlos.vale: posts the ante 100
jcarlos.vale: posts small blind 1000
ErickSayajin: posts big blind 2000
*** HOLE CARDS ***
Dealt to jcarlos.vale [5h 4c]
jcarlos.vale: raises 3200 to 5200
ErickSayajin: calls 3200
*** FLOP *** [9c As 7d]
ErickSayajin: bets 5300
jcarlos.vale: folds 
Uncalled bet (5300) returned to ErickSayajin
ErickSayajin collected 10600 from pot
ErickSayajin: doesn't show hand 
*** SUMMARY ***
Total pot 10600 | Rake 0 
Board [9c As 7d]
Seat 2: ErickSayajin (big blind) collected (10600)
Seat 7: jcarlos.vale (button) (small blind) folded on the Flop



PokerStars Hand #220862461913: Tournament #3060068759, $0.23+$0.02 USD Hold'em No Limit - Level XV (1000/2000) - 2020/11/28 2:44:18 EET [2020/11/27 19:44:18 ET]
Table '3060068759 5' 9-max Seat #2 is the button
Seat 2: ErickSayajin (33730 in chips) 
Seat 7: jcarlos.vale (33770 in chips) 
ErickSayajin: posts the ante 100
jcarlos.vale: posts the ante 100
ErickSayajin: posts small blind 1000
jcarlos.vale: posts big blind 2000
*** HOLE CARDS ***
Dealt to jcarlos.vale [Qh 4s]
ErickSayajin: calls 1000
jcarlos.vale: checks 
*** FLOP *** [Ah 5h 9c]
jcarlos.vale: checks 
ErickSayajin: checks 
*** TURN *** [Ah 5h 9c] [2c]
jcarlos.vale: checks 
jcarlos.vale said, "1min"
ErickSayajin: bets 4000
jcarlos.vale: folds 
Uncalled bet (4000) returned to ErickSayajin
jcarlos.vale said, "back"
ErickSayajin collected 4200 from pot
ErickSayajin: doesn't show hand 
*** SUMMARY ***
Total pot 4200 | Rake 0 
Board [Ah 5h 9c 2c]
Seat 2: ErickSayajin (button) (small blind) collected (4200)
Seat 7: jcarlos.vale (big blind) folded on the Turn



PokerStars Hand #220862498674: Tournament #3060068759, $0.23+$0.02 USD Hold'em No Limit - Level XV (1000/2000) - 2020/11/28 2:45:37 EET [2020/11/27 19:45:37 ET]
Table '3060068759 5' 9-max Seat #7 is the button
Seat 2: ErickSayajin (35830 in chips) 
Seat 7: jcarlos.vale (31670 in chips) 
ErickSayajin: posts the ante 100
jcarlos.vale: posts the ante 100
jcarlos.vale: posts small blind 1000
ErickSayajin: posts big blind 2000
*** HOLE CARDS ***
Dealt to jcarlos.vale [6d 3s]
jcarlos.vale: folds 
Uncalled bet (1000) returned to ErickSayajin
ErickSayajin collected 2200 from pot
ErickSayajin: doesn't show hand 
*** SUMMARY ***
Total pot 2200 | Rake 0 
Seat 2: ErickSayajin (big blind) collected (2200)
Seat 7: jcarlos.vale (button) (small blind) folded before Flop



PokerStars Hand #220862503564: Tournament #3060068759, $0.23+$0.02 USD Hold'em No Limit - Level XV (1000/2000) - 2020/11/28 2:45:47 EET [2020/11/27 19:45:47 ET]
Table '3060068759 5' 9-max Seat #2 is the button
Seat 2: ErickSayajin (36930 in chips) 
Seat 7: jcarlos.vale (30570 in chips) 
ErickSayajin: posts the ante 100
jcarlos.vale: posts the ante 100
ErickSayajin: posts small blind 1000
jcarlos.vale: posts big blind 2000
*** HOLE CARDS ***
Dealt to jcarlos.vale [Ad 8c]
ErickSayajin: folds 
Uncalled bet (1000) returned to jcarlos.vale
jcarlos.vale collected 2200 from pot
jcarlos.vale: doesn't show hand 
*** SUMMARY ***
Total pot 2200 | Rake 0 
Seat 2: ErickSayajin (button) (small blind) folded before Flop
Seat 7: jcarlos.vale (big blind) collected (2200)



PokerStars Hand #220862508961: Tournament #3060068759, $0.23+$0.02 USD Hold'em No Limit - Level XV (1000/2000) - 2020/11/28 2:45:59 EET [2020/11/27 19:45:59 ET]
Table '3060068759 5' 9-max Seat #7 is the button
Seat 2: ErickSayajin (35830 in chips) 
Seat 7: jcarlos.vale (31670 in chips) 
ErickSayajin: posts the ante 100
jcarlos.vale: posts the ante 100
jcarlos.vale: posts small blind 1000
ErickSayajin: posts big blind 2000
*** HOLE CARDS ***
Dealt to jcarlos.vale [Jh 6s]
jcarlos.vale: calls 1000
ErickSayajin: checks 
*** FLOP *** [Ks Qh Tc]
ErickSayajin: bets 2100
jcarlos.vale: calls 2100
*** TURN *** [Ks Qh Tc] [7s]
ErickSayajin: checks 
jcarlos.vale: checks 
*** RIVER *** [Ks Qh Tc 7s] [4d]
ErickSayajin: checks 
jcarlos.vale: bets 6300
ErickSayajin: folds 
Uncalled bet (6300) returned to jcarlos.vale
jcarlos.vale collected 8400 from pot
jcarlos.vale: doesn't show hand 
*** SUMMARY ***
Total pot 8400 | Rake 0 
Board [Ks Qh Tc 7s 4d]
Seat 2: ErickSayajin (big blind) folded on the River
Seat 7: jcarlos.vale (button) (small blind) collected (8400)



PokerStars Hand #220862522219: Tournament #3060068759, $0.23+$0.02 USD Hold'em No Limit - Level XV (1000/2000) - 2020/11/28 2:46:28 EET [2020/11/27 19:46:28 ET]
Table '3060068759 5' 9-max Seat #2 is the button
Seat 2: ErickSayajin (31630 in chips) 
Seat 7: jcarlos.vale (35870 in chips) 
ErickSayajin: posts the ante 100
jcarlos.vale: posts the ante 100
ErickSayajin: posts small blind 1000
jcarlos.vale: posts big blind 2000
*** HOLE CARDS ***
Dealt to jcarlos.vale [3d 8c]
ErickSayajin: folds 
Uncalled bet (1000) returned to jcarlos.vale
jcarlos.vale collected 2200 from pot
jcarlos.vale: doesn't show hand 
*** SUMMARY ***
Total pot 2200 | Rake 0 
Seat 2: ErickSayajin (button) (small blind) folded before Flop
Seat 7: jcarlos.vale (big blind) collected (2200)



PokerStars Hand #220862527293: Tournament #3060068759, $0.23+$0.02 USD Hold'em No Limit - Level XV (1000/2000) - 2020/11/28 2:46:39 EET [2020/11/27 19:46:39 ET]
Table '3060068759 5' 9-max Seat #7 is the button
Seat 2: ErickSayajin (30530 in chips) 
Seat 7: jcarlos.vale (36970 in chips) 
ErickSayajin: posts the ante 100
jcarlos.vale: posts the ante 100
jcarlos.vale: posts small blind 1000
ErickSayajin: posts big blind 2000
*** HOLE CARDS ***
Dealt to jcarlos.vale [Qd Td]
jcarlos.vale: raises 3200 to 5200
ErickSayajin: folds 
Uncalled bet (3200) returned to jcarlos.vale
jcarlos.vale collected 4200 from pot
jcarlos.vale: doesn't show hand 
*** SUMMARY ***
Total pot 4200 | Rake 0 
Seat 2: ErickSayajin (big blind) folded before Flop
Seat 7: jcarlos.vale (button) (small blind) collected (4200)



PokerStars Hand #220862532539: Tournament #3060068759, $0.23+$0.02 USD Hold'em No Limit - Level XV (1000/2000) - 2020/11/28 2:46:50 EET [2020/11/27 19:46:50 ET]
Table '3060068759 5' 9-max Seat #2 is the button
Seat 2: ErickSayajin (28430 in chips) 
Seat 7: jcarlos.vale (39070 in chips) 
ErickSayajin: posts the ante 100
jcarlos.vale: posts the ante 100
ErickSayajin: posts small blind 1000
jcarlos.vale: posts big blind 2000
*** HOLE CARDS ***
Dealt to jcarlos.vale [Tc Ac]
ErickSayajin: raises 26330 to 28330 and is all-in
jcarlos.vale: calls 26330
*** FLOP *** [2h Qd Jc]
jcarlos.vale said, "lol"
*** TURN *** [2h Qd Jc] [Kd]
*** RIVER *** [2h Qd Jc Kd] [9c]
*** SHOW DOWN ***
jcarlos.vale: shows [Tc Ac] (a straight, Ten to Ace)
ErickSayajin: shows [As Ts] (a straight, Ten to Ace)
ErickSayajin said, "kkkkk"
jcarlos.vale collected 28430 from pot
ErickSayajin collected 28430 from pot
*** SUMMARY ***
Total pot 56860 | Rake 0 
Board [2h Qd Jc Kd 9c]
Seat 2: ErickSayajin (button) (small blind) showed [As Ts] and won (28430) with a straight, Ten to Ace
Seat 7: jcarlos.vale (big blind) showed [Tc Ac] and won (28430) with a straight, Ten to Ace



PokerStars Hand #220862543258: Tournament #3060068759, $0.23+$0.02 USD Hold'em No Limit - Level XV (1000/2000) - 2020/11/28 2:47:13 EET [2020/11/27 19:47:13 ET]
Table '3060068759 5' 9-max Seat #7 is the button
Seat 2: ErickSayajin (28430 in chips) 
Seat 7: jcarlos.vale (39070 in chips) 
ErickSayajin: posts the ante 100
jcarlos.vale: posts the ante 100
jcarlos.vale: posts small blind 1000
ErickSayajin: posts big blind 2000
*** HOLE CARDS ***
Dealt to jcarlos.vale [Qc 9d]
jcarlos.vale: raises 3200 to 5200
ErickSayajin said, "vamos ficar ate amanha aqui kk"
ErickSayajin: folds 
Uncalled bet (3200) returned to jcarlos.vale
jcarlos.vale collected 4200 from pot
jcarlos.vale: doesn't show hand 
jcarlos.vale said, "nada"
*** SUMMARY ***
Total pot 4200 | Rake 0 
Seat 2: ErickSayajin (big blind) folded before Flop
Seat 7: jcarlos.vale (button) (small blind) collected (4200)



PokerStars Hand #220862552917: Tournament #3060068759, $0.23+$0.02 USD Hold'em No Limit - Level XV (1000/2000) - 2020/11/28 2:47:34 EET [2020/11/27 19:47:34 ET]
Table '3060068759 5' 9-max Seat #2 is the button
Seat 2: ErickSayajin (26330 in chips) 
Seat 7: jcarlos.vale (41170 in chips) 
ErickSayajin: posts the ante 100
jcarlos.vale: posts the ante 100
ErickSayajin: posts small blind 1000
jcarlos.vale: posts big blind 2000
*** HOLE CARDS ***
Dealt to jcarlos.vale [Qs 3c]
jcarlos.vale said, "ja ja o PS da um bad beat"
ErickSayajin: folds 
Uncalled bet (1000) returned to jcarlos.vale
ErickSayajin said, "kkkk"
jcarlos.vale collected 2200 from pot
jcarlos.vale: doesn't show hand 
*** SUMMARY ***
Total pot 2200 | Rake 0 
Seat 2: ErickSayajin (button) (small blind) folded before Flop
Seat 7: jcarlos.vale (big blind) collected (2200)



PokerStars Hand #220862562093: Tournament #3060068759, $0.23+$0.02 USD Hold'em No Limit - Level XV (1000/2000) - 2020/11/28 2:47:54 EET [2020/11/27 19:47:54 ET]
Table '3060068759 5' 9-max Seat #7 is the button
Seat 2: ErickSayajin (25230 in chips) 
Seat 7: jcarlos.vale (42270 in chips) 
ErickSayajin: posts the ante 100
jcarlos.vale: posts the ante 100
jcarlos.vale: posts small blind 1000
ErickSayajin: posts big blind 2000
*** HOLE CARDS ***
Dealt to jcarlos.vale [Qs Kc]
jcarlos.vale: raises 3200 to 5200
ErickSayajin: folds 
Uncalled bet (3200) returned to jcarlos.vale
jcarlos.vale collected 4200 from pot
jcarlos.vale: doesn't show hand 
*** SUMMARY ***
Total pot 4200 | Rake 0 
Seat 2: ErickSayajin (big blind) folded before Flop
Seat 7: jcarlos.vale (button) (small blind) collected (4200)



PokerStars Hand #220862568073: Tournament #3060068759, $0.23+$0.02 USD Hold'em No Limit - Level XV (1000/2000) - 2020/11/28 2:48:07 EET [2020/11/27 19:48:07 ET]
Table '3060068759 5' 9-max Seat #2 is the button
Seat 2: ErickSayajin (23130 in chips) 
Seat 7: jcarlos.vale (44370 in chips) 
ErickSayajin: posts the ante 100
jcarlos.vale: posts the ante 100
ErickSayajin: posts small blind 1000
jcarlos.vale: posts big blind 2000
*** HOLE CARDS ***
Dealt to jcarlos.vale [7s Ah]
ErickSayajin: raises 2000 to 4000
jcarlos.vale: calls 2000
*** FLOP *** [Th 2h 2d]
jcarlos.vale: checks 
ErickSayajin: bets 19030 and is all-in
jcarlos.vale: folds 
Uncalled bet (19030) returned to ErickSayajin
ErickSayajin collected 8200 from pot
ErickSayajin: doesn't show hand 
*** SUMMARY ***
Total pot 8200 | Rake 0 
Board [Th 2h 2d]
Seat 2: ErickSayajin (button) (small blind) collected (8200)
Seat 7: jcarlos.vale (big blind) folded on the Flop



PokerStars Hand #220862577862: Tournament #3060068759, $0.23+$0.02 USD Hold'em No Limit - Level XV (1000/2000) - 2020/11/28 2:48:28 EET [2020/11/27 19:48:28 ET]
Table '3060068759 5' 9-max Seat #7 is the button
Seat 2: ErickSayajin (27230 in chips) 
Seat 7: jcarlos.vale (40270 in chips) 
ErickSayajin: posts the ante 100
jcarlos.vale: posts the ante 100
jcarlos.vale: posts small blind 1000
ErickSayajin: posts big blind 2000
*** HOLE CARDS ***
Dealt to jcarlos.vale [6s 8c]
jcarlos.vale: folds 
Uncalled bet (1000) returned to ErickSayajin
ErickSayajin collected 2200 from pot
ErickSayajin: doesn't show hand 
*** SUMMARY ***
Total pot 2200 | Rake 0 
Seat 2: ErickSayajin (big blind) collected (2200)
Seat 7: jcarlos.vale (button) (small blind) folded before Flop



PokerStars Hand #220862582688: Tournament #3060068759, $0.23+$0.02 USD Hold'em No Limit - Level XV (1000/2000) - 2020/11/28 2:48:39 EET [2020/11/27 19:48:39 ET]
Table '3060068759 5' 9-max Seat #2 is the button
Seat 2: ErickSayajin (28330 in chips) 
Seat 7: jcarlos.vale (39170 in chips) 
ErickSayajin: posts the ante 100
jcarlos.vale: posts the ante 100
ErickSayajin: posts small blind 1000
jcarlos.vale: posts big blind 2000
*** HOLE CARDS ***
Dealt to jcarlos.vale [2c 3c]
ErickSayajin: calls 1000
jcarlos.vale: checks 
*** FLOP *** [Qd 7c 9d]
jcarlos.vale: checks 
ErickSayajin: bets 2100
jcarlos.vale: folds 
Uncalled bet (2100) returned to ErickSayajin
ErickSayajin collected 4200 from pot
ErickSayajin: shows [Ad Ks] (high card Ace)
*** SUMMARY ***
Total pot 4200 | Rake 0 
Board [Qd 7c 9d]
Seat 2: ErickSayajin (button) (small blind) collected (4200)
Seat 7: jcarlos.vale (big blind) folded on the Flop



PokerStars Hand #220862592416: Tournament #3060068759, $0.23+$0.02 USD Hold'em No Limit - Level XV (1000/2000) - 2020/11/28 2:49:00 EET [2020/11/27 19:49:00 ET]
Table '3060068759 5' 9-max Seat #7 is the button
Seat 2: ErickSayajin (30430 in chips) 
Seat 7: jcarlos.vale (37070 in chips) 
ErickSayajin: posts the ante 100
jcarlos.vale: posts the ante 100
jcarlos.vale: posts small blind 1000
ErickSayajin: posts big blind 2000
*** HOLE CARDS ***
Dealt to jcarlos.vale [5h 9h]
jcarlos.vale: raises 3200 to 5200
ErickSayajin: folds 
Uncalled bet (3200) returned to jcarlos.vale
jcarlos.vale collected 4200 from pot
jcarlos.vale: doesn't show hand 
*** SUMMARY ***
Total pot 4200 | Rake 0 
Seat 2: ErickSayajin (big blind) folded before Flop
Seat 7: jcarlos.vale (button) (small blind) collected (4200)



PokerStars Hand #220862598533: Tournament #3060068759, $0.23+$0.02 USD Hold'em No Limit - Level XV (1000/2000) - 2020/11/28 2:49:14 EET [2020/11/27 19:49:14 ET]
Table '3060068759 5' 9-max Seat #2 is the button
Seat 2: ErickSayajin (28330 in chips) 
Seat 7: jcarlos.vale (39170 in chips) 
ErickSayajin: posts the ante 100
jcarlos.vale: posts the ante 100
ErickSayajin: posts small blind 1000
jcarlos.vale: posts big blind 2000
*** HOLE CARDS ***
Dealt to jcarlos.vale [Tc Jc]
ErickSayajin: calls 1000
jcarlos.vale: checks 
*** FLOP *** [Kh 8d 7s]
jcarlos.vale: checks 
ErickSayajin: bets 2100
jcarlos.vale: calls 2100
*** TURN *** [Kh 8d 7s] [9d]
jcarlos.vale: checks 
ErickSayajin: checks 
*** RIVER *** [Kh 8d 7s 9d] [6d]
jcarlos.vale: bets 4200
ErickSayajin: folds 
Uncalled bet (4200) returned to jcarlos.vale
jcarlos.vale collected 8400 from pot
jcarlos.vale: doesn't show hand 
*** SUMMARY ***
Total pot 8400 | Rake 0 
Board [Kh 8d 7s 9d 6d]
Seat 2: ErickSayajin (button) (small blind) folded on the River
Seat 7: jcarlos.vale (big blind) collected (8400)



PokerStars Hand #220862617550: Tournament #3060068759, $0.23+$0.02 USD Hold'em No Limit - Level XV (1000/2000) - 2020/11/28 2:49:55 EET [2020/11/27 19:49:55 ET]
Table '3060068759 5' 9-max Seat #7 is the button
Seat 2: ErickSayajin (24130 in chips) 
Seat 7: jcarlos.vale (43370 in chips) 
ErickSayajin: posts the ante 100
jcarlos.vale: posts the ante 100
jcarlos.vale: posts small blind 1000
ErickSayajin: posts big blind 2000
*** HOLE CARDS ***
Dealt to jcarlos.vale [5d 9c]
jcarlos.vale: folds 
Uncalled bet (1000) returned to ErickSayajin
ErickSayajin collected 2200 from pot
ErickSayajin: doesn't show hand 
*** SUMMARY ***
Total pot 2200 | Rake 0 
Seat 2: ErickSayajin (big blind) collected (2200)
Seat 7: jcarlos.vale (button) (small blind) folded before Flop



PokerStars Hand #220862622130: Tournament #3060068759, $0.23+$0.02 USD Hold'em No Limit - Level XV (1000/2000) - 2020/11/28 2:50:05 EET [2020/11/27 19:50:05 ET]
Table '3060068759 5' 9-max Seat #2 is the button
Seat 2: ErickSayajin (25230 in chips) 
Seat 7: jcarlos.vale (42270 in chips) 
ErickSayajin: posts the ante 100
jcarlos.vale: posts the ante 100
ErickSayajin: posts small blind 1000
jcarlos.vale: posts big blind 2000
*** HOLE CARDS ***
Dealt to jcarlos.vale [3s 2c]
ErickSayajin: calls 1000
jcarlos.vale: checks 
*** FLOP *** [2d 4s 6h]
jcarlos.vale: bets 2100
ErickSayajin: calls 2100
*** TURN *** [2d 4s 6h] [Tc]
jcarlos.vale: bets 4200
ErickSayajin: folds 
Uncalled bet (4200) returned to jcarlos.vale
jcarlos.vale collected 8400 from pot
jcarlos.vale: doesn't show hand 
*** SUMMARY ***
Total pot 8400 | Rake 0 
Board [2d 4s 6h Tc]
Seat 2: ErickSayajin (button) (small blind) folded on the Turn
Seat 7: jcarlos.vale (big blind) collected (8400)



PokerStars Hand #220862633043: Tournament #3060068759, $0.23+$0.02 USD Hold'em No Limit - Level XVI (1500/3000) - 2020/11/28 2:50:30 EET [2020/11/27 19:50:30 ET]
Table '3060068759 5' 9-max Seat #7 is the button
Seat 2: ErickSayajin (21030 in chips) 
Seat 7: jcarlos.vale (46470 in chips) 
ErickSayajin: posts the ante 150
jcarlos.vale: posts the ante 150
jcarlos.vale: posts small blind 1500
ErickSayajin: posts big blind 3000
*** HOLE CARDS ***
Dealt to jcarlos.vale [4d 3h]
jcarlos.vale: folds 
Uncalled bet (1500) returned to ErickSayajin
ErickSayajin collected 3300 from pot
ErickSayajin: doesn't show hand 
*** SUMMARY ***
Total pot 3300 | Rake 0 
Seat 2: ErickSayajin (big blind) collected (3300)
Seat 7: jcarlos.vale (button) (small blind) folded before Flop



PokerStars Hand #220862637618: Tournament #3060068759, $0.23+$0.02 USD Hold'em No Limit - Level XVI (1500/3000) - 2020/11/28 2:50:40 EET [2020/11/27 19:50:40 ET]
Table '3060068759 5' 9-max Seat #2 is the button
Seat 2: ErickSayajin (22680 in chips) 
Seat 7: jcarlos.vale (44820 in chips) 
ErickSayajin: posts the ante 150
jcarlos.vale: posts the ante 150
ErickSayajin: posts small blind 1500
jcarlos.vale: posts big blind 3000
*** HOLE CARDS ***
Dealt to jcarlos.vale [Ts 8h]
ErickSayajin: folds 
Uncalled bet (1500) returned to jcarlos.vale
jcarlos.vale collected 3300 from pot
jcarlos.vale: doesn't show hand 
*** SUMMARY ***
Total pot 3300 | Rake 0 
Seat 2: ErickSayajin (button) (small blind) folded before Flop
Seat 7: jcarlos.vale (big blind) collected (3300)



PokerStars Hand #220862643708: Tournament #3060068759, $0.23+$0.02 USD Hold'em No Limit - Level XVI (1500/3000) - 2020/11/28 2:50:53 EET [2020/11/27 19:50:53 ET]
Table '3060068759 5' 9-max Seat #7 is the button
Seat 2: ErickSayajin (21030 in chips) 
Seat 7: jcarlos.vale (46470 in chips) 
ErickSayajin: posts the ante 150
jcarlos.vale: posts the ante 150
jcarlos.vale: posts small blind 1500
ErickSayajin: posts big blind 3000
*** HOLE CARDS ***
Dealt to jcarlos.vale [7c 4c]
jcarlos.vale: raises 4800 to 7800
ErickSayajin: raises 13080 to 20880 and is all-in
jcarlos.vale: folds 
Uncalled bet (13080) returned to ErickSayajin
ErickSayajin collected 15900 from pot
ErickSayajin: doesn't show hand 
*** SUMMARY ***
Total pot 15900 | Rake 0 
Seat 2: ErickSayajin (big blind) collected (15900)
Seat 7: jcarlos.vale (button) (small blind) folded before Flop



PokerStars Hand #220862650841: Tournament #3060068759, $0.23+$0.02 USD Hold'em No Limit - Level XVI (1500/3000) - 2020/11/28 2:51:09 EET [2020/11/27 19:51:09 ET]
Table '3060068759 5' 9-max Seat #2 is the button
Seat 2: ErickSayajin (28980 in chips) 
Seat 7: jcarlos.vale (38520 in chips) 
ErickSayajin: posts the ante 150
jcarlos.vale: posts the ante 150
ErickSayajin: posts small blind 1500
jcarlos.vale: posts big blind 3000
*** HOLE CARDS ***
Dealt to jcarlos.vale [Ah 6d]
ErickSayajin: raises 6000 to 9000
jcarlos.vale: folds 
Uncalled bet (6000) returned to ErickSayajin
ErickSayajin collected 6300 from pot
ErickSayajin: doesn't show hand 
*** SUMMARY ***
Total pot 6300 | Rake 0 
Seat 2: ErickSayajin (button) (small blind) collected (6300)
Seat 7: jcarlos.vale (big blind) folded before Flop



PokerStars Hand #220862657130: Tournament #3060068759, $0.23+$0.02 USD Hold'em No Limit - Level XVI (1500/3000) - 2020/11/28 2:51:23 EET [2020/11/27 19:51:23 ET]
Table '3060068759 5' 9-max Seat #7 is the button
Seat 2: ErickSayajin (32130 in chips) 
Seat 7: jcarlos.vale (35370 in chips) 
ErickSayajin: posts the ante 150
jcarlos.vale: posts the ante 150
jcarlos.vale: posts small blind 1500
ErickSayajin: posts big blind 3000
*** HOLE CARDS ***
Dealt to jcarlos.vale [Ac 6d]
jcarlos.vale: raises 4800 to 7800
ErickSayajin: folds 
Uncalled bet (4800) returned to jcarlos.vale
jcarlos.vale collected 6300 from pot
jcarlos.vale: doesn't show hand 
*** SUMMARY ***
Total pot 6300 | Rake 0 
Seat 2: ErickSayajin (big blind) folded before Flop
Seat 7: jcarlos.vale (button) (small blind) collected (6300)



PokerStars Hand #220862671966: Tournament #3060068759, $0.23+$0.02 USD Hold'em No Limit - Level XVI (1500/3000) - 2020/11/28 2:51:37 EET [2020/11/27 19:51:37 ET]
Table '3060068759 5' 9-max Seat #2 is the button
Seat 2: ErickSayajin (28980 in chips) 
Seat 7: jcarlos.vale (38520 in chips) 
ErickSayajin: posts the ante 150
jcarlos.vale: posts the ante 150
ErickSayajin: posts small blind 1500
jcarlos.vale: posts big blind 3000
*** HOLE CARDS ***
Dealt to jcarlos.vale [8c Jd]
ErickSayajin: calls 1500
jcarlos.vale: checks 
*** FLOP *** [4s Qd 6s]
jcarlos.vale: checks 
ErickSayajin: bets 3150
jcarlos.vale: folds 
Uncalled bet (3150) returned to ErickSayajin
ErickSayajin collected 6300 from pot
ErickSayajin: doesn't show hand 
*** SUMMARY ***
Total pot 6300 | Rake 0 
Board [4s Qd 6s]
Seat 2: ErickSayajin (button) (small blind) collected (6300)
Seat 7: jcarlos.vale (big blind) folded on the Flop



PokerStars Hand #220862682265: Tournament #3060068759, $0.23+$0.02 USD Hold'em No Limit - Level XVI (1500/3000) - 2020/11/28 2:51:59 EET [2020/11/27 19:51:59 ET]
Table '3060068759 5' 9-max Seat #7 is the button
Seat 2: ErickSayajin (32130 in chips) 
Seat 7: jcarlos.vale (35370 in chips) 
ErickSayajin: posts the ante 150
jcarlos.vale: posts the ante 150
jcarlos.vale: posts small blind 1500
ErickSayajin: posts big blind 3000
*** HOLE CARDS ***
Dealt to jcarlos.vale [Qh 8c]
jcarlos.vale: raises 4800 to 7800
ErickSayajin: folds 
Uncalled bet (4800) returned to jcarlos.vale
jcarlos.vale collected 6300 from pot
jcarlos.vale: doesn't show hand 
*** SUMMARY ***
Total pot 6300 | Rake 0 
Seat 2: ErickSayajin (big blind) folded before Flop
Seat 7: jcarlos.vale (button) (small blind) collected (6300)



PokerStars Hand #220862687444: Tournament #3060068759, $0.23+$0.02 USD Hold'em No Limit - Level XVI (1500/3000) - 2020/11/28 2:52:11 EET [2020/11/27 19:52:11 ET]
Table '3060068759 5' 9-max Seat #2 is the button
Seat 2: ErickSayajin (28980 in chips) 
Seat 7: jcarlos.vale (38520 in chips) 
ErickSayajin: posts the ante 150
jcarlos.vale: posts the ante 150
ErickSayajin: posts small blind 1500
jcarlos.vale: posts big blind 3000
*** HOLE CARDS ***
Dealt to jcarlos.vale [As 9d]
ErickSayajin: raises 3000 to 6000
jcarlos.vale: raises 32370 to 38370 and is all-in
ErickSayajin: folds 
Uncalled bet (32370) returned to jcarlos.vale
jcarlos.vale collected 12300 from pot
jcarlos.vale: doesn't show hand 
*** SUMMARY ***
Total pot 12300 | Rake 0 
Seat 2: ErickSayajin (button) (small blind) folded before Flop
Seat 7: jcarlos.vale (big blind) collected (12300)



PokerStars Hand #220862695236: Tournament #3060068759, $0.23+$0.02 USD Hold'em No Limit - Level XVI (1500/3000) - 2020/11/28 2:52:28 EET [2020/11/27 19:52:28 ET]
Table '3060068759 5' 9-max Seat #7 is the button
Seat 2: ErickSayajin (22830 in chips) 
Seat 7: jcarlos.vale (44670 in chips) 
ErickSayajin: posts the ante 150
jcarlos.vale: posts the ante 150
jcarlos.vale: posts small blind 1500
ErickSayajin: posts big blind 3000
*** HOLE CARDS ***
Dealt to jcarlos.vale [4d Ts]
jcarlos.vale: folds 
Uncalled bet (1500) returned to ErickSayajin
ErickSayajin collected 3300 from pot
ErickSayajin: doesn't show hand 
*** SUMMARY ***
Total pot 3300 | Rake 0 
Seat 2: ErickSayajin (big blind) collected (3300)
Seat 7: jcarlos.vale (button) (small blind) folded before Flop



PokerStars Hand #220862699849: Tournament #3060068759, $0.23+$0.02 USD Hold'em No Limit - Level XVI (1500/3000) - 2020/11/28 2:52:38 EET [2020/11/27 19:52:38 ET]
Table '3060068759 5' 9-max Seat #2 is the button
Seat 2: ErickSayajin (24480 in chips) 
Seat 7: jcarlos.vale (43020 in chips) 
ErickSayajin: posts the ante 150
jcarlos.vale: posts the ante 150
ErickSayajin: posts small blind 1500
jcarlos.vale: posts big blind 3000
*** HOLE CARDS ***
Dealt to jcarlos.vale [Th 7c]
ErickSayajin: raises 21330 to 24330 and is all-in
jcarlos.vale: folds 
Uncalled bet (21330) returned to ErickSayajin
ErickSayajin collected 6300 from pot
ErickSayajin: doesn't show hand 
*** SUMMARY ***
Total pot 6300 | Rake 0 
Seat 2: ErickSayajin (button) (small blind) collected (6300)
Seat 7: jcarlos.vale (big blind) folded before Flop



PokerStars Hand #220862706479: Tournament #3060068759, $0.23+$0.02 USD Hold'em No Limit - Level XVI (1500/3000) - 2020/11/28 2:52:53 EET [2020/11/27 19:52:53 ET]
Table '3060068759 5' 9-max Seat #7 is the button
Seat 2: ErickSayajin (27630 in chips) 
Seat 7: jcarlos.vale (39870 in chips) 
ErickSayajin: posts the ante 150
jcarlos.vale: posts the ante 150
jcarlos.vale: posts small blind 1500
ErickSayajin: posts big blind 3000
*** HOLE CARDS ***
Dealt to jcarlos.vale [As 7d]
jcarlos.vale: raises 36720 to 39720 and is all-in
ErickSayajin: calls 24480 and is all-in
Uncalled bet (12240) returned to jcarlos.vale
*** FLOP *** [4d Kc 5d]
*** TURN *** [4d Kc 5d] [7h]
*** RIVER *** [4d Kc 5d 7h] [Jc]
*** SHOW DOWN ***
ErickSayajin: shows [Kd Ah] (a pair of Kings)
jcarlos.vale: shows [As 7d] (a pair of Sevens)
jcarlos.vale said, "lol"
ErickSayajin collected 55260 from pot
ErickSayajin said, "kkkk"
*** SUMMARY ***
Total pot 55260 | Rake 0 
Board [4d Kc 5d 7h Jc]
Seat 2: ErickSayajin (big blind) showed [Kd Ah] and won (55260) with a pair of Kings
Seat 7: jcarlos.vale (button) (small blind) showed [As 7d] and lost with a pair of Sevens



