PokerStars Hand #221731643739: Tournament #3079057742, $0.98+$0.12 USD Hold'em No Limit - Level I (15/30) - 2020/12/22 22:30:06 EET [2020/12/22 15:30:06 ET]
Table '3079057742 3' 9-max Seat #1 is the button
Seat 1: patapila (3000 in chips) 
Seat 2: marquitopoker4 (3000 in chips) 
Seat 3: hoz007 (3000 in chips) 
Seat 4: Suba778 (3000 in chips) 
Seat 5: Willcs02 (3000 in chips) 
Seat 6: honkelic (3000 in chips) 
Seat 7: qw303 (3000 in chips) 
Seat 8: jcarlos.vale (3000 in chips) 
Seat 9: mao1114 (3000 in chips) 
patapila: posts the ante 4
marquitopoker4: posts the ante 4
hoz007: posts the ante 4
Suba778: posts the ante 4
Willcs02: posts the ante 4
honkelic: posts the ante 4
qw303: posts the ante 4
jcarlos.vale: posts the ante 4
mao1114: posts the ante 4
marquitopoker4: posts small blind 15
hoz007: posts big blind 30
*** HOLE CARDS ***
Dealt to jcarlos.vale [Js 3s]
Suba778: folds 
Willcs02: folds 
honkelic: calls 30
qw303: folds 
jcarlos.vale: folds 
mao1114: calls 30
patapila: calls 30
marquitopoker4: folds 
hoz007: checks 
*** FLOP *** [Kc 3h 4h]
hoz007: checks 
honkelic: checks 
mao1114: checks 
patapila: bets 2966 and is all-in
hoz007: folds 
honkelic: calls 2966 and is all-in
mao1114: folds 
*** TURN *** [Kc 3h 4h] [5h]
*** RIVER *** [Kc 3h 4h 5h] [7s]
*** SHOW DOWN ***
honkelic: shows [Ah Th] (a flush, Ace high)
patapila: shows [8h Ks] (a pair of Kings)
honkelic collected 6103 from pot
patapila finished the tournament
*** SUMMARY ***
Total pot 6103 | Rake 0 
Board [Kc 3h 4h 5h 7s]
Seat 1: patapila (button) showed [8h Ks] and lost with a pair of Kings
Seat 2: marquitopoker4 (small blind) folded before Flop
Seat 3: hoz007 (big blind) folded on the Flop
Seat 4: Suba778 folded before Flop (didn't bet)
Seat 5: Willcs02 folded before Flop (didn't bet)
Seat 6: honkelic showed [Ah Th] and won (6103) with a flush, Ace high
Seat 7: qw303 folded before Flop (didn't bet)
Seat 8: jcarlos.vale folded before Flop (didn't bet)
Seat 9: mao1114 folded on the Flop



PokerStars Hand #221731693860: Tournament #3079057742, $0.98+$0.12 USD Hold'em No Limit - Level I (15/30) - 2020/12/22 22:31:20 EET [2020/12/22 15:31:20 ET]
Table '3079057742 3' 9-max Seat #2 is the button
Seat 2: marquitopoker4 (2981 in chips) 
Seat 3: hoz007 (2966 in chips) 
Seat 4: Suba778 (2996 in chips) 
Seat 5: Willcs02 (2996 in chips) 
Seat 6: honkelic (6103 in chips) 
Seat 7: qw303 (2996 in chips) 
Seat 8: jcarlos.vale (2996 in chips) 
Seat 9: mao1114 (2966 in chips) 
marquitopoker4: posts the ante 4
hoz007: posts the ante 4
Suba778: posts the ante 4
Willcs02: posts the ante 4
honkelic: posts the ante 4
qw303: posts the ante 4
jcarlos.vale: posts the ante 4
mao1114: posts the ante 4
hoz007: posts small blind 15
Suba778: posts big blind 30
*** HOLE CARDS ***
Dealt to jcarlos.vale [2d 5s]
Willcs02: folds 
honkelic: folds 
qw303: folds 
jcarlos.vale: folds 
mao1114: calls 30
marquitopoker4: folds 
hoz007: calls 15
Suba778: checks 
*** FLOP *** [Ad Th 5d]
hoz007: checks 
Suba778: checks 
mao1114: checks 
*** TURN *** [Ad Th 5d] [Qd]
hoz007: checks 
Suba778: checks 
mao1114: bets 240
hoz007: folds 
Suba778: folds 
Uncalled bet (240) returned to mao1114
mao1114 collected 122 from pot
mao1114: doesn't show hand 
*** SUMMARY ***
Total pot 122 | Rake 0 
Board [Ad Th 5d Qd]
Seat 2: marquitopoker4 (button) folded before Flop (didn't bet)
Seat 3: hoz007 (small blind) folded on the Turn
Seat 4: Suba778 (big blind) folded on the Turn
Seat 5: Willcs02 folded before Flop (didn't bet)
Seat 6: honkelic folded before Flop (didn't bet)
Seat 7: qw303 folded before Flop (didn't bet)
Seat 8: jcarlos.vale folded before Flop (didn't bet)
Seat 9: mao1114 collected (122)



PokerStars Hand #221731728573: Tournament #3079057742, $0.98+$0.12 USD Hold'em No Limit - Level I (15/30) - 2020/12/22 22:32:11 EET [2020/12/22 15:32:11 ET]
Table '3079057742 3' 9-max Seat #3 is the button
Seat 1: SimoneD29 (3000 in chips) 
Seat 2: marquitopoker4 (2977 in chips) 
Seat 3: hoz007 (2932 in chips) 
Seat 4: Suba778 (2962 in chips) 
Seat 5: Willcs02 (2992 in chips) 
Seat 6: honkelic (6099 in chips) 
Seat 7: qw303 (2992 in chips) 
Seat 8: jcarlos.vale (2992 in chips) 
Seat 9: mao1114 (3054 in chips) 
SimoneD29: posts the ante 4
marquitopoker4: posts the ante 4
hoz007: posts the ante 4
Suba778: posts the ante 4
Willcs02: posts the ante 4
honkelic: posts the ante 4
qw303: posts the ante 4
jcarlos.vale: posts the ante 4
mao1114: posts the ante 4
Suba778: posts small blind 15
Willcs02: posts big blind 30
*** HOLE CARDS ***
Dealt to jcarlos.vale [9d 4d]
honkelic: folds 
qw303: folds 
jcarlos.vale: folds 
mao1114: folds 
SimoneD29: folds 
marquitopoker4: folds 
hoz007: calls 30
Suba778: raises 90 to 120
Willcs02: calls 90
hoz007: calls 90
*** FLOP *** [Ts 3d 7d]
Suba778: bets 198
Willcs02: calls 198
hoz007: folds 
*** TURN *** [Ts 3d 7d] [5d]
Suba778: bets 396
Willcs02: folds 
Uncalled bet (396) returned to Suba778
Suba778 collected 792 from pot
Suba778: doesn't show hand 
*** SUMMARY ***
Total pot 792 | Rake 0 
Board [Ts 3d 7d 5d]
Seat 1: SimoneD29 folded before Flop (didn't bet)
Seat 2: marquitopoker4 folded before Flop (didn't bet)
Seat 3: hoz007 (button) folded on the Flop
Seat 4: Suba778 (small blind) collected (792)
Seat 5: Willcs02 (big blind) folded on the Turn
Seat 6: honkelic folded before Flop (didn't bet)
Seat 7: qw303 folded before Flop (didn't bet)
Seat 8: jcarlos.vale folded before Flop (didn't bet)
Seat 9: mao1114 folded before Flop (didn't bet)



PokerStars Hand #221731778728: Tournament #3079057742, $0.98+$0.12 USD Hold'em No Limit - Level I (15/30) - 2020/12/22 22:33:25 EET [2020/12/22 15:33:25 ET]
Table '3079057742 3' 9-max Seat #4 is the button
Seat 1: SimoneD29 (2996 in chips) 
Seat 2: marquitopoker4 (2973 in chips) 
Seat 3: hoz007 (2808 in chips) 
Seat 4: Suba778 (3432 in chips) 
Seat 5: Willcs02 (2670 in chips) 
Seat 6: honkelic (6095 in chips) 
Seat 7: qw303 (2988 in chips) 
Seat 8: jcarlos.vale (2988 in chips) 
Seat 9: mao1114 (3050 in chips) 
SimoneD29: posts the ante 4
marquitopoker4: posts the ante 4
hoz007: posts the ante 4
Suba778: posts the ante 4
Willcs02: posts the ante 4
honkelic: posts the ante 4
qw303: posts the ante 4
jcarlos.vale: posts the ante 4
mao1114: posts the ante 4
Willcs02: posts small blind 15
honkelic: posts big blind 30
*** HOLE CARDS ***
Dealt to jcarlos.vale [Kh Jd]
qw303: folds 
jcarlos.vale: raises 48 to 78
mao1114: folds 
SimoneD29: raises 48 to 126
marquitopoker4: folds 
hoz007: calls 126
Suba778: folds 
Willcs02: raises 432 to 558
honkelic: folds 
jcarlos.vale: folds 
SimoneD29: calls 432
hoz007: folds 
*** FLOP *** [Kc 6d 6c]
Willcs02: bets 693
SimoneD29: raises 693 to 1386
Willcs02: raises 722 to 2108 and is all-in
SimoneD29: calls 722
*** TURN *** [Kc 6d 6c] [Ts]
*** RIVER *** [Kc 6d 6c Ts] [5h]
*** SHOW DOWN ***
Willcs02: shows [Ac As] (two pair, Aces and Sixes)
SimoneD29: shows [2h Kd] (two pair, Kings and Sixes)
Willcs02 collected 5602 from pot
*** SUMMARY ***
Total pot 5602 | Rake 0 
Board [Kc 6d 6c Ts 5h]
Seat 1: SimoneD29 showed [2h Kd] and lost with two pair, Kings and Sixes
Seat 2: marquitopoker4 folded before Flop (didn't bet)
Seat 3: hoz007 folded before Flop
Seat 4: Suba778 (button) folded before Flop (didn't bet)
Seat 5: Willcs02 (small blind) showed [Ac As] and won (5602) with two pair, Aces and Sixes
Seat 6: honkelic (big blind) folded before Flop
Seat 7: qw303 folded before Flop (didn't bet)
Seat 8: jcarlos.vale folded before Flop
Seat 9: mao1114 folded before Flop (didn't bet)



PokerStars Hand #221731821633: Tournament #3079057742, $0.98+$0.12 USD Hold'em No Limit - Level I (15/30) - 2020/12/22 22:34:28 EET [2020/12/22 15:34:28 ET]
Table '3079057742 3' 9-max Seat #5 is the button
Seat 1: SimoneD29 (326 in chips) 
Seat 2: marquitopoker4 (2969 in chips) 
Seat 3: hoz007 (2678 in chips) 
Seat 4: Suba778 (3428 in chips) 
Seat 5: Willcs02 (5602 in chips) 
Seat 6: honkelic (6061 in chips) 
Seat 7: qw303 (2984 in chips) 
Seat 8: jcarlos.vale (2906 in chips) 
Seat 9: mao1114 (3046 in chips) 
SimoneD29: posts the ante 4
marquitopoker4: posts the ante 4
hoz007: posts the ante 4
Suba778: posts the ante 4
Willcs02: posts the ante 4
honkelic: posts the ante 4
qw303: posts the ante 4
jcarlos.vale: posts the ante 4
mao1114: posts the ante 4
honkelic: posts small blind 15
qw303: posts big blind 30
*** HOLE CARDS ***
Dealt to jcarlos.vale [Kd Jd]
jcarlos.vale: raises 48 to 78
mao1114: calls 78
SimoneD29: raises 244 to 322 and is all-in
marquitopoker4: folds 
hoz007: folds 
Suba778: calls 322
Willcs02: calls 322
honkelic: calls 307
qw303: folds 
jcarlos.vale: calls 244
mao1114: folds 
*** FLOP *** [Kc 5h Ah]
honkelic: checks 
jcarlos.vale: checks 
Suba778: checks 
Willcs02: checks 
*** TURN *** [Kc 5h Ah] [Kh]
honkelic: checks 
jcarlos.vale: bets 1316
Suba778: folds 
Willcs02: folds 
honkelic: folds 
Uncalled bet (1316) returned to jcarlos.vale
*** RIVER *** [Kc 5h Ah Kh] [2d]
*** SHOW DOWN ***
jcarlos.vale: shows [Kd Jd] (three of a kind, Kings)
SimoneD29: shows [5c 4c] (two pair, Kings and Fives)
jcarlos.vale collected 1754 from pot
SimoneD29 finished the tournament
*** SUMMARY ***
Total pot 1754 | Rake 0 
Board [Kc 5h Ah Kh 2d]
Seat 1: SimoneD29 showed [5c 4c] and lost with two pair, Kings and Fives
Seat 2: marquitopoker4 folded before Flop (didn't bet)
Seat 3: hoz007 folded before Flop (didn't bet)
Seat 4: Suba778 folded on the Turn
Seat 5: Willcs02 (button) folded on the Turn
Seat 6: honkelic (small blind) folded on the Turn
Seat 7: qw303 (big blind) folded before Flop
Seat 8: jcarlos.vale showed [Kd Jd] and won (1754) with three of a kind, Kings
Seat 9: mao1114 folded before Flop



PokerStars Hand #221731862940: Tournament #3079057742, $0.98+$0.12 USD Hold'em No Limit - Level I (15/30) - 2020/12/22 22:35:29 EET [2020/12/22 15:35:29 ET]
Table '3079057742 3' 9-max Seat #6 is the button
Seat 2: marquitopoker4 (2965 in chips) 
Seat 3: hoz007 (2674 in chips) 
Seat 4: Suba778 (3102 in chips) 
Seat 5: Willcs02 (5276 in chips) 
Seat 6: honkelic (5735 in chips) 
Seat 7: qw303 (2950 in chips) 
Seat 8: jcarlos.vale (4334 in chips) 
Seat 9: mao1114 (2964 in chips) 
marquitopoker4: posts the ante 4
hoz007: posts the ante 4
Suba778: posts the ante 4
Willcs02: posts the ante 4
honkelic: posts the ante 4
qw303: posts the ante 4
jcarlos.vale: posts the ante 4
mao1114: posts the ante 4
qw303: posts small blind 15
jcarlos.vale: posts big blind 30
*** HOLE CARDS ***
Dealt to jcarlos.vale [4d 3h]
mao1114: calls 30
marquitopoker4: folds 
hoz007: calls 30
Suba778: folds 
Willcs02: folds 
honkelic: folds 
qw303: folds 
jcarlos.vale: checks 
*** FLOP *** [As Ks 8h]
jcarlos.vale: checks 
mao1114: checks 
hoz007: bets 30
jcarlos.vale: folds 
mao1114: calls 30
*** TURN *** [As Ks 8h] [4h]
mao1114: checks 
hoz007: bets 30
mao1114: folds 
Uncalled bet (30) returned to hoz007
hoz007 collected 197 from pot
hoz007: doesn't show hand 
*** SUMMARY ***
Total pot 197 | Rake 0 
Board [As Ks 8h 4h]
Seat 2: marquitopoker4 folded before Flop (didn't bet)
Seat 3: hoz007 collected (197)
Seat 4: Suba778 folded before Flop (didn't bet)
Seat 5: Willcs02 folded before Flop (didn't bet)
Seat 6: honkelic (button) folded before Flop (didn't bet)
Seat 7: qw303 (small blind) folded before Flop
Seat 8: jcarlos.vale (big blind) folded on the Flop
Seat 9: mao1114 folded on the Turn



PokerStars Hand #221731902967: Tournament #3079057742, $0.98+$0.12 USD Hold'em No Limit - Level I (15/30) - 2020/12/22 22:36:27 EET [2020/12/22 15:36:27 ET]
Table '3079057742 3' 9-max Seat #7 is the button
Seat 1: czini007 (3000 in chips) 
Seat 2: marquitopoker4 (2961 in chips) 
Seat 3: hoz007 (2807 in chips) 
Seat 4: Suba778 (3098 in chips) 
Seat 5: Willcs02 (5272 in chips) 
Seat 6: honkelic (5731 in chips) 
Seat 7: qw303 (2931 in chips) 
Seat 8: jcarlos.vale (4300 in chips) 
Seat 9: mao1114 (2900 in chips) 
czini007: posts the ante 4
marquitopoker4: posts the ante 4
hoz007: posts the ante 4
Suba778: posts the ante 4
Willcs02: posts the ante 4
honkelic: posts the ante 4
qw303: posts the ante 4
jcarlos.vale: posts the ante 4
mao1114: posts the ante 4
jcarlos.vale: posts small blind 15
mao1114: posts big blind 30
*** HOLE CARDS ***
Dealt to jcarlos.vale [5c 8h]
czini007: raises 30 to 60
marquitopoker4: folds 
hoz007: calls 60
Suba778: folds 
Willcs02: folds 
honkelic: calls 60
qw303: folds 
jcarlos.vale: folds 
mao1114: calls 30
*** FLOP *** [4s 6d 6h]
mao1114: checks 
czini007: checks 
hoz007: checks 
honkelic: bets 146
mao1114: folds 
czini007: calls 146
hoz007: folds 
*** TURN *** [4s 6d 6h] [3c]
czini007: checks 
honkelic: checks 
*** RIVER *** [4s 6d 6h 3c] [4h]
czini007: bets 270
honkelic: calls 270
*** SHOW DOWN ***
czini007: shows [As 5s] (two pair, Sixes and Fours)
honkelic: shows [Th Ac] (two pair, Sixes and Fours)
czini007 collected 562 from pot
honkelic collected 561 from pot
*** SUMMARY ***
Total pot 1123 | Rake 0 
Board [4s 6d 6h 3c 4h]
Seat 1: czini007 showed [As 5s] and won (562) with two pair, Sixes and Fours
Seat 2: marquitopoker4 folded before Flop (didn't bet)
Seat 3: hoz007 folded on the Flop
Seat 4: Suba778 folded before Flop (didn't bet)
Seat 5: Willcs02 folded before Flop (didn't bet)
Seat 6: honkelic showed [Th Ac] and won (561) with two pair, Sixes and Fours
Seat 7: qw303 (button) folded before Flop (didn't bet)
Seat 8: jcarlos.vale (small blind) folded before Flop
Seat 9: mao1114 (big blind) folded on the Flop



PokerStars Hand #221731941172: Tournament #3079057742, $0.98+$0.12 USD Hold'em No Limit - Level I (15/30) - 2020/12/22 22:37:23 EET [2020/12/22 15:37:23 ET]
Table '3079057742 3' 9-max Seat #8 is the button
Seat 1: czini007 (3082 in chips) 
Seat 2: marquitopoker4 (2957 in chips) 
Seat 3: hoz007 (2743 in chips) 
Seat 4: Suba778 (3094 in chips) 
Seat 5: Willcs02 (5268 in chips) 
Seat 6: honkelic (5812 in chips) 
Seat 7: qw303 (2927 in chips) 
Seat 8: jcarlos.vale (4281 in chips) 
Seat 9: mao1114 (2836 in chips) 
czini007: posts the ante 4
marquitopoker4: posts the ante 4
hoz007: posts the ante 4
Suba778: posts the ante 4
Willcs02: posts the ante 4
honkelic: posts the ante 4
qw303: posts the ante 4
jcarlos.vale: posts the ante 4
mao1114: posts the ante 4
mao1114: posts small blind 15
czini007: posts big blind 30
*** HOLE CARDS ***
Dealt to jcarlos.vale [7s 6d]
marquitopoker4: folds 
hoz007: calls 30
Suba778: folds 
Willcs02: folds 
honkelic: calls 30
qw303: folds 
jcarlos.vale: folds 
mao1114: folds 
czini007: raises 30 to 60
hoz007: calls 30
honkelic: calls 30
*** FLOP *** [8d 3c 4s]
czini007: bets 116
hoz007: raises 2563 to 2679 and is all-in
honkelic: folds 
czini007: folds 
Uncalled bet (2563) returned to hoz007
hoz007 collected 463 from pot
hoz007: doesn't show hand 
*** SUMMARY ***
Total pot 463 | Rake 0 
Board [8d 3c 4s]
Seat 1: czini007 (big blind) folded on the Flop
Seat 2: marquitopoker4 folded before Flop (didn't bet)
Seat 3: hoz007 collected (463)
Seat 4: Suba778 folded before Flop (didn't bet)
Seat 5: Willcs02 folded before Flop (didn't bet)
Seat 6: honkelic folded on the Flop
Seat 7: qw303 folded before Flop (didn't bet)
Seat 8: jcarlos.vale (button) folded before Flop (didn't bet)
Seat 9: mao1114 (small blind) folded before Flop



PokerStars Hand #221731975328: Tournament #3079057742, $0.98+$0.12 USD Hold'em No Limit - Level I (15/30) - 2020/12/22 22:38:13 EET [2020/12/22 15:38:13 ET]
Table '3079057742 3' 9-max Seat #9 is the button
Seat 1: czini007 (2902 in chips) 
Seat 2: marquitopoker4 (2953 in chips) 
Seat 3: hoz007 (3026 in chips) 
Seat 4: Suba778 (3090 in chips) 
Seat 5: Willcs02 (5264 in chips) 
Seat 6: honkelic (5748 in chips) 
Seat 7: qw303 (2923 in chips) 
Seat 8: jcarlos.vale (4277 in chips) 
Seat 9: mao1114 (2817 in chips) 
czini007: posts the ante 4
marquitopoker4: posts the ante 4
hoz007: posts the ante 4
Suba778: posts the ante 4
Willcs02: posts the ante 4
honkelic: posts the ante 4
qw303: posts the ante 4
jcarlos.vale: posts the ante 4
mao1114: posts the ante 4
czini007: posts small blind 15
marquitopoker4: posts big blind 30
*** HOLE CARDS ***
Dealt to jcarlos.vale [9d Ah]
hoz007: calls 30
Suba778: raises 90 to 120
Willcs02: folds 
honkelic: calls 120
qw303: folds 
jcarlos.vale: folds 
mao1114: folds 
czini007: raises 420 to 540
marquitopoker4: folds 
hoz007: folds 
Suba778: folds 
honkelic: calls 420
*** FLOP *** [8d Jh Jd]
czini007: bets 2358 and is all-in
honkelic: folds 
Uncalled bet (2358) returned to czini007
czini007 collected 1296 from pot
czini007: doesn't show hand 
*** SUMMARY ***
Total pot 1296 | Rake 0 
Board [8d Jh Jd]
Seat 1: czini007 (small blind) collected (1296)
Seat 2: marquitopoker4 (big blind) folded before Flop
Seat 3: hoz007 folded before Flop
Seat 4: Suba778 folded before Flop
Seat 5: Willcs02 folded before Flop (didn't bet)
Seat 6: honkelic folded on the Flop
Seat 7: qw303 folded before Flop (didn't bet)
Seat 8: jcarlos.vale folded before Flop (didn't bet)
Seat 9: mao1114 (button) folded before Flop (didn't bet)



PokerStars Hand #221732025236: Tournament #3079057742, $0.98+$0.12 USD Hold'em No Limit - Level I (15/30) - 2020/12/22 22:39:26 EET [2020/12/22 15:39:26 ET]
Table '3079057742 3' 9-max Seat #1 is the button
Seat 1: czini007 (3654 in chips) 
Seat 2: marquitopoker4 (2919 in chips) 
Seat 3: hoz007 (2992 in chips) 
Seat 4: Suba778 (2966 in chips) 
Seat 5: Willcs02 (5260 in chips) 
Seat 6: honkelic (5204 in chips) 
Seat 7: qw303 (2919 in chips) 
Seat 8: jcarlos.vale (4273 in chips) 
Seat 9: mao1114 (2813 in chips) 
czini007: posts the ante 4
marquitopoker4: posts the ante 4
hoz007: posts the ante 4
Suba778: posts the ante 4
Willcs02: posts the ante 4
honkelic: posts the ante 4
qw303: posts the ante 4
jcarlos.vale: posts the ante 4
mao1114: posts the ante 4
marquitopoker4: posts small blind 15
hoz007: posts big blind 30
*** HOLE CARDS ***
Dealt to jcarlos.vale [Kc 7h]
Suba778: folds 
Willcs02: folds 
honkelic: folds 
qw303: folds 
jcarlos.vale: folds 
mao1114: folds 
czini007: folds 
marquitopoker4: calls 15
hoz007: checks 
*** FLOP *** [Kd Ah 4s]
marquitopoker4: bets 31
hoz007: raises 391 to 422
marquitopoker4: folds 
Uncalled bet (391) returned to hoz007
marquitopoker4 is sitting out
marquitopoker4 has returned
marquitopoker4 is sitting out
hoz007 collected 158 from pot
marquitopoker4 has returned
hoz007: doesn't show hand 
*** SUMMARY ***
Total pot 158 | Rake 0 
Board [Kd Ah 4s]
Seat 1: czini007 (button) folded before Flop (didn't bet)
Seat 2: marquitopoker4 (small blind) folded on the Flop
Seat 3: hoz007 (big blind) collected (158)
Seat 4: Suba778 folded before Flop (didn't bet)
Seat 5: Willcs02 folded before Flop (didn't bet)
Seat 6: honkelic folded before Flop (didn't bet)
Seat 7: qw303 folded before Flop (didn't bet)
Seat 8: jcarlos.vale folded before Flop (didn't bet)
Seat 9: mao1114 folded before Flop (didn't bet)



PokerStars Hand #221732047671: Tournament #3079057742, $0.98+$0.12 USD Hold'em No Limit - Level I (15/30) - 2020/12/22 22:40:00 EET [2020/12/22 15:40:00 ET]
Table '3079057742 3' 9-max Seat #2 is the button
Seat 1: czini007 (3650 in chips) 
Seat 2: marquitopoker4 (2854 in chips) 
Seat 3: hoz007 (3085 in chips) 
Seat 4: Suba778 (2962 in chips) 
Seat 5: Willcs02 (5256 in chips) 
Seat 6: honkelic (5200 in chips) 
Seat 7: qw303 (2915 in chips) 
Seat 8: jcarlos.vale (4269 in chips) 
Seat 9: mao1114 (2809 in chips) 
czini007: posts the ante 4
marquitopoker4: posts the ante 4
hoz007: posts the ante 4
Suba778: posts the ante 4
Willcs02: posts the ante 4
honkelic: posts the ante 4
qw303: posts the ante 4
jcarlos.vale: posts the ante 4
mao1114: posts the ante 4
hoz007: posts small blind 15
Suba778: posts big blind 30
*** HOLE CARDS ***
Dealt to jcarlos.vale [8h Ad]
Willcs02: folds 
honkelic: calls 30
qw303: folds 
jcarlos.vale: folds 
mao1114: calls 30
czini007: folds 
marquitopoker4: folds 
hoz007: calls 15
Suba778: checks 
*** FLOP *** [8d 8s Th]
hoz007: checks 
Suba778: checks 
honkelic: checks 
mao1114: checks 
*** TURN *** [8d 8s Th] [3h]
hoz007: checks 
Suba778: checks 
honkelic: checks 
mao1114: bets 300
hoz007: folds 
Suba778: folds 
honkelic: calls 300
*** RIVER *** [8d 8s Th 3h] [2s]
honkelic: checks 
mao1114: bets 360
honkelic: folds 
Uncalled bet (360) returned to mao1114
mao1114 collected 756 from pot
mao1114: doesn't show hand 
*** SUMMARY ***
Total pot 756 | Rake 0 
Board [8d 8s Th 3h 2s]
Seat 1: czini007 folded before Flop (didn't bet)
Seat 2: marquitopoker4 (button) folded before Flop (didn't bet)
Seat 3: hoz007 (small blind) folded on the Turn
Seat 4: Suba778 (big blind) folded on the Turn
Seat 5: Willcs02 folded before Flop (didn't bet)
Seat 6: honkelic folded on the River
Seat 7: qw303 folded before Flop (didn't bet)
Seat 8: jcarlos.vale folded before Flop (didn't bet)
Seat 9: mao1114 collected (756)



PokerStars Hand #221732098841: Tournament #3079057742, $0.98+$0.12 USD Hold'em No Limit - Level II (20/40) - 2020/12/22 22:41:15 EET [2020/12/22 15:41:15 ET]
Table '3079057742 3' 9-max Seat #3 is the button
Seat 1: czini007 (3646 in chips) 
Seat 2: marquitopoker4 (2850 in chips) 
Seat 3: hoz007 (3051 in chips) 
Seat 4: Suba778 (2928 in chips) 
Seat 5: Willcs02 (5252 in chips) 
Seat 6: honkelic (4866 in chips) 
Seat 7: qw303 (2911 in chips) 
Seat 8: jcarlos.vale (4265 in chips) 
Seat 9: mao1114 (3231 in chips) 
czini007: posts the ante 5
marquitopoker4: posts the ante 5
hoz007: posts the ante 5
Suba778: posts the ante 5
Willcs02: posts the ante 5
honkelic: posts the ante 5
qw303: posts the ante 5
jcarlos.vale: posts the ante 5
mao1114: posts the ante 5
Suba778: posts small blind 20
Willcs02: posts big blind 40
*** HOLE CARDS ***
Dealt to jcarlos.vale [9h Qd]
honkelic: folds 
qw303: folds 
jcarlos.vale: folds 
mao1114: calls 40
czini007: folds 
marquitopoker4: calls 40
hoz007: folds 
Suba778: raises 160 to 200
Willcs02: calls 160
mao1114: calls 160
marquitopoker4: calls 160
*** FLOP *** [5c 6s 7c]
Suba778: checks 
Willcs02: checks 
mao1114: checks 
marquitopoker4: checks 
*** TURN *** [5c 6s 7c] [7s]
Suba778: checks 
Willcs02: checks 
mao1114: checks 
marquitopoker4: bets 287
Suba778: folds 
Willcs02: calls 287
mao1114: calls 287
*** RIVER *** [5c 6s 7c 7s] [Jh]
Willcs02: checks 
mao1114: bets 1706
marquitopoker4: folds 
Willcs02: folds 
Uncalled bet (1706) returned to mao1114
mao1114 collected 1706 from pot
mao1114: doesn't show hand 
*** SUMMARY ***
Total pot 1706 | Rake 0 
Board [5c 6s 7c 7s Jh]
Seat 1: czini007 folded before Flop (didn't bet)
Seat 2: marquitopoker4 folded on the River
Seat 3: hoz007 (button) folded before Flop (didn't bet)
Seat 4: Suba778 (small blind) folded on the Turn
Seat 5: Willcs02 (big blind) folded on the River
Seat 6: honkelic folded before Flop (didn't bet)
Seat 7: qw303 folded before Flop (didn't bet)
Seat 8: jcarlos.vale folded before Flop (didn't bet)
Seat 9: mao1114 collected (1706)



PokerStars Hand #221732165859: Tournament #3079057742, $0.98+$0.12 USD Hold'em No Limit - Level II (20/40) - 2020/12/22 22:42:53 EET [2020/12/22 15:42:53 ET]
Table '3079057742 3' 9-max Seat #4 is the button
Seat 1: czini007 (3641 in chips) 
Seat 2: marquitopoker4 (2358 in chips) 
Seat 3: hoz007 (3046 in chips) 
Seat 4: Suba778 (2723 in chips) 
Seat 5: Willcs02 (4760 in chips) 
Seat 6: honkelic (4861 in chips) 
Seat 7: qw303 (2906 in chips) 
Seat 8: jcarlos.vale (4260 in chips) 
Seat 9: mao1114 (4445 in chips) 
czini007: posts the ante 5
marquitopoker4: posts the ante 5
hoz007: posts the ante 5
Suba778: posts the ante 5
Willcs02: posts the ante 5
honkelic: posts the ante 5
qw303: posts the ante 5
jcarlos.vale: posts the ante 5
mao1114: posts the ante 5
Willcs02: posts small blind 20
honkelic: posts big blind 40
*** HOLE CARDS ***
Dealt to jcarlos.vale [4c 5d]
qw303: folds 
jcarlos.vale: folds 
mao1114: folds 
czini007: folds 
marquitopoker4: folds 
hoz007: calls 40
Suba778: raises 120 to 160
Willcs02: calls 140
honkelic: folds 
hoz007: calls 120
*** FLOP *** [Jh 9s Tc]
Willcs02: checks 
hoz007: bets 240
Suba778: calls 240
Willcs02: calls 240
*** TURN *** [Jh 9s Tc] [7c]
Willcs02: checks 
hoz007: bets 2641 and is all-in
Suba778: folds 
Willcs02: folds 
Uncalled bet (2641) returned to hoz007
hoz007 collected 1285 from pot
hoz007: doesn't show hand 
*** SUMMARY ***
Total pot 1285 | Rake 0 
Board [Jh 9s Tc 7c]
Seat 1: czini007 folded before Flop (didn't bet)
Seat 2: marquitopoker4 folded before Flop (didn't bet)
Seat 3: hoz007 collected (1285)
Seat 4: Suba778 (button) folded on the Turn
Seat 5: Willcs02 (small blind) folded on the Turn
Seat 6: honkelic (big blind) folded before Flop
Seat 7: qw303 folded before Flop (didn't bet)
Seat 8: jcarlos.vale folded before Flop (didn't bet)
Seat 9: mao1114 folded before Flop (didn't bet)



PokerStars Hand #221732211287: Tournament #3079057742, $0.98+$0.12 USD Hold'em No Limit - Level II (20/40) - 2020/12/22 22:44:00 EET [2020/12/22 15:44:00 ET]
Table '3079057742 3' 9-max Seat #5 is the button
Seat 1: czini007 (3636 in chips) 
Seat 2: marquitopoker4 (2353 in chips) 
Seat 3: hoz007 (3926 in chips) 
Seat 4: Suba778 (2318 in chips) 
Seat 5: Willcs02 (4355 in chips) 
Seat 6: honkelic (4816 in chips) 
Seat 7: qw303 (2901 in chips) 
Seat 8: jcarlos.vale (4255 in chips) 
Seat 9: mao1114 (4440 in chips) 
czini007: posts the ante 5
marquitopoker4: posts the ante 5
hoz007: posts the ante 5
Suba778: posts the ante 5
Willcs02: posts the ante 5
honkelic: posts the ante 5
qw303: posts the ante 5
jcarlos.vale: posts the ante 5
mao1114: posts the ante 5
honkelic: posts small blind 20
qw303: posts big blind 40
*** HOLE CARDS ***
Dealt to jcarlos.vale [Jh Kc]
jcarlos.vale: raises 64 to 104
mao1114: folds 
czini007: calls 104
marquitopoker4: raises 2216 to 2320
hoz007: folds 
Suba778: folds 
Willcs02: folds 
honkelic: folds 
qw303: folds 
jcarlos.vale: folds 
czini007: folds [Ah]
Uncalled bet (2216) returned to marquitopoker4
marquitopoker4 collected 417 from pot
marquitopoker4: doesn't show hand 
*** SUMMARY ***
Total pot 417 | Rake 0 
Seat 1: czini007 folded before Flop
Seat 2: marquitopoker4 collected (417)
Seat 3: hoz007 folded before Flop (didn't bet)
Seat 4: Suba778 folded before Flop (didn't bet)
Seat 5: Willcs02 (button) folded before Flop (didn't bet)
Seat 6: honkelic (small blind) folded before Flop
Seat 7: qw303 (big blind) folded before Flop
Seat 8: jcarlos.vale folded before Flop
Seat 9: mao1114 folded before Flop (didn't bet)



PokerStars Hand #221732242965: Tournament #3079057742, $0.98+$0.12 USD Hold'em No Limit - Level II (20/40) - 2020/12/22 22:44:46 EET [2020/12/22 15:44:46 ET]
Table '3079057742 3' 9-max Seat #6 is the button
Seat 1: czini007 (3527 in chips) 
Seat 2: marquitopoker4 (2661 in chips) 
Seat 4: Suba778 (2313 in chips) 
Seat 5: Willcs02 (4350 in chips) 
Seat 6: honkelic (4791 in chips) 
Seat 7: qw303 (2856 in chips) 
Seat 8: jcarlos.vale (4146 in chips) 
Seat 9: mao1114 (4435 in chips) 
czini007: posts the ante 5
marquitopoker4: posts the ante 5
Suba778: posts the ante 5
Willcs02: posts the ante 5
honkelic: posts the ante 5
qw303: posts the ante 5
jcarlos.vale: posts the ante 5
mao1114: posts the ante 5
qw303: posts small blind 20
jcarlos.vale: posts big blind 40
*** HOLE CARDS ***
Dealt to jcarlos.vale [7c Qd]
mao1114: folds 
czini007: folds 
marquitopoker4: raises 55 to 95
Suba778: folds 
Willcs02: folds 
honkelic: folds 
qw303: folds 
jcarlos.vale: folds 
Uncalled bet (55) returned to marquitopoker4
marquitopoker4 collected 140 from pot
marquitopoker4: doesn't show hand 
*** SUMMARY ***
Total pot 140 | Rake 0 
Seat 1: czini007 folded before Flop (didn't bet)
Seat 2: marquitopoker4 collected (140)
Seat 4: Suba778 folded before Flop (didn't bet)
Seat 5: Willcs02 folded before Flop (didn't bet)
Seat 6: honkelic (button) folded before Flop (didn't bet)
Seat 7: qw303 (small blind) folded before Flop
Seat 8: jcarlos.vale (big blind) folded before Flop
Seat 9: mao1114 folded before Flop (didn't bet)



PokerStars Hand #221732271321: Tournament #3079057742, $0.98+$0.12 USD Hold'em No Limit - Level II (20/40) - 2020/12/22 22:45:28 EET [2020/12/22 15:45:28 ET]
Table '3079057742 3' 9-max Seat #7 is the button
Seat 1: czini007 (3522 in chips) 
Seat 2: marquitopoker4 (2756 in chips) 
Seat 3: IkeAmez54 (3000 in chips) 
Seat 4: Suba778 (2308 in chips) 
Seat 5: Willcs02 (4345 in chips) 
Seat 6: honkelic (4786 in chips) 
Seat 7: qw303 (2831 in chips) 
Seat 8: jcarlos.vale (4101 in chips) 
Seat 9: mao1114 (4430 in chips) 
czini007: posts the ante 5
marquitopoker4: posts the ante 5
IkeAmez54: posts the ante 5
Suba778: posts the ante 5
Willcs02: posts the ante 5
honkelic: posts the ante 5
qw303: posts the ante 5
jcarlos.vale: posts the ante 5
mao1114: posts the ante 5
jcarlos.vale: posts small blind 20
mao1114: posts big blind 40
*** HOLE CARDS ***
Dealt to jcarlos.vale [Ad Ts]
czini007: folds 
marquitopoker4: folds 
IkeAmez54: folds 
Suba778: raises 80 to 120
Willcs02: calls 120
honkelic: calls 120
qw303: folds 
jcarlos.vale: folds 
mao1114: folds 
*** FLOP *** [5s 5h 7c]
Suba778: bets 233
Willcs02: calls 233
honkelic: calls 233
*** TURN *** [5s 5h 7c] [Qd]
Suba778: checks 
Willcs02: checks 
honkelic: checks 
*** RIVER *** [5s 5h 7c Qd] [8h]
Suba778: checks 
Willcs02: bets 931
honkelic: folds 
Suba778: folds 
Uncalled bet (931) returned to Willcs02
Willcs02 collected 1164 from pot
Willcs02: doesn't show hand 
*** SUMMARY ***
Total pot 1164 | Rake 0 
Board [5s 5h 7c Qd 8h]
Seat 1: czini007 folded before Flop (didn't bet)
Seat 2: marquitopoker4 folded before Flop (didn't bet)
Seat 3: IkeAmez54 folded before Flop (didn't bet)
Seat 4: Suba778 folded on the River
Seat 5: Willcs02 collected (1164)
Seat 6: honkelic folded on the River
Seat 7: qw303 (button) folded before Flop (didn't bet)
Seat 8: jcarlos.vale (small blind) folded before Flop
Seat 9: mao1114 (big blind) folded before Flop



PokerStars Hand #221732338041: Tournament #3079057742, $0.98+$0.12 USD Hold'em No Limit - Level II (20/40) - 2020/12/22 22:47:06 EET [2020/12/22 15:47:06 ET]
Table '3079057742 3' 9-max Seat #8 is the button
Seat 1: czini007 (3517 in chips) 
Seat 2: marquitopoker4 (2751 in chips) 
Seat 3: IkeAmez54 (2995 in chips) 
Seat 4: Suba778 (1950 in chips) 
Seat 5: Willcs02 (5151 in chips) 
Seat 6: honkelic (4428 in chips) 
Seat 7: qw303 (2826 in chips) 
Seat 8: jcarlos.vale (4076 in chips) 
Seat 9: mao1114 (4385 in chips) 
czini007: posts the ante 5
marquitopoker4: posts the ante 5
IkeAmez54: posts the ante 5
Suba778: posts the ante 5
Willcs02: posts the ante 5
honkelic: posts the ante 5
qw303: posts the ante 5
jcarlos.vale: posts the ante 5
mao1114: posts the ante 5
mao1114: posts small blind 20
czini007: posts big blind 40
*** HOLE CARDS ***
Dealt to jcarlos.vale [Ac Js]
marquitopoker4: folds 
IkeAmez54: folds 
Suba778: folds 
Willcs02: raises 48 to 88
honkelic: folds 
qw303: raises 2733 to 2821 and is all-in
jcarlos.vale: folds 
mao1114: folds 
czini007: folds 
Willcs02: folds 
Uncalled bet (2733) returned to qw303
qw303 collected 281 from pot
qw303: doesn't show hand 
*** SUMMARY ***
Total pot 281 | Rake 0 
Seat 1: czini007 (big blind) folded before Flop
Seat 2: marquitopoker4 folded before Flop (didn't bet)
Seat 3: IkeAmez54 folded before Flop (didn't bet)
Seat 4: Suba778 folded before Flop (didn't bet)
Seat 5: Willcs02 folded before Flop
Seat 6: honkelic folded before Flop (didn't bet)
Seat 7: qw303 collected (281)
Seat 8: jcarlos.vale (button) folded before Flop (didn't bet)
Seat 9: mao1114 (small blind) folded before Flop



PokerStars Hand #221732362365: Tournament #3079057742, $0.98+$0.12 USD Hold'em No Limit - Level II (20/40) - 2020/12/22 22:47:42 EET [2020/12/22 15:47:42 ET]
Table '3079057742 3' 9-max Seat #9 is the button
Seat 1: czini007 (3472 in chips) 
Seat 2: marquitopoker4 (2746 in chips) 
Seat 3: IkeAmez54 (2990 in chips) 
Seat 4: Suba778 (1945 in chips) 
Seat 5: Willcs02 (5058 in chips) 
Seat 6: honkelic (4423 in chips) 
Seat 7: qw303 (3014 in chips) 
Seat 8: jcarlos.vale (4071 in chips) 
Seat 9: mao1114 (4360 in chips) 
czini007: posts the ante 5
marquitopoker4: posts the ante 5
IkeAmez54: posts the ante 5
Suba778: posts the ante 5
Willcs02: posts the ante 5
honkelic: posts the ante 5
qw303: posts the ante 5
jcarlos.vale: posts the ante 5
mao1114: posts the ante 5
czini007: posts small blind 20
marquitopoker4: posts big blind 40
*** HOLE CARDS ***
Dealt to jcarlos.vale [Qd 9s]
IkeAmez54: folds 
Suba778: folds 
Willcs02: folds 
honkelic: calls 40
qw303: folds 
jcarlos.vale: folds 
mao1114: calls 40
czini007: calls 20
marquitopoker4: checks 
*** FLOP *** [Ac Js 2h]
czini007: checks 
marquitopoker4: checks 
honkelic: checks 
mao1114: checks 
*** TURN *** [Ac Js 2h] [Ts]
czini007: checks 
marquitopoker4: checks 
honkelic: bets 103
mao1114: folds 
czini007: folds 
marquitopoker4: folds 
Uncalled bet (103) returned to honkelic
honkelic collected 205 from pot
honkelic: doesn't show hand 
*** SUMMARY ***
Total pot 205 | Rake 0 
Board [Ac Js 2h Ts]
Seat 1: czini007 (small blind) folded on the Turn
Seat 2: marquitopoker4 (big blind) folded on the Turn
Seat 3: IkeAmez54 folded before Flop (didn't bet)
Seat 4: Suba778 folded before Flop (didn't bet)
Seat 5: Willcs02 folded before Flop (didn't bet)
Seat 6: honkelic collected (205)
Seat 7: qw303 folded before Flop (didn't bet)
Seat 8: jcarlos.vale folded before Flop (didn't bet)
Seat 9: mao1114 (button) folded on the Turn



PokerStars Hand #221732413895: Tournament #3079057742, $0.98+$0.12 USD Hold'em No Limit - Level II (20/40) - 2020/12/22 22:48:47 EET [2020/12/22 15:48:47 ET]
Table '3079057742 3' 9-max Seat #1 is the button
Seat 1: czini007 (3427 in chips) 
Seat 2: marquitopoker4 (2701 in chips) 
Seat 3: IkeAmez54 (2985 in chips) 
Seat 4: Suba778 (1940 in chips) 
Seat 5: Willcs02 (5053 in chips) 
Seat 6: honkelic (4583 in chips) 
Seat 7: qw303 (3009 in chips) 
Seat 8: jcarlos.vale (4066 in chips) 
Seat 9: mao1114 (4315 in chips) 
czini007: posts the ante 5
marquitopoker4: posts the ante 5
IkeAmez54: posts the ante 5
Suba778: posts the ante 5
Willcs02: posts the ante 5
honkelic: posts the ante 5
qw303: posts the ante 5
jcarlos.vale: posts the ante 5
mao1114: posts the ante 5
marquitopoker4: posts small blind 20
IkeAmez54: posts big blind 40
*** HOLE CARDS ***
Dealt to jcarlos.vale [Jc Ks]
Suba778: folds 
Willcs02: folds 
honkelic: folds 
qw303: folds 
jcarlos.vale: raises 64 to 104
mao1114: folds 
czini007: folds 
marquitopoker4: folds 
IkeAmez54: calls 64
*** FLOP *** [Td Qs 3c]
IkeAmez54: checks 
jcarlos.vale: bets 120
IkeAmez54: calls 120
*** TURN *** [Td Qs 3c] [7h]
IkeAmez54: bets 128
jcarlos.vale: calls 128
*** RIVER *** [Td Qs 3c 7h] [9h]
IkeAmez54: checks 
jcarlos.vale: bets 200
IkeAmez54: raises 585 to 785
jcarlos.vale: raises 2924 to 3709 and is all-in
IkeAmez54: calls 1843 and is all-in
Uncalled bet (1081) returned to jcarlos.vale
*** SHOW DOWN ***
jcarlos.vale: shows [Jc Ks] (a straight, Nine to King)
IkeAmez54: shows [Kh Js] (a straight, Nine to King)
IkeAmez54 collected 3013 from pot
jcarlos.vale collected 3012 from pot
*** SUMMARY ***
Total pot 6025 | Rake 0 
Board [Td Qs 3c 7h 9h]
Seat 1: czini007 (button) folded before Flop (didn't bet)
Seat 2: marquitopoker4 (small blind) folded before Flop
Seat 3: IkeAmez54 (big blind) showed [Kh Js] and won (3013) with a straight, Nine to King
Seat 4: Suba778 folded before Flop (didn't bet)
Seat 5: Willcs02 folded before Flop (didn't bet)
Seat 6: honkelic folded before Flop (didn't bet)
Seat 7: qw303 folded before Flop (didn't bet)
Seat 8: jcarlos.vale showed [Jc Ks] and won (3012) with a straight, Nine to King
Seat 9: mao1114 folded before Flop (didn't bet)



PokerStars Hand #221732490362: Tournament #3079057742, $0.98+$0.12 USD Hold'em No Limit - Level III (25/50) - 2020/12/22 22:50:25 EET [2020/12/22 15:50:25 ET]
Table '3079057742 3' 9-max Seat #2 is the button
Seat 1: czini007 (3422 in chips) 
Seat 2: marquitopoker4 (2676 in chips) 
Seat 3: IkeAmez54 (3013 in chips) 
Seat 4: Suba778 (1935 in chips) 
Seat 5: Willcs02 (5048 in chips) 
Seat 6: honkelic (4578 in chips) 
Seat 7: qw303 (3004 in chips) 
Seat 8: jcarlos.vale (4093 in chips) 
Seat 9: mao1114 (4310 in chips) 
czini007: posts the ante 6
marquitopoker4: posts the ante 6
IkeAmez54: posts the ante 6
Suba778: posts the ante 6
Willcs02: posts the ante 6
honkelic: posts the ante 6
qw303: posts the ante 6
jcarlos.vale: posts the ante 6
mao1114: posts the ante 6
IkeAmez54: posts small blind 25
Suba778: posts big blind 50
*** HOLE CARDS ***
Dealt to jcarlos.vale [7c Qd]
Willcs02: raises 60 to 110
honkelic: raises 4462 to 4572 and is all-in
qw303: folds 
jcarlos.vale: folds 
mao1114: calls 4304 and is all-in
czini007: folds 
marquitopoker4: folds 
IkeAmez54: folds 
Suba778: folds 
Willcs02: folds 
Uncalled bet (268) returned to honkelic
*** FLOP *** [9s Jh 3s]
*** TURN *** [9s Jh 3s] [5c]
*** RIVER *** [9s Jh 3s 5c] [Kh]
*** SHOW DOWN ***
honkelic: shows [Kc Ad] (a pair of Kings)
mao1114: shows [5h Ah] (a pair of Fives)
honkelic collected 8847 from pot
honkelic is sitting out
mao1114 finished the tournament
*** SUMMARY ***
Total pot 8847 | Rake 0 
Board [9s Jh 3s 5c Kh]
Seat 1: czini007 folded before Flop (didn't bet)
Seat 2: marquitopoker4 (button) folded before Flop (didn't bet)
Seat 3: IkeAmez54 (small blind) folded before Flop
Seat 4: Suba778 (big blind) folded before Flop
Seat 5: Willcs02 folded before Flop
Seat 6: honkelic showed [Kc Ad] and won (8847) with a pair of Kings
Seat 7: qw303 folded before Flop (didn't bet)
Seat 8: jcarlos.vale folded before Flop (didn't bet)
Seat 9: mao1114 showed [5h Ah] and lost with a pair of Fives



PokerStars Hand #221732522359: Tournament #3079057742, $0.98+$0.12 USD Hold'em No Limit - Level III (25/50) - 2020/12/22 22:51:12 EET [2020/12/22 15:51:12 ET]
Table '3079057742 3' 9-max Seat #3 is the button
Seat 1: czini007 (3416 in chips) 
Seat 2: marquitopoker4 (2670 in chips) 
Seat 3: IkeAmez54 (2982 in chips) 
Seat 4: Suba778 (1879 in chips) 
Seat 5: Willcs02 (4932 in chips) 
Seat 6: honkelic (9115 in chips) is sitting out
Seat 7: qw303 (2998 in chips) 
Seat 8: jcarlos.vale (4087 in chips) 
czini007: posts the ante 6
marquitopoker4: posts the ante 6
IkeAmez54: posts the ante 6
Suba778: posts the ante 6
Willcs02: posts the ante 6
honkelic: posts the ante 6
qw303: posts the ante 6
jcarlos.vale: posts the ante 6
Suba778: posts small blind 25
Willcs02: posts big blind 50
*** HOLE CARDS ***
Dealt to jcarlos.vale [5h 4s]
honkelic: folds 
czini007 said, "wow"
qw303: folds 
jcarlos.vale: folds 
czini007: folds 
marquitopoker4: raises 69 to 119
IkeAmez54: folds 
Suba778: folds 
Willcs02: folds 
Uncalled bet (69) returned to marquitopoker4
marquitopoker4 collected 173 from pot
marquitopoker4: doesn't show hand 
*** SUMMARY ***
Total pot 173 | Rake 0 
Seat 1: czini007 folded before Flop (didn't bet)
Seat 2: marquitopoker4 collected (173)
Seat 3: IkeAmez54 (button) folded before Flop (didn't bet)
Seat 4: Suba778 (small blind) folded before Flop
Seat 5: Willcs02 (big blind) folded before Flop
Seat 6: honkelic folded before Flop (didn't bet)
Seat 7: qw303 folded before Flop (didn't bet)
Seat 8: jcarlos.vale folded before Flop (didn't bet)



PokerStars Hand #221732535045: Tournament #3079057742, $0.98+$0.12 USD Hold'em No Limit - Level III (25/50) - 2020/12/22 22:51:31 EET [2020/12/22 15:51:31 ET]
Table '3079057742 3' 9-max Seat #4 is the button
Seat 1: czini007 (3410 in chips) 
Seat 2: marquitopoker4 (2787 in chips) 
Seat 3: IkeAmez54 (2976 in chips) 
Seat 4: Suba778 (1848 in chips) 
Seat 5: Willcs02 (4876 in chips) 
Seat 6: honkelic (9109 in chips) is sitting out
Seat 7: qw303 (2992 in chips) 
Seat 8: jcarlos.vale (4081 in chips) 
czini007: posts the ante 6
marquitopoker4: posts the ante 6
IkeAmez54: posts the ante 6
Suba778: posts the ante 6
Willcs02: posts the ante 6
honkelic: posts the ante 6
qw303: posts the ante 6
jcarlos.vale: posts the ante 6
Willcs02: posts small blind 25
honkelic: posts big blind 50
*** HOLE CARDS ***
Dealt to jcarlos.vale [2d 4d]
qw303: folds 
jcarlos.vale: folds 
czini007: folds 
marquitopoker4: folds 
IkeAmez54: raises 70 to 120
Suba778: raises 230 to 350
Willcs02: folds 
honkelic: folds 
IkeAmez54: raises 2620 to 2970 and is all-in
Suba778: calls 1492 and is all-in
Uncalled bet (1128) returned to IkeAmez54
*** FLOP *** [Jh Tc 4s]
*** TURN *** [Jh Tc 4s] [Ah]
*** RIVER *** [Jh Tc 4s Ah] [9d]
*** SHOW DOWN ***
IkeAmez54: shows [Qc Qs] (a pair of Queens)
Suba778: shows [Kc Kd] (a pair of Kings)
Suba778 collected 3807 from pot
*** SUMMARY ***
Total pot 3807 | Rake 0 
Board [Jh Tc 4s Ah 9d]
Seat 1: czini007 folded before Flop (didn't bet)
Seat 2: marquitopoker4 folded before Flop (didn't bet)
Seat 3: IkeAmez54 showed [Qc Qs] and lost with a pair of Queens
Seat 4: Suba778 (button) showed [Kc Kd] and won (3807) with a pair of Kings
Seat 5: Willcs02 (small blind) folded before Flop
Seat 6: honkelic (big blind) folded before Flop
Seat 7: qw303 folded before Flop (didn't bet)
Seat 8: jcarlos.vale folded before Flop (didn't bet)



PokerStars Hand #221732567924: Tournament #3079057742, $0.98+$0.12 USD Hold'em No Limit - Level III (25/50) - 2020/12/22 22:52:20 EET [2020/12/22 15:52:20 ET]
Table '3079057742 3' 9-max Seat #5 is the button
Seat 1: czini007 (3404 in chips) 
Seat 2: marquitopoker4 (2781 in chips) 
Seat 3: IkeAmez54 (1128 in chips) 
Seat 4: Suba778 (3807 in chips) 
Seat 5: Willcs02 (4845 in chips) 
Seat 6: honkelic (9053 in chips) is sitting out
Seat 7: qw303 (2986 in chips) 
Seat 8: jcarlos.vale (4075 in chips) 
Seat 9: Nikos8511 (3000 in chips) 
czini007: posts the ante 6
marquitopoker4: posts the ante 6
IkeAmez54: posts the ante 6
Suba778: posts the ante 6
Willcs02: posts the ante 6
honkelic: posts the ante 6
qw303: posts the ante 6
jcarlos.vale: posts the ante 6
Nikos8511: posts the ante 6
honkelic: posts small blind 25
qw303: posts big blind 50
*** HOLE CARDS ***
Dealt to jcarlos.vale [3s 6s]
jcarlos.vale: folds 
Nikos8511: folds 
czini007: raises 50 to 100
marquitopoker4: folds 
IkeAmez54: folds 
Suba778: folds 
Willcs02: folds 
honkelic: folds 
qw303: folds 
Uncalled bet (50) returned to czini007
czini007 collected 179 from pot
czini007: doesn't show hand 
*** SUMMARY ***
Total pot 179 | Rake 0 
Seat 1: czini007 collected (179)
Seat 2: marquitopoker4 folded before Flop (didn't bet)
Seat 3: IkeAmez54 folded before Flop (didn't bet)
Seat 4: Suba778 folded before Flop (didn't bet)
Seat 5: Willcs02 (button) folded before Flop (didn't bet)
Seat 6: honkelic (small blind) folded before Flop
Seat 7: qw303 (big blind) folded before Flop
Seat 8: jcarlos.vale folded before Flop (didn't bet)
Seat 9: Nikos8511 folded before Flop (didn't bet)



PokerStars Hand #221732600499: Tournament #3079057742, $0.98+$0.12 USD Hold'em No Limit - Level III (25/50) - 2020/12/22 22:53:08 EET [2020/12/22 15:53:08 ET]
Table '3079057742 3' 9-max Seat #6 is the button
Seat 1: czini007 (3527 in chips) 
Seat 2: marquitopoker4 (2775 in chips) 
Seat 3: IkeAmez54 (1122 in chips) 
Seat 4: Suba778 (3801 in chips) 
Seat 5: Willcs02 (4839 in chips) 
Seat 6: honkelic (9022 in chips) is sitting out
Seat 7: qw303 (2930 in chips) 
Seat 8: jcarlos.vale (4069 in chips) 
Seat 9: Nikos8511 (2994 in chips) 
czini007: posts the ante 6
marquitopoker4: posts the ante 6
IkeAmez54: posts the ante 6
Suba778: posts the ante 6
Willcs02: posts the ante 6
honkelic: posts the ante 6
qw303: posts the ante 6
jcarlos.vale: posts the ante 6
Nikos8511: posts the ante 6
qw303: posts small blind 25
jcarlos.vale: posts big blind 50
*** HOLE CARDS ***
Dealt to jcarlos.vale [Ac 2c]
Nikos8511: folds 
czini007: folds 
marquitopoker4: folds 
IkeAmez54: folds 
Suba778: folds 
Willcs02: folds 
honkelic: folds 
qw303: folds 
Uncalled bet (25) returned to jcarlos.vale
jcarlos.vale collected 104 from pot
jcarlos.vale: doesn't show hand 
*** SUMMARY ***
Total pot 104 | Rake 0 
Seat 1: czini007 folded before Flop (didn't bet)
Seat 2: marquitopoker4 folded before Flop (didn't bet)
Seat 3: IkeAmez54 folded before Flop (didn't bet)
Seat 4: Suba778 folded before Flop (didn't bet)
Seat 5: Willcs02 folded before Flop (didn't bet)
Seat 6: honkelic (button) folded before Flop (didn't bet)
Seat 7: qw303 (small blind) folded before Flop
Seat 8: jcarlos.vale (big blind) collected (104)
Seat 9: Nikos8511 folded before Flop (didn't bet)



PokerStars Hand #221732609967: Tournament #3079057742, $0.98+$0.12 USD Hold'em No Limit - Level III (25/50) - 2020/12/22 22:53:21 EET [2020/12/22 15:53:21 ET]
Table '3079057742 3' 9-max Seat #7 is the button
Seat 1: czini007 (3521 in chips) 
Seat 2: marquitopoker4 (2769 in chips) 
Seat 3: IkeAmez54 (1116 in chips) 
Seat 4: Suba778 (3795 in chips) 
Seat 5: Willcs02 (4833 in chips) 
Seat 6: honkelic (9016 in chips) is sitting out
Seat 7: qw303 (2899 in chips) 
Seat 8: jcarlos.vale (4142 in chips) 
Seat 9: Nikos8511 (2988 in chips) 
czini007: posts the ante 6
marquitopoker4: posts the ante 6
IkeAmez54: posts the ante 6
Suba778: posts the ante 6
Willcs02: posts the ante 6
honkelic: posts the ante 6
qw303: posts the ante 6
jcarlos.vale: posts the ante 6
Nikos8511: posts the ante 6
jcarlos.vale: posts small blind 25
Nikos8511: posts big blind 50
*** HOLE CARDS ***
Dealt to jcarlos.vale [3c 8d]
czini007: folds 
marquitopoker4: folds 
IkeAmez54: folds 
Suba778: raises 100 to 150
Willcs02: folds 
honkelic: folds 
qw303: folds 
jcarlos.vale: folds 
Nikos8511: folds 
Uncalled bet (100) returned to Suba778
Suba778 collected 179 from pot
Suba778: doesn't show hand 
*** SUMMARY ***
Total pot 179 | Rake 0 
Seat 1: czini007 folded before Flop (didn't bet)
Seat 2: marquitopoker4 folded before Flop (didn't bet)
Seat 3: IkeAmez54 folded before Flop (didn't bet)
Seat 4: Suba778 collected (179)
Seat 5: Willcs02 folded before Flop (didn't bet)
Seat 6: honkelic folded before Flop (didn't bet)
Seat 7: qw303 (button) folded before Flop (didn't bet)
Seat 8: jcarlos.vale (small blind) folded before Flop
Seat 9: Nikos8511 (big blind) folded before Flop



PokerStars Hand #221732626179: Tournament #3079057742, $0.98+$0.12 USD Hold'em No Limit - Level III (25/50) - 2020/12/22 22:53:45 EET [2020/12/22 15:53:45 ET]
Table '3079057742 3' 9-max Seat #8 is the button
Seat 1: czini007 (3515 in chips) 
Seat 2: marquitopoker4 (2763 in chips) 
Seat 3: IkeAmez54 (1110 in chips) 
Seat 4: Suba778 (3918 in chips) 
Seat 5: Willcs02 (4827 in chips) 
Seat 6: honkelic (9010 in chips) is sitting out
Seat 7: qw303 (2893 in chips) 
Seat 8: jcarlos.vale (4111 in chips) 
Seat 9: Nikos8511 (2932 in chips) 
czini007: posts the ante 6
marquitopoker4: posts the ante 6
IkeAmez54: posts the ante 6
Suba778: posts the ante 6
Willcs02: posts the ante 6
honkelic: posts the ante 6
qw303: posts the ante 6
jcarlos.vale: posts the ante 6
Nikos8511: posts the ante 6
Nikos8511: posts small blind 25
czini007: posts big blind 50
*** HOLE CARDS ***
Dealt to jcarlos.vale [Ts 8h]
marquitopoker4: folds 
IkeAmez54: folds 
Suba778: folds 
Willcs02: folds 
honkelic: folds 
qw303: folds 
jcarlos.vale: folds 
Nikos8511: calls 25
czini007: checks 
*** FLOP *** [9c 5h Jc]
Nikos8511: bets 88
czini007: folds 
Uncalled bet (88) returned to Nikos8511
Nikos8511 collected 154 from pot
Nikos8511: doesn't show hand 
*** SUMMARY ***
Total pot 154 | Rake 0 
Board [9c 5h Jc]
Seat 1: czini007 (big blind) folded on the Flop
Seat 2: marquitopoker4 folded before Flop (didn't bet)
Seat 3: IkeAmez54 folded before Flop (didn't bet)
Seat 4: Suba778 folded before Flop (didn't bet)
Seat 5: Willcs02 folded before Flop (didn't bet)
Seat 6: honkelic folded before Flop (didn't bet)
Seat 7: qw303 folded before Flop (didn't bet)
Seat 8: jcarlos.vale (button) folded before Flop (didn't bet)
Seat 9: Nikos8511 (small blind) collected (154)



PokerStars Hand #221732641275: Tournament #3079057742, $0.98+$0.12 USD Hold'em No Limit - Level III (25/50) - 2020/12/22 22:54:08 EET [2020/12/22 15:54:08 ET]
Table '3079057742 3' 9-max Seat #9 is the button
Seat 1: czini007 (3459 in chips) 
Seat 2: marquitopoker4 (2757 in chips) 
Seat 3: IkeAmez54 (1104 in chips) 
Seat 4: Suba778 (3912 in chips) 
Seat 5: Willcs02 (4821 in chips) 
Seat 6: honkelic (9004 in chips) is sitting out
Seat 7: qw303 (2887 in chips) 
Seat 8: jcarlos.vale (4105 in chips) 
Seat 9: Nikos8511 (3030 in chips) 
czini007: posts the ante 6
marquitopoker4: posts the ante 6
IkeAmez54: posts the ante 6
Suba778: posts the ante 6
Willcs02: posts the ante 6
honkelic: posts the ante 6
qw303: posts the ante 6
jcarlos.vale: posts the ante 6
Nikos8511: posts the ante 6
czini007: posts small blind 25
marquitopoker4: posts big blind 50
*** HOLE CARDS ***
Dealt to jcarlos.vale [4d 8s]
IkeAmez54: folds 
Suba778: folds 
Willcs02: raises 60 to 110
honkelic: folds 
qw303: folds 
jcarlos.vale: folds 
Nikos8511: folds 
czini007: folds 
marquitopoker4: folds 
Uncalled bet (60) returned to Willcs02
Willcs02 collected 179 from pot
Willcs02: doesn't show hand 
*** SUMMARY ***
Total pot 179 | Rake 0 
Seat 1: czini007 (small blind) folded before Flop
Seat 2: marquitopoker4 (big blind) folded before Flop
Seat 3: IkeAmez54 folded before Flop (didn't bet)
Seat 4: Suba778 folded before Flop (didn't bet)
Seat 5: Willcs02 collected (179)
Seat 6: honkelic folded before Flop (didn't bet)
Seat 7: qw303 folded before Flop (didn't bet)
Seat 8: jcarlos.vale folded before Flop (didn't bet)
Seat 9: Nikos8511 (button) folded before Flop (didn't bet)



PokerStars Hand #221732652739: Tournament #3079057742, $0.98+$0.12 USD Hold'em No Limit - Level III (25/50) - 2020/12/22 22:54:25 EET [2020/12/22 15:54:25 ET]
Table '3079057742 3' 9-max Seat #1 is the button
Seat 1: czini007 (3428 in chips) 
Seat 2: marquitopoker4 (2701 in chips) 
Seat 3: IkeAmez54 (1098 in chips) 
Seat 4: Suba778 (3906 in chips) 
Seat 5: Willcs02 (4944 in chips) 
Seat 6: honkelic (8998 in chips) is sitting out
Seat 7: qw303 (2881 in chips) 
Seat 8: jcarlos.vale (4099 in chips) 
Seat 9: Nikos8511 (3024 in chips) 
czini007: posts the ante 6
marquitopoker4: posts the ante 6
IkeAmez54: posts the ante 6
Suba778: posts the ante 6
Willcs02: posts the ante 6
honkelic: posts the ante 6
qw303: posts the ante 6
jcarlos.vale: posts the ante 6
Nikos8511: posts the ante 6
marquitopoker4: posts small blind 25
IkeAmez54: posts big blind 50
*** HOLE CARDS ***
Dealt to jcarlos.vale [7h Td]
Suba778: folds 
Willcs02: folds 
honkelic: folds 
qw303: folds 
jcarlos.vale: folds 
Nikos8511: folds 
czini007: raises 50 to 100
marquitopoker4: folds 
IkeAmez54: folds 
Uncalled bet (50) returned to czini007
czini007 collected 179 from pot
czini007: doesn't show hand 
*** SUMMARY ***
Total pot 179 | Rake 0 
Seat 1: czini007 (button) collected (179)
Seat 2: marquitopoker4 (small blind) folded before Flop
Seat 3: IkeAmez54 (big blind) folded before Flop
Seat 4: Suba778 folded before Flop (didn't bet)
Seat 5: Willcs02 folded before Flop (didn't bet)
Seat 6: honkelic folded before Flop (didn't bet)
Seat 7: qw303 folded before Flop (didn't bet)
Seat 8: jcarlos.vale folded before Flop (didn't bet)
Seat 9: Nikos8511 folded before Flop (didn't bet)



PokerStars Hand #221732894565: Tournament #3079057742, $0.98+$0.12 USD Hold'em No Limit - Level III (25/50) - 2020/12/22 23:01:49 EET [2020/12/22 16:01:49 ET]
Table '3079057742 3' 9-max Seat #2 is the button
Seat 1: czini007 (3551 in chips) 
Seat 2: marquitopoker4 (2670 in chips) 
Seat 3: IkeAmez54 (1042 in chips) 
Seat 4: Suba778 (3900 in chips) 
Seat 6: honkelic (8992 in chips) 
Seat 7: Citadel_7 (3000 in chips) 
Seat 8: jcarlos.vale (4093 in chips) 
Seat 9: Nikos8511 (3018 in chips) 
czini007: posts the ante 6
marquitopoker4: posts the ante 6
IkeAmez54: posts the ante 6
Suba778: posts the ante 6
honkelic: posts the ante 6
Citadel_7: posts the ante 6
jcarlos.vale: posts the ante 6
Nikos8511: posts the ante 6
IkeAmez54: posts small blind 25
Suba778: posts big blind 50
*** HOLE CARDS ***
Dealt to jcarlos.vale [8h Qs]
honkelic: folds 
Citadel_7: raises 50 to 100
jcarlos.vale: folds 
Nikos8511: calls 100
czini007: calls 100
marquitopoker4: folds 
IkeAmez54: folds 
Suba778: calls 50
*** FLOP *** [5s Kc 6s]
Suba778: checks 
Citadel_7: checks 
Nikos8511: checks 
czini007: checks 
*** TURN *** [5s Kc 6s] [6c]
Suba778: checks 
Citadel_7: checks 
Nikos8511: checks 
czini007: checks 
*** RIVER *** [5s Kc 6s 6c] [5d]
Suba778: checks 
Citadel_7: checks 
Nikos8511: checks 
czini007: bets 200
Suba778: folds 
Citadel_7: folds 
Nikos8511: folds 
Uncalled bet (200) returned to czini007
czini007 collected 473 from pot
czini007: doesn't show hand 
*** SUMMARY ***
Total pot 473 | Rake 0 
Board [5s Kc 6s 6c 5d]
Seat 1: czini007 collected (473)
Seat 2: marquitopoker4 (button) folded before Flop (didn't bet)
Seat 3: IkeAmez54 (small blind) folded before Flop
Seat 4: Suba778 (big blind) folded on the River
Seat 6: honkelic folded before Flop (didn't bet)
Seat 7: Citadel_7 folded on the River
Seat 8: jcarlos.vale folded before Flop (didn't bet)
Seat 9: Nikos8511 folded on the River



PokerStars Hand #221732961995: Tournament #3079057742, $0.98+$0.12 USD Hold'em No Limit - Level III (25/50) - 2020/12/22 23:03:31 EET [2020/12/22 16:03:31 ET]
Table '3079057742 3' 9-max Seat #3 is the button
Seat 1: czini007 (3918 in chips) 
Seat 2: marquitopoker4 (2664 in chips) 
Seat 3: IkeAmez54 (1011 in chips) 
Seat 4: Suba778 (3794 in chips) 
Seat 5: $kiLLme1sTeR (3000 in chips) 
Seat 7: Citadel_7 (2894 in chips) 
Seat 8: jcarlos.vale (4087 in chips) 
Seat 9: Nikos8511 (2912 in chips) 
czini007: posts the ante 6
marquitopoker4: posts the ante 6
IkeAmez54: posts the ante 6
Suba778: posts the ante 6
$kiLLme1sTeR: posts the ante 6
Citadel_7: posts the ante 6
jcarlos.vale: posts the ante 6
Nikos8511: posts the ante 6
Suba778: posts small blind 25
$kiLLme1sTeR: posts big blind 50
*** HOLE CARDS ***
Dealt to jcarlos.vale [Ac 7c]
Citadel_7: folds 
jcarlos.vale: raises 80 to 130
Nikos8511: folds 
czini007: folds 
marquitopoker4: folds 
IkeAmez54: folds 
Suba778: folds 
$kiLLme1sTeR: folds 
Uncalled bet (80) returned to jcarlos.vale
jcarlos.vale collected 173 from pot
jcarlos.vale: doesn't show hand 
*** SUMMARY ***
Total pot 173 | Rake 0 
Seat 1: czini007 folded before Flop (didn't bet)
Seat 2: marquitopoker4 folded before Flop (didn't bet)
Seat 3: IkeAmez54 (button) folded before Flop (didn't bet)
Seat 4: Suba778 (small blind) folded before Flop
Seat 5: $kiLLme1sTeR (big blind) folded before Flop
Seat 7: Citadel_7 folded before Flop (didn't bet)
Seat 8: jcarlos.vale collected (173)
Seat 9: Nikos8511 folded before Flop (didn't bet)



PokerStars Hand #221732981283: Tournament #3079057742, $0.98+$0.12 USD Hold'em No Limit - Level III (25/50) - 2020/12/22 23:04:01 EET [2020/12/22 16:04:01 ET]
Table '3079057742 3' 9-max Seat #4 is the button
Seat 1: czini007 (3912 in chips) 
Seat 2: marquitopoker4 (2658 in chips) 
Seat 3: IkeAmez54 (1005 in chips) 
Seat 4: Suba778 (3763 in chips) 
Seat 5: $kiLLme1sTeR (2944 in chips) 
Seat 6: SteveD36 (3000 in chips) 
Seat 7: Citadel_7 (2888 in chips) 
Seat 8: jcarlos.vale (4204 in chips) 
Seat 9: Nikos8511 (2906 in chips) 
czini007: posts the ante 6
marquitopoker4: posts the ante 6
IkeAmez54: posts the ante 6
Suba778: posts the ante 6
$kiLLme1sTeR: posts the ante 6
SteveD36: posts the ante 6
Citadel_7: posts the ante 6
jcarlos.vale: posts the ante 6
Nikos8511: posts the ante 6
$kiLLme1sTeR: posts small blind 25
SteveD36: posts big blind 50
*** HOLE CARDS ***
Dealt to jcarlos.vale [Ac Th]
Citadel_7: folds 
jcarlos.vale: calls 50
Nikos8511: folds 
czini007: folds 
marquitopoker4: folds 
IkeAmez54: folds 
Suba778: raises 150 to 200
$kiLLme1sTeR: folds 
SteveD36: folds 
jcarlos.vale: folds 
Uncalled bet (150) returned to Suba778
Suba778 collected 229 from pot
Suba778: doesn't show hand 
*** SUMMARY ***
Total pot 229 | Rake 0 
Seat 1: czini007 folded before Flop (didn't bet)
Seat 2: marquitopoker4 folded before Flop (didn't bet)
Seat 3: IkeAmez54 folded before Flop (didn't bet)
Seat 4: Suba778 (button) collected (229)
Seat 5: $kiLLme1sTeR (small blind) folded before Flop
Seat 6: SteveD36 (big blind) folded before Flop
Seat 7: Citadel_7 folded before Flop (didn't bet)
Seat 8: jcarlos.vale folded before Flop
Seat 9: Nikos8511 folded before Flop (didn't bet)



PokerStars Hand #221733010846: Tournament #3079057742, $0.98+$0.12 USD Hold'em No Limit - Level III (25/50) - 2020/12/22 23:04:44 EET [2020/12/22 16:04:44 ET]
Table '3079057742 3' 9-max Seat #5 is the button
Seat 1: czini007 (3906 in chips) 
Seat 2: marquitopoker4 (2652 in chips) 
Seat 3: IkeAmez54 (999 in chips) 
Seat 4: Suba778 (3936 in chips) 
Seat 5: $kiLLme1sTeR (2913 in chips) 
Seat 6: SteveD36 (2944 in chips) 
Seat 7: Citadel_7 (2882 in chips) 
Seat 8: jcarlos.vale (4148 in chips) 
Seat 9: Nikos8511 (2900 in chips) 
czini007: posts the ante 6
marquitopoker4: posts the ante 6
IkeAmez54: posts the ante 6
Suba778: posts the ante 6
$kiLLme1sTeR: posts the ante 6
SteveD36: posts the ante 6
Citadel_7: posts the ante 6
jcarlos.vale: posts the ante 6
Nikos8511: posts the ante 6
SteveD36: posts small blind 25
Citadel_7: posts big blind 50
*** HOLE CARDS ***
Dealt to jcarlos.vale [4d 9c]
jcarlos.vale: folds 
Nikos8511: folds 
czini007: raises 50 to 100
marquitopoker4: folds 
IkeAmez54: folds 
Suba778: folds 
$kiLLme1sTeR: folds 
SteveD36: calls 75
Citadel_7: folds 
*** FLOP *** [7s 9s 6s]
SteveD36: checks 
czini007: checks 
*** TURN *** [7s 9s 6s] [8s]
SteveD36: bets 152
czini007: folds 
Uncalled bet (152) returned to SteveD36
SteveD36 collected 304 from pot
SteveD36: doesn't show hand 
*** SUMMARY ***
Total pot 304 | Rake 0 
Board [7s 9s 6s 8s]
Seat 1: czini007 folded on the Turn
Seat 2: marquitopoker4 folded before Flop (didn't bet)
Seat 3: IkeAmez54 folded before Flop (didn't bet)
Seat 4: Suba778 folded before Flop (didn't bet)
Seat 5: $kiLLme1sTeR (button) folded before Flop (didn't bet)
Seat 6: SteveD36 (small blind) collected (304)
Seat 7: Citadel_7 (big blind) folded before Flop
Seat 8: jcarlos.vale folded before Flop (didn't bet)
Seat 9: Nikos8511 folded before Flop (didn't bet)



PokerStars Hand #221733044860: Tournament #3079057742, $0.98+$0.12 USD Hold'em No Limit - Level III (25/50) - 2020/12/22 23:05:34 EET [2020/12/22 16:05:34 ET]
Table '3079057742 3' 9-max Seat #6 is the button
Seat 1: czini007 (3800 in chips) 
Seat 2: marquitopoker4 (2646 in chips) 
Seat 3: IkeAmez54 (993 in chips) 
Seat 5: $kiLLme1sTeR (2907 in chips) 
Seat 6: SteveD36 (3142 in chips) 
Seat 7: Citadel_7 (2826 in chips) 
Seat 8: jcarlos.vale (4142 in chips) 
Seat 9: Nikos8511 (2894 in chips) 
czini007: posts the ante 6
marquitopoker4: posts the ante 6
IkeAmez54: posts the ante 6
$kiLLme1sTeR: posts the ante 6
SteveD36: posts the ante 6
Citadel_7: posts the ante 6
jcarlos.vale: posts the ante 6
Nikos8511: posts the ante 6
Citadel_7: posts small blind 25
jcarlos.vale: posts big blind 50
*** HOLE CARDS ***
Dealt to jcarlos.vale [4s Ad]
Nikos8511: calls 50
czini007: folds 
marquitopoker4: folds 
IkeAmez54: folds 
$kiLLme1sTeR: calls 50
SteveD36: folds 
Citadel_7: calls 25
jcarlos.vale: checks 
*** FLOP *** [Js 4c 5d]
Citadel_7: checks 
jcarlos.vale: bets 50
Nikos8511: raises 254 to 304
$kiLLme1sTeR: calls 304
Citadel_7: folds 
jcarlos.vale: folds 
*** TURN *** [Js 4c 5d] [4h]
Nikos8511: checks 
$kiLLme1sTeR: checks 
*** RIVER *** [Js 4c 5d 4h] [Th]
Nikos8511: bets 516
$kiLLme1sTeR: folds 
Uncalled bet (516) returned to Nikos8511
Nikos8511 collected 906 from pot
Nikos8511: doesn't show hand 
*** SUMMARY ***
Total pot 906 | Rake 0 
Board [Js 4c 5d 4h Th]
Seat 1: czini007 folded before Flop (didn't bet)
Seat 2: marquitopoker4 folded before Flop (didn't bet)
Seat 3: IkeAmez54 folded before Flop (didn't bet)
Seat 5: $kiLLme1sTeR folded on the River
Seat 6: SteveD36 (button) folded before Flop (didn't bet)
Seat 7: Citadel_7 (small blind) folded on the Flop
Seat 8: jcarlos.vale (big blind) folded on the Flop
Seat 9: Nikos8511 collected (906)



PokerStars Hand #221733093985: Tournament #3079057742, $0.98+$0.12 USD Hold'em No Limit - Level IV (30/60) - 2020/12/22 23:06:48 EET [2020/12/22 16:06:48 ET]
Table '3079057742 3' 9-max Seat #7 is the button
Seat 1: czini007 (3794 in chips) 
Seat 2: marquitopoker4 (2640 in chips) 
Seat 3: IkeAmez54 (987 in chips) 
Seat 5: $kiLLme1sTeR (2547 in chips) 
Seat 6: SteveD36 (3136 in chips) 
Seat 7: Citadel_7 (2770 in chips) 
Seat 8: jcarlos.vale (4036 in chips) 
Seat 9: Nikos8511 (3440 in chips) 
czini007: posts the ante 7
marquitopoker4: posts the ante 7
IkeAmez54: posts the ante 7
$kiLLme1sTeR: posts the ante 7
SteveD36: posts the ante 7
Citadel_7: posts the ante 7
jcarlos.vale: posts the ante 7
Nikos8511: posts the ante 7
jcarlos.vale: posts small blind 30
Nikos8511: posts big blind 60
*** HOLE CARDS ***
Dealt to jcarlos.vale [Jd 7s]
czini007: calls 60
marquitopoker4: folds 
IkeAmez54: folds 
$kiLLme1sTeR: folds 
SteveD36: folds 
Citadel_7: raises 120 to 180
jcarlos.vale: folds 
Nikos8511: folds 
czini007: calls 120
*** FLOP *** [9d 3d 6d]
czini007: checks 
Citadel_7: bets 390
czini007: calls 390
*** TURN *** [9d 3d 6d] [9c]
czini007: checks 
Citadel_7: checks 
*** RIVER *** [9d 3d 6d 9c] [7d]
czini007: checks 
Citadel_7: checks 
*** SHOW DOWN ***
czini007: shows [Qh 9s] (three of a kind, Nines)
Citadel_7: shows [Qd Ac] (a flush, Queen high)
Citadel_7 collected 1286 from pot
*** SUMMARY ***
Total pot 1286 | Rake 0 
Board [9d 3d 6d 9c 7d]
Seat 1: czini007 showed [Qh 9s] and lost with three of a kind, Nines
Seat 2: marquitopoker4 folded before Flop (didn't bet)
Seat 3: IkeAmez54 folded before Flop (didn't bet)
Seat 5: $kiLLme1sTeR folded before Flop (didn't bet)
Seat 6: SteveD36 folded before Flop (didn't bet)
Seat 7: Citadel_7 (button) showed [Qd Ac] and won (1286) with a flush, Queen high
Seat 8: jcarlos.vale (small blind) folded before Flop
Seat 9: Nikos8511 (big blind) folded before Flop



PokerStars Hand #221733138974: Tournament #3079057742, $0.98+$0.12 USD Hold'em No Limit - Level IV (30/60) - 2020/12/22 23:07:55 EET [2020/12/22 16:07:55 ET]
Table '3079057742 3' 9-max Seat #8 is the button
Seat 1: czini007 (3217 in chips) 
Seat 2: marquitopoker4 (2633 in chips) 
Seat 3: IkeAmez54 (980 in chips) 
Seat 5: $kiLLme1sTeR (2540 in chips) 
Seat 6: SteveD36 (3129 in chips) 
Seat 7: Citadel_7 (3479 in chips) 
Seat 8: jcarlos.vale (3999 in chips) 
Seat 9: Nikos8511 (3373 in chips) 
czini007: posts the ante 7
marquitopoker4: posts the ante 7
IkeAmez54: posts the ante 7
$kiLLme1sTeR: posts the ante 7
SteveD36: posts the ante 7
Citadel_7: posts the ante 7
jcarlos.vale: posts the ante 7
Nikos8511: posts the ante 7
Nikos8511: posts small blind 30
czini007: posts big blind 60
*** HOLE CARDS ***
Dealt to jcarlos.vale [2c 7h]
marquitopoker4: raises 83 to 143
IkeAmez54: folds 
$kiLLme1sTeR: folds 
SteveD36: calls 143
Citadel_7: calls 143
jcarlos.vale: folds 
Nikos8511: calls 113
czini007: calls 83
*** FLOP *** [6c Th Ks]
Nikos8511: checks 
czini007: checks 
marquitopoker4: bets 262
SteveD36: calls 262
Citadel_7: calls 262
Nikos8511: folds 
czini007: folds 
*** TURN *** [6c Th Ks] [5h]
marquitopoker4: bets 919
SteveD36: raises 1798 to 2717 and is all-in
Citadel_7: folds 
marquitopoker4: calls 1302 and is all-in
Uncalled bet (496) returned to SteveD36
*** RIVER *** [6c Th Ks 5h] [7s]
*** SHOW DOWN ***
marquitopoker4: shows [Qd Kh] (a pair of Kings)
SteveD36: shows [Jh Ah] (high card Ace)
marquitopoker4 collected 5999 from pot
*** SUMMARY ***
Total pot 5999 | Rake 0 
Board [6c Th Ks 5h 7s]
Seat 1: czini007 (big blind) folded on the Flop
Seat 2: marquitopoker4 showed [Qd Kh] and won (5999) with a pair of Kings
Seat 3: IkeAmez54 folded before Flop (didn't bet)
Seat 5: $kiLLme1sTeR folded before Flop (didn't bet)
Seat 6: SteveD36 showed [Jh Ah] and lost with high card Ace
Seat 7: Citadel_7 folded on the Turn
Seat 8: jcarlos.vale (button) folded before Flop (didn't bet)
Seat 9: Nikos8511 (small blind) folded on the Flop



PokerStars Hand #221733191415: Tournament #3079057742, $0.98+$0.12 USD Hold'em No Limit - Level IV (30/60) - 2020/12/22 23:09:12 EET [2020/12/22 16:09:12 ET]
Table '3079057742 3' 9-max Seat #9 is the button
Seat 1: czini007 (3067 in chips) 
Seat 2: marquitopoker4 (5999 in chips) 
Seat 3: IkeAmez54 (973 in chips) 
Seat 5: $kiLLme1sTeR (2533 in chips) 
Seat 6: SteveD36 (496 in chips) 
Seat 7: Citadel_7 (3067 in chips) 
Seat 8: jcarlos.vale (3992 in chips) 
Seat 9: Nikos8511 (3223 in chips) 
czini007: posts the ante 7
marquitopoker4: posts the ante 7
IkeAmez54: posts the ante 7
$kiLLme1sTeR: posts the ante 7
SteveD36: posts the ante 7
Citadel_7: posts the ante 7
jcarlos.vale: posts the ante 7
Nikos8511: posts the ante 7
czini007: posts small blind 30
marquitopoker4: posts big blind 60
*** HOLE CARDS ***
Dealt to jcarlos.vale [Qh 5d]
IkeAmez54: folds 
$kiLLme1sTeR: folds 
SteveD36: folds 
Citadel_7: folds 
jcarlos.vale: folds 
Nikos8511: folds 
czini007: raises 60 to 120
marquitopoker4: raises 296 to 416
czini007: raises 2644 to 3060 and is all-in
marquitopoker4: calls 2644
*** FLOP *** [Kh 6d 4d]
*** TURN *** [Kh 6d 4d] [9c]
*** RIVER *** [Kh 6d 4d 9c] [3c]
*** SHOW DOWN ***
czini007: shows [4s 4h] (three of a kind, Fours)
marquitopoker4: shows [9h Ah] (a pair of Nines)
czini007 collected 6176 from pot
*** SUMMARY ***
Total pot 6176 | Rake 0 
Board [Kh 6d 4d 9c 3c]
Seat 1: czini007 (small blind) showed [4s 4h] and won (6176) with three of a kind, Fours
Seat 2: marquitopoker4 (big blind) showed [9h Ah] and lost with a pair of Nines
Seat 3: IkeAmez54 folded before Flop (didn't bet)
Seat 5: $kiLLme1sTeR folded before Flop (didn't bet)
Seat 6: SteveD36 folded before Flop (didn't bet)
Seat 7: Citadel_7 folded before Flop (didn't bet)
Seat 8: jcarlos.vale folded before Flop (didn't bet)
Seat 9: Nikos8511 (button) folded before Flop (didn't bet)



PokerStars Hand #221733214619: Tournament #3079057742, $0.98+$0.12 USD Hold'em No Limit - Level IV (30/60) - 2020/12/22 23:09:46 EET [2020/12/22 16:09:46 ET]
Table '3079057742 3' 9-max Seat #1 is the button
Seat 1: czini007 (6176 in chips) 
Seat 2: marquitopoker4 (2932 in chips) 
Seat 3: IkeAmez54 (966 in chips) 
Seat 5: $kiLLme1sTeR (2526 in chips) 
Seat 6: SteveD36 (489 in chips) 
Seat 7: Citadel_7 (3060 in chips) 
Seat 8: jcarlos.vale (3985 in chips) 
Seat 9: Nikos8511 (3216 in chips) 
czini007: posts the ante 7
marquitopoker4: posts the ante 7
IkeAmez54: posts the ante 7
$kiLLme1sTeR: posts the ante 7
SteveD36: posts the ante 7
Citadel_7: posts the ante 7
jcarlos.vale: posts the ante 7
Nikos8511: posts the ante 7
marquitopoker4: posts small blind 30
IkeAmez54: posts big blind 60
*** HOLE CARDS ***
Dealt to jcarlos.vale [Ks 9d]
$kiLLme1sTeR: folds 
SteveD36: folds 
czini007 said, "thanks"
Citadel_7: folds 
jcarlos.vale: folds 
Nikos8511: folds 
czini007: raises 60 to 120
marquitopoker4: folds 
IkeAmez54: calls 60
*** FLOP *** [Ts Qh 9h]
IkeAmez54: checks 
czini007: checks 
*** TURN *** [Ts Qh 9h] [5h]
IkeAmez54: bets 82
czini007: raises 5967 to 6049 and is all-in
IkeAmez54: calls 757 and is all-in
Uncalled bet (5210) returned to czini007
*** RIVER *** [Ts Qh 9h 5h] [6c]
*** SHOW DOWN ***
IkeAmez54: shows [Kh 7s] (high card King)
czini007: shows [Jh Qc] (a pair of Queens)
czini007 collected 2004 from pot
IkeAmez54 finished the tournament
*** SUMMARY ***
Total pot 2004 | Rake 0 
Board [Ts Qh 9h 5h 6c]
Seat 1: czini007 (button) showed [Jh Qc] and won (2004) with a pair of Queens
Seat 2: marquitopoker4 (small blind) folded before Flop
Seat 3: IkeAmez54 (big blind) showed [Kh 7s] and lost with high card King
Seat 5: $kiLLme1sTeR folded before Flop (didn't bet)
Seat 6: SteveD36 folded before Flop (didn't bet)
Seat 7: Citadel_7 folded before Flop (didn't bet)
Seat 8: jcarlos.vale folded before Flop (didn't bet)
Seat 9: Nikos8511 folded before Flop (didn't bet)



PokerStars Hand #221733243683: Tournament #3079057742, $0.98+$0.12 USD Hold'em No Limit - Level IV (30/60) - 2020/12/22 23:10:29 EET [2020/12/22 16:10:29 ET]
Table '3079057742 3' 9-max Seat #2 is the button
Seat 1: czini007 (7214 in chips) 
Seat 2: marquitopoker4 (2895 in chips) 
Seat 4: Tatanca666 (3000 in chips) out of hand (moved from another table into small blind)
Seat 5: $kiLLme1sTeR (2519 in chips) 
Seat 6: SteveD36 (482 in chips) 
Seat 7: Citadel_7 (3053 in chips) 
Seat 8: jcarlos.vale (3978 in chips) 
Seat 9: Nikos8511 (3209 in chips) 
Tatanca666 will be allowed to play after the button
czini007: posts the ante 7
marquitopoker4: posts the ante 7
$kiLLme1sTeR: posts the ante 7
SteveD36: posts the ante 7
Citadel_7: posts the ante 7
jcarlos.vale: posts the ante 7
Nikos8511: posts the ante 7
$kiLLme1sTeR: posts small blind 30
SteveD36: posts big blind 60
*** HOLE CARDS ***
Dealt to jcarlos.vale [4s 6s]
Citadel_7: raises 120 to 180
jcarlos.vale: folds 
Nikos8511: folds 
czini007: folds 
marquitopoker4: folds 
$kiLLme1sTeR: folds 
SteveD36: folds 
Uncalled bet (120) returned to Citadel_7
Citadel_7 collected 199 from pot
Citadel_7: doesn't show hand 
*** SUMMARY ***
Total pot 199 | Rake 0 
Seat 1: czini007 folded before Flop (didn't bet)
Seat 2: marquitopoker4 (button) folded before Flop (didn't bet)
Seat 5: $kiLLme1sTeR (small blind) folded before Flop
Seat 6: SteveD36 (big blind) folded before Flop
Seat 7: Citadel_7 collected (199)
Seat 8: jcarlos.vale folded before Flop (didn't bet)
Seat 9: Nikos8511 folded before Flop (didn't bet)



PokerStars Hand #221733264015: Tournament #3079057742, $0.98+$0.12 USD Hold'em No Limit - Level IV (30/60) - 2020/12/22 23:11:00 EET [2020/12/22 16:11:00 ET]
Table '3079057742 3' 9-max Seat #5 is the button
Seat 1: czini007 (7207 in chips) 
Seat 2: marquitopoker4 (2888 in chips) 
Seat 4: Tatanca666 (3000 in chips) 
Seat 5: $kiLLme1sTeR (2482 in chips) 
Seat 6: SteveD36 (415 in chips) 
Seat 7: Citadel_7 (3185 in chips) 
Seat 8: jcarlos.vale (3971 in chips) 
Seat 9: Nikos8511 (3202 in chips) 
czini007: posts the ante 7
marquitopoker4: posts the ante 7
Tatanca666: posts the ante 7
$kiLLme1sTeR: posts the ante 7
SteveD36: posts the ante 7
Citadel_7: posts the ante 7
jcarlos.vale: posts the ante 7
Nikos8511: posts the ante 7
SteveD36: posts small blind 30
Citadel_7: posts big blind 60
*** HOLE CARDS ***
Dealt to jcarlos.vale [Ac 7h]
jcarlos.vale: folds 
Nikos8511: folds 
czini007: calls 60
marquitopoker4: folds 
Tatanca666: calls 60
$kiLLme1sTeR: folds 
SteveD36: raises 348 to 408 and is all-in
Citadel_7: folds 
czini007: calls 348
Tatanca666: calls 348
*** FLOP *** [Qs 6c 3s]
czini007: checks 
Tatanca666: checks 
*** TURN *** [Qs 6c 3s] [2h]
czini007: checks 
Tatanca666: checks 
*** RIVER *** [Qs 6c 3s 2h] [5c]
czini007: checks 
Tatanca666: checks 
*** SHOW DOWN ***
SteveD36: shows [Kh 3h] (a pair of Threes)
czini007: mucks hand 
Tatanca666: mucks hand 
SteveD36 collected 1340 from pot
*** SUMMARY ***
Total pot 1340 | Rake 0 
Board [Qs 6c 3s 2h 5c]
Seat 1: czini007 mucked [9c Td]
Seat 2: marquitopoker4 folded before Flop (didn't bet)
Seat 4: Tatanca666 mucked [Kc Jh]
Seat 5: $kiLLme1sTeR (button) folded before Flop (didn't bet)
Seat 6: SteveD36 (small blind) showed [Kh 3h] and won (1340) with a pair of Threes
Seat 7: Citadel_7 (big blind) folded before Flop
Seat 8: jcarlos.vale folded before Flop (didn't bet)
Seat 9: Nikos8511 folded before Flop (didn't bet)



PokerStars Hand #221733305270: Tournament #3079057742, $0.98+$0.12 USD Hold'em No Limit - Level IV (30/60) - 2020/12/22 23:12:01 EET [2020/12/22 16:12:01 ET]
Table '3079057742 3' 9-max Seat #6 is the button
Seat 1: czini007 (6792 in chips) 
Seat 2: marquitopoker4 (2881 in chips) 
Seat 3: oronso 104 (3000 in chips) 
Seat 4: Tatanca666 (2585 in chips) 
Seat 5: $kiLLme1sTeR (2475 in chips) 
Seat 6: SteveD36 (1340 in chips) 
Seat 7: Citadel_7 (3118 in chips) 
Seat 8: jcarlos.vale (3964 in chips) 
Seat 9: Nikos8511 (3195 in chips) 
czini007: posts the ante 7
marquitopoker4: posts the ante 7
oronso 104: posts the ante 7
Tatanca666: posts the ante 7
$kiLLme1sTeR: posts the ante 7
SteveD36: posts the ante 7
Citadel_7: posts the ante 7
jcarlos.vale: posts the ante 7
Nikos8511: posts the ante 7
Citadel_7: posts small blind 30
jcarlos.vale: posts big blind 60
*** HOLE CARDS ***
Dealt to jcarlos.vale [7s 8c]
czini007 said, "lol"
Nikos8511: folds 
czini007: folds 
marquitopoker4: folds 
oronso 104: raises 120 to 180
Tatanca666: folds 
$kiLLme1sTeR: folds 
SteveD36: folds 
Citadel_7: folds 
jcarlos.vale: folds 
Uncalled bet (120) returned to oronso 104
oronso 104 collected 213 from pot
oronso 104: doesn't show hand 
*** SUMMARY ***
Total pot 213 | Rake 0 
Seat 1: czini007 folded before Flop (didn't bet)
Seat 2: marquitopoker4 folded before Flop (didn't bet)
Seat 3: oronso 104 collected (213)
Seat 4: Tatanca666 folded before Flop (didn't bet)
Seat 5: $kiLLme1sTeR folded before Flop (didn't bet)
Seat 6: SteveD36 (button) folded before Flop (didn't bet)
Seat 7: Citadel_7 (small blind) folded before Flop
Seat 8: jcarlos.vale (big blind) folded before Flop
Seat 9: Nikos8511 folded before Flop (didn't bet)



PokerStars Hand #221733328092: Tournament #3079057742, $0.98+$0.12 USD Hold'em No Limit - Level IV (30/60) - 2020/12/22 23:12:34 EET [2020/12/22 16:12:34 ET]
Table '3079057742 3' 9-max Seat #7 is the button
Seat 1: czini007 (6785 in chips) 
Seat 2: marquitopoker4 (2874 in chips) 
Seat 3: oronso 104 (3146 in chips) 
Seat 4: Tatanca666 (2578 in chips) 
Seat 5: $kiLLme1sTeR (2468 in chips) 
Seat 6: SteveD36 (1333 in chips) 
Seat 7: Citadel_7 (3081 in chips) 
Seat 8: jcarlos.vale (3897 in chips) 
Seat 9: Nikos8511 (3188 in chips) 
czini007: posts the ante 7
marquitopoker4: posts the ante 7
oronso 104: posts the ante 7
Tatanca666: posts the ante 7
$kiLLme1sTeR: posts the ante 7
SteveD36: posts the ante 7
Citadel_7: posts the ante 7
jcarlos.vale: posts the ante 7
Nikos8511: posts the ante 7
jcarlos.vale: posts small blind 30
Nikos8511: posts big blind 60
*** HOLE CARDS ***
Dealt to jcarlos.vale [6c Qs]
czini007: folds 
marquitopoker4: folds 
oronso 104: folds 
Tatanca666: calls 60
$kiLLme1sTeR: folds 
Tatanca666 said, "zzzzzzzzzzzzzzzzzzzz"
SteveD36: folds 
SteveD36 is sitting out
Citadel_7: calls 60
jcarlos.vale: calls 30
Nikos8511: checks 
*** FLOP *** [Ks 9d Td]
jcarlos.vale: checks 
Nikos8511: checks 
Tatanca666: checks 
Citadel_7: bets 152
jcarlos.vale: folds 
SteveD36 has returned
Nikos8511: folds 
Tatanca666: folds 
Uncalled bet (152) returned to Citadel_7
Citadel_7 collected 303 from pot
Citadel_7: doesn't show hand 
*** SUMMARY ***
Total pot 303 | Rake 0 
Board [Ks 9d Td]
Seat 1: czini007 folded before Flop (didn't bet)
Seat 2: marquitopoker4 folded before Flop (didn't bet)
Seat 3: oronso 104 folded before Flop (didn't bet)
Seat 4: Tatanca666 folded on the Flop
Seat 5: $kiLLme1sTeR folded before Flop (didn't bet)
Seat 6: SteveD36 folded before Flop (didn't bet)
Seat 7: Citadel_7 (button) collected (303)
Seat 8: jcarlos.vale (small blind) folded on the Flop
Seat 9: Nikos8511 (big blind) folded on the Flop



PokerStars Hand #221733381547: Tournament #3079057742, $0.98+$0.12 USD Hold'em No Limit - Level IV (30/60) - 2020/12/22 23:13:54 EET [2020/12/22 16:13:54 ET]
Table '3079057742 3' 9-max Seat #8 is the button
Seat 1: czini007 (6778 in chips) 
Seat 2: marquitopoker4 (2867 in chips) 
Seat 3: oronso 104 (3139 in chips) 
Seat 4: Tatanca666 (2511 in chips) 
Seat 5: $kiLLme1sTeR (2461 in chips) 
Seat 6: SteveD36 (1326 in chips) 
Seat 7: Citadel_7 (3317 in chips) 
Seat 8: jcarlos.vale (3830 in chips) 
Seat 9: Nikos8511 (3121 in chips) 
czini007: posts the ante 7
marquitopoker4: posts the ante 7
oronso 104: posts the ante 7
Tatanca666: posts the ante 7
$kiLLme1sTeR: posts the ante 7
SteveD36: posts the ante 7
Citadel_7: posts the ante 7
jcarlos.vale: posts the ante 7
Nikos8511: posts the ante 7
Nikos8511: posts small blind 30
czini007: posts big blind 60
*** HOLE CARDS ***
Dealt to jcarlos.vale [3d 6c]
marquitopoker4: raises 83 to 143
oronso 104: folds 
Tatanca666: calls 143
$kiLLme1sTeR: folds 
SteveD36: folds 
Citadel_7: folds 
jcarlos.vale: folds 
Nikos8511: folds 
czini007: folds 
*** FLOP *** [Ad 4h Jd]
marquitopoker4: bets 149
Tatanca666: folds 
Uncalled bet (149) returned to marquitopoker4
marquitopoker4 collected 439 from pot
marquitopoker4: doesn't show hand 
*** SUMMARY ***
Total pot 439 | Rake 0 
Board [Ad 4h Jd]
Seat 1: czini007 (big blind) folded before Flop
Seat 2: marquitopoker4 collected (439)
Seat 3: oronso 104 folded before Flop (didn't bet)
Seat 4: Tatanca666 folded on the Flop
Seat 5: $kiLLme1sTeR folded before Flop (didn't bet)
Seat 6: SteveD36 folded before Flop (didn't bet)
Seat 7: Citadel_7 folded before Flop (didn't bet)
Seat 8: jcarlos.vale (button) folded before Flop (didn't bet)
Seat 9: Nikos8511 (small blind) folded before Flop



PokerStars Hand #221733408797: Tournament #3079057742, $0.98+$0.12 USD Hold'em No Limit - Level IV (30/60) - 2020/12/22 23:14:35 EET [2020/12/22 16:14:35 ET]
Table '3079057742 3' 9-max Seat #9 is the button
Seat 1: czini007 (6711 in chips) 
Seat 2: marquitopoker4 (3156 in chips) 
Seat 3: oronso 104 (3132 in chips) 
Seat 4: Tatanca666 (2361 in chips) 
Seat 5: $kiLLme1sTeR (2454 in chips) 
Seat 6: SteveD36 (1319 in chips) 
Seat 7: Citadel_7 (3310 in chips) 
Seat 8: jcarlos.vale (3823 in chips) 
Seat 9: Nikos8511 (3084 in chips) 
czini007: posts the ante 7
marquitopoker4: posts the ante 7
oronso 104: posts the ante 7
Tatanca666: posts the ante 7
$kiLLme1sTeR: posts the ante 7
SteveD36: posts the ante 7
Citadel_7: posts the ante 7
jcarlos.vale: posts the ante 7
Nikos8511: posts the ante 7
czini007: posts small blind 30
marquitopoker4: posts big blind 60
*** HOLE CARDS ***
Dealt to jcarlos.vale [4h 6s]
oronso 104: raises 72 to 132
Tatanca666: folds 
$kiLLme1sTeR: folds 
SteveD36: folds 
Citadel_7: folds 
jcarlos.vale: folds 
Nikos8511: folds 
czini007: folds 
marquitopoker4: calls 72
*** FLOP *** [Qc 5d 8h]
marquitopoker4: checks 
oronso 104: bets 107
marquitopoker4: calls 107
*** TURN *** [Qc 5d 8h] [5s]
marquitopoker4: checks 
oronso 104: checks 
*** RIVER *** [Qc 5d 8h 5s] [2h]
marquitopoker4: checks 
oronso 104: checks 
*** SHOW DOWN ***
marquitopoker4: shows [Jd 9s] (a pair of Fives)
oronso 104: shows [3h 3s] (two pair, Fives and Threes)
oronso 104 collected 571 from pot
*** SUMMARY ***
Total pot 571 | Rake 0 
Board [Qc 5d 8h 5s 2h]
Seat 1: czini007 (small blind) folded before Flop
Seat 2: marquitopoker4 (big blind) showed [Jd 9s] and lost with a pair of Fives
Seat 3: oronso 104 showed [3h 3s] and won (571) with two pair, Fives and Threes
Seat 4: Tatanca666 folded before Flop (didn't bet)
Seat 5: $kiLLme1sTeR folded before Flop (didn't bet)
Seat 6: SteveD36 folded before Flop (didn't bet)
Seat 7: Citadel_7 folded before Flop (didn't bet)
Seat 8: jcarlos.vale folded before Flop (didn't bet)
Seat 9: Nikos8511 (button) folded before Flop (didn't bet)



PokerStars Hand #221733454679: Tournament #3079057742, $0.98+$0.12 USD Hold'em No Limit - Level IV (30/60) - 2020/12/22 23:15:42 EET [2020/12/22 16:15:42 ET]
Table '3079057742 3' 9-max Seat #1 is the button
Seat 1: czini007 (6674 in chips) 
Seat 2: marquitopoker4 (2910 in chips) 
Seat 3: oronso 104 (3457 in chips) 
Seat 4: Tatanca666 (2354 in chips) 
Seat 5: $kiLLme1sTeR (2447 in chips) 
Seat 6: SteveD36 (1312 in chips) 
Seat 7: Citadel_7 (3303 in chips) 
Seat 8: jcarlos.vale (3816 in chips) 
Seat 9: Nikos8511 (3077 in chips) 
czini007: posts the ante 7
marquitopoker4: posts the ante 7
oronso 104: posts the ante 7
Tatanca666: posts the ante 7
$kiLLme1sTeR: posts the ante 7
SteveD36: posts the ante 7
Citadel_7: posts the ante 7
jcarlos.vale: posts the ante 7
Nikos8511: posts the ante 7
marquitopoker4: posts small blind 30
oronso 104: posts big blind 60
*** HOLE CARDS ***
Dealt to jcarlos.vale [3c 6h]
Tatanca666: calls 60
$kiLLme1sTeR: folds 
SteveD36: folds 
Citadel_7: folds 
jcarlos.vale: folds 
Nikos8511: folds 
czini007: calls 60
marquitopoker4: folds 
oronso 104: checks 
*** FLOP *** [Qh Jh 8s]
oronso 104: checks 
Tatanca666: checks 
czini007: checks 
*** TURN *** [Qh Jh 8s] [Ks]
oronso 104: checks 
Tatanca666: checks 
czini007: checks 
*** RIVER *** [Qh Jh 8s Ks] [7c]
oronso 104: checks 
Tatanca666: checks 
czini007: bets 273
oronso 104: folds 
Tatanca666: folds 
Uncalled bet (273) returned to czini007
czini007 collected 273 from pot
czini007: doesn't show hand 
*** SUMMARY ***
Total pot 273 | Rake 0 
Board [Qh Jh 8s Ks 7c]
Seat 1: czini007 (button) collected (273)
Seat 2: marquitopoker4 (small blind) folded before Flop
Seat 3: oronso 104 (big blind) folded on the River
Seat 4: Tatanca666 folded on the River
Seat 5: $kiLLme1sTeR folded before Flop (didn't bet)
Seat 6: SteveD36 folded before Flop (didn't bet)
Seat 7: Citadel_7 folded before Flop (didn't bet)
Seat 8: jcarlos.vale folded before Flop (didn't bet)
Seat 9: Nikos8511 folded before Flop (didn't bet)



PokerStars Hand #221733481557: Tournament #3079057742, $0.98+$0.12 USD Hold'em No Limit - Level IV (30/60) - 2020/12/22 23:16:21 EET [2020/12/22 16:16:21 ET]
Table '3079057742 3' 9-max Seat #2 is the button
Seat 1: czini007 (6880 in chips) 
Seat 2: marquitopoker4 (2873 in chips) 
Seat 3: oronso 104 (3390 in chips) 
Seat 4: Tatanca666 (2287 in chips) 
Seat 5: $kiLLme1sTeR (2440 in chips) 
Seat 6: SteveD36 (1305 in chips) 
Seat 7: Citadel_7 (3296 in chips) 
Seat 8: jcarlos.vale (3809 in chips) 
Seat 9: Nikos8511 (3070 in chips) 
czini007: posts the ante 7
marquitopoker4: posts the ante 7
oronso 104: posts the ante 7
Tatanca666: posts the ante 7
$kiLLme1sTeR: posts the ante 7
SteveD36: posts the ante 7
Citadel_7: posts the ante 7
jcarlos.vale: posts the ante 7
Nikos8511: posts the ante 7
oronso 104: posts small blind 30
Tatanca666: posts big blind 60
*** HOLE CARDS ***
Dealt to jcarlos.vale [Ks 2s]
$kiLLme1sTeR: folds 
SteveD36: folds 
Citadel_7: raises 60 to 120
jcarlos.vale: folds 
Nikos8511: calls 120
czini007: folds 
marquitopoker4: calls 120
oronso 104: folds 
Tatanca666: calls 60
*** FLOP *** [5c Jc 2h]
Tatanca666: checks 
Citadel_7: checks 
Nikos8511: checks 
marquitopoker4: checks 
*** TURN *** [5c Jc 2h] [8s]
Tatanca666: bets 60
Citadel_7: raises 150 to 210
Nikos8511: calls 210
marquitopoker4: folds 
Tatanca666: folds 
*** RIVER *** [5c Jc 2h 8s] [Js]
Citadel_7: checks 
Nikos8511: bets 769
Citadel_7: folds 
Uncalled bet (769) returned to Nikos8511
Nikos8511 collected 1053 from pot
Nikos8511: doesn't show hand 
*** SUMMARY ***
Total pot 1053 | Rake 0 
Board [5c Jc 2h 8s Js]
Seat 1: czini007 folded before Flop (didn't bet)
Seat 2: marquitopoker4 (button) folded on the Turn
Seat 3: oronso 104 (small blind) folded before Flop
Seat 4: Tatanca666 (big blind) folded on the Turn
Seat 5: $kiLLme1sTeR folded before Flop (didn't bet)
Seat 6: SteveD36 folded before Flop (didn't bet)
Seat 7: Citadel_7 folded on the River
Seat 8: jcarlos.vale folded before Flop (didn't bet)
Seat 9: Nikos8511 collected (1053)



PokerStars Hand #221733542890: Tournament #3079057742, $0.98+$0.12 USD Hold'em No Limit - Level V (40/80) - 2020/12/22 23:17:50 EET [2020/12/22 16:17:50 ET]
Table '3079057742 3' 9-max Seat #3 is the button
Seat 1: czini007 (6873 in chips) 
Seat 2: marquitopoker4 (2746 in chips) 
Seat 3: oronso 104 (3353 in chips) 
Seat 4: Tatanca666 (2100 in chips) 
Seat 5: $kiLLme1sTeR (2433 in chips) 
Seat 6: SteveD36 (1298 in chips) 
Seat 7: Citadel_7 (2959 in chips) 
Seat 8: jcarlos.vale (3802 in chips) 
Seat 9: Nikos8511 (3786 in chips) 
czini007: posts the ante 10
marquitopoker4: posts the ante 10
oronso 104: posts the ante 10
Tatanca666: posts the ante 10
$kiLLme1sTeR: posts the ante 10
SteveD36: posts the ante 10
Citadel_7: posts the ante 10
jcarlos.vale: posts the ante 10
Nikos8511: posts the ante 10
Tatanca666: posts small blind 40
$kiLLme1sTeR: posts big blind 80
*** HOLE CARDS ***
Dealt to jcarlos.vale [Kc 9s]
SteveD36: folds 
Citadel_7: raises 80 to 160
jcarlos.vale: folds 
Nikos8511: folds 
czini007: folds 
marquitopoker4: folds 
oronso 104: folds 
Tatanca666: folds 
$kiLLme1sTeR: calls 80
*** FLOP *** [9c 9d As]
$kiLLme1sTeR: checks 
Citadel_7: checks 
*** TURN *** [9c 9d As] [8s]
$kiLLme1sTeR: bets 140
Citadel_7: calls 140
*** RIVER *** [9c 9d As 8s] [5h]
$kiLLme1sTeR: bets 343
Citadel_7: folds 
Uncalled bet (343) returned to $kiLLme1sTeR
$kiLLme1sTeR collected 730 from pot
*** SUMMARY ***
Total pot 730 | Rake 0 
Board [9c 9d As 8s 5h]
Seat 1: czini007 folded before Flop (didn't bet)
Seat 2: marquitopoker4 folded before Flop (didn't bet)
Seat 3: oronso 104 (button) folded before Flop (didn't bet)
Seat 4: Tatanca666 (small blind) folded before Flop
Seat 5: $kiLLme1sTeR (big blind) collected (730)
Seat 6: SteveD36 folded before Flop (didn't bet)
Seat 7: Citadel_7 folded on the River
Seat 8: jcarlos.vale folded before Flop (didn't bet)
Seat 9: Nikos8511 folded before Flop (didn't bet)



PokerStars Hand #221733599308: Tournament #3079057742, $0.98+$0.12 USD Hold'em No Limit - Level V (40/80) - 2020/12/22 23:19:10 EET [2020/12/22 16:19:10 ET]
Table '3079057742 3' 9-max Seat #4 is the button
Seat 1: czini007 (6863 in chips) 
Seat 3: oronso 104 (3343 in chips) 
Seat 4: Tatanca666 (2050 in chips) 
Seat 5: $kiLLme1sTeR (2853 in chips) 
Seat 6: SteveD36 (1288 in chips) 
Seat 7: Citadel_7 (2649 in chips) 
Seat 8: jcarlos.vale (3792 in chips) 
Seat 9: Nikos8511 (3776 in chips) 
czini007: posts the ante 10
oronso 104: posts the ante 10
Tatanca666: posts the ante 10
$kiLLme1sTeR: posts the ante 10
SteveD36: posts the ante 10
Citadel_7: posts the ante 10
jcarlos.vale: posts the ante 10
Nikos8511: posts the ante 10
$kiLLme1sTeR: posts small blind 40
SteveD36: posts big blind 80
*** HOLE CARDS ***
Dealt to jcarlos.vale [Jc 8c]
Citadel_7: folds 
jcarlos.vale: raises 128 to 208
Nikos8511: folds 
czini007: raises 688 to 896
oronso 104: folds 
Tatanca666: folds 
$kiLLme1sTeR: folds 
SteveD36: folds 
jcarlos.vale: folds 
Uncalled bet (688) returned to czini007
czini007 collected 616 from pot
czini007: doesn't show hand 
*** SUMMARY ***
Total pot 616 | Rake 0 
Seat 1: czini007 collected (616)
Seat 3: oronso 104 folded before Flop (didn't bet)
Seat 4: Tatanca666 (button) folded before Flop (didn't bet)
Seat 5: $kiLLme1sTeR (small blind) folded before Flop
Seat 6: SteveD36 (big blind) folded before Flop
Seat 7: Citadel_7 folded before Flop (didn't bet)
Seat 8: jcarlos.vale folded before Flop
Seat 9: Nikos8511 folded before Flop (didn't bet)



PokerStars Hand #221733613696: Tournament #3079057742, $0.98+$0.12 USD Hold'em No Limit - Level V (40/80) - 2020/12/22 23:19:31 EET [2020/12/22 16:19:31 ET]
Table '3079057742 3' 9-max Seat #5 is the button
Seat 1: czini007 (7261 in chips) 
Seat 3: oronso 104 (3333 in chips) 
Seat 4: Tatanca666 (2040 in chips) 
Seat 5: $kiLLme1sTeR (2803 in chips) 
Seat 6: SteveD36 (1198 in chips) 
Seat 7: Citadel_7 (2639 in chips) 
Seat 8: jcarlos.vale (3574 in chips) 
Seat 9: Nikos8511 (3766 in chips) 
czini007: posts the ante 10
oronso 104: posts the ante 10
Tatanca666: posts the ante 10
$kiLLme1sTeR: posts the ante 10
SteveD36: posts the ante 10
Citadel_7: posts the ante 10
jcarlos.vale: posts the ante 10
Nikos8511: posts the ante 10
SteveD36: posts small blind 40
Citadel_7: posts big blind 80
*** HOLE CARDS ***
Dealt to jcarlos.vale [5h 4c]
jcarlos.vale: folds 
Nikos8511: folds 
czini007: folds 
oronso 104: raises 96 to 176
Tatanca666: folds 
$kiLLme1sTeR: folds 
SteveD36: folds 
Citadel_7: calls 96
*** FLOP *** [Ah Kd Ks]
Citadel_7: checks 
oronso 104: bets 156
Citadel_7: folds 
Uncalled bet (156) returned to oronso 104
oronso 104 collected 472 from pot
oronso 104: doesn't show hand 
*** SUMMARY ***
Total pot 472 | Rake 0 
Board [Ah Kd Ks]
Seat 1: czini007 folded before Flop (didn't bet)
Seat 3: oronso 104 collected (472)
Seat 4: Tatanca666 folded before Flop (didn't bet)
Seat 5: $kiLLme1sTeR (button) folded before Flop (didn't bet)
Seat 6: SteveD36 (small blind) folded before Flop
Seat 7: Citadel_7 (big blind) folded on the Flop
Seat 8: jcarlos.vale folded before Flop (didn't bet)
Seat 9: Nikos8511 folded before Flop (didn't bet)



PokerStars Hand #221733654193: Tournament #3079057742, $0.98+$0.12 USD Hold'em No Limit - Level V (40/80) - 2020/12/22 23:20:27 EET [2020/12/22 16:20:27 ET]
Table '3079057742 3' 9-max Seat #6 is the button
Seat 1: czini007 (7251 in chips) 
Seat 3: oronso 104 (3619 in chips) 
Seat 4: Tatanca666 (2030 in chips) 
Seat 5: $kiLLme1sTeR (2793 in chips) 
Seat 6: SteveD36 (1148 in chips) 
Seat 7: Citadel_7 (2453 in chips) 
Seat 8: jcarlos.vale (3564 in chips) 
Seat 9: Nikos8511 (3756 in chips) 
czini007: posts the ante 10
oronso 104: posts the ante 10
Tatanca666: posts the ante 10
$kiLLme1sTeR: posts the ante 10
SteveD36: posts the ante 10
Citadel_7: posts the ante 10
jcarlos.vale: posts the ante 10
Nikos8511: posts the ante 10
Citadel_7: posts small blind 40
jcarlos.vale: posts big blind 80
*** HOLE CARDS ***
Dealt to jcarlos.vale [Th Jh]
Nikos8511: folds 
czini007: folds 
oronso 104: folds 
Tatanca666: folds 
$kiLLme1sTeR: folds 
SteveD36: raises 1058 to 1138 and is all-in
Citadel_7: folds 
jcarlos.vale: folds 
Uncalled bet (1058) returned to SteveD36
SteveD36 collected 280 from pot
SteveD36: doesn't show hand 
*** SUMMARY ***
Total pot 280 | Rake 0 
Seat 1: czini007 folded before Flop (didn't bet)
Seat 3: oronso 104 folded before Flop (didn't bet)
Seat 4: Tatanca666 folded before Flop (didn't bet)
Seat 5: $kiLLme1sTeR folded before Flop (didn't bet)
Seat 6: SteveD36 (button) collected (280)
Seat 7: Citadel_7 (small blind) folded before Flop
Seat 8: jcarlos.vale (big blind) folded before Flop
Seat 9: Nikos8511 folded before Flop (didn't bet)



PokerStars Hand #221733671514: Tournament #3079057742, $0.98+$0.12 USD Hold'em No Limit - Level V (40/80) - 2020/12/22 23:20:52 EET [2020/12/22 16:20:52 ET]
Table '3079057742 3' 9-max Seat #7 is the button
Seat 1: czini007 (7241 in chips) 
Seat 2: WhoIsThisGuy20 (3485 in chips) 
Seat 3: oronso 104 (3609 in chips) 
Seat 4: Tatanca666 (2020 in chips) 
Seat 5: $kiLLme1sTeR (2783 in chips) 
Seat 6: SteveD36 (1338 in chips) 
Seat 7: Citadel_7 (2403 in chips) 
Seat 8: jcarlos.vale (3474 in chips) 
Seat 9: Nikos8511 (3746 in chips) 
czini007: posts the ante 10
WhoIsThisGuy20: posts the ante 10
oronso 104: posts the ante 10
Tatanca666: posts the ante 10
$kiLLme1sTeR: posts the ante 10
SteveD36: posts the ante 10
Citadel_7: posts the ante 10
jcarlos.vale: posts the ante 10
Nikos8511: posts the ante 10
jcarlos.vale: posts small blind 40
Nikos8511: posts big blind 80
*** HOLE CARDS ***
Dealt to jcarlos.vale [6s 7d]
czini007: calls 80
WhoIsThisGuy20: folds 
oronso 104: folds 
Tatanca666: calls 80
$kiLLme1sTeR: raises 284 to 364
SteveD36: folds 
Citadel_7: folds 
jcarlos.vale: folds 
Nikos8511: folds 
czini007: folds 
Tatanca666: calls 284
*** FLOP *** [Kd 2s 7s]
Tatanca666: bets 1018
$kiLLme1sTeR: folds 
Uncalled bet (1018) returned to Tatanca666
Tatanca666 collected 1018 from pot
*** SUMMARY ***
Total pot 1018 | Rake 0 
Board [Kd 2s 7s]
Seat 1: czini007 folded before Flop
Seat 2: WhoIsThisGuy20 folded before Flop (didn't bet)
Seat 3: oronso 104 folded before Flop (didn't bet)
Seat 4: Tatanca666 collected (1018)
Seat 5: $kiLLme1sTeR folded on the Flop
Seat 6: SteveD36 folded before Flop (didn't bet)
Seat 7: Citadel_7 (button) folded before Flop (didn't bet)
Seat 8: jcarlos.vale (small blind) folded before Flop
Seat 9: Nikos8511 (big blind) folded before Flop



PokerStars Hand #221733695617: Tournament #3079057742, $0.98+$0.12 USD Hold'em No Limit - Level V (40/80) - 2020/12/22 23:21:27 EET [2020/12/22 16:21:27 ET]
Table '3079057742 3' 9-max Seat #8 is the button
Seat 1: czini007 (7151 in chips) 
Seat 2: WhoIsThisGuy20 (3475 in chips) 
Seat 3: oronso 104 (3599 in chips) 
Seat 4: Tatanca666 (2664 in chips) 
Seat 5: $kiLLme1sTeR (2409 in chips) 
Seat 6: SteveD36 (1328 in chips) 
Seat 7: Citadel_7 (2393 in chips) 
Seat 8: jcarlos.vale (3424 in chips) 
Seat 9: Nikos8511 (3656 in chips) 
czini007: posts the ante 10
WhoIsThisGuy20: posts the ante 10
oronso 104: posts the ante 10
Tatanca666: posts the ante 10
$kiLLme1sTeR: posts the ante 10
SteveD36: posts the ante 10
Citadel_7: posts the ante 10
jcarlos.vale: posts the ante 10
Nikos8511: posts the ante 10
Nikos8511: posts small blind 40
czini007: posts big blind 80
*** HOLE CARDS ***
Dealt to jcarlos.vale [4c 4h]
WhoIsThisGuy20: folds 
oronso 104: folds 
Tatanca666: calls 80
$kiLLme1sTeR: raises 284 to 364
SteveD36: folds 
Citadel_7: folds 
jcarlos.vale: folds 
Nikos8511: folds 
czini007: folds 
Tatanca666: folds 
Uncalled bet (284) returned to $kiLLme1sTeR
$kiLLme1sTeR collected 370 from pot
*** SUMMARY ***
Total pot 370 | Rake 0 
Seat 1: czini007 (big blind) folded before Flop
Seat 2: WhoIsThisGuy20 folded before Flop (didn't bet)
Seat 3: oronso 104 folded before Flop (didn't bet)
Seat 4: Tatanca666 folded before Flop
Seat 5: $kiLLme1sTeR collected (370)
Seat 6: SteveD36 folded before Flop (didn't bet)
Seat 7: Citadel_7 folded before Flop (didn't bet)
Seat 8: jcarlos.vale (button) folded before Flop (didn't bet)
Seat 9: Nikos8511 (small blind) folded before Flop



PokerStars Hand #221733719989: Tournament #3079057742, $0.98+$0.12 USD Hold'em No Limit - Level V (40/80) - 2020/12/22 23:22:02 EET [2020/12/22 16:22:02 ET]
Table '3079057742 3' 9-max Seat #9 is the button
Seat 1: czini007 (7061 in chips) 
Seat 2: WhoIsThisGuy20 (3465 in chips) 
Seat 3: oronso 104 (3589 in chips) 
Seat 4: Tatanca666 (2574 in chips) 
Seat 5: $kiLLme1sTeR (2689 in chips) 
Seat 6: SteveD36 (1318 in chips) 
Seat 7: Citadel_7 (2383 in chips) 
Seat 8: jcarlos.vale (3414 in chips) 
Seat 9: Nikos8511 (3606 in chips) 
czini007: posts the ante 10
WhoIsThisGuy20: posts the ante 10
oronso 104: posts the ante 10
Tatanca666: posts the ante 10
$kiLLme1sTeR: posts the ante 10
SteveD36: posts the ante 10
Citadel_7: posts the ante 10
jcarlos.vale: posts the ante 10
Nikos8511: posts the ante 10
czini007: posts small blind 40
WhoIsThisGuy20: posts big blind 80
*** HOLE CARDS ***
Dealt to jcarlos.vale [8h 7h]
oronso 104: folds 
Tatanca666: calls 80
$kiLLme1sTeR: calls 80
SteveD36: folds 
Citadel_7: folds 
jcarlos.vale: raises 128 to 208
Nikos8511: folds 
czini007: folds 
WhoIsThisGuy20: folds 
Tatanca666: folds 
$kiLLme1sTeR: calls 128
*** FLOP *** [Ah 5d 6c]
$kiLLme1sTeR: checks 
jcarlos.vale: bets 160
$kiLLme1sTeR: folds 
Uncalled bet (160) returned to jcarlos.vale
jcarlos.vale collected 706 from pot
jcarlos.vale: doesn't show hand 
*** SUMMARY ***
Total pot 706 | Rake 0 
Board [Ah 5d 6c]
Seat 1: czini007 (small blind) folded before Flop
Seat 2: WhoIsThisGuy20 (big blind) folded before Flop
Seat 3: oronso 104 folded before Flop (didn't bet)
Seat 4: Tatanca666 folded before Flop
Seat 5: $kiLLme1sTeR folded on the Flop
Seat 6: SteveD36 folded before Flop (didn't bet)
Seat 7: Citadel_7 folded before Flop (didn't bet)
Seat 8: jcarlos.vale collected (706)
Seat 9: Nikos8511 (button) folded before Flop (didn't bet)



PokerStars Hand #221733739696: Tournament #3079057742, $0.98+$0.12 USD Hold'em No Limit - Level V (40/80) - 2020/12/22 23:22:30 EET [2020/12/22 16:22:30 ET]
Table '3079057742 3' 9-max Seat #1 is the button
Seat 1: czini007 (7011 in chips) 
Seat 2: WhoIsThisGuy20 (3375 in chips) 
Seat 3: oronso 104 (3579 in chips) 
Seat 4: Tatanca666 (2484 in chips) 
Seat 5: $kiLLme1sTeR (2471 in chips) 
Seat 6: SteveD36 (1308 in chips) 
Seat 7: Citadel_7 (2373 in chips) 
Seat 8: jcarlos.vale (3902 in chips) 
Seat 9: Nikos8511 (3596 in chips) 
czini007: posts the ante 10
WhoIsThisGuy20: posts the ante 10
oronso 104: posts the ante 10
Tatanca666: posts the ante 10
$kiLLme1sTeR: posts the ante 10
SteveD36: posts the ante 10
Citadel_7: posts the ante 10
jcarlos.vale: posts the ante 10
Nikos8511: posts the ante 10
WhoIsThisGuy20: posts small blind 40
oronso 104: posts big blind 80
*** HOLE CARDS ***
Dealt to jcarlos.vale [9s 6c]
Tatanca666: folds 
$kiLLme1sTeR: folds 
SteveD36: folds 
Citadel_7 has timed out
Citadel_7: folds 
Citadel_7 is sitting out
jcarlos.vale: folds 
Nikos8511: folds 
czini007: raises 80 to 160
WhoIsThisGuy20: folds 
oronso 104: folds 
Uncalled bet (80) returned to czini007
czini007 collected 290 from pot
czini007: doesn't show hand 
*** SUMMARY ***
Total pot 290 | Rake 0 
Seat 1: czini007 (button) collected (290)
Seat 2: WhoIsThisGuy20 (small blind) folded before Flop
Seat 3: oronso 104 (big blind) folded before Flop
Seat 4: Tatanca666 folded before Flop (didn't bet)
Seat 5: $kiLLme1sTeR folded before Flop (didn't bet)
Seat 6: SteveD36 folded before Flop (didn't bet)
Seat 7: Citadel_7 folded before Flop (didn't bet)
Seat 8: jcarlos.vale folded before Flop (didn't bet)
Seat 9: Nikos8511 folded before Flop (didn't bet)



PokerStars Hand #221733765606: Tournament #3079057742, $0.98+$0.12 USD Hold'em No Limit - Level V (40/80) - 2020/12/22 23:23:07 EET [2020/12/22 16:23:07 ET]
Table '3079057742 3' 9-max Seat #2 is the button
Seat 1: czini007 (7211 in chips) 
Seat 2: WhoIsThisGuy20 (3325 in chips) 
Seat 3: oronso 104 (3489 in chips) 
Seat 4: Tatanca666 (2474 in chips) 
Seat 5: $kiLLme1sTeR (2461 in chips) 
Seat 6: SteveD36 (1298 in chips) 
Seat 7: Citadel_7 (2363 in chips) 
Seat 8: jcarlos.vale (3892 in chips) 
Seat 9: Nikos8511 (3586 in chips) 
czini007: posts the ante 10
WhoIsThisGuy20: posts the ante 10
oronso 104: posts the ante 10
Tatanca666: posts the ante 10
$kiLLme1sTeR: posts the ante 10
SteveD36: posts the ante 10
Citadel_7: posts the ante 10
jcarlos.vale: posts the ante 10
Nikos8511: posts the ante 10
oronso 104: posts small blind 40
Tatanca666: posts big blind 80
*** HOLE CARDS ***
Dealt to jcarlos.vale [2d Ac]
$kiLLme1sTeR: folds 
SteveD36: folds 
Citadel_7: folds 
jcarlos.vale: folds 
Nikos8511: folds 
czini007: folds 
WhoIsThisGuy20: folds 
oronso 104: folds 
Uncalled bet (40) returned to Tatanca666
Tatanca666 collected 170 from pot
*** SUMMARY ***
Total pot 170 | Rake 0 
Seat 1: czini007 folded before Flop (didn't bet)
Seat 2: WhoIsThisGuy20 (button) folded before Flop (didn't bet)
Seat 3: oronso 104 (small blind) folded before Flop
Seat 4: Tatanca666 (big blind) collected (170)
Seat 5: $kiLLme1sTeR folded before Flop (didn't bet)
Seat 6: SteveD36 folded before Flop (didn't bet)
Seat 7: Citadel_7 folded before Flop (didn't bet)
Seat 8: jcarlos.vale folded before Flop (didn't bet)
Seat 9: Nikos8511 folded before Flop (didn't bet)



PokerStars Hand #221733782428: Tournament #3079057742, $0.98+$0.12 USD Hold'em No Limit - Level V (40/80) - 2020/12/22 23:23:31 EET [2020/12/22 16:23:31 ET]
Table '3079057742 3' 9-max Seat #3 is the button
Seat 1: czini007 (7201 in chips) 
Seat 2: WhoIsThisGuy20 (3315 in chips) 
Seat 3: oronso 104 (3439 in chips) 
Seat 4: Tatanca666 (2594 in chips) 
Seat 5: $kiLLme1sTeR (2451 in chips) 
Seat 6: SteveD36 (1288 in chips) 
Seat 7: Citadel_7 (2353 in chips) 
Seat 8: jcarlos.vale (3882 in chips) 
Seat 9: Nikos8511 (3576 in chips) 
czini007: posts the ante 10
WhoIsThisGuy20: posts the ante 10
oronso 104: posts the ante 10
Tatanca666: posts the ante 10
$kiLLme1sTeR: posts the ante 10
SteveD36: posts the ante 10
Citadel_7: posts the ante 10
jcarlos.vale: posts the ante 10
Nikos8511: posts the ante 10
Tatanca666: posts small blind 40
$kiLLme1sTeR: posts big blind 80
*** HOLE CARDS ***
Dealt to jcarlos.vale [2h Qd]
SteveD36: folds 
Citadel_7: raises 160 to 240
jcarlos.vale: folds 
Nikos8511: folds 
czini007: folds 
WhoIsThisGuy20: folds 
oronso 104: folds 
Tatanca666: calls 200
$kiLLme1sTeR: folds 
*** FLOP *** [8d 4h Ah]
Tatanca666: bets 80
Citadel_7: raises 440 to 520
Tatanca666: folds 
Uncalled bet (440) returned to Citadel_7
Citadel_7 collected 810 from pot
Citadel_7: doesn't show hand 
*** SUMMARY ***
Total pot 810 | Rake 0 
Board [8d 4h Ah]
Seat 1: czini007 folded before Flop (didn't bet)
Seat 2: WhoIsThisGuy20 folded before Flop (didn't bet)
Seat 3: oronso 104 (button) folded before Flop (didn't bet)
Seat 4: Tatanca666 (small blind) folded on the Flop
Seat 5: $kiLLme1sTeR (big blind) folded before Flop
Seat 6: SteveD36 folded before Flop (didn't bet)
Seat 7: Citadel_7 collected (810)
Seat 8: jcarlos.vale folded before Flop (didn't bet)
Seat 9: Nikos8511 folded before Flop (didn't bet)



PokerStars Hand #221733817070: Tournament #3079057742, $0.98+$0.12 USD Hold'em No Limit - Level V (40/80) - 2020/12/22 23:24:21 EET [2020/12/22 16:24:21 ET]
Table '3079057742 3' 9-max Seat #4 is the button
Seat 1: czini007 (7191 in chips) 
Seat 2: WhoIsThisGuy20 (3305 in chips) 
Seat 3: oronso 104 (3429 in chips) 
Seat 4: Tatanca666 (2264 in chips) 
Seat 5: $kiLLme1sTeR (2361 in chips) 
Seat 6: SteveD36 (1278 in chips) 
Seat 7: Citadel_7 (2833 in chips) 
Seat 8: jcarlos.vale (3872 in chips) 
Seat 9: Nikos8511 (3566 in chips) 
czini007: posts the ante 10
WhoIsThisGuy20: posts the ante 10
oronso 104: posts the ante 10
Tatanca666: posts the ante 10
$kiLLme1sTeR: posts the ante 10
SteveD36: posts the ante 10
Citadel_7: posts the ante 10
jcarlos.vale: posts the ante 10
Nikos8511: posts the ante 10
$kiLLme1sTeR: posts small blind 40
SteveD36: posts big blind 80
*** HOLE CARDS ***
Dealt to jcarlos.vale [Ac Ts]
Citadel_7: folds 
jcarlos.vale: raises 128 to 208
Nikos8511: calls 208
czini007: folds 
WhoIsThisGuy20: folds 
oronso 104: folds 
Tatanca666: raises 2046 to 2254 and is all-in
$kiLLme1sTeR: folds 
SteveD36: folds 
jcarlos.vale: folds 
Nikos8511: folds 
Uncalled bet (2046) returned to Tatanca666
Tatanca666 collected 834 from pot
*** SUMMARY ***
Total pot 834 | Rake 0 
Seat 1: czini007 folded before Flop (didn't bet)
Seat 2: WhoIsThisGuy20 folded before Flop (didn't bet)
Seat 3: oronso 104 folded before Flop (didn't bet)
Seat 4: Tatanca666 (button) collected (834)
Seat 5: $kiLLme1sTeR (small blind) folded before Flop
Seat 6: SteveD36 (big blind) folded before Flop
Seat 7: Citadel_7 folded before Flop (didn't bet)
Seat 8: jcarlos.vale folded before Flop
Seat 9: Nikos8511 folded before Flop



PokerStars Hand #221733839136: Tournament #3079057742, $0.98+$0.12 USD Hold'em No Limit - Level V (40/80) - 2020/12/22 23:24:43 EET [2020/12/22 16:24:43 ET]
Table '3079057742 3' 9-max Seat #5 is the button
Seat 1: czini007 (7181 in chips) 
Seat 2: WhoIsThisGuy20 (3295 in chips) 
Seat 3: oronso 104 (3419 in chips) 
Seat 4: Tatanca666 (2880 in chips) 
Seat 5: $kiLLme1sTeR (2311 in chips) 
Seat 6: SteveD36 (1188 in chips) 
Seat 7: Citadel_7 (2823 in chips) 
Seat 8: jcarlos.vale (3654 in chips) 
Seat 9: Nikos8511 (3348 in chips) 
czini007: posts the ante 10
WhoIsThisGuy20: posts the ante 10
oronso 104: posts the ante 10
Tatanca666: posts the ante 10
$kiLLme1sTeR: posts the ante 10
SteveD36: posts the ante 10
Citadel_7: posts the ante 10
jcarlos.vale: posts the ante 10
Nikos8511: posts the ante 10
SteveD36: posts small blind 40
Citadel_7: posts big blind 80
*** HOLE CARDS ***
Dealt to jcarlos.vale [Kd 5d]
jcarlos.vale: folds 
Nikos8511: raises 104 to 184
czini007: folds 
WhoIsThisGuy20: calls 184
oronso 104: folds 
Tatanca666: calls 184
$kiLLme1sTeR: calls 184
SteveD36: folds 
Citadel_7: folds 
*** FLOP *** [Qs Kc 9s]
Nikos8511: bets 691
WhoIsThisGuy20: raises 2410 to 3101 and is all-in
Tatanca666: folds 
$kiLLme1sTeR: folds 
Nikos8511: calls 2410
*** TURN *** [Qs Kc 9s] [8c]
*** RIVER *** [Qs Kc 9s 8c] [5h]
*** SHOW DOWN ***
Nikos8511: shows [Ks Qc] (two pair, Kings and Queens)
WhoIsThisGuy20: shows [Ad Ac] (a pair of Aces)
Nikos8511 collected 7148 from pot
WhoIsThisGuy20 finished the tournament
*** SUMMARY ***
Total pot 7148 | Rake 0 
Board [Qs Kc 9s 8c 5h]
Seat 1: czini007 folded before Flop (didn't bet)
Seat 2: WhoIsThisGuy20 showed [Ad Ac] and lost with a pair of Aces
Seat 3: oronso 104 folded before Flop (didn't bet)
Seat 4: Tatanca666 folded on the Flop
Seat 5: $kiLLme1sTeR (button) folded on the Flop
Seat 6: SteveD36 (small blind) folded before Flop
Seat 7: Citadel_7 (big blind) folded before Flop
Seat 8: jcarlos.vale folded before Flop (didn't bet)
Seat 9: Nikos8511 showed [Ks Qc] and won (7148) with two pair, Kings and Queens



PokerStars Hand #221733870817: Tournament #3079057742, $0.98+$0.12 USD Hold'em No Limit - Level V (40/80) - 2020/12/22 23:25:29 EET [2020/12/22 16:25:29 ET]
Table '3079057742 3' 9-max Seat #6 is the button
Seat 1: czini007 (7171 in chips) 
Seat 3: oronso 104 (3409 in chips) 
Seat 4: Tatanca666 (2686 in chips) 
Seat 5: $kiLLme1sTeR (2117 in chips) 
Seat 6: SteveD36 (1138 in chips) 
Seat 7: Citadel_7 (2733 in chips) 
Seat 8: jcarlos.vale (3644 in chips) 
Seat 9: Nikos8511 (7201 in chips) 
czini007: posts the ante 10
oronso 104: posts the ante 10
Tatanca666: posts the ante 10
$kiLLme1sTeR: posts the ante 10
SteveD36: posts the ante 10
Citadel_7: posts the ante 10
jcarlos.vale: posts the ante 10
Nikos8511: posts the ante 10
Citadel_7: posts small blind 40
jcarlos.vale: posts big blind 80
*** HOLE CARDS ***
Dealt to jcarlos.vale [4h 7d]
Nikos8511: raises 104 to 184
czini007: calls 184
oronso 104: raises 3215 to 3399 and is all-in
Tatanca666: folds 
$kiLLme1sTeR: folds 
SteveD36: folds 
Citadel_7: folds 
jcarlos.vale: folds 
Nikos8511: folds 
czini007: calls 3215
*** FLOP *** [2c Ks Kh]
*** TURN *** [2c Ks Kh] [3s]
*** RIVER *** [2c Ks Kh 3s] [Th]
*** SHOW DOWN ***
czini007: shows [Qh Kd] (three of a kind, Kings)
oronso 104: shows [Kc Ac] (three of a kind, Kings - Ace kicker)
oronso 104 collected 7182 from pot
*** SUMMARY ***
Total pot 7182 | Rake 0 
Board [2c Ks Kh 3s Th]
Seat 1: czini007 showed [Qh Kd] and lost with three of a kind, Kings
Seat 3: oronso 104 showed [Kc Ac] and won (7182) with three of a kind, Kings
Seat 4: Tatanca666 folded before Flop (didn't bet)
Seat 5: $kiLLme1sTeR folded before Flop (didn't bet)
Seat 6: SteveD36 (button) folded before Flop (didn't bet)
Seat 7: Citadel_7 (small blind) folded before Flop
Seat 8: jcarlos.vale (big blind) folded before Flop
Seat 9: Nikos8511 folded before Flop



PokerStars Hand #221733890383: Tournament #3079057742, $0.98+$0.12 USD Hold'em No Limit - Level V (40/80) - 2020/12/22 23:25:57 EET [2020/12/22 16:25:57 ET]
Table '3079057742 3' 9-max Seat #7 is the button
Seat 1: czini007 (3762 in chips) 
Seat 3: oronso 104 (7182 in chips) 
Seat 4: Tatanca666 (2676 in chips) 
Seat 5: $kiLLme1sTeR (2107 in chips) 
Seat 6: SteveD36 (1128 in chips) 
Seat 7: Citadel_7 (2683 in chips) 
Seat 8: jcarlos.vale (3554 in chips) 
Seat 9: Nikos8511 (7007 in chips) 
czini007: posts the ante 10
oronso 104: posts the ante 10
Tatanca666: posts the ante 10
$kiLLme1sTeR: posts the ante 10
SteveD36: posts the ante 10
Citadel_7: posts the ante 10
jcarlos.vale: posts the ante 10
Nikos8511: posts the ante 10
jcarlos.vale: posts small blind 40
Nikos8511: posts big blind 80
*** HOLE CARDS ***
Dealt to jcarlos.vale [Ah 6h]
czini007: folds 
oronso 104: folds 
Tatanca666: calls 80
$kiLLme1sTeR: folds 
SteveD36: folds 
Citadel_7: folds 
jcarlos.vale: calls 40
Nikos8511: checks 
*** FLOP *** [7s Ks Jd]
jcarlos.vale: checks 
Nikos8511: checks 
Tatanca666: checks 
*** TURN *** [7s Ks Jd] [9d]
jcarlos.vale: checks 
Nikos8511: checks 
Tatanca666: checks 
*** RIVER *** [7s Ks Jd 9d] [Jh]
jcarlos.vale: checks 
Nikos8511: checks 
Tatanca666: checks 
*** SHOW DOWN ***
jcarlos.vale: shows [Ah 6h] (a pair of Jacks)
Nikos8511: mucks hand 
Tatanca666: shows [Ad 5h] (a pair of Jacks)
jcarlos.vale collected 160 from pot
Tatanca666 collected 160 from pot
*** SUMMARY ***
Total pot 320 | Rake 0 
Board [7s Ks Jd 9d Jh]
Seat 1: czini007 folded before Flop (didn't bet)
Seat 3: oronso 104 folded before Flop (didn't bet)
Seat 4: Tatanca666 showed [Ad 5h] and won (160) with a pair of Jacks
Seat 5: $kiLLme1sTeR folded before Flop (didn't bet)
Seat 6: SteveD36 folded before Flop (didn't bet)
Seat 7: Citadel_7 (button) folded before Flop (didn't bet)
Seat 8: jcarlos.vale (small blind) showed [Ah 6h] and won (160) with a pair of Jacks
Seat 9: Nikos8511 (big blind) mucked [Qc 2c]



PokerStars Hand #221733915706: Tournament #3079057742, $0.98+$0.12 USD Hold'em No Limit - Level V (40/80) - 2020/12/22 23:26:34 EET [2020/12/22 16:26:34 ET]
Table '3079057742 3' 9-max Seat #8 is the button
Seat 1: czini007 (3752 in chips) 
Seat 3: oronso 104 (7172 in chips) 
Seat 4: Tatanca666 (2746 in chips) 
Seat 5: $kiLLme1sTeR (2097 in chips) 
Seat 6: SteveD36 (1118 in chips) 
Seat 7: Citadel_7 (2673 in chips) 
Seat 8: jcarlos.vale (3624 in chips) 
Seat 9: Nikos8511 (6917 in chips) 
czini007: posts the ante 10
oronso 104: posts the ante 10
Tatanca666: posts the ante 10
$kiLLme1sTeR: posts the ante 10
SteveD36: posts the ante 10
Citadel_7: posts the ante 10
jcarlos.vale: posts the ante 10
Nikos8511: posts the ante 10
Nikos8511: posts small blind 40
czini007: posts big blind 80
*** HOLE CARDS ***
Dealt to jcarlos.vale [6h 5c]
oronso 104: folds 
Tatanca666: calls 80
$kiLLme1sTeR: folds 
SteveD36: raises 1028 to 1108 and is all-in
Citadel_7: folds 
jcarlos.vale: folds 
Nikos8511: folds 
czini007: folds 
Tatanca666: folds 
Uncalled bet (1028) returned to SteveD36
SteveD36 collected 360 from pot
*** SUMMARY ***
Total pot 360 | Rake 0 
Seat 1: czini007 (big blind) folded before Flop
Seat 3: oronso 104 folded before Flop (didn't bet)
Seat 4: Tatanca666 folded before Flop
Seat 5: $kiLLme1sTeR folded before Flop (didn't bet)
Seat 6: SteveD36 collected (360)
Seat 7: Citadel_7 folded before Flop (didn't bet)
Seat 8: jcarlos.vale (button) folded before Flop (didn't bet)
Seat 9: Nikos8511 (small blind) folded before Flop



PokerStars Hand #221733934297: Tournament #3079057742, $0.98+$0.12 USD Hold'em No Limit - Level VI (50/100) - 2020/12/22 23:27:01 EET [2020/12/22 16:27:01 ET]
Table '3079057742 3' 9-max Seat #9 is the button
Seat 1: czini007 (3662 in chips) 
Seat 3: oronso 104 (7162 in chips) 
Seat 4: Tatanca666 (2656 in chips) 
Seat 5: $kiLLme1sTeR (2087 in chips) 
Seat 6: SteveD36 (1388 in chips) 
Seat 7: Citadel_7 (2663 in chips) 
Seat 8: jcarlos.vale (3614 in chips) 
Seat 9: Nikos8511 (6867 in chips) 
czini007: posts the ante 12
oronso 104: posts the ante 12
Tatanca666: posts the ante 12
$kiLLme1sTeR: posts the ante 12
SteveD36: posts the ante 12
Citadel_7: posts the ante 12
jcarlos.vale: posts the ante 12
Nikos8511: posts the ante 12
czini007: posts small blind 50
oronso 104: posts big blind 100
*** HOLE CARDS ***
Dealt to jcarlos.vale [Qd Jc]
Tatanca666: folds 
$kiLLme1sTeR: folds 
SteveD36: folds 
Citadel_7: folds 
jcarlos.vale: raises 160 to 260
Nikos8511: calls 260
czini007: folds 
oronso 104: folds 
*** FLOP *** [3d Qh 8d]
jcarlos.vale: bets 300
Nikos8511: calls 300
*** TURN *** [3d Qh 8d] [7d]
jcarlos.vale: bets 300
Nikos8511: raises 2163 to 2463
jcarlos.vale: folds [Qd]
Uncalled bet (2163) returned to Nikos8511
Nikos8511 collected 1966 from pot
Nikos8511: doesn't show hand 
*** SUMMARY ***
Total pot 1966 | Rake 0 
Board [3d Qh 8d 7d]
Seat 1: czini007 (small blind) folded before Flop
Seat 3: oronso 104 (big blind) folded before Flop
Seat 4: Tatanca666 folded before Flop (didn't bet)
Seat 5: $kiLLme1sTeR folded before Flop (didn't bet)
Seat 6: SteveD36 folded before Flop (didn't bet)
Seat 7: Citadel_7 folded before Flop (didn't bet)
Seat 8: jcarlos.vale folded on the Turn
Seat 9: Nikos8511 (button) collected (1966)



PokerStars Hand #221733975445: Tournament #3079057742, $0.98+$0.12 USD Hold'em No Limit - Level VI (50/100) - 2020/12/22 23:28:01 EET [2020/12/22 16:28:01 ET]
Table '3079057742 3' 9-max Seat #1 is the button
Seat 1: czini007 (3600 in chips) 
Seat 2: spy4711 (6161 in chips) out of hand (moved from another table into small blind)
Seat 3: oronso 104 (7050 in chips) 
Seat 4: Tatanca666 (2644 in chips) 
Seat 5: $kiLLme1sTeR (2075 in chips) 
Seat 6: SteveD36 (1376 in chips) 
Seat 7: Citadel_7 (2651 in chips) 
Seat 8: jcarlos.vale (2742 in chips) 
Seat 9: Nikos8511 (7961 in chips) 
spy4711 will be allowed to play after the button
czini007: posts the ante 12
oronso 104: posts the ante 12
Tatanca666: posts the ante 12
$kiLLme1sTeR: posts the ante 12
SteveD36: posts the ante 12
Citadel_7: posts the ante 12
jcarlos.vale: posts the ante 12
Nikos8511: posts the ante 12
oronso 104: posts small blind 50
Tatanca666: posts big blind 100
*** HOLE CARDS ***
Dealt to jcarlos.vale [4s 7d]
$kiLLme1sTeR: folds 
SteveD36: raises 200 to 300
Citadel_7: folds 
jcarlos.vale: folds 
Nikos8511: folds 
czini007: raises 3288 to 3588 and is all-in
oronso 104: folds 
Tatanca666: folds 
SteveD36: calls 1064 and is all-in
Uncalled bet (2224) returned to czini007
*** FLOP *** [5d 3c 3s]
*** TURN *** [5d 3c 3s] [4c]
*** RIVER *** [5d 3c 3s 4c] [9s]
*** SHOW DOWN ***
SteveD36: shows [Js Jd] (two pair, Jacks and Threes)
czini007: shows [8s Ah] (a pair of Threes)
SteveD36 collected 2974 from pot
*** SUMMARY ***
Total pot 2974 | Rake 0 
Board [5d 3c 3s 4c 9s]
Seat 1: czini007 (button) showed [8s Ah] and lost with a pair of Threes
Seat 3: oronso 104 (small blind) folded before Flop
Seat 4: Tatanca666 (big blind) folded before Flop
Seat 5: $kiLLme1sTeR folded before Flop (didn't bet)
Seat 6: SteveD36 showed [Js Jd] and won (2974) with two pair, Jacks and Threes
Seat 7: Citadel_7 folded before Flop (didn't bet)
Seat 8: jcarlos.vale folded before Flop (didn't bet)
Seat 9: Nikos8511 folded before Flop (didn't bet)



PokerStars Hand #221733992343: Tournament #3079057742, $0.98+$0.12 USD Hold'em No Limit - Level VI (50/100) - 2020/12/22 23:28:25 EET [2020/12/22 16:28:25 ET]
Table '3079057742 3' 9-max Seat #3 is the button
Seat 1: czini007 (2224 in chips) 
Seat 2: spy4711 (6161 in chips) 
Seat 3: oronso 104 (6988 in chips) 
Seat 4: Tatanca666 (2532 in chips) 
Seat 5: $kiLLme1sTeR (2063 in chips) 
Seat 6: SteveD36 (2974 in chips) 
Seat 7: Citadel_7 (2639 in chips) 
Seat 8: jcarlos.vale (2730 in chips) 
Seat 9: Nikos8511 (7949 in chips) 
czini007: posts the ante 12
spy4711: posts the ante 12
oronso 104: posts the ante 12
Tatanca666: posts the ante 12
$kiLLme1sTeR: posts the ante 12
SteveD36: posts the ante 12
Citadel_7: posts the ante 12
jcarlos.vale: posts the ante 12
Nikos8511: posts the ante 12
Tatanca666: posts small blind 50
$kiLLme1sTeR: posts big blind 100
*** HOLE CARDS ***
Dealt to jcarlos.vale [Qs 9d]
SteveD36: folds 
Citadel_7: raises 100 to 200
jcarlos.vale: folds 
Nikos8511: folds 
czini007: raises 2012 to 2212 and is all-in
spy4711: folds 
oronso 104: folds 
Tatanca666: raises 308 to 2520 and is all-in
$kiLLme1sTeR: folds 
Citadel_7: folds 
Uncalled bet (308) returned to Tatanca666
*** FLOP *** [Qc Js 8h]
*** TURN *** [Qc Js 8h] [8s]
*** RIVER *** [Qc Js 8h 8s] [Jc]
*** SHOW DOWN ***
Tatanca666: shows [7s 7h] (two pair, Jacks and Eights)
czini007: shows [Ac Qh] (two pair, Queens and Jacks)
czini007 collected 4832 from pot
*** SUMMARY ***
Total pot 4832 | Rake 0 
Board [Qc Js 8h 8s Jc]
Seat 1: czini007 showed [Ac Qh] and won (4832) with two pair, Queens and Jacks
Seat 2: spy4711 folded before Flop (didn't bet)
Seat 3: oronso 104 (button) folded before Flop (didn't bet)
Seat 4: Tatanca666 (small blind) showed [7s 7h] and lost with two pair, Jacks and Eights
Seat 5: $kiLLme1sTeR (big blind) folded before Flop
Seat 6: SteveD36 folded before Flop (didn't bet)
Seat 7: Citadel_7 folded before Flop
Seat 8: jcarlos.vale folded before Flop (didn't bet)
Seat 9: Nikos8511 folded before Flop (didn't bet)



PokerStars Hand #221734016961: Tournament #3079057742, $0.98+$0.12 USD Hold'em No Limit - Level VI (50/100) - 2020/12/22 23:29:01 EET [2020/12/22 16:29:01 ET]
Table '3079057742 3' 9-max Seat #4 is the button
Seat 1: czini007 (4832 in chips) 
Seat 2: spy4711 (6149 in chips) 
Seat 3: oronso 104 (6976 in chips) 
Seat 4: Tatanca666 (308 in chips) 
Seat 5: $kiLLme1sTeR (1951 in chips) 
Seat 6: SteveD36 (2962 in chips) 
Seat 7: Citadel_7 (2427 in chips) 
Seat 8: jcarlos.vale (2718 in chips) 
Seat 9: Nikos8511 (7937 in chips) 
czini007: posts the ante 12
spy4711: posts the ante 12
oronso 104: posts the ante 12
Tatanca666: posts the ante 12
$kiLLme1sTeR: posts the ante 12
SteveD36: posts the ante 12
Citadel_7: posts the ante 12
jcarlos.vale: posts the ante 12
Nikos8511: posts the ante 12
$kiLLme1sTeR: posts small blind 50
SteveD36: posts big blind 100
*** HOLE CARDS ***
Dealt to jcarlos.vale [3d 8c]
Citadel_7: raises 100 to 200
jcarlos.vale: folds 
Nikos8511: calls 200
czini007: folds 
spy4711: folds 
oronso 104: folds 
Tatanca666: folds 
$kiLLme1sTeR: folds 
SteveD36: calls 100
*** FLOP *** [7c Ad 5h]
SteveD36: checks 
Citadel_7: checks 
Nikos8511: bets 432
SteveD36: calls 432
Citadel_7: folds 
*** TURN *** [7c Ad 5h] [9h]
SteveD36: checks 
Nikos8511: checks 
*** RIVER *** [7c Ad 5h 9h] [5d]
SteveD36: bets 1100
Nikos8511: folds 
Uncalled bet (1100) returned to SteveD36
SteveD36 collected 1622 from pot
SteveD36: doesn't show hand 
*** SUMMARY ***
Total pot 1622 | Rake 0 
Board [7c Ad 5h 9h 5d]
Seat 1: czini007 folded before Flop (didn't bet)
Seat 2: spy4711 folded before Flop (didn't bet)
Seat 3: oronso 104 folded before Flop (didn't bet)
Seat 4: Tatanca666 (button) folded before Flop (didn't bet)
Seat 5: $kiLLme1sTeR (small blind) folded before Flop
Seat 6: SteveD36 (big blind) collected (1622)
Seat 7: Citadel_7 folded on the Flop
Seat 8: jcarlos.vale folded before Flop (didn't bet)
Seat 9: Nikos8511 folded on the River



PokerStars Hand #221734061141: Tournament #3079057742, $0.98+$0.12 USD Hold'em No Limit - Level VI (50/100) - 2020/12/22 23:30:05 EET [2020/12/22 16:30:05 ET]
Table '3079057742 3' 9-max Seat #5 is the button
Seat 1: czini007 (4820 in chips) 
Seat 2: spy4711 (6137 in chips) 
Seat 3: oronso 104 (6964 in chips) 
Seat 4: Tatanca666 (296 in chips) 
Seat 5: $kiLLme1sTeR (1889 in chips) 
Seat 6: SteveD36 (3940 in chips) 
Seat 7: Citadel_7 (2215 in chips) 
Seat 8: jcarlos.vale (2706 in chips) 
Seat 9: Nikos8511 (7293 in chips) 
czini007: posts the ante 12
spy4711: posts the ante 12
oronso 104: posts the ante 12
Tatanca666: posts the ante 12
$kiLLme1sTeR: posts the ante 12
SteveD36: posts the ante 12
Citadel_7: posts the ante 12
jcarlos.vale: posts the ante 12
Nikos8511: posts the ante 12
SteveD36: posts small blind 50
Citadel_7: posts big blind 100
*** HOLE CARDS ***
Dealt to jcarlos.vale [2h 8c]
jcarlos.vale: folds 
Nikos8511: raises 230 to 330
czini007: folds 
spy4711: folds 
oronso 104: folds 
Tatanca666: calls 284 and is all-in
$kiLLme1sTeR: folds 
SteveD36: folds 
Citadel_7 has timed out
Citadel_7: folds 
Citadel_7 is sitting out
Uncalled bet (46) returned to Nikos8511
Citadel_7 has returned
*** FLOP *** [4s Js 8d]
*** TURN *** [4s Js 8d] [Jc]
*** RIVER *** [4s Js 8d Jc] [9d]
*** SHOW DOWN ***
Nikos8511: shows [As Ah] (two pair, Aces and Jacks)
Tatanca666: shows [7h 8s] (two pair, Jacks and Eights)
Nikos8511 collected 826 from pot
Tatanca666 finished the tournament
*** SUMMARY ***
Total pot 826 | Rake 0 
Board [4s Js 8d Jc 9d]
Seat 1: czini007 folded before Flop (didn't bet)
Seat 2: spy4711 folded before Flop (didn't bet)
Seat 3: oronso 104 folded before Flop (didn't bet)
Seat 4: Tatanca666 showed [7h 8s] and lost with two pair, Jacks and Eights
Seat 5: $kiLLme1sTeR (button) folded before Flop (didn't bet)
Seat 6: SteveD36 (small blind) folded before Flop
Seat 7: Citadel_7 (big blind) folded before Flop
Seat 8: jcarlos.vale folded before Flop (didn't bet)
Seat 9: Nikos8511 showed [As Ah] and won (826) with two pair, Aces and Jacks



PokerStars Hand #221734084926: Tournament #3079057742, $0.98+$0.12 USD Hold'em No Limit - Level VI (50/100) - 2020/12/22 23:30:40 EET [2020/12/22 16:30:40 ET]
Table '3079057742 3' 9-max Seat #6 is the button
Seat 1: czini007 (4808 in chips) 
Seat 2: spy4711 (6125 in chips) 
Seat 3: oronso 104 (6952 in chips) 
Seat 5: $kiLLme1sTeR (1877 in chips) 
Seat 6: SteveD36 (3878 in chips) 
Seat 7: Citadel_7 (2103 in chips) 
Seat 8: jcarlos.vale (2694 in chips) 
Seat 9: Nikos8511 (7823 in chips) 
czini007: posts the ante 12
spy4711: posts the ante 12
oronso 104: posts the ante 12
$kiLLme1sTeR: posts the ante 12
SteveD36: posts the ante 12
Citadel_7: posts the ante 12
jcarlos.vale: posts the ante 12
Nikos8511: posts the ante 12
Citadel_7: posts small blind 50
jcarlos.vale: posts big blind 100
*** HOLE CARDS ***
Dealt to jcarlos.vale [4h Jc]
Nikos8511: raises 230 to 330
czini007: folds 
spy4711: folds 
oronso 104: raises 6610 to 6940 and is all-in
$kiLLme1sTeR: folds 
SteveD36: folds 
Citadel_7: folds 
jcarlos.vale: folds 
Nikos8511: folds 
Uncalled bet (6610) returned to oronso 104
oronso 104 collected 906 from pot
oronso 104: doesn't show hand 
*** SUMMARY ***
Total pot 906 | Rake 0 
Seat 1: czini007 folded before Flop (didn't bet)
Seat 2: spy4711 folded before Flop (didn't bet)
Seat 3: oronso 104 collected (906)
Seat 5: $kiLLme1sTeR folded before Flop (didn't bet)
Seat 6: SteveD36 (button) folded before Flop (didn't bet)
Seat 7: Citadel_7 (small blind) folded before Flop
Seat 8: jcarlos.vale (big blind) folded before Flop
Seat 9: Nikos8511 folded before Flop



PokerStars Hand #221734099288: Tournament #3079057742, $0.98+$0.12 USD Hold'em No Limit - Level VI (50/100) - 2020/12/22 23:31:00 EET [2020/12/22 16:31:00 ET]
Table '3079057742 3' 9-max Seat #7 is the button
Seat 1: czini007 (4796 in chips) 
Seat 2: spy4711 (6113 in chips) 
Seat 3: oronso 104 (7516 in chips) 
Seat 4: [ro]hoi (3000 in chips) 
Seat 5: $kiLLme1sTeR (1865 in chips) 
Seat 6: SteveD36 (3866 in chips) 
Seat 7: Citadel_7 (2041 in chips) 
Seat 8: jcarlos.vale (2582 in chips) 
Seat 9: Nikos8511 (7481 in chips) 
czini007: posts the ante 12
spy4711: posts the ante 12
oronso 104: posts the ante 12
[ro]hoi: posts the ante 12
$kiLLme1sTeR: posts the ante 12
SteveD36: posts the ante 12
Citadel_7: posts the ante 12
jcarlos.vale: posts the ante 12
Nikos8511: posts the ante 12
jcarlos.vale: posts small blind 50
Nikos8511: posts big blind 100
*** HOLE CARDS ***
Dealt to jcarlos.vale [Qh 2s]
czini007: folds 
spy4711: folds 
oronso 104: folds 
[ro]hoi: folds 
$kiLLme1sTeR: folds 
SteveD36: folds 
Citadel_7: folds 
jcarlos.vale: folds 
Uncalled bet (50) returned to Nikos8511
Nikos8511 collected 208 from pot
Nikos8511: doesn't show hand 
*** SUMMARY ***
Total pot 208 | Rake 0 
Seat 1: czini007 folded before Flop (didn't bet)
Seat 2: spy4711 folded before Flop (didn't bet)
Seat 3: oronso 104 folded before Flop (didn't bet)
Seat 4: [ro]hoi folded before Flop (didn't bet)
Seat 5: $kiLLme1sTeR folded before Flop (didn't bet)
Seat 6: SteveD36 folded before Flop (didn't bet)
Seat 7: Citadel_7 (button) folded before Flop (didn't bet)
Seat 8: jcarlos.vale (small blind) folded before Flop
Seat 9: Nikos8511 (big blind) collected (208)



PokerStars Hand #221734112585: Tournament #3079057742, $0.98+$0.12 USD Hold'em No Limit - Level VI (50/100) - 2020/12/22 23:31:20 EET [2020/12/22 16:31:20 ET]
Table '3079057742 3' 9-max Seat #8 is the button
Seat 1: czini007 (4784 in chips) 
Seat 2: spy4711 (6101 in chips) 
Seat 3: oronso 104 (7504 in chips) 
Seat 4: [ro]hoi (2988 in chips) 
Seat 5: $kiLLme1sTeR (1853 in chips) 
Seat 6: SteveD36 (3854 in chips) 
Seat 7: Citadel_7 (2029 in chips) 
Seat 8: jcarlos.vale (2520 in chips) 
Seat 9: Nikos8511 (7627 in chips) 
czini007: posts the ante 12
spy4711: posts the ante 12
oronso 104: posts the ante 12
[ro]hoi: posts the ante 12
$kiLLme1sTeR: posts the ante 12
SteveD36: posts the ante 12
Citadel_7: posts the ante 12
jcarlos.vale: posts the ante 12
Nikos8511: posts the ante 12
Nikos8511: posts small blind 50
czini007: posts big blind 100
*** HOLE CARDS ***
Dealt to jcarlos.vale [Qs 9d]
spy4711: calls 100
oronso 104: folds 
[ro]hoi: calls 100
$kiLLme1sTeR: folds 
SteveD36: folds 
Citadel_7: folds 
jcarlos.vale: folds 
Nikos8511: calls 50
czini007: checks 
*** FLOP *** [2h 6d 2s]
Nikos8511: checks 
czini007: checks 
spy4711: checks 
[ro]hoi: bets 500
Nikos8511: folds 
czini007: folds 
spy4711: folds 
Uncalled bet (500) returned to [ro]hoi
[ro]hoi collected 508 from pot
[ro]hoi: doesn't show hand 
*** SUMMARY ***
Total pot 508 | Rake 0 
Board [2h 6d 2s]
Seat 1: czini007 (big blind) folded on the Flop
Seat 2: spy4711 folded on the Flop
Seat 3: oronso 104 folded before Flop (didn't bet)
Seat 4: [ro]hoi collected (508)
Seat 5: $kiLLme1sTeR folded before Flop (didn't bet)
Seat 6: SteveD36 folded before Flop (didn't bet)
Seat 7: Citadel_7 folded before Flop (didn't bet)
Seat 8: jcarlos.vale (button) folded before Flop (didn't bet)
Seat 9: Nikos8511 (small blind) folded on the Flop



PokerStars Hand #221734146936: Tournament #3079057742, $0.98+$0.12 USD Hold'em No Limit - Level VI (50/100) - 2020/12/22 23:32:09 EET [2020/12/22 16:32:09 ET]
Table '3079057742 3' 9-max Seat #9 is the button
Seat 1: czini007 (4672 in chips) 
Seat 2: spy4711 (5989 in chips) 
Seat 3: oronso 104 (7492 in chips) 
Seat 4: [ro]hoi (3384 in chips) 
Seat 5: $kiLLme1sTeR (1841 in chips) 
Seat 6: SteveD36 (3842 in chips) 
Seat 7: Citadel_7 (2017 in chips) 
Seat 8: jcarlos.vale (2508 in chips) 
Seat 9: Nikos8511 (7515 in chips) 
czini007: posts the ante 12
spy4711: posts the ante 12
oronso 104: posts the ante 12
[ro]hoi: posts the ante 12
$kiLLme1sTeR: posts the ante 12
SteveD36: posts the ante 12
Citadel_7: posts the ante 12
jcarlos.vale: posts the ante 12
Nikos8511: posts the ante 12
czini007: posts small blind 50
spy4711: posts big blind 100
*** HOLE CARDS ***
Dealt to jcarlos.vale [5h 7s]
oronso 104: folds 
[ro]hoi: folds 
$kiLLme1sTeR: folds 
SteveD36: folds 
Citadel_7 has timed out
Citadel_7: folds 
Citadel_7 is sitting out
jcarlos.vale: folds 
Nikos8511: folds 
czini007: calls 50
spy4711: checks 
*** FLOP *** [Jc Jh Ac]
czini007: checks 
Citadel_7 has returned
spy4711: checks 
*** TURN *** [Jc Jh Ac] [6s]
czini007: bets 100
spy4711: folds 
Uncalled bet (100) returned to czini007
czini007 collected 308 from pot
czini007: doesn't show hand 
*** SUMMARY ***
Total pot 308 | Rake 0 
Board [Jc Jh Ac 6s]
Seat 1: czini007 (small blind) collected (308)
Seat 2: spy4711 (big blind) folded on the Turn
Seat 3: oronso 104 folded before Flop (didn't bet)
Seat 4: [ro]hoi folded before Flop (didn't bet)
Seat 5: $kiLLme1sTeR folded before Flop (didn't bet)
Seat 6: SteveD36 folded before Flop (didn't bet)
Seat 7: Citadel_7 folded before Flop (didn't bet)
Seat 8: jcarlos.vale folded before Flop (didn't bet)
Seat 9: Nikos8511 (button) folded before Flop (didn't bet)



PokerStars Hand #221734168465: Tournament #3079057742, $0.98+$0.12 USD Hold'em No Limit - Level VI (50/100) - 2020/12/22 23:32:40 EET [2020/12/22 16:32:40 ET]
Table '3079057742 3' 9-max Seat #1 is the button
Seat 1: czini007 (4868 in chips) 
Seat 2: spy4711 (5877 in chips) 
Seat 3: oronso 104 (7480 in chips) 
Seat 4: [ro]hoi (3372 in chips) 
Seat 5: $kiLLme1sTeR (1829 in chips) 
Seat 6: SteveD36 (3830 in chips) 
Seat 7: Citadel_7 (2005 in chips) 
Seat 8: jcarlos.vale (2496 in chips) 
Seat 9: Nikos8511 (7503 in chips) 
czini007: posts the ante 12
spy4711: posts the ante 12
oronso 104: posts the ante 12
[ro]hoi: posts the ante 12
$kiLLme1sTeR: posts the ante 12
SteveD36: posts the ante 12
Citadel_7: posts the ante 12
jcarlos.vale: posts the ante 12
Nikos8511: posts the ante 12
spy4711: posts small blind 50
oronso 104: posts big blind 100
*** HOLE CARDS ***
Dealt to jcarlos.vale [5h 9s]
[ro]hoi: folds 
$kiLLme1sTeR: folds 
SteveD36: folds 
Citadel_7: raises 1893 to 1993 and is all-in
jcarlos.vale: folds 
Nikos8511: folds 
czini007: folds 
spy4711: folds 
oronso 104: folds 
Uncalled bet (1893) returned to Citadel_7
Citadel_7 collected 358 from pot
Citadel_7: doesn't show hand 
*** SUMMARY ***
Total pot 358 | Rake 0 
Seat 1: czini007 (button) folded before Flop (didn't bet)
Seat 2: spy4711 (small blind) folded before Flop
Seat 3: oronso 104 (big blind) folded before Flop
Seat 4: [ro]hoi folded before Flop (didn't bet)
Seat 5: $kiLLme1sTeR folded before Flop (didn't bet)
Seat 6: SteveD36 folded before Flop (didn't bet)
Seat 7: Citadel_7 collected (358)
Seat 8: jcarlos.vale folded before Flop (didn't bet)
Seat 9: Nikos8511 folded before Flop (didn't bet)



PokerStars Hand #221734189386: Tournament #3079057742, $0.98+$0.12 USD Hold'em No Limit - Level VI (50/100) - 2020/12/22 23:33:10 EET [2020/12/22 16:33:10 ET]
Table '3079057742 3' 9-max Seat #2 is the button
Seat 1: czini007 (4856 in chips) 
Seat 2: spy4711 (5815 in chips) 
Seat 3: oronso 104 (7368 in chips) 
Seat 4: [ro]hoi (3360 in chips) 
Seat 5: $kiLLme1sTeR (1817 in chips) 
Seat 6: SteveD36 (3818 in chips) 
Seat 7: Citadel_7 (2251 in chips) 
Seat 8: jcarlos.vale (2484 in chips) 
czini007: posts the ante 12
spy4711: posts the ante 12
oronso 104: posts the ante 12
[ro]hoi: posts the ante 12
$kiLLme1sTeR: posts the ante 12
SteveD36: posts the ante 12
Citadel_7: posts the ante 12
jcarlos.vale: posts the ante 12
oronso 104: posts small blind 50
[ro]hoi: posts big blind 100
*** HOLE CARDS ***
Dealt to jcarlos.vale [Ad 3s]
$kiLLme1sTeR: folds 
SteveD36: folds 
Citadel_7: raises 100 to 200
jcarlos.vale: folds 
czini007: raises 646 to 846
spy4711: folds 
oronso 104: raises 6510 to 7356 and is all-in
[ro]hoi: folds 
Citadel_7: folds 
czini007: calls 3998 and is all-in
Uncalled bet (2512) returned to oronso 104
*** FLOP *** [3c As 5d]
*** TURN *** [3c As 5d] [Jh]
*** RIVER *** [3c As 5d Jh] [8h]
*** SHOW DOWN ***
oronso 104: shows [9c 9h] (a pair of Nines)
czini007: shows [Qd Qh] (a pair of Queens)
czini007 collected 10084 from pot
*** SUMMARY ***
Total pot 10084 | Rake 0 
Board [3c As 5d Jh 8h]
Seat 1: czini007 showed [Qd Qh] and won (10084) with a pair of Queens
Seat 2: spy4711 (button) folded before Flop (didn't bet)
Seat 3: oronso 104 (small blind) showed [9c 9h] and lost with a pair of Nines
Seat 4: [ro]hoi (big blind) folded before Flop
Seat 5: $kiLLme1sTeR folded before Flop (didn't bet)
Seat 6: SteveD36 folded before Flop (didn't bet)
Seat 7: Citadel_7 folded before Flop
Seat 8: jcarlos.vale folded before Flop (didn't bet)



PokerStars Hand #221734215872: Tournament #3079057742, $0.98+$0.12 USD Hold'em No Limit - Level VI (50/100) - 2020/12/22 23:33:49 EET [2020/12/22 16:33:49 ET]
Table '3079057742 3' 9-max Seat #3 is the button
Seat 1: czini007 (10084 in chips) 
Seat 2: spy4711 (5803 in chips) 
Seat 3: oronso 104 (2512 in chips) 
Seat 4: [ro]hoi (3248 in chips) 
Seat 5: $kiLLme1sTeR (1805 in chips) 
Seat 6: SteveD36 (3806 in chips) 
Seat 7: Citadel_7 (2039 in chips) 
Seat 8: jcarlos.vale (2472 in chips) 
Seat 9: muffbee (3000 in chips) 
czini007: posts the ante 12
spy4711: posts the ante 12
oronso 104: posts the ante 12
[ro]hoi: posts the ante 12
$kiLLme1sTeR: posts the ante 12
SteveD36: posts the ante 12
Citadel_7: posts the ante 12
jcarlos.vale: posts the ante 12
muffbee: posts the ante 12
[ro]hoi: posts small blind 50
$kiLLme1sTeR: posts big blind 100
*** HOLE CARDS ***
Dealt to jcarlos.vale [8d Jc]
SteveD36: raises 200 to 300
Citadel_7 has timed out
Citadel_7: folds 
Citadel_7 is sitting out
jcarlos.vale: folds 
Citadel_7 has returned
muffbee: calls 300
czini007: folds 
spy4711: folds 
oronso 104: folds 
[ro]hoi: folds 
$kiLLme1sTeR: folds 
*** FLOP *** [3s Ac 7s]
SteveD36: bets 300
muffbee: calls 300
*** TURN *** [3s Ac 7s] [Qh]
SteveD36: bets 700
muffbee: folds 
Uncalled bet (700) returned to SteveD36
SteveD36 collected 1458 from pot
SteveD36: doesn't show hand 
*** SUMMARY ***
Total pot 1458 | Rake 0 
Board [3s Ac 7s Qh]
Seat 1: czini007 folded before Flop (didn't bet)
Seat 2: spy4711 folded before Flop (didn't bet)
Seat 3: oronso 104 (button) folded before Flop (didn't bet)
Seat 4: [ro]hoi (small blind) folded before Flop
Seat 5: $kiLLme1sTeR (big blind) folded before Flop
Seat 6: SteveD36 collected (1458)
Seat 7: Citadel_7 folded before Flop (didn't bet)
Seat 8: jcarlos.vale folded before Flop (didn't bet)
Seat 9: muffbee folded on the Turn



PokerStars Hand #221734259868: Tournament #3079057742, $0.98+$0.12 USD Hold'em No Limit - Level VI (50/100) - 2020/12/22 23:34:52 EET [2020/12/22 16:34:52 ET]
Table '3079057742 3' 9-max Seat #4 is the button
Seat 1: czini007 (10072 in chips) 
Seat 2: spy4711 (5791 in chips) 
Seat 3: oronso 104 (2500 in chips) 
Seat 4: [ro]hoi (3186 in chips) 
Seat 5: $kiLLme1sTeR (1693 in chips) 
Seat 6: SteveD36 (4652 in chips) 
Seat 7: Citadel_7 (2027 in chips) 
Seat 8: jcarlos.vale (2460 in chips) 
Seat 9: muffbee (2388 in chips) 
czini007: posts the ante 12
spy4711: posts the ante 12
oronso 104: posts the ante 12
[ro]hoi: posts the ante 12
$kiLLme1sTeR: posts the ante 12
SteveD36: posts the ante 12
Citadel_7: posts the ante 12
jcarlos.vale: posts the ante 12
muffbee: posts the ante 12
$kiLLme1sTeR: posts small blind 50
SteveD36: posts big blind 100
*** HOLE CARDS ***
Dealt to jcarlos.vale [Kh Qs]
Citadel_7: raises 1915 to 2015 and is all-in
jcarlos.vale: folds 
muffbee: folds 
czini007: calls 2015
spy4711: folds 
oronso 104: folds 
[ro]hoi: folds 
$kiLLme1sTeR: folds 
SteveD36: folds 
*** FLOP *** [6s 2h 6d]
*** TURN *** [6s 2h 6d] [Qc]
*** RIVER *** [6s 2h 6d Qc] [Th]
*** SHOW DOWN ***
Citadel_7: shows [7d 7c] (two pair, Sevens and Sixes)
czini007: shows [8s 8d] (two pair, Eights and Sixes)
czini007 collected 4288 from pot
Citadel_7 finished the tournament
*** SUMMARY ***
Total pot 4288 | Rake 0 
Board [6s 2h 6d Qc Th]
Seat 1: czini007 showed [8s 8d] and won (4288) with two pair, Eights and Sixes
Seat 2: spy4711 folded before Flop (didn't bet)
Seat 3: oronso 104 folded before Flop (didn't bet)
Seat 4: [ro]hoi (button) folded before Flop (didn't bet)
Seat 5: $kiLLme1sTeR (small blind) folded before Flop
Seat 6: SteveD36 (big blind) folded before Flop
Seat 7: Citadel_7 showed [7d 7c] and lost with two pair, Sevens and Sixes
Seat 8: jcarlos.vale folded before Flop (didn't bet)
Seat 9: muffbee folded before Flop (didn't bet)



PokerStars Hand #221734282238: Tournament #3079057742, $0.98+$0.12 USD Hold'em No Limit - Level VI (50/100) - 2020/12/22 23:35:25 EET [2020/12/22 16:35:25 ET]
Table '3079057742 3' 9-max Seat #5 is the button
Seat 1: czini007 (12333 in chips) 
Seat 2: spy4711 (5779 in chips) 
Seat 3: oronso 104 (2488 in chips) 
Seat 4: [ro]hoi (3174 in chips) 
Seat 5: $kiLLme1sTeR (1631 in chips) 
Seat 6: SteveD36 (4540 in chips) 
Seat 8: jcarlos.vale (2448 in chips) 
Seat 9: muffbee (2376 in chips) 
czini007: posts the ante 12
spy4711: posts the ante 12
oronso 104: posts the ante 12
[ro]hoi: posts the ante 12
$kiLLme1sTeR: posts the ante 12
SteveD36: posts the ante 12
jcarlos.vale: posts the ante 12
muffbee: posts the ante 12
SteveD36: posts small blind 50
jcarlos.vale: posts big blind 100
*** HOLE CARDS ***
Dealt to jcarlos.vale [8s Tc]
muffbee: calls 100
czini007: calls 100
spy4711: calls 100
oronso 104: folds 
[ro]hoi: folds 
$kiLLme1sTeR: folds 
SteveD36: folds 
jcarlos.vale: checks 
*** FLOP *** [8c 9h Qh]
jcarlos.vale: bets 200
muffbee: folds 
czini007: calls 200
spy4711: folds 
*** TURN *** [8c 9h Qh] [7s]
jcarlos.vale: bets 200
czini007: calls 200
*** RIVER *** [8c 9h Qh 7s] [3c]
jcarlos.vale: bets 200
czini007: calls 200
*** SHOW DOWN ***
jcarlos.vale: shows [8s Tc] (a pair of Eights)
czini007: shows [Ts Qs] (a pair of Queens)
czini007 collected 1746 from pot
*** SUMMARY ***
Total pot 1746 | Rake 0 
Board [8c 9h Qh 7s 3c]
Seat 1: czini007 showed [Ts Qs] and won (1746) with a pair of Queens
Seat 2: spy4711 folded on the Flop
Seat 3: oronso 104 folded before Flop (didn't bet)
Seat 4: [ro]hoi folded before Flop (didn't bet)
Seat 5: $kiLLme1sTeR (button) folded before Flop (didn't bet)
Seat 6: SteveD36 (small blind) folded before Flop
Seat 8: jcarlos.vale (big blind) showed [8s Tc] and lost with a pair of Eights
Seat 9: muffbee folded on the Flop



PokerStars Hand #221734311039: Tournament #3079057742, $0.98+$0.12 USD Hold'em No Limit - Level VI (50/100) - 2020/12/22 23:36:07 EET [2020/12/22 16:36:07 ET]
Table '3079057742 3' 9-max Seat #6 is the button
Seat 1: czini007 (13367 in chips) 
Seat 2: spy4711 (5667 in chips) 
Seat 3: oronso 104 (2476 in chips) 
Seat 4: [ro]hoi (3162 in chips) 
Seat 5: $kiLLme1sTeR (1619 in chips) 
Seat 6: SteveD36 (4478 in chips) 
Seat 7: john2030347 (3000 in chips) out of hand (moved from another table into small blind)
Seat 8: jcarlos.vale (1736 in chips) 
Seat 9: muffbee (2264 in chips) 
john2030347 will be allowed to play after the button
czini007: posts the ante 12
spy4711: posts the ante 12
oronso 104: posts the ante 12
[ro]hoi: posts the ante 12
$kiLLme1sTeR: posts the ante 12
SteveD36: posts the ante 12
jcarlos.vale: posts the ante 12
muffbee: posts the ante 12
jcarlos.vale: posts small blind 50
muffbee: posts big blind 100
*** HOLE CARDS ***
Dealt to jcarlos.vale [6d Ac]
czini007: calls 100
spy4711: folds 
oronso 104: folds 
[ro]hoi: folds 
$kiLLme1sTeR: folds 
SteveD36: folds 
jcarlos.vale: calls 50
muffbee: checks 
*** FLOP *** [Ah 5s As]
jcarlos.vale: checks 
muffbee: checks 
czini007: checks 
*** TURN *** [Ah 5s As] [Ks]
jcarlos.vale: bets 100
muffbee: calls 100
czini007: calls 100
*** RIVER *** [Ah 5s As Ks] [3h]
jcarlos.vale: bets 100
muffbee: calls 100
czini007: calls 100
*** SHOW DOWN ***
jcarlos.vale: shows [6d Ac] (three of a kind, Aces)
muffbee: mucks hand 
czini007: mucks hand 
jcarlos.vale collected 996 from pot
*** SUMMARY ***
Total pot 996 | Rake 0 
Board [Ah 5s As Ks 3h]
Seat 1: czini007 mucked [Qd 8c]
Seat 2: spy4711 folded before Flop (didn't bet)
Seat 3: oronso 104 folded before Flop (didn't bet)
Seat 4: [ro]hoi folded before Flop (didn't bet)
Seat 5: $kiLLme1sTeR folded before Flop (didn't bet)
Seat 6: SteveD36 (button) folded before Flop (didn't bet)
Seat 8: jcarlos.vale (small blind) showed [6d Ac] and won (996) with three of a kind, Aces
Seat 9: muffbee (big blind) mucked [9d 2s]



PokerStars Hand #221734340916: Tournament #3079057742, $0.98+$0.12 USD Hold'em No Limit - Level VII (60/120) - 2020/12/22 23:36:50 EET [2020/12/22 16:36:50 ET]
Table '3079057742 3' 9-max Seat #8 is the button
Seat 2: spy4711 (5655 in chips) 
Seat 3: oronso 104 (2464 in chips) 
Seat 4: [ro]hoi (3150 in chips) 
Seat 5: $kiLLme1sTeR (1607 in chips) 
Seat 6: SteveD36 (4466 in chips) 
Seat 7: john2030347 (3000 in chips) 
Seat 8: jcarlos.vale (2420 in chips) 
Seat 9: muffbee (1952 in chips) 
spy4711: posts the ante 15
oronso 104: posts the ante 15
[ro]hoi: posts the ante 15
$kiLLme1sTeR: posts the ante 15
SteveD36: posts the ante 15
john2030347: posts the ante 15
jcarlos.vale: posts the ante 15
muffbee: posts the ante 15
muffbee: posts small blind 60
spy4711: posts big blind 120
*** HOLE CARDS ***
Dealt to jcarlos.vale [9h 3d]
oronso 104: raises 144 to 264
[ro]hoi: calls 264
$kiLLme1sTeR: folds 
SteveD36: folds 
john2030347: calls 264
jcarlos.vale: folds 
muffbee: calls 204
spy4711: folds 
*** FLOP *** [Th 6c 5s]
muffbee: bets 120
oronso 104: raises 1352 to 1472
[ro]hoi: folds 
john2030347: calls 1472
muffbee: raises 201 to 1673 and is all-in
oronso 104: calls 201
john2030347: calls 201
*** TURN *** [Th 6c 5s] [Jh]
oronso 104: bets 512 and is all-in
john2030347: calls 512
*** RIVER *** [Th 6c 5s Jh] [Ad]
*** SHOW DOWN ***
oronso 104: shows [Jd Tc] (two pair, Jacks and Tens)
john2030347: shows [Kh 6s] (a pair of Sixes)
oronso 104 collected 1024 from side pot
muffbee: shows [9d 9s] (a pair of Nines)
oronso 104 collected 6315 from main pot
muffbee finished the tournament
*** SUMMARY ***
Total pot 7339 Main pot 6315. Side pot 1024. | Rake 0 
Board [Th 6c 5s Jh Ad]
Seat 2: spy4711 (big blind) folded before Flop
Seat 3: oronso 104 showed [Jd Tc] and won (7339) with two pair, Jacks and Tens
Seat 4: [ro]hoi folded on the Flop
Seat 5: $kiLLme1sTeR folded before Flop (didn't bet)
Seat 6: SteveD36 folded before Flop (didn't bet)
Seat 7: john2030347 showed [Kh 6s] and lost with a pair of Sixes
Seat 8: jcarlos.vale (button) folded before Flop (didn't bet)
Seat 9: muffbee (small blind) showed [9d 9s] and lost with a pair of Nines



PokerStars Hand #221734389808: Tournament #3079057742, $0.98+$0.12 USD Hold'em No Limit - Level VII (60/120) - 2020/12/22 23:38:01 EET [2020/12/22 16:38:01 ET]
Table '3079057742 3' 9-max Seat #2 is the button
Seat 1: konex (5913 in chips) 
Seat 2: spy4711 (5520 in chips) 
Seat 3: oronso 104 (7339 in chips) 
Seat 4: [ro]hoi (2871 in chips) 
Seat 5: $kiLLme1sTeR (1592 in chips) 
Seat 6: SteveD36 (4451 in chips) 
Seat 7: john2030347 (536 in chips) 
Seat 8: jcarlos.vale (2405 in chips) 
konex: posts the ante 15
spy4711: posts the ante 15
oronso 104: posts the ante 15
[ro]hoi: posts the ante 15
$kiLLme1sTeR: posts the ante 15
SteveD36: posts the ante 15
john2030347: posts the ante 15
jcarlos.vale: posts the ante 15
oronso 104: posts small blind 60
[ro]hoi: posts big blind 120
*** HOLE CARDS ***
Dealt to jcarlos.vale [2c 4d]
$kiLLme1sTeR: folds 
SteveD36: folds 
john2030347: raises 401 to 521 and is all-in
jcarlos.vale: folds 
konex: folds 
spy4711: folds 
oronso 104: folds 
[ro]hoi: folds 
Uncalled bet (401) returned to john2030347
john2030347 collected 420 from pot
john2030347: doesn't show hand 
*** SUMMARY ***
Total pot 420 | Rake 0 
Seat 1: konex folded before Flop (didn't bet)
Seat 2: spy4711 (button) folded before Flop (didn't bet)
Seat 3: oronso 104 (small blind) folded before Flop
Seat 4: [ro]hoi (big blind) folded before Flop
Seat 5: $kiLLme1sTeR folded before Flop (didn't bet)
Seat 6: SteveD36 folded before Flop (didn't bet)
Seat 7: john2030347 collected (420)
Seat 8: jcarlos.vale folded before Flop (didn't bet)



PokerStars Hand #221734408550: Tournament #3079057742, $0.98+$0.12 USD Hold'em No Limit - Level VII (60/120) - 2020/12/22 23:38:29 EET [2020/12/22 16:38:29 ET]
Table '3079057742 3' 9-max Seat #3 is the button
Seat 1: konex (5898 in chips) 
Seat 2: spy4711 (5505 in chips) 
Seat 3: oronso 104 (7264 in chips) 
Seat 4: [ro]hoi (2736 in chips) 
Seat 5: $kiLLme1sTeR (1577 in chips) 
Seat 6: SteveD36 (4436 in chips) 
Seat 7: john2030347 (821 in chips) 
Seat 8: jcarlos.vale (2390 in chips) 
Seat 9: Matever1k (3000 in chips) 
konex: posts the ante 15
spy4711: posts the ante 15
oronso 104: posts the ante 15
[ro]hoi: posts the ante 15
$kiLLme1sTeR: posts the ante 15
SteveD36: posts the ante 15
john2030347: posts the ante 15
jcarlos.vale: posts the ante 15
Matever1k: posts the ante 15
[ro]hoi: posts small blind 60
$kiLLme1sTeR: posts big blind 120
*** HOLE CARDS ***
Dealt to jcarlos.vale [Kh Qh]
SteveD36: folds 
john2030347: folds 
jcarlos.vale: raises 192 to 312
Matever1k: folds 
konex: folds 
spy4711: folds 
oronso 104: folds 
[ro]hoi: folds 
$kiLLme1sTeR: folds 
Uncalled bet (192) returned to jcarlos.vale
jcarlos.vale collected 435 from pot
jcarlos.vale: doesn't show hand 
*** SUMMARY ***
Total pot 435 | Rake 0 
Seat 1: konex folded before Flop (didn't bet)
Seat 2: spy4711 folded before Flop (didn't bet)
Seat 3: oronso 104 (button) folded before Flop (didn't bet)
Seat 4: [ro]hoi (small blind) folded before Flop
Seat 5: $kiLLme1sTeR (big blind) folded before Flop
Seat 6: SteveD36 folded before Flop (didn't bet)
Seat 7: john2030347 folded before Flop (didn't bet)
Seat 8: jcarlos.vale collected (435)
Seat 9: Matever1k folded before Flop (didn't bet)



PokerStars Hand #221734424777: Tournament #3079057742, $0.98+$0.12 USD Hold'em No Limit - Level VII (60/120) - 2020/12/22 23:38:53 EET [2020/12/22 16:38:53 ET]
Table '3079057742 3' 9-max Seat #4 is the button
Seat 1: konex (5883 in chips) 
Seat 2: spy4711 (5490 in chips) 
Seat 3: oronso 104 (7249 in chips) 
Seat 4: [ro]hoi (2661 in chips) 
Seat 5: $kiLLme1sTeR (1442 in chips) 
Seat 6: SteveD36 (4421 in chips) 
Seat 7: john2030347 (806 in chips) 
Seat 8: jcarlos.vale (2690 in chips) 
Seat 9: Matever1k (2985 in chips) 
konex: posts the ante 15
spy4711: posts the ante 15
oronso 104: posts the ante 15
[ro]hoi: posts the ante 15
$kiLLme1sTeR: posts the ante 15
SteveD36: posts the ante 15
john2030347: posts the ante 15
jcarlos.vale: posts the ante 15
Matever1k: posts the ante 15
$kiLLme1sTeR: posts small blind 60
SteveD36: posts big blind 120
*** HOLE CARDS ***
Dealt to jcarlos.vale [Jc Jh]
john2030347: raises 120 to 240
jcarlos.vale: raises 480 to 720
Matever1k: raises 2250 to 2970 and is all-in
konex: folds 
spy4711: folds 
oronso 104: folds 
[ro]hoi: folds 
$kiLLme1sTeR: folds 
SteveD36: folds 
john2030347: calls 551 and is all-in
jcarlos.vale: calls 1955 and is all-in
Uncalled bet (295) returned to Matever1k
*** FLOP *** [5d 7h Qc]
*** TURN *** [5d 7h Qc] [5s]
*** RIVER *** [5d 7h Qc 5s] [Ts]
*** SHOW DOWN ***
jcarlos.vale: shows [Jc Jh] (two pair, Jacks and Fives)
Matever1k: shows [As 7s] (two pair, Sevens and Fives)
jcarlos.vale collected 3768 from side pot
john2030347: shows [Js 8d] (a pair of Fives)
jcarlos.vale collected 2688 from main pot
john2030347 finished the tournament
*** SUMMARY ***
Total pot 6456 Main pot 2688. Side pot 3768. | Rake 0 
Board [5d 7h Qc 5s Ts]
Seat 1: konex folded before Flop (didn't bet)
Seat 2: spy4711 folded before Flop (didn't bet)
Seat 3: oronso 104 folded before Flop (didn't bet)
Seat 4: [ro]hoi (button) folded before Flop (didn't bet)
Seat 5: $kiLLme1sTeR (small blind) folded before Flop
Seat 6: SteveD36 (big blind) folded before Flop
Seat 7: john2030347 showed [Js 8d] and lost with a pair of Fives
Seat 8: jcarlos.vale showed [Jc Jh] and won (6456) with two pair, Jacks and Fives
Seat 9: Matever1k showed [As 7s] and lost with two pair, Sevens and Fives



PokerStars Hand #221734465066: Tournament #3079057742, $0.98+$0.12 USD Hold'em No Limit - Level VII (60/120) - 2020/12/22 23:39:52 EET [2020/12/22 16:39:52 ET]
Table '3079057742 3' 9-max Seat #5 is the button
Seat 1: konex (5868 in chips) 
Seat 2: spy4711 (5475 in chips) 
Seat 3: oronso 104 (7234 in chips) 
Seat 4: [ro]hoi (2646 in chips) 
Seat 5: $kiLLme1sTeR (1367 in chips) 
Seat 6: SteveD36 (4286 in chips) 
Seat 8: jcarlos.vale (6456 in chips) 
Seat 9: Matever1k (295 in chips) 
konex: posts the ante 15
spy4711: posts the ante 15
oronso 104: posts the ante 15
[ro]hoi: posts the ante 15
$kiLLme1sTeR: posts the ante 15
SteveD36: posts the ante 15
jcarlos.vale: posts the ante 15
Matever1k: posts the ante 15
SteveD36: posts small blind 60
jcarlos.vale: posts big blind 120
*** HOLE CARDS ***
Dealt to jcarlos.vale [Kc 9d]
Matever1k: raises 160 to 280 and is all-in
konex: folds 
spy4711: folds 
oronso 104: raises 200 to 480
[ro]hoi: calls 480
$kiLLme1sTeR: folds 
SteveD36: folds 
jcarlos.vale: folds 
*** FLOP *** [Ah 6s 8s]
oronso 104: bets 508
[ro]hoi: folds 
Uncalled bet (508) returned to oronso 104
*** TURN *** [Ah 6s 8s] [Kd]
*** RIVER *** [Ah 6s 8s Kd] [2c]
*** SHOW DOWN ***
oronso 104: shows [8d 8h] (three of a kind, Eights)
oronso 104 collected 400 from side pot
Matever1k: shows [2d 3d] (a pair of Deuces)
oronso 104 collected 1140 from main pot
Matever1k is sitting out
Matever1k finished the tournament
*** SUMMARY ***
Total pot 1540 Main pot 1140. Side pot 400. | Rake 0 
Board [Ah 6s 8s Kd 2c]
Seat 1: konex folded before Flop (didn't bet)
Seat 2: spy4711 folded before Flop (didn't bet)
Seat 3: oronso 104 showed [8d 8h] and won (1540) with three of a kind, Eights
Seat 4: [ro]hoi folded on the Flop
Seat 5: $kiLLme1sTeR (button) folded before Flop (didn't bet)
Seat 6: SteveD36 (small blind) folded before Flop
Seat 8: jcarlos.vale (big blind) folded before Flop
Seat 9: Matever1k showed [2d 3d] and lost with a pair of Deuces



PokerStars Hand #221734497806: Tournament #3079057742, $0.98+$0.12 USD Hold'em No Limit - Level VII (60/120) - 2020/12/22 23:40:41 EET [2020/12/22 16:40:41 ET]
Table '3079057742 3' 9-max Seat #6 is the button
Seat 1: konex (5853 in chips) 
Seat 2: spy4711 (5460 in chips) 
Seat 3: oronso 104 (8279 in chips) 
Seat 4: [ro]hoi (2151 in chips) 
Seat 5: $kiLLme1sTeR (1352 in chips) 
Seat 6: SteveD36 (4211 in chips) 
Seat 8: jcarlos.vale (6321 in chips) 
konex: posts the ante 15
spy4711: posts the ante 15
oronso 104: posts the ante 15
[ro]hoi: posts the ante 15
$kiLLme1sTeR: posts the ante 15
SteveD36: posts the ante 15
jcarlos.vale: posts the ante 15
jcarlos.vale: posts small blind 60
konex: posts big blind 120
*** HOLE CARDS ***
Dealt to jcarlos.vale [9h 5h]
spy4711: folds 
oronso 104: folds 
[ro]hoi: raises 120 to 240
$kiLLme1sTeR: folds 
SteveD36: folds 
jcarlos.vale: folds 
konex: folds 
Uncalled bet (120) returned to [ro]hoi
[ro]hoi collected 405 from pot
[ro]hoi: doesn't show hand 
*** SUMMARY ***
Total pot 405 | Rake 0 
Seat 1: konex (big blind) folded before Flop
Seat 2: spy4711 folded before Flop (didn't bet)
Seat 3: oronso 104 folded before Flop (didn't bet)
Seat 4: [ro]hoi collected (405)
Seat 5: $kiLLme1sTeR folded before Flop (didn't bet)
Seat 6: SteveD36 (button) folded before Flop (didn't bet)
Seat 8: jcarlos.vale (small blind) folded before Flop



PokerStars Hand #221734513601: Tournament #3079057742, $0.98+$0.12 USD Hold'em No Limit - Level VII (60/120) - 2020/12/22 23:41:04 EET [2020/12/22 16:41:04 ET]
Table '3079057742 3' 9-max Seat #8 is the button
Seat 1: konex (5718 in chips) 
Seat 2: spy4711 (5445 in chips) 
Seat 3: oronso 104 (8264 in chips) 
Seat 4: [ro]hoi (2421 in chips) 
Seat 5: $kiLLme1sTeR (1337 in chips) 
Seat 6: SteveD36 (4196 in chips) 
Seat 7: eric205 (3000 in chips) 
Seat 8: jcarlos.vale (6246 in chips) 
konex: posts the ante 15
spy4711: posts the ante 15
oronso 104: posts the ante 15
[ro]hoi: posts the ante 15
$kiLLme1sTeR: posts the ante 15
SteveD36: posts the ante 15
eric205: posts the ante 15
jcarlos.vale: posts the ante 15
konex: posts small blind 60
spy4711: posts big blind 120
*** HOLE CARDS ***
Dealt to jcarlos.vale [2c 8c]
oronso 104: folds 
[ro]hoi: folds 
$kiLLme1sTeR: folds 
SteveD36: folds 
eric205: folds 
jcarlos.vale: folds 
konex: calls 60
spy4711: checks 
*** FLOP *** [5h 3c 5s]
konex: checks 
spy4711: checks 
*** TURN *** [5h 3c 5s] [9d]
konex: checks 
spy4711: checks 
*** RIVER *** [5h 3c 5s 9d] [Qs]
konex: checks 
spy4711: checks 
*** SHOW DOWN ***
konex: shows [Jh 8d] (a pair of Fives)
spy4711: mucks hand 
konex collected 360 from pot
*** SUMMARY ***
Total pot 360 | Rake 0 
Board [5h 3c 5s 9d Qs]
Seat 1: konex (small blind) showed [Jh 8d] and won (360) with a pair of Fives
Seat 2: spy4711 (big blind) mucked [7h 6d]
Seat 3: oronso 104 folded before Flop (didn't bet)
Seat 4: [ro]hoi folded before Flop (didn't bet)
Seat 5: $kiLLme1sTeR folded before Flop (didn't bet)
Seat 6: SteveD36 folded before Flop (didn't bet)
Seat 7: eric205 folded before Flop (didn't bet)
Seat 8: jcarlos.vale (button) folded before Flop (didn't bet)



PokerStars Hand #221734549775: Tournament #3079057742, $0.98+$0.12 USD Hold'em No Limit - Level VII (60/120) - 2020/12/22 23:41:57 EET [2020/12/22 16:41:57 ET]
Table '3079057742 3' 9-max Seat #1 is the button
Seat 1: konex (5943 in chips) 
Seat 2: spy4711 (5310 in chips) 
Seat 3: oronso 104 (8249 in chips) 
Seat 4: [ro]hoi (2406 in chips) 
Seat 5: $kiLLme1sTeR (1322 in chips) 
Seat 6: SteveD36 (4181 in chips) 
Seat 7: eric205 (2985 in chips) 
Seat 8: jcarlos.vale (6231 in chips) 
Seat 9: fsh67 (3000 in chips) 
konex: posts the ante 15
spy4711: posts the ante 15
oronso 104: posts the ante 15
[ro]hoi: posts the ante 15
$kiLLme1sTeR: posts the ante 15
SteveD36: posts the ante 15
eric205: posts the ante 15
jcarlos.vale: posts the ante 15
fsh67: posts the ante 15
spy4711: posts small blind 60
oronso 104: posts big blind 120
*** HOLE CARDS ***
Dealt to jcarlos.vale [7c Th]
[ro]hoi: folds 
$kiLLme1sTeR: folds 
SteveD36: folds 
eric205: calls 120
jcarlos.vale: folds 
fsh67: folds 
konex: folds 
spy4711: calls 60
oronso 104: checks 
*** FLOP *** [Tc Ac Qs]
spy4711: checks 
oronso 104: checks 
eric205: bets 120
spy4711: folds 
oronso 104: folds 
Uncalled bet (120) returned to eric205
eric205 collected 495 from pot
eric205: doesn't show hand 
*** SUMMARY ***
Total pot 495 | Rake 0 
Board [Tc Ac Qs]
Seat 1: konex (button) folded before Flop (didn't bet)
Seat 2: spy4711 (small blind) folded on the Flop
Seat 3: oronso 104 (big blind) folded on the Flop
Seat 4: [ro]hoi folded before Flop (didn't bet)
Seat 5: $kiLLme1sTeR folded before Flop (didn't bet)
Seat 6: SteveD36 folded before Flop (didn't bet)
Seat 7: eric205 collected (495)
Seat 8: jcarlos.vale folded before Flop (didn't bet)
Seat 9: fsh67 folded before Flop (didn't bet)



PokerStars Hand #221734600851: Tournament #3079057742, $0.98+$0.12 USD Hold'em No Limit - Level VII (60/120) - 2020/12/22 23:43:14 EET [2020/12/22 16:43:14 ET]
Table '3079057742 3' 9-max Seat #2 is the button
Seat 1: konex (5928 in chips) 
Seat 2: spy4711 (5175 in chips) 
Seat 3: oronso 104 (8114 in chips) 
Seat 4: [ro]hoi (2391 in chips) 
Seat 5: $kiLLme1sTeR (1307 in chips) 
Seat 6: SteveD36 (4166 in chips) 
Seat 7: eric205 (3345 in chips) 
Seat 8: jcarlos.vale (6216 in chips) 
Seat 9: fsh67 (2985 in chips) 
konex: posts the ante 15
spy4711: posts the ante 15
oronso 104: posts the ante 15
[ro]hoi: posts the ante 15
$kiLLme1sTeR: posts the ante 15
SteveD36: posts the ante 15
eric205: posts the ante 15
jcarlos.vale: posts the ante 15
fsh67: posts the ante 15
oronso 104: posts small blind 60
[ro]hoi: posts big blind 120
*** HOLE CARDS ***
Dealt to jcarlos.vale [4s Ah]
$kiLLme1sTeR: raises 1172 to 1292 and is all-in
SteveD36: folds 
eric205: folds 
jcarlos.vale: folds 
fsh67: calls 1292
konex: folds 
spy4711: folds 
oronso 104: folds 
[ro]hoi: folds 
*** FLOP *** [Th Jh 4d]
*** TURN *** [Th Jh 4d] [6d]
*** RIVER *** [Th Jh 4d 6d] [2d]
*** SHOW DOWN ***
$kiLLme1sTeR: shows [5h 5s] (a pair of Fives)
fsh67: shows [9d Ks] (high card King)
$kiLLme1sTeR collected 2899 from pot
*** SUMMARY ***
Total pot 2899 | Rake 0 
Board [Th Jh 4d 6d 2d]
Seat 1: konex folded before Flop (didn't bet)
Seat 2: spy4711 (button) folded before Flop (didn't bet)
Seat 3: oronso 104 (small blind) folded before Flop
Seat 4: [ro]hoi (big blind) folded before Flop
Seat 5: $kiLLme1sTeR showed [5h 5s] and won (2899) with a pair of Fives
Seat 6: SteveD36 folded before Flop (didn't bet)
Seat 7: eric205 folded before Flop (didn't bet)
Seat 8: jcarlos.vale folded before Flop (didn't bet)
Seat 9: fsh67 showed [9d Ks] and lost with high card King



PokerStars Hand #221734628944: Tournament #3079057742, $0.98+$0.12 USD Hold'em No Limit - Level VII (60/120) - 2020/12/22 23:43:56 EET [2020/12/22 16:43:56 ET]
Table '3079057742 3' 9-max Seat #3 is the button
Seat 1: konex (5913 in chips) 
Seat 2: spy4711 (5160 in chips) 
Seat 3: oronso 104 (8039 in chips) 
Seat 4: [ro]hoi (2256 in chips) 
Seat 5: $kiLLme1sTeR (2899 in chips) 
Seat 6: SteveD36 (4151 in chips) 
Seat 7: eric205 (3330 in chips) 
Seat 8: jcarlos.vale (6201 in chips) 
Seat 9: fsh67 (1678 in chips) 
konex: posts the ante 15
spy4711: posts the ante 15
oronso 104: posts the ante 15
[ro]hoi: posts the ante 15
$kiLLme1sTeR: posts the ante 15
SteveD36: posts the ante 15
eric205: posts the ante 15
jcarlos.vale: posts the ante 15
fsh67: posts the ante 15
[ro]hoi: posts small blind 60
$kiLLme1sTeR: posts big blind 120
*** HOLE CARDS ***
Dealt to jcarlos.vale [2d 6d]
SteveD36: folds 
eric205: calls 120
jcarlos.vale: folds 
fsh67: folds 
konex: folds 
spy4711: folds 
oronso 104: folds 
[ro]hoi: calls 60
$kiLLme1sTeR: checks 
*** FLOP *** [9h 8s Th]
[ro]hoi: checks 
$kiLLme1sTeR: bets 233
eric205: calls 233
[ro]hoi: folds 
*** TURN *** [9h 8s Th] [Jd]
$kiLLme1sTeR: checks 
eric205: bets 360
$kiLLme1sTeR: calls 360
*** RIVER *** [9h 8s Th Jd] [Td]
$kiLLme1sTeR: checks 
eric205: checks 
*** SHOW DOWN ***
$kiLLme1sTeR: shows [Jh Ks] (two pair, Jacks and Tens)
eric205: mucks hand 
$kiLLme1sTeR collected 1681 from pot
*** SUMMARY ***
Total pot 1681 | Rake 0 
Board [9h 8s Th Jd Td]
Seat 1: konex folded before Flop (didn't bet)
Seat 2: spy4711 folded before Flop (didn't bet)
Seat 3: oronso 104 (button) folded before Flop (didn't bet)
Seat 4: [ro]hoi (small blind) folded on the Flop
Seat 5: $kiLLme1sTeR (big blind) showed [Jh Ks] and won (1681) with two pair, Jacks and Tens
Seat 6: SteveD36 folded before Flop (didn't bet)
Seat 7: eric205 mucked [9c 6c]
Seat 8: jcarlos.vale folded before Flop (didn't bet)
Seat 9: fsh67 folded before Flop (didn't bet)



PokerStars Hand #221734671288: Tournament #3079057742, $0.98+$0.12 USD Hold'em No Limit - Level VII (60/120) - 2020/12/22 23:44:55 EET [2020/12/22 16:44:55 ET]
Table '3079057742 3' 9-max Seat #4 is the button
Seat 1: konex (5898 in chips) 
Seat 2: spy4711 (5145 in chips) 
Seat 3: oronso 104 (8024 in chips) 
Seat 4: [ro]hoi (2121 in chips) 
Seat 5: $kiLLme1sTeR (3852 in chips) 
Seat 6: SteveD36 (4136 in chips) 
Seat 7: eric205 (2602 in chips) 
Seat 8: jcarlos.vale (6186 in chips) 
Seat 9: fsh67 (1663 in chips) 
konex: posts the ante 15
spy4711: posts the ante 15
oronso 104: posts the ante 15
[ro]hoi: posts the ante 15
$kiLLme1sTeR: posts the ante 15
SteveD36: posts the ante 15
eric205: posts the ante 15
jcarlos.vale: posts the ante 15
fsh67: posts the ante 15
$kiLLme1sTeR: posts small blind 60
SteveD36: posts big blind 120
*** HOLE CARDS ***
Dealt to jcarlos.vale [7d Qc]
eric205: folds 
jcarlos.vale: folds 
fsh67: calls 120
konex: folds 
spy4711: folds 
oronso 104: folds 
[ro]hoi: folds 
$kiLLme1sTeR: calls 60
SteveD36: checks 
*** FLOP *** [Ah 2s 6s]
$kiLLme1sTeR: bets 120
SteveD36: folds 
fsh67: folds 
Uncalled bet (120) returned to $kiLLme1sTeR
$kiLLme1sTeR collected 495 from pot
*** SUMMARY ***
Total pot 495 | Rake 0 
Board [Ah 2s 6s]
Seat 1: konex folded before Flop (didn't bet)
Seat 2: spy4711 folded before Flop (didn't bet)
Seat 3: oronso 104 folded before Flop (didn't bet)
Seat 4: [ro]hoi (button) folded before Flop (didn't bet)
Seat 5: $kiLLme1sTeR (small blind) collected (495)
Seat 6: SteveD36 (big blind) folded on the Flop
Seat 7: eric205 folded before Flop (didn't bet)
Seat 8: jcarlos.vale folded before Flop (didn't bet)
Seat 9: fsh67 folded on the Flop



PokerStars Hand #221734690466: Tournament #3079057742, $0.98+$0.12 USD Hold'em No Limit - Level VII (60/120) - 2020/12/22 23:45:23 EET [2020/12/22 16:45:23 ET]
Table '3079057742 3' 9-max Seat #5 is the button
Seat 1: konex (5883 in chips) 
Seat 2: spy4711 (5130 in chips) 
Seat 4: [ro]hoi (2106 in chips) 
Seat 5: $kiLLme1sTeR (4212 in chips) 
Seat 6: SteveD36 (4001 in chips) 
Seat 7: eric205 (2587 in chips) 
Seat 8: jcarlos.vale (6171 in chips) 
Seat 9: fsh67 (1528 in chips) 
konex: posts the ante 15
spy4711: posts the ante 15
[ro]hoi: posts the ante 15
$kiLLme1sTeR: posts the ante 15
SteveD36: posts the ante 15
eric205: posts the ante 15
jcarlos.vale: posts the ante 15
fsh67: posts the ante 15
SteveD36: posts small blind 60
eric205: posts big blind 120
*** HOLE CARDS ***
Dealt to jcarlos.vale [9c 5s]
jcarlos.vale: folds 
fsh67: calls 120
konex: raises 120 to 240
spy4711: folds 
[ro]hoi: raises 120 to 360
$kiLLme1sTeR: folds 
SteveD36: folds 
eric205: calls 240
fsh67: calls 240
konex: calls 120
*** FLOP *** [6c 9h Ac]
eric205: bets 810
fsh67: folds 
konex: calls 810
[ro]hoi: folds 
*** TURN *** [6c 9h Ac] [4d]
eric205: bets 1402 and is all-in
konex: calls 1402
*** RIVER *** [6c 9h Ac 4d] [9s]
*** SHOW DOWN ***
eric205: shows [4s As] (two pair, Aces and Nines)
konex: shows [Kc Ah] (two pair, Aces and Nines - King kicker)
konex collected 6044 from pot
eric205 finished the tournament
*** SUMMARY ***
Total pot 6044 | Rake 0 
Board [6c 9h Ac 4d 9s]
Seat 1: konex showed [Kc Ah] and won (6044) with two pair, Aces and Nines
Seat 2: spy4711 folded before Flop (didn't bet)
Seat 4: [ro]hoi folded on the Flop
Seat 5: $kiLLme1sTeR (button) folded before Flop (didn't bet)
Seat 6: SteveD36 (small blind) folded before Flop
Seat 7: eric205 (big blind) showed [4s As] and lost with two pair, Aces and Nines
Seat 8: jcarlos.vale folded before Flop (didn't bet)
Seat 9: fsh67 folded on the Flop



PokerStars Hand #221734768490: Tournament #3079057742, $0.98+$0.12 USD Hold'em No Limit - Level VIII (75/150) - 2020/12/22 23:47:10 EET [2020/12/22 16:47:10 ET]
Table '3079057742 3' 9-max Seat #6 is the button
Seat 1: konex (9340 in chips) 
Seat 2: spy4711 (5115 in chips) 
Seat 3: essbutcher (3000 in chips) 
Seat 4: [ro]hoi (1731 in chips) 
Seat 5: $kiLLme1sTeR (4197 in chips) 
Seat 6: SteveD36 (3926 in chips) 
Seat 7: xPrimat (3000 in chips) out of hand (moved from another table into small blind)
Seat 8: jcarlos.vale (6156 in chips) 
Seat 9: fsh67 (1153 in chips) 
xPrimat will be allowed to play after the button
konex: posts the ante 20
spy4711: posts the ante 20
essbutcher: posts the ante 20
[ro]hoi: posts the ante 20
$kiLLme1sTeR: posts the ante 20
SteveD36: posts the ante 20
jcarlos.vale: posts the ante 20
fsh67: posts the ante 20
jcarlos.vale: posts small blind 75
fsh67: posts big blind 150
*** HOLE CARDS ***
Dealt to jcarlos.vale [9d Qc]
konex: folds 
spy4711: folds 
essbutcher: folds 
[ro]hoi: raises 150 to 300
$kiLLme1sTeR: folds 
SteveD36: folds 
jcarlos.vale: folds 
fsh67: folds 
Uncalled bet (150) returned to [ro]hoi
[ro]hoi collected 535 from pot
[ro]hoi: doesn't show hand 
*** SUMMARY ***
Total pot 535 | Rake 0 
Seat 1: konex folded before Flop (didn't bet)
Seat 2: spy4711 folded before Flop (didn't bet)
Seat 3: essbutcher folded before Flop (didn't bet)
Seat 4: [ro]hoi collected (535)
Seat 5: $kiLLme1sTeR folded before Flop (didn't bet)
Seat 6: SteveD36 (button) folded before Flop (didn't bet)
Seat 8: jcarlos.vale (small blind) folded before Flop
Seat 9: fsh67 (big blind) folded before Flop



PokerStars Hand #221734781461: Tournament #3079057742, $0.98+$0.12 USD Hold'em No Limit - Level VIII (75/150) - 2020/12/22 23:47:29 EET [2020/12/22 16:47:29 ET]
Table '3079057742 3' 9-max Seat #8 is the button
Seat 1: konex (9320 in chips) 
Seat 2: spy4711 (5095 in chips) 
Seat 3: essbutcher (2980 in chips) 
Seat 4: [ro]hoi (2096 in chips) 
Seat 5: $kiLLme1sTeR (4177 in chips) 
Seat 6: SteveD36 (3906 in chips) 
Seat 7: xPrimat (3000 in chips) 
Seat 8: jcarlos.vale (6061 in chips) 
Seat 9: fsh67 (983 in chips) 
konex: posts the ante 20
spy4711: posts the ante 20
essbutcher: posts the ante 20
[ro]hoi: posts the ante 20
$kiLLme1sTeR: posts the ante 20
SteveD36: posts the ante 20
xPrimat: posts the ante 20
jcarlos.vale: posts the ante 20
fsh67: posts the ante 20
fsh67: posts small blind 75
konex: posts big blind 150
*** HOLE CARDS ***
Dealt to jcarlos.vale [9h Qc]
spy4711: folds 
essbutcher: folds 
[ro]hoi: calls 150
$kiLLme1sTeR: folds 
SteveD36: folds 
xPrimat: calls 150
jcarlos.vale: folds 
fsh67: folds 
konex: checks 
*** FLOP *** [2c Jh 2s]
konex: checks 
[ro]hoi: checks 
xPrimat: checks 
*** TURN *** [2c Jh 2s] [4c]
konex: bets 353
[ro]hoi: calls 353
xPrimat: folds 
*** RIVER *** [2c Jh 2s 4c] [3s]
konex: bets 1650
[ro]hoi: folds 
Uncalled bet (1650) returned to konex
konex collected 1411 from pot
*** SUMMARY ***
Total pot 1411 | Rake 0 
Board [2c Jh 2s 4c 3s]
Seat 1: konex (big blind) collected (1411)
Seat 2: spy4711 folded before Flop (didn't bet)
Seat 3: essbutcher folded before Flop (didn't bet)
Seat 4: [ro]hoi folded on the River
Seat 5: $kiLLme1sTeR folded before Flop (didn't bet)
Seat 6: SteveD36 folded before Flop (didn't bet)
Seat 7: xPrimat folded on the Turn
Seat 8: jcarlos.vale (button) folded before Flop (didn't bet)
Seat 9: fsh67 (small blind) folded before Flop



PokerStars Hand #221734837562: Tournament #3079057742, $0.98+$0.12 USD Hold'em No Limit - Level VIII (75/150) - 2020/12/22 23:48:50 EET [2020/12/22 16:48:50 ET]
Table '3079057742 3' 9-max Seat #9 is the button
Seat 1: konex (10208 in chips) 
Seat 2: spy4711 (5075 in chips) 
Seat 3: essbutcher (2960 in chips) 
Seat 4: [ro]hoi (1573 in chips) 
Seat 5: $kiLLme1sTeR (4157 in chips) 
Seat 6: SteveD36 (3886 in chips) 
Seat 7: xPrimat (2830 in chips) 
Seat 8: jcarlos.vale (6041 in chips) 
Seat 9: fsh67 (888 in chips) 
konex: posts the ante 20
spy4711: posts the ante 20
essbutcher: posts the ante 20
[ro]hoi: posts the ante 20
$kiLLme1sTeR: posts the ante 20
SteveD36: posts the ante 20
xPrimat: posts the ante 20
jcarlos.vale: posts the ante 20
fsh67: posts the ante 20
konex: posts small blind 75
spy4711: posts big blind 150
*** HOLE CARDS ***
Dealt to jcarlos.vale [7d Qs]
essbutcher: calls 150
[ro]hoi: folds 
$kiLLme1sTeR: folds 
SteveD36: folds 
xPrimat: calls 150
jcarlos.vale: folds 
fsh67: raises 718 to 868 and is all-in
konex: folds 
spy4711: folds 
essbutcher: calls 718
xPrimat: calls 718
*** FLOP *** [3h 6c 7h]
essbutcher: bets 600
xPrimat: raises 1342 to 1942 and is all-in
essbutcher: calls 1342
*** TURN *** [3h 6c 7h] [5d]
*** RIVER *** [3h 6c 7h 5d] [4h]
*** SHOW DOWN ***
essbutcher: shows [8c 9c] (a straight, Five to Nine)
xPrimat: shows [7s 6s] (a straight, Three to Seven)
essbutcher collected 3884 from side pot
fsh67: shows [Kh Js] (a straight, Three to Seven)
essbutcher collected 3009 from main pot
xPrimat finished the tournament
fsh67 finished the tournament
*** SUMMARY ***
Total pot 6893 Main pot 3009. Side pot 3884. | Rake 0 
Board [3h 6c 7h 5d 4h]
Seat 1: konex (small blind) folded before Flop
Seat 2: spy4711 (big blind) folded before Flop
Seat 3: essbutcher showed [8c 9c] and won (6893) with a straight, Five to Nine
Seat 4: [ro]hoi folded before Flop (didn't bet)
Seat 5: $kiLLme1sTeR folded before Flop (didn't bet)
Seat 6: SteveD36 folded before Flop (didn't bet)
Seat 7: xPrimat showed [7s 6s] and lost with a straight, Three to Seven
Seat 8: jcarlos.vale folded before Flop (didn't bet)
Seat 9: fsh67 (button) showed [Kh Js] and lost with a straight, Three to Seven



PokerStars Hand #221734879771: Tournament #3079057742, $0.98+$0.12 USD Hold'em No Limit - Level VIII (75/150) - 2020/12/22 23:49:52 EET [2020/12/22 16:49:52 ET]
Table '3079057742 3' 9-max Seat #1 is the button
Seat 1: konex (10113 in chips) 
Seat 2: spy4711 (4905 in chips) 
Seat 3: essbutcher (7023 in chips) 
Seat 4: [ro]hoi (1553 in chips) 
Seat 5: $kiLLme1sTeR (4137 in chips) 
Seat 6: SteveD36 (3866 in chips) 
Seat 8: jcarlos.vale (6021 in chips) 
Seat 9: jonojojello1998 (6396 in chips) 
konex: posts the ante 20
spy4711: posts the ante 20
essbutcher: posts the ante 20
[ro]hoi: posts the ante 20
$kiLLme1sTeR: posts the ante 20
SteveD36: posts the ante 20
jcarlos.vale: posts the ante 20
jonojojello1998: posts the ante 20
spy4711: posts small blind 75
essbutcher: posts big blind 150
*** HOLE CARDS ***
Dealt to jcarlos.vale [Ts Js]
[ro]hoi: folds 
$kiLLme1sTeR: folds 
SteveD36: folds 
jcarlos.vale: raises 240 to 390
jonojojello1998: folds 
konex: folds 
spy4711: folds 
essbutcher: calls 240
*** FLOP *** [7s 8d Ad]
essbutcher: checks 
jcarlos.vale: checks 
*** TURN *** [7s 8d Ad] [9d]
essbutcher: bets 1015
jcarlos.vale: raises 4596 to 5611 and is all-in
essbutcher: calls 4596
*** RIVER *** [7s 8d Ad 9d] [9c]
*** SHOW DOWN ***
essbutcher: shows [As 8s] (two pair, Aces and Nines)
jcarlos.vale: shows [Ts Js] (a straight, Seven to Jack)
jcarlos.vale collected 12237 from pot
*** SUMMARY ***
Total pot 12237 | Rake 0 
Board [7s 8d Ad 9d 9c]
Seat 1: konex (button) folded before Flop (didn't bet)
Seat 2: spy4711 (small blind) folded before Flop
Seat 3: essbutcher (big blind) showed [As 8s] and lost with two pair, Aces and Nines
Seat 4: [ro]hoi folded before Flop (didn't bet)
Seat 5: $kiLLme1sTeR folded before Flop (didn't bet)
Seat 6: SteveD36 folded before Flop (didn't bet)
Seat 8: jcarlos.vale showed [Ts Js] and won (12237) with a straight, Seven to Jack
Seat 9: jonojojello1998 folded before Flop (didn't bet)



PokerStars Hand #221734917891: Tournament #3079057742, $0.98+$0.12 USD Hold'em No Limit - Level VIII (75/150) - 2020/12/22 23:50:48 EET [2020/12/22 16:50:48 ET]
Table '3079057742 3' 9-max Seat #2 is the button
Seat 1: konex (10093 in chips) 
Seat 2: spy4711 (4810 in chips) 
Seat 3: essbutcher (1002 in chips) 
Seat 4: [ro]hoi (1533 in chips) 
Seat 5: $kiLLme1sTeR (4117 in chips) 
Seat 6: SteveD36 (3846 in chips) 
Seat 8: jcarlos.vale (12237 in chips) 
Seat 9: jonojojello1998 (6376 in chips) 
konex: posts the ante 20
spy4711: posts the ante 20
essbutcher: posts the ante 20
[ro]hoi: posts the ante 20
$kiLLme1sTeR: posts the ante 20
SteveD36: posts the ante 20
jcarlos.vale: posts the ante 20
jonojojello1998: posts the ante 20
essbutcher: posts small blind 75
[ro]hoi: posts big blind 150
*** HOLE CARDS ***
Dealt to jcarlos.vale [9s Js]
$kiLLme1sTeR: folds 
SteveD36: folds 
jcarlos.vale: raises 240 to 390
jonojojello1998: folds 
konex: raises 240 to 630
spy4711: folds 
essbutcher: raises 352 to 982 and is all-in
[ro]hoi: folds 
jcarlos.vale: folds 
konex: calls 352
*** FLOP *** [Kd Qc Kh]
*** TURN *** [Kd Qc Kh] [7s]
*** RIVER *** [Kd Qc Kh 7s] [7c]
*** SHOW DOWN ***
essbutcher: shows [5d Ah] (two pair, Kings and Sevens)
konex: shows [Jd Jh] (two pair, Kings and Jacks)
konex collected 2664 from pot
essbutcher finished the tournament
*** SUMMARY ***
Total pot 2664 | Rake 0 
Board [Kd Qc Kh 7s 7c]
Seat 1: konex showed [Jd Jh] and won (2664) with two pair, Kings and Jacks
Seat 2: spy4711 (button) folded before Flop (didn't bet)
Seat 3: essbutcher (small blind) showed [5d Ah] and lost with two pair, Kings and Sevens
Seat 4: [ro]hoi (big blind) folded before Flop
Seat 5: $kiLLme1sTeR folded before Flop (didn't bet)
Seat 6: SteveD36 folded before Flop (didn't bet)
Seat 8: jcarlos.vale folded before Flop
Seat 9: jonojojello1998 folded before Flop (didn't bet)



PokerStars Hand #221734943635: Tournament #3079057742, $0.98+$0.12 USD Hold'em No Limit - Level VIII (75/150) - 2020/12/22 23:51:26 EET [2020/12/22 16:51:26 ET]
Table '3079057742 3' 9-max Seat #4 is the button
Seat 1: konex (11755 in chips) 
Seat 2: spy4711 (4790 in chips) 
Seat 4: [ro]hoi (1363 in chips) 
Seat 5: $kiLLme1sTeR (4097 in chips) 
Seat 6: SteveD36 (3826 in chips) 
Seat 7: Bulldogg12345 (5115 in chips) 
Seat 8: jcarlos.vale (11827 in chips) 
Seat 9: jonojojello1998 (6356 in chips) 
konex: posts the ante 20
spy4711: posts the ante 20
[ro]hoi: posts the ante 20
$kiLLme1sTeR: posts the ante 20
SteveD36: posts the ante 20
Bulldogg12345: posts the ante 20
jcarlos.vale: posts the ante 20
jonojojello1998: posts the ante 20
$kiLLme1sTeR: posts small blind 75
SteveD36: posts big blind 150
*** HOLE CARDS ***
Dealt to jcarlos.vale [Jh Kd]
Bulldogg12345: folds 
jcarlos.vale: raises 240 to 390
jonojojello1998: folds 
konex: folds 
spy4711: folds 
[ro]hoi: folds 
$kiLLme1sTeR: folds 
SteveD36: calls 240
*** FLOP *** [5c Ah As]
SteveD36: checks 
jcarlos.vale: checks 
*** TURN *** [5c Ah As] [Kh]
SteveD36: checks 
jcarlos.vale: bets 300
SteveD36: calls 300
*** RIVER *** [5c Ah As Kh] [3c]
SteveD36: checks 
jcarlos.vale: checks 
*** SHOW DOWN ***
SteveD36: shows [Kc 2s] (two pair, Aces and Kings)
jcarlos.vale: shows [Jh Kd] (two pair, Aces and Kings - Jack kicker)
jcarlos.vale collected 1615 from pot
*** SUMMARY ***
Total pot 1615 | Rake 0 
Board [5c Ah As Kh 3c]
Seat 1: konex folded before Flop (didn't bet)
Seat 2: spy4711 folded before Flop (didn't bet)
Seat 4: [ro]hoi (button) folded before Flop (didn't bet)
Seat 5: $kiLLme1sTeR (small blind) folded before Flop
Seat 6: SteveD36 (big blind) showed [Kc 2s] and lost with two pair, Aces and Kings
Seat 7: Bulldogg12345 folded before Flop (didn't bet)
Seat 8: jcarlos.vale showed [Jh Kd] and won (1615) with two pair, Aces and Kings
Seat 9: jonojojello1998 folded before Flop (didn't bet)



PokerStars Hand #221734972336: Tournament #3079057742, $0.98+$0.12 USD Hold'em No Limit - Level VIII (75/150) - 2020/12/22 23:52:08 EET [2020/12/22 16:52:08 ET]
Table '3079057742 3' 9-max Seat #5 is the button
Seat 1: konex (11735 in chips) 
Seat 2: spy4711 (4770 in chips) 
Seat 3: kyriasavv21 (16835 in chips) 
Seat 4: [ro]hoi (1343 in chips) 
Seat 5: $kiLLme1sTeR (4002 in chips) 
Seat 6: SteveD36 (3116 in chips) 
Seat 7: Bulldogg12345 (5095 in chips) 
Seat 8: jcarlos.vale (12732 in chips) 
Seat 9: jonojojello1998 (6336 in chips) 
konex: posts the ante 20
spy4711: posts the ante 20
kyriasavv21: posts the ante 20
[ro]hoi: posts the ante 20
$kiLLme1sTeR: posts the ante 20
SteveD36: posts the ante 20
Bulldogg12345: posts the ante 20
jcarlos.vale: posts the ante 20
jonojojello1998: posts the ante 20
SteveD36: posts small blind 75
Bulldogg12345: posts big blind 150
*** HOLE CARDS ***
Dealt to jcarlos.vale [8c Kd]
jcarlos.vale: folds 
jonojojello1998: calls 150
konex: folds 
spy4711: calls 150
kyriasavv21: raises 900 to 1050
[ro]hoi: folds 
$kiLLme1sTeR: folds 
SteveD36: folds 
Bulldogg12345: calls 900
jonojojello1998: folds 
spy4711: calls 900
*** FLOP *** [6s Qs 4c]
Bulldogg12345: checks 
spy4711: checks 
kyriasavv21: bets 4350
Bulldogg12345: folds 
spy4711: folds 
Uncalled bet (4350) returned to kyriasavv21
kyriasavv21 collected 3555 from pot
kyriasavv21: doesn't show hand 
*** SUMMARY ***
Total pot 3555 | Rake 0 
Board [6s Qs 4c]
Seat 1: konex folded before Flop (didn't bet)
Seat 2: spy4711 folded on the Flop
Seat 3: kyriasavv21 collected (3555)
Seat 4: [ro]hoi folded before Flop (didn't bet)
Seat 5: $kiLLme1sTeR (button) folded before Flop (didn't bet)
Seat 6: SteveD36 (small blind) folded before Flop
Seat 7: Bulldogg12345 (big blind) folded on the Flop
Seat 8: jcarlos.vale folded before Flop (didn't bet)
Seat 9: jonojojello1998 folded before Flop



PokerStars Hand #221735004271: Tournament #3079057742, $0.98+$0.12 USD Hold'em No Limit - Level VIII (75/150) - 2020/12/22 23:52:55 EET [2020/12/22 16:52:55 ET]
Table '3079057742 3' 9-max Seat #6 is the button
Seat 1: konex (11715 in chips) 
Seat 2: spy4711 (3700 in chips) 
Seat 3: kyriasavv21 (19320 in chips) 
Seat 4: [ro]hoi (1323 in chips) 
Seat 5: $kiLLme1sTeR (3982 in chips) 
Seat 6: SteveD36 (3021 in chips) 
Seat 7: Bulldogg12345 (4025 in chips) 
Seat 8: jcarlos.vale (12712 in chips) 
Seat 9: jonojojello1998 (6166 in chips) 
konex: posts the ante 20
spy4711: posts the ante 20
kyriasavv21: posts the ante 20
[ro]hoi: posts the ante 20
$kiLLme1sTeR: posts the ante 20
SteveD36: posts the ante 20
Bulldogg12345: posts the ante 20
jcarlos.vale: posts the ante 20
jonojojello1998: posts the ante 20
Bulldogg12345: posts small blind 75
jcarlos.vale: posts big blind 150
*** HOLE CARDS ***
Dealt to jcarlos.vale [7c 3c]
jonojojello1998: calls 150
konex: folds 
spy4711: folds 
kyriasavv21: calls 150
[ro]hoi: calls 150
$kiLLme1sTeR: calls 150
SteveD36: folds 
Bulldogg12345: raises 300 to 450
jcarlos.vale: folds 
jonojojello1998: calls 300
kyriasavv21: calls 300
[ro]hoi: raises 853 to 1303 and is all-in
$kiLLme1sTeR: folds 
Bulldogg12345: raises 2702 to 4005 and is all-in
jonojojello1998: folds 
kyriasavv21: folds 
Uncalled bet (2702) returned to Bulldogg12345
*** FLOP *** [Qc 4d 3s]
*** TURN *** [Qc 4d 3s] [5c]
*** RIVER *** [Qc 4d 3s 5c] [5d]
*** SHOW DOWN ***
Bulldogg12345: shows [Ah Kh] (a pair of Fives)
[ro]hoi: shows [Jh Qs] (two pair, Queens and Fives)
[ro]hoi collected 3986 from pot
*** SUMMARY ***
Total pot 3986 | Rake 0 
Board [Qc 4d 3s 5c 5d]
Seat 1: konex folded before Flop (didn't bet)
Seat 2: spy4711 folded before Flop (didn't bet)
Seat 3: kyriasavv21 folded before Flop
Seat 4: [ro]hoi showed [Jh Qs] and won (3986) with two pair, Queens and Fives
Seat 5: $kiLLme1sTeR folded before Flop
Seat 6: SteveD36 (button) folded before Flop (didn't bet)
Seat 7: Bulldogg12345 (small blind) showed [Ah Kh] and lost with a pair of Fives
Seat 8: jcarlos.vale (big blind) folded before Flop
Seat 9: jonojojello1998 folded before Flop



PokerStars Hand #221735046131: Tournament #3079057742, $0.98+$0.12 USD Hold'em No Limit - Level VIII (75/150) - 2020/12/22 23:53:57 EET [2020/12/22 16:53:57 ET]
Table '3079057742 3' 9-max Seat #7 is the button
Seat 1: konex (11695 in chips) 
Seat 2: spy4711 (3680 in chips) 
Seat 3: kyriasavv21 (18850 in chips) 
Seat 4: [ro]hoi (3986 in chips) 
Seat 5: $kiLLme1sTeR (3812 in chips) 
Seat 6: SteveD36 (3001 in chips) 
Seat 7: Bulldogg12345 (2702 in chips) 
Seat 8: jcarlos.vale (12542 in chips) 
Seat 9: jonojojello1998 (5696 in chips) 
konex: posts the ante 20
spy4711: posts the ante 20
kyriasavv21: posts the ante 20
[ro]hoi: posts the ante 20
$kiLLme1sTeR: posts the ante 20
SteveD36: posts the ante 20
Bulldogg12345: posts the ante 20
jcarlos.vale: posts the ante 20
jonojojello1998: posts the ante 20
jcarlos.vale: posts small blind 75
jonojojello1998: posts big blind 150
*** HOLE CARDS ***
Dealt to jcarlos.vale [Tc 4d]
konex: folds 
spy4711: folds 
kyriasavv21: raises 900 to 1050
[ro]hoi: calls 1050
$kiLLme1sTeR: folds 
SteveD36: folds 
Bulldogg12345: folds 
jcarlos.vale: folds 
jonojojello1998: folds 
*** FLOP *** [2s Qs 2c]
kyriasavv21: bets 1350
[ro]hoi: raises 1566 to 2916 and is all-in
kyriasavv21: calls 1566
*** TURN *** [2s Qs 2c] [7d]
*** RIVER *** [2s Qs 2c 7d] [7h]
*** SHOW DOWN ***
kyriasavv21: shows [Ah Kh] (two pair, Sevens and Deuces)
[ro]hoi: shows [4s 4h] (two pair, Sevens and Fours)
[ro]hoi collected 8337 from pot
*** SUMMARY ***
Total pot 8337 | Rake 0 
Board [2s Qs 2c 7d 7h]
Seat 1: konex folded before Flop (didn't bet)
Seat 2: spy4711 folded before Flop (didn't bet)
Seat 3: kyriasavv21 showed [Ah Kh] and lost with two pair, Sevens and Deuces
Seat 4: [ro]hoi showed [4s 4h] and won (8337) with two pair, Sevens and Fours
Seat 5: $kiLLme1sTeR folded before Flop (didn't bet)
Seat 6: SteveD36 folded before Flop (didn't bet)
Seat 7: Bulldogg12345 (button) folded before Flop (didn't bet)
Seat 8: jcarlos.vale (small blind) folded before Flop
Seat 9: jonojojello1998 (big blind) folded before Flop



PokerStars Hand #221735085785: Tournament #3079057742, $0.98+$0.12 USD Hold'em No Limit - Level VIII (75/150) - 2020/12/22 23:54:43 EET [2020/12/22 16:54:43 ET]
Table '3079057742 3' 9-max Seat #8 is the button
Seat 1: konex (11675 in chips) 
Seat 2: spy4711 (3660 in chips) 
Seat 3: kyriasavv21 (14864 in chips) 
Seat 4: [ro]hoi (8337 in chips) 
Seat 5: $kiLLme1sTeR (3792 in chips) 
Seat 6: SteveD36 (2981 in chips) 
Seat 7: Bulldogg12345 (2682 in chips) 
Seat 8: jcarlos.vale (12447 in chips) 
Seat 9: jonojojello1998 (5526 in chips) 
konex: posts the ante 20
spy4711: posts the ante 20
kyriasavv21: posts the ante 20
[ro]hoi: posts the ante 20
$kiLLme1sTeR: posts the ante 20
SteveD36: posts the ante 20
Bulldogg12345: posts the ante 20
jcarlos.vale: posts the ante 20
jonojojello1998: posts the ante 20
jonojojello1998: posts small blind 75
konex: posts big blind 150
*** HOLE CARDS ***
Dealt to jcarlos.vale [Ts 8c]
spy4711: calls 150
kyriasavv21: raises 300 to 450
[ro]hoi: calls 450
$kiLLme1sTeR: folds 
SteveD36: folds 
Bulldogg12345: raises 2212 to 2662 and is all-in
jcarlos.vale: folds 
jonojojello1998: folds 
konex: folds 
spy4711: folds 
kyriasavv21: calls 2212
[ro]hoi: calls 2212
*** FLOP *** [Jc 3c Qd]
kyriasavv21: checks 
[ro]hoi: checks 
*** TURN *** [Jc 3c Qd] [4h]
kyriasavv21: bets 750
[ro]hoi: folds 
Uncalled bet (750) returned to kyriasavv21
*** RIVER *** [Jc 3c Qd 4h] [6s]
*** SHOW DOWN ***
kyriasavv21: shows [4d Ad] (a pair of Fours)
Bulldogg12345: shows [Js Qs] (two pair, Queens and Jacks)
Bulldogg12345 collected 8541 from pot
*** SUMMARY ***
Total pot 8541 | Rake 0 
Board [Jc 3c Qd 4h 6s]
Seat 1: konex (big blind) folded before Flop
Seat 2: spy4711 folded before Flop
Seat 3: kyriasavv21 showed [4d Ad] and lost with a pair of Fours
Seat 4: [ro]hoi folded on the Turn
Seat 5: $kiLLme1sTeR folded before Flop (didn't bet)
Seat 6: SteveD36 folded before Flop (didn't bet)
Seat 7: Bulldogg12345 showed [Js Qs] and won (8541) with two pair, Queens and Jacks
Seat 8: jcarlos.vale (button) folded before Flop (didn't bet)
Seat 9: jonojojello1998 (small blind) folded before Flop



PokerStars Hand #221735316376: Tournament #3079057742, $0.98+$0.12 USD Hold'em No Limit - Level VIII (75/150) - 2020/12/23 0:01:48 EET [2020/12/22 17:01:48 ET]
Table '3079057742 3' 9-max Seat #9 is the button
Seat 1: konex (11505 in chips) 
Seat 2: spy4711 (3490 in chips) 
Seat 3: kyriasavv21 (12182 in chips) 
Seat 4: [ro]hoi (5655 in chips) 
Seat 5: $kiLLme1sTeR (3772 in chips) 
Seat 6: SteveD36 (2961 in chips) 
Seat 7: Bulldogg12345 (8541 in chips) 
Seat 8: jcarlos.vale (12427 in chips) 
Seat 9: jonojojello1998 (5431 in chips) 
konex: posts the ante 20
spy4711: posts the ante 20
kyriasavv21: posts the ante 20
[ro]hoi: posts the ante 20
$kiLLme1sTeR: posts the ante 20
SteveD36: posts the ante 20
Bulldogg12345: posts the ante 20
jcarlos.vale: posts the ante 20
jonojojello1998: posts the ante 20
konex: posts small blind 75
spy4711: posts big blind 150
*** HOLE CARDS ***
Dealt to jcarlos.vale [8c 5c]
kyriasavv21 has timed out
kyriasavv21: folds 
kyriasavv21 is sitting out
[ro]hoi: folds 
$kiLLme1sTeR: folds 
SteveD36: folds 
Bulldogg12345: calls 150
jcarlos.vale: calls 150
jonojojello1998: folds 
konex: calls 75
spy4711: checks 
*** FLOP *** [6h Tc Jh]
konex: checks 
spy4711: checks 
Bulldogg12345: bets 390
jcarlos.vale: folds 
konex: folds 
spy4711: folds 
Uncalled bet (390) returned to Bulldogg12345
Bulldogg12345 collected 780 from pot
Bulldogg12345: doesn't show hand 
*** SUMMARY ***
Total pot 780 | Rake 0 
Board [6h Tc Jh]
Seat 1: konex (small blind) folded on the Flop
Seat 2: spy4711 (big blind) folded on the Flop
Seat 3: kyriasavv21 folded before Flop (didn't bet)
Seat 4: [ro]hoi folded before Flop (didn't bet)
Seat 5: $kiLLme1sTeR folded before Flop (didn't bet)
Seat 6: SteveD36 folded before Flop (didn't bet)
Seat 7: Bulldogg12345 collected (780)
Seat 8: jcarlos.vale folded on the Flop
Seat 9: jonojojello1998 (button) folded before Flop (didn't bet)



PokerStars Hand #221735393684: Tournament #3079057742, $0.98+$0.12 USD Hold'em No Limit - Level IX (100/200) - 2020/12/23 0:03:43 EET [2020/12/22 17:03:43 ET]
Table '3079057742 3' 9-max Seat #1 is the button
Seat 1: konex (11335 in chips) 
Seat 2: spy4711 (3320 in chips) 
Seat 3: kyriasavv21 (12162 in chips) is sitting out
Seat 4: [ro]hoi (5635 in chips) 
Seat 5: $kiLLme1sTeR (3752 in chips) 
Seat 6: SteveD36 (2941 in chips) 
Seat 7: Bulldogg12345 (9151 in chips) 
Seat 8: jcarlos.vale (12257 in chips) 
Seat 9: jonojojello1998 (5411 in chips) 
konex: posts the ante 25
spy4711: posts the ante 25
kyriasavv21: posts the ante 25
[ro]hoi: posts the ante 25
$kiLLme1sTeR: posts the ante 25
SteveD36: posts the ante 25
Bulldogg12345: posts the ante 25
jcarlos.vale: posts the ante 25
jonojojello1998: posts the ante 25
spy4711: posts small blind 100
kyriasavv21: posts big blind 200
*** HOLE CARDS ***
Dealt to jcarlos.vale [As 7s]
[ro]hoi: folds 
$kiLLme1sTeR: folds 
SteveD36: folds 
Bulldogg12345: calls 200
jcarlos.vale: raises 320 to 520
jonojojello1998: folds 
konex: folds 
spy4711: folds 
kyriasavv21: folds 
Bulldogg12345: calls 320
*** FLOP *** [Qs 7h 9s]
Bulldogg12345: checks 
jcarlos.vale: checks 
*** TURN *** [Qs 7h 9s] [Th]
Bulldogg12345: checks 
jcarlos.vale: checks 
*** RIVER *** [Qs 7h 9s Th] [8h]
Bulldogg12345: bets 783
jcarlos.vale: folds 
Uncalled bet (783) returned to Bulldogg12345
Bulldogg12345 collected 1565 from pot
Bulldogg12345: doesn't show hand 
*** SUMMARY ***
Total pot 1565 | Rake 0 
Board [Qs 7h 9s Th 8h]
Seat 1: konex (button) folded before Flop (didn't bet)
Seat 2: spy4711 (small blind) folded before Flop
Seat 3: kyriasavv21 (big blind) folded before Flop
Seat 4: [ro]hoi folded before Flop (didn't bet)
Seat 5: $kiLLme1sTeR folded before Flop (didn't bet)
Seat 6: SteveD36 folded before Flop (didn't bet)
Seat 7: Bulldogg12345 collected (1565)
Seat 8: jcarlos.vale folded on the River
Seat 9: jonojojello1998 folded before Flop (didn't bet)



PokerStars Hand #221735432538: Tournament #3079057742, $0.98+$0.12 USD Hold'em No Limit - Level IX (100/200) - 2020/12/23 0:04:40 EET [2020/12/22 17:04:40 ET]
Table '3079057742 3' 9-max Seat #2 is the button
Seat 1: konex (11310 in chips) 
Seat 2: spy4711 (3195 in chips) 
Seat 3: kyriasavv21 (11937 in chips) is sitting out
Seat 4: [ro]hoi (5610 in chips) 
Seat 5: $kiLLme1sTeR (3727 in chips) 
Seat 6: SteveD36 (2916 in chips) 
Seat 7: Bulldogg12345 (10171 in chips) 
Seat 8: jcarlos.vale (11712 in chips) 
Seat 9: jonojojello1998 (5386 in chips) 
konex: posts the ante 25
spy4711: posts the ante 25
kyriasavv21: posts the ante 25
[ro]hoi: posts the ante 25
$kiLLme1sTeR: posts the ante 25
SteveD36: posts the ante 25
Bulldogg12345: posts the ante 25
jcarlos.vale: posts the ante 25
jonojojello1998: posts the ante 25
kyriasavv21: posts small blind 100
[ro]hoi: posts big blind 200
*** HOLE CARDS ***
Dealt to jcarlos.vale [2c 5s]
$kiLLme1sTeR: folds 
SteveD36: folds 
Bulldogg12345: folds 
jcarlos.vale: folds 
jonojojello1998: calls 200
konex: folds 
spy4711: folds 
kyriasavv21: folds 
[ro]hoi: checks 
*** FLOP *** [4s Qd Jc]
[ro]hoi: checks 
jonojojello1998: checks 
*** TURN *** [4s Qd Jc] [6d]
[ro]hoi: bets 200
jonojojello1998: calls 200
*** RIVER *** [4s Qd Jc 6d] [5h]
[ro]hoi: checks 
jonojojello1998: bets 400
[ro]hoi: folds 
Uncalled bet (400) returned to jonojojello1998
jonojojello1998 collected 1125 from pot
jonojojello1998: doesn't show hand 
*** SUMMARY ***
Total pot 1125 | Rake 0 
Board [4s Qd Jc 6d 5h]
Seat 1: konex folded before Flop (didn't bet)
Seat 2: spy4711 (button) folded before Flop (didn't bet)
Seat 3: kyriasavv21 (small blind) folded before Flop
Seat 4: [ro]hoi (big blind) folded on the River
Seat 5: $kiLLme1sTeR folded before Flop (didn't bet)
Seat 6: SteveD36 folded before Flop (didn't bet)
Seat 7: Bulldogg12345 folded before Flop (didn't bet)
Seat 8: jcarlos.vale folded before Flop (didn't bet)
Seat 9: jonojojello1998 collected (1125)



PokerStars Hand #221735478321: Tournament #3079057742, $0.98+$0.12 USD Hold'em No Limit - Level IX (100/200) - 2020/12/23 0:05:47 EET [2020/12/22 17:05:47 ET]
Table '3079057742 3' 9-max Seat #3 is the button
Seat 1: konex (11285 in chips) 
Seat 2: spy4711 (3170 in chips) 
Seat 3: kyriasavv21 (11812 in chips) is sitting out
Seat 4: [ro]hoi (5185 in chips) 
Seat 5: $kiLLme1sTeR (3702 in chips) 
Seat 6: SteveD36 (2891 in chips) 
Seat 7: Bulldogg12345 (10146 in chips) 
Seat 8: jcarlos.vale (11687 in chips) 
Seat 9: jonojojello1998 (6086 in chips) 
konex: posts the ante 25
spy4711: posts the ante 25
kyriasavv21: posts the ante 25
[ro]hoi: posts the ante 25
$kiLLme1sTeR: posts the ante 25
SteveD36: posts the ante 25
Bulldogg12345: posts the ante 25
jcarlos.vale: posts the ante 25
jonojojello1998: posts the ante 25
[ro]hoi: posts small blind 100
$kiLLme1sTeR: posts big blind 200
*** HOLE CARDS ***
Dealt to jcarlos.vale [3s 2s]
SteveD36: folds 
Bulldogg12345: raises 200 to 400
jcarlos.vale: folds 
jonojojello1998: folds 
konex: folds 
spy4711: folds 
kyriasavv21: folds 
[ro]hoi: folds 
$kiLLme1sTeR: raises 3277 to 3677 and is all-in
Bulldogg12345: calls 3277
*** FLOP *** [4h 3c 9c]
*** TURN *** [4h 3c 9c] [6s]
*** RIVER *** [4h 3c 9c 6s] [Ts]
*** SHOW DOWN ***
$kiLLme1sTeR: shows [Ac Kh] (high card Ace)
Bulldogg12345: shows [Ks Ah] (high card Ace)
$kiLLme1sTeR collected 3840 from pot
Bulldogg12345 collected 3839 from pot
*** SUMMARY ***
Total pot 7679 | Rake 0 
Board [4h 3c 9c 6s Ts]
Seat 1: konex folded before Flop (didn't bet)
Seat 2: spy4711 folded before Flop (didn't bet)
Seat 3: kyriasavv21 (button) folded before Flop (didn't bet)
Seat 4: [ro]hoi (small blind) folded before Flop
Seat 5: $kiLLme1sTeR (big blind) showed [Ac Kh] and won (3840) with high card Ace
Seat 6: SteveD36 folded before Flop (didn't bet)
Seat 7: Bulldogg12345 showed [Ks Ah] and won (3839) with high card Ace
Seat 8: jcarlos.vale folded before Flop (didn't bet)
Seat 9: jonojojello1998 folded before Flop (didn't bet)



PokerStars Hand #221735510434: Tournament #3079057742, $0.98+$0.12 USD Hold'em No Limit - Level IX (100/200) - 2020/12/23 0:06:34 EET [2020/12/22 17:06:34 ET]
Table '3079057742 3' 9-max Seat #4 is the button
Seat 1: konex (11260 in chips) 
Seat 2: spy4711 (3145 in chips) 
Seat 3: kyriasavv21 (11787 in chips) is sitting out
Seat 4: [ro]hoi (5060 in chips) 
Seat 5: $kiLLme1sTeR (3840 in chips) 
Seat 6: SteveD36 (2866 in chips) 
Seat 7: Bulldogg12345 (10283 in chips) 
Seat 8: jcarlos.vale (11662 in chips) 
Seat 9: jonojojello1998 (6061 in chips) 
konex: posts the ante 25
spy4711: posts the ante 25
kyriasavv21: posts the ante 25
[ro]hoi: posts the ante 25
$kiLLme1sTeR: posts the ante 25
SteveD36: posts the ante 25
Bulldogg12345: posts the ante 25
jcarlos.vale: posts the ante 25
jonojojello1998: posts the ante 25
$kiLLme1sTeR: posts small blind 100
SteveD36: posts big blind 200
*** HOLE CARDS ***
Dealt to jcarlos.vale [6s 7d]
Bulldogg12345: folds 
jcarlos.vale: folds 
jonojojello1998: folds 
konex: folds 
spy4711: calls 200
kyriasavv21: folds 
[ro]hoi: calls 200
$kiLLme1sTeR: calls 100
SteveD36: checks 
*** FLOP *** [Kh 7c 2d]
$kiLLme1sTeR: checks 
SteveD36: checks 
spy4711: checks 
[ro]hoi: checks 
*** TURN *** [Kh 7c 2d] [7h]
$kiLLme1sTeR: bets 707
SteveD36: folds 
spy4711: folds 
[ro]hoi: folds 
Uncalled bet (707) returned to $kiLLme1sTeR
$kiLLme1sTeR collected 1025 from pot
*** SUMMARY ***
Total pot 1025 | Rake 0 
Board [Kh 7c 2d 7h]
Seat 1: konex folded before Flop (didn't bet)
Seat 2: spy4711 folded on the Turn
Seat 3: kyriasavv21 folded before Flop (didn't bet)
Seat 4: [ro]hoi (button) folded on the Turn
Seat 5: $kiLLme1sTeR (small blind) collected (1025)
Seat 6: SteveD36 (big blind) folded on the Turn
Seat 7: Bulldogg12345 folded before Flop (didn't bet)
Seat 8: jcarlos.vale folded before Flop (didn't bet)
Seat 9: jonojojello1998 folded before Flop (didn't bet)



PokerStars Hand #221735551822: Tournament #3079057742, $0.98+$0.12 USD Hold'em No Limit - Level IX (100/200) - 2020/12/23 0:07:35 EET [2020/12/22 17:07:35 ET]
Table '3079057742 3' 9-max Seat #5 is the button
Seat 1: konex (11235 in chips) 
Seat 2: spy4711 (2920 in chips) 
Seat 3: kyriasavv21 (11762 in chips) is sitting out
Seat 4: [ro]hoi (4835 in chips) 
Seat 5: $kiLLme1sTeR (4640 in chips) 
Seat 6: SteveD36 (2641 in chips) 
Seat 7: Bulldogg12345 (10258 in chips) 
Seat 8: jcarlos.vale (11637 in chips) 
Seat 9: jonojojello1998 (6036 in chips) 
konex: posts the ante 25
spy4711: posts the ante 25
kyriasavv21: posts the ante 25
[ro]hoi: posts the ante 25
$kiLLme1sTeR: posts the ante 25
SteveD36: posts the ante 25
Bulldogg12345: posts the ante 25
jcarlos.vale: posts the ante 25
jonojojello1998: posts the ante 25
SteveD36: posts small blind 100
Bulldogg12345: posts big blind 200
*** HOLE CARDS ***
Dealt to jcarlos.vale [Jc 6c]
jcarlos.vale: folds 
jonojojello1998: folds 
konex: calls 200
spy4711: folds 
kyriasavv21: folds 
[ro]hoi: raises 200 to 400
$kiLLme1sTeR: raises 4215 to 4615 and is all-in
SteveD36: folds 
Bulldogg12345: folds 
konex: folds 
[ro]hoi: folds 
Uncalled bet (4215) returned to $kiLLme1sTeR
$kiLLme1sTeR collected 1525 from pot
*** SUMMARY ***
Total pot 1525 | Rake 0 
Seat 1: konex folded before Flop
Seat 2: spy4711 folded before Flop (didn't bet)
Seat 3: kyriasavv21 folded before Flop (didn't bet)
Seat 4: [ro]hoi folded before Flop
Seat 5: $kiLLme1sTeR (button) collected (1525)
Seat 6: SteveD36 (small blind) folded before Flop
Seat 7: Bulldogg12345 (big blind) folded before Flop
Seat 8: jcarlos.vale folded before Flop (didn't bet)
Seat 9: jonojojello1998 folded before Flop (didn't bet)



PokerStars Hand #221735587724: Tournament #3079057742, $0.98+$0.12 USD Hold'em No Limit - Level IX (100/200) - 2020/12/23 0:08:28 EET [2020/12/22 17:08:28 ET]
Table '3079057742 3' 9-max Seat #6 is the button
Seat 1: konex (11010 in chips) 
Seat 2: spy4711 (2895 in chips) 
Seat 3: kyriasavv21 (11737 in chips) is sitting out
Seat 4: [ro]hoi (4410 in chips) 
Seat 5: $kiLLme1sTeR (5740 in chips) 
Seat 6: SteveD36 (2516 in chips) 
Seat 7: Bulldogg12345 (10033 in chips) 
Seat 8: jcarlos.vale (11612 in chips) 
Seat 9: jonojojello1998 (6011 in chips) 
konex: posts the ante 25
spy4711: posts the ante 25
kyriasavv21: posts the ante 25
[ro]hoi: posts the ante 25
$kiLLme1sTeR: posts the ante 25
SteveD36: posts the ante 25
Bulldogg12345: posts the ante 25
jcarlos.vale: posts the ante 25
jonojojello1998: posts the ante 25
Bulldogg12345: posts small blind 100
jcarlos.vale: posts big blind 200
*** HOLE CARDS ***
Dealt to jcarlos.vale [2c 7h]
jonojojello1998: calls 200
konex: folds 
spy4711: calls 200
kyriasavv21: folds 
[ro]hoi: folds 
$kiLLme1sTeR: raises 376 to 576
SteveD36: folds 
Bulldogg12345: calls 476
jcarlos.vale: folds 
jonojojello1998: calls 376
spy4711: calls 376
*** FLOP *** [4c Th Qh]
Bulldogg12345: bets 600
jonojojello1998: folds 
spy4711: folds 
$kiLLme1sTeR: raises 1847 to 2447
Bulldogg12345: folds 
Uncalled bet (1847) returned to $kiLLme1sTeR
$kiLLme1sTeR collected 3929 from pot
*** SUMMARY ***
Total pot 3929 | Rake 0 
Board [4c Th Qh]
Seat 1: konex folded before Flop (didn't bet)
Seat 2: spy4711 folded on the Flop
Seat 3: kyriasavv21 folded before Flop (didn't bet)
Seat 4: [ro]hoi folded before Flop (didn't bet)
Seat 5: $kiLLme1sTeR collected (3929)
Seat 6: SteveD36 (button) folded before Flop (didn't bet)
Seat 7: Bulldogg12345 (small blind) folded on the Flop
Seat 8: jcarlos.vale (big blind) folded before Flop
Seat 9: jonojojello1998 folded on the Flop



PokerStars Hand #221735619792: Tournament #3079057742, $0.98+$0.12 USD Hold'em No Limit - Level IX (100/200) - 2020/12/23 0:09:15 EET [2020/12/22 17:09:15 ET]
Table '3079057742 3' 9-max Seat #7 is the button
Seat 1: konex (10985 in chips) 
Seat 2: spy4711 (2294 in chips) 
Seat 3: kyriasavv21 (11712 in chips) is sitting out
Seat 4: [ro]hoi (4385 in chips) 
Seat 5: $kiLLme1sTeR (8468 in chips) 
Seat 6: SteveD36 (2491 in chips) 
Seat 7: Bulldogg12345 (8832 in chips) 
Seat 8: jcarlos.vale (11387 in chips) 
Seat 9: jonojojello1998 (5410 in chips) 
konex: posts the ante 25
spy4711: posts the ante 25
kyriasavv21: posts the ante 25
[ro]hoi: posts the ante 25
$kiLLme1sTeR: posts the ante 25
SteveD36: posts the ante 25
Bulldogg12345: posts the ante 25
jcarlos.vale: posts the ante 25
jonojojello1998: posts the ante 25
jcarlos.vale: posts small blind 100
jonojojello1998: posts big blind 200
*** HOLE CARDS ***
Dealt to jcarlos.vale [9s Ad]
konex: folds 
spy4711: folds 
kyriasavv21: folds 
[ro]hoi: raises 200 to 400
$kiLLme1sTeR: folds 
SteveD36: folds 
Bulldogg12345: raises 400 to 800
jcarlos.vale: folds 
jonojojello1998: folds 
[ro]hoi: calls 400
*** FLOP *** [Js Qc Kd]
[ro]hoi: checks 
Bulldogg12345: bets 8007 and is all-in
[ro]hoi: calls 3560 and is all-in
Uncalled bet (4447) returned to Bulldogg12345
*** TURN *** [Js Qc Kd] [9d]
*** RIVER *** [Js Qc Kd 9d] [7d]
*** SHOW DOWN ***
[ro]hoi: shows [As 9h] (a pair of Nines)
Bulldogg12345: shows [Kc Ks] (three of a kind, Kings)
Bulldogg12345 collected 9245 from pot
[ro]hoi finished the tournament in 343rd place
*** SUMMARY ***
Total pot 9245 | Rake 0 
Board [Js Qc Kd 9d 7d]
Seat 1: konex folded before Flop (didn't bet)
Seat 2: spy4711 folded before Flop (didn't bet)
Seat 3: kyriasavv21 folded before Flop (didn't bet)
Seat 4: [ro]hoi showed [As 9h] and lost with a pair of Nines
Seat 5: $kiLLme1sTeR folded before Flop (didn't bet)
Seat 6: SteveD36 folded before Flop (didn't bet)
Seat 7: Bulldogg12345 (button) showed [Kc Ks] and won (9245) with three of a kind, Kings
Seat 8: jcarlos.vale (small blind) folded before Flop
Seat 9: jonojojello1998 (big blind) folded before Flop



PokerStars Hand #221735665728: Tournament #3079057742, $0.98+$0.12 USD Hold'em No Limit - Level IX (100/200) - 2020/12/23 0:10:23 EET [2020/12/22 17:10:23 ET]
Table '3079057742 38' 9-max Seat #5 is the button
Seat 1: KattyOnFire (9690 in chips) 
Seat 2: 66demon99 (9272 in chips) 
Seat 3: Lucinha171 (7580 in chips) 
Seat 4: jcarlos.vale (11262 in chips) 
Seat 5: shah1955 (3885 in chips) 
Seat 6: Puzikov64 (7900 in chips) 
Seat 7: Leadon Method (5241 in chips) 
Seat 8: ssanchez86 (40866 in chips) 
Seat 9: passyonn5485 (7377 in chips) 
KattyOnFire: posts the ante 25
66demon99: posts the ante 25
Lucinha171: posts the ante 25
jcarlos.vale: posts the ante 25
shah1955: posts the ante 25
Puzikov64: posts the ante 25
Leadon Method: posts the ante 25
ssanchez86: posts the ante 25
passyonn5485: posts the ante 25
Puzikov64: posts small blind 100
Leadon Method: posts big blind 200
*** HOLE CARDS ***
Dealt to jcarlos.vale [Jc Ah]
ssanchez86: folds 
passyonn5485: raises 200 to 400
KattyOnFire: folds 
66demon99: folds 
Lucinha171: raises 200 to 600
jcarlos.vale: folds 
shah1955: folds 
Puzikov64: folds 
Leadon Method: folds 
passyonn5485: calls 200
*** FLOP *** [Jd 2h 3h]
passyonn5485: checks 
Lucinha171: bets 200
passyonn5485: calls 200
*** TURN *** [Jd 2h 3h] [4s]
passyonn5485: checks 
Lucinha171: bets 200
passyonn5485: calls 200
*** RIVER *** [Jd 2h 3h 4s] [Ad]
passyonn5485: checks 
Lucinha171: bets 200
passyonn5485: calls 200
*** SHOW DOWN ***
Lucinha171: shows [Kd Jh] (a pair of Jacks)
passyonn5485: mucks hand 
Lucinha171 collected 2925 from pot
*** SUMMARY ***
Total pot 2925 | Rake 0 
Board [Jd 2h 3h 4s Ad]
Seat 1: KattyOnFire folded before Flop (didn't bet)
Seat 2: 66demon99 folded before Flop (didn't bet)
Seat 3: Lucinha171 showed [Kd Jh] and won (2925) with a pair of Jacks
Seat 4: jcarlos.vale folded before Flop (didn't bet)
Seat 5: shah1955 (button) folded before Flop (didn't bet)
Seat 6: Puzikov64 (small blind) folded before Flop
Seat 7: Leadon Method (big blind) folded before Flop
Seat 8: ssanchez86 folded before Flop (didn't bet)
Seat 9: passyonn5485 mucked [Kc 6c]



PokerStars Hand #221735703771: Tournament #3079057742, $0.98+$0.12 USD Hold'em No Limit - Level IX (100/200) - 2020/12/23 0:11:20 EET [2020/12/22 17:11:20 ET]
Table '3079057742 38' 9-max Seat #6 is the button
Seat 1: KattyOnFire (9665 in chips) 
Seat 2: 66demon99 (9247 in chips) 
Seat 3: Lucinha171 (9280 in chips) 
Seat 4: jcarlos.vale (11237 in chips) 
Seat 5: shah1955 (3860 in chips) 
Seat 6: Puzikov64 (7775 in chips) 
Seat 7: Leadon Method (5016 in chips) 
Seat 8: ssanchez86 (40841 in chips) 
Seat 9: passyonn5485 (6152 in chips) 
KattyOnFire: posts the ante 25
66demon99: posts the ante 25
Lucinha171: posts the ante 25
jcarlos.vale: posts the ante 25
shah1955: posts the ante 25
Puzikov64: posts the ante 25
Leadon Method: posts the ante 25
ssanchez86: posts the ante 25
passyonn5485: posts the ante 25
Leadon Method: posts small blind 100
ssanchez86: posts big blind 200
*** HOLE CARDS ***
Dealt to jcarlos.vale [Ah 4h]
passyonn5485: folds 
KattyOnFire: folds 
66demon99: folds 
passyonn5485 is sitting out
Lucinha171: calls 200
jcarlos.vale: folds 
shah1955: folds 
Puzikov64: folds 
Leadon Method: raises 200 to 400
ssanchez86: calls 200
Lucinha171: calls 200
*** FLOP *** [Jh 3s Qs]
Leadon Method: bets 713
ssanchez86: calls 713
Lucinha171: calls 713
*** TURN *** [Jh 3s Qs] [4d]
passyonn5485 has returned
Leadon Method: checks 
ssanchez86: bets 1069
Lucinha171: calls 1069
Leadon Method: folds 
*** RIVER *** [Jh 3s Qs 4d] [9h]
ssanchez86: checks 
Lucinha171: checks 
*** SHOW DOWN ***
ssanchez86: shows [Tc 9c] (a pair of Nines)
Lucinha171: shows [Qd 7d] (a pair of Queens)
Lucinha171 collected 5702 from pot
*** SUMMARY ***
Total pot 5702 | Rake 0 
Board [Jh 3s Qs 4d 9h]
Seat 1: KattyOnFire folded before Flop (didn't bet)
Seat 2: 66demon99 folded before Flop (didn't bet)
Seat 3: Lucinha171 showed [Qd 7d] and won (5702) with a pair of Queens
Seat 4: jcarlos.vale folded before Flop (didn't bet)
Seat 5: shah1955 folded before Flop (didn't bet)
Seat 6: Puzikov64 (button) folded before Flop (didn't bet)
Seat 7: Leadon Method (small blind) folded on the Turn
Seat 8: ssanchez86 (big blind) showed [Tc 9c] and lost with a pair of Nines
Seat 9: passyonn5485 folded before Flop (didn't bet)



PokerStars Hand #221735769692: Tournament #3079057742, $0.98+$0.12 USD Hold'em No Limit - Level IX (100/200) - 2020/12/23 0:12:58 EET [2020/12/22 17:12:58 ET]
Table '3079057742 38' 9-max Seat #7 is the button
Seat 1: KattyOnFire (9640 in chips) 
Seat 2: 66demon99 (9222 in chips) 
Seat 3: Lucinha171 (12775 in chips) 
Seat 4: jcarlos.vale (11212 in chips) 
Seat 5: shah1955 (3835 in chips) 
Seat 6: Puzikov64 (7750 in chips) 
Seat 7: Leadon Method (3878 in chips) 
Seat 8: ssanchez86 (38634 in chips) 
Seat 9: passyonn5485 (6127 in chips) 
KattyOnFire: posts the ante 25
66demon99: posts the ante 25
Lucinha171: posts the ante 25
jcarlos.vale: posts the ante 25
shah1955: posts the ante 25
Puzikov64: posts the ante 25
Leadon Method: posts the ante 25
ssanchez86: posts the ante 25
passyonn5485: posts the ante 25
ssanchez86: posts small blind 100
passyonn5485: posts big blind 200
*** HOLE CARDS ***
Dealt to jcarlos.vale [6s Ac]
KattyOnFire: folds 
66demon99: folds 
Lucinha171: calls 200
jcarlos.vale: folds 
shah1955: calls 200
Puzikov64 has timed out
Puzikov64: folds 
Puzikov64 is sitting out
Leadon Method: folds 
ssanchez86: folds 
passyonn5485: checks 
*** FLOP *** [6h Kc Kd]
passyonn5485: checks 
Lucinha171: checks 
Puzikov64 has returned
shah1955: checks 
*** TURN *** [6h Kc Kd] [Ad]
passyonn5485: checks 
Lucinha171: checks 
shah1955: checks 
*** RIVER *** [6h Kc Kd Ad] [5d]
passyonn5485: checks 
Lucinha171: checks 
shah1955: checks 
*** SHOW DOWN ***
passyonn5485: shows [Qd 5s] (two pair, Kings and Fives)
Lucinha171: mucks hand 
shah1955: mucks hand 
passyonn5485 collected 925 from pot
*** SUMMARY ***
Total pot 925 | Rake 0 
Board [6h Kc Kd Ad 5d]
Seat 1: KattyOnFire folded before Flop (didn't bet)
Seat 2: 66demon99 folded before Flop (didn't bet)
Seat 3: Lucinha171 mucked [Ts 8s]
Seat 4: jcarlos.vale folded before Flop (didn't bet)
Seat 5: shah1955 mucked [8h 9h]
Seat 6: Puzikov64 folded before Flop (didn't bet)
Seat 7: Leadon Method (button) folded before Flop (didn't bet)
Seat 8: ssanchez86 (small blind) folded before Flop
Seat 9: passyonn5485 (big blind) showed [Qd 5s] and won (925) with two pair, Kings and Fives



PokerStars Hand #221735838314: Tournament #3079057742, $0.98+$0.12 USD Hold'em No Limit - Level X (125/250) - 2020/12/23 0:14:40 EET [2020/12/22 17:14:40 ET]
Table '3079057742 38' 9-max Seat #8 is the button
Seat 1: KattyOnFire (9615 in chips) 
Seat 2: 66demon99 (9197 in chips) 
Seat 3: Lucinha171 (12550 in chips) 
Seat 4: jcarlos.vale (11187 in chips) 
Seat 5: shah1955 (3610 in chips) 
Seat 6: Puzikov64 (7725 in chips) 
Seat 7: Leadon Method (3853 in chips) 
Seat 8: ssanchez86 (38509 in chips) 
Seat 9: passyonn5485 (6827 in chips) 
KattyOnFire: posts the ante 30
66demon99: posts the ante 30
Lucinha171: posts the ante 30
jcarlos.vale: posts the ante 30
shah1955: posts the ante 30
Puzikov64: posts the ante 30
Leadon Method: posts the ante 30
ssanchez86: posts the ante 30
passyonn5485: posts the ante 30
passyonn5485: posts small blind 125
KattyOnFire: posts big blind 250
*** HOLE CARDS ***
Dealt to jcarlos.vale [3d 7d]
66demon99: raises 250 to 500
Lucinha171: folds 
jcarlos.vale: folds 
shah1955: folds 
Puzikov64: folds 
Leadon Method: calls 500
ssanchez86: calls 500
passyonn5485: calls 375
KattyOnFire: calls 250
*** FLOP *** [Ks 6d 5c]
passyonn5485: checks 
KattyOnFire: bets 2770
66demon99: folds 
Leadon Method: folds 
ssanchez86: folds 
passyonn5485: folds 
Uncalled bet (2770) returned to KattyOnFire
KattyOnFire collected 2770 from pot
*** SUMMARY ***
Total pot 2770 | Rake 0 
Board [Ks 6d 5c]
Seat 1: KattyOnFire (big blind) collected (2770)
Seat 2: 66demon99 folded on the Flop
Seat 3: Lucinha171 folded before Flop (didn't bet)
Seat 4: jcarlos.vale folded before Flop (didn't bet)
Seat 5: shah1955 folded before Flop (didn't bet)
Seat 6: Puzikov64 folded before Flop (didn't bet)
Seat 7: Leadon Method folded on the Flop
Seat 8: ssanchez86 (button) folded on the Flop
Seat 9: passyonn5485 (small blind) folded on the Flop



PokerStars Hand #221735866978: Tournament #3079057742, $0.98+$0.12 USD Hold'em No Limit - Level X (125/250) - 2020/12/23 0:15:22 EET [2020/12/22 17:15:22 ET]
Table '3079057742 38' 9-max Seat #9 is the button
Seat 1: KattyOnFire (11855 in chips) 
Seat 2: 66demon99 (8667 in chips) 
Seat 3: Lucinha171 (12520 in chips) 
Seat 4: jcarlos.vale (11157 in chips) 
Seat 5: shah1955 (3580 in chips) 
Seat 6: Puzikov64 (7695 in chips) 
Seat 7: Leadon Method (3323 in chips) 
Seat 8: ssanchez86 (37979 in chips) 
Seat 9: passyonn5485 (6297 in chips) 
KattyOnFire: posts the ante 30
66demon99: posts the ante 30
Lucinha171: posts the ante 30
jcarlos.vale: posts the ante 30
shah1955: posts the ante 30
Puzikov64: posts the ante 30
Leadon Method: posts the ante 30
ssanchez86: posts the ante 30
passyonn5485: posts the ante 30
KattyOnFire: posts small blind 125
66demon99: posts big blind 250
*** HOLE CARDS ***
Dealt to jcarlos.vale [5d 9c]
Lucinha171: calls 250
jcarlos.vale: folds 
shah1955: calls 250
Puzikov64: folds 
Leadon Method: folds 
ssanchez86: folds 
passyonn5485: calls 250
KattyOnFire: calls 125
66demon99: checks 
*** FLOP *** [6h Tc Ts]
KattyOnFire: bets 760
66demon99: folds 
Lucinha171: raises 760 to 1520
shah1955 has timed out
shah1955: folds 
shah1955 is sitting out
passyonn5485: calls 1520
KattyOnFire: folds 
*** TURN *** [6h Tc Ts] [Kd]
Lucinha171: bets 250
passyonn5485: calls 250
*** RIVER *** [6h Tc Ts Kd] [7d]
Lucinha171: checks 
shah1955 has returned
passyonn5485: bets 2500
Lucinha171: raises 2500 to 5000
passyonn5485: calls 1747 and is all-in
Uncalled bet (753) returned to Lucinha171
*** SHOW DOWN ***
Lucinha171: shows [Th 5c] (three of a kind, Tens)
passyonn5485: shows [Td Ah] (three of a kind, Tens - Ace kicker)
passyonn5485 collected 14314 from pot
*** SUMMARY ***
Total pot 14314 | Rake 0 
Board [6h Tc Ts Kd 7d]
Seat 1: KattyOnFire (small blind) folded on the Flop
Seat 2: 66demon99 (big blind) folded on the Flop
Seat 3: Lucinha171 showed [Th 5c] and lost with three of a kind, Tens
Seat 4: jcarlos.vale folded before Flop (didn't bet)
Seat 5: shah1955 folded on the Flop
Seat 6: Puzikov64 folded before Flop (didn't bet)
Seat 7: Leadon Method folded before Flop (didn't bet)
Seat 8: ssanchez86 folded before Flop (didn't bet)
Seat 9: passyonn5485 (button) showed [Td Ah] and won (14314) with three of a kind, Tens



PokerStars Hand #221735928089: Tournament #3079057742, $0.98+$0.12 USD Hold'em No Limit - Level X (125/250) - 2020/12/23 0:16:53 EET [2020/12/22 17:16:53 ET]
Table '3079057742 38' 9-max Seat #1 is the button
Seat 1: KattyOnFire (10815 in chips) 
Seat 2: 66demon99 (8387 in chips) 
Seat 3: Lucinha171 (6223 in chips) 
Seat 4: jcarlos.vale (11127 in chips) 
Seat 5: shah1955 (3300 in chips) 
Seat 6: Puzikov64 (7665 in chips) 
Seat 7: Leadon Method (3293 in chips) 
Seat 8: ssanchez86 (37949 in chips) 
Seat 9: passyonn5485 (14314 in chips) 
KattyOnFire: posts the ante 30
66demon99: posts the ante 30
Lucinha171: posts the ante 30
jcarlos.vale: posts the ante 30
shah1955: posts the ante 30
Puzikov64: posts the ante 30
Leadon Method: posts the ante 30
ssanchez86: posts the ante 30
passyonn5485: posts the ante 30
66demon99: posts small blind 125
Lucinha171: posts big blind 250
*** HOLE CARDS ***
Dealt to jcarlos.vale [8c 4c]
jcarlos.vale: folds 
shah1955: folds 
Puzikov64 has timed out
Puzikov64: folds 
Puzikov64 is sitting out
Leadon Method: folds 
ssanchez86: raises 250 to 500
Puzikov64 has returned
passyonn5485: folds 
KattyOnFire: calls 500
66demon99: folds 
Lucinha171: calls 250
*** FLOP *** [Tc 3d 6d]
Lucinha171: checks 
ssanchez86: bets 948
KattyOnFire: folds 
Lucinha171: folds 
Uncalled bet (948) returned to ssanchez86
ssanchez86 collected 1895 from pot
ssanchez86: doesn't show hand 
*** SUMMARY ***
Total pot 1895 | Rake 0 
Board [Tc 3d 6d]
Seat 1: KattyOnFire (button) folded on the Flop
Seat 2: 66demon99 (small blind) folded before Flop
Seat 3: Lucinha171 (big blind) folded on the Flop
Seat 4: jcarlos.vale folded before Flop (didn't bet)
Seat 5: shah1955 folded before Flop (didn't bet)
Seat 6: Puzikov64 folded before Flop (didn't bet)
Seat 7: Leadon Method folded before Flop (didn't bet)
Seat 8: ssanchez86 collected (1895)
Seat 9: passyonn5485 folded before Flop (didn't bet)



PokerStars Hand #221735984947: Tournament #3079057742, $0.98+$0.12 USD Hold'em No Limit - Level X (125/250) - 2020/12/23 0:18:19 EET [2020/12/22 17:18:19 ET]
Table '3079057742 38' 9-max Seat #2 is the button
Seat 1: KattyOnFire (10285 in chips) 
Seat 2: 66demon99 (8232 in chips) 
Seat 3: Lucinha171 (5693 in chips) 
Seat 4: jcarlos.vale (11097 in chips) 
Seat 5: shah1955 (3270 in chips) 
Seat 6: Puzikov64 (7635 in chips) 
Seat 7: Leadon Method (3263 in chips) 
Seat 8: ssanchez86 (39314 in chips) 
Seat 9: passyonn5485 (14284 in chips) 
KattyOnFire: posts the ante 30
66demon99: posts the ante 30
Lucinha171: posts the ante 30
jcarlos.vale: posts the ante 30
shah1955: posts the ante 30
Puzikov64: posts the ante 30
Leadon Method: posts the ante 30
ssanchez86: posts the ante 30
passyonn5485: posts the ante 30
Lucinha171: posts small blind 125
jcarlos.vale: posts big blind 250
*** HOLE CARDS ***
Dealt to jcarlos.vale [5d Js]
shah1955: calls 250
Puzikov64: calls 250
Leadon Method: folds 
ssanchez86: folds 
passyonn5485: folds 
KattyOnFire: calls 250
66demon99: folds 
Lucinha171: calls 125
jcarlos.vale: checks 
*** FLOP *** [Ah 4c 6d]
Lucinha171: checks 
jcarlos.vale: checks 
shah1955: checks 
Puzikov64: bets 250
KattyOnFire: calls 250
Lucinha171: calls 250
jcarlos.vale: folds 
shah1955: folds 
*** TURN *** [Ah 4c 6d] [9c]
Lucinha171: checks 
Puzikov64: bets 250
KattyOnFire: calls 250
Lucinha171: calls 250
*** RIVER *** [Ah 4c 6d 9c] [Th]
Lucinha171: bets 250
Puzikov64: calls 250
KattyOnFire: folds 
*** SHOW DOWN ***
Lucinha171: shows [9s Ts] (two pair, Tens and Nines)
Puzikov64: mucks hand 
Lucinha171 collected 3520 from pot
*** SUMMARY ***
Total pot 3520 | Rake 0 
Board [Ah 4c 6d 9c Th]
Seat 1: KattyOnFire folded on the River
Seat 2: 66demon99 (button) folded before Flop (didn't bet)
Seat 3: Lucinha171 (small blind) showed [9s Ts] and won (3520) with two pair, Tens and Nines
Seat 4: jcarlos.vale (big blind) folded on the Flop
Seat 5: shah1955 folded on the Flop
Seat 6: Puzikov64 mucked [Ac 8s]
Seat 7: Leadon Method folded before Flop (didn't bet)
Seat 8: ssanchez86 folded before Flop (didn't bet)
Seat 9: passyonn5485 folded before Flop (didn't bet)



PokerStars Hand #221736033723: Tournament #3079057742, $0.98+$0.12 USD Hold'em No Limit - Level X (125/250) - 2020/12/23 0:19:32 EET [2020/12/22 17:19:32 ET]
Table '3079057742 38' 9-max Seat #3 is the button
Seat 1: KattyOnFire (9505 in chips) 
Seat 2: 66demon99 (8202 in chips) 
Seat 3: Lucinha171 (8183 in chips) 
Seat 4: jcarlos.vale (10817 in chips) 
Seat 5: shah1955 (2990 in chips) 
Seat 6: Puzikov64 (6605 in chips) 
Seat 7: Leadon Method (3233 in chips) 
Seat 8: ssanchez86 (39284 in chips) 
Seat 9: passyonn5485 (14254 in chips) 
KattyOnFire: posts the ante 30
66demon99: posts the ante 30
Lucinha171: posts the ante 30
jcarlos.vale: posts the ante 30
shah1955: posts the ante 30
Puzikov64: posts the ante 30
Leadon Method: posts the ante 30
ssanchez86: posts the ante 30
passyonn5485: posts the ante 30
jcarlos.vale: posts small blind 125
shah1955: posts big blind 250
*** HOLE CARDS ***
Dealt to jcarlos.vale [6c 6d]
Puzikov64: calls 250
Leadon Method: folds 
ssanchez86: folds 
passyonn5485: folds 
KattyOnFire: folds 
66demon99: folds 
Lucinha171: raises 250 to 500
jcarlos.vale: calls 375
shah1955: calls 250
Puzikov64: calls 250
*** FLOP *** [2h 5h Kc]
jcarlos.vale: bets 500
shah1955: folds 
Puzikov64: folds 
Lucinha171: calls 500
*** TURN *** [2h 5h Kc] [5c]
jcarlos.vale: bets 750
Lucinha171: calls 750
*** RIVER *** [2h 5h Kc 5c] [9h]
jcarlos.vale: bets 1000
Lucinha171: raises 1000 to 2000
jcarlos.vale: calls 1000
*** SHOW DOWN ***
Lucinha171: shows [7c Tc] (a pair of Fives)
jcarlos.vale: shows [6c 6d] (two pair, Sixes and Fives)
jcarlos.vale collected 8770 from pot
*** SUMMARY ***
Total pot 8770 | Rake 0 
Board [2h 5h Kc 5c 9h]
Seat 1: KattyOnFire folded before Flop (didn't bet)
Seat 2: 66demon99 folded before Flop (didn't bet)
Seat 3: Lucinha171 (button) showed [7c Tc] and lost with a pair of Fives
Seat 4: jcarlos.vale (small blind) showed [6c 6d] and won (8770) with two pair, Sixes and Fives
Seat 5: shah1955 (big blind) folded on the Flop
Seat 6: Puzikov64 folded on the Flop
Seat 7: Leadon Method folded before Flop (didn't bet)
Seat 8: ssanchez86 folded before Flop (didn't bet)
Seat 9: passyonn5485 folded before Flop (didn't bet)



PokerStars Hand #221736077703: Tournament #3079057742, $0.98+$0.12 USD Hold'em No Limit - Level X (125/250) - 2020/12/23 0:20:38 EET [2020/12/22 17:20:38 ET]
Table '3079057742 38' 9-max Seat #4 is the button
Seat 1: KattyOnFire (9475 in chips) 
Seat 2: 66demon99 (8172 in chips) 
Seat 3: Lucinha171 (4403 in chips) 
Seat 4: jcarlos.vale (15807 in chips) 
Seat 5: shah1955 (2460 in chips) 
Seat 6: Puzikov64 (6075 in chips) 
Seat 7: Leadon Method (3203 in chips) 
Seat 8: ssanchez86 (39254 in chips) 
Seat 9: passyonn5485 (14224 in chips) 
KattyOnFire: posts the ante 30
66demon99: posts the ante 30
Lucinha171: posts the ante 30
jcarlos.vale: posts the ante 30
shah1955: posts the ante 30
Puzikov64: posts the ante 30
Leadon Method: posts the ante 30
ssanchez86: posts the ante 30
passyonn5485: posts the ante 30
shah1955: posts small blind 125
Puzikov64: posts big blind 250
*** HOLE CARDS ***
Dealt to jcarlos.vale [Th 9h]
Leadon Method: folds 
ssanchez86: raises 250 to 500
passyonn5485: calls 500
KattyOnFire: folds 
66demon99: folds 
Lucinha171: folds 
jcarlos.vale: calls 500
shah1955: calls 375
Puzikov64: folds 
*** FLOP *** [5c 6s 3s]
shah1955: checks 
ssanchez86: bets 756
passyonn5485: calls 756
jcarlos.vale: folds 
shah1955: folds 
*** TURN *** [5c 6s 3s] [Ts]
ssanchez86: checks 
passyonn5485: checks 
*** RIVER *** [5c 6s 3s Ts] [Qc]
ssanchez86: bets 4032
passyonn5485: calls 4032
*** SHOW DOWN ***
ssanchez86: shows [4s As] (a flush, Ace high)
passyonn5485: mucks hand 
ssanchez86 collected 12096 from pot
*** SUMMARY ***
Total pot 12096 | Rake 0 
Board [5c 6s 3s Ts Qc]
Seat 1: KattyOnFire folded before Flop (didn't bet)
Seat 2: 66demon99 folded before Flop (didn't bet)
Seat 3: Lucinha171 folded before Flop (didn't bet)
Seat 4: jcarlos.vale (button) folded on the Flop
Seat 5: shah1955 (small blind) folded on the Flop
Seat 6: Puzikov64 (big blind) folded before Flop
Seat 7: Leadon Method folded before Flop (didn't bet)
Seat 8: ssanchez86 showed [4s As] and won (12096) with a flush, Ace high
Seat 9: passyonn5485 mucked [Jc Qs]



PokerStars Hand #221736113871: Tournament #3079057742, $0.98+$0.12 USD Hold'em No Limit - Level X (125/250) - 2020/12/23 0:21:32 EET [2020/12/22 17:21:32 ET]
Table '3079057742 38' 9-max Seat #5 is the button
Seat 1: KattyOnFire (9445 in chips) 
Seat 2: 66demon99 (8142 in chips) 
Seat 3: Lucinha171 (4373 in chips) 
Seat 4: jcarlos.vale (15277 in chips) 
Seat 5: shah1955 (1930 in chips) 
Seat 6: Puzikov64 (5795 in chips) 
Seat 7: Leadon Method (3173 in chips) 
Seat 8: ssanchez86 (46032 in chips) 
Seat 9: passyonn5485 (8906 in chips) 
KattyOnFire: posts the ante 30
66demon99: posts the ante 30
Lucinha171: posts the ante 30
jcarlos.vale: posts the ante 30
shah1955: posts the ante 30
Puzikov64: posts the ante 30
Leadon Method: posts the ante 30
ssanchez86: posts the ante 30
passyonn5485: posts the ante 30
Puzikov64: posts small blind 125
Leadon Method: posts big blind 250
*** HOLE CARDS ***
Dealt to jcarlos.vale [5d 8s]
ssanchez86: calls 250
passyonn5485: folds 
KattyOnFire: calls 250
66demon99: folds 
Lucinha171: calls 250
jcarlos.vale: folds 
shah1955: folds 
Puzikov64: calls 125
Leadon Method: checks 
*** FLOP *** [8d 6h Js]
Puzikov64: checks 
Leadon Method: checks 
ssanchez86: bets 250
KattyOnFire: calls 250
Lucinha171: calls 250
Puzikov64: calls 250
Leadon Method: folds 
*** TURN *** [8d 6h Js] [Jh]
Puzikov64: checks 
ssanchez86: checks 
KattyOnFire: checks 
Lucinha171: checks 
*** RIVER *** [8d 6h Js Jh] [2d]
Puzikov64: bets 500
ssanchez86: calls 500
KattyOnFire: folds 
Lucinha171: folds 
*** SHOW DOWN ***
Puzikov64: shows [2h 8h] (two pair, Jacks and Eights)
ssanchez86: mucks hand 
Puzikov64 collected 3520 from pot
*** SUMMARY ***
Total pot 3520 | Rake 0 
Board [8d 6h Js Jh 2d]
Seat 1: KattyOnFire folded on the River
Seat 2: 66demon99 folded before Flop (didn't bet)
Seat 3: Lucinha171 folded on the River
Seat 4: jcarlos.vale folded before Flop (didn't bet)
Seat 5: shah1955 (button) folded before Flop (didn't bet)
Seat 6: Puzikov64 (small blind) showed [2h 8h] and won (3520) with two pair, Jacks and Eights
Seat 7: Leadon Method (big blind) folded on the Flop
Seat 8: ssanchez86 mucked [6s As]
Seat 9: passyonn5485 folded before Flop (didn't bet)



PokerStars Hand #221736174928: Tournament #3079057742, $0.98+$0.12 USD Hold'em No Limit - Level X (125/250) - 2020/12/23 0:22:55 EET [2020/12/22 17:22:55 ET]
Table '3079057742 38' 9-max Seat #6 is the button
Seat 1: KattyOnFire (8915 in chips) 
Seat 2: 66demon99 (8112 in chips) 
Seat 3: Lucinha171 (3843 in chips) 
Seat 4: jcarlos.vale (15247 in chips) 
Seat 5: shah1955 (1900 in chips) 
Seat 6: Puzikov64 (8285 in chips) 
Seat 7: Leadon Method (2893 in chips) 
Seat 8: ssanchez86 (45002 in chips) 
Seat 9: passyonn5485 (8876 in chips) 
KattyOnFire: posts the ante 30
66demon99: posts the ante 30
Lucinha171: posts the ante 30
jcarlos.vale: posts the ante 30
shah1955: posts the ante 30
Puzikov64: posts the ante 30
Leadon Method: posts the ante 30
ssanchez86: posts the ante 30
passyonn5485: posts the ante 30
Leadon Method: posts small blind 125
ssanchez86: posts big blind 250
*** HOLE CARDS ***
Dealt to jcarlos.vale [3s 6s]
passyonn5485: folds 
KattyOnFire: calls 250
66demon99: folds 
Lucinha171: folds 
jcarlos.vale: folds 
shah1955: folds 
Puzikov64: calls 250
Leadon Method: raises 2613 to 2863 and is all-in
ssanchez86: calls 2613
KattyOnFire: folds 
Puzikov64: folds 
*** FLOP *** [3h 7s Td]
*** TURN *** [3h 7s Td] [4d]
*** RIVER *** [3h 7s Td 4d] [8h]
*** SHOW DOWN ***
Leadon Method: shows [9c Ah] (high card Ace)
ssanchez86: shows [Jc Ad] (high card Ace - Jack kicker)
ssanchez86 collected 6496 from pot
Leadon Method finished the tournament in 271st place
*** SUMMARY ***
Total pot 6496 | Rake 0 
Board [3h 7s Td 4d 8h]
Seat 1: KattyOnFire folded before Flop
Seat 2: 66demon99 folded before Flop (didn't bet)
Seat 3: Lucinha171 folded before Flop (didn't bet)
Seat 4: jcarlos.vale folded before Flop (didn't bet)
Seat 5: shah1955 folded before Flop (didn't bet)
Seat 6: Puzikov64 (button) folded before Flop
Seat 7: Leadon Method (small blind) showed [9c Ah] and lost with high card Ace
Seat 8: ssanchez86 (big blind) showed [Jc Ad] and won (6496) with high card Ace
Seat 9: passyonn5485 folded before Flop (didn't bet)



PokerStars Hand #221736220785: Tournament #3079057742, $0.98+$0.12 USD Hold'em No Limit - Level XI (150/300) - 2020/12/23 0:24:05 EET [2020/12/22 17:24:05 ET]
Table '3079057742 50' 9-max Seat #9 is the button
Seat 1: Lucas0258 (28916 in chips) 
Seat 2: angus5 (9957 in chips) 
Seat 3: MathiasFer (4772 in chips) is sitting out
Seat 4: pedrostjr (11122 in chips) 
Seat 5: jcarlos.vale (15217 in chips) 
Seat 6: Praevus (3882 in chips) 
Seat 7: GosPanda (6887 in chips) 
Seat 9: LuvPeec (11366 in chips) 
Lucas0258: posts the ante 40
angus5: posts the ante 40
MathiasFer: posts the ante 40
pedrostjr: posts the ante 40
jcarlos.vale: posts the ante 40
Praevus: posts the ante 40
GosPanda: posts the ante 40
LuvPeec: posts the ante 40
Lucas0258: posts small blind 150
angus5: posts big blind 300
*** HOLE CARDS ***
Dealt to jcarlos.vale [Ks Jc]
MathiasFer: folds 
pedrostjr: folds 
jcarlos.vale: raises 480 to 780
Praevus: folds 
GosPanda: raises 1380 to 2160
LuvPeec: folds 
Lucas0258: folds 
angus5: folds 
jcarlos.vale: folds 
Uncalled bet (1380) returned to GosPanda
GosPanda collected 2330 from pot
GosPanda: doesn't show hand 
*** SUMMARY ***
Total pot 2330 | Rake 0 
Seat 1: Lucas0258 (small blind) folded before Flop
Seat 2: angus5 (big blind) folded before Flop
Seat 3: MathiasFer folded before Flop (didn't bet)
Seat 4: pedrostjr folded before Flop (didn't bet)
Seat 5: jcarlos.vale folded before Flop
Seat 6: Praevus folded before Flop (didn't bet)
Seat 7: GosPanda collected (2330)
Seat 9: LuvPeec (button) folded before Flop (didn't bet)



PokerStars Hand #221736241256: Tournament #3079057742, $0.98+$0.12 USD Hold'em No Limit - Level XI (150/300) - 2020/12/23 0:24:36 EET [2020/12/22 17:24:36 ET]
Table '3079057742 50' 9-max Seat #1 is the button
Seat 1: Lucas0258 (28726 in chips) 
Seat 2: angus5 (9617 in chips) 
Seat 3: MathiasFer (4732 in chips) is sitting out
Seat 4: pedrostjr (11082 in chips) 
Seat 5: jcarlos.vale (14397 in chips) 
Seat 6: Praevus (3842 in chips) 
Seat 7: GosPanda (8397 in chips) 
Seat 9: LuvPeec (11326 in chips) 
Lucas0258: posts the ante 40
angus5: posts the ante 40
MathiasFer: posts the ante 40
pedrostjr: posts the ante 40
jcarlos.vale: posts the ante 40
Praevus: posts the ante 40
GosPanda: posts the ante 40
LuvPeec: posts the ante 40
angus5: posts small blind 150
MathiasFer: posts big blind 300
*** HOLE CARDS ***
Dealt to jcarlos.vale [9d Kd]
pedrostjr: folds 
jcarlos.vale: folds 
Praevus: folds 
GosPanda: raises 300 to 600
LuvPeec: calls 600
Lucas0258: folds 
angus5: calls 450
MathiasFer: folds 
*** FLOP *** [6d 3d Jh]
angus5: checks 
GosPanda: bets 1646
LuvPeec: calls 1646
angus5: folds 
*** TURN *** [6d 3d Jh] [7d]
GosPanda: bets 450
LuvPeec: calls 450
*** RIVER *** [6d 3d Jh 7d] [Tc]
GosPanda: checks 
LuvPeec: bets 2645
GosPanda: calls 2645
*** SHOW DOWN ***
LuvPeec: shows [8s 8h] (a pair of Eights)
GosPanda: shows [7h 7c] (three of a kind, Sevens)
GosPanda collected 11902 from pot
*** SUMMARY ***
Total pot 11902 | Rake 0 
Board [6d 3d Jh 7d Tc]
Seat 1: Lucas0258 (button) folded before Flop (didn't bet)
Seat 2: angus5 (small blind) folded on the Flop
Seat 3: MathiasFer (big blind) folded before Flop
Seat 4: pedrostjr folded before Flop (didn't bet)
Seat 5: jcarlos.vale folded before Flop (didn't bet)
Seat 6: Praevus folded before Flop (didn't bet)
Seat 7: GosPanda showed [7h 7c] and won (11902) with three of a kind, Sevens
Seat 9: LuvPeec showed [8s 8h] and lost with a pair of Eights



PokerStars Hand #221736299519: Tournament #3079057742, $0.98+$0.12 USD Hold'em No Limit - Level XI (150/300) - 2020/12/23 0:26:01 EET [2020/12/22 17:26:01 ET]
Table '3079057742 50' 9-max Seat #2 is the button
Seat 1: Lucas0258 (28686 in chips) 
Seat 2: angus5 (8977 in chips) 
Seat 3: MathiasFer (4392 in chips) is sitting out
Seat 4: pedrostjr (11042 in chips) 
Seat 5: jcarlos.vale (14357 in chips) 
Seat 6: Praevus (3802 in chips) 
Seat 7: GosPanda (14918 in chips) 
Seat 8: zagaia011 (12545 in chips) 
Seat 9: LuvPeec (5945 in chips) 
Lucas0258: posts the ante 40
angus5: posts the ante 40
MathiasFer: posts the ante 40
pedrostjr: posts the ante 40
jcarlos.vale: posts the ante 40
Praevus: posts the ante 40
GosPanda: posts the ante 40
zagaia011: posts the ante 40
LuvPeec: posts the ante 40
MathiasFer: posts small blind 150
pedrostjr: posts big blind 300
*** HOLE CARDS ***
Dealt to jcarlos.vale [Qd 2s]
jcarlos.vale: folds 
Praevus: folds 
GosPanda: folds 
zagaia011: folds 
LuvPeec: raises 375 to 675
Lucas0258: folds 
angus5: folds 
MathiasFer: folds 
pedrostjr: folds 
Uncalled bet (375) returned to LuvPeec
LuvPeec collected 1110 from pot
LuvPeec: doesn't show hand 
*** SUMMARY ***
Total pot 1110 | Rake 0 
Seat 1: Lucas0258 folded before Flop (didn't bet)
Seat 2: angus5 (button) folded before Flop (didn't bet)
Seat 3: MathiasFer (small blind) folded before Flop
Seat 4: pedrostjr (big blind) folded before Flop
Seat 5: jcarlos.vale folded before Flop (didn't bet)
Seat 6: Praevus folded before Flop (didn't bet)
Seat 7: GosPanda folded before Flop (didn't bet)
Seat 8: zagaia011 folded before Flop (didn't bet)
Seat 9: LuvPeec collected (1110)



PokerStars Hand #221736312643: Tournament #3079057742, $0.98+$0.12 USD Hold'em No Limit - Level XI (150/300) - 2020/12/23 0:26:21 EET [2020/12/22 17:26:21 ET]
Table '3079057742 50' 9-max Seat #3 is the button
Seat 1: Lucas0258 (28646 in chips) 
Seat 2: angus5 (8937 in chips) 
Seat 3: MathiasFer (4202 in chips) is sitting out
Seat 4: pedrostjr (10702 in chips) 
Seat 5: jcarlos.vale (14317 in chips) 
Seat 6: Praevus (3762 in chips) 
Seat 7: GosPanda (14878 in chips) 
Seat 8: zagaia011 (12505 in chips) 
Seat 9: LuvPeec (6715 in chips) 
Lucas0258: posts the ante 40
angus5: posts the ante 40
MathiasFer: posts the ante 40
pedrostjr: posts the ante 40
jcarlos.vale: posts the ante 40
Praevus: posts the ante 40
GosPanda: posts the ante 40
zagaia011: posts the ante 40
LuvPeec: posts the ante 40
pedrostjr: posts small blind 150
jcarlos.vale: posts big blind 300
*** HOLE CARDS ***
Dealt to jcarlos.vale [Kc 6c]
Praevus: folds 
GosPanda: folds 
zagaia011: folds 
LuvPeec: folds 
Lucas0258: raises 327 to 627
angus5: folds 
MathiasFer: folds 
pedrostjr: folds 
jcarlos.vale: folds 
Uncalled bet (327) returned to Lucas0258
Lucas0258 collected 1110 from pot
Lucas0258: doesn't show hand 
*** SUMMARY ***
Total pot 1110 | Rake 0 
Seat 1: Lucas0258 collected (1110)
Seat 2: angus5 folded before Flop (didn't bet)
Seat 3: MathiasFer (button) folded before Flop (didn't bet)
Seat 4: pedrostjr (small blind) folded before Flop
Seat 5: jcarlos.vale (big blind) folded before Flop
Seat 6: Praevus folded before Flop (didn't bet)
Seat 7: GosPanda folded before Flop (didn't bet)
Seat 8: zagaia011 folded before Flop (didn't bet)
Seat 9: LuvPeec folded before Flop (didn't bet)



PokerStars Hand #221736330059: Tournament #3079057742, $0.98+$0.12 USD Hold'em No Limit - Level XI (150/300) - 2020/12/23 0:26:48 EET [2020/12/22 17:26:48 ET]
Table '3079057742 50' 9-max Seat #4 is the button
Seat 1: Lucas0258 (29416 in chips) 
Seat 2: angus5 (8897 in chips) 
Seat 3: MathiasFer (4162 in chips) is sitting out
Seat 4: pedrostjr (10512 in chips) 
Seat 5: jcarlos.vale (13977 in chips) 
Seat 6: Praevus (3722 in chips) 
Seat 7: GosPanda (14838 in chips) 
Seat 8: zagaia011 (12465 in chips) 
Seat 9: LuvPeec (6675 in chips) 
Lucas0258: posts the ante 40
angus5: posts the ante 40
MathiasFer: posts the ante 40
pedrostjr: posts the ante 40
jcarlos.vale: posts the ante 40
Praevus: posts the ante 40
GosPanda: posts the ante 40
zagaia011: posts the ante 40
LuvPeec: posts the ante 40
jcarlos.vale: posts small blind 150
Praevus: posts big blind 300
*** HOLE CARDS ***
Dealt to jcarlos.vale [4s Qh]
GosPanda: folds 
zagaia011: folds 
LuvPeec: folds 
Lucas0258: folds 
angus5: folds 
MathiasFer: folds 
pedrostjr: raises 366 to 666
jcarlos.vale: folds 
Praevus: raises 3016 to 3682 and is all-in
pedrostjr: folds 
Uncalled bet (3016) returned to Praevus
Praevus collected 1842 from pot
Praevus: doesn't show hand 
*** SUMMARY ***
Total pot 1842 | Rake 0 
Seat 1: Lucas0258 folded before Flop (didn't bet)
Seat 2: angus5 folded before Flop (didn't bet)
Seat 3: MathiasFer folded before Flop (didn't bet)
Seat 4: pedrostjr (button) folded before Flop
Seat 5: jcarlos.vale (small blind) folded before Flop
Seat 6: Praevus (big blind) collected (1842)
Seat 7: GosPanda folded before Flop (didn't bet)
Seat 8: zagaia011 folded before Flop (didn't bet)
Seat 9: LuvPeec folded before Flop (didn't bet)



PokerStars Hand #221736350943: Tournament #3079057742, $0.98+$0.12 USD Hold'em No Limit - Level XI (150/300) - 2020/12/23 0:27:20 EET [2020/12/22 17:27:20 ET]
Table '3079057742 50' 9-max Seat #5 is the button
Seat 1: Lucas0258 (29376 in chips) 
Seat 2: angus5 (8857 in chips) 
Seat 3: MathiasFer (4122 in chips) is sitting out
Seat 4: pedrostjr (9806 in chips) 
Seat 5: jcarlos.vale (13787 in chips) 
Seat 6: Praevus (4858 in chips) 
Seat 7: GosPanda (14798 in chips) 
Seat 8: zagaia011 (12425 in chips) 
Seat 9: LuvPeec (6635 in chips) 
Lucas0258: posts the ante 40
angus5: posts the ante 40
MathiasFer: posts the ante 40
pedrostjr: posts the ante 40
jcarlos.vale: posts the ante 40
Praevus: posts the ante 40
GosPanda: posts the ante 40
zagaia011: posts the ante 40
LuvPeec: posts the ante 40
Praevus: posts small blind 150
GosPanda: posts big blind 300
*** HOLE CARDS ***
Dealt to jcarlos.vale [Ac 4h]
zagaia011: folds 
LuvPeec: raises 375 to 675
Lucas0258: calls 675
angus5: folds 
MathiasFer: folds 
pedrostjr: folds 
jcarlos.vale: folds 
Praevus: folds 
GosPanda: calls 375
*** FLOP *** [Kd Kh 9c]
GosPanda: checks 
LuvPeec: checks 
Lucas0258: checks 
*** TURN *** [Kd Kh 9c] [Qd]
GosPanda: checks 
LuvPeec: bets 634
Lucas0258: calls 634
GosPanda: folds 
*** RIVER *** [Kd Kh 9c Qd] [Qh]
LuvPeec: checks 
Lucas0258: checks 
*** SHOW DOWN ***
LuvPeec: shows [7h 7s] (two pair, Kings and Queens)
Lucas0258: shows [Jd Qs] (a full house, Queens full of Kings)
Lucas0258 collected 3803 from pot
*** SUMMARY ***
Total pot 3803 | Rake 0 
Board [Kd Kh 9c Qd Qh]
Seat 1: Lucas0258 showed [Jd Qs] and won (3803) with a full house, Queens full of Kings
Seat 2: angus5 folded before Flop (didn't bet)
Seat 3: MathiasFer folded before Flop (didn't bet)
Seat 4: pedrostjr folded before Flop (didn't bet)
Seat 5: jcarlos.vale (button) folded before Flop (didn't bet)
Seat 6: Praevus (small blind) folded before Flop
Seat 7: GosPanda (big blind) folded on the Turn
Seat 8: zagaia011 folded before Flop (didn't bet)
Seat 9: LuvPeec showed [7h 7s] and lost with two pair, Kings and Queens



PokerStars Hand #221736399284: Tournament #3079057742, $0.98+$0.12 USD Hold'em No Limit - Level XI (150/300) - 2020/12/23 0:28:34 EET [2020/12/22 17:28:34 ET]
Table '3079057742 50' 9-max Seat #6 is the button
Seat 1: Lucas0258 (31830 in chips) 
Seat 2: angus5 (8817 in chips) 
Seat 3: MathiasFer (4082 in chips) is sitting out
Seat 4: pedrostjr (9766 in chips) 
Seat 5: jcarlos.vale (13747 in chips) 
Seat 6: Praevus (4668 in chips) 
Seat 7: GosPanda (14083 in chips) 
Seat 8: zagaia011 (12385 in chips) 
Seat 9: LuvPeec (5286 in chips) 
Lucas0258: posts the ante 40
angus5: posts the ante 40
MathiasFer: posts the ante 40
pedrostjr: posts the ante 40
jcarlos.vale: posts the ante 40
Praevus: posts the ante 40
GosPanda: posts the ante 40
zagaia011: posts the ante 40
LuvPeec: posts the ante 40
GosPanda: posts small blind 150
zagaia011: posts big blind 300
*** HOLE CARDS ***
Dealt to jcarlos.vale [Ah 4d]
LuvPeec: calls 300
Lucas0258: folds 
angus5: calls 300
MathiasFer: folds 
pedrostjr: folds 
jcarlos.vale: folds 
Praevus: folds 
GosPanda: calls 150
zagaia011: checks 
*** FLOP *** [5s As 4c]
GosPanda: checks 
zagaia011: checks 
LuvPeec: checks 
angus5: checks 
*** TURN *** [5s As 4c] [6c]
GosPanda: checks 
zagaia011: checks 
LuvPeec: checks 
angus5: checks 
*** RIVER *** [5s As 4c 6c] [5d]
GosPanda: checks 
zagaia011: checks 
LuvPeec: checks 
angus5: checks 
*** SHOW DOWN ***
GosPanda: shows [9d Kc] (a pair of Fives)
zagaia011: mucks hand 
LuvPeec: mucks hand 
angus5: mucks hand 
GosPanda collected 1560 from pot
*** SUMMARY ***
Total pot 1560 | Rake 0 
Board [5s As 4c 6c 5d]
Seat 1: Lucas0258 folded before Flop (didn't bet)
Seat 2: angus5 mucked [Qs Jh]
Seat 3: MathiasFer folded before Flop (didn't bet)
Seat 4: pedrostjr folded before Flop (didn't bet)
Seat 5: jcarlos.vale folded before Flop (didn't bet)
Seat 6: Praevus (button) folded before Flop (didn't bet)
Seat 7: GosPanda (small blind) showed [9d Kc] and won (1560) with a pair of Fives
Seat 8: zagaia011 (big blind) mucked [Qh 3d]
Seat 9: LuvPeec mucked [Ts Js]



PokerStars Hand #221736436258: Tournament #3079057742, $0.98+$0.12 USD Hold'em No Limit - Level XI (150/300) - 2020/12/23 0:29:32 EET [2020/12/22 17:29:32 ET]
Table '3079057742 50' 9-max Seat #7 is the button
Seat 1: Lucas0258 (31790 in chips) 
Seat 2: angus5 (8477 in chips) 
Seat 3: MathiasFer (4042 in chips) is sitting out
Seat 4: pedrostjr (9726 in chips) 
Seat 5: jcarlos.vale (13707 in chips) 
Seat 6: Praevus (4628 in chips) 
Seat 7: GosPanda (15303 in chips) 
Seat 8: zagaia011 (12045 in chips) 
Seat 9: LuvPeec (4946 in chips) 
Lucas0258: posts the ante 40
angus5: posts the ante 40
MathiasFer: posts the ante 40
pedrostjr: posts the ante 40
jcarlos.vale: posts the ante 40
Praevus: posts the ante 40
GosPanda: posts the ante 40
zagaia011: posts the ante 40
LuvPeec: posts the ante 40
zagaia011: posts small blind 150
LuvPeec: posts big blind 300
*** HOLE CARDS ***
Dealt to jcarlos.vale [3s Td]
Lucas0258: folds 
angus5: folds 
MathiasFer: folds 
pedrostjr: folds 
jcarlos.vale: folds 
Praevus: folds 
GosPanda: folds 
zagaia011: raises 300 to 600
LuvPeec: calls 300
*** FLOP *** [Ks 4s Jd]
zagaia011: bets 593
LuvPeec: folds 
Uncalled bet (593) returned to zagaia011
zagaia011 collected 1560 from pot
zagaia011: doesn't show hand 
*** SUMMARY ***
Total pot 1560 | Rake 0 
Board [Ks 4s Jd]
Seat 1: Lucas0258 folded before Flop (didn't bet)
Seat 2: angus5 folded before Flop (didn't bet)
Seat 3: MathiasFer folded before Flop (didn't bet)
Seat 4: pedrostjr folded before Flop (didn't bet)
Seat 5: jcarlos.vale folded before Flop (didn't bet)
Seat 6: Praevus folded before Flop (didn't bet)
Seat 7: GosPanda (button) folded before Flop (didn't bet)
Seat 8: zagaia011 (small blind) collected (1560)
Seat 9: LuvPeec (big blind) folded on the Flop



PokerStars Hand #221736462701: Tournament #3079057742, $0.98+$0.12 USD Hold'em No Limit - Level XI (150/300) - 2020/12/23 0:30:13 EET [2020/12/22 17:30:13 ET]
Table '3079057742 50' 9-max Seat #8 is the button
Seat 1: Lucas0258 (31750 in chips) 
Seat 2: angus5 (8437 in chips) 
Seat 3: MathiasFer (4002 in chips) is sitting out
Seat 4: pedrostjr (9686 in chips) 
Seat 5: jcarlos.vale (13667 in chips) 
Seat 6: Praevus (4588 in chips) 
Seat 7: GosPanda (15263 in chips) 
Seat 8: zagaia011 (12965 in chips) 
Seat 9: LuvPeec (4306 in chips) 
Lucas0258: posts the ante 40
angus5: posts the ante 40
MathiasFer: posts the ante 40
pedrostjr: posts the ante 40
jcarlos.vale: posts the ante 40
Praevus: posts the ante 40
GosPanda: posts the ante 40
zagaia011: posts the ante 40
LuvPeec: posts the ante 40
LuvPeec: posts small blind 150
Lucas0258: posts big blind 300
*** HOLE CARDS ***
Dealt to jcarlos.vale [9d Jd]
angus5: folds 
MathiasFer: folds 
pedrostjr: folds 
jcarlos.vale: raises 480 to 780
Praevus: folds 
GosPanda: folds 
zagaia011: folds 
LuvPeec: folds 
Lucas0258: calls 480
*** FLOP *** [4s As 2h]
Lucas0258: checks 
jcarlos.vale: bets 600
Lucas0258: folds 
Uncalled bet (600) returned to jcarlos.vale
jcarlos.vale collected 2070 from pot
jcarlos.vale: doesn't show hand 
*** SUMMARY ***
Total pot 2070 | Rake 0 
Board [4s As 2h]
Seat 1: Lucas0258 (big blind) folded on the Flop
Seat 2: angus5 folded before Flop (didn't bet)
Seat 3: MathiasFer folded before Flop (didn't bet)
Seat 4: pedrostjr folded before Flop (didn't bet)
Seat 5: jcarlos.vale collected (2070)
Seat 6: Praevus folded before Flop (didn't bet)
Seat 7: GosPanda folded before Flop (didn't bet)
Seat 8: zagaia011 (button) folded before Flop (didn't bet)
Seat 9: LuvPeec (small blind) folded before Flop



PokerStars Hand #221736483921: Tournament #3079057742, $0.98+$0.12 USD Hold'em No Limit - Level XI (150/300) - 2020/12/23 0:30:45 EET [2020/12/22 17:30:45 ET]
Table '3079057742 50' 9-max Seat #9 is the button
Seat 1: Lucas0258 (30930 in chips) 
Seat 2: angus5 (8397 in chips) 
Seat 3: MathiasFer (3962 in chips) is sitting out
Seat 4: pedrostjr (9646 in chips) 
Seat 5: jcarlos.vale (14917 in chips) 
Seat 6: Praevus (4548 in chips) 
Seat 7: GosPanda (15223 in chips) 
Seat 8: zagaia011 (12925 in chips) 
Seat 9: LuvPeec (4116 in chips) 
Lucas0258: posts the ante 40
angus5: posts the ante 40
MathiasFer: posts the ante 40
pedrostjr: posts the ante 40
jcarlos.vale: posts the ante 40
Praevus: posts the ante 40
GosPanda: posts the ante 40
zagaia011: posts the ante 40
LuvPeec: posts the ante 40
Lucas0258: posts small blind 150
angus5: posts big blind 300
*** HOLE CARDS ***
Dealt to jcarlos.vale [6s 7d]
MathiasFer: folds 
pedrostjr: raises 366 to 666
jcarlos.vale: folds 
Praevus: folds 
GosPanda: folds 
zagaia011: folds 
LuvPeec: raises 3410 to 4076 and is all-in
Lucas0258: folds 
angus5: folds 
pedrostjr: calls 3410
*** FLOP *** [2d Kc 5c]
*** TURN *** [2d Kc 5c] [4d]
*** RIVER *** [2d Kc 5c 4d] [7c]
*** SHOW DOWN ***
pedrostjr: shows [Ad Qs] (high card Ace)
LuvPeec: shows [Jd Jc] (a pair of Jacks)
LuvPeec collected 8962 from pot
*** SUMMARY ***
Total pot 8962 | Rake 0 
Board [2d Kc 5c 4d 7c]
Seat 1: Lucas0258 (small blind) folded before Flop
Seat 2: angus5 (big blind) folded before Flop
Seat 3: MathiasFer folded before Flop (didn't bet)
Seat 4: pedrostjr showed [Ad Qs] and lost with high card Ace
Seat 5: jcarlos.vale folded before Flop (didn't bet)
Seat 6: Praevus folded before Flop (didn't bet)
Seat 7: GosPanda folded before Flop (didn't bet)
Seat 8: zagaia011 folded before Flop (didn't bet)
Seat 9: LuvPeec (button) showed [Jd Jc] and won (8962) with a pair of Jacks



PokerStars Hand #221736506513: Tournament #3079057742, $0.98+$0.12 USD Hold'em No Limit - Level XI (150/300) - 2020/12/23 0:31:20 EET [2020/12/22 17:31:20 ET]
Table '3079057742 50' 9-max Seat #1 is the button
Seat 1: Lucas0258 (30740 in chips) 
Seat 2: angus5 (8057 in chips) 
Seat 3: MathiasFer (3922 in chips) is sitting out
Seat 4: pedrostjr (5530 in chips) 
Seat 5: jcarlos.vale (14877 in chips) 
Seat 6: Praevus (4508 in chips) 
Seat 7: GosPanda (15183 in chips) 
Seat 8: zagaia011 (12885 in chips) 
Seat 9: LuvPeec (8962 in chips) 
Lucas0258: posts the ante 40
angus5: posts the ante 40
MathiasFer: posts the ante 40
pedrostjr: posts the ante 40
jcarlos.vale: posts the ante 40
Praevus: posts the ante 40
GosPanda: posts the ante 40
zagaia011: posts the ante 40
LuvPeec: posts the ante 40
angus5: posts small blind 150
MathiasFer: posts big blind 300
*** HOLE CARDS ***
Dealt to jcarlos.vale [7s Kh]
pedrostjr: folds 
jcarlos.vale: folds 
Praevus: folds 
GosPanda: raises 600 to 900
zagaia011: folds 
LuvPeec: folds 
Lucas0258: folds 
angus5: folds 
MathiasFer: folds 
Uncalled bet (600) returned to GosPanda
GosPanda collected 1110 from pot
GosPanda: doesn't show hand 
*** SUMMARY ***
Total pot 1110 | Rake 0 
Seat 1: Lucas0258 (button) folded before Flop (didn't bet)
Seat 2: angus5 (small blind) folded before Flop
Seat 3: MathiasFer (big blind) folded before Flop
Seat 4: pedrostjr folded before Flop (didn't bet)
Seat 5: jcarlos.vale folded before Flop (didn't bet)
Seat 6: Praevus folded before Flop (didn't bet)
Seat 7: GosPanda collected (1110)
Seat 8: zagaia011 folded before Flop (didn't bet)
Seat 9: LuvPeec folded before Flop (didn't bet)



PokerStars Hand #221736530691: Tournament #3079057742, $0.98+$0.12 USD Hold'em No Limit - Level XI (150/300) - 2020/12/23 0:31:58 EET [2020/12/22 17:31:58 ET]
Table '3079057742 50' 9-max Seat #2 is the button
Seat 1: Lucas0258 (30700 in chips) 
Seat 2: angus5 (7867 in chips) 
Seat 3: MathiasFer (3582 in chips) is sitting out
Seat 4: pedrostjr (5490 in chips) 
Seat 5: jcarlos.vale (14837 in chips) 
Seat 6: Praevus (4468 in chips) 
Seat 7: GosPanda (15953 in chips) 
Seat 8: zagaia011 (12845 in chips) 
Seat 9: LuvPeec (8922 in chips) 
Lucas0258: posts the ante 40
angus5: posts the ante 40
MathiasFer: posts the ante 40
pedrostjr: posts the ante 40
jcarlos.vale: posts the ante 40
Praevus: posts the ante 40
GosPanda: posts the ante 40
zagaia011: posts the ante 40
LuvPeec: posts the ante 40
MathiasFer: posts small blind 150
pedrostjr: posts big blind 300
*** HOLE CARDS ***
Dealt to jcarlos.vale [Qc Kc]
jcarlos.vale: raises 480 to 780
Praevus: folds 
GosPanda: folds 
zagaia011: folds 
LuvPeec: folds 
Lucas0258: folds 
angus5: folds 
MathiasFer: folds 
pedrostjr: folds 
Uncalled bet (480) returned to jcarlos.vale
jcarlos.vale collected 1110 from pot
jcarlos.vale: doesn't show hand 
*** SUMMARY ***
Total pot 1110 | Rake 0 
Seat 1: Lucas0258 folded before Flop (didn't bet)
Seat 2: angus5 (button) folded before Flop (didn't bet)
Seat 3: MathiasFer (small blind) folded before Flop
Seat 4: pedrostjr (big blind) folded before Flop
Seat 5: jcarlos.vale collected (1110)
Seat 6: Praevus folded before Flop (didn't bet)
Seat 7: GosPanda folded before Flop (didn't bet)
Seat 8: zagaia011 folded before Flop (didn't bet)
Seat 9: LuvPeec folded before Flop (didn't bet)



PokerStars Hand #221736542951: Tournament #3079057742, $0.98+$0.12 USD Hold'em No Limit - Level XI (150/300) - 2020/12/23 0:32:16 EET [2020/12/22 17:32:16 ET]
Table '3079057742 50' 9-max Seat #3 is the button
Seat 1: Lucas0258 (30660 in chips) 
Seat 2: angus5 (7827 in chips) 
Seat 3: MathiasFer (3392 in chips) is sitting out
Seat 4: pedrostjr (5150 in chips) 
Seat 5: jcarlos.vale (15607 in chips) 
Seat 6: Praevus (4428 in chips) 
Seat 7: GosPanda (15913 in chips) 
Seat 8: zagaia011 (12805 in chips) 
Seat 9: LuvPeec (8882 in chips) 
Lucas0258: posts the ante 40
angus5: posts the ante 40
MathiasFer: posts the ante 40
pedrostjr: posts the ante 40
jcarlos.vale: posts the ante 40
Praevus: posts the ante 40
GosPanda: posts the ante 40
zagaia011: posts the ante 40
LuvPeec: posts the ante 40
pedrostjr: posts small blind 150
jcarlos.vale: posts big blind 300
*** HOLE CARDS ***
Dealt to jcarlos.vale [9c 6d]
Praevus: folds 
GosPanda: folds 
zagaia011: folds 
LuvPeec: folds 
Lucas0258: folds 
angus5: calls 300
MathiasFer: folds 
pedrostjr: raises 4810 to 5110 and is all-in
jcarlos.vale: folds 
angus5: folds 
Uncalled bet (4810) returned to pedrostjr
pedrostjr collected 1260 from pot
pedrostjr: doesn't show hand 
*** SUMMARY ***
Total pot 1260 | Rake 0 
Seat 1: Lucas0258 folded before Flop (didn't bet)
Seat 2: angus5 folded before Flop
Seat 3: MathiasFer (button) folded before Flop (didn't bet)
Seat 4: pedrostjr (small blind) collected (1260)
Seat 5: jcarlos.vale (big blind) folded before Flop
Seat 6: Praevus folded before Flop (didn't bet)
Seat 7: GosPanda folded before Flop (didn't bet)
Seat 8: zagaia011 folded before Flop (didn't bet)
Seat 9: LuvPeec folded before Flop (didn't bet)



PokerStars Hand #221736566568: Tournament #3079057742, $0.98+$0.12 USD Hold'em No Limit - Level XI (150/300) - 2020/12/23 0:32:53 EET [2020/12/22 17:32:53 ET]
Table '3079057742 50' 9-max Seat #4 is the button
Seat 1: Lucas0258 (30620 in chips) 
Seat 2: angus5 (7487 in chips) 
Seat 3: MathiasFer (3352 in chips) is sitting out
Seat 4: pedrostjr (6070 in chips) 
Seat 5: jcarlos.vale (15267 in chips) 
Seat 6: Praevus (4388 in chips) 
Seat 7: GosPanda (15873 in chips) 
Seat 8: zagaia011 (12765 in chips) 
Seat 9: LuvPeec (8842 in chips) 
Lucas0258: posts the ante 40
angus5: posts the ante 40
MathiasFer: posts the ante 40
pedrostjr: posts the ante 40
jcarlos.vale: posts the ante 40
Praevus: posts the ante 40
GosPanda: posts the ante 40
zagaia011: posts the ante 40
LuvPeec: posts the ante 40
jcarlos.vale: posts small blind 150
Praevus: posts big blind 300
*** HOLE CARDS ***
Dealt to jcarlos.vale [8d 3h]
GosPanda: folds 
zagaia011: raises 300 to 600
LuvPeec: folds 
Lucas0258: folds 
angus5: folds 
MathiasFer: folds 
pedrostjr: folds 
jcarlos.vale: folds 
Praevus: folds 
Uncalled bet (300) returned to zagaia011
zagaia011 collected 1110 from pot
zagaia011: doesn't show hand 
*** SUMMARY ***
Total pot 1110 | Rake 0 
Seat 1: Lucas0258 folded before Flop (didn't bet)
Seat 2: angus5 folded before Flop (didn't bet)
Seat 3: MathiasFer folded before Flop (didn't bet)
Seat 4: pedrostjr (button) folded before Flop (didn't bet)
Seat 5: jcarlos.vale (small blind) folded before Flop
Seat 6: Praevus (big blind) folded before Flop
Seat 7: GosPanda folded before Flop (didn't bet)
Seat 8: zagaia011 collected (1110)
Seat 9: LuvPeec folded before Flop (didn't bet)



PokerStars Hand #221736591344: Tournament #3079057742, $0.98+$0.12 USD Hold'em No Limit - Level XII (200/400) - 2020/12/23 0:33:32 EET [2020/12/22 17:33:32 ET]
Table '3079057742 50' 9-max Seat #5 is the button
Seat 1: Lucas0258 (30580 in chips) 
Seat 2: angus5 (7447 in chips) 
Seat 3: MathiasFer (3312 in chips) is sitting out
Seat 4: pedrostjr (6030 in chips) 
Seat 5: jcarlos.vale (15077 in chips) 
Seat 6: Praevus (4048 in chips) 
Seat 7: GosPanda (15833 in chips) 
Seat 8: zagaia011 (13535 in chips) 
Seat 9: LuvPeec (8802 in chips) 
Lucas0258: posts the ante 50
angus5: posts the ante 50
MathiasFer: posts the ante 50
pedrostjr: posts the ante 50
jcarlos.vale: posts the ante 50
Praevus: posts the ante 50
GosPanda: posts the ante 50
zagaia011: posts the ante 50
LuvPeec: posts the ante 50
Praevus: posts small blind 200
GosPanda: posts big blind 400
*** HOLE CARDS ***
Dealt to jcarlos.vale [6c 6s]
zagaia011: folds 
LuvPeec: folds 
Lucas0258: folds 
angus5: folds 
MathiasFer: folds 
pedrostjr: raises 5580 to 5980 and is all-in
jcarlos.vale: folds 
Praevus: folds 
GosPanda: folds 
Uncalled bet (5580) returned to pedrostjr
pedrostjr collected 1450 from pot
pedrostjr: doesn't show hand 
*** SUMMARY ***
Total pot 1450 | Rake 0 
Seat 1: Lucas0258 folded before Flop (didn't bet)
Seat 2: angus5 folded before Flop (didn't bet)
Seat 3: MathiasFer folded before Flop (didn't bet)
Seat 4: pedrostjr collected (1450)
Seat 5: jcarlos.vale (button) folded before Flop (didn't bet)
Seat 6: Praevus (small blind) folded before Flop
Seat 7: GosPanda (big blind) folded before Flop
Seat 8: zagaia011 folded before Flop (didn't bet)
Seat 9: LuvPeec folded before Flop (didn't bet)



PokerStars Hand #221736616905: Tournament #3079057742, $0.98+$0.12 USD Hold'em No Limit - Level XII (200/400) - 2020/12/23 0:34:12 EET [2020/12/22 17:34:12 ET]
Table '3079057742 50' 9-max Seat #6 is the button
Seat 1: Lucas0258 (30530 in chips) 
Seat 2: angus5 (7397 in chips) 
Seat 3: MathiasFer (3262 in chips) is sitting out
Seat 4: pedrostjr (7030 in chips) 
Seat 5: jcarlos.vale (15027 in chips) 
Seat 6: Praevus (3798 in chips) 
Seat 7: GosPanda (15383 in chips) 
Seat 8: zagaia011 (13485 in chips) 
Seat 9: LuvPeec (8752 in chips) 
Lucas0258: posts the ante 50
angus5: posts the ante 50
MathiasFer: posts the ante 50
pedrostjr: posts the ante 50
jcarlos.vale: posts the ante 50
Praevus: posts the ante 50
GosPanda: posts the ante 50
zagaia011: posts the ante 50
LuvPeec: posts the ante 50
GosPanda: posts small blind 200
zagaia011: posts big blind 400
*** HOLE CARDS ***
Dealt to jcarlos.vale [Jh 4c]
LuvPeec: folds 
Lucas0258: raises 436 to 836
angus5: folds 
MathiasFer: folds 
pedrostjr: folds 
jcarlos.vale: folds 
Praevus: folds 
GosPanda: calls 636
zagaia011: folds 
*** FLOP *** [2d 9h Ad]
GosPanda: checks 
Lucas0258: bets 757
GosPanda: calls 757
*** TURN *** [2d 9h Ad] [4h]
GosPanda: checks 
Lucas0258: checks 
*** RIVER *** [2d 9h Ad 4h] [7c]
GosPanda: checks 
Lucas0258: checks 
*** SHOW DOWN ***
GosPanda: shows [As 6s] (a pair of Aces)
Lucas0258: mucks hand 
GosPanda collected 4036 from pot
*** SUMMARY ***
Total pot 4036 | Rake 0 
Board [2d 9h Ad 4h 7c]
Seat 1: Lucas0258 mucked [Jc 8h]
Seat 2: angus5 folded before Flop (didn't bet)
Seat 3: MathiasFer folded before Flop (didn't bet)
Seat 4: pedrostjr folded before Flop (didn't bet)
Seat 5: jcarlos.vale folded before Flop (didn't bet)
Seat 6: Praevus (button) folded before Flop (didn't bet)
Seat 7: GosPanda (small blind) showed [As 6s] and won (4036) with a pair of Aces
Seat 8: zagaia011 (big blind) folded before Flop
Seat 9: LuvPeec folded before Flop (didn't bet)



PokerStars Hand #221736659466: Tournament #3079057742, $0.98+$0.12 USD Hold'em No Limit - Level XII (200/400) - 2020/12/23 0:35:04 EET [2020/12/22 17:35:04 ET]
Table '3079057742 50' 9-max Seat #7 is the button
Seat 1: Lucas0258 (28887 in chips) 
Seat 2: angus5 (7347 in chips) 
Seat 3: MathiasFer (3212 in chips) is sitting out
Seat 4: pedrostjr (6980 in chips) 
Seat 5: jcarlos.vale (14977 in chips) 
Seat 6: Praevus (3748 in chips) 
Seat 7: GosPanda (17776 in chips) 
Seat 8: zagaia011 (13035 in chips) 
Seat 9: LuvPeec (8702 in chips) 
Lucas0258: posts the ante 50
angus5: posts the ante 50
MathiasFer: posts the ante 50
pedrostjr: posts the ante 50
jcarlos.vale: posts the ante 50
Praevus: posts the ante 50
GosPanda: posts the ante 50
zagaia011: posts the ante 50
LuvPeec: posts the ante 50
zagaia011: posts small blind 200
LuvPeec: posts big blind 400
*** HOLE CARDS ***
Dealt to jcarlos.vale [4h 2c]
Lucas0258: raises 436 to 836
angus5: calls 836
MathiasFer: folds 
pedrostjr: folds 
jcarlos.vale: folds 
Praevus: folds 
GosPanda: folds 
zagaia011: folds 
LuvPeec: calls 436
*** FLOP *** [4d 3d 5c]
LuvPeec: checks 
Lucas0258: checks 
angus5: checks 
*** TURN *** [4d 3d 5c] [Ah]
LuvPeec: checks 
Lucas0258: bets 800
angus5: raises 5661 to 6461 and is all-in
LuvPeec: folds 
Lucas0258: calls 5661
*** RIVER *** [4d 3d 5c Ah] [7c]
*** SHOW DOWN ***
Lucas0258: shows [6d Ad] (a straight, Three to Seven)
angus5: shows [Kd Ac] (a pair of Aces)
Lucas0258 collected 16080 from pot
angus5 finished the tournament in 222nd place
*** SUMMARY ***
Total pot 16080 | Rake 0 
Board [4d 3d 5c Ah 7c]
Seat 1: Lucas0258 showed [6d Ad] and won (16080) with a straight, Three to Seven
Seat 2: angus5 showed [Kd Ac] and lost with a pair of Aces
Seat 3: MathiasFer folded before Flop (didn't bet)
Seat 4: pedrostjr folded before Flop (didn't bet)
Seat 5: jcarlos.vale folded before Flop (didn't bet)
Seat 6: Praevus folded before Flop (didn't bet)
Seat 7: GosPanda (button) folded before Flop (didn't bet)
Seat 8: zagaia011 (small blind) folded before Flop
Seat 9: LuvPeec (big blind) folded on the Turn



PokerStars Hand #221736717539: Tournament #3079057742, $0.98+$0.12 USD Hold'em No Limit - Level XII (200/400) - 2020/12/23 0:36:36 EET [2020/12/22 17:36:36 ET]
Table '3079057742 50' 9-max Seat #8 is the button
Seat 1: Lucas0258 (37620 in chips) 
Seat 3: MathiasFer (3162 in chips) is sitting out
Seat 4: pedrostjr (6930 in chips) 
Seat 5: jcarlos.vale (14927 in chips) 
Seat 6: Praevus (3698 in chips) 
Seat 7: GosPanda (17726 in chips) 
Seat 8: zagaia011 (12785 in chips) 
Seat 9: LuvPeec (7816 in chips) 
Lucas0258: posts the ante 50
MathiasFer: posts the ante 50
pedrostjr: posts the ante 50
jcarlos.vale: posts the ante 50
Praevus: posts the ante 50
GosPanda: posts the ante 50
zagaia011: posts the ante 50
LuvPeec: posts the ante 50
LuvPeec: posts small blind 200
Lucas0258: posts big blind 400
*** HOLE CARDS ***
Dealt to jcarlos.vale [Jh 2h]
MathiasFer: folds 
pedrostjr: folds 
jcarlos.vale: folds 
Praevus: folds 
GosPanda: folds 
zagaia011: folds 
LuvPeec: folds 
Uncalled bet (200) returned to Lucas0258
Lucas0258 collected 800 from pot
*** SUMMARY ***
Total pot 800 | Rake 0 
Seat 1: Lucas0258 (big blind) collected (800)
Seat 3: MathiasFer folded before Flop (didn't bet)
Seat 4: pedrostjr folded before Flop (didn't bet)
Seat 5: jcarlos.vale folded before Flop (didn't bet)
Seat 6: Praevus folded before Flop (didn't bet)
Seat 7: GosPanda folded before Flop (didn't bet)
Seat 8: zagaia011 (button) folded before Flop (didn't bet)
Seat 9: LuvPeec (small blind) folded before Flop



PokerStars Hand #221736730036: Tournament #3079057742, $0.98+$0.12 USD Hold'em No Limit - Level XII (200/400) - 2020/12/23 0:36:55 EET [2020/12/22 17:36:55 ET]
Table '3079057742 50' 9-max Seat #9 is the button
Seat 1: Lucas0258 (38170 in chips) 
Seat 3: MathiasFer (3112 in chips) is sitting out
Seat 4: pedrostjr (6880 in chips) 
Seat 5: jcarlos.vale (14877 in chips) 
Seat 6: Praevus (3648 in chips) 
Seat 7: GosPanda (17676 in chips) 
Seat 8: zagaia011 (12735 in chips) 
Seat 9: LuvPeec (7566 in chips) 
Lucas0258: posts the ante 50
MathiasFer: posts the ante 50
pedrostjr: posts the ante 50
jcarlos.vale: posts the ante 50
Praevus: posts the ante 50
GosPanda: posts the ante 50
zagaia011: posts the ante 50
LuvPeec: posts the ante 50
Lucas0258: posts small blind 200
MathiasFer: posts big blind 400
*** HOLE CARDS ***
Dealt to jcarlos.vale [4h Ad]
pedrostjr: folds 
jcarlos.vale: folds 
Praevus: folds 
GosPanda: folds 
zagaia011: folds 
LuvPeec: raises 500 to 900
Lucas0258: raises 1100 to 2000
MathiasFer: folds 
LuvPeec: calls 1100
*** FLOP *** [Kh 3c Qh]
Lucas0258: checks 
LuvPeec: bets 1920
Lucas0258: folds 
Uncalled bet (1920) returned to LuvPeec
LuvPeec collected 4800 from pot
LuvPeec: doesn't show hand 
*** SUMMARY ***
Total pot 4800 | Rake 0 
Board [Kh 3c Qh]
Seat 1: Lucas0258 (small blind) folded on the Flop
Seat 3: MathiasFer (big blind) folded before Flop
Seat 4: pedrostjr folded before Flop (didn't bet)
Seat 5: jcarlos.vale folded before Flop (didn't bet)
Seat 6: Praevus folded before Flop (didn't bet)
Seat 7: GosPanda folded before Flop (didn't bet)
Seat 8: zagaia011 folded before Flop (didn't bet)
Seat 9: LuvPeec (button) collected (4800)



PokerStars Hand #221736781211: Tournament #3079057742, $0.98+$0.12 USD Hold'em No Limit - Level XII (200/400) - 2020/12/23 0:38:16 EET [2020/12/22 17:38:16 ET]
Table '3079057742 50' 9-max Seat #1 is the button
Seat 1: Lucas0258 (36120 in chips) 
Seat 2: checkroom (3343 in chips) out of hand (moved from another table into small blind)
Seat 3: MathiasFer (2662 in chips) is sitting out
Seat 4: pedrostjr (6830 in chips) 
Seat 5: jcarlos.vale (14827 in chips) 
Seat 6: Praevus (3598 in chips) 
Seat 7: GosPanda (17626 in chips) 
Seat 8: zagaia011 (12685 in chips) 
Seat 9: LuvPeec (10316 in chips) 
checkroom will be allowed to play after the button
Lucas0258: posts the ante 50
MathiasFer: posts the ante 50
pedrostjr: posts the ante 50
jcarlos.vale: posts the ante 50
Praevus: posts the ante 50
GosPanda: posts the ante 50
zagaia011: posts the ante 50
LuvPeec: posts the ante 50
MathiasFer: posts small blind 200
pedrostjr: posts big blind 400
*** HOLE CARDS ***
Dealt to jcarlos.vale [Ac Th]
jcarlos.vale: raises 640 to 1040
Praevus: folds 
GosPanda: folds 
zagaia011: folds 
LuvPeec: folds 
Lucas0258: folds 
MathiasFer: folds 
pedrostjr: raises 5740 to 6780 and is all-in
jcarlos.vale: folds 
Uncalled bet (5740) returned to pedrostjr
pedrostjr collected 2680 from pot
pedrostjr: doesn't show hand 
*** SUMMARY ***
Total pot 2680 | Rake 0 
Seat 1: Lucas0258 (button) folded before Flop (didn't bet)
Seat 3: MathiasFer (small blind) folded before Flop
Seat 4: pedrostjr (big blind) collected (2680)
Seat 5: jcarlos.vale folded before Flop
Seat 6: Praevus folded before Flop (didn't bet)
Seat 7: GosPanda folded before Flop (didn't bet)
Seat 8: zagaia011 folded before Flop (didn't bet)
Seat 9: LuvPeec folded before Flop (didn't bet)



PokerStars Hand #221736807546: Tournament #3079057742, $0.98+$0.12 USD Hold'em No Limit - Level XII (200/400) - 2020/12/23 0:38:58 EET [2020/12/22 17:38:58 ET]
Table '3079057742 50' 9-max Seat #3 is the button
Seat 1: Lucas0258 (36070 in chips) 
Seat 2: checkroom (3343 in chips) 
Seat 3: MathiasFer (2412 in chips) is sitting out
Seat 4: pedrostjr (8420 in chips) 
Seat 5: jcarlos.vale (13737 in chips) 
Seat 6: Praevus (3548 in chips) 
Seat 7: GosPanda (17576 in chips) 
Seat 8: zagaia011 (12635 in chips) 
Seat 9: LuvPeec (10266 in chips) 
Lucas0258: posts the ante 50
checkroom: posts the ante 50
MathiasFer: posts the ante 50
pedrostjr: posts the ante 50
jcarlos.vale: posts the ante 50
Praevus: posts the ante 50
GosPanda: posts the ante 50
zagaia011: posts the ante 50
LuvPeec: posts the ante 50
pedrostjr: posts small blind 200
jcarlos.vale: posts big blind 400
*** HOLE CARDS ***
Dealt to jcarlos.vale [Tc Kh]
Praevus: folds 
GosPanda: folds 
zagaia011: folds 
LuvPeec: folds 
Lucas0258: raises 436 to 836
checkroom: folds 
MathiasFer: folds 
pedrostjr: folds 
jcarlos.vale: folds 
Uncalled bet (436) returned to Lucas0258
Lucas0258 collected 1450 from pot
Lucas0258: doesn't show hand 
*** SUMMARY ***
Total pot 1450 | Rake 0 
Seat 1: Lucas0258 collected (1450)
Seat 2: checkroom folded before Flop (didn't bet)
Seat 3: MathiasFer (button) folded before Flop (didn't bet)
Seat 4: pedrostjr (small blind) folded before Flop
Seat 5: jcarlos.vale (big blind) folded before Flop
Seat 6: Praevus folded before Flop (didn't bet)
Seat 7: GosPanda folded before Flop (didn't bet)
Seat 8: zagaia011 folded before Flop (didn't bet)
Seat 9: LuvPeec folded before Flop (didn't bet)



PokerStars Hand #221736822605: Tournament #3079057742, $0.98+$0.12 USD Hold'em No Limit - Level XII (200/400) - 2020/12/23 0:39:22 EET [2020/12/22 17:39:22 ET]
Table '3079057742 50' 9-max Seat #4 is the button
Seat 1: Lucas0258 (37070 in chips) 
Seat 2: checkroom (3293 in chips) 
Seat 3: MathiasFer (2362 in chips) is sitting out
Seat 4: pedrostjr (8170 in chips) 
Seat 5: jcarlos.vale (13287 in chips) 
Seat 6: Praevus (3498 in chips) 
Seat 7: GosPanda (17526 in chips) 
Seat 8: zagaia011 (12585 in chips) 
Seat 9: LuvPeec (10216 in chips) 
Lucas0258: posts the ante 50
checkroom: posts the ante 50
MathiasFer: posts the ante 50
pedrostjr: posts the ante 50
jcarlos.vale: posts the ante 50
Praevus: posts the ante 50
GosPanda: posts the ante 50
zagaia011: posts the ante 50
LuvPeec: posts the ante 50
jcarlos.vale: posts small blind 200
Praevus: posts big blind 400
*** HOLE CARDS ***
Dealt to jcarlos.vale [5d Ah]
GosPanda: folds 
zagaia011: folds 
LuvPeec: folds 
Lucas0258: folds 
checkroom: folds 
MathiasFer: folds 
pedrostjr: folds 
jcarlos.vale: raises 640 to 1040
Praevus: folds 
Uncalled bet (640) returned to jcarlos.vale
jcarlos.vale collected 1250 from pot
jcarlos.vale: doesn't show hand 
*** SUMMARY ***
Total pot 1250 | Rake 0 
Seat 1: Lucas0258 folded before Flop (didn't bet)
Seat 2: checkroom folded before Flop (didn't bet)
Seat 3: MathiasFer folded before Flop (didn't bet)
Seat 4: pedrostjr (button) folded before Flop (didn't bet)
Seat 5: jcarlos.vale (small blind) collected (1250)
Seat 6: Praevus (big blind) folded before Flop
Seat 7: GosPanda folded before Flop (didn't bet)
Seat 8: zagaia011 folded before Flop (didn't bet)
Seat 9: LuvPeec folded before Flop (didn't bet)



PokerStars Hand #221736847724: Tournament #3079057742, $0.98+$0.12 USD Hold'em No Limit - Level XII (200/400) - 2020/12/23 0:40:03 EET [2020/12/22 17:40:03 ET]
Table '3079057742 50' 9-max Seat #5 is the button
Seat 1: Lucas0258 (37020 in chips) 
Seat 2: checkroom (3243 in chips) 
Seat 3: MathiasFer (2312 in chips) is sitting out
Seat 4: pedrostjr (8120 in chips) 
Seat 5: jcarlos.vale (14087 in chips) 
Seat 6: Praevus (3048 in chips) 
Seat 7: GosPanda (17476 in chips) 
Seat 8: zagaia011 (12535 in chips) 
Seat 9: LuvPeec (10166 in chips) 
Lucas0258: posts the ante 50
checkroom: posts the ante 50
MathiasFer: posts the ante 50
pedrostjr: posts the ante 50
jcarlos.vale: posts the ante 50
Praevus: posts the ante 50
GosPanda: posts the ante 50
zagaia011: posts the ante 50
LuvPeec: posts the ante 50
Praevus: posts small blind 200
GosPanda: posts big blind 400
*** HOLE CARDS ***
Dealt to jcarlos.vale [Jc 2d]
zagaia011: folds 
LuvPeec: folds 
Lucas0258: folds 
checkroom: folds 
MathiasFer: folds 
pedrostjr: folds 
jcarlos.vale: folds 
Praevus: raises 2598 to 2998 and is all-in
GosPanda: folds 
Uncalled bet (2598) returned to Praevus
Praevus collected 1250 from pot
Praevus: doesn't show hand 
*** SUMMARY ***
Total pot 1250 | Rake 0 
Seat 1: Lucas0258 folded before Flop (didn't bet)
Seat 2: checkroom folded before Flop (didn't bet)
Seat 3: MathiasFer folded before Flop (didn't bet)
Seat 4: pedrostjr folded before Flop (didn't bet)
Seat 5: jcarlos.vale (button) folded before Flop (didn't bet)
Seat 6: Praevus (small blind) collected (1250)
Seat 7: GosPanda (big blind) folded before Flop
Seat 8: zagaia011 folded before Flop (didn't bet)
Seat 9: LuvPeec folded before Flop (didn't bet)



PokerStars Hand #221736868333: Tournament #3079057742, $0.98+$0.12 USD Hold'em No Limit - Level XII (200/400) - 2020/12/23 0:40:36 EET [2020/12/22 17:40:36 ET]
Table '3079057742 50' 9-max Seat #6 is the button
Seat 1: Lucas0258 (36970 in chips) 
Seat 2: checkroom (3193 in chips) 
Seat 3: MathiasFer (2262 in chips) is sitting out
Seat 4: pedrostjr (8070 in chips) 
Seat 5: jcarlos.vale (14037 in chips) 
Seat 6: Praevus (3848 in chips) 
Seat 7: GosPanda (17026 in chips) 
Seat 8: zagaia011 (12485 in chips) 
Seat 9: LuvPeec (10116 in chips) 
Lucas0258: posts the ante 50
checkroom: posts the ante 50
MathiasFer: posts the ante 50
pedrostjr: posts the ante 50
jcarlos.vale: posts the ante 50
Praevus: posts the ante 50
GosPanda: posts the ante 50
zagaia011: posts the ante 50
LuvPeec: posts the ante 50
GosPanda: posts small blind 200
zagaia011: posts big blind 400
*** HOLE CARDS ***
Dealt to jcarlos.vale [Qd 4h]
LuvPeec: folds 
Lucas0258: folds 
checkroom: folds 
MathiasFer: folds 
pedrostjr: folds 
jcarlos.vale: folds 
Praevus: folds 
GosPanda: calls 200
zagaia011: raises 1000 to 1400
GosPanda: folds 
Uncalled bet (1000) returned to zagaia011
zagaia011 collected 1250 from pot
zagaia011: doesn't show hand 
*** SUMMARY ***
Total pot 1250 | Rake 0 
Seat 1: Lucas0258 folded before Flop (didn't bet)
Seat 2: checkroom folded before Flop (didn't bet)
Seat 3: MathiasFer folded before Flop (didn't bet)
Seat 4: pedrostjr folded before Flop (didn't bet)
Seat 5: jcarlos.vale folded before Flop (didn't bet)
Seat 6: Praevus (button) folded before Flop (didn't bet)
Seat 7: GosPanda (small blind) folded before Flop
Seat 8: zagaia011 (big blind) collected (1250)
Seat 9: LuvPeec folded before Flop (didn't bet)



PokerStars Hand #221736898348: Tournament #3079057742, $0.98+$0.12 USD Hold'em No Limit - Level XII (200/400) - 2020/12/23 0:41:24 EET [2020/12/22 17:41:24 ET]
Table '3079057742 50' 9-max Seat #7 is the button
Seat 1: Lucas0258 (36920 in chips) 
Seat 2: checkroom (3143 in chips) 
Seat 3: MathiasFer (2212 in chips) is sitting out
Seat 4: pedrostjr (8020 in chips) 
Seat 5: jcarlos.vale (13987 in chips) 
Seat 6: Praevus (3798 in chips) 
Seat 7: GosPanda (16576 in chips) 
Seat 8: zagaia011 (13285 in chips) 
Seat 9: LuvPeec (10066 in chips) 
Lucas0258: posts the ante 50
checkroom: posts the ante 50
MathiasFer: posts the ante 50
pedrostjr: posts the ante 50
jcarlos.vale: posts the ante 50
Praevus: posts the ante 50
GosPanda: posts the ante 50
zagaia011: posts the ante 50
LuvPeec: posts the ante 50
zagaia011: posts small blind 200
LuvPeec: posts big blind 400
*** HOLE CARDS ***
Dealt to jcarlos.vale [7d Jh]
Lucas0258: folds 
checkroom: folds 
MathiasFer: folds 
pedrostjr: folds 
jcarlos.vale: folds 
Praevus: folds 
GosPanda: folds 
zagaia011: folds 
Uncalled bet (200) returned to LuvPeec
LuvPeec collected 850 from pot
LuvPeec: doesn't show hand 
*** SUMMARY ***
Total pot 850 | Rake 0 
Seat 1: Lucas0258 folded before Flop (didn't bet)
Seat 2: checkroom folded before Flop (didn't bet)
Seat 3: MathiasFer folded before Flop (didn't bet)
Seat 4: pedrostjr folded before Flop (didn't bet)
Seat 5: jcarlos.vale folded before Flop (didn't bet)
Seat 6: Praevus folded before Flop (didn't bet)
Seat 7: GosPanda (button) folded before Flop (didn't bet)
Seat 8: zagaia011 (small blind) folded before Flop
Seat 9: LuvPeec (big blind) collected (850)



PokerStars Hand #221736916193: Tournament #3079057742, $0.98+$0.12 USD Hold'em No Limit - Level XII (200/400) - 2020/12/23 0:41:53 EET [2020/12/22 17:41:53 ET]
Table '3079057742 50' 9-max Seat #8 is the button
Seat 1: Lucas0258 (36870 in chips) 
Seat 2: checkroom (3093 in chips) 
Seat 3: MathiasFer (2162 in chips) is sitting out
Seat 4: pedrostjr (7970 in chips) 
Seat 5: jcarlos.vale (13937 in chips) 
Seat 6: Praevus (3748 in chips) 
Seat 7: GosPanda (16526 in chips) 
Seat 8: zagaia011 (13035 in chips) 
Seat 9: LuvPeec (10666 in chips) 
Lucas0258: posts the ante 50
checkroom: posts the ante 50
MathiasFer: posts the ante 50
pedrostjr: posts the ante 50
jcarlos.vale: posts the ante 50
Praevus: posts the ante 50
GosPanda: posts the ante 50
zagaia011: posts the ante 50
LuvPeec: posts the ante 50
LuvPeec: posts small blind 200
Lucas0258: posts big blind 400
*** HOLE CARDS ***
Dealt to jcarlos.vale [Td Ac]
checkroom: folds 
MathiasFer: folds 
pedrostjr: folds 
jcarlos.vale: raises 640 to 1040
Praevus: folds 
GosPanda: folds 
zagaia011: calls 1040
LuvPeec: folds 
Lucas0258: folds 
*** FLOP *** [6d Kh 7c]
jcarlos.vale: checks 
zagaia011: checks 
*** TURN *** [6d Kh 7c] [5c]
jcarlos.vale: checks 
zagaia011: checks 
*** RIVER *** [6d Kh 7c 5c] [6s]
jcarlos.vale: checks 
zagaia011: checks 
*** SHOW DOWN ***
jcarlos.vale: shows [Td Ac] (a pair of Sixes)
zagaia011: shows [As Qd] (a pair of Sixes - Ace+King+Queen kicker)
zagaia011 collected 3130 from pot
*** SUMMARY ***
Total pot 3130 | Rake 0 
Board [6d Kh 7c 5c 6s]
Seat 1: Lucas0258 (big blind) folded before Flop
Seat 2: checkroom folded before Flop (didn't bet)
Seat 3: MathiasFer folded before Flop (didn't bet)
Seat 4: pedrostjr folded before Flop (didn't bet)
Seat 5: jcarlos.vale showed [Td Ac] and lost with a pair of Sixes
Seat 6: Praevus folded before Flop (didn't bet)
Seat 7: GosPanda folded before Flop (didn't bet)
Seat 8: zagaia011 (button) showed [As Qd] and won (3130) with a pair of Sixes
Seat 9: LuvPeec (small blind) folded before Flop



PokerStars Hand #221736955542: Tournament #3079057742, $0.98+$0.12 USD Hold'em No Limit - Level XII (200/400) - 2020/12/23 0:42:56 EET [2020/12/22 17:42:56 ET]
Table '3079057742 50' 9-max Seat #9 is the button
Seat 1: Lucas0258 (36420 in chips) 
Seat 2: checkroom (3043 in chips) 
Seat 3: MathiasFer (2112 in chips) is sitting out
Seat 4: pedrostjr (7920 in chips) 
Seat 5: jcarlos.vale (12847 in chips) 
Seat 6: Praevus (3698 in chips) 
Seat 7: GosPanda (16476 in chips) 
Seat 8: zagaia011 (15075 in chips) 
Seat 9: LuvPeec (10416 in chips) 
Lucas0258: posts the ante 50
checkroom: posts the ante 50
MathiasFer: posts the ante 50
pedrostjr: posts the ante 50
jcarlos.vale: posts the ante 50
Praevus: posts the ante 50
GosPanda: posts the ante 50
zagaia011: posts the ante 50
LuvPeec: posts the ante 50
Lucas0258: posts small blind 200
checkroom: posts big blind 400
*** HOLE CARDS ***
Dealt to jcarlos.vale [2d Qs]
MathiasFer: folds 
pedrostjr: folds 
jcarlos.vale: folds 
Praevus: folds 
GosPanda: folds 
zagaia011: folds 
LuvPeec: folds 
Lucas0258: raises 492 to 892
checkroom: raises 2101 to 2993 and is all-in
Lucas0258: folds 
Uncalled bet (2101) returned to checkroom
checkroom collected 2234 from pot
checkroom: doesn't show hand 
*** SUMMARY ***
Total pot 2234 | Rake 0 
Seat 1: Lucas0258 (small blind) folded before Flop
Seat 2: checkroom (big blind) collected (2234)
Seat 3: MathiasFer folded before Flop (didn't bet)
Seat 4: pedrostjr folded before Flop (didn't bet)
Seat 5: jcarlos.vale folded before Flop (didn't bet)
Seat 6: Praevus folded before Flop (didn't bet)
Seat 7: GosPanda folded before Flop (didn't bet)
Seat 8: zagaia011 folded before Flop (didn't bet)
Seat 9: LuvPeec (button) folded before Flop (didn't bet)



PokerStars Hand #221736985732: Tournament #3079057742, $0.98+$0.12 USD Hold'em No Limit - Level XIII (250/500) - 2020/12/23 0:43:45 EET [2020/12/22 17:43:45 ET]
Table '3079057742 50' 9-max Seat #1 is the button
Seat 1: Lucas0258 (35478 in chips) 
Seat 3: MathiasFer (2062 in chips) is sitting out
Seat 4: pedrostjr (7870 in chips) 
Seat 5: jcarlos.vale (12797 in chips) 
Seat 6: Praevus (3648 in chips) 
Seat 7: GosPanda (16426 in chips) 
Seat 8: zagaia011 (15025 in chips) 
Seat 9: LuvPeec (10366 in chips) 
Lucas0258: posts the ante 60
MathiasFer: posts the ante 60
pedrostjr: posts the ante 60
jcarlos.vale: posts the ante 60
Praevus: posts the ante 60
GosPanda: posts the ante 60
zagaia011: posts the ante 60
LuvPeec: posts the ante 60
MathiasFer: posts small blind 250
pedrostjr: posts big blind 500
*** HOLE CARDS ***
Dealt to jcarlos.vale [9h 3s]
jcarlos.vale: folds 
Praevus: folds 
GosPanda: raises 500 to 1000
zagaia011: folds 
LuvPeec: folds 
Lucas0258: folds 
MathiasFer: folds 
pedrostjr: folds 
Uncalled bet (500) returned to GosPanda
GosPanda collected 1730 from pot
GosPanda: doesn't show hand 
*** SUMMARY ***
Total pot 1730 | Rake 0 
Seat 1: Lucas0258 (button) folded before Flop (didn't bet)
Seat 3: MathiasFer (small blind) folded before Flop
Seat 4: pedrostjr (big blind) folded before Flop
Seat 5: jcarlos.vale folded before Flop (didn't bet)
Seat 6: Praevus folded before Flop (didn't bet)
Seat 7: GosPanda collected (1730)
Seat 8: zagaia011 folded before Flop (didn't bet)
Seat 9: LuvPeec folded before Flop (didn't bet)



PokerStars Hand #221737010911: Tournament #3079057742, $0.98+$0.12 USD Hold'em No Limit - Level XIII (250/500) - 2020/12/23 0:44:25 EET [2020/12/22 17:44:25 ET]
Table '3079057742 50' 9-max Seat #3 is the button
Seat 1: Lucas0258 (35418 in chips) 
Seat 3: MathiasFer (1752 in chips) is sitting out
Seat 4: pedrostjr (7310 in chips) 
Seat 5: jcarlos.vale (12737 in chips) 
Seat 6: Praevus (3588 in chips) 
Seat 7: GosPanda (17596 in chips) 
Seat 8: zagaia011 (14965 in chips) 
Seat 9: LuvPeec (10306 in chips) 
Lucas0258: posts the ante 60
MathiasFer: posts the ante 60
pedrostjr: posts the ante 60
jcarlos.vale: posts the ante 60
Praevus: posts the ante 60
GosPanda: posts the ante 60
zagaia011: posts the ante 60
LuvPeec: posts the ante 60
pedrostjr: posts small blind 250
jcarlos.vale: posts big blind 500
*** HOLE CARDS ***
Dealt to jcarlos.vale [6h 9s]
Praevus: folds 
GosPanda: folds 
zagaia011: folds 
LuvPeec: folds 
Lucas0258: folds 
MathiasFer: folds 
pedrostjr: raises 6750 to 7250 and is all-in
jcarlos.vale: folds 
Uncalled bet (6750) returned to pedrostjr
pedrostjr collected 1480 from pot
pedrostjr: doesn't show hand 
*** SUMMARY ***
Total pot 1480 | Rake 0 
Seat 1: Lucas0258 folded before Flop (didn't bet)
Seat 3: MathiasFer (button) folded before Flop (didn't bet)
Seat 4: pedrostjr (small blind) collected (1480)
Seat 5: jcarlos.vale (big blind) folded before Flop
Seat 6: Praevus folded before Flop (didn't bet)
Seat 7: GosPanda folded before Flop (didn't bet)
Seat 8: zagaia011 folded before Flop (didn't bet)
Seat 9: LuvPeec folded before Flop (didn't bet)



PokerStars Hand #221737032824: Tournament #3079057742, $0.98+$0.12 USD Hold'em No Limit - Level XIII (250/500) - 2020/12/23 0:45:00 EET [2020/12/22 17:45:00 ET]
Table '3079057742 50' 9-max Seat #4 is the button
Seat 1: Lucas0258 (35358 in chips) 
Seat 3: MathiasFer (1692 in chips) is sitting out
Seat 4: pedrostjr (8230 in chips) 
Seat 5: jcarlos.vale (12177 in chips) 
Seat 6: Praevus (3528 in chips) 
Seat 7: GosPanda (17536 in chips) 
Seat 8: zagaia011 (14905 in chips) 
Seat 9: LuvPeec (10246 in chips) 
Lucas0258: posts the ante 60
MathiasFer: posts the ante 60
pedrostjr: posts the ante 60
jcarlos.vale: posts the ante 60
Praevus: posts the ante 60
GosPanda: posts the ante 60
zagaia011: posts the ante 60
LuvPeec: posts the ante 60
jcarlos.vale: posts small blind 250
Praevus: posts big blind 500
*** HOLE CARDS ***
Dealt to jcarlos.vale [Qs 6d]
GosPanda: folds 
zagaia011: folds 
LuvPeec: folds 
Lucas0258: raises 545 to 1045
MathiasFer: folds 
pedrostjr: folds 
jcarlos.vale: folds 
Praevus: folds 
Uncalled bet (545) returned to Lucas0258
Lucas0258 collected 1730 from pot
*** SUMMARY ***
Total pot 1730 | Rake 0 
Seat 1: Lucas0258 collected (1730)
Seat 3: MathiasFer folded before Flop (didn't bet)
Seat 4: pedrostjr (button) folded before Flop (didn't bet)
Seat 5: jcarlos.vale (small blind) folded before Flop
Seat 6: Praevus (big blind) folded before Flop
Seat 7: GosPanda folded before Flop (didn't bet)
Seat 8: zagaia011 folded before Flop (didn't bet)
Seat 9: LuvPeec folded before Flop (didn't bet)



PokerStars Hand #221737051019: Tournament #3079057742, $0.98+$0.12 USD Hold'em No Limit - Level XIII (250/500) - 2020/12/23 0:45:30 EET [2020/12/22 17:45:30 ET]
Table '3079057742 50' 9-max Seat #5 is the button
Seat 1: Lucas0258 (36528 in chips) 
Seat 3: MathiasFer (1632 in chips) is sitting out
Seat 4: pedrostjr (8170 in chips) 
Seat 5: jcarlos.vale (11867 in chips) 
Seat 6: Praevus (2968 in chips) 
Seat 7: GosPanda (17476 in chips) 
Seat 8: zagaia011 (14845 in chips) 
Seat 9: LuvPeec (10186 in chips) 
Lucas0258: posts the ante 60
MathiasFer: posts the ante 60
pedrostjr: posts the ante 60
jcarlos.vale: posts the ante 60
Praevus: posts the ante 60
GosPanda: posts the ante 60
zagaia011: posts the ante 60
LuvPeec: posts the ante 60
Praevus: posts small blind 250
GosPanda: posts big blind 500
*** HOLE CARDS ***
Dealt to jcarlos.vale [7d Tc]
zagaia011: raises 500 to 1000
LuvPeec: folds 
Lucas0258: folds 
MathiasFer: folds 
pedrostjr: folds 
jcarlos.vale: folds 
Praevus: folds 
GosPanda: folds 
Uncalled bet (500) returned to zagaia011
zagaia011 collected 1730 from pot
zagaia011: doesn't show hand 
*** SUMMARY ***
Total pot 1730 | Rake 0 
Seat 1: Lucas0258 folded before Flop (didn't bet)
Seat 3: MathiasFer folded before Flop (didn't bet)
Seat 4: pedrostjr folded before Flop (didn't bet)
Seat 5: jcarlos.vale (button) folded before Flop (didn't bet)
Seat 6: Praevus (small blind) folded before Flop
Seat 7: GosPanda (big blind) folded before Flop
Seat 8: zagaia011 collected (1730)
Seat 9: LuvPeec folded before Flop (didn't bet)



PokerStars Hand #221737063875: Tournament #3079057742, $0.98+$0.12 USD Hold'em No Limit - Level XIII (250/500) - 2020/12/23 0:45:51 EET [2020/12/22 17:45:51 ET]
Table '3079057742 50' 9-max Seat #6 is the button
Seat 1: Lucas0258 (36468 in chips) 
Seat 3: MathiasFer (1572 in chips) is sitting out
Seat 4: pedrostjr (8110 in chips) 
Seat 5: jcarlos.vale (11807 in chips) 
Seat 6: Praevus (2658 in chips) 
Seat 7: GosPanda (16916 in chips) 
Seat 8: zagaia011 (16015 in chips) 
Seat 9: LuvPeec (10126 in chips) 
Lucas0258: posts the ante 60
MathiasFer: posts the ante 60
pedrostjr: posts the ante 60
jcarlos.vale: posts the ante 60
Praevus: posts the ante 60
GosPanda: posts the ante 60
zagaia011: posts the ante 60
LuvPeec: posts the ante 60
GosPanda: posts small blind 250
zagaia011: posts big blind 500
*** HOLE CARDS ***
Dealt to jcarlos.vale [2h 6s]
LuvPeec: folds 
Lucas0258: raises 545 to 1045
MathiasFer: folds 
pedrostjr: folds 
jcarlos.vale: folds 
Praevus: folds 
GosPanda: calls 795
zagaia011: folds 
*** FLOP *** [Ad 7d Td]
GosPanda: checks 
Lucas0258: bets 920
GosPanda: calls 920
*** TURN *** [Ad 7d Td] [4d]
GosPanda: checks 
Lucas0258: bets 1000
GosPanda: folds 
Uncalled bet (1000) returned to Lucas0258
Lucas0258 collected 4910 from pot
*** SUMMARY ***
Total pot 4910 | Rake 0 
Board [Ad 7d Td 4d]
Seat 1: Lucas0258 collected (4910)
Seat 3: MathiasFer folded before Flop (didn't bet)
Seat 4: pedrostjr folded before Flop (didn't bet)
Seat 5: jcarlos.vale folded before Flop (didn't bet)
Seat 6: Praevus (button) folded before Flop (didn't bet)
Seat 7: GosPanda (small blind) folded on the Turn
Seat 8: zagaia011 (big blind) folded before Flop
Seat 9: LuvPeec folded before Flop (didn't bet)



PokerStars Hand #221737102745: Tournament #3079057742, $0.98+$0.12 USD Hold'em No Limit - Level XIII (250/500) - 2020/12/23 0:46:54 EET [2020/12/22 17:46:54 ET]
Table '3079057742 50' 9-max Seat #7 is the button
Seat 1: Lucas0258 (39353 in chips) 
Seat 3: MathiasFer (1512 in chips) is sitting out
Seat 4: pedrostjr (8050 in chips) 
Seat 5: jcarlos.vale (11747 in chips) 
Seat 6: Praevus (2598 in chips) 
Seat 7: GosPanda (14891 in chips) 
Seat 8: zagaia011 (15455 in chips) 
Seat 9: LuvPeec (10066 in chips) 
Lucas0258: posts the ante 60
MathiasFer: posts the ante 60
pedrostjr: posts the ante 60
jcarlos.vale: posts the ante 60
Praevus: posts the ante 60
GosPanda: posts the ante 60
zagaia011: posts the ante 60
LuvPeec: posts the ante 60
zagaia011: posts small blind 250
LuvPeec: posts big blind 500
*** HOLE CARDS ***
Dealt to jcarlos.vale [3s 2d]
Lucas0258: raises 545 to 1045
MathiasFer: folds 
pedrostjr: folds 
jcarlos.vale: folds 
Praevus: folds 
GosPanda: folds 
zagaia011: folds 
LuvPeec: folds 
Uncalled bet (545) returned to Lucas0258
Lucas0258 collected 1730 from pot
*** SUMMARY ***
Total pot 1730 | Rake 0 
Seat 1: Lucas0258 collected (1730)
Seat 3: MathiasFer folded before Flop (didn't bet)
Seat 4: pedrostjr folded before Flop (didn't bet)
Seat 5: jcarlos.vale folded before Flop (didn't bet)
Seat 6: Praevus folded before Flop (didn't bet)
Seat 7: GosPanda (button) folded before Flop (didn't bet)
Seat 8: zagaia011 (small blind) folded before Flop
Seat 9: LuvPeec (big blind) folded before Flop



PokerStars Hand #221737152198: Tournament #3079057742, $0.98+$0.12 USD Hold'em No Limit - Level XIII (250/500) - 2020/12/23 0:48:17 EET [2020/12/22 17:48:17 ET]
Table '3079057742 50' 9-max Seat #8 is the button
Seat 1: Lucas0258 (40523 in chips) 
Seat 2: kemelok1 (1462 in chips) 
Seat 3: MathiasFer (1452 in chips) is sitting out
Seat 4: pedrostjr (7990 in chips) 
Seat 5: jcarlos.vale (11687 in chips) 
Seat 6: Praevus (2538 in chips) 
Seat 7: GosPanda (14831 in chips) 
Seat 8: zagaia011 (15145 in chips) 
Seat 9: LuvPeec (9506 in chips) 
Lucas0258: posts the ante 60
kemelok1: posts the ante 60
MathiasFer: posts the ante 60
pedrostjr: posts the ante 60
jcarlos.vale: posts the ante 60
Praevus: posts the ante 60
GosPanda: posts the ante 60
zagaia011: posts the ante 60
LuvPeec: posts the ante 60
LuvPeec: posts small blind 250
Lucas0258: posts big blind 500
*** HOLE CARDS ***
Dealt to jcarlos.vale [9d Qd]
kemelok1: folds 
MathiasFer: folds 
pedrostjr: raises 7430 to 7930 and is all-in
jcarlos.vale: folds 
Praevus: folds 
GosPanda: folds 
zagaia011: folds 
LuvPeec: folds 
Lucas0258: folds 
Uncalled bet (7430) returned to pedrostjr
pedrostjr collected 1790 from pot
pedrostjr: doesn't show hand 
*** SUMMARY ***
Total pot 1790 | Rake 0 
Seat 1: Lucas0258 (big blind) folded before Flop
Seat 2: kemelok1 folded before Flop (didn't bet)
Seat 3: MathiasFer folded before Flop (didn't bet)
Seat 4: pedrostjr collected (1790)
Seat 5: jcarlos.vale folded before Flop (didn't bet)
Seat 6: Praevus folded before Flop (didn't bet)
Seat 7: GosPanda folded before Flop (didn't bet)
Seat 8: zagaia011 (button) folded before Flop (didn't bet)
Seat 9: LuvPeec (small blind) folded before Flop



PokerStars Hand #221737178300: Tournament #3079057742, $0.98+$0.12 USD Hold'em No Limit - Level XIII (250/500) - 2020/12/23 0:49:00 EET [2020/12/22 17:49:00 ET]
Table '3079057742 50' 9-max Seat #9 is the button
Seat 1: Lucas0258 (39963 in chips) 
Seat 2: kemelok1 (1402 in chips) 
Seat 3: MathiasFer (1392 in chips) is sitting out
Seat 4: pedrostjr (9220 in chips) 
Seat 5: jcarlos.vale (11627 in chips) 
Seat 6: Praevus (2478 in chips) 
Seat 7: GosPanda (14771 in chips) 
Seat 8: zagaia011 (15085 in chips) 
Seat 9: LuvPeec (9196 in chips) 
Lucas0258: posts the ante 60
kemelok1: posts the ante 60
MathiasFer: posts the ante 60
pedrostjr: posts the ante 60
jcarlos.vale: posts the ante 60
Praevus: posts the ante 60
GosPanda: posts the ante 60
zagaia011: posts the ante 60
LuvPeec: posts the ante 60
Lucas0258: posts small blind 250
kemelok1: posts big blind 500
*** HOLE CARDS ***
Dealt to jcarlos.vale [7c 8h]
MathiasFer: folds 
pedrostjr: folds 
jcarlos.vale: folds 
Praevus: folds 
GosPanda: folds 
zagaia011: raises 500 to 1000
LuvPeec: calls 1000
Lucas0258: folds 
kemelok1: raises 342 to 1342 and is all-in
zagaia011: calls 342
LuvPeec: calls 342
*** FLOP *** [Jd 7d 6c]
zagaia011: bets 1830
LuvPeec: calls 1830
*** TURN *** [Jd 7d 6c] [4h]
zagaia011: bets 3221
LuvPeec: folds 
Uncalled bet (3221) returned to zagaia011
*** RIVER *** [Jd 7d 6c 4h] [7h]
*** SHOW DOWN ***
zagaia011: shows [Jh Kc] (two pair, Jacks and Sevens)
zagaia011 collected 3660 from side pot
kemelok1: shows [2c Qc] (a pair of Sevens)
zagaia011 collected 4816 from main pot
kemelok1 finished the tournament in 180th place and received $1.68.
*** SUMMARY ***
Total pot 8476 Main pot 4816. Side pot 3660. | Rake 0 
Board [Jd 7d 6c 4h 7h]
Seat 1: Lucas0258 (small blind) folded before Flop
Seat 2: kemelok1 (big blind) showed [2c Qc] and lost with a pair of Sevens
Seat 3: MathiasFer folded before Flop (didn't bet)
Seat 4: pedrostjr folded before Flop (didn't bet)
Seat 5: jcarlos.vale folded before Flop (didn't bet)
Seat 6: Praevus folded before Flop (didn't bet)
Seat 7: GosPanda folded before Flop (didn't bet)
Seat 8: zagaia011 showed [Jh Kc] and won (8476) with two pair, Jacks and Sevens
Seat 9: LuvPeec (button) folded on the Turn



PokerStars Hand #221737221419: Tournament #3079057742, $0.98+$0.12 USD Hold'em No Limit - Level XIII (250/500) - 2020/12/23 0:50:11 EET [2020/12/22 17:50:11 ET]
Table '3079057742 50' 9-max Seat #1 is the button
Seat 1: Lucas0258 (39653 in chips) 
Seat 3: MathiasFer (1332 in chips) is sitting out
Seat 4: pedrostjr (9160 in chips) 
Seat 5: jcarlos.vale (11567 in chips) 
Seat 6: Praevus (2418 in chips) 
Seat 7: GosPanda (14711 in chips) 
Seat 8: zagaia011 (20329 in chips) 
Seat 9: LuvPeec (5964 in chips) 
Lucas0258: posts the ante 60
MathiasFer: posts the ante 60
pedrostjr: posts the ante 60
jcarlos.vale: posts the ante 60
Praevus: posts the ante 60
GosPanda: posts the ante 60
zagaia011: posts the ante 60
LuvPeec: posts the ante 60
MathiasFer: posts small blind 250
pedrostjr: posts big blind 500
*** HOLE CARDS ***
Dealt to jcarlos.vale [5s Ad]
jcarlos.vale: folds 
Praevus: folds 
GosPanda: raises 500 to 1000
zagaia011: folds 
LuvPeec: folds 
Lucas0258: folds 
MathiasFer: folds 
pedrostjr: folds 
Uncalled bet (500) returned to GosPanda
GosPanda collected 1730 from pot
GosPanda: doesn't show hand 
*** SUMMARY ***
Total pot 1730 | Rake 0 
Seat 1: Lucas0258 (button) folded before Flop (didn't bet)
Seat 3: MathiasFer (small blind) folded before Flop
Seat 4: pedrostjr (big blind) folded before Flop
Seat 5: jcarlos.vale folded before Flop (didn't bet)
Seat 6: Praevus folded before Flop (didn't bet)
Seat 7: GosPanda collected (1730)
Seat 8: zagaia011 folded before Flop (didn't bet)
Seat 9: LuvPeec folded before Flop (didn't bet)



PokerStars Hand #221737231594: Tournament #3079057742, $0.98+$0.12 USD Hold'em No Limit - Level XIII (250/500) - 2020/12/23 0:50:27 EET [2020/12/22 17:50:27 ET]
Table '3079057742 50' 9-max Seat #3 is the button
Seat 1: Lucas0258 (39593 in chips) 
Seat 3: MathiasFer (1022 in chips) is sitting out
Seat 4: pedrostjr (8600 in chips) 
Seat 5: jcarlos.vale (11507 in chips) 
Seat 6: Praevus (2358 in chips) 
Seat 7: GosPanda (15881 in chips) 
Seat 8: zagaia011 (20269 in chips) 
Seat 9: LuvPeec (5904 in chips) 
Lucas0258: posts the ante 60
MathiasFer: posts the ante 60
pedrostjr: posts the ante 60
jcarlos.vale: posts the ante 60
Praevus: posts the ante 60
GosPanda: posts the ante 60
zagaia011: posts the ante 60
LuvPeec: posts the ante 60
pedrostjr: posts small blind 250
jcarlos.vale: posts big blind 500
*** HOLE CARDS ***
Dealt to jcarlos.vale [7h 3s]
Praevus: folds 
GosPanda: folds 
zagaia011: folds 
LuvPeec: folds 
Lucas0258: raises 545 to 1045
MathiasFer: folds 
pedrostjr: folds 
jcarlos.vale: folds 
Uncalled bet (545) returned to Lucas0258
Lucas0258 collected 1730 from pot
*** SUMMARY ***
Total pot 1730 | Rake 0 
Seat 1: Lucas0258 collected (1730)
Seat 3: MathiasFer (button) folded before Flop (didn't bet)
Seat 4: pedrostjr (small blind) folded before Flop
Seat 5: jcarlos.vale (big blind) folded before Flop
Seat 6: Praevus folded before Flop (didn't bet)
Seat 7: GosPanda folded before Flop (didn't bet)
Seat 8: zagaia011 folded before Flop (didn't bet)
Seat 9: LuvPeec folded before Flop (didn't bet)



PokerStars Hand #221737240833: Tournament #3079057742, $0.98+$0.12 USD Hold'em No Limit - Level XIII (250/500) - 2020/12/23 0:50:42 EET [2020/12/22 17:50:42 ET]
Table '3079057742 50' 9-max Seat #4 is the button
Seat 1: Lucas0258 (40763 in chips) 
Seat 3: MathiasFer (962 in chips) is sitting out
Seat 4: pedrostjr (8290 in chips) 
Seat 5: jcarlos.vale (10947 in chips) 
Seat 6: Praevus (2298 in chips) 
Seat 7: GosPanda (15821 in chips) 
Seat 8: zagaia011 (20209 in chips) 
Seat 9: LuvPeec (5844 in chips) 
Lucas0258: posts the ante 60
MathiasFer: posts the ante 60
pedrostjr: posts the ante 60
jcarlos.vale: posts the ante 60
Praevus: posts the ante 60
GosPanda: posts the ante 60
zagaia011: posts the ante 60
LuvPeec: posts the ante 60
jcarlos.vale: posts small blind 250
Praevus: posts big blind 500
*** HOLE CARDS ***
Dealt to jcarlos.vale [3c Kc]
GosPanda: folds 
zagaia011: folds 
LuvPeec: raises 5284 to 5784 and is all-in
Lucas0258: folds 
MathiasFer: folds 
pedrostjr: folds 
jcarlos.vale: folds 
Praevus: calls 1738 and is all-in
Uncalled bet (3546) returned to LuvPeec
*** FLOP *** [Jd Qh 4h]
*** TURN *** [Jd Qh 4h] [4d]
*** RIVER *** [Jd Qh 4h 4d] [7c]
*** SHOW DOWN ***
Praevus: shows [7s Ac] (two pair, Sevens and Fours)
LuvPeec: shows [9d 9s] (two pair, Nines and Fours)
LuvPeec collected 5206 from pot
Praevus finished the tournament in 171st place and received $1.68.
*** SUMMARY ***
Total pot 5206 | Rake 0 
Board [Jd Qh 4h 4d 7c]
Seat 1: Lucas0258 folded before Flop (didn't bet)
Seat 3: MathiasFer folded before Flop (didn't bet)
Seat 4: pedrostjr (button) folded before Flop (didn't bet)
Seat 5: jcarlos.vale (small blind) folded before Flop
Seat 6: Praevus (big blind) showed [7s Ac] and lost with two pair, Sevens and Fours
Seat 7: GosPanda folded before Flop (didn't bet)
Seat 8: zagaia011 folded before Flop (didn't bet)
Seat 9: LuvPeec showed [9d 9s] and won (5206) with two pair, Nines and Fours



PokerStars Hand #221737263308: Tournament #3079057742, $0.98+$0.12 USD Hold'em No Limit - Level XIII (250/500) - 2020/12/23 0:51:19 EET [2020/12/22 17:51:19 ET]
Table '3079057742 50' 9-max Seat #5 is the button
Seat 1: Lucas0258 (40703 in chips) 
Seat 2: ruccos384 (13677 in chips) 
Seat 3: MathiasFer (902 in chips) is sitting out
Seat 4: pedrostjr (8230 in chips) 
Seat 5: jcarlos.vale (10637 in chips) 
Seat 7: GosPanda (15761 in chips) 
Seat 8: zagaia011 (20149 in chips) 
Seat 9: LuvPeec (8752 in chips) 
Lucas0258: posts the ante 60
ruccos384: posts the ante 60
MathiasFer: posts the ante 60
pedrostjr: posts the ante 60
jcarlos.vale: posts the ante 60
GosPanda: posts the ante 60
zagaia011: posts the ante 60
LuvPeec: posts the ante 60
GosPanda: posts small blind 250
zagaia011: posts big blind 500
*** HOLE CARDS ***
Dealt to jcarlos.vale [9d 2h]
LuvPeec: folds 
Lucas0258: folds 
ruccos384: folds 
MathiasFer: folds 
pedrostjr: raises 610 to 1110
jcarlos.vale: folds 
GosPanda: folds 
zagaia011: folds 
Uncalled bet (610) returned to pedrostjr
pedrostjr collected 1730 from pot
pedrostjr: doesn't show hand 
*** SUMMARY ***
Total pot 1730 | Rake 0 
Seat 1: Lucas0258 folded before Flop (didn't bet)
Seat 2: ruccos384 folded before Flop (didn't bet)
Seat 3: MathiasFer folded before Flop (didn't bet)
Seat 4: pedrostjr collected (1730)
Seat 5: jcarlos.vale (button) folded before Flop (didn't bet)
Seat 7: GosPanda (small blind) folded before Flop
Seat 8: zagaia011 (big blind) folded before Flop
Seat 9: LuvPeec folded before Flop (didn't bet)



PokerStars Hand #221737273956: Tournament #3079057742, $0.98+$0.12 USD Hold'em No Limit - Level XIII (250/500) - 2020/12/23 0:51:37 EET [2020/12/22 17:51:37 ET]
Table '3079057742 50' 9-max Seat #7 is the button
Seat 1: Lucas0258 (40643 in chips) 
Seat 2: ruccos384 (13617 in chips) 
Seat 3: MathiasFer (842 in chips) is sitting out
Seat 4: pedrostjr (9400 in chips) 
Seat 5: jcarlos.vale (10577 in chips) 
Seat 7: GosPanda (15451 in chips) 
Seat 8: zagaia011 (19589 in chips) 
Seat 9: LuvPeec (8692 in chips) 
Lucas0258: posts the ante 60
ruccos384: posts the ante 60
MathiasFer: posts the ante 60
pedrostjr: posts the ante 60
jcarlos.vale: posts the ante 60
GosPanda: posts the ante 60
zagaia011: posts the ante 60
LuvPeec: posts the ante 60
zagaia011: posts small blind 250
LuvPeec: posts big blind 500
*** HOLE CARDS ***
Dealt to jcarlos.vale [2s Ac]
Lucas0258: folds 
ruccos384: folds 
MathiasFer: folds 
pedrostjr: folds 
jcarlos.vale: folds 
GosPanda: raises 500 to 1000
zagaia011: folds 
LuvPeec: calls 500
*** FLOP *** [9s Jc 3d]
LuvPeec: checks 
GosPanda: bets 750
LuvPeec: folds 
Uncalled bet (750) returned to GosPanda
GosPanda collected 2730 from pot
GosPanda: doesn't show hand 
*** SUMMARY ***
Total pot 2730 | Rake 0 
Board [9s Jc 3d]
Seat 1: Lucas0258 folded before Flop (didn't bet)
Seat 2: ruccos384 folded before Flop (didn't bet)
Seat 3: MathiasFer folded before Flop (didn't bet)
Seat 4: pedrostjr folded before Flop (didn't bet)
Seat 5: jcarlos.vale folded before Flop (didn't bet)
Seat 7: GosPanda (button) collected (2730)
Seat 8: zagaia011 (small blind) folded before Flop
Seat 9: LuvPeec (big blind) folded on the Flop



PokerStars Hand #221737297721: Tournament #3079057742, $0.98+$0.12 USD Hold'em No Limit - Level XIII (250/500) - 2020/12/23 0:52:16 EET [2020/12/22 17:52:16 ET]
Table '3079057742 50' 9-max Seat #8 is the button
Seat 1: Lucas0258 (40583 in chips) 
Seat 2: ruccos384 (13557 in chips) 
Seat 3: MathiasFer (782 in chips) is sitting out
Seat 4: pedrostjr (9340 in chips) 
Seat 5: jcarlos.vale (10517 in chips) 
Seat 7: GosPanda (17121 in chips) 
Seat 8: zagaia011 (19279 in chips) 
Seat 9: LuvPeec (7632 in chips) 
Lucas0258: posts the ante 60
ruccos384: posts the ante 60
MathiasFer: posts the ante 60
pedrostjr: posts the ante 60
jcarlos.vale: posts the ante 60
GosPanda: posts the ante 60
zagaia011: posts the ante 60
LuvPeec: posts the ante 60
LuvPeec: posts small blind 250
Lucas0258: posts big blind 500
*** HOLE CARDS ***
Dealt to jcarlos.vale [Th Qc]
ruccos384: folds 
MathiasFer: folds 
pedrostjr: folds 
jcarlos.vale: folds 
GosPanda: calls 500
zagaia011: folds 
LuvPeec: folds 
Lucas0258: checks 
*** FLOP *** [5h Jc Kc]
Lucas0258: checks 
GosPanda: bets 500
Lucas0258: raises 800 to 1300
GosPanda: folds 
Uncalled bet (800) returned to Lucas0258
Lucas0258 collected 2730 from pot
Lucas0258: doesn't show hand 
*** SUMMARY ***
Total pot 2730 | Rake 0 
Board [5h Jc Kc]
Seat 1: Lucas0258 (big blind) collected (2730)
Seat 2: ruccos384 folded before Flop (didn't bet)
Seat 3: MathiasFer folded before Flop (didn't bet)
Seat 4: pedrostjr folded before Flop (didn't bet)
Seat 5: jcarlos.vale folded before Flop (didn't bet)
Seat 7: GosPanda folded on the Flop
Seat 8: zagaia011 (button) folded before Flop (didn't bet)
Seat 9: LuvPeec (small blind) folded before Flop



PokerStars Hand #221737323868: Tournament #3079057742, $0.98+$0.12 USD Hold'em No Limit - Level XIII (250/500) - 2020/12/23 0:53:00 EET [2020/12/22 17:53:00 ET]
Table '3079057742 50' 9-max Seat #9 is the button
Seat 1: Lucas0258 (42253 in chips) 
Seat 2: ruccos384 (13497 in chips) 
Seat 3: MathiasFer (722 in chips) is sitting out
Seat 4: pedrostjr (9280 in chips) 
Seat 5: jcarlos.vale (10457 in chips) 
Seat 6: AriFawkes (14221 in chips) 
Seat 7: GosPanda (16061 in chips) 
Seat 8: zagaia011 (19219 in chips) 
Seat 9: LuvPeec (7322 in chips) 
Lucas0258: posts the ante 60
ruccos384: posts the ante 60
MathiasFer: posts the ante 60
pedrostjr: posts the ante 60
jcarlos.vale: posts the ante 60
AriFawkes: posts the ante 60
GosPanda: posts the ante 60
zagaia011: posts the ante 60
LuvPeec: posts the ante 60
Lucas0258: posts small blind 250
ruccos384: posts big blind 500
*** HOLE CARDS ***
Dealt to jcarlos.vale [4s 9c]
MathiasFer: folds 
pedrostjr: folds 
jcarlos.vale: folds 
AriFawkes: folds 
GosPanda: folds 
zagaia011: folds 
LuvPeec: raises 1000 to 1500
Lucas0258: folds 
ruccos384: raises 11937 to 13437 and is all-in
LuvPeec: calls 5762 and is all-in
Uncalled bet (6175) returned to ruccos384
*** FLOP *** [9h 6c 2c]
*** TURN *** [9h 6c 2c] [Ac]
*** RIVER *** [9h 6c 2c Ac] [7c]
*** SHOW DOWN ***
ruccos384: shows [Js As] (a pair of Aces)
LuvPeec: shows [4c 4h] (a flush, Ace high)
LuvPeec collected 15314 from pot
*** SUMMARY ***
Total pot 15314 | Rake 0 
Board [9h 6c 2c Ac 7c]
Seat 1: Lucas0258 (small blind) folded before Flop
Seat 2: ruccos384 (big blind) showed [Js As] and lost with a pair of Aces
Seat 3: MathiasFer folded before Flop (didn't bet)
Seat 4: pedrostjr folded before Flop (didn't bet)
Seat 5: jcarlos.vale folded before Flop (didn't bet)
Seat 6: AriFawkes folded before Flop (didn't bet)
Seat 7: GosPanda folded before Flop (didn't bet)
Seat 8: zagaia011 folded before Flop (didn't bet)
Seat 9: LuvPeec (button) showed [4c 4h] and won (15314) with a flush, Ace high



PokerStars Hand #221737349649: Tournament #3079057742, $0.98+$0.12 USD Hold'em No Limit - Level XIV (300/600) - 2020/12/23 0:53:43 EET [2020/12/22 17:53:43 ET]
Table '3079057742 50' 9-max Seat #1 is the button
Seat 1: Lucas0258 (41943 in chips) 
Seat 2: ruccos384 (6175 in chips) 
Seat 3: MathiasFer (662 in chips) is sitting out
Seat 4: pedrostjr (9220 in chips) 
Seat 5: jcarlos.vale (10397 in chips) 
Seat 6: AriFawkes (14161 in chips) 
Seat 7: GosPanda (16001 in chips) 
Seat 8: zagaia011 (19159 in chips) 
Seat 9: LuvPeec (15314 in chips) 
Lucas0258: posts the ante 70
ruccos384: posts the ante 70
MathiasFer: posts the ante 70
pedrostjr: posts the ante 70
jcarlos.vale: posts the ante 70
AriFawkes: posts the ante 70
GosPanda: posts the ante 70
zagaia011: posts the ante 70
LuvPeec: posts the ante 70
ruccos384: posts small blind 300
MathiasFer: posts big blind 592 and is all-in
*** HOLE CARDS ***
Dealt to jcarlos.vale [2h 2c]
pedrostjr: folds 
jcarlos.vale: folds 
AriFawkes: folds 
GosPanda: raises 608 to 1200
zagaia011: folds 
LuvPeec: folds 
Lucas0258: folds 
ruccos384: raises 4905 to 6105 and is all-in
MathiasFer: folds 
GosPanda: calls 4905
*** FLOP *** [3d 4h 4d]
*** TURN *** [3d 4h 4d] [Js]
*** RIVER *** [3d 4h 4d Js] [Ac]
*** SHOW DOWN ***
ruccos384: shows [7s Ad] (two pair, Aces and Fours)
GosPanda: shows [Kd Qs] (a pair of Fours)
ruccos384 collected 13432 from pot
MathiasFer finished the tournament in 155th place and received $1.68.
*** SUMMARY ***
Total pot 13432 | Rake 0 
Board [3d 4h 4d Js Ac]
Seat 1: Lucas0258 (button) folded before Flop (didn't bet)
Seat 2: ruccos384 (small blind) showed [7s Ad] and won (13432) with two pair, Aces and Fours
Seat 3: MathiasFer (big blind) folded before Flop
Seat 4: pedrostjr folded before Flop (didn't bet)
Seat 5: jcarlos.vale folded before Flop (didn't bet)
Seat 6: AriFawkes folded before Flop (didn't bet)
Seat 7: GosPanda showed [Kd Qs] and lost with a pair of Fours
Seat 8: zagaia011 folded before Flop (didn't bet)
Seat 9: LuvPeec folded before Flop (didn't bet)



PokerStars Hand #221737368281: Tournament #3079057742, $0.98+$0.12 USD Hold'em No Limit - Level XIV (300/600) - 2020/12/23 0:54:15 EET [2020/12/22 17:54:15 ET]
Table '3079057742 50' 9-max Seat #2 is the button
Seat 1: Lucas0258 (41873 in chips) 
Seat 2: ruccos384 (13432 in chips) 
Seat 4: pedrostjr (9150 in chips) 
Seat 5: jcarlos.vale (10327 in chips) 
Seat 6: AriFawkes (14091 in chips) 
Seat 7: GosPanda (9826 in chips) 
Seat 8: zagaia011 (19089 in chips) 
Seat 9: LuvPeec (15244 in chips) 
Lucas0258: posts the ante 70
ruccos384: posts the ante 70
pedrostjr: posts the ante 70
jcarlos.vale: posts the ante 70
AriFawkes: posts the ante 70
GosPanda: posts the ante 70
zagaia011: posts the ante 70
LuvPeec: posts the ante 70
pedrostjr: posts small blind 300
jcarlos.vale: posts big blind 600
*** HOLE CARDS ***
Dealt to jcarlos.vale [4d 4s]
AriFawkes: folds 
GosPanda: folds 
zagaia011: folds 
LuvPeec: folds 
Lucas0258: raises 654 to 1254
ruccos384: folds 
pedrostjr: folds 
jcarlos.vale: raises 9003 to 10257 and is all-in
Lucas0258: folds 
Uncalled bet (9003) returned to jcarlos.vale
jcarlos.vale collected 3368 from pot
jcarlos.vale: doesn't show hand 
*** SUMMARY ***
Total pot 3368 | Rake 0 
Seat 1: Lucas0258 folded before Flop
Seat 2: ruccos384 (button) folded before Flop (didn't bet)
Seat 4: pedrostjr (small blind) folded before Flop
Seat 5: jcarlos.vale (big blind) collected (3368)
Seat 6: AriFawkes folded before Flop (didn't bet)
Seat 7: GosPanda folded before Flop (didn't bet)
Seat 8: zagaia011 folded before Flop (didn't bet)
Seat 9: LuvPeec folded before Flop (didn't bet)



PokerStars Hand #221737381738: Tournament #3079057742, $0.98+$0.12 USD Hold'em No Limit - Level XIV (300/600) - 2020/12/23 0:54:38 EET [2020/12/22 17:54:38 ET]
Table '3079057742 50' 9-max Seat #4 is the button
Seat 1: Lucas0258 (40549 in chips) 
Seat 2: ruccos384 (13362 in chips) 
Seat 3: mesca27 (9489 in chips) 
Seat 4: pedrostjr (8780 in chips) 
Seat 5: jcarlos.vale (12371 in chips) 
Seat 6: AriFawkes (14021 in chips) 
Seat 7: GosPanda (9756 in chips) 
Seat 8: zagaia011 (19019 in chips) 
Seat 9: LuvPeec (15174 in chips) 
Lucas0258: posts the ante 70
ruccos384: posts the ante 70
mesca27: posts the ante 70
pedrostjr: posts the ante 70
jcarlos.vale: posts the ante 70
AriFawkes: posts the ante 70
GosPanda: posts the ante 70
zagaia011: posts the ante 70
LuvPeec: posts the ante 70
jcarlos.vale: posts small blind 300
AriFawkes: posts big blind 600
*** HOLE CARDS ***
Dealt to jcarlos.vale [4c 4s]
GosPanda: folds 
zagaia011: folds 
LuvPeec: folds 
Lucas0258: folds 
ruccos384: folds 
mesca27: raises 720 to 1320
pedrostjr: folds 
jcarlos.vale: folds 
AriFawkes: calls 720
*** FLOP *** [5h 3s 5s]
AriFawkes: checks 
mesca27: bets 1200
Lucas0258 is sitting out
AriFawkes: folds 
Uncalled bet (1200) returned to mesca27
mesca27 collected 3570 from pot
mesca27: doesn't show hand 
*** SUMMARY ***
Total pot 3570 | Rake 0 
Board [5h 3s 5s]
Seat 1: Lucas0258 folded before Flop (didn't bet)
Seat 2: ruccos384 folded before Flop (didn't bet)
Seat 3: mesca27 collected (3570)
Seat 4: pedrostjr (button) folded before Flop (didn't bet)
Seat 5: jcarlos.vale (small blind) folded before Flop
Seat 6: AriFawkes (big blind) folded on the Flop
Seat 7: GosPanda folded before Flop (didn't bet)
Seat 8: zagaia011 folded before Flop (didn't bet)
Seat 9: LuvPeec folded before Flop (didn't bet)



PokerStars Hand #221737624184: Tournament #3079057742, $0.98+$0.12 USD Hold'em No Limit - Level XIV (300/600) - 2020/12/23 1:02:32 EET [2020/12/22 18:02:32 ET]
Table '3079057742 50' 9-max Seat #5 is the button
Seat 1: Lucas0258 (40479 in chips) 
Seat 2: ruccos384 (13292 in chips) 
Seat 3: mesca27 (11669 in chips) 
Seat 4: pedrostjr (8710 in chips) 
Seat 5: jcarlos.vale (12001 in chips) 
Seat 6: AriFawkes (12631 in chips) 
Seat 7: GosPanda (9686 in chips) 
Seat 8: zagaia011 (18949 in chips) is sitting out
Seat 9: LuvPeec (15104 in chips) 
Lucas0258: posts the ante 70
ruccos384: posts the ante 70
mesca27: posts the ante 70
pedrostjr: posts the ante 70
jcarlos.vale: posts the ante 70
AriFawkes: posts the ante 70
GosPanda: posts the ante 70
zagaia011: posts the ante 70
LuvPeec: posts the ante 70
AriFawkes: posts small blind 300
GosPanda: posts big blind 600
*** HOLE CARDS ***
Dealt to jcarlos.vale [Th Jd]
zagaia011: folds 
LuvPeec: folds 
Lucas0258: folds 
ruccos384: raises 600 to 1200
mesca27: folds 
pedrostjr: folds 
jcarlos.vale: folds 
AriFawkes: folds 
GosPanda: calls 600
*** FLOP *** [Qc Qs Ts]
GosPanda: checks 
ruccos384: bets 1099
GosPanda: folds 
Uncalled bet (1099) returned to ruccos384
ruccos384 collected 3330 from pot
*** SUMMARY ***
Total pot 3330 | Rake 0 
Board [Qc Qs Ts]
Seat 1: Lucas0258 folded before Flop (didn't bet)
Seat 2: ruccos384 collected (3330)
Seat 3: mesca27 folded before Flop (didn't bet)
Seat 4: pedrostjr folded before Flop (didn't bet)
Seat 5: jcarlos.vale (button) folded before Flop (didn't bet)
Seat 6: AriFawkes (small blind) folded before Flop
Seat 7: GosPanda (big blind) folded on the Flop
Seat 8: zagaia011 folded before Flop (didn't bet)
Seat 9: LuvPeec folded before Flop (didn't bet)



PokerStars Hand #221737660280: Tournament #3079057742, $0.98+$0.12 USD Hold'em No Limit - Level XIV (300/600) - 2020/12/23 1:03:34 EET [2020/12/22 18:03:34 ET]
Table '3079057742 50' 9-max Seat #6 is the button
Seat 1: Lucas0258 (40409 in chips) 
Seat 2: ruccos384 (15352 in chips) 
Seat 3: mesca27 (11599 in chips) 
Seat 4: pedrostjr (8640 in chips) 
Seat 5: jcarlos.vale (11931 in chips) 
Seat 6: AriFawkes (12261 in chips) 
Seat 7: GosPanda (8416 in chips) 
Seat 8: zagaia011 (18879 in chips) is sitting out
Seat 9: LuvPeec (15034 in chips) 
Lucas0258: posts the ante 70
ruccos384: posts the ante 70
mesca27: posts the ante 70
pedrostjr: posts the ante 70
jcarlos.vale: posts the ante 70
AriFawkes: posts the ante 70
GosPanda: posts the ante 70
zagaia011: posts the ante 70
LuvPeec: posts the ante 70
GosPanda: posts small blind 300
zagaia011: posts big blind 600
*** HOLE CARDS ***
Dealt to jcarlos.vale [4s 9d]
LuvPeec: folds 
Lucas0258: folds 
ruccos384: folds 
mesca27: folds 
pedrostjr: folds 
jcarlos.vale: folds 
AriFawkes: folds 
GosPanda: raises 600 to 1200
zagaia011: folds 
Uncalled bet (600) returned to GosPanda
GosPanda collected 1830 from pot
GosPanda: doesn't show hand 
*** SUMMARY ***
Total pot 1830 | Rake 0 
Seat 1: Lucas0258 folded before Flop (didn't bet)
Seat 2: ruccos384 folded before Flop (didn't bet)
Seat 3: mesca27 folded before Flop (didn't bet)
Seat 4: pedrostjr folded before Flop (didn't bet)
Seat 5: jcarlos.vale folded before Flop (didn't bet)
Seat 6: AriFawkes (button) folded before Flop (didn't bet)
Seat 7: GosPanda (small blind) collected (1830)
Seat 8: zagaia011 (big blind) folded before Flop
Seat 9: LuvPeec folded before Flop (didn't bet)



PokerStars Hand #221737670297: Tournament #3079057742, $0.98+$0.12 USD Hold'em No Limit - Level XIV (300/600) - 2020/12/23 1:03:51 EET [2020/12/22 18:03:51 ET]
Table '3079057742 50' 9-max Seat #7 is the button
Seat 1: Lucas0258 (40339 in chips) 
Seat 2: ruccos384 (15282 in chips) 
Seat 3: mesca27 (11529 in chips) 
Seat 4: pedrostjr (8570 in chips) 
Seat 5: jcarlos.vale (11861 in chips) 
Seat 6: AriFawkes (12191 in chips) 
Seat 7: GosPanda (9576 in chips) 
Seat 8: zagaia011 (18209 in chips) is sitting out
Seat 9: LuvPeec (14964 in chips) 
Lucas0258: posts the ante 70
ruccos384: posts the ante 70
mesca27: posts the ante 70
pedrostjr: posts the ante 70
jcarlos.vale: posts the ante 70
AriFawkes: posts the ante 70
GosPanda: posts the ante 70
zagaia011: posts the ante 70
LuvPeec: posts the ante 70
zagaia011: posts small blind 300
LuvPeec: posts big blind 600
*** HOLE CARDS ***
Dealt to jcarlos.vale [Th Jd]
Lucas0258: folds 
ruccos384: folds 
mesca27: raises 1200 to 1800
pedrostjr: folds 
jcarlos.vale: folds 
AriFawkes: folds 
GosPanda: folds 
zagaia011: folds 
LuvPeec: calls 1200
*** FLOP *** [7d Kh 2h]
LuvPeec: checks 
mesca27: bets 1800
LuvPeec: folds 
Uncalled bet (1800) returned to mesca27
mesca27 collected 4530 from pot
mesca27: doesn't show hand 
*** SUMMARY ***
Total pot 4530 | Rake 0 
Board [7d Kh 2h]
Seat 1: Lucas0258 folded before Flop (didn't bet)
Seat 2: ruccos384 folded before Flop (didn't bet)
Seat 3: mesca27 collected (4530)
Seat 4: pedrostjr folded before Flop (didn't bet)
Seat 5: jcarlos.vale folded before Flop (didn't bet)
Seat 6: AriFawkes folded before Flop (didn't bet)
Seat 7: GosPanda (button) folded before Flop (didn't bet)
Seat 8: zagaia011 (small blind) folded before Flop
Seat 9: LuvPeec (big blind) folded on the Flop



PokerStars Hand #221737694683: Tournament #3079057742, $0.98+$0.12 USD Hold'em No Limit - Level XIV (300/600) - 2020/12/23 1:04:33 EET [2020/12/22 18:04:33 ET]
Table '3079057742 50' 9-max Seat #8 is the button
Seat 1: Lucas0258 (40269 in chips) 
Seat 2: ruccos384 (15212 in chips) 
Seat 3: mesca27 (14189 in chips) 
Seat 4: pedrostjr (8500 in chips) 
Seat 5: jcarlos.vale (11791 in chips) 
Seat 6: AriFawkes (12121 in chips) 
Seat 7: GosPanda (9506 in chips) 
Seat 8: zagaia011 (17839 in chips) is sitting out
Seat 9: LuvPeec (13094 in chips) 
Lucas0258: posts the ante 70
ruccos384: posts the ante 70
mesca27: posts the ante 70
pedrostjr: posts the ante 70
jcarlos.vale: posts the ante 70
AriFawkes: posts the ante 70
GosPanda: posts the ante 70
zagaia011: posts the ante 70
LuvPeec: posts the ante 70
LuvPeec: posts small blind 300
Lucas0258: posts big blind 600
*** HOLE CARDS ***
Dealt to jcarlos.vale [6h 7s]
zagaia011 has returned
ruccos384: folds 
mesca27: folds 
pedrostjr: folds 
jcarlos.vale: folds 
AriFawkes: folds 
GosPanda: raises 8836 to 9436 and is all-in
zagaia011: folds 
LuvPeec: folds 
Lucas0258: calls 8836
*** FLOP *** [2c 5c 9s]
*** TURN *** [2c 5c 9s] [Jc]
*** RIVER *** [2c 5c 9s Jc] [Kh]
*** SHOW DOWN ***
Lucas0258: shows [Kd Ah] (a pair of Kings)
GosPanda: shows [9d 8h] (a pair of Nines)
Lucas0258 collected 19802 from pot
GosPanda finished the tournament in 148th place and received $1.68.
*** SUMMARY ***
Total pot 19802 | Rake 0 
Board [2c 5c 9s Jc Kh]
Seat 1: Lucas0258 (big blind) showed [Kd Ah] and won (19802) with a pair of Kings
Seat 2: ruccos384 folded before Flop (didn't bet)
Seat 3: mesca27 folded before Flop (didn't bet)
Seat 4: pedrostjr folded before Flop (didn't bet)
Seat 5: jcarlos.vale folded before Flop (didn't bet)
Seat 6: AriFawkes folded before Flop (didn't bet)
Seat 7: GosPanda showed [9d 8h] and lost with a pair of Nines
Seat 8: zagaia011 (button) folded before Flop (didn't bet)
Seat 9: LuvPeec (small blind) folded before Flop



PokerStars Hand #221737712646: Tournament #3079057742, $0.98+$0.12 USD Hold'em No Limit - Level XIV (300/600) - 2020/12/23 1:05:04 EET [2020/12/22 18:05:04 ET]
Table '3079057742 50' 9-max Seat #9 is the button
Seat 1: Lucas0258 (50565 in chips) 
Seat 2: ruccos384 (15142 in chips) 
Seat 3: mesca27 (14119 in chips) 
Seat 4: pedrostjr (8430 in chips) 
Seat 5: jcarlos.vale (11721 in chips) 
Seat 6: AriFawkes (12051 in chips) 
Seat 8: zagaia011 (17769 in chips) 
Seat 9: LuvPeec (12724 in chips) 
Lucas0258: posts the ante 70
ruccos384: posts the ante 70
mesca27: posts the ante 70
pedrostjr: posts the ante 70
jcarlos.vale: posts the ante 70
AriFawkes: posts the ante 70
zagaia011: posts the ante 70
LuvPeec: posts the ante 70
Lucas0258: posts small blind 300
ruccos384: posts big blind 600
*** HOLE CARDS ***
Dealt to jcarlos.vale [8d 5h]
mesca27: folds 
pedrostjr: folds 
jcarlos.vale: folds 
AriFawkes: folds 
zagaia011: folds 
LuvPeec: folds 
Lucas0258: raises 900 to 1500
ruccos384: calls 900
*** FLOP *** [9c 6s 7h]
Lucas0258: checks 
ruccos384: bets 1175
Lucas0258: calls 1175
*** TURN *** [9c 6s 7h] [Kh]
Lucas0258: checks 
ruccos384: bets 1950
Lucas0258: folds 
Uncalled bet (1950) returned to ruccos384
ruccos384 collected 5910 from pot
*** SUMMARY ***
Total pot 5910 | Rake 0 
Board [9c 6s 7h Kh]
Seat 1: Lucas0258 (small blind) folded on the Turn
Seat 2: ruccos384 (big blind) collected (5910)
Seat 3: mesca27 folded before Flop (didn't bet)
Seat 4: pedrostjr folded before Flop (didn't bet)
Seat 5: jcarlos.vale folded before Flop (didn't bet)
Seat 6: AriFawkes folded before Flop (didn't bet)
Seat 8: zagaia011 folded before Flop (didn't bet)
Seat 9: LuvPeec (button) folded before Flop (didn't bet)



PokerStars Hand #221737749683: Tournament #3079057742, $0.98+$0.12 USD Hold'em No Limit - Level XIV (300/600) - 2020/12/23 1:06:08 EET [2020/12/22 18:06:08 ET]
Table '3079057742 50' 9-max Seat #1 is the button
Seat 1: Lucas0258 (47820 in chips) 
Seat 2: ruccos384 (18307 in chips) 
Seat 3: mesca27 (14049 in chips) 
Seat 4: pedrostjr (8360 in chips) 
Seat 5: jcarlos.vale (11651 in chips) 
Seat 6: AriFawkes (11981 in chips) 
Seat 8: zagaia011 (17699 in chips) 
Seat 9: LuvPeec (12654 in chips) 
Lucas0258: posts the ante 70
ruccos384: posts the ante 70
mesca27: posts the ante 70
pedrostjr: posts the ante 70
jcarlos.vale: posts the ante 70
AriFawkes: posts the ante 70
zagaia011: posts the ante 70
LuvPeec: posts the ante 70
ruccos384: posts small blind 300
mesca27: posts big blind 600
*** HOLE CARDS ***
Dealt to jcarlos.vale [3d 4h]
pedrostjr: folds 
jcarlos.vale: folds 
AriFawkes: folds 
zagaia011: folds 
LuvPeec: folds 
Lucas0258: raises 738 to 1338
ruccos384: folds 
mesca27: calls 738
*** FLOP *** [4s 2s Jd]
mesca27: checks 
Lucas0258: checks 
*** TURN *** [4s 2s Jd] [As]
mesca27: checks 
Lucas0258: bets 1200
mesca27: folds 
Uncalled bet (1200) returned to Lucas0258
Lucas0258 collected 3536 from pot
Lucas0258: doesn't show hand 
*** SUMMARY ***
Total pot 3536 | Rake 0 
Board [4s 2s Jd As]
Seat 1: Lucas0258 (button) collected (3536)
Seat 2: ruccos384 (small blind) folded before Flop
Seat 3: mesca27 (big blind) folded on the Turn
Seat 4: pedrostjr folded before Flop (didn't bet)
Seat 5: jcarlos.vale folded before Flop (didn't bet)
Seat 6: AriFawkes folded before Flop (didn't bet)
Seat 8: zagaia011 folded before Flop (didn't bet)
Seat 9: LuvPeec folded before Flop (didn't bet)



PokerStars Hand #221737774921: Tournament #3079057742, $0.98+$0.12 USD Hold'em No Limit - Level XIV (300/600) - 2020/12/23 1:06:52 EET [2020/12/22 18:06:52 ET]
Table '3079057742 50' 9-max Seat #2 is the button
Seat 1: Lucas0258 (49948 in chips) 
Seat 2: ruccos384 (17937 in chips) 
Seat 3: mesca27 (12641 in chips) 
Seat 4: pedrostjr (8290 in chips) 
Seat 5: jcarlos.vale (11581 in chips) 
Seat 6: AriFawkes (11911 in chips) 
Seat 7: shibaba420 (18231 in chips) 
Seat 8: zagaia011 (17629 in chips) 
Seat 9: LuvPeec (12584 in chips) 
Lucas0258: posts the ante 70
ruccos384: posts the ante 70
mesca27: posts the ante 70
pedrostjr: posts the ante 70
jcarlos.vale: posts the ante 70
AriFawkes: posts the ante 70
shibaba420: posts the ante 70
zagaia011: posts the ante 70
LuvPeec: posts the ante 70
mesca27: posts small blind 300
pedrostjr: posts big blind 600
*** HOLE CARDS ***
Dealt to jcarlos.vale [6d 4d]
jcarlos.vale: folds 
AriFawkes: folds 
shibaba420: folds 
zagaia011: folds 
LuvPeec: folds 
Lucas0258: raises 654 to 1254
ruccos384: raises 2346 to 3600
mesca27: folds 
pedrostjr: folds 
Lucas0258: calls 2346
*** FLOP *** [4c 6s Tc]
Lucas0258: bets 3000
ruccos384: calls 3000
*** TURN *** [4c 6s Tc] [Ac]
Lucas0258: bets 11400
ruccos384: calls 11267 and is all-in
Uncalled bet (133) returned to Lucas0258
*** RIVER *** [4c 6s Tc Ac] [9d]
*** SHOW DOWN ***
Lucas0258: shows [8h As] (a pair of Aces)
ruccos384: shows [Ad Qh] (a pair of Aces - Queen kicker)
ruccos384 collected 37264 from pot
*** SUMMARY ***
Total pot 37264 | Rake 0 
Board [4c 6s Tc Ac 9d]
Seat 1: Lucas0258 showed [8h As] and lost with a pair of Aces
Seat 2: ruccos384 (button) showed [Ad Qh] and won (37264) with a pair of Aces
Seat 3: mesca27 (small blind) folded before Flop
Seat 4: pedrostjr (big blind) folded before Flop
Seat 5: jcarlos.vale folded before Flop (didn't bet)
Seat 6: AriFawkes folded before Flop (didn't bet)
Seat 7: shibaba420 folded before Flop (didn't bet)
Seat 8: zagaia011 folded before Flop (didn't bet)
Seat 9: LuvPeec folded before Flop (didn't bet)



PokerStars Hand #221737814402: Tournament #3079057742, $0.98+$0.12 USD Hold'em No Limit - Level XIV (300/600) - 2020/12/23 1:08:00 EET [2020/12/22 18:08:00 ET]
Table '3079057742 50' 9-max Seat #3 is the button
Seat 1: Lucas0258 (32011 in chips) 
Seat 2: ruccos384 (37264 in chips) 
Seat 3: mesca27 (12271 in chips) 
Seat 4: pedrostjr (7620 in chips) 
Seat 5: jcarlos.vale (11511 in chips) 
Seat 6: AriFawkes (11841 in chips) 
Seat 7: shibaba420 (18161 in chips) 
Seat 8: zagaia011 (17559 in chips) 
Seat 9: LuvPeec (12514 in chips) 
Lucas0258: posts the ante 70
ruccos384: posts the ante 70
mesca27: posts the ante 70
pedrostjr: posts the ante 70
jcarlos.vale: posts the ante 70
AriFawkes: posts the ante 70
shibaba420: posts the ante 70
zagaia011: posts the ante 70
LuvPeec: posts the ante 70
pedrostjr: posts small blind 300
jcarlos.vale: posts big blind 600
*** HOLE CARDS ***
Dealt to jcarlos.vale [7c Ad]
AriFawkes: folds 
shibaba420: folds 
zagaia011: folds 
LuvPeec: folds 
Lucas0258: folds 
ruccos384: raises 600 to 1200
mesca27: folds 
pedrostjr: raises 6350 to 7550 and is all-in
jcarlos.vale: folds 
ruccos384: folds 
Uncalled bet (6350) returned to pedrostjr
pedrostjr collected 3630 from pot
pedrostjr: doesn't show hand 
*** SUMMARY ***
Total pot 3630 | Rake 0 
Seat 1: Lucas0258 folded before Flop (didn't bet)
Seat 2: ruccos384 folded before Flop
Seat 3: mesca27 (button) folded before Flop (didn't bet)
Seat 4: pedrostjr (small blind) collected (3630)
Seat 5: jcarlos.vale (big blind) folded before Flop
Seat 6: AriFawkes folded before Flop (didn't bet)
Seat 7: shibaba420 folded before Flop (didn't bet)
Seat 8: zagaia011 folded before Flop (didn't bet)
Seat 9: LuvPeec folded before Flop (didn't bet)



PokerStars Hand #221737833677: Tournament #3079057742, $0.98+$0.12 USD Hold'em No Limit - Level XIV (300/600) - 2020/12/23 1:08:33 EET [2020/12/22 18:08:33 ET]
Table '3079057742 50' 9-max Seat #4 is the button
Seat 1: Lucas0258 (31941 in chips) 
Seat 2: ruccos384 (35994 in chips) 
Seat 3: mesca27 (12201 in chips) 
Seat 4: pedrostjr (9980 in chips) 
Seat 5: jcarlos.vale (10841 in chips) 
Seat 6: AriFawkes (11771 in chips) 
Seat 7: shibaba420 (18091 in chips) 
Seat 8: zagaia011 (17489 in chips) 
Seat 9: LuvPeec (12444 in chips) 
Lucas0258: posts the ante 70
ruccos384: posts the ante 70
mesca27: posts the ante 70
pedrostjr: posts the ante 70
jcarlos.vale: posts the ante 70
AriFawkes: posts the ante 70
shibaba420: posts the ante 70
zagaia011: posts the ante 70
LuvPeec: posts the ante 70
jcarlos.vale: posts small blind 300
AriFawkes: posts big blind 600
*** HOLE CARDS ***
Dealt to jcarlos.vale [9c As]
shibaba420: folds 
zagaia011: folds 
LuvPeec: folds 
Lucas0258: raises 654 to 1254
ruccos384: folds 
mesca27: folds 
pedrostjr: folds 
jcarlos.vale: raises 9517 to 10771 and is all-in
AriFawkes: folds 
Lucas0258: folds 
Uncalled bet (9517) returned to jcarlos.vale
jcarlos.vale collected 3738 from pot
jcarlos.vale: doesn't show hand 
*** SUMMARY ***
Total pot 3738 | Rake 0 
Seat 1: Lucas0258 folded before Flop
Seat 2: ruccos384 folded before Flop (didn't bet)
Seat 3: mesca27 folded before Flop (didn't bet)
Seat 4: pedrostjr (button) folded before Flop (didn't bet)
Seat 5: jcarlos.vale (small blind) collected (3738)
Seat 6: AriFawkes (big blind) folded before Flop
Seat 7: shibaba420 folded before Flop (didn't bet)
Seat 8: zagaia011 folded before Flop (didn't bet)
Seat 9: LuvPeec folded before Flop (didn't bet)



PokerStars Hand #221737855667: Tournament #3079057742, $0.98+$0.12 USD Hold'em No Limit - Level XIV (300/600) - 2020/12/23 1:09:12 EET [2020/12/22 18:09:12 ET]
Table '3079057742 50' 9-max Seat #5 is the button
Seat 1: Lucas0258 (30617 in chips) 
Seat 2: ruccos384 (35924 in chips) 
Seat 3: mesca27 (12131 in chips) 
Seat 4: pedrostjr (9910 in chips) 
Seat 5: jcarlos.vale (13255 in chips) 
Seat 6: AriFawkes (11101 in chips) 
Seat 7: shibaba420 (18021 in chips) 
Seat 8: zagaia011 (17419 in chips) 
Seat 9: LuvPeec (12374 in chips) 
Lucas0258: posts the ante 70
ruccos384: posts the ante 70
mesca27: posts the ante 70
pedrostjr: posts the ante 70
jcarlos.vale: posts the ante 70
AriFawkes: posts the ante 70
shibaba420: posts the ante 70
zagaia011: posts the ante 70
LuvPeec: posts the ante 70
AriFawkes: posts small blind 300
shibaba420: posts big blind 600
*** HOLE CARDS ***
Dealt to jcarlos.vale [Qd 4h]
zagaia011: folds 
LuvPeec: folds 
Lucas0258: folds 
ruccos384: folds 
mesca27: folds 
pedrostjr: folds 
jcarlos.vale: folds 
AriFawkes: calls 300
shibaba420: checks 
*** FLOP *** [4d Ah As]
AriFawkes: checks 
shibaba420: checks 
*** TURN *** [4d Ah As] [Jd]
AriFawkes: bets 600
shibaba420: folds 
Uncalled bet (600) returned to AriFawkes
AriFawkes collected 1830 from pot
AriFawkes: doesn't show hand 
*** SUMMARY ***
Total pot 1830 | Rake 0 
Board [4d Ah As Jd]
Seat 1: Lucas0258 folded before Flop (didn't bet)
Seat 2: ruccos384 folded before Flop (didn't bet)
Seat 3: mesca27 folded before Flop (didn't bet)
Seat 4: pedrostjr folded before Flop (didn't bet)
Seat 5: jcarlos.vale (button) folded before Flop (didn't bet)
Seat 6: AriFawkes (small blind) collected (1830)
Seat 7: shibaba420 (big blind) folded on the Turn
Seat 8: zagaia011 folded before Flop (didn't bet)
Seat 9: LuvPeec folded before Flop (didn't bet)



PokerStars Hand #221737879418: Tournament #3079057742, $0.98+$0.12 USD Hold'em No Limit - Level XIV (300/600) - 2020/12/23 1:09:53 EET [2020/12/22 18:09:53 ET]
Table '3079057742 50' 9-max Seat #6 is the button
Seat 1: Lucas0258 (30547 in chips) 
Seat 3: mesca27 (12061 in chips) 
Seat 4: pedrostjr (9840 in chips) 
Seat 5: jcarlos.vale (13185 in chips) 
Seat 6: AriFawkes (12261 in chips) 
Seat 7: shibaba420 (17351 in chips) 
Seat 8: zagaia011 (17349 in chips) 
Seat 9: LuvPeec (12304 in chips) 
Lucas0258: posts the ante 70
mesca27: posts the ante 70
pedrostjr: posts the ante 70
jcarlos.vale: posts the ante 70
AriFawkes: posts the ante 70
shibaba420: posts the ante 70
zagaia011: posts the ante 70
LuvPeec: posts the ante 70
shibaba420: posts small blind 300
zagaia011: posts big blind 600
*** HOLE CARDS ***
Dealt to jcarlos.vale [4h 8h]
LuvPeec: folds 
Lucas0258: raises 654 to 1254
mesca27: calls 1254
pedrostjr: folds 
jcarlos.vale: folds 
AriFawkes: folds 
shibaba420: calls 954
zagaia011: folds 
*** FLOP *** [9c 8d Kd]
shibaba420: checks 
Lucas0258: checks 
mesca27: checks 
*** TURN *** [9c 8d Kd] [Ac]
shibaba420: checks 
Lucas0258: bets 1200
mesca27: calls 1200
shibaba420: folds 
*** RIVER *** [9c 8d Kd Ac] [Qh]
Lucas0258: checks 
mesca27: checks 
*** SHOW DOWN ***
Lucas0258: shows [Ad 7s] (a pair of Aces)
mesca27: shows [As 3s] (a pair of Aces)
Lucas0258 collected 3661 from pot
mesca27 collected 3661 from pot
*** SUMMARY ***
Total pot 7322 | Rake 0 
Board [9c 8d Kd Ac Qh]
Seat 1: Lucas0258 showed [Ad 7s] and won (3661) with a pair of Aces
Seat 3: mesca27 showed [As 3s] and won (3661) with a pair of Aces
Seat 4: pedrostjr folded before Flop (didn't bet)
Seat 5: jcarlos.vale folded before Flop (didn't bet)
Seat 6: AriFawkes (button) folded before Flop (didn't bet)
Seat 7: shibaba420 (small blind) folded on the Turn
Seat 8: zagaia011 (big blind) folded before Flop
Seat 9: LuvPeec folded before Flop (didn't bet)



PokerStars Hand #221737928776: Tournament #3079057742, $0.98+$0.12 USD Hold'em No Limit - Level XV (350/700) - 2020/12/23 1:11:19 EET [2020/12/22 18:11:19 ET]
Table '3079057742 50' 9-max Seat #7 is the button
Seat 1: Lucas0258 (31684 in chips) 
Seat 3: mesca27 (13198 in chips) 
Seat 4: pedrostjr (9770 in chips) 
Seat 5: jcarlos.vale (13115 in chips) 
Seat 6: AriFawkes (12191 in chips) 
Seat 7: shibaba420 (16027 in chips) 
Seat 8: zagaia011 (16679 in chips) 
Seat 9: LuvPeec (12234 in chips) 
Lucas0258: posts the ante 85
mesca27: posts the ante 85
pedrostjr: posts the ante 85
jcarlos.vale: posts the ante 85
AriFawkes: posts the ante 85
shibaba420: posts the ante 85
zagaia011: posts the ante 85
LuvPeec: posts the ante 85
zagaia011: posts small blind 350
LuvPeec: posts big blind 700
*** HOLE CARDS ***
Dealt to jcarlos.vale [Qc Jc]
Lucas0258: folds 
mesca27: folds 
pedrostjr: folds 
jcarlos.vale: raises 1120 to 1820
AriFawkes: folds 
shibaba420: folds 
zagaia011: folds 
LuvPeec: calls 1120
*** FLOP *** [5s 6s Kh]
LuvPeec: checks 
jcarlos.vale: bets 1400
LuvPeec: folds 
Uncalled bet (1400) returned to jcarlos.vale
jcarlos.vale collected 4670 from pot
jcarlos.vale: doesn't show hand 
*** SUMMARY ***
Total pot 4670 | Rake 0 
Board [5s 6s Kh]
Seat 1: Lucas0258 folded before Flop (didn't bet)
Seat 3: mesca27 folded before Flop (didn't bet)
Seat 4: pedrostjr folded before Flop (didn't bet)
Seat 5: jcarlos.vale collected (4670)
Seat 6: AriFawkes folded before Flop (didn't bet)
Seat 7: shibaba420 (button) folded before Flop (didn't bet)
Seat 8: zagaia011 (small blind) folded before Flop
Seat 9: LuvPeec (big blind) folded on the Flop



PokerStars Hand #221737949359: Tournament #3079057742, $0.98+$0.12 USD Hold'em No Limit - Level XV (350/700) - 2020/12/23 1:11:55 EET [2020/12/22 18:11:55 ET]
Table '3079057742 50' 9-max Seat #8 is the button
Seat 1: Lucas0258 (31599 in chips) 
Seat 3: mesca27 (13113 in chips) 
Seat 4: pedrostjr (9685 in chips) 
Seat 5: jcarlos.vale (15880 in chips) 
Seat 6: AriFawkes (12106 in chips) 
Seat 7: shibaba420 (15942 in chips) 
Seat 8: zagaia011 (16244 in chips) 
Seat 9: LuvPeec (10329 in chips) 
Lucas0258: posts the ante 85
mesca27: posts the ante 85
pedrostjr: posts the ante 85
jcarlos.vale: posts the ante 85
AriFawkes: posts the ante 85
shibaba420: posts the ante 85
zagaia011: posts the ante 85
LuvPeec: posts the ante 85
LuvPeec: posts small blind 350
Lucas0258: posts big blind 700
*** HOLE CARDS ***
Dealt to jcarlos.vale [7d 5c]
mesca27: folds 
pedrostjr: folds 
jcarlos.vale: folds 
AriFawkes: folds 
shibaba420: folds 
zagaia011: folds 
LuvPeec: folds 
Uncalled bet (350) returned to Lucas0258
Lucas0258 collected 1380 from pot
Lucas0258: doesn't show hand 
*** SUMMARY ***
Total pot 1380 | Rake 0 
Seat 1: Lucas0258 (big blind) collected (1380)
Seat 3: mesca27 folded before Flop (didn't bet)
Seat 4: pedrostjr folded before Flop (didn't bet)
Seat 5: jcarlos.vale folded before Flop (didn't bet)
Seat 6: AriFawkes folded before Flop (didn't bet)
Seat 7: shibaba420 folded before Flop (didn't bet)
Seat 8: zagaia011 (button) folded before Flop (didn't bet)
Seat 9: LuvPeec (small blind) folded before Flop



PokerStars Hand #221737957638: Tournament #3079057742, $0.98+$0.12 USD Hold'em No Limit - Level XV (350/700) - 2020/12/23 1:12:10 EET [2020/12/22 18:12:10 ET]
Table '3079057742 50' 9-max Seat #9 is the button
Seat 1: Lucas0258 (32544 in chips) 
Seat 3: mesca27 (13028 in chips) 
Seat 4: pedrostjr (9600 in chips) 
Seat 5: jcarlos.vale (15795 in chips) 
Seat 6: AriFawkes (12021 in chips) 
Seat 7: shibaba420 (15857 in chips) 
Seat 8: zagaia011 (16159 in chips) 
Seat 9: LuvPeec (9894 in chips) 
Lucas0258: posts the ante 85
mesca27: posts the ante 85
pedrostjr: posts the ante 85
jcarlos.vale: posts the ante 85
AriFawkes: posts the ante 85
shibaba420: posts the ante 85
zagaia011: posts the ante 85
LuvPeec: posts the ante 85
Lucas0258: posts small blind 350
mesca27: posts big blind 700
*** HOLE CARDS ***
Dealt to jcarlos.vale [4d 9d]
pedrostjr: folds 
jcarlos.vale: folds 
AriFawkes: folds 
shibaba420: folds 
zagaia011: raises 700 to 1400
LuvPeec: calls 1400
Lucas0258: folds 
mesca27: folds 
*** FLOP *** [3d Th Qs]
zagaia011: bets 1495
LuvPeec: calls 1495
*** TURN *** [3d Th Qs] [8h]
zagaia011: checks 
LuvPeec: bets 3008
zagaia011: folds 
Uncalled bet (3008) returned to LuvPeec
LuvPeec collected 7520 from pot
LuvPeec: doesn't show hand 
*** SUMMARY ***
Total pot 7520 | Rake 0 
Board [3d Th Qs 8h]
Seat 1: Lucas0258 (small blind) folded before Flop
Seat 3: mesca27 (big blind) folded before Flop
Seat 4: pedrostjr folded before Flop (didn't bet)
Seat 5: jcarlos.vale folded before Flop (didn't bet)
Seat 6: AriFawkes folded before Flop (didn't bet)
Seat 7: shibaba420 folded before Flop (didn't bet)
Seat 8: zagaia011 folded on the Turn
Seat 9: LuvPeec (button) collected (7520)



PokerStars Hand #221738004024: Tournament #3079057742, $0.98+$0.12 USD Hold'em No Limit - Level XV (350/700) - 2020/12/23 1:13:32 EET [2020/12/22 18:13:32 ET]
Table '3079057742 50' 9-max Seat #1 is the button
Seat 1: Lucas0258 (32109 in chips) 
Seat 3: mesca27 (12243 in chips) 
Seat 4: pedrostjr (9515 in chips) 
Seat 5: jcarlos.vale (15710 in chips) 
Seat 6: AriFawkes (11936 in chips) 
Seat 7: shibaba420 (15772 in chips) 
Seat 8: zagaia011 (13179 in chips) 
Seat 9: LuvPeec (14434 in chips) 
Lucas0258: posts the ante 85
mesca27: posts the ante 85
pedrostjr: posts the ante 85
jcarlos.vale: posts the ante 85
AriFawkes: posts the ante 85
shibaba420: posts the ante 85
zagaia011: posts the ante 85
LuvPeec: posts the ante 85
mesca27: posts small blind 350
pedrostjr: posts big blind 700
*** HOLE CARDS ***
Dealt to jcarlos.vale [8c 8d]
jcarlos.vale: raises 1120 to 1820
AriFawkes: calls 1820
shibaba420: raises 13867 to 15687 and is all-in
zagaia011: folds 
LuvPeec: folds 
Lucas0258: folds 
mesca27: folds 
pedrostjr: folds 
jcarlos.vale: folds 
AriFawkes: calls 10031 and is all-in
Uncalled bet (3836) returned to shibaba420
*** FLOP *** [Js 3c 5s]
*** TURN *** [Js 3c 5s] [Kd]
*** RIVER *** [Js 3c 5s Kd] [Qc]
*** SHOW DOWN ***
AriFawkes: shows [Jc Kh] (two pair, Kings and Jacks)
shibaba420: shows [8s 8h] (a pair of Eights)
AriFawkes collected 27252 from pot
*** SUMMARY ***
Total pot 27252 | Rake 0 
Board [Js 3c 5s Kd Qc]
Seat 1: Lucas0258 (button) folded before Flop (didn't bet)
Seat 3: mesca27 (small blind) folded before Flop
Seat 4: pedrostjr (big blind) folded before Flop
Seat 5: jcarlos.vale folded before Flop
Seat 6: AriFawkes showed [Jc Kh] and won (27252) with two pair, Kings and Jacks
Seat 7: shibaba420 showed [8s 8h] and lost with a pair of Eights
Seat 8: zagaia011 folded before Flop (didn't bet)
Seat 9: LuvPeec folded before Flop (didn't bet)



PokerStars Hand #221738031410: Tournament #3079057742, $0.98+$0.12 USD Hold'em No Limit - Level XV (350/700) - 2020/12/23 1:14:21 EET [2020/12/22 18:14:21 ET]
Table '3079057742 50' 9-max Seat #3 is the button
Seat 1: Lucas0258 (32024 in chips) 
Seat 3: mesca27 (11808 in chips) 
Seat 4: pedrostjr (8730 in chips) 
Seat 5: jcarlos.vale (13805 in chips) 
Seat 6: AriFawkes (27252 in chips) 
Seat 7: shibaba420 (3836 in chips) 
Seat 8: zagaia011 (13094 in chips) 
Seat 9: LuvPeec (14349 in chips) 
Lucas0258: posts the ante 85
mesca27: posts the ante 85
pedrostjr: posts the ante 85
jcarlos.vale: posts the ante 85
AriFawkes: posts the ante 85
shibaba420: posts the ante 85
zagaia011: posts the ante 85
LuvPeec: posts the ante 85
pedrostjr: posts small blind 350
jcarlos.vale: posts big blind 700
*** HOLE CARDS ***
Dealt to jcarlos.vale [2h 5s]
AriFawkes: folds 
shibaba420: folds 
zagaia011: folds 
LuvPeec: raises 700 to 1400
Lucas0258: folds 
mesca27: folds 
pedrostjr: raises 7245 to 8645 and is all-in
jcarlos.vale: folds 
LuvPeec: calls 7245
*** FLOP *** [5h 9h Js]
*** TURN *** [5h 9h Js] [Jd]
*** RIVER *** [5h 9h Js Jd] [Kh]
*** SHOW DOWN ***
pedrostjr: shows [7c Ac] (a pair of Jacks)
LuvPeec: shows [8h Ah] (a flush, Ace high)
LuvPeec collected 18670 from pot
pedrostjr finished the tournament in 119th place and received $1.68.
*** SUMMARY ***
Total pot 18670 | Rake 0 
Board [5h 9h Js Jd Kh]
Seat 1: Lucas0258 folded before Flop (didn't bet)
Seat 3: mesca27 (button) folded before Flop (didn't bet)
Seat 4: pedrostjr (small blind) showed [7c Ac] and lost with a pair of Jacks
Seat 5: jcarlos.vale (big blind) folded before Flop
Seat 6: AriFawkes folded before Flop (didn't bet)
Seat 7: shibaba420 folded before Flop (didn't bet)
Seat 8: zagaia011 folded before Flop (didn't bet)
Seat 9: LuvPeec showed [8h Ah] and won (18670) with a flush, Ace high



PokerStars Hand #221738060856: Tournament #3079057742, $0.98+$0.12 USD Hold'em No Limit - Level XV (350/700) - 2020/12/23 1:14:59 EET [2020/12/22 18:14:59 ET]
Table '3079057742 50' 9-max Seat #5 is the button
Seat 1: Lucas0258 (31939 in chips) 
Seat 3: mesca27 (11723 in chips) 
Seat 5: jcarlos.vale (13020 in chips) 
Seat 6: AriFawkes (27167 in chips) 
Seat 7: shibaba420 (3751 in chips) 
Seat 8: zagaia011 (13009 in chips) 
Seat 9: LuvPeec (24289 in chips) 
Lucas0258: posts the ante 85
mesca27: posts the ante 85
jcarlos.vale: posts the ante 85
AriFawkes: posts the ante 85
shibaba420: posts the ante 85
zagaia011: posts the ante 85
LuvPeec: posts the ante 85
AriFawkes: posts small blind 350
shibaba420: posts big blind 700
*** HOLE CARDS ***
Dealt to jcarlos.vale [6c 2h]
zagaia011: folds 
LuvPeec: folds 
Lucas0258: folds 
mesca27: folds 
jcarlos.vale: folds 
AriFawkes: folds 
Uncalled bet (350) returned to shibaba420
shibaba420 collected 1295 from pot
*** SUMMARY ***
Total pot 1295 | Rake 0 
Seat 1: Lucas0258 folded before Flop (didn't bet)
Seat 3: mesca27 folded before Flop (didn't bet)
Seat 5: jcarlos.vale (button) folded before Flop (didn't bet)
Seat 6: AriFawkes (small blind) folded before Flop
Seat 7: shibaba420 (big blind) collected (1295)
Seat 8: zagaia011 folded before Flop (didn't bet)
Seat 9: LuvPeec folded before Flop (didn't bet)



PokerStars Hand #221738067748: Tournament #3079057742, $0.98+$0.12 USD Hold'em No Limit - Level XV (350/700) - 2020/12/23 1:15:11 EET [2020/12/22 18:15:11 ET]
Table '3079057742 50' 9-max Seat #6 is the button
Seat 1: Lucas0258 (31854 in chips) 
Seat 2: Adolf3090 (62939 in chips) 
Seat 3: mesca27 (11638 in chips) 
Seat 5: jcarlos.vale (12935 in chips) 
Seat 6: AriFawkes (26732 in chips) 
Seat 7: shibaba420 (4611 in chips) 
Seat 8: zagaia011 (12924 in chips) 
Seat 9: LuvPeec (24204 in chips) 
Lucas0258: posts the ante 85
Adolf3090: posts the ante 85
mesca27: posts the ante 85
jcarlos.vale: posts the ante 85
AriFawkes: posts the ante 85
shibaba420: posts the ante 85
zagaia011: posts the ante 85
LuvPeec: posts the ante 85
shibaba420: posts small blind 350
zagaia011: posts big blind 700
*** HOLE CARDS ***
Dealt to jcarlos.vale [9c 8c]
LuvPeec: folds 
Lucas0258: folds 
Adolf3090: raises 1400 to 2100
mesca27: folds 
jcarlos.vale: folds 
AriFawkes: folds 
shibaba420: folds 
zagaia011: folds 
Uncalled bet (1400) returned to Adolf3090
Adolf3090 collected 2430 from pot
*** SUMMARY ***
Total pot 2430 | Rake 0 
Seat 1: Lucas0258 folded before Flop (didn't bet)
Seat 2: Adolf3090 collected (2430)
Seat 3: mesca27 folded before Flop (didn't bet)
Seat 5: jcarlos.vale folded before Flop (didn't bet)
Seat 6: AriFawkes (button) folded before Flop (didn't bet)
Seat 7: shibaba420 (small blind) folded before Flop
Seat 8: zagaia011 (big blind) folded before Flop
Seat 9: LuvPeec folded before Flop (didn't bet)



PokerStars Hand #221738089564: Tournament #3079057742, $0.98+$0.12 USD Hold'em No Limit - Level XV (350/700) - 2020/12/23 1:15:50 EET [2020/12/22 18:15:50 ET]
Table '3079057742 50' 9-max Seat #7 is the button
Seat 1: Lucas0258 (31769 in chips) 
Seat 2: Adolf3090 (64584 in chips) 
Seat 3: mesca27 (11553 in chips) 
Seat 5: jcarlos.vale (12850 in chips) 
Seat 6: AriFawkes (26647 in chips) 
Seat 7: shibaba420 (4176 in chips) 
Seat 8: zagaia011 (12139 in chips) 
Seat 9: LuvPeec (24119 in chips) 
Lucas0258: posts the ante 85
Adolf3090: posts the ante 85
mesca27: posts the ante 85
jcarlos.vale: posts the ante 85
AriFawkes: posts the ante 85
shibaba420: posts the ante 85
zagaia011: posts the ante 85
LuvPeec: posts the ante 85
zagaia011: posts small blind 350
LuvPeec: posts big blind 700
*** HOLE CARDS ***
Dealt to jcarlos.vale [3d 6h]
Lucas0258: folds 
Adolf3090: raises 700 to 1400
mesca27: folds 
jcarlos.vale: folds 
AriFawkes: calls 1400
shibaba420: folds 
zagaia011: folds 
LuvPeec: folds 
*** FLOP *** [8c 3c Qc]
Adolf3090: bets 2100
AriFawkes: folds 
Uncalled bet (2100) returned to Adolf3090
Adolf3090 collected 4530 from pot
*** SUMMARY ***
Total pot 4530 | Rake 0 
Board [8c 3c Qc]
Seat 1: Lucas0258 folded before Flop (didn't bet)
Seat 2: Adolf3090 collected (4530)
Seat 3: mesca27 folded before Flop (didn't bet)
Seat 5: jcarlos.vale folded before Flop (didn't bet)
Seat 6: AriFawkes folded on the Flop
Seat 7: shibaba420 (button) folded before Flop (didn't bet)
Seat 8: zagaia011 (small blind) folded before Flop
Seat 9: LuvPeec (big blind) folded before Flop



PokerStars Hand #221738104270: Tournament #3079057742, $0.98+$0.12 USD Hold'em No Limit - Level XV (350/700) - 2020/12/23 1:16:17 EET [2020/12/22 18:16:17 ET]
Table '3079057742 50' 9-max Seat #8 is the button
Seat 1: Lucas0258 (31684 in chips) 
Seat 2: Adolf3090 (67629 in chips) 
Seat 3: mesca27 (11468 in chips) 
Seat 5: jcarlos.vale (12765 in chips) 
Seat 6: AriFawkes (25162 in chips) 
Seat 7: shibaba420 (4091 in chips) 
Seat 8: zagaia011 (11704 in chips) 
Seat 9: LuvPeec (23334 in chips) 
Lucas0258: posts the ante 85
Adolf3090: posts the ante 85
mesca27: posts the ante 85
jcarlos.vale: posts the ante 85
AriFawkes: posts the ante 85
shibaba420: posts the ante 85
zagaia011: posts the ante 85
LuvPeec: posts the ante 85
LuvPeec: posts small blind 350
Lucas0258: posts big blind 700
*** HOLE CARDS ***
Dealt to jcarlos.vale [4s 6c]
Adolf3090: folds 
mesca27: folds 
jcarlos.vale: folds 
AriFawkes: raises 700 to 1400
shibaba420: raises 2606 to 4006 and is all-in
zagaia011: folds 
LuvPeec: folds 
Lucas0258: folds 
AriFawkes: calls 2606
*** FLOP *** [Td 8d 8c]
*** TURN *** [Td 8d 8c] [Qd]
*** RIVER *** [Td 8d 8c Qd] [9d]
*** SHOW DOWN ***
AriFawkes: shows [8s Ks] (three of a kind, Eights)
shibaba420: shows [Th Kc] (two pair, Tens and Eights)
AriFawkes collected 9742 from pot
shibaba420 finished the tournament in 118th place and received $1.68.
*** SUMMARY ***
Total pot 9742 | Rake 0 
Board [Td 8d 8c Qd 9d]
Seat 1: Lucas0258 (big blind) folded before Flop
Seat 2: Adolf3090 folded before Flop (didn't bet)
Seat 3: mesca27 folded before Flop (didn't bet)
Seat 5: jcarlos.vale folded before Flop (didn't bet)
Seat 6: AriFawkes showed [8s Ks] and won (9742) with three of a kind, Eights
Seat 7: shibaba420 showed [Th Kc] and lost with two pair, Tens and Eights
Seat 8: zagaia011 (button) folded before Flop (didn't bet)
Seat 9: LuvPeec (small blind) folded before Flop



PokerStars Hand #221738126075: Tournament #3079057742, $0.98+$0.12 USD Hold'em No Limit - Level XV (350/700) - 2020/12/23 1:16:56 EET [2020/12/22 18:16:56 ET]
Table '3079057742 16' 9-max Seat #4 is the button
Seat 1: ))) XÞ¥ ((( (6339 in chips) 
Seat 2: tomsasxdd (7303 in chips) 
Seat 3: puidokas1983 (29831 in chips) 
Seat 4: 8EVGENIY8 (33639 in chips) 
Seat 5: Dimitrrr1 (25606 in chips) 
Seat 6: pimdebeer (39428 in chips) 
Seat 7: jcarlos.vale (12680 in chips) 
Seat 8: ennyy01 (17855 in chips) 
Seat 9: checkroom (9360 in chips) 
))) XÞ¥ (((: posts the ante 85
tomsasxdd: posts the ante 85
puidokas1983: posts the ante 85
8EVGENIY8: posts the ante 85
Dimitrrr1: posts the ante 85
pimdebeer: posts the ante 85
jcarlos.vale: posts the ante 85
ennyy01: posts the ante 85
checkroom: posts the ante 85
Dimitrrr1: posts small blind 350
pimdebeer: posts big blind 700
*** HOLE CARDS ***
Dealt to jcarlos.vale [6s 8d]
puidokas1983 said, "LoL"
jcarlos.vale: folds 
ennyy01: folds 
checkroom: folds 
))) XÞ¥ (((: folds 
tomsasxdd: folds 
puidokas1983: calls 700
8EVGENIY8: raises 1750 to 2450
Dimitrrr1: folds 
pimdebeer: folds 
puidokas1983: calls 1750
*** FLOP *** [Qs Tc Js]
puidokas1983: checks 
8EVGENIY8: bets 2216
puidokas1983: folds 
Uncalled bet (2216) returned to 8EVGENIY8
8EVGENIY8 collected 6715 from pot
8EVGENIY8: doesn't show hand 
*** SUMMARY ***
Total pot 6715 | Rake 0 
Board [Qs Tc Js]
Seat 1: ))) XÞ¥ ((( folded before Flop (didn't bet)
Seat 2: tomsasxdd folded before Flop (didn't bet)
Seat 3: puidokas1983 folded on the Flop
Seat 4: 8EVGENIY8 (button) collected (6715)
Seat 5: Dimitrrr1 (small blind) folded before Flop
Seat 6: pimdebeer (big blind) folded before Flop
Seat 7: jcarlos.vale folded before Flop (didn't bet)
Seat 8: ennyy01 folded before Flop (didn't bet)
Seat 9: checkroom folded before Flop (didn't bet)



PokerStars Hand #221738163973: Tournament #3079057742, $0.98+$0.12 USD Hold'em No Limit - Level XV (350/700) - 2020/12/23 1:18:03 EET [2020/12/22 18:18:03 ET]
Table '3079057742 16' 9-max Seat #5 is the button
Seat 1: ))) XÞ¥ ((( (6254 in chips) 
Seat 2: tomsasxdd (7218 in chips) 
Seat 3: puidokas1983 (27296 in chips) 
Seat 4: 8EVGENIY8 (37819 in chips) 
Seat 5: Dimitrrr1 (25171 in chips) 
Seat 6: pimdebeer (38643 in chips) 
Seat 7: jcarlos.vale (12595 in chips) 
Seat 8: ennyy01 (17770 in chips) 
Seat 9: checkroom (9275 in chips) 
))) XÞ¥ (((: posts the ante 85
tomsasxdd: posts the ante 85
puidokas1983: posts the ante 85
8EVGENIY8: posts the ante 85
Dimitrrr1: posts the ante 85
pimdebeer: posts the ante 85
jcarlos.vale: posts the ante 85
ennyy01: posts the ante 85
checkroom: posts the ante 85
pimdebeer: posts small blind 350
jcarlos.vale: posts big blind 700
*** HOLE CARDS ***
Dealt to jcarlos.vale [8h Th]
ennyy01: raises 700 to 1400
checkroom: folds 
))) XÞ¥ (((: folds 
tomsasxdd: folds 
puidokas1983: folds 
8EVGENIY8: folds 
Dimitrrr1: calls 1400
pimdebeer: folds 
jcarlos.vale: calls 700
*** FLOP *** [Td 8d 6s]
jcarlos.vale: bets 11110 and is all-in
ennyy01: calls 11110
Dimitrrr1: folds 
*** TURN *** [Td 8d 6s] [Jd]
*** RIVER *** [Td 8d 6s Jd] [7c]
*** SHOW DOWN ***
jcarlos.vale: shows [8h Th] (two pair, Tens and Eights)
ennyy01: shows [As Ad] (a pair of Aces)
jcarlos.vale collected 27535 from pot
*** SUMMARY ***
Total pot 27535 | Rake 0 
Board [Td 8d 6s Jd 7c]
Seat 1: ))) XÞ¥ ((( folded before Flop (didn't bet)
Seat 2: tomsasxdd folded before Flop (didn't bet)
Seat 3: puidokas1983 folded before Flop (didn't bet)
Seat 4: 8EVGENIY8 folded before Flop (didn't bet)
Seat 5: Dimitrrr1 (button) folded on the Flop
Seat 6: pimdebeer (small blind) folded before Flop
Seat 7: jcarlos.vale (big blind) showed [8h Th] and won (27535) with two pair, Tens and Eights
Seat 8: ennyy01 showed [As Ad] and lost with a pair of Aces
Seat 9: checkroom folded before Flop (didn't bet)



PokerStars Hand #221738189874: Tournament #3079057742, $0.98+$0.12 USD Hold'em No Limit - Level XV (350/700) - 2020/12/23 1:18:50 EET [2020/12/22 18:18:50 ET]
Table '3079057742 16' 9-max Seat #6 is the button
Seat 1: ))) XÞ¥ ((( (6169 in chips) 
Seat 2: tomsasxdd (7133 in chips) 
Seat 3: puidokas1983 (27211 in chips) 
Seat 4: 8EVGENIY8 (37734 in chips) 
Seat 5: Dimitrrr1 (23686 in chips) 
Seat 6: pimdebeer (38208 in chips) 
Seat 7: jcarlos.vale (27535 in chips) 
Seat 8: ennyy01 (5175 in chips) 
Seat 9: checkroom (9190 in chips) 
))) XÞ¥ (((: posts the ante 85
tomsasxdd: posts the ante 85
puidokas1983: posts the ante 85
8EVGENIY8: posts the ante 85
Dimitrrr1: posts the ante 85
pimdebeer: posts the ante 85
jcarlos.vale: posts the ante 85
ennyy01: posts the ante 85
checkroom: posts the ante 85
jcarlos.vale: posts small blind 350
ennyy01: posts big blind 700
*** HOLE CARDS ***
Dealt to jcarlos.vale [Ac 3c]
checkroom: folds 
))) XÞ¥ (((: folds 
tomsasxdd: calls 700
puidokas1983: calls 700
8EVGENIY8: folds 
Dimitrrr1: folds 
pimdebeer: folds 
jcarlos.vale: calls 350
ennyy01: checks 
*** FLOP *** [9h 4h Js]
jcarlos.vale: checks 
ennyy01: checks 
tomsasxdd: bets 700
puidokas1983: calls 700
jcarlos.vale: folds 
ennyy01: folds 
*** TURN *** [9h 4h Js] [Kc]
tomsasxdd: bets 700
puidokas1983: folds 
Uncalled bet (700) returned to tomsasxdd
tomsasxdd collected 4965 from pot
tomsasxdd: doesn't show hand 
*** SUMMARY ***
Total pot 4965 | Rake 0 
Board [9h 4h Js Kc]
Seat 1: ))) XÞ¥ ((( folded before Flop (didn't bet)
Seat 2: tomsasxdd collected (4965)
Seat 3: puidokas1983 folded on the Turn
Seat 4: 8EVGENIY8 folded before Flop (didn't bet)
Seat 5: Dimitrrr1 folded before Flop (didn't bet)
Seat 6: pimdebeer (button) folded before Flop (didn't bet)
Seat 7: jcarlos.vale (small blind) folded on the Flop
Seat 8: ennyy01 (big blind) folded on the Flop
Seat 9: checkroom folded before Flop (didn't bet)



PokerStars Hand #221738255660: Tournament #3079057742, $0.98+$0.12 USD Hold'em No Limit - Level XVI (400/800) - 2020/12/23 1:20:48 EET [2020/12/22 18:20:48 ET]
Table '3079057742 16' 9-max Seat #7 is the button
Seat 1: ))) XÞ¥ ((( (6084 in chips) 
Seat 2: tomsasxdd (10613 in chips) 
Seat 3: puidokas1983 (25726 in chips) 
Seat 4: 8EVGENIY8 (37649 in chips) 
Seat 5: Dimitrrr1 (23601 in chips) 
Seat 6: pimdebeer (38123 in chips) 
Seat 7: jcarlos.vale (26750 in chips) 
Seat 8: ennyy01 (4390 in chips) 
Seat 9: checkroom (9105 in chips) 
))) XÞ¥ (((: posts the ante 100
tomsasxdd: posts the ante 100
puidokas1983: posts the ante 100
8EVGENIY8: posts the ante 100
Dimitrrr1: posts the ante 100
pimdebeer: posts the ante 100
jcarlos.vale: posts the ante 100
ennyy01: posts the ante 100
checkroom: posts the ante 100
ennyy01: posts small blind 400
checkroom: posts big blind 800
*** HOLE CARDS ***
Dealt to jcarlos.vale [2c Jh]
))) XÞ¥ (((: folds 
tomsasxdd: folds 
puidokas1983: calls 800
8EVGENIY8: folds 
Dimitrrr1: folds 
pimdebeer: raises 2400 to 3200
jcarlos.vale: folds 
ennyy01: folds 
checkroom: folds 
puidokas1983: calls 2400
*** FLOP *** [Js 3c 5h]
puidokas1983: checks 
pimdebeer: checks 
*** TURN *** [Js 3c 5h] [6h]
puidokas1983: bets 800
pimdebeer: folds 
Uncalled bet (800) returned to puidokas1983
puidokas1983 collected 8500 from pot
puidokas1983: doesn't show hand 
*** SUMMARY ***
Total pot 8500 | Rake 0 
Board [Js 3c 5h 6h]
Seat 1: ))) XÞ¥ ((( folded before Flop (didn't bet)
Seat 2: tomsasxdd folded before Flop (didn't bet)
Seat 3: puidokas1983 collected (8500)
Seat 4: 8EVGENIY8 folded before Flop (didn't bet)
Seat 5: Dimitrrr1 folded before Flop (didn't bet)
Seat 6: pimdebeer folded on the Turn
Seat 7: jcarlos.vale (button) folded before Flop (didn't bet)
Seat 8: ennyy01 (small blind) folded before Flop
Seat 9: checkroom (big blind) folded before Flop



PokerStars Hand #221738310413: Tournament #3079057742, $0.98+$0.12 USD Hold'em No Limit - Level XVI (400/800) - 2020/12/23 1:22:15 EET [2020/12/22 18:22:15 ET]
Table '3079057742 16' 9-max Seat #8 is the button
Seat 1: ))) XÞ¥ ((( (5984 in chips) 
Seat 2: tomsasxdd (10513 in chips) 
Seat 3: puidokas1983 (30926 in chips) 
Seat 4: 8EVGENIY8 (37549 in chips) 
Seat 5: Dimitrrr1 (23501 in chips) 
Seat 6: pimdebeer (34823 in chips) 
Seat 7: jcarlos.vale (26650 in chips) 
Seat 8: ennyy01 (3890 in chips) 
Seat 9: checkroom (8205 in chips) 
))) XÞ¥ (((: posts the ante 100
tomsasxdd: posts the ante 100
puidokas1983: posts the ante 100
8EVGENIY8: posts the ante 100
Dimitrrr1: posts the ante 100
pimdebeer: posts the ante 100
jcarlos.vale: posts the ante 100
ennyy01: posts the ante 100
checkroom: posts the ante 100
checkroom: posts small blind 400
))) XÞ¥ (((: posts big blind 800
*** HOLE CARDS ***
Dealt to jcarlos.vale [8s As]
tomsasxdd: folds 
puidokas1983: calls 800
8EVGENIY8: folds 
Dimitrrr1: folds 
pimdebeer: folds 
jcarlos.vale: calls 800
ennyy01: folds 
checkroom: folds 
))) XÞ¥ (((: checks 
*** FLOP *** [Ac Kh Jc]
))) XÞ¥ (((: checks 
puidokas1983: bets 800
jcarlos.vale: raises 800 to 1600
))) XÞ¥ (((: raises 3484 to 5084 and is all-in
puidokas1983: calls 4284
jcarlos.vale: calls 3484
*** TURN *** [Ac Kh Jc] [Qd]
puidokas1983: checks 
jcarlos.vale: checks 
*** RIVER *** [Ac Kh Jc Qd] [Jd]
puidokas1983: checks 
jcarlos.vale: checks 
*** SHOW DOWN ***
))) XÞ¥ (((: shows [3d Jh] (three of a kind, Jacks)
puidokas1983: mucks hand 
jcarlos.vale: mucks hand 
))) XÞ¥ ((( collected 18952 from pot
*** SUMMARY ***
Total pot 18952 | Rake 0 
Board [Ac Kh Jc Qd Jd]
Seat 1: ))) XÞ¥ ((( (big blind) showed [3d Jh] and won (18952) with three of a kind, Jacks
Seat 2: tomsasxdd folded before Flop (didn't bet)
Seat 3: puidokas1983 mucked [Ad Qh]
Seat 4: 8EVGENIY8 folded before Flop (didn't bet)
Seat 5: Dimitrrr1 folded before Flop (didn't bet)
Seat 6: pimdebeer folded before Flop (didn't bet)
Seat 7: jcarlos.vale mucked [8s As]
Seat 8: ennyy01 (button) folded before Flop (didn't bet)
Seat 9: checkroom (small blind) folded before Flop



PokerStars Hand #221738364824: Tournament #3079057742, $0.98+$0.12 USD Hold'em No Limit - Level XVI (400/800) - 2020/12/23 1:23:55 EET [2020/12/22 18:23:55 ET]
Table '3079057742 16' 9-max Seat #9 is the button
Seat 1: ))) XÞ¥ ((( (18952 in chips) 
Seat 2: tomsasxdd (10413 in chips) 
Seat 3: puidokas1983 (24942 in chips) 
Seat 4: 8EVGENIY8 (37449 in chips) 
Seat 5: Dimitrrr1 (23401 in chips) 
Seat 6: pimdebeer (34723 in chips) 
Seat 7: jcarlos.vale (20666 in chips) 
Seat 8: ennyy01 (3790 in chips) 
Seat 9: checkroom (7705 in chips) 
))) XÞ¥ (((: posts the ante 100
tomsasxdd: posts the ante 100
puidokas1983: posts the ante 100
8EVGENIY8: posts the ante 100
Dimitrrr1: posts the ante 100
pimdebeer: posts the ante 100
jcarlos.vale: posts the ante 100
ennyy01: posts the ante 100
checkroom: posts the ante 100
))) XÞ¥ (((: posts small blind 400
tomsasxdd: posts big blind 800
*** HOLE CARDS ***
Dealt to jcarlos.vale [2d 4c]
puidokas1983: raises 800 to 1600
8EVGENIY8: raises 3200 to 4800
Dimitrrr1: folds 
pimdebeer: folds 
jcarlos.vale: folds 
ennyy01: folds 
checkroom: folds 
))) XÞ¥ (((: folds 
tomsasxdd: folds 
puidokas1983: calls 3200
*** FLOP *** [Jh 8d 5s]
puidokas1983: checks 
8EVGENIY8: bets 3861
puidokas1983: calls 3861
*** TURN *** [Jh 8d 5s] [7d]
puidokas1983: checks 
8EVGENIY8: checks 
*** RIVER *** [Jh 8d 5s 7d] [5d]
puidokas1983: bets 9711
8EVGENIY8: raises 18977 to 28688 and is all-in
puidokas1983: calls 6470 and is all-in
Uncalled bet (12507) returned to 8EVGENIY8
*** SHOW DOWN ***
8EVGENIY8: shows [Ac Ad] (two pair, Aces and Fives)
puidokas1983: shows [Qd As] (a pair of Fives)
8EVGENIY8 collected 51784 from pot
puidokas1983 finished the tournament in 103rd place and received $2.91.
*** SUMMARY ***
Total pot 51784 | Rake 0 
Board [Jh 8d 5s 7d 5d]
Seat 1: ))) XÞ¥ ((( (small blind) folded before Flop
Seat 2: tomsasxdd (big blind) folded before Flop
Seat 3: puidokas1983 showed [Qd As] and lost with a pair of Fives
Seat 4: 8EVGENIY8 showed [Ac Ad] and won (51784) with two pair, Aces and Fives
Seat 5: Dimitrrr1 folded before Flop (didn't bet)
Seat 6: pimdebeer folded before Flop (didn't bet)
Seat 7: jcarlos.vale folded before Flop (didn't bet)
Seat 8: ennyy01 folded before Flop (didn't bet)
Seat 9: checkroom (button) folded before Flop (didn't bet)



PokerStars Hand #221738403121: Tournament #3079057742, $0.98+$0.12 USD Hold'em No Limit - Level XVI (400/800) - 2020/12/23 1:25:06 EET [2020/12/22 18:25:06 ET]
Table '3079057742 16' 9-max Seat #1 is the button
Seat 1: ))) XÞ¥ ((( (18452 in chips) 
Seat 2: tomsasxdd (9513 in chips) 
Seat 4: 8EVGENIY8 (64291 in chips) 
Seat 5: Dimitrrr1 (23301 in chips) 
Seat 6: pimdebeer (34623 in chips) 
Seat 7: jcarlos.vale (20566 in chips) 
Seat 8: ennyy01 (3690 in chips) 
Seat 9: checkroom (7605 in chips) 
))) XÞ¥ (((: posts the ante 100
tomsasxdd: posts the ante 100
8EVGENIY8: posts the ante 100
Dimitrrr1: posts the ante 100
pimdebeer: posts the ante 100
jcarlos.vale: posts the ante 100
ennyy01: posts the ante 100
checkroom: posts the ante 100
tomsasxdd: posts small blind 400
8EVGENIY8: posts big blind 800
*** HOLE CARDS ***
Dealt to jcarlos.vale [Kc Qh]
Dimitrrr1: folds 
pimdebeer: folds 
jcarlos.vale: raises 1280 to 2080
ennyy01: folds 
checkroom: folds 
))) XÞ¥ (((: folds 
tomsasxdd: folds 
8EVGENIY8: folds 
Uncalled bet (1280) returned to jcarlos.vale
jcarlos.vale collected 2800 from pot
jcarlos.vale: doesn't show hand 
*** SUMMARY ***
Total pot 2800 | Rake 0 
Seat 1: ))) XÞ¥ ((( (button) folded before Flop (didn't bet)
Seat 2: tomsasxdd (small blind) folded before Flop
Seat 4: 8EVGENIY8 (big blind) folded before Flop
Seat 5: Dimitrrr1 folded before Flop (didn't bet)
Seat 6: pimdebeer folded before Flop (didn't bet)
Seat 7: jcarlos.vale collected (2800)
Seat 8: ennyy01 folded before Flop (didn't bet)
Seat 9: checkroom folded before Flop (didn't bet)



PokerStars Hand #221738429719: Tournament #3079057742, $0.98+$0.12 USD Hold'em No Limit - Level XVI (400/800) - 2020/12/23 1:25:54 EET [2020/12/22 18:25:54 ET]
Table '3079057742 16' 9-max Seat #2 is the button
Seat 1: ))) XÞ¥ ((( (18352 in chips) 
Seat 2: tomsasxdd (9013 in chips) 
Seat 4: 8EVGENIY8 (63391 in chips) 
Seat 5: Dimitrrr1 (23201 in chips) 
Seat 6: pimdebeer (34523 in chips) 
Seat 7: jcarlos.vale (22466 in chips) 
Seat 8: ennyy01 (3590 in chips) 
Seat 9: checkroom (7505 in chips) 
))) XÞ¥ (((: posts the ante 100
tomsasxdd: posts the ante 100
8EVGENIY8: posts the ante 100
Dimitrrr1: posts the ante 100
pimdebeer: posts the ante 100
jcarlos.vale: posts the ante 100
ennyy01: posts the ante 100
checkroom: posts the ante 100
8EVGENIY8: posts small blind 400
Dimitrrr1: posts big blind 800
*** HOLE CARDS ***
Dealt to jcarlos.vale [5s 7s]
pimdebeer: folds 
jcarlos.vale: folds 
ennyy01: folds 
checkroom: raises 6605 to 7405 and is all-in
))) XÞ¥ (((: folds 
tomsasxdd: folds 
8EVGENIY8: folds 
Dimitrrr1: folds 
Uncalled bet (6605) returned to checkroom
checkroom collected 2800 from pot
checkroom: doesn't show hand 
*** SUMMARY ***
Total pot 2800 | Rake 0 
Seat 1: ))) XÞ¥ ((( folded before Flop (didn't bet)
Seat 2: tomsasxdd (button) folded before Flop (didn't bet)
Seat 4: 8EVGENIY8 (small blind) folded before Flop
Seat 5: Dimitrrr1 (big blind) folded before Flop
Seat 6: pimdebeer folded before Flop (didn't bet)
Seat 7: jcarlos.vale folded before Flop (didn't bet)
Seat 8: ennyy01 folded before Flop (didn't bet)
Seat 9: checkroom collected (2800)



PokerStars Hand #221738448809: Tournament #3079057742, $0.98+$0.12 USD Hold'em No Limit - Level XVI (400/800) - 2020/12/23 1:26:29 EET [2020/12/22 18:26:29 ET]
Table '3079057742 16' 9-max Seat #4 is the button
Seat 1: ))) XÞ¥ ((( (18252 in chips) 
Seat 2: tomsasxdd (8913 in chips) 
Seat 4: 8EVGENIY8 (62891 in chips) 
Seat 5: Dimitrrr1 (22301 in chips) 
Seat 6: pimdebeer (34423 in chips) 
Seat 7: jcarlos.vale (22366 in chips) 
Seat 8: ennyy01 (3490 in chips) 
Seat 9: checkroom (9405 in chips) 
))) XÞ¥ (((: posts the ante 100
tomsasxdd: posts the ante 100
8EVGENIY8: posts the ante 100
Dimitrrr1: posts the ante 100
pimdebeer: posts the ante 100
jcarlos.vale: posts the ante 100
ennyy01: posts the ante 100
checkroom: posts the ante 100
Dimitrrr1: posts small blind 400
pimdebeer: posts big blind 800
*** HOLE CARDS ***
Dealt to jcarlos.vale [5c Kc]
jcarlos.vale: folds 
ennyy01: raises 2590 to 3390 and is all-in
checkroom: folds 
))) XÞ¥ (((: folds 
tomsasxdd: folds 
8EVGENIY8: folds 
Dimitrrr1: folds 
pimdebeer: folds 
Uncalled bet (2590) returned to ennyy01
ennyy01 collected 2800 from pot
ennyy01: doesn't show hand 
*** SUMMARY ***
Total pot 2800 | Rake 0 
Seat 1: ))) XÞ¥ ((( folded before Flop (didn't bet)
Seat 2: tomsasxdd folded before Flop (didn't bet)
Seat 4: 8EVGENIY8 (button) folded before Flop (didn't bet)
Seat 5: Dimitrrr1 (small blind) folded before Flop
Seat 6: pimdebeer (big blind) folded before Flop
Seat 7: jcarlos.vale folded before Flop (didn't bet)
Seat 8: ennyy01 collected (2800)
Seat 9: checkroom folded before Flop (didn't bet)



PokerStars Hand #221738465212: Tournament #3079057742, $0.98+$0.12 USD Hold'em No Limit - Level XVI (400/800) - 2020/12/23 1:26:59 EET [2020/12/22 18:26:59 ET]
Table '3079057742 16' 9-max Seat #5 is the button
Seat 1: ))) XÞ¥ ((( (18152 in chips) 
Seat 2: tomsasxdd (8813 in chips) 
Seat 3: jean.cruz94 (29019 in chips) 
Seat 4: 8EVGENIY8 (62791 in chips) 
Seat 5: Dimitrrr1 (21801 in chips) 
Seat 6: pimdebeer (33523 in chips) 
Seat 7: jcarlos.vale (22266 in chips) 
Seat 8: ennyy01 (5390 in chips) 
Seat 9: checkroom (9305 in chips) 
))) XÞ¥ (((: posts the ante 100
tomsasxdd: posts the ante 100
jean.cruz94: posts the ante 100
8EVGENIY8: posts the ante 100
Dimitrrr1: posts the ante 100
pimdebeer: posts the ante 100
jcarlos.vale: posts the ante 100
ennyy01: posts the ante 100
checkroom: posts the ante 100
pimdebeer: posts small blind 400
jcarlos.vale: posts big blind 800
*** HOLE CARDS ***
Dealt to jcarlos.vale [7h 2s]
ennyy01: folds 
checkroom: folds 
))) XÞ¥ (((: folds 
tomsasxdd: folds 
jean.cruz94: folds 
8EVGENIY8: raises 800 to 1600
Dimitrrr1: folds 
pimdebeer: folds 
jcarlos.vale: folds 
Uncalled bet (800) returned to 8EVGENIY8
8EVGENIY8 collected 2900 from pot
8EVGENIY8: doesn't show hand 
*** SUMMARY ***
Total pot 2900 | Rake 0 
Seat 1: ))) XÞ¥ ((( folded before Flop (didn't bet)
Seat 2: tomsasxdd folded before Flop (didn't bet)
Seat 3: jean.cruz94 folded before Flop (didn't bet)
Seat 4: 8EVGENIY8 collected (2900)
Seat 5: Dimitrrr1 (button) folded before Flop (didn't bet)
Seat 6: pimdebeer (small blind) folded before Flop
Seat 7: jcarlos.vale (big blind) folded before Flop
Seat 8: ennyy01 folded before Flop (didn't bet)
Seat 9: checkroom folded before Flop (didn't bet)



PokerStars Hand #221738480648: Tournament #3079057742, $0.98+$0.12 USD Hold'em No Limit - Level XVI (400/800) - 2020/12/23 1:27:28 EET [2020/12/22 18:27:28 ET]
Table '3079057742 16' 9-max Seat #6 is the button
Seat 1: ))) XÞ¥ ((( (18052 in chips) 
Seat 2: tomsasxdd (8713 in chips) 
Seat 3: jean.cruz94 (28919 in chips) 
Seat 4: 8EVGENIY8 (64791 in chips) 
Seat 5: Dimitrrr1 (21701 in chips) 
Seat 6: pimdebeer (33023 in chips) 
Seat 7: jcarlos.vale (21366 in chips) 
Seat 8: ennyy01 (5290 in chips) 
Seat 9: checkroom (9205 in chips) 
))) XÞ¥ (((: posts the ante 100
tomsasxdd: posts the ante 100
jean.cruz94: posts the ante 100
8EVGENIY8: posts the ante 100
Dimitrrr1: posts the ante 100
pimdebeer: posts the ante 100
jcarlos.vale: posts the ante 100
ennyy01: posts the ante 100
checkroom: posts the ante 100
jcarlos.vale: posts small blind 400
ennyy01: posts big blind 800
*** HOLE CARDS ***
Dealt to jcarlos.vale [Th Ts]
checkroom: folds 
))) XÞ¥ (((: folds 
tomsasxdd: folds 
jean.cruz94: folds 
8EVGENIY8: folds 
Dimitrrr1: folds 
pimdebeer: raises 1200 to 2000
jcarlos.vale: raises 4400 to 6400
ennyy01: folds 
pimdebeer: folds 
Uncalled bet (4400) returned to jcarlos.vale
jcarlos.vale collected 5700 from pot
jcarlos.vale: doesn't show hand 
*** SUMMARY ***
Total pot 5700 | Rake 0 
Seat 1: ))) XÞ¥ ((( folded before Flop (didn't bet)
Seat 2: tomsasxdd folded before Flop (didn't bet)
Seat 3: jean.cruz94 folded before Flop (didn't bet)
Seat 4: 8EVGENIY8 folded before Flop (didn't bet)
Seat 5: Dimitrrr1 folded before Flop (didn't bet)
Seat 6: pimdebeer (button) folded before Flop
Seat 7: jcarlos.vale (small blind) collected (5700)
Seat 8: ennyy01 (big blind) folded before Flop
Seat 9: checkroom folded before Flop (didn't bet)



PokerStars Hand #221738503844: Tournament #3079057742, $0.98+$0.12 USD Hold'em No Limit - Level XVI (400/800) - 2020/12/23 1:28:11 EET [2020/12/22 18:28:11 ET]
Table '3079057742 16' 9-max Seat #7 is the button
Seat 1: ))) XÞ¥ ((( (17952 in chips) 
Seat 2: tomsasxdd (8613 in chips) 
Seat 3: jean.cruz94 (28819 in chips) 
Seat 4: 8EVGENIY8 (64691 in chips) 
Seat 5: Dimitrrr1 (21601 in chips) 
Seat 6: pimdebeer (30923 in chips) 
Seat 7: jcarlos.vale (24966 in chips) 
Seat 8: ennyy01 (4390 in chips) 
Seat 9: checkroom (9105 in chips) 
))) XÞ¥ (((: posts the ante 100
tomsasxdd: posts the ante 100
jean.cruz94: posts the ante 100
8EVGENIY8: posts the ante 100
Dimitrrr1: posts the ante 100
pimdebeer: posts the ante 100
jcarlos.vale: posts the ante 100
ennyy01: posts the ante 100
checkroom: posts the ante 100
ennyy01: posts small blind 400
checkroom: posts big blind 800
*** HOLE CARDS ***
Dealt to jcarlos.vale [As Kh]
))) XÞ¥ (((: folds 
tomsasxdd: folds 
jean.cruz94: folds 
8EVGENIY8: raises 800 to 1600
Dimitrrr1: folds 
pimdebeer: folds 
jcarlos.vale: calls 1600
ennyy01: folds 
checkroom: folds 
*** FLOP *** [6h 6s 4d]
8EVGENIY8: checks 
jcarlos.vale: checks 
*** TURN *** [6h 6s 4d] [2d]
8EVGENIY8: bets 1749
jcarlos.vale: calls 1749
*** RIVER *** [6h 6s 4d 2d] [Qs]
8EVGENIY8: checks 
jcarlos.vale: checks 
*** SHOW DOWN ***
8EVGENIY8: shows [Ac 2c] (two pair, Sixes and Deuces)
jcarlos.vale: mucks hand 
8EVGENIY8 collected 8798 from pot
*** SUMMARY ***
Total pot 8798 | Rake 0 
Board [6h 6s 4d 2d Qs]
Seat 1: ))) XÞ¥ ((( folded before Flop (didn't bet)
Seat 2: tomsasxdd folded before Flop (didn't bet)
Seat 3: jean.cruz94 folded before Flop (didn't bet)
Seat 4: 8EVGENIY8 showed [Ac 2c] and won (8798) with two pair, Sixes and Deuces
Seat 5: Dimitrrr1 folded before Flop (didn't bet)
Seat 6: pimdebeer folded before Flop (didn't bet)
Seat 7: jcarlos.vale (button) mucked [As Kh]
Seat 8: ennyy01 (small blind) folded before Flop
Seat 9: checkroom (big blind) folded before Flop



PokerStars Hand #221738536427: Tournament #3079057742, $0.98+$0.12 USD Hold'em No Limit - Level XVI (400/800) - 2020/12/23 1:29:12 EET [2020/12/22 18:29:12 ET]
Table '3079057742 16' 9-max Seat #8 is the button
Seat 1: ))) XÞ¥ ((( (17852 in chips) 
Seat 2: tomsasxdd (8513 in chips) 
Seat 3: jean.cruz94 (28719 in chips) 
Seat 4: 8EVGENIY8 (70040 in chips) 
Seat 5: Dimitrrr1 (21501 in chips) 
Seat 6: pimdebeer (30823 in chips) 
Seat 7: jcarlos.vale (21517 in chips) 
Seat 8: ennyy01 (3890 in chips) 
Seat 9: checkroom (8205 in chips) 
))) XÞ¥ (((: posts the ante 100
tomsasxdd: posts the ante 100
jean.cruz94: posts the ante 100
8EVGENIY8: posts the ante 100
Dimitrrr1: posts the ante 100
pimdebeer: posts the ante 100
jcarlos.vale: posts the ante 100
ennyy01: posts the ante 100
checkroom: posts the ante 100
checkroom: posts small blind 400
))) XÞ¥ (((: posts big blind 800
*** HOLE CARDS ***
Dealt to jcarlos.vale [7c 8d]
tomsasxdd: calls 800
jean.cruz94: calls 800
8EVGENIY8: folds 
Dimitrrr1: folds 
pimdebeer: folds 
jcarlos.vale: folds 
ennyy01: folds 
checkroom: folds 
))) XÞ¥ (((: checks 
*** FLOP *** [Ac Qc 2h]
))) XÞ¥ (((: checks 
tomsasxdd: bets 800
jean.cruz94: calls 800
))) XÞ¥ (((: calls 800
*** TURN *** [Ac Qc 2h] [4h]
))) XÞ¥ (((: checks 
tomsasxdd: checks 
jean.cruz94: bets 3050
))) XÞ¥ (((: calls 3050
tomsasxdd: calls 3050
*** RIVER *** [Ac Qc 2h 4h] [4d]
))) XÞ¥ (((: checks 
tomsasxdd: checks 
jean.cruz94: checks 
*** SHOW DOWN ***
))) XÞ¥ (((: shows [Kc Qh] (two pair, Queens and Fours)
tomsasxdd: mucks hand 
jean.cruz94: shows [Qs Th] (two pair, Queens and Fours)
))) XÞ¥ ((( collected 7625 from pot
jean.cruz94 collected 7625 from pot
*** SUMMARY ***
Total pot 15250 | Rake 0 
Board [Ac Qc 2h 4h 4d]
Seat 1: ))) XÞ¥ ((( (big blind) showed [Kc Qh] and won (7625) with two pair, Queens and Fours
Seat 2: tomsasxdd mucked [Tc 8c]
Seat 3: jean.cruz94 showed [Qs Th] and won (7625) with two pair, Queens and Fours
Seat 4: 8EVGENIY8 folded before Flop (didn't bet)
Seat 5: Dimitrrr1 folded before Flop (didn't bet)
Seat 6: pimdebeer folded before Flop (didn't bet)
Seat 7: jcarlos.vale folded before Flop (didn't bet)
Seat 8: ennyy01 (button) folded before Flop (didn't bet)
Seat 9: checkroom (small blind) folded before Flop



PokerStars Hand #221738580439: Tournament #3079057742, $0.98+$0.12 USD Hold'em No Limit - Level XVI (400/800) - 2020/12/23 1:30:34 EET [2020/12/22 18:30:34 ET]
Table '3079057742 16' 9-max Seat #9 is the button
Seat 1: ))) XÞ¥ ((( (20727 in chips) 
Seat 2: tomsasxdd (3763 in chips) 
Seat 3: jean.cruz94 (31594 in chips) 
Seat 4: 8EVGENIY8 (69940 in chips) 
Seat 5: Dimitrrr1 (21401 in chips) 
Seat 6: pimdebeer (30723 in chips) 
Seat 7: jcarlos.vale (21417 in chips) 
Seat 8: ennyy01 (3790 in chips) 
Seat 9: checkroom (7705 in chips) 
))) XÞ¥ (((: posts the ante 100
tomsasxdd: posts the ante 100
jean.cruz94: posts the ante 100
8EVGENIY8: posts the ante 100
Dimitrrr1: posts the ante 100
pimdebeer: posts the ante 100
jcarlos.vale: posts the ante 100
ennyy01: posts the ante 100
checkroom: posts the ante 100
))) XÞ¥ (((: posts small blind 400
tomsasxdd: posts big blind 800
*** HOLE CARDS ***
Dealt to jcarlos.vale [7s 3h]
jean.cruz94: folds 
8EVGENIY8: folds 
Dimitrrr1: folds 
pimdebeer: folds 
jcarlos.vale: folds 
ennyy01: folds 
checkroom: raises 6805 to 7605 and is all-in
))) XÞ¥ (((: folds 
tomsasxdd: calls 2863 and is all-in
Uncalled bet (3942) returned to checkroom
*** FLOP *** [4c 8h Qd]
*** TURN *** [4c 8h Qd] [Jd]
*** RIVER *** [4c 8h Qd Jd] [Ah]
*** SHOW DOWN ***
tomsasxdd: shows [Ts Qs] (a pair of Queens)
checkroom: shows [Qc Tc] (a pair of Queens)
tomsasxdd collected 4313 from pot
checkroom collected 4313 from pot
*** SUMMARY ***
Total pot 8626 | Rake 0 
Board [4c 8h Qd Jd Ah]
Seat 1: ))) XÞ¥ ((( (small blind) folded before Flop
Seat 2: tomsasxdd (big blind) showed [Ts Qs] and won (4313) with a pair of Queens
Seat 3: jean.cruz94 folded before Flop (didn't bet)
Seat 4: 8EVGENIY8 folded before Flop (didn't bet)
Seat 5: Dimitrrr1 folded before Flop (didn't bet)
Seat 6: pimdebeer folded before Flop (didn't bet)
Seat 7: jcarlos.vale folded before Flop (didn't bet)
Seat 8: ennyy01 folded before Flop (didn't bet)
Seat 9: checkroom (button) showed [Qc Tc] and won (4313) with a pair of Queens



PokerStars Hand #221738595686: Tournament #3079057742, $0.98+$0.12 USD Hold'em No Limit - Level XVII (500/1000) - 2020/12/23 1:31:02 EET [2020/12/22 18:31:02 ET]
Table '3079057742 16' 9-max Seat #1 is the button
Seat 1: ))) XÞ¥ ((( (20227 in chips) 
Seat 2: tomsasxdd (4313 in chips) 
Seat 3: jean.cruz94 (31494 in chips) 
Seat 4: 8EVGENIY8 (69840 in chips) 
Seat 5: Dimitrrr1 (21301 in chips) 
Seat 6: pimdebeer (30623 in chips) 
Seat 7: jcarlos.vale (21317 in chips) 
Seat 8: ennyy01 (3690 in chips) 
Seat 9: checkroom (8255 in chips) 
))) XÞ¥ (((: posts the ante 125
tomsasxdd: posts the ante 125
jean.cruz94: posts the ante 125
8EVGENIY8: posts the ante 125
Dimitrrr1: posts the ante 125
pimdebeer: posts the ante 125
jcarlos.vale: posts the ante 125
ennyy01: posts the ante 125
checkroom: posts the ante 125
tomsasxdd: posts small blind 500
jean.cruz94: posts big blind 1000
*** HOLE CARDS ***
Dealt to jcarlos.vale [9d 5s]
8EVGENIY8: raises 1000 to 2000
Dimitrrr1: folds 
pimdebeer: folds 
jcarlos.vale: folds 
ennyy01: folds 
checkroom: folds 
))) XÞ¥ (((: folds 
tomsasxdd: folds 
jean.cruz94: folds 
Uncalled bet (1000) returned to 8EVGENIY8
8EVGENIY8 collected 3625 from pot
8EVGENIY8: doesn't show hand 
*** SUMMARY ***
Total pot 3625 | Rake 0 
Seat 1: ))) XÞ¥ ((( (button) folded before Flop (didn't bet)
Seat 2: tomsasxdd (small blind) folded before Flop
Seat 3: jean.cruz94 (big blind) folded before Flop
Seat 4: 8EVGENIY8 collected (3625)
Seat 5: Dimitrrr1 folded before Flop (didn't bet)
Seat 6: pimdebeer folded before Flop (didn't bet)
Seat 7: jcarlos.vale folded before Flop (didn't bet)
Seat 8: ennyy01 folded before Flop (didn't bet)
Seat 9: checkroom folded before Flop (didn't bet)



PokerStars Hand #221738607893: Tournament #3079057742, $0.98+$0.12 USD Hold'em No Limit - Level XVII (500/1000) - 2020/12/23 1:31:25 EET [2020/12/22 18:31:25 ET]
Table '3079057742 16' 9-max Seat #2 is the button
Seat 1: ))) XÞ¥ ((( (20102 in chips) 
Seat 2: tomsasxdd (3688 in chips) 
Seat 3: jean.cruz94 (30369 in chips) 
Seat 4: 8EVGENIY8 (72340 in chips) 
Seat 5: Dimitrrr1 (21176 in chips) 
Seat 6: pimdebeer (30498 in chips) 
Seat 7: jcarlos.vale (21192 in chips) 
Seat 8: ennyy01 (3565 in chips) 
Seat 9: checkroom (8130 in chips) 
))) XÞ¥ (((: posts the ante 125
tomsasxdd: posts the ante 125
jean.cruz94: posts the ante 125
8EVGENIY8: posts the ante 125
Dimitrrr1: posts the ante 125
pimdebeer: posts the ante 125
jcarlos.vale: posts the ante 125
ennyy01: posts the ante 125
checkroom: posts the ante 125
jean.cruz94: posts small blind 500
8EVGENIY8: posts big blind 1000
*** HOLE CARDS ***
Dealt to jcarlos.vale [9s 2h]
Dimitrrr1: folds 
pimdebeer: folds 
jcarlos.vale: folds 
ennyy01: raises 2440 to 3440 and is all-in
checkroom: raises 4565 to 8005 and is all-in
))) XÞ¥ (((: folds 
tomsasxdd: calls 3563 and is all-in
jean.cruz94: raises 22239 to 30244 and is all-in
8EVGENIY8: folds 
Uncalled bet (22239) returned to jean.cruz94
*** FLOP *** [Kc Qh 7d]
*** TURN *** [Kc Qh 7d] [5d]
*** RIVER *** [Kc Qh 7d 5d] [Jd]
*** SHOW DOWN ***
jean.cruz94: shows [Qd Ad] (a flush, Ace high)
checkroom: shows [Ts Ks] (a pair of Kings)
jean.cruz94 collected 8884 from side pot-2 
tomsasxdd: shows [4h 4s] (a pair of Fours)
jean.cruz94 collected 369 from side pot-1 
ennyy01: shows [As 9h] (high card Ace)
jean.cruz94 collected 15885 from main pot
checkroom finished the tournament in 91st place and received $2.91.
tomsasxdd finished the tournament in 92nd place and received $2.91.
ennyy01 finished the tournament in 93rd place and received $2.91.
*** SUMMARY ***
Total pot 25138 Main pot 15885. Side pot-1 369. Side pot-2 8884. | Rake 0 
Board [Kc Qh 7d 5d Jd]
Seat 1: ))) XÞ¥ ((( folded before Flop (didn't bet)
Seat 2: tomsasxdd (button) showed [4h 4s] and lost with a pair of Fours
Seat 3: jean.cruz94 (small blind) showed [Qd Ad] and won (25138) with a flush, Ace high
Seat 4: 8EVGENIY8 (big blind) folded before Flop
Seat 5: Dimitrrr1 folded before Flop (didn't bet)
Seat 6: pimdebeer folded before Flop (didn't bet)
Seat 7: jcarlos.vale folded before Flop (didn't bet)
Seat 8: ennyy01 showed [As 9h] and lost with high card Ace
Seat 9: checkroom showed [Ts Ks] and lost with a pair of Kings



PokerStars Hand #221738646260: Tournament #3079057742, $0.98+$0.12 USD Hold'em No Limit - Level XVII (500/1000) - 2020/12/23 1:32:36 EET [2020/12/22 18:32:36 ET]
Table '3079057742 5' 9-max Seat #2 is the button
Seat 1: paulomimo (31006 in chips) 
Seat 2: markgs2011 (16783 in chips) 
Seat 3: jqs1 (63205 in chips) 
Seat 4: Radodo96 (78873 in chips) 
Seat 5: salentino80 (20184 in chips) 
Seat 6: jcarlos.vale (21067 in chips) 
Seat 7: renanpf123 (22433 in chips) 
Seat 8: bog7775030 (3039 in chips) 
Seat 9: isimireanu (26341 in chips) 
paulomimo: posts the ante 125
markgs2011: posts the ante 125
jqs1: posts the ante 125
Radodo96: posts the ante 125
salentino80: posts the ante 125
jcarlos.vale: posts the ante 125
renanpf123: posts the ante 125
bog7775030: posts the ante 125
isimireanu: posts the ante 125
jqs1: posts small blind 500
Radodo96: posts big blind 1000
*** HOLE CARDS ***
Dealt to jcarlos.vale [5h Ah]
salentino80: folds 
jcarlos.vale: raises 1600 to 2600
renanpf123: folds 
bog7775030: folds 
isimireanu: folds 
paulomimo: folds 
markgs2011: folds 
jqs1: calls 2100
Radodo96: calls 1600
*** FLOP *** [Qh 6h Jh]
jqs1: checks 
Radodo96: checks 
jcarlos.vale: checks 
*** TURN *** [Qh 6h Jh] [9c]
jqs1: bets 1000
Radodo96: calls 1000
jcarlos.vale: calls 1000
*** RIVER *** [Qh 6h Jh 9c] [Kd]
jqs1: bets 1000
Radodo96: folds 
jcarlos.vale: raises 3000 to 4000
jqs1: calls 3000
*** SHOW DOWN ***
jcarlos.vale: shows [5h Ah] (a flush, Ace high)
jqs1: mucks hand 
jcarlos.vale collected 19925 from pot
*** SUMMARY ***
Total pot 19925 | Rake 0 
Board [Qh 6h Jh 9c Kd]
Seat 1: paulomimo folded before Flop (didn't bet)
Seat 2: markgs2011 (button) folded before Flop (didn't bet)
Seat 3: jqs1 (small blind) mucked [Tc Ts]
Seat 4: Radodo96 (big blind) folded on the River
Seat 5: salentino80 folded before Flop (didn't bet)
Seat 6: jcarlos.vale showed [5h Ah] and won (19925) with a flush, Ace high
Seat 7: renanpf123 folded before Flop (didn't bet)
Seat 8: bog7775030 folded before Flop (didn't bet)
Seat 9: isimireanu folded before Flop (didn't bet)



PokerStars Hand #221738682122: Tournament #3079057742, $0.98+$0.12 USD Hold'em No Limit - Level XVII (500/1000) - 2020/12/23 1:33:43 EET [2020/12/22 18:33:43 ET]
Table '3079057742 5' 9-max Seat #3 is the button
Seat 1: paulomimo (30881 in chips) 
Seat 2: markgs2011 (16658 in chips) 
Seat 3: jqs1 (55480 in chips) 
Seat 4: Radodo96 (75148 in chips) 
Seat 5: salentino80 (20059 in chips) 
Seat 6: jcarlos.vale (33267 in chips) 
Seat 7: renanpf123 (22308 in chips) 
Seat 8: bog7775030 (2914 in chips) 
Seat 9: isimireanu (26216 in chips) 
paulomimo: posts the ante 125
markgs2011: posts the ante 125
jqs1: posts the ante 125
Radodo96: posts the ante 125
salentino80: posts the ante 125
jcarlos.vale: posts the ante 125
renanpf123: posts the ante 125
bog7775030: posts the ante 125
isimireanu: posts the ante 125
Radodo96: posts small blind 500
salentino80: posts big blind 1000
*** HOLE CARDS ***
Dealt to jcarlos.vale [Jh 7d]
jcarlos.vale: folds 
renanpf123: folds 
bog7775030: folds 
isimireanu: folds 
paulomimo: folds 
markgs2011: folds 
jqs1: folds 
Radodo96: raises 2000 to 3000
salentino80: raises 16934 to 19934 and is all-in
Radodo96: folds 
Uncalled bet (16934) returned to salentino80
salentino80 collected 7125 from pot
salentino80: doesn't show hand 
*** SUMMARY ***
Total pot 7125 | Rake 0 
Seat 1: paulomimo folded before Flop (didn't bet)
Seat 2: markgs2011 folded before Flop (didn't bet)
Seat 3: jqs1 (button) folded before Flop (didn't bet)
Seat 4: Radodo96 (small blind) folded before Flop
Seat 5: salentino80 (big blind) collected (7125)
Seat 6: jcarlos.vale folded before Flop (didn't bet)
Seat 7: renanpf123 folded before Flop (didn't bet)
Seat 8: bog7775030 folded before Flop (didn't bet)
Seat 9: isimireanu folded before Flop (didn't bet)



PokerStars Hand #221738705547: Tournament #3079057742, $0.98+$0.12 USD Hold'em No Limit - Level XVII (500/1000) - 2020/12/23 1:34:27 EET [2020/12/22 18:34:27 ET]
Table '3079057742 5' 9-max Seat #4 is the button
Seat 1: paulomimo (30756 in chips) 
Seat 2: markgs2011 (16533 in chips) 
Seat 3: jqs1 (55355 in chips) 
Seat 4: Radodo96 (72023 in chips) 
Seat 5: salentino80 (24059 in chips) 
Seat 6: jcarlos.vale (33142 in chips) 
Seat 7: renanpf123 (22183 in chips) 
Seat 8: bog7775030 (2789 in chips) 
Seat 9: isimireanu (26091 in chips) 
paulomimo: posts the ante 125
markgs2011: posts the ante 125
jqs1: posts the ante 125
Radodo96: posts the ante 125
salentino80: posts the ante 125
jcarlos.vale: posts the ante 125
renanpf123: posts the ante 125
bog7775030: posts the ante 125
isimireanu: posts the ante 125
salentino80: posts small blind 500
jcarlos.vale: posts big blind 1000
*** HOLE CARDS ***
Dealt to jcarlos.vale [4h 3h]
renanpf123: folds 
bog7775030: raises 1625 to 2625
isimireanu: folds 
paulomimo: calls 2625
markgs2011: folds 
jqs1: folds 
Radodo96: folds 
salentino80: folds 
jcarlos.vale: calls 1625
*** FLOP *** [Td Qh 8c]
jcarlos.vale: bets 1000
bog7775030: calls 39 and is all-in
paulomimo: calls 1000
*** TURN *** [Td Qh 8c] [5h]
jcarlos.vale: checks 
paulomimo: checks 
*** RIVER *** [Td Qh 8c 5h] [5s]
jcarlos.vale: checks 
paulomimo: checks 
*** SHOW DOWN ***
jcarlos.vale: shows [4h 3h] (a pair of Fives)
paulomimo: shows [Th Kh] (two pair, Tens and Fives)
paulomimo collected 1922 from side pot
bog7775030: shows [Kc Qd] (two pair, Queens and Fives)
bog7775030 collected 9617 from main pot
*** SUMMARY ***
Total pot 11539 Main pot 9617. Side pot 1922. | Rake 0 
Board [Td Qh 8c 5h 5s]
Seat 1: paulomimo showed [Th Kh] and won (1922) with two pair, Tens and Fives
Seat 2: markgs2011 folded before Flop (didn't bet)
Seat 3: jqs1 folded before Flop (didn't bet)
Seat 4: Radodo96 (button) folded before Flop (didn't bet)
Seat 5: salentino80 (small blind) folded before Flop
Seat 6: jcarlos.vale (big blind) showed [4h 3h] and lost with a pair of Fives
Seat 7: renanpf123 folded before Flop (didn't bet)
Seat 8: bog7775030 showed [Kc Qd] and won (9617) with two pair, Queens and Fives
Seat 9: isimireanu folded before Flop (didn't bet)



PokerStars Hand #221738734304: Tournament #3079057742, $0.98+$0.12 USD Hold'em No Limit - Level XVII (500/1000) - 2020/12/23 1:35:20 EET [2020/12/22 18:35:20 ET]
Table '3079057742 5' 9-max Seat #5 is the button
Seat 1: paulomimo (28928 in chips) 
Seat 2: markgs2011 (16408 in chips) 
Seat 3: jqs1 (55230 in chips) 
Seat 4: Radodo96 (71898 in chips) 
Seat 5: salentino80 (23434 in chips) 
Seat 6: jcarlos.vale (29392 in chips) 
Seat 7: renanpf123 (22058 in chips) 
Seat 8: bog7775030 (9617 in chips) 
Seat 9: isimireanu (25966 in chips) 
paulomimo: posts the ante 125
markgs2011: posts the ante 125
jqs1: posts the ante 125
Radodo96: posts the ante 125
salentino80: posts the ante 125
jcarlos.vale: posts the ante 125
renanpf123: posts the ante 125
bog7775030: posts the ante 125
isimireanu: posts the ante 125
jcarlos.vale: posts small blind 500
renanpf123: posts big blind 1000
*** HOLE CARDS ***
Dealt to jcarlos.vale [4h 7h]
bog7775030: folds 
isimireanu: folds 
paulomimo: folds 
markgs2011: calls 1000
jqs1: calls 1000
Radodo96: folds 
salentino80: folds 
jcarlos.vale: calls 500
renanpf123: checks 
*** FLOP *** [8h Kc 2c]
jcarlos.vale: checks 
renanpf123: checks 
markgs2011: bets 15283 and is all-in
jqs1: calls 15283
jcarlos.vale: folds 
renanpf123: folds 
*** TURN *** [8h Kc 2c] [4c]
*** RIVER *** [8h Kc 2c 4c] [Ks]
*** SHOW DOWN ***
markgs2011: shows [Ac 3c] (a flush, Ace high)
jqs1: shows [9c Kd] (three of a kind, Kings)
markgs2011 collected 35691 from pot
*** SUMMARY ***
Total pot 35691 | Rake 0 
Board [8h Kc 2c 4c Ks]
Seat 1: paulomimo folded before Flop (didn't bet)
Seat 2: markgs2011 showed [Ac 3c] and won (35691) with a flush, Ace high
Seat 3: jqs1 showed [9c Kd] and lost with three of a kind, Kings
Seat 4: Radodo96 folded before Flop (didn't bet)
Seat 5: salentino80 (button) folded before Flop (didn't bet)
Seat 6: jcarlos.vale (small blind) folded on the Flop
Seat 7: renanpf123 (big blind) folded on the Flop
Seat 8: bog7775030 folded before Flop (didn't bet)
Seat 9: isimireanu folded before Flop (didn't bet)



PokerStars Hand #221738761470: Tournament #3079057742, $0.98+$0.12 USD Hold'em No Limit - Level XVII (500/1000) - 2020/12/23 1:36:11 EET [2020/12/22 18:36:11 ET]
Table '3079057742 5' 9-max Seat #6 is the button
Seat 1: paulomimo (28803 in chips) 
Seat 2: markgs2011 (35691 in chips) 
Seat 3: jqs1 (38822 in chips) 
Seat 5: salentino80 (23309 in chips) 
Seat 6: jcarlos.vale (28267 in chips) 
Seat 7: renanpf123 (20933 in chips) 
Seat 8: bog7775030 (9492 in chips) 
Seat 9: isimireanu (25841 in chips) 
paulomimo: posts the ante 125
markgs2011: posts the ante 125
jqs1: posts the ante 125
salentino80: posts the ante 125
jcarlos.vale: posts the ante 125
renanpf123: posts the ante 125
bog7775030: posts the ante 125
isimireanu: posts the ante 125
renanpf123: posts small blind 500
bog7775030: posts big blind 1000
*** HOLE CARDS ***
Dealt to jcarlos.vale [9d Ah]
isimireanu: raises 1100 to 2100
paulomimo: folds 
markgs2011: folds 
jqs1: calls 2100
salentino80: calls 2100
jcarlos.vale: folds 
renanpf123: folds 
bog7775030: folds 
*** FLOP *** [2h Qc 3c]
isimireanu: checks 
jqs1: checks 
salentino80: checks 
*** TURN *** [2h Qc 3c] [Kd]
isimireanu: checks 
jqs1: checks 
salentino80: checks 
*** RIVER *** [2h Qc 3c Kd] [Jd]
isimireanu: checks 
jqs1: checks 
salentino80: checks 
*** SHOW DOWN ***
isimireanu: shows [Ts Tc] (a pair of Tens)
jqs1: mucks hand 
salentino80: mucks hand 
isimireanu collected 8800 from pot
*** SUMMARY ***
Total pot 8800 | Rake 0 
Board [2h Qc 3c Kd Jd]
Seat 1: paulomimo folded before Flop (didn't bet)
Seat 2: markgs2011 folded before Flop (didn't bet)
Seat 3: jqs1 mucked [Ad 5d]
Seat 5: salentino80 mucked [8c Ac]
Seat 6: jcarlos.vale (button) folded before Flop (didn't bet)
Seat 7: renanpf123 (small blind) folded before Flop
Seat 8: bog7775030 (big blind) folded before Flop
Seat 9: isimireanu showed [Ts Tc] and won (8800) with a pair of Tens



PokerStars Hand #221738799473: Tournament #3079057742, $0.98+$0.12 USD Hold'em No Limit - Level XVII (500/1000) - 2020/12/23 1:37:14 EET [2020/12/22 18:37:14 ET]
Table '3079057742 5' 9-max Seat #7 is the button
Seat 1: paulomimo (28678 in chips) 
Seat 2: markgs2011 (35566 in chips) 
Seat 3: jqs1 (36597 in chips) 
Seat 5: salentino80 (21084 in chips) 
Seat 6: jcarlos.vale (28142 in chips) 
Seat 7: renanpf123 (20308 in chips) 
Seat 8: bog7775030 (8367 in chips) 
Seat 9: isimireanu (32416 in chips) 
paulomimo: posts the ante 125
markgs2011: posts the ante 125
jqs1: posts the ante 125
salentino80: posts the ante 125
jcarlos.vale: posts the ante 125
renanpf123: posts the ante 125
bog7775030: posts the ante 125
isimireanu: posts the ante 125
bog7775030: posts small blind 500
isimireanu: posts big blind 1000
*** HOLE CARDS ***
Dealt to jcarlos.vale [Ks As]
paulomimo: folds 
markgs2011: calls 1000
jqs1: folds 
salentino80: calls 1000
jcarlos.vale: raises 2000 to 3000
renanpf123: folds 
bog7775030: folds 
isimireanu: folds 
markgs2011: calls 2000
salentino80: calls 2000
*** FLOP *** [5s 7c Ac]
markgs2011: bets 4000
salentino80: calls 4000
jcarlos.vale: raises 17625 to 21625
markgs2011: raises 10816 to 32441 and is all-in
salentino80: folds 
jcarlos.vale: calls 3392 and is all-in
Uncalled bet (7424) returned to markgs2011
*** TURN *** [5s 7c Ac] [Kd]
*** RIVER *** [5s 7c Ac Kd] [Jh]
*** SHOW DOWN ***
markgs2011: shows [7d 7h] (three of a kind, Sevens)
jcarlos.vale: shows [Ks As] (two pair, Aces and Kings)
markgs2011 collected 65534 from pot
jcarlos.vale finished the tournament in 80th place and received $2.91.
*** SUMMARY ***
Total pot 65534 | Rake 0 
Board [5s 7c Ac Kd Jh]
Seat 1: paulomimo folded before Flop (didn't bet)
Seat 2: markgs2011 showed [7d 7h] and won (65534) with three of a kind, Sevens
Seat 3: jqs1 folded before Flop (didn't bet)
Seat 5: salentino80 folded on the Flop
Seat 6: jcarlos.vale showed [Ks As] and lost with two pair, Aces and Kings
Seat 7: renanpf123 (button) folded before Flop (didn't bet)
Seat 8: bog7775030 (small blind) folded before Flop
Seat 9: isimireanu (big blind) folded before Flop



