PokerStars Hand #208296842229: Tournament #2779056951, $0.49+$0.06 USD Hold'em No Limit - Level VI (50/100) - 2020/01/18 22:02:11 EET [2020/01/18 15:02:11 ET]
Table '2779056951 40' 9-max Seat #5 is the button
Seat 1: W SERENA (5000 in chips) 
Seat 2: matalaha (6917 in chips) 
Seat 3: xTheWindelPilot (1268 in chips) 
Seat 4: schlier4 (8186 in chips) 
Seat 5: mjmj1971 (10998 in chips) 
Seat 6: GunDolfAA (4523 in chips) 
Seat 7: Oliver N76 (13836 in chips) 
Seat 8: H3ll5cream (2717 in chips) 
Seat 9: jcarlos.vale (5000 in chips) 
W SERENA: posts the ante 10
matalaha: posts the ante 10
xTheWindelPilot: posts the ante 10
schlier4: posts the ante 10
mjmj1971: posts the ante 10
GunDolfAA: posts the ante 10
Oliver N76: posts the ante 10
H3ll5cream: posts the ante 10
jcarlos.vale: posts the ante 10
GunDolfAA: posts small blind 50
Oliver N76: posts big blind 100
*** HOLE CARDS ***
Dealt to jcarlos.vale [Kc 7d]
H3ll5cream: folds 
jcarlos.vale: folds 
W SERENA: calls 100
matalaha: folds 
xTheWindelPilot: folds 
schlier4: folds 
mjmj1971: calls 100
GunDolfAA: folds 
Oliver N76: checks 
*** FLOP *** [7s 5h Jc]
Oliver N76: checks 
W SERENA: checks 
mjmj1971: checks 
*** TURN *** [7s 5h Jc] [Qd]
Oliver N76: checks 
W SERENA: checks 
mjmj1971: checks 
*** RIVER *** [7s 5h Jc Qd] [8d]
Oliver N76: checks 
W SERENA: checks 
mjmj1971: bets 300
Oliver N76: folds 
W SERENA: folds 
Uncalled bet (300) returned to mjmj1971
mjmj1971 collected 440 from pot
mjmj1971: doesn't show handDTO
*** SUMMARY ***
Total pot 440 | Rake 0 
Board [7s 5h Jc Qd 8d]
Seat 1: W SERENA folded on the River
Seat 2: matalaha folded before Flop (didn't bet)
Seat 3: xTheWindelPilot folded before Flop (didn't bet)
Seat 4: schlier4 folded before Flop (didn't bet)
Seat 5: mjmj1971 (button) collected (440)
Seat 6: GunDolfAA (small blind) folded before Flop
Seat 7: Oliver N76 (big blind) folded on the River
Seat 8: H3ll5cream folded before Flop (didn't bet)
Seat 9: jcarlos.vale folded before Flop (didn't bet)



PokerStars Hand #208296897356: Tournament #2779056951, $0.49+$0.06 USD Hold'em No Limit - Level VI (50/100) - 2020/01/18 22:03:38 EET [2020/01/18 15:03:38 ET]
Table '2779056951 40' 9-max Seat #6 is the button
Seat 1: W SERENA (4890 in chips) 
Seat 2: matalaha (6907 in chips) 
Seat 3: xTheWindelPilot (1258 in chips) 
Seat 4: schlier4 (8176 in chips) 
Seat 5: mjmj1971 (11328 in chips) 
Seat 6: GunDolfAA (4463 in chips) 
Seat 7: Oliver N76 (13726 in chips) 
Seat 8: H3ll5cream (2707 in chips) 
Seat 9: jcarlos.vale (4990 in chips) 
W SERENA: posts the ante 10
matalaha: posts the ante 10
xTheWindelPilot: posts the ante 10
schlier4: posts the ante 10
mjmj1971: posts the ante 10
GunDolfAA: posts the ante 10
Oliver N76: posts the ante 10
H3ll5cream: posts the ante 10
jcarlos.vale: posts the ante 10
Oliver N76: posts small blind 50
H3ll5cream: posts big blind 100
*** HOLE CARDS ***
Dealt to jcarlos.vale [As 5s]
jcarlos.vale: folds 
W SERENA: calls 100
matalaha: folds 
xTheWindelPilot: folds 
schlier4: calls 100
mjmj1971: calls 100
GunDolfAA: folds 
Oliver N76: calls 50
H3ll5cream: raises 2597 to 2697 and is all-in
W SERENA: folds 
schlier4: folds 
mjmj1971: folds 
Oliver N76: folds 
Uncalled bet (2597) returned to H3ll5cream
H3ll5cream collected 590 from pot
H3ll5cream: doesn't show handDTO
*** SUMMARY ***
Total pot 590 | Rake 0 
Seat 1: W SERENA folded before Flop
Seat 2: matalaha folded before Flop (didn't bet)
Seat 3: xTheWindelPilot folded before Flop (didn't bet)
Seat 4: schlier4 folded before Flop
Seat 5: mjmj1971 folded before Flop
Seat 6: GunDolfAA (button) folded before Flop (didn't bet)
Seat 7: Oliver N76 (small blind) folded before Flop
Seat 8: H3ll5cream (big blind) collected (590)
Seat 9: jcarlos.vale folded before Flop (didn't bet)



PokerStars Hand #208296919055: Tournament #2779056951, $0.49+$0.06 USD Hold'em No Limit - Level VI (50/100) - 2020/01/18 22:04:12 EET [2020/01/18 15:04:12 ET]
Table '2779056951 40' 9-max Seat #7 is the button
Seat 1: W SERENA (4780 in chips) 
Seat 2: matalaha (6897 in chips) 
Seat 3: xTheWindelPilot (1248 in chips) 
Seat 4: schlier4 (8066 in chips) 
Seat 5: mjmj1971 (11218 in chips) 
Seat 6: GunDolfAA (4453 in chips) 
Seat 7: Oliver N76 (13616 in chips) 
Seat 8: H3ll5cream (3187 in chips) 
Seat 9: jcarlos.vale (4980 in chips) 
W SERENA: posts the ante 10
matalaha: posts the ante 10
xTheWindelPilot: posts the ante 10
schlier4: posts the ante 10
mjmj1971: posts the ante 10
GunDolfAA: posts the ante 10
Oliver N76: posts the ante 10
H3ll5cream: posts the ante 10
jcarlos.vale: posts the ante 10
H3ll5cream: posts small blind 50
jcarlos.vale: posts big blind 100
*** HOLE CARDS ***
Dealt to jcarlos.vale [7d Qh]
W SERENA: calls 100
matalaha: folds 
xTheWindelPilot: folds 
schlier4: folds 
mjmj1971: folds 
GunDolfAA: folds 
Oliver N76: folds 
H3ll5cream: folds 
jcarlos.vale: checks 
*** FLOP *** [9c Ts 5s]
jcarlos.vale: checks 
W SERENA: bets 500
jcarlos.vale: folds 
Uncalled bet (500) returned to W SERENA
W SERENA collected 340 from pot
W SERENA: doesn't show handDTO
*** SUMMARY ***
Total pot 340 | Rake 0 
Board [9c Ts 5s]
Seat 1: W SERENA collected (340)
Seat 2: matalaha folded before Flop (didn't bet)
Seat 3: xTheWindelPilot folded before Flop (didn't bet)
Seat 4: schlier4 folded before Flop (didn't bet)
Seat 5: mjmj1971 folded before Flop (didn't bet)
Seat 6: GunDolfAA folded before Flop (didn't bet)
Seat 7: Oliver N76 (button) folded before Flop (didn't bet)
Seat 8: H3ll5cream (small blind) folded before Flop
Seat 9: jcarlos.vale (big blind) folded on the Flop



PokerStars Hand #208296936565: Tournament #2779056951, $0.49+$0.06 USD Hold'em No Limit - Level VI (50/100) - 2020/01/18 22:04:39 EET [2020/01/18 15:04:39 ET]
Table '2779056951 40' 9-max Seat #8 is the button
Seat 1: W SERENA (5010 in chips) 
Seat 2: matalaha (6887 in chips) 
Seat 3: xTheWindelPilot (1238 in chips) 
Seat 4: schlier4 (8056 in chips) 
Seat 5: mjmj1971 (11208 in chips) 
Seat 6: GunDolfAA (4443 in chips) 
Seat 7: Oliver N76 (13606 in chips) 
Seat 8: H3ll5cream (3127 in chips) 
Seat 9: jcarlos.vale (4870 in chips) 
W SERENA: posts the ante 10
matalaha: posts the ante 10
xTheWindelPilot: posts the ante 10
schlier4: posts the ante 10
mjmj1971: posts the ante 10
GunDolfAA: posts the ante 10
Oliver N76: posts the ante 10
H3ll5cream: posts the ante 10
jcarlos.vale: posts the ante 10
jcarlos.vale: posts small blind 50
W SERENA: posts big blind 100
*** HOLE CARDS ***
Dealt to jcarlos.vale [5d Qd]
matalaha: folds 
xTheWindelPilot: folds 
schlier4: folds 
mjmj1971: folds 
GunDolfAA: folds 
Oliver N76: folds 
H3ll5cream: folds 
jcarlos.vale: folds 
Uncalled bet (50) returned to W SERENA
W SERENA collected 190 from pot
W SERENA: doesn't show handDTO
*** SUMMARY ***
Total pot 190 | Rake 0 
Seat 1: W SERENA (big blind) collected (190)
Seat 2: matalaha folded before Flop (didn't bet)
Seat 3: xTheWindelPilot folded before Flop (didn't bet)
Seat 4: schlier4 folded before Flop (didn't bet)
Seat 5: mjmj1971 folded before Flop (didn't bet)
Seat 6: GunDolfAA folded before Flop (didn't bet)
Seat 7: Oliver N76 folded before Flop (didn't bet)
Seat 8: H3ll5cream (button) folded before Flop (didn't bet)
Seat 9: jcarlos.vale (small blind) folded before Flop



PokerStars Hand #208296947668: Tournament #2779056951, $0.49+$0.06 USD Hold'em No Limit - Level VI (50/100) - 2020/01/18 22:04:57 EET [2020/01/18 15:04:57 ET]
Table '2779056951 40' 9-max Seat #9 is the button
Seat 1: W SERENA (5140 in chips) 
Seat 2: matalaha (6877 in chips) 
Seat 3: xTheWindelPilot (1228 in chips) 
Seat 4: schlier4 (8046 in chips) 
Seat 5: mjmj1971 (11198 in chips) 
Seat 6: GunDolfAA (4433 in chips) 
Seat 7: Oliver N76 (13596 in chips) 
Seat 8: H3ll5cream (3117 in chips) 
Seat 9: jcarlos.vale (4810 in chips) 
W SERENA: posts the ante 10
matalaha: posts the ante 10
xTheWindelPilot: posts the ante 10
schlier4: posts the ante 10
mjmj1971: posts the ante 10
GunDolfAA: posts the ante 10
Oliver N76: posts the ante 10
H3ll5cream: posts the ante 10
jcarlos.vale: posts the ante 10
W SERENA: posts small blind 50
matalaha: posts big blind 100
*** HOLE CARDS ***
Dealt to jcarlos.vale [9d 4c]
xTheWindelPilot: folds 
schlier4: folds 
mjmj1971: calls 100
GunDolfAA: folds 
Oliver N76: folds 
H3ll5cream: folds 
jcarlos.vale: folds 
W SERENA: calls 50
matalaha: checks 
*** FLOP *** [6d 6h 3s]
W SERENA: checks 
matalaha: checks 
mjmj1971: checks 
*** TURN *** [6d 6h 3s] [Td]
W SERENA: checks 
matalaha: checks 
mjmj1971: bets 100
W SERENA: calls 100
matalaha: folds 
*** RIVER *** [6d 6h 3s Td] [2h]
W SERENA: checks 
mjmj1971: bets 100
W SERENA: folds 
Uncalled bet (100) returned to mjmj1971
mjmj1971 collected 590 from pot
mjmj1971: doesn't show handDTO
*** SUMMARY ***
Total pot 590 | Rake 0 
Board [6d 6h 3s Td 2h]
Seat 1: W SERENA (small blind) folded on the River
Seat 2: matalaha (big blind) folded on the Turn
Seat 3: xTheWindelPilot folded before Flop (didn't bet)
Seat 4: schlier4 folded before Flop (didn't bet)
Seat 5: mjmj1971 collected (590)
Seat 6: GunDolfAA folded before Flop (didn't bet)
Seat 7: Oliver N76 folded before Flop (didn't bet)
Seat 8: H3ll5cream folded before Flop (didn't bet)
Seat 9: jcarlos.vale (button) folded before Flop (didn't bet)



PokerStars Hand #208296993434: Tournament #2779056951, $0.49+$0.06 USD Hold'em No Limit - Level VI (50/100) - 2020/01/18 22:06:07 EET [2020/01/18 15:06:07 ET]
Table '2779056951 40' 9-max Seat #1 is the button
Seat 1: W SERENA (4930 in chips) 
Seat 2: matalaha (6767 in chips) 
Seat 3: xTheWindelPilot (1218 in chips) 
Seat 4: schlier4 (8036 in chips) 
Seat 5: mjmj1971 (11578 in chips) 
Seat 6: GunDolfAA (4423 in chips) 
Seat 7: Oliver N76 (13586 in chips) 
Seat 8: H3ll5cream (3107 in chips) 
Seat 9: jcarlos.vale (4800 in chips) 
W SERENA: posts the ante 10
matalaha: posts the ante 10
xTheWindelPilot: posts the ante 10
schlier4: posts the ante 10
mjmj1971: posts the ante 10
GunDolfAA: posts the ante 10
Oliver N76: posts the ante 10
H3ll5cream: posts the ante 10
jcarlos.vale: posts the ante 10
matalaha: posts small blind 50
xTheWindelPilot: posts big blind 100
*** HOLE CARDS ***
Dealt to jcarlos.vale [3h Qs]
schlier4: folds 
mjmj1971: folds 
GunDolfAA: calls 100
Oliver N76: folds 
H3ll5cream: folds 
jcarlos.vale: folds 
W SERENA: calls 100
matalaha: calls 50
xTheWindelPilot: raises 1108 to 1208 and is all-in
GunDolfAA: folds 
W SERENA: calls 1108
matalaha: folds 
*** FLOP *** [9d 9h 9c]
*** TURN *** [9d 9h 9c] [9s]
*** RIVER *** [9d 9h 9c 9s] [8c]
*** SHOW DOWN ***
xTheWindelPilot: shows [8s 8h] (four of a kind, Nines)
W SERENA: shows [As 3s] (four of a kind, Nines - Ace kicker)
W SERENA collected 2706 from pot
xTheWindelPilot finished the tournament
*** SUMMARY ***
Total pot 2706 | Rake 0 
Board [9d 9h 9c 9s 8c]
Seat 1: W SERENA (button) showed [As 3s] and won (2706) with four of a kind, Nines
Seat 2: matalaha (small blind) folded before Flop
Seat 3: xTheWindelPilot (big blind) showed [8s 8h] and lost with four of a kind, Nines
Seat 4: schlier4 folded before Flop (didn't bet)
Seat 5: mjmj1971 folded before Flop (didn't bet)
Seat 6: GunDolfAA folded before Flop
Seat 7: Oliver N76 folded before Flop (didn't bet)
Seat 8: H3ll5cream folded before Flop (didn't bet)
Seat 9: jcarlos.vale folded before Flop (didn't bet)



PokerStars Hand #208297047144: Tournament #2779056951, $0.49+$0.06 USD Hold'em No Limit - Level VII (60/120) - 2020/01/18 22:07:29 EET [2020/01/18 15:07:29 ET]
Table '2779056951 40' 9-max Seat #2 is the button
Seat 1: W SERENA (6418 in chips) 
Seat 2: matalaha (6657 in chips) 
Seat 4: schlier4 (8026 in chips) 
Seat 5: mjmj1971 (11568 in chips) 
Seat 6: GunDolfAA (4313 in chips) 
Seat 7: Oliver N76 (13576 in chips) 
Seat 8: H3ll5cream (3097 in chips) 
Seat 9: jcarlos.vale (4790 in chips) 
W SERENA: posts the ante 12
matalaha: posts the ante 12
schlier4: posts the ante 12
mjmj1971: posts the ante 12
GunDolfAA: posts the ante 12
Oliver N76: posts the ante 12
H3ll5cream: posts the ante 12
jcarlos.vale: posts the ante 12
schlier4: posts small blind 60
mjmj1971: posts big blind 120
*** HOLE CARDS ***
Dealt to jcarlos.vale [8c 4d]
GunDolfAA: raises 360 to 480
Oliver N76: folds 
H3ll5cream: folds 
jcarlos.vale: folds 
W SERENA: calls 480
matalaha: folds 
schlier4: folds 
mjmj1971: folds 
*** FLOP *** [8s Ks 6c]
GunDolfAA: bets 618
W SERENA: folds 
Uncalled bet (618) returned to GunDolfAA
GunDolfAA collected 1236 from pot
GunDolfAA: doesn't show handDTO
*** SUMMARY ***
Total pot 1236 | Rake 0 
Board [8s Ks 6c]
Seat 1: W SERENA folded on the Flop
Seat 2: matalaha (button) folded before Flop (didn't bet)
Seat 4: schlier4 (small blind) folded before Flop
Seat 5: mjmj1971 (big blind) folded before Flop
Seat 6: GunDolfAA collected (1236)
Seat 7: Oliver N76 folded before Flop (didn't bet)
Seat 8: H3ll5cream folded before Flop (didn't bet)
Seat 9: jcarlos.vale folded before Flop (didn't bet)



PokerStars Hand #208297072991: Tournament #2779056951, $0.49+$0.06 USD Hold'em No Limit - Level VII (60/120) - 2020/01/18 22:08:08 EET [2020/01/18 15:08:08 ET]
Table '2779056951 40' 9-max Seat #4 is the button
Seat 1: W SERENA (5926 in chips) 
Seat 2: matalaha (6645 in chips) 
Seat 3: VitalikX77 (5000 in chips) 
Seat 4: schlier4 (7954 in chips) 
Seat 5: mjmj1971 (11436 in chips) 
Seat 6: GunDolfAA (5057 in chips) 
Seat 7: Oliver N76 (13564 in chips) 
Seat 8: H3ll5cream (3085 in chips) 
Seat 9: jcarlos.vale (4778 in chips) 
W SERENA: posts the ante 12
matalaha: posts the ante 12
VitalikX77: posts the ante 12
schlier4: posts the ante 12
mjmj1971: posts the ante 12
GunDolfAA: posts the ante 12
Oliver N76: posts the ante 12
H3ll5cream: posts the ante 12
jcarlos.vale: posts the ante 12
mjmj1971: posts small blind 60
GunDolfAA: posts big blind 120
*** HOLE CARDS ***
Dealt to jcarlos.vale [5d 2d]
Oliver N76: folds 
H3ll5cream: folds 
jcarlos.vale: folds 
W SERENA: calls 120
matalaha: folds 
VitalikX77: folds 
schlier4: folds 
mjmj1971: calls 60
GunDolfAA: checks 
*** FLOP *** [4c Kc 7s]
mjmj1971: checks 
GunDolfAA: bets 120
W SERENA: folds 
mjmj1971: calls 120
*** TURN *** [4c Kc 7s] [6d]
mjmj1971: checks 
GunDolfAA: bets 120
mjmj1971: folds 
Uncalled bet (120) returned to GunDolfAA
GunDolfAA collected 708 from pot
*** SUMMARY ***
Total pot 708 | Rake 0 
Board [4c Kc 7s 6d]
Seat 1: W SERENA folded on the Flop
Seat 2: matalaha folded before Flop (didn't bet)
Seat 3: VitalikX77 folded before Flop (didn't bet)
Seat 4: schlier4 (button) folded before Flop (didn't bet)
Seat 5: mjmj1971 (small blind) folded on the Turn
Seat 6: GunDolfAA (big blind) collected (708)
Seat 7: Oliver N76 folded before Flop (didn't bet)
Seat 8: H3ll5cream folded before Flop (didn't bet)
Seat 9: jcarlos.vale folded before Flop (didn't bet)



PokerStars Hand #208297100749: Tournament #2779056951, $0.49+$0.06 USD Hold'em No Limit - Level VII (60/120) - 2020/01/18 22:08:50 EET [2020/01/18 15:08:50 ET]
Table '2779056951 40' 9-max Seat #5 is the button
Seat 1: W SERENA (5794 in chips) 
Seat 2: matalaha (6633 in chips) 
Seat 3: VitalikX77 (4988 in chips) 
Seat 4: schlier4 (7942 in chips) 
Seat 5: mjmj1971 (11184 in chips) 
Seat 6: GunDolfAA (5513 in chips) 
Seat 7: Oliver N76 (13552 in chips) 
Seat 8: H3ll5cream (3073 in chips) 
Seat 9: jcarlos.vale (4766 in chips) 
W SERENA: posts the ante 12
matalaha: posts the ante 12
VitalikX77: posts the ante 12
schlier4: posts the ante 12
mjmj1971: posts the ante 12
GunDolfAA: posts the ante 12
Oliver N76: posts the ante 12
H3ll5cream: posts the ante 12
jcarlos.vale: posts the ante 12
GunDolfAA: posts small blind 60
Oliver N76: posts big blind 120
*** HOLE CARDS ***
Dealt to jcarlos.vale [Jd 4c]
H3ll5cream: folds 
jcarlos.vale: folds 
W SERENA: raises 840 to 960
matalaha: folds 
VitalikX77: folds 
schlier4: folds 
mjmj1971: folds 
GunDolfAA: folds 
Oliver N76: folds 
Uncalled bet (840) returned to W SERENA
W SERENA collected 408 from pot
W SERENA: doesn't show handDTO
*** SUMMARY ***
Total pot 408 | Rake 0 
Seat 1: W SERENA collected (408)
Seat 2: matalaha folded before Flop (didn't bet)
Seat 3: VitalikX77 folded before Flop (didn't bet)
Seat 4: schlier4 folded before Flop (didn't bet)
Seat 5: mjmj1971 (button) folded before Flop (didn't bet)
Seat 6: GunDolfAA (small blind) folded before Flop
Seat 7: Oliver N76 (big blind) folded before Flop
Seat 8: H3ll5cream folded before Flop (didn't bet)
Seat 9: jcarlos.vale folded before Flop (didn't bet)



PokerStars Hand #208297141666: Tournament #2779056951, $0.49+$0.06 USD Hold'em No Limit - Level VII (60/120) - 2020/01/18 22:09:43 EET [2020/01/18 15:09:43 ET]
Table '2779056951 40' 9-max Seat #6 is the button
Seat 1: W SERENA (6070 in chips) 
Seat 2: matalaha (6621 in chips) 
Seat 3: VitalikX77 (4976 in chips) 
Seat 4: schlier4 (7930 in chips) 
Seat 5: mjmj1971 (11172 in chips) 
Seat 6: GunDolfAA (5441 in chips) 
Seat 7: Oliver N76 (13420 in chips) 
Seat 8: H3ll5cream (3061 in chips) 
Seat 9: jcarlos.vale (4754 in chips) 
W SERENA: posts the ante 12
matalaha: posts the ante 12
VitalikX77: posts the ante 12
schlier4: posts the ante 12
mjmj1971: posts the ante 12
GunDolfAA: posts the ante 12
Oliver N76: posts the ante 12
H3ll5cream: posts the ante 12
jcarlos.vale: posts the ante 12
Oliver N76: posts small blind 60
H3ll5cream: posts big blind 120
*** HOLE CARDS ***
Dealt to jcarlos.vale [3d Tc]
jcarlos.vale: folds 
W SERENA: calls 120
matalaha: folds 
VitalikX77: raises 240 to 360
schlier4: folds 
mjmj1971: folds 
GunDolfAA: folds 
Oliver N76: calls 300
H3ll5cream: folds 
W SERENA: raises 5698 to 6058 and is all-in
VitalikX77: calls 4604 and is all-in
Oliver N76: folds [8c 8s]
Uncalled bet (1094) returned to W SERENA
*** FLOP *** [9d 2h 9h]
*** TURN *** [9d 2h 9h] [Jh]
*** RIVER *** [9d 2h 9h Jh] [6s]
*** SHOW DOWN ***
W SERENA: shows [As Qc] (a pair of Nines)
VitalikX77: shows [Ah Qh] (a flush, Ace high)
VitalikX77 collected 10516 from pot
*** SUMMARY ***
Total pot 10516 | Rake 0 
Board [9d 2h 9h Jh 6s]
Seat 1: W SERENA showed [As Qc] and lost with a pair of Nines
Seat 2: matalaha folded before Flop (didn't bet)
Seat 3: VitalikX77 showed [Ah Qh] and won (10516) with a flush, Ace high
Seat 4: schlier4 folded before Flop (didn't bet)
Seat 5: mjmj1971 folded before Flop (didn't bet)
Seat 6: GunDolfAA (button) folded before Flop (didn't bet)
Seat 7: Oliver N76 (small blind) folded before Flop
Seat 8: H3ll5cream (big blind) folded before Flop
Seat 9: jcarlos.vale folded before Flop (didn't bet)



PokerStars Hand #208297171261: Tournament #2779056951, $0.49+$0.06 USD Hold'em No Limit - Level VII (60/120) - 2020/01/18 22:10:28 EET [2020/01/18 15:10:28 ET]
Table '2779056951 40' 9-max Seat #7 is the button
Seat 1: W SERENA (1094 in chips) 
Seat 2: matalaha (6609 in chips) 
Seat 3: VitalikX77 (10516 in chips) 
Seat 4: schlier4 (7918 in chips) 
Seat 5: mjmj1971 (11160 in chips) 
Seat 6: GunDolfAA (5429 in chips) 
Seat 7: Oliver N76 (13048 in chips) 
Seat 8: H3ll5cream (2929 in chips) 
Seat 9: jcarlos.vale (4742 in chips) 
W SERENA: posts the ante 12
matalaha: posts the ante 12
VitalikX77: posts the ante 12
schlier4: posts the ante 12
mjmj1971: posts the ante 12
GunDolfAA: posts the ante 12
Oliver N76: posts the ante 12
H3ll5cream: posts the ante 12
jcarlos.vale: posts the ante 12
H3ll5cream: posts small blind 60
jcarlos.vale: posts big blind 120
*** HOLE CARDS ***
Dealt to jcarlos.vale [Js 4h]
W SERENA: folds 
matalaha: raises 144 to 264
VitalikX77: folds 
schlier4: folds 
mjmj1971: folds 
GunDolfAA: calls 264
Oliver N76: folds 
H3ll5cream: folds 
jcarlos.vale: folds 
*** FLOP *** [2d 9s Th]
matalaha: bets 571
GunDolfAA: calls 571
*** TURN *** [2d 9s Th] [7s]
matalaha: checks 
GunDolfAA: checks 
*** RIVER *** [2d 9s Th 7s] [5c]
matalaha: checks 
GunDolfAA: checks 
*** SHOW DOWN ***
matalaha: shows [Ts Qs] (a pair of Tens)
GunDolfAA: mucks handDTO
matalaha collected 1958 from pot
*** SUMMARY ***
Total pot 1958 | Rake 0 
Board [2d 9s Th 7s 5c]
Seat 1: W SERENA folded before Flop (didn't bet)
Seat 2: matalaha showed [Ts Qs] and won (1958) with a pair of Tens
Seat 3: VitalikX77 folded before Flop (didn't bet)
Seat 4: schlier4 folded before Flop (didn't bet)
Seat 5: mjmj1971 folded before Flop (didn't bet)
Seat 6: GunDolfAA mucked [Ah 8h]
Seat 7: Oliver N76 (button) folded before Flop (didn't bet)
Seat 8: H3ll5cream (small blind) folded before Flop
Seat 9: jcarlos.vale (big blind) folded before Flop



PokerStars Hand #208297203983: Tournament #2779056951, $0.49+$0.06 USD Hold'em No Limit - Level VII (60/120) - 2020/01/18 22:11:17 EET [2020/01/18 15:11:17 ET]
Table '2779056951 40' 9-max Seat #8 is the button
Seat 1: W SERENA (1082 in chips) 
Seat 2: matalaha (7720 in chips) 
Seat 3: VitalikX77 (10504 in chips) 
Seat 4: schlier4 (7906 in chips) 
Seat 5: mjmj1971 (11148 in chips) 
Seat 6: GunDolfAA (4582 in chips) 
Seat 7: Oliver N76 (13036 in chips) 
Seat 8: H3ll5cream (2857 in chips) 
Seat 9: jcarlos.vale (4610 in chips) 
W SERENA: posts the ante 12
matalaha: posts the ante 12
VitalikX77: posts the ante 12
schlier4: posts the ante 12
mjmj1971: posts the ante 12
GunDolfAA: posts the ante 12
Oliver N76: posts the ante 12
H3ll5cream: posts the ante 12
jcarlos.vale: posts the ante 12
jcarlos.vale: posts small blind 60
W SERENA: posts big blind 120
*** HOLE CARDS ***
Dealt to jcarlos.vale [Kh 3s]
matalaha: folds 
VitalikX77: raises 120 to 240
schlier4: folds 
mjmj1971: calls 240
GunDolfAA: folds 
Oliver N76: folds 
H3ll5cream: folds 
jcarlos.vale: folds 
W SERENA: calls 120
*** FLOP *** [Kc 4h 9c]
W SERENA: checks 
VitalikX77: bets 420
mjmj1971: folds 
W SERENA: folds 
Uncalled bet (420) returned to VitalikX77
VitalikX77 collected 888 from pot
*** SUMMARY ***
Total pot 888 | Rake 0 
Board [Kc 4h 9c]
Seat 1: W SERENA (big blind) folded on the Flop
Seat 2: matalaha folded before Flop (didn't bet)
Seat 3: VitalikX77 collected (888)
Seat 4: schlier4 folded before Flop (didn't bet)
Seat 5: mjmj1971 folded on the Flop
Seat 6: GunDolfAA folded before Flop (didn't bet)
Seat 7: Oliver N76 folded before Flop (didn't bet)
Seat 8: H3ll5cream (button) folded before Flop (didn't bet)
Seat 9: jcarlos.vale (small blind) folded before Flop



PokerStars Hand #208297242690: Tournament #2779056951, $0.49+$0.06 USD Hold'em No Limit - Level VII (60/120) - 2020/01/18 22:12:16 EET [2020/01/18 15:12:16 ET]
Table '2779056951 40' 9-max Seat #9 is the button
Seat 1: W SERENA (830 in chips) 
Seat 2: matalaha (7708 in chips) 
Seat 3: VitalikX77 (11140 in chips) 
Seat 4: schlier4 (7894 in chips) 
Seat 5: mjmj1971 (10896 in chips) 
Seat 6: GunDolfAA (4570 in chips) 
Seat 7: Oliver N76 (13024 in chips) 
Seat 8: H3ll5cream (2845 in chips) 
Seat 9: jcarlos.vale (4538 in chips) 
W SERENA: posts the ante 12
matalaha: posts the ante 12
VitalikX77: posts the ante 12
schlier4: posts the ante 12
mjmj1971: posts the ante 12
GunDolfAA: posts the ante 12
Oliver N76: posts the ante 12
H3ll5cream: posts the ante 12
jcarlos.vale: posts the ante 12
W SERENA: posts small blind 60
matalaha: posts big blind 120
*** HOLE CARDS ***
Dealt to jcarlos.vale [Jd Qd]
VitalikX77: raises 144 to 264
schlier4: calls 264
mjmj1971: folds 
GunDolfAA: folds 
Oliver N76: folds 
H3ll5cream: folds 
jcarlos.vale: folds 
W SERENA: raises 554 to 818 and is all-in
matalaha: folds 
VitalikX77: calls 554
schlier4: calls 554
*** FLOP *** [Js 2d 6d]
VitalikX77: checks 
schlier4: checks 
*** TURN *** [Js 2d 6d] [4c]
VitalikX77: checks 
schlier4: checks 
*** RIVER *** [Js 2d 6d 4c] [7d]
VitalikX77: checks 
schlier4: checks 
*** SHOW DOWN ***
W SERENA: shows [Ts 3s] (high pairOfCards Jack)
VitalikX77: shows [7s 9s] (a pair of Sevens)
schlier4: mucks handDTO
VitalikX77 collected 2682 from pot
W SERENA finished the tournament
*** SUMMARY ***
Total pot 2682 | Rake 0 
Board [Js 2d 6d 4c 7d]
Seat 1: W SERENA (small blind) showed [Ts 3s] and lost with high pairOfCards Jack
Seat 2: matalaha (big blind) folded before Flop
Seat 3: VitalikX77 showed [7s 9s] and won (2682) with a pair of Sevens
Seat 4: schlier4 mucked [5s As]
Seat 5: mjmj1971 folded before Flop (didn't bet)
Seat 6: GunDolfAA folded before Flop (didn't bet)
Seat 7: Oliver N76 folded before Flop (didn't bet)
Seat 8: H3ll5cream folded before Flop (didn't bet)
Seat 9: jcarlos.vale (button) folded before Flop (didn't bet)



PokerStars Hand #208297290084: Tournament #2779056951, $0.49+$0.06 USD Hold'em No Limit - Level VII (60/120) - 2020/01/18 22:13:21 EET [2020/01/18 15:13:21 ET]
Table '2779056951 40' 9-max Seat #2 is the button
Seat 2: matalaha (7576 in chips) 
Seat 3: VitalikX77 (12992 in chips) 
Seat 4: schlier4 (7064 in chips) 
Seat 5: mjmj1971 (10884 in chips) 
Seat 6: GunDolfAA (4558 in chips) 
Seat 7: Oliver N76 (13012 in chips) 
Seat 8: H3ll5cream (2833 in chips) 
Seat 9: jcarlos.vale (4526 in chips) 
matalaha: posts the ante 12
VitalikX77: posts the ante 12
schlier4: posts the ante 12
mjmj1971: posts the ante 12
GunDolfAA: posts the ante 12
Oliver N76: posts the ante 12
H3ll5cream: posts the ante 12
jcarlos.vale: posts the ante 12
VitalikX77: posts small blind 60
schlier4: posts big blind 120
*** HOLE CARDS ***
Dealt to jcarlos.vale [Qh 9d]
mjmj1971: raises 120 to 240
GunDolfAA: folds 
Oliver N76: folds 
H3ll5cream: folds 
jcarlos.vale: folds 
matalaha: folds 
VitalikX77: folds 
schlier4: folds 
Uncalled bet (120) returned to mjmj1971
mjmj1971 collected 396 from pot
mjmj1971: doesn't show handDTO
*** SUMMARY ***
Total pot 396 | Rake 0 
Seat 2: matalaha (button) folded before Flop (didn't bet)
Seat 3: VitalikX77 (small blind) folded before Flop
Seat 4: schlier4 (big blind) folded before Flop
Seat 5: mjmj1971 collected (396)
Seat 6: GunDolfAA folded before Flop (didn't bet)
Seat 7: Oliver N76 folded before Flop (didn't bet)
Seat 8: H3ll5cream folded before Flop (didn't bet)
Seat 9: jcarlos.vale folded before Flop (didn't bet)



PokerStars Hand #208297313312: Tournament #2779056951, $0.49+$0.06 USD Hold'em No Limit - Level VII (60/120) - 2020/01/18 22:13:55 EET [2020/01/18 15:13:55 ET]
Table '2779056951 40' 9-max Seat #3 is the button
Seat 1: hyha692 (5000 in chips) 
Seat 2: matalaha (7564 in chips) 
Seat 3: VitalikX77 (12920 in chips) 
Seat 4: schlier4 (6932 in chips) 
Seat 5: mjmj1971 (11148 in chips) 
Seat 6: GunDolfAA (4546 in chips) 
Seat 7: Oliver N76 (13000 in chips) 
Seat 8: H3ll5cream (2821 in chips) 
Seat 9: jcarlos.vale (4514 in chips) 
hyha692: posts the ante 12
matalaha: posts the ante 12
VitalikX77: posts the ante 12
schlier4: posts the ante 12
mjmj1971: posts the ante 12
GunDolfAA: posts the ante 12
Oliver N76: posts the ante 12
H3ll5cream: posts the ante 12
jcarlos.vale: posts the ante 12
schlier4: posts small blind 60
mjmj1971: posts big blind 120
*** HOLE CARDS ***
Dealt to jcarlos.vale [8h Kh]
GunDolfAA: folds 
Oliver N76: folds 
H3ll5cream: folds 
jcarlos.vale: folds 
hyha692: raises 408 to 528
matalaha: folds 
VitalikX77: folds 
schlier4: folds 
mjmj1971: folds 
Uncalled bet (408) returned to hyha692
hyha692 collected 408 from pot
hyha692: doesn't show handDTO
*** SUMMARY ***
Total pot 408 | Rake 0 
Seat 1: hyha692 collected (408)
Seat 2: matalaha folded before Flop (didn't bet)
Seat 3: VitalikX77 (button) folded before Flop (didn't bet)
Seat 4: schlier4 (small blind) folded before Flop
Seat 5: mjmj1971 (big blind) folded before Flop
Seat 6: GunDolfAA folded before Flop (didn't bet)
Seat 7: Oliver N76 folded before Flop (didn't bet)
Seat 8: H3ll5cream folded before Flop (didn't bet)
Seat 9: jcarlos.vale folded before Flop (didn't bet)



PokerStars Hand #208297327272: Tournament #2779056951, $0.49+$0.06 USD Hold'em No Limit - Level VII (60/120) - 2020/01/18 22:14:16 EET [2020/01/18 15:14:16 ET]
Table '2779056951 40' 9-max Seat #4 is the button
Seat 1: hyha692 (5276 in chips) 
Seat 2: matalaha (7552 in chips) 
Seat 3: VitalikX77 (12908 in chips) 
Seat 4: schlier4 (6860 in chips) 
Seat 5: mjmj1971 (11016 in chips) 
Seat 6: GunDolfAA (4534 in chips) 
Seat 7: Oliver N76 (12988 in chips) 
Seat 8: H3ll5cream (2809 in chips) 
Seat 9: jcarlos.vale (4502 in chips) 
hyha692: posts the ante 12
matalaha: posts the ante 12
VitalikX77: posts the ante 12
schlier4: posts the ante 12
mjmj1971: posts the ante 12
GunDolfAA: posts the ante 12
Oliver N76: posts the ante 12
H3ll5cream: posts the ante 12
jcarlos.vale: posts the ante 12
mjmj1971: posts small blind 60
GunDolfAA: posts big blind 120
*** HOLE CARDS ***
Dealt to jcarlos.vale [Kd Jh]
Oliver N76: folds 
H3ll5cream: folds 
jcarlos.vale: raises 132 to 252
hyha692: folds 
matalaha: folds 
VitalikX77: calls 252
schlier4: calls 252
mjmj1971: calls 192
GunDolfAA: folds 
*** FLOP *** [5c Kc Qs]
mjmj1971: checks 
jcarlos.vale: bets 720
VitalikX77: folds 
schlier4: calls 720
mjmj1971: folds 
*** TURN *** [5c Kc Qs] [9d]
jcarlos.vale: bets 1440
schlier4: folds 
Uncalled bet (1440) returned to jcarlos.vale
jcarlos.vale collected 2676 from pot
jcarlos.vale: doesn't show handDTO
*** SUMMARY ***
Total pot 2676 | Rake 0 
Board [5c Kc Qs 9d]
Seat 1: hyha692 folded before Flop (didn't bet)
Seat 2: matalaha folded before Flop (didn't bet)
Seat 3: VitalikX77 folded on the Flop
Seat 4: schlier4 (button) folded on the Turn
Seat 5: mjmj1971 (small blind) folded on the Flop
Seat 6: GunDolfAA (big blind) folded before Flop
Seat 7: Oliver N76 folded before Flop (didn't bet)
Seat 8: H3ll5cream folded before Flop (didn't bet)
Seat 9: jcarlos.vale collected (2676)



PokerStars Hand #208297367573: Tournament #2779056951, $0.49+$0.06 USD Hold'em No Limit - Level VII (60/120) - 2020/01/18 22:15:17 EET [2020/01/18 15:15:17 ET]
Table '2779056951 40' 9-max Seat #5 is the button
Seat 1: hyha692 (5264 in chips) 
Seat 2: matalaha (7540 in chips) 
Seat 3: VitalikX77 (12644 in chips) 
Seat 4: schlier4 (5876 in chips) 
Seat 5: mjmj1971 (10752 in chips) 
Seat 6: GunDolfAA (4402 in chips) 
Seat 7: Oliver N76 (12976 in chips) 
Seat 8: H3ll5cream (2797 in chips) 
Seat 9: jcarlos.vale (6194 in chips) 
hyha692: posts the ante 12
matalaha: posts the ante 12
VitalikX77: posts the ante 12
schlier4: posts the ante 12
mjmj1971: posts the ante 12
GunDolfAA: posts the ante 12
Oliver N76: posts the ante 12
H3ll5cream: posts the ante 12
jcarlos.vale: posts the ante 12
GunDolfAA: posts small blind 60
Oliver N76: posts big blind 120
*** HOLE CARDS ***
Dealt to jcarlos.vale [Kc Ad]
H3ll5cream: folds 
jcarlos.vale: raises 132 to 252
hyha692: raises 132 to 384
matalaha: folds 
VitalikX77: folds 
schlier4: folds 
mjmj1971: calls 384
GunDolfAA: folds 
Oliver N76: folds 
jcarlos.vale: calls 132
*** FLOP *** [Qc 4h 7c]
jcarlos.vale: checks 
hyha692: bets 1440
mjmj1971: folds 
jcarlos.vale: folds 
Uncalled bet (1440) returned to hyha692
hyha692 collected 1440 from pot
hyha692: doesn't show handDTO
*** SUMMARY ***
Total pot 1440 | Rake 0 
Board [Qc 4h 7c]
Seat 1: hyha692 collected (1440)
Seat 2: matalaha folded before Flop (didn't bet)
Seat 3: VitalikX77 folded before Flop (didn't bet)
Seat 4: schlier4 folded before Flop (didn't bet)
Seat 5: mjmj1971 (button) folded on the Flop
Seat 6: GunDolfAA (small blind) folded before Flop
Seat 7: Oliver N76 (big blind) folded before Flop
Seat 8: H3ll5cream folded before Flop (didn't bet)
Seat 9: jcarlos.vale folded on the Flop



PokerStars Hand #208297405743: Tournament #2779056951, $0.49+$0.06 USD Hold'em No Limit - Level VII (60/120) - 2020/01/18 22:16:15 EET [2020/01/18 15:16:15 ET]
Table '2779056951 40' 9-max Seat #6 is the button
Seat 1: hyha692 (6308 in chips) 
Seat 2: matalaha (7528 in chips) 
Seat 3: VitalikX77 (12632 in chips) 
Seat 4: schlier4 (5864 in chips) 
Seat 5: mjmj1971 (10356 in chips) 
Seat 6: GunDolfAA (4330 in chips) 
Seat 7: Oliver N76 (12844 in chips) 
Seat 8: H3ll5cream (2785 in chips) 
Seat 9: jcarlos.vale (5798 in chips) 
hyha692: posts the ante 12
matalaha: posts the ante 12
VitalikX77: posts the ante 12
schlier4: posts the ante 12
mjmj1971: posts the ante 12
GunDolfAA: posts the ante 12
Oliver N76: posts the ante 12
H3ll5cream: posts the ante 12
jcarlos.vale: posts the ante 12
Oliver N76: posts small blind 60
H3ll5cream: posts big blind 120
*** HOLE CARDS ***
Dealt to jcarlos.vale [7h 3s]
jcarlos.vale: folds 
hyha692: raises 408 to 528
matalaha: folds 
VitalikX77: folds 
schlier4: folds 
mjmj1971: folds 
GunDolfAA: raises 3790 to 4318 and is all-in
Oliver N76: folds 
H3ll5cream: folds 
hyha692: calls 3790
*** FLOP *** [Jd 4d Qs]
*** TURN *** [Jd 4d Qs] [4c]
*** RIVER *** [Jd 4d Qs 4c] [7s]
*** SHOW DOWN ***
hyha692: shows [6d 5d] (a pair of Fours)
GunDolfAA: shows [Ah Ac] (two pair, Aces and Fours)
GunDolfAA collected 8924 from pot
*** SUMMARY ***
Total pot 8924 | Rake 0 
Board [Jd 4d Qs 4c 7s]
Seat 1: hyha692 showed [6d 5d] and lost with a pair of Fours
Seat 2: matalaha folded before Flop (didn't bet)
Seat 3: VitalikX77 folded before Flop (didn't bet)
Seat 4: schlier4 folded before Flop (didn't bet)
Seat 5: mjmj1971 folded before Flop (didn't bet)
Seat 6: GunDolfAA (button) showed [Ah Ac] and won (8924) with two pair, Aces and Fours
Seat 7: Oliver N76 (small blind) folded before Flop
Seat 8: H3ll5cream (big blind) folded before Flop
Seat 9: jcarlos.vale folded before Flop (didn't bet)



PokerStars Hand #208297433429: Tournament #2779056951, $0.49+$0.06 USD Hold'em No Limit - Level VII (60/120) - 2020/01/18 22:16:55 EET [2020/01/18 15:16:55 ET]
Table '2779056951 40' 9-max Seat #7 is the button
Seat 1: hyha692 (1978 in chips) 
Seat 2: matalaha (7516 in chips) 
Seat 3: VitalikX77 (12620 in chips) 
Seat 4: schlier4 (5852 in chips) 
Seat 5: mjmj1971 (10344 in chips) 
Seat 6: GunDolfAA (8924 in chips) 
Seat 7: Oliver N76 (12772 in chips) 
Seat 8: H3ll5cream (2653 in chips) 
Seat 9: jcarlos.vale (5786 in chips) 
hyha692: posts the ante 12
matalaha: posts the ante 12
VitalikX77: posts the ante 12
schlier4: posts the ante 12
mjmj1971: posts the ante 12
GunDolfAA: posts the ante 12
Oliver N76: posts the ante 12
H3ll5cream: posts the ante 12
jcarlos.vale: posts the ante 12
H3ll5cream: posts small blind 60
jcarlos.vale: posts big blind 120
*** HOLE CARDS ***
Dealt to jcarlos.vale [5s 7d]
hyha692: raises 408 to 528
matalaha: folds 
VitalikX77: calls 528
schlier4: calls 528
mjmj1971: folds 
GunDolfAA: folds 
Oliver N76: folds 
H3ll5cream: folds 
jcarlos.vale: folds 
*** FLOP *** [As 9c Ts]
hyha692: checks 
VitalikX77: checks 
schlier4: checks 
*** TURN *** [As 9c Ts] [Jd]
hyha692: bets 936
VitalikX77: raises 936 to 1872
schlier4: calls 1872
hyha692: calls 502 and is all-in
*** RIVER *** [As 9c Ts Jd] [2h]
VitalikX77: checks 
schlier4: checks 
*** SHOW DOWN ***
VitalikX77: shows [Td Qd] (a pair of Tens)
schlier4: shows [Ah Jh] (two pair, Aces and Jacks)
schlier4 collected 868 from side pot
hyha692: mucks handDTO
schlier4 collected 6186 from main pot
hyha692 finished the tournament
*** SUMMARY ***
Total pot 7054 Main pot 6186. Side pot 868. | Rake 0 
Board [As 9c Ts Jd 2h]
Seat 1: hyha692 mucked [4d 8s]
Seat 2: matalaha folded before Flop (didn't bet)
Seat 3: VitalikX77 showed [Td Qd] and lost with a pair of Tens
Seat 4: schlier4 showed [Ah Jh] and won (7054) with two pair, Aces and Jacks
Seat 5: mjmj1971 folded before Flop (didn't bet)
Seat 6: GunDolfAA folded before Flop (didn't bet)
Seat 7: Oliver N76 (button) folded before Flop (didn't bet)
Seat 8: H3ll5cream (small blind) folded before Flop
Seat 9: jcarlos.vale (big blind) folded before Flop



PokerStars Hand #208297508200: Tournament #2779056951, $0.49+$0.06 USD Hold'em No Limit - Level VIII (75/150) - 2020/01/18 22:18:39 EET [2020/01/18 15:18:39 ET]
Table '2779056951 40' 9-max Seat #8 is the button
Seat 1: Saphc (5000 in chips) 
Seat 2: matalaha (7504 in chips) 
Seat 3: VitalikX77 (10208 in chips) 
Seat 4: schlier4 (10494 in chips) 
Seat 5: mjmj1971 (10332 in chips) 
Seat 6: GunDolfAA (8912 in chips) 
Seat 7: Oliver N76 (12760 in chips) 
Seat 8: H3ll5cream (2581 in chips) 
Seat 9: jcarlos.vale (5654 in chips) 
Saphc: posts the ante 15
matalaha: posts the ante 15
VitalikX77: posts the ante 15
schlier4: posts the ante 15
mjmj1971: posts the ante 15
GunDolfAA: posts the ante 15
Oliver N76: posts the ante 15
H3ll5cream: posts the ante 15
jcarlos.vale: posts the ante 15
jcarlos.vale: posts small blind 75
Saphc: posts big blind 150
*** HOLE CARDS ***
Dealt to jcarlos.vale [4s 8d]
matalaha: folds 
VitalikX77: folds 
schlier4: folds 
mjmj1971: raises 150 to 300
GunDolfAA: folds 
Oliver N76: folds 
H3ll5cream: folds 
jcarlos.vale: folds 
Saphc: folds 
Uncalled bet (150) returned to mjmj1971
mjmj1971 collected 510 from pot
mjmj1971: doesn't show handDTO
*** SUMMARY ***
Total pot 510 | Rake 0 
Seat 1: Saphc (big blind) folded before Flop
Seat 2: matalaha folded before Flop (didn't bet)
Seat 3: VitalikX77 folded before Flop (didn't bet)
Seat 4: schlier4 folded before Flop (didn't bet)
Seat 5: mjmj1971 collected (510)
Seat 6: GunDolfAA folded before Flop (didn't bet)
Seat 7: Oliver N76 folded before Flop (didn't bet)
Seat 8: H3ll5cream (button) folded before Flop (didn't bet)
Seat 9: jcarlos.vale (small blind) folded before Flop



PokerStars Hand #208297521215: Tournament #2779056951, $0.49+$0.06 USD Hold'em No Limit - Level VIII (75/150) - 2020/01/18 22:18:59 EET [2020/01/18 15:18:59 ET]
Table '2779056951 40' 9-max Seat #9 is the button
Seat 1: Saphc (4835 in chips) 
Seat 2: matalaha (7489 in chips) 
Seat 3: VitalikX77 (10193 in chips) 
Seat 4: schlier4 (10479 in chips) 
Seat 5: mjmj1971 (10677 in chips) 
Seat 6: GunDolfAA (8897 in chips) 
Seat 7: Oliver N76 (12745 in chips) 
Seat 8: H3ll5cream (2566 in chips) 
Seat 9: jcarlos.vale (5564 in chips) 
Saphc: posts the ante 15
matalaha: posts the ante 15
VitalikX77: posts the ante 15
schlier4: posts the ante 15
mjmj1971: posts the ante 15
GunDolfAA: posts the ante 15
Oliver N76: posts the ante 15
H3ll5cream: posts the ante 15
jcarlos.vale: posts the ante 15
Saphc: posts small blind 75
matalaha: posts big blind 150
*** HOLE CARDS ***
Dealt to jcarlos.vale [2h 5s]
VitalikX77: folds 
schlier4: folds 
mjmj1971: folds 
GunDolfAA: folds 
Oliver N76: folds 
H3ll5cream: folds 
jcarlos.vale: folds 
Saphc: calls 75
matalaha: checks 
*** FLOP *** [Kc 5c 3s]
Saphc: bets 150
matalaha: calls 150
*** TURN *** [Kc 5c 3s] [8h]
Saphc: bets 150
matalaha: calls 150
*** RIVER *** [Kc 5c 3s 8h] [Qc]
Saphc: checks 
matalaha: checks 
*** SHOW DOWN ***
Saphc: shows [6c 4h] (high pairOfCards King)
matalaha: shows [Ah Tc] (high pairOfCards Ace)
matalaha collected 1035 from pot
*** SUMMARY ***
Total pot 1035 | Rake 0 
Board [Kc 5c 3s 8h Qc]
Seat 1: Saphc (small blind) showed [6c 4h] and lost with high pairOfCards King
Seat 2: matalaha (big blind) showed [Ah Tc] and won (1035) with high pairOfCards Ace
Seat 3: VitalikX77 folded before Flop (didn't bet)
Seat 4: schlier4 folded before Flop (didn't bet)
Seat 5: mjmj1971 folded before Flop (didn't bet)
Seat 6: GunDolfAA folded before Flop (didn't bet)
Seat 7: Oliver N76 folded before Flop (didn't bet)
Seat 8: H3ll5cream folded before Flop (didn't bet)
Seat 9: jcarlos.vale (button) folded before Flop (didn't bet)



PokerStars Hand #208297561890: Tournament #2779056951, $0.49+$0.06 USD Hold'em No Limit - Level VIII (75/150) - 2020/01/18 22:20:00 EET [2020/01/18 15:20:00 ET]
Table '2779056951 40' 9-max Seat #1 is the button
Seat 1: Saphc (4370 in chips) 
Seat 2: matalaha (8059 in chips) 
Seat 3: VitalikX77 (10178 in chips) 
Seat 4: schlier4 (10464 in chips) 
Seat 5: mjmj1971 (10662 in chips) 
Seat 6: GunDolfAA (8882 in chips) 
Seat 7: Oliver N76 (12730 in chips) 
Seat 8: H3ll5cream (2551 in chips) 
Seat 9: jcarlos.vale (5549 in chips) 
Saphc: posts the ante 15
matalaha: posts the ante 15
VitalikX77: posts the ante 15
schlier4: posts the ante 15
mjmj1971: posts the ante 15
GunDolfAA: posts the ante 15
Oliver N76: posts the ante 15
H3ll5cream: posts the ante 15
jcarlos.vale: posts the ante 15
matalaha: posts small blind 75
VitalikX77: posts big blind 150
*** HOLE CARDS ***
Dealt to jcarlos.vale [9s 2c]
schlier4: folds 
mjmj1971: folds 
GunDolfAA: folds 
Oliver N76: raises 195 to 345
H3ll5cream: folds 
jcarlos.vale: folds 
Saphc: folds 
matalaha: folds 
VitalikX77: folds 
Uncalled bet (195) returned to Oliver N76
Oliver N76 collected 510 from pot
Oliver N76: doesn't show handDTO
*** SUMMARY ***
Total pot 510 | Rake 0 
Seat 1: Saphc (button) folded before Flop (didn't bet)
Seat 2: matalaha (small blind) folded before Flop
Seat 3: VitalikX77 (big blind) folded before Flop
Seat 4: schlier4 folded before Flop (didn't bet)
Seat 5: mjmj1971 folded before Flop (didn't bet)
Seat 6: GunDolfAA folded before Flop (didn't bet)
Seat 7: Oliver N76 collected (510)
Seat 8: H3ll5cream folded before Flop (didn't bet)
Seat 9: jcarlos.vale folded before Flop (didn't bet)



PokerStars Hand #208297583605: Tournament #2779056951, $0.49+$0.06 USD Hold'em No Limit - Level VIII (75/150) - 2020/01/18 22:20:33 EET [2020/01/18 15:20:33 ET]
Table '2779056951 40' 9-max Seat #2 is the button
Seat 1: Saphc (4355 in chips) 
Seat 2: matalaha (7969 in chips) 
Seat 3: VitalikX77 (10013 in chips) 
Seat 4: schlier4 (10449 in chips) 
Seat 5: mjmj1971 (10647 in chips) 
Seat 6: GunDolfAA (8867 in chips) 
Seat 7: Oliver N76 (13075 in chips) 
Seat 8: H3ll5cream (2536 in chips) 
Seat 9: jcarlos.vale (5534 in chips) 
Saphc: posts the ante 15
matalaha: posts the ante 15
VitalikX77: posts the ante 15
schlier4: posts the ante 15
mjmj1971: posts the ante 15
GunDolfAA: posts the ante 15
Oliver N76: posts the ante 15
H3ll5cream: posts the ante 15
jcarlos.vale: posts the ante 15
VitalikX77: posts small blind 75
schlier4: posts big blind 150
*** HOLE CARDS ***
Dealt to jcarlos.vale [7h 9d]
mjmj1971: folds 
GunDolfAA: folds 
Oliver N76: raises 195 to 345
H3ll5cream: folds 
jcarlos.vale: folds 
Saphc: folds 
matalaha: calls 345
VitalikX77: folds 
schlier4: calls 195
*** FLOP *** [5c 9s 4d]
schlier4: checks 
Oliver N76: checks 
matalaha: checks 
*** TURN *** [5c 9s 4d] [3s]
schlier4: bets 150
Oliver N76: calls 150
matalaha: calls 150
*** RIVER *** [5c 9s 4d 3s] [8h]
schlier4: bets 150
Oliver N76: folds 
matalaha: calls 150
*** SHOW DOWN ***
schlier4: shows [As 9h] (a pair of Nines)
matalaha: mucks handDTO
schlier4 collected 1995 from pot
*** SUMMARY ***
Total pot 1995 | Rake 0 
Board [5c 9s 4d 3s 8h]
Seat 1: Saphc folded before Flop (didn't bet)
Seat 2: matalaha (button) mucked [2h 2c]
Seat 3: VitalikX77 (small blind) folded before Flop
Seat 4: schlier4 (big blind) showed [As 9h] and won (1995) with a pair of Nines
Seat 5: mjmj1971 folded before Flop (didn't bet)
Seat 6: GunDolfAA folded before Flop (didn't bet)
Seat 7: Oliver N76 folded on the River
Seat 8: H3ll5cream folded before Flop (didn't bet)
Seat 9: jcarlos.vale folded before Flop (didn't bet)



PokerStars Hand #208297623017: Tournament #2779056951, $0.49+$0.06 USD Hold'em No Limit - Level VIII (75/150) - 2020/01/18 22:21:33 EET [2020/01/18 15:21:33 ET]
Table '2779056951 40' 9-max Seat #3 is the button
Seat 1: Saphc (4340 in chips) 
Seat 2: matalaha (7309 in chips) 
Seat 3: VitalikX77 (9923 in chips) 
Seat 4: schlier4 (11784 in chips) 
Seat 5: mjmj1971 (10632 in chips) 
Seat 6: GunDolfAA (8852 in chips) 
Seat 7: Oliver N76 (12565 in chips) 
Seat 8: H3ll5cream (2521 in chips) 
Seat 9: jcarlos.vale (5519 in chips) 
Saphc: posts the ante 15
matalaha: posts the ante 15
VitalikX77: posts the ante 15
schlier4: posts the ante 15
mjmj1971: posts the ante 15
GunDolfAA: posts the ante 15
Oliver N76: posts the ante 15
H3ll5cream: posts the ante 15
jcarlos.vale: posts the ante 15
schlier4: posts small blind 75
mjmj1971: posts big blind 150
*** HOLE CARDS ***
Dealt to jcarlos.vale [As 2d]
GunDolfAA: raises 450 to 600
Oliver N76: folds 
H3ll5cream: folds 
jcarlos.vale: folds 
Saphc: calls 600
matalaha: folds 
VitalikX77: folds 
schlier4: folds 
mjmj1971: folds 
*** FLOP *** [5s 6d 2h]
GunDolfAA: checks 
Saphc: bets 3725 and is all-in
GunDolfAA: folds [Qc Ah]
Uncalled bet (3725) returned to Saphc
Saphc collected 1560 from pot
Saphc: doesn't show handDTO
*** SUMMARY ***
Total pot 1560 | Rake 0 
Board [5s 6d 2h]
Seat 1: Saphc collected (1560)
Seat 2: matalaha folded before Flop (didn't bet)
Seat 3: VitalikX77 (button) folded before Flop (didn't bet)
Seat 4: schlier4 (small blind) folded before Flop
Seat 5: mjmj1971 (big blind) folded before Flop
Seat 6: GunDolfAA folded on the Flop
Seat 7: Oliver N76 folded before Flop (didn't bet)
Seat 8: H3ll5cream folded before Flop (didn't bet)
Seat 9: jcarlos.vale folded before Flop (didn't bet)



PokerStars Hand #208297650133: Tournament #2779056951, $0.49+$0.06 USD Hold'em No Limit - Level VIII (75/150) - 2020/01/18 22:22:14 EET [2020/01/18 15:22:14 ET]
Table '2779056951 40' 9-max Seat #4 is the button
Seat 1: Saphc (5285 in chips) 
Seat 2: matalaha (7294 in chips) 
Seat 3: VitalikX77 (9908 in chips) 
Seat 4: schlier4 (11694 in chips) 
Seat 5: mjmj1971 (10467 in chips) 
Seat 6: GunDolfAA (8237 in chips) 
Seat 7: Oliver N76 (12550 in chips) 
Seat 8: H3ll5cream (2506 in chips) 
Seat 9: jcarlos.vale (5504 in chips) 
Saphc: posts the ante 15
matalaha: posts the ante 15
VitalikX77: posts the ante 15
schlier4: posts the ante 15
mjmj1971: posts the ante 15
GunDolfAA: posts the ante 15
Oliver N76: posts the ante 15
H3ll5cream: posts the ante 15
jcarlos.vale: posts the ante 15
mjmj1971: posts small blind 75
GunDolfAA: posts big blind 150
*** HOLE CARDS ***
Dealt to jcarlos.vale [5s 2d]
Oliver N76: folds 
H3ll5cream: folds 
jcarlos.vale: folds 
Saphc: calls 150
matalaha: folds 
VitalikX77: raises 300 to 450
schlier4: folds 
mjmj1971: folds 
GunDolfAA: folds 
Saphc: calls 300
*** FLOP *** [Ac 6s Kd]
Saphc: checks 
VitalikX77: bets 600
Saphc: folds 
Uncalled bet (600) returned to VitalikX77
VitalikX77 collected 1260 from pot
*** SUMMARY ***
Total pot 1260 | Rake 0 
Board [Ac 6s Kd]
Seat 1: Saphc folded on the Flop
Seat 2: matalaha folded before Flop (didn't bet)
Seat 3: VitalikX77 collected (1260)
Seat 4: schlier4 (button) folded before Flop (didn't bet)
Seat 5: mjmj1971 (small blind) folded before Flop
Seat 6: GunDolfAA (big blind) folded before Flop
Seat 7: Oliver N76 folded before Flop (didn't bet)
Seat 8: H3ll5cream folded before Flop (didn't bet)
Seat 9: jcarlos.vale folded before Flop (didn't bet)



PokerStars Hand #208297684128: Tournament #2779056951, $0.49+$0.06 USD Hold'em No Limit - Level VIII (75/150) - 2020/01/18 22:23:05 EET [2020/01/18 15:23:05 ET]
Table '2779056951 40' 9-max Seat #5 is the button
Seat 1: Saphc (4820 in chips) 
Seat 2: matalaha (7279 in chips) 
Seat 3: VitalikX77 (10703 in chips) 
Seat 4: schlier4 (11679 in chips) 
Seat 5: mjmj1971 (10377 in chips) 
Seat 6: GunDolfAA (8072 in chips) 
Seat 7: Oliver N76 (12535 in chips) 
Seat 8: H3ll5cream (2491 in chips) 
Seat 9: jcarlos.vale (5489 in chips) 
Saphc: posts the ante 15
matalaha: posts the ante 15
VitalikX77: posts the ante 15
schlier4: posts the ante 15
mjmj1971: posts the ante 15
GunDolfAA: posts the ante 15
Oliver N76: posts the ante 15
H3ll5cream: posts the ante 15
jcarlos.vale: posts the ante 15
GunDolfAA: posts small blind 75
Oliver N76: posts big blind 150
*** HOLE CARDS ***
Dealt to jcarlos.vale [3h 3c]
H3ll5cream: folds 
jcarlos.vale: raises 165 to 315
Saphc: calls 315
matalaha has timed out
matalaha: folds 
matalaha is sitting out
matalaha has returned
VitalikX77: calls 315
schlier4: folds 
mjmj1971: calls 315
GunDolfAA: calls 240
Oliver N76: calls 165
*** FLOP *** [8c Ah 3d]
GunDolfAA: checks 
Oliver N76: checks 
jcarlos.vale: checks 
Saphc: checks 
VitalikX77: checks 
mjmj1971: checks 
*** TURN *** [8c Ah 3d] [Tc]
GunDolfAA: checks 
Oliver N76: checks 
jcarlos.vale: bets 450
Saphc: folds 
VitalikX77: folds 
mjmj1971: calls 450
GunDolfAA: folds 
Oliver N76: folds 
*** RIVER *** [8c Ah 3d Tc] [3s]
Saphc is sitting out
jcarlos.vale: bets 600
mjmj1971: folds 
Uncalled bet (600) returned to jcarlos.vale
jcarlos.vale collected 2925 from pot
jcarlos.vale: doesn't show handDTO
*** SUMMARY ***
Total pot 2925 | Rake 0 
Board [8c Ah 3d Tc 3s]
Seat 1: Saphc folded on the Turn
Seat 2: matalaha folded before Flop (didn't bet)
Seat 3: VitalikX77 folded on the Turn
Seat 4: schlier4 folded before Flop (didn't bet)
Seat 5: mjmj1971 (button) folded on the River
Seat 6: GunDolfAA (small blind) folded on the Turn
Seat 7: Oliver N76 (big blind) folded on the Turn
Seat 8: H3ll5cream folded before Flop (didn't bet)
Seat 9: jcarlos.vale collected (2925)



PokerStars Hand #208297753601: Tournament #2779056951, $0.49+$0.06 USD Hold'em No Limit - Level VIII (75/150) - 2020/01/18 22:24:51 EET [2020/01/18 15:24:51 ET]
Table '2779056951 40' 9-max Seat #6 is the button
Seat 1: Saphc (4490 in chips) is sitting out
Seat 2: matalaha (7264 in chips) 
Seat 3: VitalikX77 (10373 in chips) 
Seat 4: schlier4 (11664 in chips) 
Seat 5: mjmj1971 (9597 in chips) 
Seat 6: GunDolfAA (7742 in chips) 
Seat 7: Oliver N76 (12205 in chips) 
Seat 8: H3ll5cream (2476 in chips) 
Seat 9: jcarlos.vale (7634 in chips) 
Saphc: posts the ante 15
matalaha: posts the ante 15
VitalikX77: posts the ante 15
schlier4: posts the ante 15
mjmj1971: posts the ante 15
GunDolfAA: posts the ante 15
Oliver N76: posts the ante 15
H3ll5cream: posts the ante 15
jcarlos.vale: posts the ante 15
Oliver N76: posts small blind 75
H3ll5cream: posts big blind 150
*** HOLE CARDS ***
Dealt to jcarlos.vale [9d 5s]
Saphc has returned
jcarlos.vale: folds 
Saphc: calls 150
matalaha: folds 
VitalikX77: folds 
schlier4: folds 
mjmj1971: calls 150
GunDolfAA: folds 
Oliver N76: folds 
H3ll5cream: checks 
*** FLOP *** [4s Ks 3d]
H3ll5cream: checks 
Saphc: bets 300
mjmj1971: calls 300
H3ll5cream: folds 
*** TURN *** [4s Ks 3d] [3h]
Saphc: bets 300
mjmj1971: calls 300
*** RIVER *** [4s Ks 3d 3h] [3s]
Saphc: bets 600
mjmj1971: calls 600
*** SHOW DOWN ***
Saphc: shows [9s 6s] (a flush, King high)
mjmj1971: shows [Kc Qd] (a full house, Threes full of Kings)
mjmj1971 collected 3060 from pot
*** SUMMARY ***
Total pot 3060 | Rake 0 
Board [4s Ks 3d 3h 3s]
Seat 1: Saphc showed [9s 6s] and lost with a flush, King high
Seat 2: matalaha folded before Flop (didn't bet)
Seat 3: VitalikX77 folded before Flop (didn't bet)
Seat 4: schlier4 folded before Flop (didn't bet)
Seat 5: mjmj1971 showed [Kc Qd] and won (3060) with a full house, Threes full of Kings
Seat 6: GunDolfAA (button) folded before Flop (didn't bet)
Seat 7: Oliver N76 (small blind) folded before Flop
Seat 8: H3ll5cream (big blind) folded on the Flop
Seat 9: jcarlos.vale folded before Flop (didn't bet)



PokerStars Hand #208297798548: Tournament #2779056951, $0.49+$0.06 USD Hold'em No Limit - Level VIII (75/150) - 2020/01/18 22:25:49 EET [2020/01/18 15:25:49 ET]
Table '2779056951 40' 9-max Seat #7 is the button
Seat 1: Saphc (3125 in chips) 
Seat 2: matalaha (7249 in chips) 
Seat 3: VitalikX77 (10358 in chips) 
Seat 4: schlier4 (11649 in chips) 
Seat 5: mjmj1971 (11292 in chips) 
Seat 6: GunDolfAA (7727 in chips) 
Seat 7: Oliver N76 (12115 in chips) 
Seat 8: H3ll5cream (2311 in chips) 
Seat 9: jcarlos.vale (7619 in chips) 
Saphc: posts the ante 15
matalaha: posts the ante 15
VitalikX77: posts the ante 15
schlier4: posts the ante 15
mjmj1971: posts the ante 15
GunDolfAA: posts the ante 15
Oliver N76: posts the ante 15
H3ll5cream: posts the ante 15
jcarlos.vale: posts the ante 15
H3ll5cream: posts small blind 75
jcarlos.vale: posts big blind 150
*** HOLE CARDS ***
Dealt to jcarlos.vale [Kd 8s]
Saphc: folds 
matalaha: raises 180 to 330
VitalikX77: folds 
schlier4: folds 
mjmj1971: folds 
GunDolfAA: folds 
Oliver N76: calls 330
H3ll5cream: folds 
jcarlos.vale: folds 
*** FLOP *** [Td 4h 6c]
matalaha: checks 
Oliver N76: checks 
*** TURN *** [Td 4h 6c] [Ah]
matalaha has timed out
matalaha: checks 
Oliver N76: checks 
*** RIVER *** [Td 4h 6c Ah] [Qd]
matalaha: bets 561
Oliver N76: calls 561
*** SHOW DOWN ***
matalaha: shows [Jh As] (a pair of Aces)
Oliver N76: shows [Jd Ad] (a pair of Aces)
matalaha collected 1071 from pot
Oliver N76 collected 1071 from pot
*** SUMMARY ***
Total pot 2142 | Rake 0 
Board [Td 4h 6c Ah Qd]
Seat 1: Saphc folded before Flop (didn't bet)
Seat 2: matalaha showed [Jh As] and won (1071) with a pair of Aces
Seat 3: VitalikX77 folded before Flop (didn't bet)
Seat 4: schlier4 folded before Flop (didn't bet)
Seat 5: mjmj1971 folded before Flop (didn't bet)
Seat 6: GunDolfAA folded before Flop (didn't bet)
Seat 7: Oliver N76 (button) showed [Jd Ad] and won (1071) with a pair of Aces
Seat 8: H3ll5cream (small blind) folded before Flop
Seat 9: jcarlos.vale (big blind) folded before Flop



PokerStars Hand #208297836521: Tournament #2779056951, $0.49+$0.06 USD Hold'em No Limit - Level VIII (75/150) - 2020/01/18 22:26:47 EET [2020/01/18 15:26:47 ET]
Table '2779056951 40' 9-max Seat #8 is the button
Seat 1: Saphc (3110 in chips) 
Seat 2: matalaha (7414 in chips) 
Seat 3: VitalikX77 (10343 in chips) 
Seat 4: schlier4 (11634 in chips) 
Seat 5: mjmj1971 (11277 in chips) 
Seat 6: GunDolfAA (7712 in chips) 
Seat 7: Oliver N76 (12280 in chips) 
Seat 8: H3ll5cream (2221 in chips) 
Seat 9: jcarlos.vale (7454 in chips) 
Saphc: posts the ante 15
matalaha: posts the ante 15
VitalikX77: posts the ante 15
schlier4: posts the ante 15
mjmj1971: posts the ante 15
GunDolfAA: posts the ante 15
Oliver N76: posts the ante 15
H3ll5cream: posts the ante 15
jcarlos.vale: posts the ante 15
jcarlos.vale: posts small blind 75
Saphc: posts big blind 150
*** HOLE CARDS ***
Dealt to jcarlos.vale [7h 8h]
matalaha: folds 
VitalikX77: folds 
schlier4: folds 
mjmj1971: folds 
GunDolfAA: folds 
Oliver N76: folds 
H3ll5cream: raises 2056 to 2206 and is all-in
jcarlos.vale: folds 
Saphc: calls 2056
*** FLOP *** [7s 8c 2s]
*** TURN *** [7s 8c 2s] [Qs]
*** RIVER *** [7s 8c 2s Qs] [7c]
*** SHOW DOWN ***
Saphc: shows [Tc Ad] (a pair of Sevens)
H3ll5cream: shows [Qc Ks] (two pair, Queens and Sevens)
H3ll5cream collected 4622 from pot
*** SUMMARY ***
Total pot 4622 | Rake 0 
Board [7s 8c 2s Qs 7c]
Seat 1: Saphc (big blind) showed [Tc Ad] and lost with a pair of Sevens
Seat 2: matalaha folded before Flop (didn't bet)
Seat 3: VitalikX77 folded before Flop (didn't bet)
Seat 4: schlier4 folded before Flop (didn't bet)
Seat 5: mjmj1971 folded before Flop (didn't bet)
Seat 6: GunDolfAA folded before Flop (didn't bet)
Seat 7: Oliver N76 folded before Flop (didn't bet)
Seat 8: H3ll5cream (button) showed [Qc Ks] and won (4622) with two pair, Queens and Sevens
Seat 9: jcarlos.vale (small blind) folded before Flop



PokerStars Hand #208297861055: Tournament #2779056951, $0.49+$0.06 USD Hold'em No Limit - Level IX (100/200) - 2020/01/18 22:27:24 EET [2020/01/18 15:27:24 ET]
Table '2779056951 40' 9-max Seat #9 is the button
Seat 1: Saphc (889 in chips) 
Seat 2: matalaha (7399 in chips) 
Seat 3: VitalikX77 (10328 in chips) 
Seat 4: schlier4 (11619 in chips) 
Seat 5: mjmj1971 (11262 in chips) 
Seat 6: GunDolfAA (7697 in chips) 
Seat 7: Oliver N76 (12265 in chips) 
Seat 8: H3ll5cream (4622 in chips) 
Seat 9: jcarlos.vale (7364 in chips) 
Saphc: posts the ante 18
matalaha: posts the ante 18
VitalikX77: posts the ante 18
schlier4: posts the ante 18
mjmj1971: posts the ante 18
GunDolfAA: posts the ante 18
Oliver N76: posts the ante 18
H3ll5cream: posts the ante 18
jcarlos.vale: posts the ante 18
Saphc: posts small blind 100
matalaha: posts big blind 200
*** HOLE CARDS ***
Dealt to jcarlos.vale [9c 7s]
VitalikX77: raises 400 to 600
schlier4: folds 
mjmj1971: folds 
GunDolfAA: folds 
Oliver N76: folds 
H3ll5cream: folds 
jcarlos.vale: folds 
Saphc: folds 
matalaha: folds 
Uncalled bet (400) returned to VitalikX77
VitalikX77 collected 662 from pot
*** SUMMARY ***
Total pot 662 | Rake 0 
Seat 1: Saphc (small blind) folded before Flop
Seat 2: matalaha (big blind) folded before Flop
Seat 3: VitalikX77 collected (662)
Seat 4: schlier4 folded before Flop (didn't bet)
Seat 5: mjmj1971 folded before Flop (didn't bet)
Seat 6: GunDolfAA folded before Flop (didn't bet)
Seat 7: Oliver N76 folded before Flop (didn't bet)
Seat 8: H3ll5cream folded before Flop (didn't bet)
Seat 9: jcarlos.vale (button) folded before Flop (didn't bet)



PokerStars Hand #208297884587: Tournament #2779056951, $0.49+$0.06 USD Hold'em No Limit - Level IX (100/200) - 2020/01/18 22:28:00 EET [2020/01/18 15:28:00 ET]
Table '2779056951 40' 9-max Seat #1 is the button
Seat 1: Saphc (771 in chips) 
Seat 2: matalaha (7181 in chips) 
Seat 3: VitalikX77 (10772 in chips) 
Seat 4: schlier4 (11601 in chips) 
Seat 5: mjmj1971 (11244 in chips) 
Seat 6: GunDolfAA (7679 in chips) 
Seat 7: Oliver N76 (12247 in chips) 
Seat 8: H3ll5cream (4604 in chips) 
Seat 9: jcarlos.vale (7346 in chips) 
Saphc: posts the ante 18
matalaha: posts the ante 18
VitalikX77: posts the ante 18
schlier4: posts the ante 18
mjmj1971: posts the ante 18
GunDolfAA: posts the ante 18
Oliver N76: posts the ante 18
H3ll5cream: posts the ante 18
jcarlos.vale: posts the ante 18
matalaha: posts small blind 100
VitalikX77: posts big blind 200
*** HOLE CARDS ***
Dealt to jcarlos.vale [Kd 9d]
schlier4: folds 
mjmj1971: folds 
GunDolfAA: raises 400 to 600
Oliver N76: calls 600
H3ll5cream: folds 
jcarlos.vale: folds 
Saphc: raises 153 to 753 and is all-in
matalaha: folds 
VitalikX77: calls 553
GunDolfAA: calls 153
Oliver N76: folds 
*** FLOP *** [Jd Ts 5h]
VitalikX77: checks 
GunDolfAA: bets 600
VitalikX77: folds 
Uncalled bet (600) returned to GunDolfAA
*** TURN *** [Jd Ts 5h] [7h]
*** RIVER *** [Jd Ts 5h 7h] [Qc]
*** SHOW DOWN ***
GunDolfAA: shows [Jc Qs] (two pair, Queens and Jacks)
Saphc: shows [Td Ad] (a pair of Tens)
GunDolfAA collected 3121 from pot
Saphc finished the tournament
*** SUMMARY ***
Total pot 3121 | Rake 0 
Board [Jd Ts 5h 7h Qc]
Seat 1: Saphc (button) showed [Td Ad] and lost with a pair of Tens
Seat 2: matalaha (small blind) folded before Flop
Seat 3: VitalikX77 (big blind) folded on the Flop
Seat 4: schlier4 folded before Flop (didn't bet)
Seat 5: mjmj1971 folded before Flop (didn't bet)
Seat 6: GunDolfAA showed [Jc Qs] and won (3121) with two pair, Queens and Jacks
Seat 7: Oliver N76 folded before Flop
Seat 8: H3ll5cream folded before Flop (didn't bet)
Seat 9: jcarlos.vale folded before Flop (didn't bet)



PokerStars Hand #208297921300: Tournament #2779056951, $0.49+$0.06 USD Hold'em No Limit - Level IX (100/200) - 2020/01/18 22:28:56 EET [2020/01/18 15:28:56 ET]
Table '2779056951 40' 9-max Seat #2 is the button
Seat 2: matalaha (7063 in chips) 
Seat 3: VitalikX77 (10001 in chips) 
Seat 4: schlier4 (11583 in chips) 
Seat 5: mjmj1971 (11226 in chips) 
Seat 6: GunDolfAA (10029 in chips) 
Seat 7: Oliver N76 (11629 in chips) 
Seat 8: H3ll5cream (4586 in chips) 
Seat 9: jcarlos.vale (7328 in chips) 
matalaha: posts the ante 18
VitalikX77: posts the ante 18
schlier4: posts the ante 18
mjmj1971: posts the ante 18
GunDolfAA: posts the ante 18
Oliver N76: posts the ante 18
H3ll5cream: posts the ante 18
jcarlos.vale: posts the ante 18
VitalikX77: posts small blind 100
schlier4: posts big blind 200
*** HOLE CARDS ***
Dealt to jcarlos.vale [Qh 2c]
mjmj1971: folds 
GunDolfAA: folds 
Oliver N76: folds 
H3ll5cream: folds 
jcarlos.vale: folds 
matalaha: folds 
VitalikX77: raises 280 to 480
schlier4: calls 280
*** FLOP *** [2h 5d 8s]
VitalikX77: bets 500
schlier4: folds 
Uncalled bet (500) returned to VitalikX77
VitalikX77 collected 1104 from pot
VitalikX77: doesn't show handDTO
*** SUMMARY ***
Total pot 1104 | Rake 0 
Board [2h 5d 8s]
Seat 2: matalaha (button) folded before Flop (didn't bet)
Seat 3: VitalikX77 (small blind) collected (1104)
Seat 4: schlier4 (big blind) folded on the Flop
Seat 5: mjmj1971 folded before Flop (didn't bet)
Seat 6: GunDolfAA folded before Flop (didn't bet)
Seat 7: Oliver N76 folded before Flop (didn't bet)
Seat 8: H3ll5cream folded before Flop (didn't bet)
Seat 9: jcarlos.vale folded before Flop (didn't bet)



PokerStars Hand #208297949452: Tournament #2779056951, $0.49+$0.06 USD Hold'em No Limit - Level IX (100/200) - 2020/01/18 22:29:39 EET [2020/01/18 15:29:39 ET]
Table '2779056951 40' 9-max Seat #3 is the button
Seat 1: Ka4eBHuK 777 (5000 in chips) 
Seat 2: matalaha (7045 in chips) 
Seat 3: VitalikX77 (10607 in chips) 
Seat 4: schlier4 (11085 in chips) 
Seat 5: mjmj1971 (11208 in chips) 
Seat 6: GunDolfAA (10011 in chips) 
Seat 7: Oliver N76 (11611 in chips) 
Seat 8: H3ll5cream (4568 in chips) 
Seat 9: jcarlos.vale (7310 in chips) 
Ka4eBHuK 777: posts the ante 18
matalaha: posts the ante 18
VitalikX77: posts the ante 18
schlier4: posts the ante 18
mjmj1971: posts the ante 18
GunDolfAA: posts the ante 18
Oliver N76: posts the ante 18
H3ll5cream: posts the ante 18
jcarlos.vale: posts the ante 18
schlier4: posts small blind 100
mjmj1971: posts big blind 200
*** HOLE CARDS ***
Dealt to jcarlos.vale [4d Kh]
GunDolfAA: folds 
Oliver N76: folds 
H3ll5cream: folds 
jcarlos.vale: folds 
Ka4eBHuK 777 has timed out while disconnected
Ka4eBHuK 777: folds 
Ka4eBHuK 777 is sitting out
matalaha: folds 
VitalikX77: folds 
schlier4: calls 100
mjmj1971: checks 
*** FLOP *** [9s 6d Kd]
schlier4: checks 
mjmj1971: bets 200
schlier4: calls 200
*** TURN *** [9s 6d Kd] [8h]
schlier4: checks 
mjmj1971: checks 
*** RIVER *** [9s 6d Kd 8h] [2c]
schlier4: checks 
mjmj1971: checks 
*** SHOW DOWN ***
schlier4: shows [6c 7h] (a pair of Sixes)
mjmj1971: mucks handDTO
schlier4 collected 962 from pot
*** SUMMARY ***
Total pot 962 | Rake 0 
Board [9s 6d Kd 8h 2c]
Seat 1: Ka4eBHuK 777 folded before Flop (didn't bet)
Seat 2: matalaha folded before Flop (didn't bet)
Seat 3: VitalikX77 (button) folded before Flop (didn't bet)
Seat 4: schlier4 (small blind) showed [6c 7h] and won (962) with a pair of Sixes
Seat 5: mjmj1971 (big blind) mucked [2s 4h]
Seat 6: GunDolfAA folded before Flop (didn't bet)
Seat 7: Oliver N76 folded before Flop (didn't bet)
Seat 8: H3ll5cream folded before Flop (didn't bet)
Seat 9: jcarlos.vale folded before Flop (didn't bet)



PokerStars Hand #208297984182: Tournament #2779056951, $0.49+$0.06 USD Hold'em No Limit - Level IX (100/200) - 2020/01/18 22:30:30 EET [2020/01/18 15:30:30 ET]
Table '2779056951 40' 9-max Seat #4 is the button
Seat 1: Ka4eBHuK 777 (4982 in chips) is sitting out
Seat 2: matalaha (7027 in chips) 
Seat 3: VitalikX77 (10589 in chips) 
Seat 4: schlier4 (11629 in chips) 
Seat 5: mjmj1971 (10790 in chips) 
Seat 6: GunDolfAA (9993 in chips) 
Seat 7: Oliver N76 (11593 in chips) 
Seat 8: H3ll5cream (4550 in chips) 
Seat 9: jcarlos.vale (7292 in chips) 
Ka4eBHuK 777: posts the ante 18
matalaha: posts the ante 18
VitalikX77: posts the ante 18
schlier4: posts the ante 18
mjmj1971: posts the ante 18
GunDolfAA: posts the ante 18
Oliver N76: posts the ante 18
H3ll5cream: posts the ante 18
jcarlos.vale: posts the ante 18
mjmj1971: posts small blind 100
GunDolfAA: posts big blind 200
*** HOLE CARDS ***
Dealt to jcarlos.vale [7s Ah]
Oliver N76: raises 300 to 500
H3ll5cream: folds 
jcarlos.vale: folds 
Ka4eBHuK 777: folds 
matalaha: folds 
VitalikX77: folds 
schlier4: folds 
mjmj1971: calls 400
GunDolfAA: folds 
*** FLOP *** [As 5c 3d]
mjmj1971: checks 
Oliver N76: bets 409
mjmj1971: calls 409
*** TURN *** [As 5c 3d] [Jh]
mjmj1971: checks 
Oliver N76: checks 
*** RIVER *** [As 5c 3d Jh] [Ac]
mjmj1971: bets 1200
Oliver N76: folds 
Uncalled bet (1200) returned to mjmj1971
mjmj1971 collected 2180 from pot
mjmj1971: doesn't show handDTO
*** SUMMARY ***
Total pot 2180 | Rake 0 
Board [As 5c 3d Jh Ac]
Seat 1: Ka4eBHuK 777 folded before Flop (didn't bet)
Seat 2: matalaha folded before Flop (didn't bet)
Seat 3: VitalikX77 folded before Flop (didn't bet)
Seat 4: schlier4 (button) folded before Flop (didn't bet)
Seat 5: mjmj1971 (small blind) collected (2180)
Seat 6: GunDolfAA (big blind) folded before Flop
Seat 7: Oliver N76 folded on the River
Seat 8: H3ll5cream folded before Flop (didn't bet)
Seat 9: jcarlos.vale folded before Flop (didn't bet)



PokerStars Hand #208298014439: Tournament #2779056951, $0.49+$0.06 USD Hold'em No Limit - Level IX (100/200) - 2020/01/18 22:31:15 EET [2020/01/18 15:31:15 ET]
Table '2779056951 40' 9-max Seat #5 is the button
Seat 1: Ka4eBHuK 777 (4964 in chips) is sitting out
Seat 2: matalaha (7009 in chips) 
Seat 3: VitalikX77 (10571 in chips) 
Seat 4: schlier4 (11611 in chips) 
Seat 5: mjmj1971 (12043 in chips) 
Seat 6: GunDolfAA (9775 in chips) 
Seat 7: Oliver N76 (10666 in chips) 
Seat 8: H3ll5cream (4532 in chips) 
Seat 9: jcarlos.vale (7274 in chips) 
Ka4eBHuK 777: posts the ante 18
matalaha: posts the ante 18
VitalikX77: posts the ante 18
schlier4: posts the ante 18
mjmj1971: posts the ante 18
GunDolfAA: posts the ante 18
Oliver N76: posts the ante 18
H3ll5cream: posts the ante 18
jcarlos.vale: posts the ante 18
GunDolfAA: posts small blind 100
Oliver N76: posts big blind 200
*** HOLE CARDS ***
Dealt to jcarlos.vale [Ac 8s]
H3ll5cream: folds 
jcarlos.vale: folds 
Ka4eBHuK 777: folds 
matalaha: folds 
VitalikX77: folds 
schlier4: folds 
mjmj1971: folds 
GunDolfAA: folds 
Uncalled bet (100) returned to Oliver N76
Oliver N76 collected 362 from pot
Oliver N76: doesn't show handDTO
*** SUMMARY ***
Total pot 362 | Rake 0 
Seat 1: Ka4eBHuK 777 folded before Flop (didn't bet)
Seat 2: matalaha folded before Flop (didn't bet)
Seat 3: VitalikX77 folded before Flop (didn't bet)
Seat 4: schlier4 folded before Flop (didn't bet)
Seat 5: mjmj1971 (button) folded before Flop (didn't bet)
Seat 6: GunDolfAA (small blind) folded before Flop
Seat 7: Oliver N76 (big blind) collected (362)
Seat 8: H3ll5cream folded before Flop (didn't bet)
Seat 9: jcarlos.vale folded before Flop (didn't bet)



PokerStars Hand #208298025382: Tournament #2779056951, $0.49+$0.06 USD Hold'em No Limit - Level IX (100/200) - 2020/01/18 22:31:32 EET [2020/01/18 15:31:32 ET]
Table '2779056951 40' 9-max Seat #6 is the button
Seat 1: Ka4eBHuK 777 (4946 in chips) is sitting out
Seat 2: matalaha (6991 in chips) 
Seat 3: VitalikX77 (10553 in chips) 
Seat 4: schlier4 (11593 in chips) 
Seat 5: mjmj1971 (12025 in chips) 
Seat 6: GunDolfAA (9657 in chips) 
Seat 7: Oliver N76 (10910 in chips) 
Seat 8: H3ll5cream (4514 in chips) 
Seat 9: jcarlos.vale (7256 in chips) 
Ka4eBHuK 777: posts the ante 18
matalaha: posts the ante 18
VitalikX77: posts the ante 18
schlier4: posts the ante 18
mjmj1971: posts the ante 18
GunDolfAA: posts the ante 18
Oliver N76: posts the ante 18
H3ll5cream: posts the ante 18
jcarlos.vale: posts the ante 18
Oliver N76: posts small blind 100
H3ll5cream: posts big blind 200
*** HOLE CARDS ***
Dealt to jcarlos.vale [3c 8d]
jcarlos.vale: folds 
Ka4eBHuK 777: folds 
matalaha: folds 
VitalikX77: raises 280 to 480
schlier4: folds 
mjmj1971: folds 
GunDolfAA: calls 480
Oliver N76: folds 
H3ll5cream: folds 
*** FLOP *** [5d Qc Js]
VitalikX77: bets 500
GunDolfAA: folds 
Uncalled bet (500) returned to VitalikX77
VitalikX77 collected 1422 from pot
*** SUMMARY ***
Total pot 1422 | Rake 0 
Board [5d Qc Js]
Seat 1: Ka4eBHuK 777 folded before Flop (didn't bet)
Seat 2: matalaha folded before Flop (didn't bet)
Seat 3: VitalikX77 collected (1422)
Seat 4: schlier4 folded before Flop (didn't bet)
Seat 5: mjmj1971 folded before Flop (didn't bet)
Seat 6: GunDolfAA (button) folded on the Flop
Seat 7: Oliver N76 (small blind) folded before Flop
Seat 8: H3ll5cream (big blind) folded before Flop
Seat 9: jcarlos.vale folded before Flop (didn't bet)



PokerStars Hand #208298050564: Tournament #2779056951, $0.49+$0.06 USD Hold'em No Limit - Level IX (100/200) - 2020/01/18 22:32:10 EET [2020/01/18 15:32:10 ET]
Table '2779056951 40' 9-max Seat #7 is the button
Seat 1: Ka4eBHuK 777 (4928 in chips) is sitting out
Seat 2: matalaha (6973 in chips) 
Seat 3: VitalikX77 (11477 in chips) 
Seat 4: schlier4 (11575 in chips) 
Seat 5: mjmj1971 (12007 in chips) 
Seat 6: GunDolfAA (9159 in chips) 
Seat 7: Oliver N76 (10792 in chips) 
Seat 8: H3ll5cream (4296 in chips) 
Seat 9: jcarlos.vale (7238 in chips) 
Ka4eBHuK 777: posts the ante 18
matalaha: posts the ante 18
VitalikX77: posts the ante 18
schlier4: posts the ante 18
mjmj1971: posts the ante 18
GunDolfAA: posts the ante 18
Oliver N76: posts the ante 18
H3ll5cream: posts the ante 18
jcarlos.vale: posts the ante 18
H3ll5cream: posts small blind 100
jcarlos.vale: posts big blind 200
*** HOLE CARDS ***
Dealt to jcarlos.vale [Kh 2c]
Ka4eBHuK 777: folds 
matalaha: folds 
VitalikX77: folds 
schlier4: raises 200 to 400
mjmj1971: calls 400
GunDolfAA: folds 
Oliver N76: calls 400
H3ll5cream: folds 
jcarlos.vale: folds 
*** FLOP *** [8s 7s 4c]
schlier4: checks 
mjmj1971: checks 
Oliver N76: bets 831
schlier4: calls 831
mjmj1971: folds 
*** TURN *** [8s 7s 4c] [Jd]
schlier4: checks 
Oliver N76: bets 2000
schlier4: calls 2000
*** RIVER *** [8s 7s 4c Jd] [4d]
schlier4: checks 
Oliver N76: checks 
*** SHOW DOWN ***
schlier4: shows [Ks Qc] (a pair of Fours)
Oliver N76: shows [9s Ts] (a straight, Seven to Jack)
Oliver N76 collected 7324 from pot
*** SUMMARY ***
Total pot 7324 | Rake 0 
Board [8s 7s 4c Jd 4d]
Seat 1: Ka4eBHuK 777 folded before Flop (didn't bet)
Seat 2: matalaha folded before Flop (didn't bet)
Seat 3: VitalikX77 folded before Flop (didn't bet)
Seat 4: schlier4 showed [Ks Qc] and lost with a pair of Fours
Seat 5: mjmj1971 folded on the Flop
Seat 6: GunDolfAA folded before Flop (didn't bet)
Seat 7: Oliver N76 (button) showed [9s Ts] and won (7324) with a straight, Seven to Jack
Seat 8: H3ll5cream (small blind) folded before Flop
Seat 9: jcarlos.vale (big blind) folded before Flop



PokerStars Hand #208298089106: Tournament #2779056951, $0.49+$0.06 USD Hold'em No Limit - Level IX (100/200) - 2020/01/18 22:33:08 EET [2020/01/18 15:33:08 ET]
Table '2779056951 40' 9-max Seat #8 is the button
Seat 1: Ka4eBHuK 777 (4910 in chips) is sitting out
Seat 2: matalaha (6955 in chips) 
Seat 3: VitalikX77 (11459 in chips) 
Seat 4: schlier4 (8326 in chips) 
Seat 5: mjmj1971 (11589 in chips) 
Seat 6: GunDolfAA (9141 in chips) 
Seat 7: Oliver N76 (14867 in chips) 
Seat 8: H3ll5cream (4178 in chips) 
Seat 9: jcarlos.vale (7020 in chips) 
Ka4eBHuK 777: posts the ante 18
matalaha: posts the ante 18
VitalikX77: posts the ante 18
schlier4: posts the ante 18
mjmj1971: posts the ante 18
GunDolfAA: posts the ante 18
Oliver N76: posts the ante 18
H3ll5cream: posts the ante 18
jcarlos.vale: posts the ante 18
jcarlos.vale: posts small blind 100
Ka4eBHuK 777: posts big blind 200
*** HOLE CARDS ***
Dealt to jcarlos.vale [7c 5d]
matalaha: folds 
VitalikX77: raises 240 to 440
schlier4: calls 440
mjmj1971: folds 
GunDolfAA: calls 440
Oliver N76: calls 440
H3ll5cream: folds 
jcarlos.vale: folds 
Ka4eBHuK 777: folds 
*** FLOP *** [Ks 3c Js]
VitalikX77: checks 
schlier4: checks 
GunDolfAA: bets 200
Oliver N76: raises 787 to 987
VitalikX77: folds 
schlier4: folds 
GunDolfAA: folds 
Uncalled bet (787) returned to Oliver N76
Oliver N76 collected 2622 from pot
Oliver N76: doesn't show handDTO
*** SUMMARY ***
Total pot 2622 | Rake 0 
Board [Ks 3c Js]
Seat 1: Ka4eBHuK 777 (big blind) folded before Flop
Seat 2: matalaha folded before Flop (didn't bet)
Seat 3: VitalikX77 folded on the Flop
Seat 4: schlier4 folded on the Flop
Seat 5: mjmj1971 folded before Flop (didn't bet)
Seat 6: GunDolfAA folded on the Flop
Seat 7: Oliver N76 collected (2622)
Seat 8: H3ll5cream (button) folded before Flop (didn't bet)
Seat 9: jcarlos.vale (small blind) folded before Flop



PokerStars Hand #208298117921: Tournament #2779056951, $0.49+$0.06 USD Hold'em No Limit - Level IX (100/200) - 2020/01/18 22:33:52 EET [2020/01/18 15:33:52 ET]
Table '2779056951 40' 9-max Seat #9 is the button
Seat 1: Ka4eBHuK 777 (4692 in chips) is sitting out
Seat 2: matalaha (6937 in chips) 
Seat 3: VitalikX77 (11001 in chips) 
Seat 4: schlier4 (7868 in chips) 
Seat 5: mjmj1971 (11571 in chips) 
Seat 6: GunDolfAA (8483 in chips) 
Seat 7: Oliver N76 (16831 in chips) 
Seat 8: H3ll5cream (4160 in chips) 
Seat 9: jcarlos.vale (6902 in chips) 
Ka4eBHuK 777: posts the ante 18
matalaha: posts the ante 18
VitalikX77: posts the ante 18
schlier4: posts the ante 18
mjmj1971: posts the ante 18
GunDolfAA: posts the ante 18
Oliver N76: posts the ante 18
H3ll5cream: posts the ante 18
jcarlos.vale: posts the ante 18
Ka4eBHuK 777: posts small blind 100
matalaha: posts big blind 200
*** HOLE CARDS ***
Dealt to jcarlos.vale [5c 5d]
VitalikX77: folds 
schlier4: raises 200 to 400
mjmj1971: folds 
GunDolfAA: calls 400
Oliver N76: folds 
H3ll5cream: folds 
jcarlos.vale: calls 400
Ka4eBHuK 777: folds 
matalaha: calls 200
*** FLOP *** [3s 3d Qc]
matalaha: checks 
schlier4: checks 
GunDolfAA: bets 600
jcarlos.vale: folds 
matalaha: folds 
schlier4: folds 
Uncalled bet (600) returned to GunDolfAA
GunDolfAA collected 1862 from pot
*** SUMMARY ***
Total pot 1862 | Rake 0 
Board [3s 3d Qc]
Seat 1: Ka4eBHuK 777 (small blind) folded before Flop
Seat 2: matalaha (big blind) folded on the Flop
Seat 3: VitalikX77 folded before Flop (didn't bet)
Seat 4: schlier4 folded on the Flop
Seat 5: mjmj1971 folded before Flop (didn't bet)
Seat 6: GunDolfAA collected (1862)
Seat 7: Oliver N76 folded before Flop (didn't bet)
Seat 8: H3ll5cream folded before Flop (didn't bet)
Seat 9: jcarlos.vale (button) folded on the Flop



PokerStars Hand #208298152264: Tournament #2779056951, $0.49+$0.06 USD Hold'em No Limit - Level IX (100/200) - 2020/01/18 22:34:36 EET [2020/01/18 15:34:36 ET]
Table '2779056951 40' 9-max Seat #1 is the button
Seat 1: Ka4eBHuK 777 (4574 in chips) is sitting out
Seat 2: matalaha (6519 in chips) 
Seat 3: VitalikX77 (10983 in chips) 
Seat 4: schlier4 (7450 in chips) 
Seat 5: mjmj1971 (11553 in chips) 
Seat 6: GunDolfAA (9927 in chips) 
Seat 7: Oliver N76 (16813 in chips) 
Seat 8: H3ll5cream (4142 in chips) 
Seat 9: jcarlos.vale (6484 in chips) 
Ka4eBHuK 777: posts the ante 18
matalaha: posts the ante 18
VitalikX77: posts the ante 18
schlier4: posts the ante 18
mjmj1971: posts the ante 18
GunDolfAA: posts the ante 18
Oliver N76: posts the ante 18
H3ll5cream: posts the ante 18
jcarlos.vale: posts the ante 18
matalaha: posts small blind 100
VitalikX77: posts big blind 200
*** HOLE CARDS ***
Dealt to jcarlos.vale [Jh 7c]
schlier4: folds 
mjmj1971: folds 
GunDolfAA: folds 
Oliver N76: folds 
H3ll5cream: folds 
jcarlos.vale: folds 
Ka4eBHuK 777: folds 
matalaha: folds 
Uncalled bet (100) returned to VitalikX77
VitalikX77 collected 362 from pot
*** SUMMARY ***
Total pot 362 | Rake 0 
Seat 1: Ka4eBHuK 777 (button) folded before Flop (didn't bet)
Seat 2: matalaha (small blind) folded before Flop
Seat 3: VitalikX77 (big blind) collected (362)
Seat 4: schlier4 folded before Flop (didn't bet)
Seat 5: mjmj1971 folded before Flop (didn't bet)
Seat 6: GunDolfAA folded before Flop (didn't bet)
Seat 7: Oliver N76 folded before Flop (didn't bet)
Seat 8: H3ll5cream folded before Flop (didn't bet)
Seat 9: jcarlos.vale folded before Flop (didn't bet)



PokerStars Hand #208298158195: Tournament #2779056951, $0.49+$0.06 USD Hold'em No Limit - Level IX (100/200) - 2020/01/18 22:34:45 EET [2020/01/18 15:34:45 ET]
Table '2779056951 40' 9-max Seat #2 is the button
Seat 1: Ka4eBHuK 777 (4556 in chips) is sitting out
Seat 2: matalaha (6401 in chips) 
Seat 3: VitalikX77 (11227 in chips) 
Seat 4: schlier4 (7432 in chips) 
Seat 5: mjmj1971 (11535 in chips) 
Seat 6: GunDolfAA (9909 in chips) 
Seat 7: Oliver N76 (16795 in chips) 
Seat 8: H3ll5cream (4124 in chips) 
Seat 9: jcarlos.vale (6466 in chips) 
Ka4eBHuK 777: posts the ante 18
matalaha: posts the ante 18
VitalikX77: posts the ante 18
schlier4: posts the ante 18
mjmj1971: posts the ante 18
GunDolfAA: posts the ante 18
Oliver N76: posts the ante 18
H3ll5cream: posts the ante 18
jcarlos.vale: posts the ante 18
VitalikX77: posts small blind 100
schlier4: posts big blind 200
*** HOLE CARDS ***
Dealt to jcarlos.vale [Js Ac]
mjmj1971: folds 
GunDolfAA: folds 
Oliver N76: raises 256 to 456
H3ll5cream: folds 
jcarlos.vale: calls 456
Ka4eBHuK 777: folds 
matalaha: folds 
VitalikX77: folds 
schlier4: calls 256
*** FLOP *** [5s 6h 2s]
schlier4: checks 
Oliver N76: checks 
jcarlos.vale: checks 
*** TURN *** [5s 6h 2s] [6s]
schlier4: checks 
Oliver N76: bets 489
jcarlos.vale: folds 
schlier4: calls 489
*** RIVER *** [5s 6h 2s 6s] [5h]
schlier4: checks 
Oliver N76: checks 
*** SHOW DOWN ***
schlier4: shows [Th 2h] (two pair, Sixes and Fives)
Oliver N76: shows [Ah Qs] (two pair, Sixes and Fives - Ace kicker)
Oliver N76 collected 2608 from pot
*** SUMMARY ***
Total pot 2608 | Rake 0 
Board [5s 6h 2s 6s 5h]
Seat 1: Ka4eBHuK 777 folded before Flop (didn't bet)
Seat 2: matalaha (button) folded before Flop (didn't bet)
Seat 3: VitalikX77 (small blind) folded before Flop
Seat 4: schlier4 (big blind) showed [Th 2h] and lost with two pair, Sixes and Fives
Seat 5: mjmj1971 folded before Flop (didn't bet)
Seat 6: GunDolfAA folded before Flop (didn't bet)
Seat 7: Oliver N76 showed [Ah Qs] and won (2608) with two pair, Sixes and Fives
Seat 8: H3ll5cream folded before Flop (didn't bet)
Seat 9: jcarlos.vale folded on the Turn



PokerStars Hand #208298195297: Tournament #2779056951, $0.49+$0.06 USD Hold'em No Limit - Level IX (100/200) - 2020/01/18 22:35:41 EET [2020/01/18 15:35:41 ET]
Table '2779056951 40' 9-max Seat #3 is the button
Seat 1: Ka4eBHuK 777 (4538 in chips) is sitting out
Seat 2: matalaha (6383 in chips) 
Seat 3: VitalikX77 (11109 in chips) 
Seat 4: schlier4 (6469 in chips) 
Seat 5: mjmj1971 (11517 in chips) 
Seat 6: GunDolfAA (9891 in chips) 
Seat 7: Oliver N76 (18440 in chips) 
Seat 8: H3ll5cream (4106 in chips) 
Seat 9: jcarlos.vale (5992 in chips) 
Ka4eBHuK 777: posts the ante 18
matalaha: posts the ante 18
VitalikX77: posts the ante 18
schlier4: posts the ante 18
mjmj1971: posts the ante 18
GunDolfAA: posts the ante 18
Oliver N76: posts the ante 18
H3ll5cream: posts the ante 18
jcarlos.vale: posts the ante 18
schlier4: posts small blind 100
mjmj1971: posts big blind 200
*** HOLE CARDS ***
Dealt to jcarlos.vale [Jd 2h]
GunDolfAA: folds 
Oliver N76: folds 
H3ll5cream: folds 
jcarlos.vale: folds 
Ka4eBHuK 777: folds 
matalaha: raises 240 to 440
VitalikX77: folds 
schlier4: raises 5960 to 6400
mjmj1971: folds 
matalaha: folds 
Uncalled bet (5960) returned to schlier4
schlier4 collected 1242 from pot
schlier4: doesn't show handDTO
*** SUMMARY ***
Total pot 1242 | Rake 0 
Seat 1: Ka4eBHuK 777 folded before Flop (didn't bet)
Seat 2: matalaha folded before Flop
Seat 3: VitalikX77 (button) folded before Flop (didn't bet)
Seat 4: schlier4 (small blind) collected (1242)
Seat 5: mjmj1971 (big blind) folded before Flop
Seat 6: GunDolfAA folded before Flop (didn't bet)
Seat 7: Oliver N76 folded before Flop (didn't bet)
Seat 8: H3ll5cream folded before Flop (didn't bet)
Seat 9: jcarlos.vale folded before Flop (didn't bet)



PokerStars Hand #208298231834: Tournament #2779056951, $0.49+$0.06 USD Hold'em No Limit - Level IX (100/200) - 2020/01/18 22:36:37 EET [2020/01/18 15:36:37 ET]
Table '2779056951 40' 9-max Seat #4 is the button
Seat 1: Ka4eBHuK 777 (4520 in chips) is sitting out
Seat 2: matalaha (5925 in chips) 
Seat 3: VitalikX77 (11091 in chips) 
Seat 4: schlier4 (7253 in chips) 
Seat 5: mjmj1971 (11299 in chips) 
Seat 6: GunDolfAA (9873 in chips) 
Seat 7: Oliver N76 (18422 in chips) 
Seat 8: H3ll5cream (4088 in chips) 
Seat 9: jcarlos.vale (5974 in chips) 
Ka4eBHuK 777: posts the ante 18
matalaha: posts the ante 18
VitalikX77: posts the ante 18
schlier4: posts the ante 18
mjmj1971: posts the ante 18
GunDolfAA: posts the ante 18
Oliver N76: posts the ante 18
H3ll5cream: posts the ante 18
jcarlos.vale: posts the ante 18
mjmj1971: posts small blind 100
GunDolfAA: posts big blind 200
*** HOLE CARDS ***
Dealt to jcarlos.vale [2c Qh]
Oliver N76: folds 
H3ll5cream: folds 
jcarlos.vale: folds 
Ka4eBHuK 777: folds 
matalaha: folds 
VitalikX77: raises 400 to 600
schlier4: folds 
mjmj1971: calls 500
GunDolfAA: folds 
*** FLOP *** [9c Qc Qd]
mjmj1971: checks 
VitalikX77: bets 1000
mjmj1971: folds 
Uncalled bet (1000) returned to VitalikX77
VitalikX77 collected 1562 from pot
*** SUMMARY ***
Total pot 1562 | Rake 0 
Board [9c Qc Qd]
Seat 1: Ka4eBHuK 777 folded before Flop (didn't bet)
Seat 2: matalaha folded before Flop (didn't bet)
Seat 3: VitalikX77 collected (1562)
Seat 4: schlier4 (button) folded before Flop (didn't bet)
Seat 5: mjmj1971 (small blind) folded on the Flop
Seat 6: GunDolfAA (big blind) folded before Flop
Seat 7: Oliver N76 folded before Flop (didn't bet)
Seat 8: H3ll5cream folded before Flop (didn't bet)
Seat 9: jcarlos.vale folded before Flop (didn't bet)



PokerStars Hand #208298274948: Tournament #2779056951, $0.49+$0.06 USD Hold'em No Limit - Level X (125/250) - 2020/01/18 22:37:43 EET [2020/01/18 15:37:43 ET]
Table '2779056951 40' 9-max Seat #5 is the button
Seat 1: Ka4eBHuK 777 (4502 in chips) is sitting out
Seat 2: matalaha (5907 in chips) 
Seat 3: VitalikX77 (12035 in chips) 
Seat 4: schlier4 (7235 in chips) 
Seat 5: mjmj1971 (10681 in chips) 
Seat 6: GunDolfAA (9655 in chips) 
Seat 7: Oliver N76 (18404 in chips) 
Seat 8: H3ll5cream (4070 in chips) 
Seat 9: jcarlos.vale (5956 in chips) 
Ka4eBHuK 777: posts the ante 20
matalaha: posts the ante 20
VitalikX77: posts the ante 20
schlier4: posts the ante 20
mjmj1971: posts the ante 20
GunDolfAA: posts the ante 20
Oliver N76: posts the ante 20
H3ll5cream: posts the ante 20
jcarlos.vale: posts the ante 20
GunDolfAA: posts small blind 125
Oliver N76: posts big blind 250
*** HOLE CARDS ***
Dealt to jcarlos.vale [Jh 4c]
H3ll5cream: folds 
jcarlos.vale: folds 
Ka4eBHuK 777: folds 
matalaha: folds 
VitalikX77: raises 500 to 750
schlier4: folds 
mjmj1971: folds 
GunDolfAA: folds 
Oliver N76: folds 
Uncalled bet (500) returned to VitalikX77
VitalikX77 collected 805 from pot
*** SUMMARY ***
Total pot 805 | Rake 0 
Seat 1: Ka4eBHuK 777 folded before Flop (didn't bet)
Seat 2: matalaha folded before Flop (didn't bet)
Seat 3: VitalikX77 collected (805)
Seat 4: schlier4 folded before Flop (didn't bet)
Seat 5: mjmj1971 (button) folded before Flop (didn't bet)
Seat 6: GunDolfAA (small blind) folded before Flop
Seat 7: Oliver N76 (big blind) folded before Flop
Seat 8: H3ll5cream folded before Flop (didn't bet)
Seat 9: jcarlos.vale folded before Flop (didn't bet)



PokerStars Hand #208298290098: Tournament #2779056951, $0.49+$0.06 USD Hold'em No Limit - Level X (125/250) - 2020/01/18 22:38:07 EET [2020/01/18 15:38:07 ET]
Table '2779056951 40' 9-max Seat #6 is the button
Seat 1: Ka4eBHuK 777 (4482 in chips) is sitting out
Seat 2: matalaha (5887 in chips) 
Seat 3: VitalikX77 (12570 in chips) 
Seat 4: schlier4 (7215 in chips) 
Seat 5: mjmj1971 (10661 in chips) 
Seat 6: GunDolfAA (9510 in chips) 
Seat 7: Oliver N76 (18134 in chips) 
Seat 8: H3ll5cream (4050 in chips) 
Seat 9: jcarlos.vale (5936 in chips) 
Ka4eBHuK 777: posts the ante 20
matalaha: posts the ante 20
VitalikX77: posts the ante 20
schlier4: posts the ante 20
mjmj1971: posts the ante 20
GunDolfAA: posts the ante 20
Oliver N76: posts the ante 20
H3ll5cream: posts the ante 20
jcarlos.vale: posts the ante 20
Oliver N76: posts small blind 125
H3ll5cream: posts big blind 250
*** HOLE CARDS ***
Dealt to jcarlos.vale [9c As]
jcarlos.vale: folds 
Ka4eBHuK 777: folds 
matalaha: folds 
VitalikX77: folds 
schlier4: folds 
mjmj1971: raises 500 to 750
GunDolfAA: folds 
Oliver N76: folds 
H3ll5cream: folds 
Uncalled bet (500) returned to mjmj1971
mjmj1971 collected 805 from pot
mjmj1971: doesn't show handDTO
*** SUMMARY ***
Total pot 805 | Rake 0 
Seat 1: Ka4eBHuK 777 folded before Flop (didn't bet)
Seat 2: matalaha folded before Flop (didn't bet)
Seat 3: VitalikX77 folded before Flop (didn't bet)
Seat 4: schlier4 folded before Flop (didn't bet)
Seat 5: mjmj1971 collected (805)
Seat 6: GunDolfAA (button) folded before Flop (didn't bet)
Seat 7: Oliver N76 (small blind) folded before Flop
Seat 8: H3ll5cream (big blind) folded before Flop
Seat 9: jcarlos.vale folded before Flop (didn't bet)



PokerStars Hand #208298302252: Tournament #2779056951, $0.49+$0.06 USD Hold'em No Limit - Level X (125/250) - 2020/01/18 22:38:26 EET [2020/01/18 15:38:26 ET]
Table '2779056951 40' 9-max Seat #7 is the button
Seat 1: Ka4eBHuK 777 (4462 in chips) is sitting out
Seat 2: matalaha (5867 in chips) 
Seat 3: VitalikX77 (12550 in chips) 
Seat 4: schlier4 (7195 in chips) 
Seat 5: mjmj1971 (11196 in chips) 
Seat 6: GunDolfAA (9490 in chips) 
Seat 7: Oliver N76 (17989 in chips) 
Seat 8: H3ll5cream (3780 in chips) 
Seat 9: jcarlos.vale (5916 in chips) 
Ka4eBHuK 777: posts the ante 20
matalaha: posts the ante 20
VitalikX77: posts the ante 20
schlier4: posts the ante 20
mjmj1971: posts the ante 20
GunDolfAA: posts the ante 20
Oliver N76: posts the ante 20
H3ll5cream: posts the ante 20
jcarlos.vale: posts the ante 20
H3ll5cream: posts small blind 125
jcarlos.vale: posts big blind 250
*** HOLE CARDS ***
Dealt to jcarlos.vale [6c 5c]
Ka4eBHuK 777: folds 
matalaha: folds 
VitalikX77: folds 
schlier4: folds 
mjmj1971: calls 250
GunDolfAA: folds 
Oliver N76: folds 
H3ll5cream: folds 
jcarlos.vale: checks 
*** FLOP *** [7s 4d Qs]
jcarlos.vale: checks 
mjmj1971: bets 500
jcarlos.vale: folds 
Uncalled bet (500) returned to mjmj1971
mjmj1971 collected 805 from pot
mjmj1971: doesn't show handDTO
*** SUMMARY ***
Total pot 805 | Rake 0 
Board [7s 4d Qs]
Seat 1: Ka4eBHuK 777 folded before Flop (didn't bet)
Seat 2: matalaha folded before Flop (didn't bet)
Seat 3: VitalikX77 folded before Flop (didn't bet)
Seat 4: schlier4 folded before Flop (didn't bet)
Seat 5: mjmj1971 collected (805)
Seat 6: GunDolfAA folded before Flop (didn't bet)
Seat 7: Oliver N76 (button) folded before Flop (didn't bet)
Seat 8: H3ll5cream (small blind) folded before Flop
Seat 9: jcarlos.vale (big blind) folded on the Flop



PokerStars Hand #208298327828: Tournament #2779056951, $0.49+$0.06 USD Hold'em No Limit - Level X (125/250) - 2020/01/18 22:39:05 EET [2020/01/18 15:39:05 ET]
Table '2779056951 40' 9-max Seat #8 is the button
Seat 1: Ka4eBHuK 777 (4442 in chips) is sitting out
Seat 2: matalaha (5847 in chips) 
Seat 3: VitalikX77 (12530 in chips) 
Seat 4: schlier4 (7175 in chips) 
Seat 5: mjmj1971 (11731 in chips) 
Seat 6: GunDolfAA (9470 in chips) 
Seat 7: Oliver N76 (17969 in chips) 
Seat 8: H3ll5cream (3635 in chips) 
Seat 9: jcarlos.vale (5646 in chips) 
Ka4eBHuK 777: posts the ante 20
matalaha: posts the ante 20
VitalikX77: posts the ante 20
schlier4: posts the ante 20
mjmj1971: posts the ante 20
GunDolfAA: posts the ante 20
Oliver N76: posts the ante 20
H3ll5cream: posts the ante 20
jcarlos.vale: posts the ante 20
jcarlos.vale: posts small blind 125
Ka4eBHuK 777: posts big blind 250
*** HOLE CARDS ***
Dealt to jcarlos.vale [Th 6c]
matalaha: raises 300 to 550
VitalikX77: folds 
schlier4: folds 
mjmj1971: folds 
GunDolfAA: folds 
Oliver N76: folds 
H3ll5cream: folds 
jcarlos.vale: folds 
Ka4eBHuK 777: folds 
Uncalled bet (300) returned to matalaha
matalaha collected 805 from pot
matalaha: doesn't show handDTO
*** SUMMARY ***
Total pot 805 | Rake 0 
Seat 1: Ka4eBHuK 777 (big blind) folded before Flop
Seat 2: matalaha collected (805)
Seat 3: VitalikX77 folded before Flop (didn't bet)
Seat 4: schlier4 folded before Flop (didn't bet)
Seat 5: mjmj1971 folded before Flop (didn't bet)
Seat 6: GunDolfAA folded before Flop (didn't bet)
Seat 7: Oliver N76 folded before Flop (didn't bet)
Seat 8: H3ll5cream (button) folded before Flop (didn't bet)
Seat 9: jcarlos.vale (small blind) folded before Flop



PokerStars Hand #208298340701: Tournament #2779056951, $0.49+$0.06 USD Hold'em No Limit - Level X (125/250) - 2020/01/18 22:39:25 EET [2020/01/18 15:39:25 ET]
Table '2779056951 40' 9-max Seat #9 is the button
Seat 1: Ka4eBHuK 777 (4172 in chips) is sitting out
Seat 2: matalaha (6382 in chips) 
Seat 3: VitalikX77 (12510 in chips) 
Seat 4: schlier4 (7155 in chips) 
Seat 5: mjmj1971 (11711 in chips) 
Seat 6: GunDolfAA (9450 in chips) 
Seat 7: Oliver N76 (17949 in chips) 
Seat 8: H3ll5cream (3615 in chips) 
Seat 9: jcarlos.vale (5501 in chips) 
Ka4eBHuK 777: posts the ante 20
matalaha: posts the ante 20
VitalikX77: posts the ante 20
schlier4: posts the ante 20
mjmj1971: posts the ante 20
GunDolfAA: posts the ante 20
Oliver N76: posts the ante 20
H3ll5cream: posts the ante 20
jcarlos.vale: posts the ante 20
Ka4eBHuK 777: posts small blind 125
matalaha: posts big blind 250
*** HOLE CARDS ***
Dealt to jcarlos.vale [6s Kc]
VitalikX77: raises 350 to 600
schlier4: folds 
mjmj1971: folds 
GunDolfAA: folds 
Oliver N76: folds 
H3ll5cream: folds 
jcarlos.vale: folds 
Ka4eBHuK 777: folds 
matalaha: folds 
Uncalled bet (350) returned to VitalikX77
VitalikX77 collected 805 from pot
*** SUMMARY ***
Total pot 805 | Rake 0 
Seat 1: Ka4eBHuK 777 (small blind) folded before Flop
Seat 2: matalaha (big blind) folded before Flop
Seat 3: VitalikX77 collected (805)
Seat 4: schlier4 folded before Flop (didn't bet)
Seat 5: mjmj1971 folded before Flop (didn't bet)
Seat 6: GunDolfAA folded before Flop (didn't bet)
Seat 7: Oliver N76 folded before Flop (didn't bet)
Seat 8: H3ll5cream folded before Flop (didn't bet)
Seat 9: jcarlos.vale (button) folded before Flop (didn't bet)



PokerStars Hand #208298352765: Tournament #2779056951, $0.49+$0.06 USD Hold'em No Limit - Level X (125/250) - 2020/01/18 22:39:43 EET [2020/01/18 15:39:43 ET]
Table '2779056951 40' 9-max Seat #1 is the button
Seat 1: Ka4eBHuK 777 (4027 in chips) is sitting out
Seat 2: matalaha (6112 in chips) 
Seat 3: VitalikX77 (13045 in chips) 
Seat 4: schlier4 (7135 in chips) 
Seat 5: mjmj1971 (11691 in chips) 
Seat 6: GunDolfAA (9430 in chips) 
Seat 7: Oliver N76 (17929 in chips) 
Seat 8: H3ll5cream (3595 in chips) 
Seat 9: jcarlos.vale (5481 in chips) 
Ka4eBHuK 777: posts the ante 20
matalaha: posts the ante 20
VitalikX77: posts the ante 20
schlier4: posts the ante 20
mjmj1971: posts the ante 20
GunDolfAA: posts the ante 20
Oliver N76: posts the ante 20
H3ll5cream: posts the ante 20
jcarlos.vale: posts the ante 20
matalaha: posts small blind 125
VitalikX77: posts big blind 250
*** HOLE CARDS ***
Dealt to jcarlos.vale [Ac 5h]
schlier4: raises 250 to 500
mjmj1971: folds 
GunDolfAA: folds 
Oliver N76: folds 
H3ll5cream: folds 
jcarlos.vale: folds 
Ka4eBHuK 777: folds 
matalaha: calls 375
VitalikX77: folds 
*** FLOP *** [6d 6s Jh]
matalaha: checks 
schlier4: bets 500
matalaha: folds 
Uncalled bet (500) returned to schlier4
schlier4 collected 1430 from pot
schlier4: doesn't show handDTO
*** SUMMARY ***
Total pot 1430 | Rake 0 
Board [6d 6s Jh]
Seat 1: Ka4eBHuK 777 (button) folded before Flop (didn't bet)
Seat 2: matalaha (small blind) folded on the Flop
Seat 3: VitalikX77 (big blind) folded before Flop
Seat 4: schlier4 collected (1430)
Seat 5: mjmj1971 folded before Flop (didn't bet)
Seat 6: GunDolfAA folded before Flop (didn't bet)
Seat 7: Oliver N76 folded before Flop (didn't bet)
Seat 8: H3ll5cream folded before Flop (didn't bet)
Seat 9: jcarlos.vale folded before Flop (didn't bet)



PokerStars Hand #208298374177: Tournament #2779056951, $0.49+$0.06 USD Hold'em No Limit - Level X (125/250) - 2020/01/18 22:40:17 EET [2020/01/18 15:40:17 ET]
Table '2779056951 40' 9-max Seat #2 is the button
Seat 1: Ka4eBHuK 777 (4007 in chips) is sitting out
Seat 2: matalaha (5592 in chips) 
Seat 3: VitalikX77 (12775 in chips) 
Seat 4: schlier4 (8045 in chips) 
Seat 5: mjmj1971 (11671 in chips) 
Seat 6: GunDolfAA (9410 in chips) 
Seat 7: Oliver N76 (17909 in chips) 
Seat 8: H3ll5cream (3575 in chips) 
Seat 9: jcarlos.vale (5461 in chips) 
Ka4eBHuK 777: posts the ante 20
matalaha: posts the ante 20
VitalikX77: posts the ante 20
schlier4: posts the ante 20
mjmj1971: posts the ante 20
GunDolfAA: posts the ante 20
Oliver N76: posts the ante 20
H3ll5cream: posts the ante 20
jcarlos.vale: posts the ante 20
VitalikX77: posts small blind 125
schlier4: posts big blind 250
*** HOLE CARDS ***
Dealt to jcarlos.vale [2c 9s]
mjmj1971: calls 250
GunDolfAA: raises 250 to 500
Oliver N76: folds 
H3ll5cream: folds 
jcarlos.vale: folds 
Ka4eBHuK 777: folds 
matalaha: folds 
VitalikX77: folds 
schlier4: calls 250
mjmj1971: calls 250
*** FLOP *** [8h Js 9d]
schlier4: checks 
mjmj1971: checks 
GunDolfAA: bets 250
schlier4: folds 
mjmj1971: calls 250
*** TURN *** [8h Js 9d] [4s]
mjmj1971: checks 
GunDolfAA: bets 250
mjmj1971: calls 250
*** RIVER *** [8h Js 9d 4s] [Ac]
mjmj1971: checks 
GunDolfAA: bets 500
mjmj1971: folds 
Uncalled bet (500) returned to GunDolfAA
GunDolfAA collected 2805 from pot
*** SUMMARY ***
Total pot 2805 | Rake 0 
Board [8h Js 9d 4s Ac]
Seat 1: Ka4eBHuK 777 folded before Flop (didn't bet)
Seat 2: matalaha (button) folded before Flop (didn't bet)
Seat 3: VitalikX77 (small blind) folded before Flop
Seat 4: schlier4 (big blind) folded on the Flop
Seat 5: mjmj1971 folded on the River
Seat 6: GunDolfAA collected (2805)
Seat 7: Oliver N76 folded before Flop (didn't bet)
Seat 8: H3ll5cream folded before Flop (didn't bet)
Seat 9: jcarlos.vale folded before Flop (didn't bet)



PokerStars Hand #208298443762: Tournament #2779056951, $0.49+$0.06 USD Hold'em No Limit - Level X (125/250) - 2020/01/18 22:41:51 EET [2020/01/18 15:41:51 ET]
Table '2779056951 40' 9-max Seat #3 is the button
Seat 1: Ka4eBHuK 777 (3987 in chips) is sitting out
Seat 2: matalaha (5572 in chips) 
Seat 3: VitalikX77 (12630 in chips) 
Seat 4: schlier4 (7525 in chips) 
Seat 5: mjmj1971 (10651 in chips) 
Seat 6: GunDolfAA (11195 in chips) 
Seat 7: Oliver N76 (17889 in chips) 
Seat 8: H3ll5cream (3555 in chips) 
Seat 9: jcarlos.vale (5441 in chips) 
Ka4eBHuK 777: posts the ante 20
matalaha: posts the ante 20
VitalikX77: posts the ante 20
schlier4: posts the ante 20
mjmj1971: posts the ante 20
GunDolfAA: posts the ante 20
Oliver N76: posts the ante 20
H3ll5cream: posts the ante 20
jcarlos.vale: posts the ante 20
schlier4: posts small blind 125
mjmj1971: posts big blind 250
*** HOLE CARDS ***
Dealt to jcarlos.vale [Tc Jh]
GunDolfAA: folds 
Oliver N76: folds 
H3ll5cream: raises 3285 to 3535 and is all-in
jcarlos.vale: folds 
Ka4eBHuK 777: folds 
matalaha: folds 
VitalikX77: folds 
schlier4: calls 3410
mjmj1971: folds 
*** FLOP *** [3h Kh 5d]
*** TURN *** [3h Kh 5d] [Qs]
*** RIVER *** [3h Kh 5d Qs] [Js]
*** SHOW DOWN ***
schlier4: shows [Ts Th] (a pair of Tens)
H3ll5cream: shows [5c Ac] (a pair of Fives)
schlier4 collected 7500 from pot
H3ll5cream finished the tournament
*** SUMMARY ***
Total pot 7500 | Rake 0 
Board [3h Kh 5d Qs Js]
Seat 1: Ka4eBHuK 777 folded before Flop (didn't bet)
Seat 2: matalaha folded before Flop (didn't bet)
Seat 3: VitalikX77 (button) folded before Flop (didn't bet)
Seat 4: schlier4 (small blind) showed [Ts Th] and won (7500) with a pair of Tens
Seat 5: mjmj1971 (big blind) folded before Flop
Seat 6: GunDolfAA folded before Flop (didn't bet)
Seat 7: Oliver N76 folded before Flop (didn't bet)
Seat 8: H3ll5cream showed [5c Ac] and lost with a pair of Fives
Seat 9: jcarlos.vale folded before Flop (didn't bet)



PokerStars Hand #208298465989: Tournament #2779056951, $0.49+$0.06 USD Hold'em No Limit - Level X (125/250) - 2020/01/18 22:42:18 EET [2020/01/18 15:42:18 ET]
Table '2779056951 40' 9-max Seat #4 is the button
Seat 1: Ka4eBHuK 777 (3967 in chips) is sitting out
Seat 2: matalaha (5552 in chips) 
Seat 3: VitalikX77 (12610 in chips) 
Seat 4: schlier4 (11470 in chips) 
Seat 5: mjmj1971 (10381 in chips) 
Seat 6: GunDolfAA (11175 in chips) 
Seat 7: Oliver N76 (17869 in chips) 
Seat 9: jcarlos.vale (5421 in chips) 
Ka4eBHuK 777: posts the ante 20
matalaha: posts the ante 20
VitalikX77: posts the ante 20
schlier4: posts the ante 20
mjmj1971: posts the ante 20
GunDolfAA: posts the ante 20
Oliver N76: posts the ante 20
jcarlos.vale: posts the ante 20
mjmj1971: posts small blind 125
GunDolfAA: posts big blind 250
*** HOLE CARDS ***
Dealt to jcarlos.vale [Kh Qh]
Oliver N76: folds 
jcarlos.vale: raises 275 to 525
Ka4eBHuK 777: folds 
matalaha: folds 
VitalikX77: folds 
schlier4: calls 525
mjmj1971: folds 
GunDolfAA: folds 
*** FLOP *** [7c Jh 3s]
jcarlos.vale: checks 
schlier4: checks 
*** TURN *** [7c Jh 3s] [7s]
jcarlos.vale: checks 
schlier4: checks 
*** RIVER *** [7c Jh 3s 7s] [2d]
jcarlos.vale: checks 
schlier4: checks 
*** SHOW DOWN ***
jcarlos.vale: shows [Kh Qh] (a pair of Sevens)
schlier4: mucks handDTO
jcarlos.vale collected 1585 from pot
*** SUMMARY ***
Total pot 1585 | Rake 0 
Board [7c Jh 3s 7s 2d]
Seat 1: Ka4eBHuK 777 folded before Flop (didn't bet)
Seat 2: matalaha folded before Flop (didn't bet)
Seat 3: VitalikX77 folded before Flop (didn't bet)
Seat 4: schlier4 (button) mucked [Tc Kc]
Seat 5: mjmj1971 (small blind) folded before Flop
Seat 6: GunDolfAA (big blind) folded before Flop
Seat 7: Oliver N76 folded before Flop (didn't bet)
Seat 9: jcarlos.vale showed [Kh Qh] and won (1585) with a pair of Sevens



PokerStars Hand #208298484757: Tournament #2779056951, $0.49+$0.06 USD Hold'em No Limit - Level X (125/250) - 2020/01/18 22:42:48 EET [2020/01/18 15:42:48 ET]
Table '2779056951 40' 9-max Seat #5 is the button
Seat 1: Ka4eBHuK 777 (3947 in chips) is sitting out
Seat 2: matalaha (5532 in chips) 
Seat 3: VitalikX77 (12590 in chips) 
Seat 4: schlier4 (10925 in chips) 
Seat 5: mjmj1971 (10236 in chips) 
Seat 6: GunDolfAA (10905 in chips) 
Seat 7: Oliver N76 (17849 in chips) 
Seat 8: AlexGraton22 (5000 in chips) 
Seat 9: jcarlos.vale (6461 in chips) 
Ka4eBHuK 777: posts the ante 20
matalaha: posts the ante 20
VitalikX77: posts the ante 20
schlier4: posts the ante 20
mjmj1971: posts the ante 20
GunDolfAA: posts the ante 20
Oliver N76: posts the ante 20
AlexGraton22: posts the ante 20
jcarlos.vale: posts the ante 20
GunDolfAA: posts small blind 125
Oliver N76: posts big blind 250
*** HOLE CARDS ***
Dealt to jcarlos.vale [4s 5s]
AlexGraton22: raises 250 to 500
jcarlos.vale: folds 
Ka4eBHuK 777: folds 
matalaha: folds 
VitalikX77: calls 500
schlier4: folds 
mjmj1971: folds 
GunDolfAA: folds 
Oliver N76: folds 
*** FLOP *** [9s Qd As]
AlexGraton22: bets 778
VitalikX77: raises 1097 to 1875
AlexGraton22: raises 2605 to 4480 and is all-in
VitalikX77: calls 2605
*** TURN *** [9s Qd As] [4d]
*** RIVER *** [9s Qd As 4d] [6h]
*** SHOW DOWN ***
AlexGraton22: shows [Qc 5c] (a pair of Queens)
VitalikX77: shows [Ad Ks] (a pair of Aces)
VitalikX77 collected 10515 from pot
AlexGraton22 finished the tournament
*** SUMMARY ***
Total pot 10515 | Rake 0 
Board [9s Qd As 4d 6h]
Seat 1: Ka4eBHuK 777 folded before Flop (didn't bet)
Seat 2: matalaha folded before Flop (didn't bet)
Seat 3: VitalikX77 showed [Ad Ks] and won (10515) with a pair of Aces
Seat 4: schlier4 folded before Flop (didn't bet)
Seat 5: mjmj1971 (button) folded before Flop (didn't bet)
Seat 6: GunDolfAA (small blind) folded before Flop
Seat 7: Oliver N76 (big blind) folded before Flop
Seat 8: AlexGraton22 showed [Qc 5c] and lost with a pair of Queens
Seat 9: jcarlos.vale folded before Flop (didn't bet)



PokerStars Hand #208298521674: Tournament #2779056951, $0.49+$0.06 USD Hold'em No Limit - Level X (125/250) - 2020/01/18 22:43:46 EET [2020/01/18 15:43:46 ET]
Table '2779056951 40' 9-max Seat #6 is the button
Seat 1: Ka4eBHuK 777 (3927 in chips) is sitting out
Seat 2: matalaha (5512 in chips) 
Seat 3: VitalikX77 (18105 in chips) 
Seat 4: schlier4 (10905 in chips) 
Seat 5: mjmj1971 (10216 in chips) 
Seat 6: GunDolfAA (10760 in chips) 
Seat 7: Oliver N76 (17579 in chips) 
Seat 9: jcarlos.vale (6441 in chips) 
Ka4eBHuK 777: posts the ante 20
matalaha: posts the ante 20
VitalikX77: posts the ante 20
schlier4: posts the ante 20
mjmj1971: posts the ante 20
GunDolfAA: posts the ante 20
Oliver N76: posts the ante 20
jcarlos.vale: posts the ante 20
Oliver N76: posts small blind 125
jcarlos.vale: posts big blind 250
*** HOLE CARDS ***
Dealt to jcarlos.vale [Ac 9c]
Ka4eBHuK 777: folds 
matalaha: folds 
VitalikX77: folds 
schlier4: folds 
mjmj1971: folds 
GunDolfAA: raises 500 to 750
Oliver N76: folds 
jcarlos.vale: folds 
Uncalled bet (500) returned to GunDolfAA
GunDolfAA collected 785 from pot
*** SUMMARY ***
Total pot 785 | Rake 0 
Seat 1: Ka4eBHuK 777 folded before Flop (didn't bet)
Seat 2: matalaha folded before Flop (didn't bet)
Seat 3: VitalikX77 folded before Flop (didn't bet)
Seat 4: schlier4 folded before Flop (didn't bet)
Seat 5: mjmj1971 folded before Flop (didn't bet)
Seat 6: GunDolfAA (button) collected (785)
Seat 7: Oliver N76 (small blind) folded before Flop
Seat 9: jcarlos.vale (big blind) folded before Flop



PokerStars Hand #208298537734: Tournament #2779056951, $0.49+$0.06 USD Hold'em No Limit - Level X (125/250) - 2020/01/18 22:44:11 EET [2020/01/18 15:44:11 ET]
Table '2779056951 40' 9-max Seat #7 is the button
Seat 1: Ka4eBHuK 777 (3907 in chips) is sitting out
Seat 2: matalaha (5492 in chips) 
Seat 3: VitalikX77 (18085 in chips) 
Seat 4: schlier4 (10885 in chips) 
Seat 5: mjmj1971 (10196 in chips) 
Seat 6: GunDolfAA (11275 in chips) 
Seat 7: Oliver N76 (17434 in chips) 
Seat 8: No Brakes357 (5000 in chips) out of handDTO (moved from another table into small blind)
Seat 9: jcarlos.vale (6171 in chips) 
No Brakes357 will be allowed to play after the button
Ka4eBHuK 777: posts the ante 20
matalaha: posts the ante 20
VitalikX77: posts the ante 20
schlier4: posts the ante 20
mjmj1971: posts the ante 20
GunDolfAA: posts the ante 20
Oliver N76: posts the ante 20
jcarlos.vale: posts the ante 20
jcarlos.vale: posts small blind 125
Ka4eBHuK 777: posts big blind 250
*** HOLE CARDS ***
Dealt to jcarlos.vale [3d 9h]
matalaha: folds 
VitalikX77: folds 
schlier4: folds 
mjmj1971: folds 
GunDolfAA: folds 
Oliver N76: raises 325 to 575
jcarlos.vale: folds 
Ka4eBHuK 777: folds 
Uncalled bet (325) returned to Oliver N76
Oliver N76 collected 785 from pot
Oliver N76: doesn't show handDTO
*** SUMMARY ***
Total pot 785 | Rake 0 
Seat 1: Ka4eBHuK 777 (big blind) folded before Flop
Seat 2: matalaha folded before Flop (didn't bet)
Seat 3: VitalikX77 folded before Flop (didn't bet)
Seat 4: schlier4 folded before Flop (didn't bet)
Seat 5: mjmj1971 folded before Flop (didn't bet)
Seat 6: GunDolfAA folded before Flop (didn't bet)
Seat 7: Oliver N76 (button) collected (785)
Seat 9: jcarlos.vale (small blind) folded before Flop



PokerStars Hand #208298555831: Tournament #2779056951, $0.49+$0.06 USD Hold'em No Limit - Level X (125/250) - 2020/01/18 22:44:39 EET [2020/01/18 15:44:39 ET]
Table '2779056951 40' 9-max Seat #9 is the button
Seat 1: Ka4eBHuK 777 (3637 in chips) is sitting out
Seat 2: matalaha (5472 in chips) 
Seat 3: VitalikX77 (18065 in chips) 
Seat 4: schlier4 (10865 in chips) 
Seat 5: mjmj1971 (10176 in chips) 
Seat 6: GunDolfAA (11255 in chips) 
Seat 7: Oliver N76 (17949 in chips) 
Seat 8: No Brakes357 (5000 in chips) 
Seat 9: jcarlos.vale (6026 in chips) 
Ka4eBHuK 777: posts the ante 20
matalaha: posts the ante 20
VitalikX77: posts the ante 20
schlier4: posts the ante 20
mjmj1971: posts the ante 20
GunDolfAA: posts the ante 20
Oliver N76: posts the ante 20
No Brakes357: posts the ante 20
jcarlos.vale: posts the ante 20
Ka4eBHuK 777: posts small blind 125
matalaha: posts big blind 250
*** HOLE CARDS ***
Dealt to jcarlos.vale [6c 5d]
VitalikX77: raises 350 to 600
schlier4: folds 
mjmj1971: folds 
GunDolfAA: folds 
Oliver N76: folds 
No Brakes357: calls 600
jcarlos.vale: folds 
Ka4eBHuK 777: folds 
matalaha: calls 350
*** FLOP *** [As Jc 2c]
matalaha: checks 
VitalikX77: bets 632
No Brakes357: raises 1118 to 1750
matalaha: folds 
VitalikX77: folds 
Uncalled bet (1118) returned to No Brakes357
No Brakes357 collected 3369 from pot
No Brakes357: doesn't show handDTO
*** SUMMARY ***
Total pot 3369 | Rake 0 
Board [As Jc 2c]
Seat 1: Ka4eBHuK 777 (small blind) folded before Flop
Seat 2: matalaha (big blind) folded on the Flop
Seat 3: VitalikX77 folded on the Flop
Seat 4: schlier4 folded before Flop (didn't bet)
Seat 5: mjmj1971 folded before Flop (didn't bet)
Seat 6: GunDolfAA folded before Flop (didn't bet)
Seat 7: Oliver N76 folded before Flop (didn't bet)
Seat 8: No Brakes357 collected (3369)
Seat 9: jcarlos.vale (button) folded before Flop (didn't bet)



PokerStars Hand #208298590204: Tournament #2779056951, $0.49+$0.06 USD Hold'em No Limit - Level X (125/250) - 2020/01/18 22:45:33 EET [2020/01/18 15:45:33 ET]
Table '2779056951 40' 9-max Seat #1 is the button
Seat 1: Ka4eBHuK 777 (3492 in chips) is sitting out
Seat 2: matalaha (4852 in chips) 
Seat 3: VitalikX77 (16813 in chips) 
Seat 4: schlier4 (10845 in chips) 
Seat 5: mjmj1971 (10156 in chips) 
Seat 6: GunDolfAA (11235 in chips) 
Seat 7: Oliver N76 (17929 in chips) 
Seat 8: No Brakes357 (7117 in chips) 
Seat 9: jcarlos.vale (6006 in chips) 
Ka4eBHuK 777: posts the ante 20
matalaha: posts the ante 20
VitalikX77: posts the ante 20
schlier4: posts the ante 20
mjmj1971: posts the ante 20
GunDolfAA: posts the ante 20
Oliver N76: posts the ante 20
No Brakes357: posts the ante 20
jcarlos.vale: posts the ante 20
matalaha: posts small blind 125
VitalikX77: posts big blind 250
*** HOLE CARDS ***
Dealt to jcarlos.vale [5c 9c]
schlier4: folds 
mjmj1971: folds 
GunDolfAA: folds 
Oliver N76: folds 
No Brakes357: folds 
jcarlos.vale: folds 
Ka4eBHuK 777: folds 
matalaha: folds 
Uncalled bet (125) returned to VitalikX77
VitalikX77 collected 430 from pot
*** SUMMARY ***
Total pot 430 | Rake 0 
Seat 1: Ka4eBHuK 777 (button) folded before Flop (didn't bet)
Seat 2: matalaha (small blind) folded before Flop
Seat 3: VitalikX77 (big blind) collected (430)
Seat 4: schlier4 folded before Flop (didn't bet)
Seat 5: mjmj1971 folded before Flop (didn't bet)
Seat 6: GunDolfAA folded before Flop (didn't bet)
Seat 7: Oliver N76 folded before Flop (didn't bet)
Seat 8: No Brakes357 folded before Flop (didn't bet)
Seat 9: jcarlos.vale folded before Flop (didn't bet)



PokerStars Hand #208298599615: Tournament #2779056951, $0.49+$0.06 USD Hold'em No Limit - Level X (125/250) - 2020/01/18 22:45:48 EET [2020/01/18 15:45:48 ET]
Table '2779056951 40' 9-max Seat #2 is the button
Seat 1: Ka4eBHuK 777 (3472 in chips) is sitting out
Seat 2: matalaha (4707 in chips) 
Seat 3: VitalikX77 (17098 in chips) 
Seat 4: schlier4 (10825 in chips) 
Seat 5: mjmj1971 (10136 in chips) 
Seat 6: GunDolfAA (11215 in chips) 
Seat 7: Oliver N76 (17909 in chips) 
Seat 8: No Brakes357 (7097 in chips) 
Seat 9: jcarlos.vale (5986 in chips) 
Ka4eBHuK 777: posts the ante 20
matalaha: posts the ante 20
VitalikX77: posts the ante 20
schlier4: posts the ante 20
mjmj1971: posts the ante 20
GunDolfAA: posts the ante 20
Oliver N76: posts the ante 20
No Brakes357: posts the ante 20
jcarlos.vale: posts the ante 20
VitalikX77: posts small blind 125
schlier4: posts big blind 250
*** HOLE CARDS ***
Dealt to jcarlos.vale [9h 2s]
mjmj1971: folds 
GunDolfAA: calls 250
Oliver N76: raises 337 to 587
No Brakes357: folds 
jcarlos.vale: folds 
Ka4eBHuK 777: folds 
matalaha: folds 
VitalikX77: calls 462
schlier4: folds 
GunDolfAA: calls 337
*** FLOP *** [7d 4c 3h]
VitalikX77: checks 
GunDolfAA: checks 
Oliver N76: checks 
*** TURN *** [7d 4c 3h] [Jc]
VitalikX77: checks 
GunDolfAA: checks 
Oliver N76: checks 
*** RIVER *** [7d 4c 3h Jc] [9c]
VitalikX77: bets 875
GunDolfAA: folds 
Oliver N76: folds 
Uncalled bet (875) returned to VitalikX77
VitalikX77 collected 2191 from pot
*** SUMMARY ***
Total pot 2191 | Rake 0 
Board [7d 4c 3h Jc 9c]
Seat 1: Ka4eBHuK 777 folded before Flop (didn't bet)
Seat 2: matalaha (button) folded before Flop (didn't bet)
Seat 3: VitalikX77 (small blind) collected (2191)
Seat 4: schlier4 (big blind) folded before Flop
Seat 5: mjmj1971 folded before Flop (didn't bet)
Seat 6: GunDolfAA folded on the River
Seat 7: Oliver N76 folded on the River
Seat 8: No Brakes357 folded before Flop (didn't bet)
Seat 9: jcarlos.vale folded before Flop (didn't bet)



PokerStars Hand #208298658057: Tournament #2779056951, $0.49+$0.06 USD Hold'em No Limit - Level XI (150/300) - 2020/01/18 22:47:20 EET [2020/01/18 15:47:20 ET]
Table '2779056951 40' 9-max Seat #3 is the button
Seat 1: Ka4eBHuK 777 (3452 in chips) is sitting out
Seat 2: matalaha (4687 in chips) 
Seat 3: VitalikX77 (18682 in chips) 
Seat 4: schlier4 (10555 in chips) 
Seat 5: mjmj1971 (10116 in chips) 
Seat 6: GunDolfAA (10608 in chips) 
Seat 7: Oliver N76 (17302 in chips) 
Seat 8: No Brakes357 (7077 in chips) 
Seat 9: jcarlos.vale (5966 in chips) 
Ka4eBHuK 777: posts the ante 22
matalaha: posts the ante 22
VitalikX77: posts the ante 22
schlier4: posts the ante 22
mjmj1971: posts the ante 22
GunDolfAA: posts the ante 22
Oliver N76: posts the ante 22
No Brakes357: posts the ante 22
jcarlos.vale: posts the ante 22
schlier4: posts small blind 150
mjmj1971: posts big blind 300
*** HOLE CARDS ***
Dealt to jcarlos.vale [Jd 4c]
GunDolfAA: folds 
Oliver N76: folds 
No Brakes357: folds 
jcarlos.vale: folds 
Ka4eBHuK 777: folds 
matalaha: raises 300 to 600
VitalikX77: calls 600
schlier4: folds 
mjmj1971: calls 300
*** FLOP *** [Ks Qd Jc]
mjmj1971: checks 
matalaha: bets 1181
VitalikX77: folds 
mjmj1971: folds 
Uncalled bet (1181) returned to matalaha
matalaha collected 2148 from pot
matalaha: doesn't show handDTO
*** SUMMARY ***
Total pot 2148 | Rake 0 
Board [Ks Qd Jc]
Seat 1: Ka4eBHuK 777 folded before Flop (didn't bet)
Seat 2: matalaha collected (2148)
Seat 3: VitalikX77 (button) folded on the Flop
Seat 4: schlier4 (small blind) folded before Flop
Seat 5: mjmj1971 (big blind) folded on the Flop
Seat 6: GunDolfAA folded before Flop (didn't bet)
Seat 7: Oliver N76 folded before Flop (didn't bet)
Seat 8: No Brakes357 folded before Flop (didn't bet)
Seat 9: jcarlos.vale folded before Flop (didn't bet)



PokerStars Hand #208298686367: Tournament #2779056951, $0.49+$0.06 USD Hold'em No Limit - Level XI (150/300) - 2020/01/18 22:48:04 EET [2020/01/18 15:48:04 ET]
Table '2779056951 40' 9-max Seat #4 is the button
Seat 1: Ka4eBHuK 777 (3430 in chips) is sitting out
Seat 2: matalaha (6213 in chips) 
Seat 3: VitalikX77 (18060 in chips) 
Seat 4: schlier4 (10383 in chips) 
Seat 5: mjmj1971 (9494 in chips) 
Seat 6: GunDolfAA (10586 in chips) 
Seat 7: Oliver N76 (17280 in chips) 
Seat 8: No Brakes357 (7055 in chips) 
Seat 9: jcarlos.vale (5944 in chips) 
Ka4eBHuK 777: posts the ante 22
matalaha: posts the ante 22
VitalikX77: posts the ante 22
schlier4: posts the ante 22
mjmj1971: posts the ante 22
GunDolfAA: posts the ante 22
Oliver N76: posts the ante 22
No Brakes357: posts the ante 22
jcarlos.vale: posts the ante 22
mjmj1971: posts small blind 150
GunDolfAA: posts big blind 300
*** HOLE CARDS ***
Dealt to jcarlos.vale [Kc 3s]
Oliver N76: folds 
No Brakes357: folds 
jcarlos.vale: folds 
Ka4eBHuK 777: folds 
matalaha: raises 300 to 600
VitalikX77: folds 
schlier4: folds 
mjmj1971: folds 
GunDolfAA: calls 300
*** FLOP *** [Ac 3d 8c]
GunDolfAA: checks 
matalaha: bets 851
GunDolfAA: folds 
Uncalled bet (851) returned to matalaha
matalaha collected 1548 from pot
matalaha: doesn't show handDTO
*** SUMMARY ***
Total pot 1548 | Rake 0 
Board [Ac 3d 8c]
Seat 1: Ka4eBHuK 777 folded before Flop (didn't bet)
Seat 2: matalaha collected (1548)
Seat 3: VitalikX77 folded before Flop (didn't bet)
Seat 4: schlier4 (button) folded before Flop (didn't bet)
Seat 5: mjmj1971 (small blind) folded before Flop
Seat 6: GunDolfAA (big blind) folded on the Flop
Seat 7: Oliver N76 folded before Flop (didn't bet)
Seat 8: No Brakes357 folded before Flop (didn't bet)
Seat 9: jcarlos.vale folded before Flop (didn't bet)



PokerStars Hand #208298719307: Tournament #2779056951, $0.49+$0.06 USD Hold'em No Limit - Level XI (150/300) - 2020/01/18 22:48:43 EET [2020/01/18 15:48:43 ET]
Table '2779056951 40' 9-max Seat #5 is the button
Seat 1: Ka4eBHuK 777 (3408 in chips) is sitting out
Seat 2: matalaha (7139 in chips) 
Seat 3: VitalikX77 (18038 in chips) 
Seat 4: schlier4 (10361 in chips) 
Seat 5: mjmj1971 (9322 in chips) 
Seat 6: GunDolfAA (9964 in chips) 
Seat 7: Oliver N76 (17258 in chips) 
Seat 8: No Brakes357 (7033 in chips) 
Seat 9: jcarlos.vale (5922 in chips) 
Ka4eBHuK 777: posts the ante 22
matalaha: posts the ante 22
VitalikX77: posts the ante 22
schlier4: posts the ante 22
mjmj1971: posts the ante 22
GunDolfAA: posts the ante 22
Oliver N76: posts the ante 22
No Brakes357: posts the ante 22
jcarlos.vale: posts the ante 22
GunDolfAA: posts small blind 150
Oliver N76: posts big blind 300
*** HOLE CARDS ***
Dealt to jcarlos.vale [2d 6c]
No Brakes357: folds 
jcarlos.vale: folds 
Ka4eBHuK 777: folds 
matalaha: folds 
VitalikX77: folds 
schlier4: folds 
mjmj1971: raises 300 to 600
GunDolfAA: folds 
Oliver N76: calls 300
*** FLOP *** [7s Qs Js]
Oliver N76: checks 
mjmj1971: bets 600
Oliver N76: calls 600
*** TURN *** [7s Qs Js] [Qc]
Oliver N76: checks 
mjmj1971: checks 
*** RIVER *** [7s Qs Js Qc] [3c]
Oliver N76: bets 16036 and is all-in
mjmj1971: folds 
Uncalled bet (16036) returned to Oliver N76
Oliver N76 collected 2748 from pot
Oliver N76: doesn't show handDTO
*** SUMMARY ***
Total pot 2748 | Rake 0 
Board [7s Qs Js Qc 3c]
Seat 1: Ka4eBHuK 777 folded before Flop (didn't bet)
Seat 2: matalaha folded before Flop (didn't bet)
Seat 3: VitalikX77 folded before Flop (didn't bet)
Seat 4: schlier4 folded before Flop (didn't bet)
Seat 5: mjmj1971 (button) folded on the River
Seat 6: GunDolfAA (small blind) folded before Flop
Seat 7: Oliver N76 (big blind) collected (2748)
Seat 8: No Brakes357 folded before Flop (didn't bet)
Seat 9: jcarlos.vale folded before Flop (didn't bet)



PokerStars Hand #208298750488: Tournament #2779056951, $0.49+$0.06 USD Hold'em No Limit - Level XI (150/300) - 2020/01/18 22:49:32 EET [2020/01/18 15:49:32 ET]
Table '2779056951 40' 9-max Seat #6 is the button
Seat 1: Ka4eBHuK 777 (3386 in chips) is sitting out
Seat 2: matalaha (7117 in chips) 
Seat 3: VitalikX77 (18016 in chips) 
Seat 4: schlier4 (10339 in chips) 
Seat 5: mjmj1971 (8100 in chips) 
Seat 6: GunDolfAA (9792 in chips) 
Seat 7: Oliver N76 (18784 in chips) 
Seat 8: No Brakes357 (7011 in chips) 
Seat 9: jcarlos.vale (5900 in chips) 
Ka4eBHuK 777: posts the ante 22
matalaha: posts the ante 22
VitalikX77: posts the ante 22
schlier4: posts the ante 22
mjmj1971: posts the ante 22
GunDolfAA: posts the ante 22
Oliver N76: posts the ante 22
No Brakes357: posts the ante 22
jcarlos.vale: posts the ante 22
Oliver N76: posts small blind 150
No Brakes357: posts big blind 300
*** HOLE CARDS ***
Dealt to jcarlos.vale [Kd 2c]
jcarlos.vale: folds 
Ka4eBHuK 777: folds 
matalaha: folds 
VitalikX77: folds 
schlier4: folds 
mjmj1971: raises 300 to 600
GunDolfAA: calls 600
Oliver N76: folds 
No Brakes357: folds 
*** FLOP *** [Ks Tc 2d]
mjmj1971: checks 
GunDolfAA: checks 
*** TURN *** [Ks Tc 2d] [Qd]
mjmj1971: bets 300
GunDolfAA: folds 
Uncalled bet (300) returned to mjmj1971
mjmj1971 collected 1848 from pot
mjmj1971: doesn't show handDTO
*** SUMMARY ***
Total pot 1848 | Rake 0 
Board [Ks Tc 2d Qd]
Seat 1: Ka4eBHuK 777 folded before Flop (didn't bet)
Seat 2: matalaha folded before Flop (didn't bet)
Seat 3: VitalikX77 folded before Flop (didn't bet)
Seat 4: schlier4 folded before Flop (didn't bet)
Seat 5: mjmj1971 collected (1848)
Seat 6: GunDolfAA (button) folded on the Turn
Seat 7: Oliver N76 (small blind) folded before Flop
Seat 8: No Brakes357 (big blind) folded before Flop
Seat 9: jcarlos.vale folded before Flop (didn't bet)



PokerStars Hand #208298778521: Tournament #2779056951, $0.49+$0.06 USD Hold'em No Limit - Level XI (150/300) - 2020/01/18 22:50:16 EET [2020/01/18 15:50:16 ET]
Table '2779056951 40' 9-max Seat #7 is the button
Seat 1: Ka4eBHuK 777 (3364 in chips) is sitting out
Seat 2: matalaha (7095 in chips) 
Seat 3: VitalikX77 (17994 in chips) 
Seat 4: schlier4 (10317 in chips) 
Seat 5: mjmj1971 (9326 in chips) 
Seat 6: GunDolfAA (9170 in chips) 
Seat 7: Oliver N76 (18612 in chips) 
Seat 8: No Brakes357 (6689 in chips) 
Seat 9: jcarlos.vale (5878 in chips) 
Ka4eBHuK 777: posts the ante 22
matalaha: posts the ante 22
VitalikX77: posts the ante 22
schlier4: posts the ante 22
mjmj1971: posts the ante 22
GunDolfAA: posts the ante 22
Oliver N76: posts the ante 22
No Brakes357: posts the ante 22
jcarlos.vale: posts the ante 22
No Brakes357: posts small blind 150
jcarlos.vale: posts big blind 300
*** HOLE CARDS ***
Dealt to jcarlos.vale [Ad Qh]
Ka4eBHuK 777: folds 
matalaha: folds 
VitalikX77: folds 
schlier4: folds 
mjmj1971: folds 
GunDolfAA: calls 300
Oliver N76: folds 
No Brakes357: calls 150
jcarlos.vale: checks 
*** FLOP *** [2c 9c 6s]
No Brakes357: bets 549
jcarlos.vale: folds 
GunDolfAA: folds 
Uncalled bet (549) returned to No Brakes357
No Brakes357 collected 1098 from pot
No Brakes357: doesn't show handDTO
*** SUMMARY ***
Total pot 1098 | Rake 0 
Board [2c 9c 6s]
Seat 1: Ka4eBHuK 777 folded before Flop (didn't bet)
Seat 2: matalaha folded before Flop (didn't bet)
Seat 3: VitalikX77 folded before Flop (didn't bet)
Seat 4: schlier4 folded before Flop (didn't bet)
Seat 5: mjmj1971 folded before Flop (didn't bet)
Seat 6: GunDolfAA folded on the Flop
Seat 7: Oliver N76 (button) folded before Flop (didn't bet)
Seat 8: No Brakes357 (small blind) collected (1098)
Seat 9: jcarlos.vale (big blind) folded on the Flop



PokerStars Hand #208298796457: Tournament #2779056951, $0.49+$0.06 USD Hold'em No Limit - Level XI (150/300) - 2020/01/18 22:50:45 EET [2020/01/18 15:50:45 ET]
Table '2779056951 40' 9-max Seat #8 is the button
Seat 1: Ka4eBHuK 777 (3342 in chips) is sitting out
Seat 2: matalaha (7073 in chips) 
Seat 3: VitalikX77 (17972 in chips) 
Seat 4: schlier4 (10295 in chips) 
Seat 5: mjmj1971 (9304 in chips) 
Seat 6: GunDolfAA (8848 in chips) 
Seat 7: Oliver N76 (18590 in chips) 
Seat 8: No Brakes357 (7465 in chips) 
Seat 9: jcarlos.vale (5556 in chips) 
Ka4eBHuK 777: posts the ante 22
matalaha: posts the ante 22
VitalikX77: posts the ante 22
schlier4: posts the ante 22
mjmj1971: posts the ante 22
GunDolfAA: posts the ante 22
Oliver N76: posts the ante 22
No Brakes357: posts the ante 22
jcarlos.vale: posts the ante 22
jcarlos.vale: posts small blind 150
Ka4eBHuK 777: posts big blind 300
*** HOLE CARDS ***
Dealt to jcarlos.vale [4s Qd]
matalaha: raises 6751 to 7051 and is all-in
VitalikX77: folds 
schlier4: folds 
mjmj1971: folds 
GunDolfAA: folds 
Oliver N76: folds 
No Brakes357: folds 
jcarlos.vale: folds 
Ka4eBHuK 777: folds 
Uncalled bet (6751) returned to matalaha
matalaha collected 948 from pot
matalaha: doesn't show handDTO
*** SUMMARY ***
Total pot 948 | Rake 0 
Seat 1: Ka4eBHuK 777 (big blind) folded before Flop
Seat 2: matalaha collected (948)
Seat 3: VitalikX77 folded before Flop (didn't bet)
Seat 4: schlier4 folded before Flop (didn't bet)
Seat 5: mjmj1971 folded before Flop (didn't bet)
Seat 6: GunDolfAA folded before Flop (didn't bet)
Seat 7: Oliver N76 folded before Flop (didn't bet)
Seat 8: No Brakes357 (button) folded before Flop (didn't bet)
Seat 9: jcarlos.vale (small blind) folded before Flop



PokerStars Hand #208298806095: Tournament #2779056951, $0.49+$0.06 USD Hold'em No Limit - Level XI (150/300) - 2020/01/18 22:51:00 EET [2020/01/18 15:51:00 ET]
Table '2779056951 40' 9-max Seat #9 is the button
Seat 1: Ka4eBHuK 777 (3020 in chips) is sitting out
Seat 2: matalaha (7699 in chips) 
Seat 3: VitalikX77 (17950 in chips) 
Seat 4: schlier4 (10273 in chips) 
Seat 5: mjmj1971 (9282 in chips) 
Seat 6: GunDolfAA (8826 in chips) 
Seat 7: Oliver N76 (18568 in chips) 
Seat 8: No Brakes357 (7443 in chips) 
Seat 9: jcarlos.vale (5384 in chips) 
Ka4eBHuK 777: posts the ante 22
matalaha: posts the ante 22
VitalikX77: posts the ante 22
schlier4: posts the ante 22
mjmj1971: posts the ante 22
GunDolfAA: posts the ante 22
Oliver N76: posts the ante 22
No Brakes357: posts the ante 22
jcarlos.vale: posts the ante 22
Ka4eBHuK 777: posts small blind 150
matalaha: posts big blind 300
*** HOLE CARDS ***
Dealt to jcarlos.vale [8d 6s]
VitalikX77: raises 420 to 720
schlier4: folds 
mjmj1971: folds 
GunDolfAA: folds 
Oliver N76: folds 
No Brakes357: folds 
jcarlos.vale: folds 
Ka4eBHuK 777: folds 
matalaha: folds 
Uncalled bet (420) returned to VitalikX77
VitalikX77 collected 948 from pot
*** SUMMARY ***
Total pot 948 | Rake 0 
Seat 1: Ka4eBHuK 777 (small blind) folded before Flop
Seat 2: matalaha (big blind) folded before Flop
Seat 3: VitalikX77 collected (948)
Seat 4: schlier4 folded before Flop (didn't bet)
Seat 5: mjmj1971 folded before Flop (didn't bet)
Seat 6: GunDolfAA folded before Flop (didn't bet)
Seat 7: Oliver N76 folded before Flop (didn't bet)
Seat 8: No Brakes357 folded before Flop (didn't bet)
Seat 9: jcarlos.vale (button) folded before Flop (didn't bet)



PokerStars Hand #208298833456: Tournament #2779056951, $0.49+$0.06 USD Hold'em No Limit - Level XI (150/300) - 2020/01/18 22:51:44 EET [2020/01/18 15:51:44 ET]
Table '2779056951 40' 9-max Seat #1 is the button
Seat 1: Ka4eBHuK 777 (2848 in chips) is sitting out
Seat 2: matalaha (7377 in chips) 
Seat 3: VitalikX77 (18576 in chips) 
Seat 4: schlier4 (10251 in chips) 
Seat 5: mjmj1971 (9260 in chips) 
Seat 6: GunDolfAA (8804 in chips) 
Seat 7: Oliver N76 (18546 in chips) 
Seat 8: No Brakes357 (7421 in chips) 
Seat 9: jcarlos.vale (5362 in chips) 
Ka4eBHuK 777: posts the ante 22
matalaha: posts the ante 22
VitalikX77: posts the ante 22
schlier4: posts the ante 22
mjmj1971: posts the ante 22
GunDolfAA: posts the ante 22
Oliver N76: posts the ante 22
No Brakes357: posts the ante 22
jcarlos.vale: posts the ante 22
matalaha: posts small blind 150
VitalikX77: posts big blind 300
*** HOLE CARDS ***
Dealt to jcarlos.vale [Td Qd]
schlier4: folds 
mjmj1971: raises 600 to 900
GunDolfAA: folds 
Oliver N76: folds 
No Brakes357: calls 900
jcarlos.vale: folds 
Ka4eBHuK 777: folds 
matalaha: calls 750
VitalikX77: folds 
*** FLOP *** [5h 3s 5d]
matalaha: checks 
mjmj1971: checks 
No Brakes357: checks 
*** TURN *** [5h 3s 5d] [Jc]
matalaha: bets 1759
mjmj1971: folds 
No Brakes357: folds 
Uncalled bet (1759) returned to matalaha
matalaha collected 3198 from pot
matalaha: doesn't show handDTO
*** SUMMARY ***
Total pot 3198 | Rake 0 
Board [5h 3s 5d Jc]
Seat 1: Ka4eBHuK 777 (button) folded before Flop (didn't bet)
Seat 2: matalaha (small blind) collected (3198)
Seat 3: VitalikX77 (big blind) folded before Flop
Seat 4: schlier4 folded before Flop (didn't bet)
Seat 5: mjmj1971 folded on the Turn
Seat 6: GunDolfAA folded before Flop (didn't bet)
Seat 7: Oliver N76 folded before Flop (didn't bet)
Seat 8: No Brakes357 folded on the Turn
Seat 9: jcarlos.vale folded before Flop (didn't bet)



PokerStars Hand #208298868156: Tournament #2779056951, $0.49+$0.06 USD Hold'em No Limit - Level XI (150/300) - 2020/01/18 22:52:38 EET [2020/01/18 15:52:38 ET]
Table '2779056951 40' 9-max Seat #2 is the button
Seat 1: Ka4eBHuK 777 (2826 in chips) is sitting out
Seat 2: matalaha (9653 in chips) 
Seat 3: VitalikX77 (18254 in chips) 
Seat 4: schlier4 (10229 in chips) 
Seat 5: mjmj1971 (8338 in chips) 
Seat 6: GunDolfAA (8782 in chips) 
Seat 7: Oliver N76 (18524 in chips) 
Seat 8: No Brakes357 (6499 in chips) 
Seat 9: jcarlos.vale (5340 in chips) 
Ka4eBHuK 777: posts the ante 22
matalaha: posts the ante 22
VitalikX77: posts the ante 22
schlier4: posts the ante 22
mjmj1971: posts the ante 22
GunDolfAA: posts the ante 22
Oliver N76: posts the ante 22
No Brakes357: posts the ante 22
jcarlos.vale: posts the ante 22
VitalikX77: posts small blind 150
schlier4: posts big blind 300
*** HOLE CARDS ***
Dealt to jcarlos.vale [Th 4d]
mjmj1971: folds 
GunDolfAA: calls 300
Oliver N76: raises 900 to 1200
No Brakes357: calls 1200
jcarlos.vale: folds 
Ka4eBHuK 777: folds 
matalaha: folds 
VitalikX77: folds 
schlier4: calls 900
GunDolfAA: calls 900
*** FLOP *** [7c 2s Kh]
schlier4: checks 
GunDolfAA: checks 
Oliver N76: bets 1544
No Brakes357: folds 
schlier4: raises 1544 to 3088
GunDolfAA: folds 
Oliver N76: folds 
Uncalled bet (1544) returned to schlier4
schlier4 collected 8236 from pot
schlier4: doesn't show handDTO
*** SUMMARY ***
Total pot 8236 | Rake 0 
Board [7c 2s Kh]
Seat 1: Ka4eBHuK 777 folded before Flop (didn't bet)
Seat 2: matalaha (button) folded before Flop (didn't bet)
Seat 3: VitalikX77 (small blind) folded before Flop
Seat 4: schlier4 (big blind) collected (8236)
Seat 5: mjmj1971 folded before Flop (didn't bet)
Seat 6: GunDolfAA folded on the Flop
Seat 7: Oliver N76 folded on the Flop
Seat 8: No Brakes357 folded on the Flop
Seat 9: jcarlos.vale folded before Flop (didn't bet)



PokerStars Hand #208298909011: Tournament #2779056951, $0.49+$0.06 USD Hold'em No Limit - Level XI (150/300) - 2020/01/18 22:53:43 EET [2020/01/18 15:53:43 ET]
Table '2779056951 40' 9-max Seat #3 is the button
Seat 1: Ka4eBHuK 777 (2804 in chips) is sitting out
Seat 2: matalaha (9631 in chips) 
Seat 3: VitalikX77 (18082 in chips) 
Seat 4: schlier4 (15699 in chips) 
Seat 5: mjmj1971 (8316 in chips) 
Seat 6: GunDolfAA (7560 in chips) 
Seat 7: Oliver N76 (15758 in chips) 
Seat 8: No Brakes357 (5277 in chips) 
Seat 9: jcarlos.vale (5318 in chips) 
Ka4eBHuK 777: posts the ante 22
matalaha: posts the ante 22
VitalikX77: posts the ante 22
schlier4: posts the ante 22
mjmj1971: posts the ante 22
GunDolfAA: posts the ante 22
Oliver N76: posts the ante 22
No Brakes357: posts the ante 22
jcarlos.vale: posts the ante 22
schlier4: posts small blind 150
mjmj1971: posts big blind 300
*** HOLE CARDS ***
Dealt to jcarlos.vale [Ac 8c]
GunDolfAA: folds 
Oliver N76: folds 
No Brakes357: folds 
jcarlos.vale: raises 330 to 630
Ka4eBHuK 777: folds 
matalaha: folds 
VitalikX77: folds 
schlier4: calls 480
mjmj1971: calls 330
*** FLOP *** [5s Td 3h]
schlier4: checks 
mjmj1971: bets 300
jcarlos.vale: calls 300
schlier4: calls 300
*** TURN *** [5s Td 3h] [5d]
schlier4: checks 
mjmj1971: bets 300
jcarlos.vale: folds 
schlier4: calls 300
*** RIVER *** [5s Td 3h 5d] [4d]
schlier4: checks 
mjmj1971: bets 3600
schlier4: calls 3600
*** SHOW DOWN ***
mjmj1971: shows [Tc Th] (a full house, Tens full of Fives)
schlier4: mucks handDTO
mjmj1971 collected 10788 from pot
*** SUMMARY ***
Total pot 10788 | Rake 0 
Board [5s Td 3h 5d 4d]
Seat 1: Ka4eBHuK 777 folded before Flop (didn't bet)
Seat 2: matalaha folded before Flop (didn't bet)
Seat 3: VitalikX77 (button) folded before Flop (didn't bet)
Seat 4: schlier4 (small blind) mucked [Jh Js]
Seat 5: mjmj1971 (big blind) showed [Tc Th] and won (10788) with a full house, Tens full of Fives
Seat 6: GunDolfAA folded before Flop (didn't bet)
Seat 7: Oliver N76 folded before Flop (didn't bet)
Seat 8: No Brakes357 folded before Flop (didn't bet)
Seat 9: jcarlos.vale folded on the Turn



PokerStars Hand #208298936890: Tournament #2779056951, $0.49+$0.06 USD Hold'em No Limit - Level XI (150/300) - 2020/01/18 22:54:28 EET [2020/01/18 15:54:28 ET]
Table '2779056951 40' 9-max Seat #4 is the button
Seat 1: Ka4eBHuK 777 (2782 in chips) is sitting out
Seat 2: matalaha (9609 in chips) 
Seat 3: VitalikX77 (18060 in chips) 
Seat 4: schlier4 (10847 in chips) 
Seat 5: mjmj1971 (14252 in chips) 
Seat 6: GunDolfAA (7538 in chips) 
Seat 7: Oliver N76 (15736 in chips) 
Seat 8: No Brakes357 (5255 in chips) 
Seat 9: jcarlos.vale (4366 in chips) 
Ka4eBHuK 777: posts the ante 22
matalaha: posts the ante 22
VitalikX77: posts the ante 22
schlier4: posts the ante 22
mjmj1971: posts the ante 22
GunDolfAA: posts the ante 22
Oliver N76: posts the ante 22
No Brakes357: posts the ante 22
jcarlos.vale: posts the ante 22
mjmj1971: posts small blind 150
GunDolfAA: posts big blind 300
*** HOLE CARDS ***
Dealt to jcarlos.vale [Tc 8d]
Oliver N76: folds 
No Brakes357: folds 
jcarlos.vale: folds 
Ka4eBHuK 777: folds 
matalaha: raises 360 to 660
VitalikX77: calls 660
schlier4: folds 
mjmj1971: calls 510
GunDolfAA: raises 2838 to 3498
matalaha: folds 
VitalikX77: folds 
mjmj1971: folds 
Uncalled bet (2838) returned to GunDolfAA
GunDolfAA collected 2838 from pot
*** SUMMARY ***
Total pot 2838 | Rake 0 
Seat 1: Ka4eBHuK 777 folded before Flop (didn't bet)
Seat 2: matalaha folded before Flop
Seat 3: VitalikX77 folded before Flop
Seat 4: schlier4 (button) folded before Flop (didn't bet)
Seat 5: mjmj1971 (small blind) folded before Flop
Seat 6: GunDolfAA (big blind) collected (2838)
Seat 7: Oliver N76 folded before Flop (didn't bet)
Seat 8: No Brakes357 folded before Flop (didn't bet)
Seat 9: jcarlos.vale folded before Flop (didn't bet)



PokerStars Hand #208298960249: Tournament #2779056951, $0.49+$0.06 USD Hold'em No Limit - Level XI (150/300) - 2020/01/18 22:55:05 EET [2020/01/18 15:55:05 ET]
Table '2779056951 40' 9-max Seat #5 is the button
Seat 1: Ka4eBHuK 777 (2760 in chips) is sitting out
Seat 2: matalaha (8927 in chips) 
Seat 3: VitalikX77 (17378 in chips) 
Seat 4: schlier4 (10825 in chips) 
Seat 5: mjmj1971 (13570 in chips) 
Seat 6: GunDolfAA (9694 in chips) 
Seat 7: Oliver N76 (15714 in chips) 
Seat 8: No Brakes357 (5233 in chips) 
Seat 9: jcarlos.vale (4344 in chips) 
Ka4eBHuK 777: posts the ante 22
matalaha: posts the ante 22
VitalikX77: posts the ante 22
schlier4: posts the ante 22
mjmj1971: posts the ante 22
GunDolfAA: posts the ante 22
Oliver N76: posts the ante 22
No Brakes357: posts the ante 22
jcarlos.vale: posts the ante 22
GunDolfAA: posts small blind 150
Oliver N76: posts big blind 300
*** HOLE CARDS ***
Dealt to jcarlos.vale [8c Ac]
No Brakes357: folds 
jcarlos.vale: raises 4022 to 4322 and is all-in
Ka4eBHuK 777: folds 
matalaha: folds 
VitalikX77: folds 
schlier4: calls 4322
mjmj1971: folds 
GunDolfAA: folds 
Oliver N76: folds 
*** FLOP *** [5s 4h As]
*** TURN *** [5s 4h As] [9d]
*** RIVER *** [5s 4h As 9d] [4d]
*** SHOW DOWN ***
jcarlos.vale: shows [8c Ac] (two pair, Aces and Fours)
schlier4: shows [Tc Ts] (two pair, Tens and Fours)
jcarlos.vale collected 9292 from pot
*** SUMMARY ***
Total pot 9292 | Rake 0 
Board [5s 4h As 9d 4d]
Seat 1: Ka4eBHuK 777 folded before Flop (didn't bet)
Seat 2: matalaha folded before Flop (didn't bet)
Seat 3: VitalikX77 folded before Flop (didn't bet)
Seat 4: schlier4 showed [Tc Ts] and lost with two pair, Tens and Fours
Seat 5: mjmj1971 (button) folded before Flop (didn't bet)
Seat 6: GunDolfAA (small blind) folded before Flop
Seat 7: Oliver N76 (big blind) folded before Flop
Seat 8: No Brakes357 folded before Flop (didn't bet)
Seat 9: jcarlos.vale showed [8c Ac] and won (9292) with two pair, Aces and Fours



PokerStars Hand #208299193608: Tournament #2779056951, $0.49+$0.06 USD Hold'em No Limit - Level XI (150/300) - 2020/01/18 23:02:35 EET [2020/01/18 16:02:35 ET]
Table '2779056951 40' 9-max Seat #6 is the button
Seat 1: Ka4eBHuK 777 (2738 in chips) is sitting out
Seat 2: matalaha (8905 in chips) 
Seat 3: VitalikX77 (17356 in chips) 
Seat 4: schlier4 (6481 in chips) 
Seat 5: mjmj1971 (13548 in chips) 
Seat 6: GunDolfAA (9522 in chips) 
Seat 7: Oliver N76 (15392 in chips) 
Seat 8: No Brakes357 (5211 in chips) 
Seat 9: jcarlos.vale (9292 in chips) 
Ka4eBHuK 777: posts the ante 22
matalaha: posts the ante 22
VitalikX77: posts the ante 22
schlier4: posts the ante 22
mjmj1971: posts the ante 22
GunDolfAA: posts the ante 22
Oliver N76: posts the ante 22
No Brakes357: posts the ante 22
jcarlos.vale: posts the ante 22
Oliver N76: posts small blind 150
No Brakes357: posts big blind 300
*** HOLE CARDS ***
Dealt to jcarlos.vale [Kh Td]
jcarlos.vale: folds 
Ka4eBHuK 777: folds 
matalaha: folds 
VitalikX77: raises 420 to 720
schlier4: folds 
mjmj1971: calls 720
GunDolfAA: calls 720
Oliver N76 is disconnected 
Oliver N76 has timed out while disconnected
Oliver N76: folds 
Oliver N76 is sitting out
No Brakes357: folds 
*** FLOP *** [3c Kc 2h]
Oliver N76 has returned
VitalikX77: bets 1200
mjmj1971: folds 
GunDolfAA: folds 
Uncalled bet (1200) returned to VitalikX77
VitalikX77 collected 2808 from pot
*** SUMMARY ***
Total pot 2808 | Rake 0 
Board [3c Kc 2h]
Seat 1: Ka4eBHuK 777 folded before Flop (didn't bet)
Seat 2: matalaha folded before Flop (didn't bet)
Seat 3: VitalikX77 collected (2808)
Seat 4: schlier4 folded before Flop (didn't bet)
Seat 5: mjmj1971 folded on the Flop
Seat 6: GunDolfAA (button) folded on the Flop
Seat 7: Oliver N76 (small blind) folded before Flop
Seat 8: No Brakes357 (big blind) folded before Flop
Seat 9: jcarlos.vale folded before Flop (didn't bet)



PokerStars Hand #208299230938: Tournament #2779056951, $0.49+$0.06 USD Hold'em No Limit - Level XI (150/300) - 2020/01/18 23:03:35 EET [2020/01/18 16:03:35 ET]
Table '2779056951 40' 9-max Seat #7 is the button
Seat 1: Ka4eBHuK 777 (2716 in chips) is sitting out
Seat 2: matalaha (8883 in chips) 
Seat 3: VitalikX77 (19422 in chips) 
Seat 4: schlier4 (6459 in chips) 
Seat 5: mjmj1971 (12806 in chips) 
Seat 6: GunDolfAA (8780 in chips) 
Seat 7: Oliver N76 (15220 in chips) 
Seat 8: No Brakes357 (4889 in chips) 
Seat 9: jcarlos.vale (9270 in chips) 
Ka4eBHuK 777: posts the ante 22
matalaha: posts the ante 22
VitalikX77: posts the ante 22
schlier4: posts the ante 22
mjmj1971: posts the ante 22
GunDolfAA: posts the ante 22
Oliver N76: posts the ante 22
No Brakes357: posts the ante 22
jcarlos.vale: posts the ante 22
No Brakes357: posts small blind 150
jcarlos.vale: posts big blind 300
*** HOLE CARDS ***
Dealt to jcarlos.vale [6d 9h]
Ka4eBHuK 777: folds 
matalaha: folds 
VitalikX77: folds 
schlier4: folds 
mjmj1971: folds 
GunDolfAA: folds 
Oliver N76: folds 
No Brakes357: folds 
Uncalled bet (150) returned to jcarlos.vale
jcarlos.vale collected 498 from pot
jcarlos.vale: doesn't show handDTO
*** SUMMARY ***
Total pot 498 | Rake 0 
Seat 1: Ka4eBHuK 777 folded before Flop (didn't bet)
Seat 2: matalaha folded before Flop (didn't bet)
Seat 3: VitalikX77 folded before Flop (didn't bet)
Seat 4: schlier4 folded before Flop (didn't bet)
Seat 5: mjmj1971 folded before Flop (didn't bet)
Seat 6: GunDolfAA folded before Flop (didn't bet)
Seat 7: Oliver N76 (button) folded before Flop (didn't bet)
Seat 8: No Brakes357 (small blind) folded before Flop
Seat 9: jcarlos.vale (big blind) collected (498)



PokerStars Hand #208299244756: Tournament #2779056951, $0.49+$0.06 USD Hold'em No Limit - Level XI (150/300) - 2020/01/18 23:03:58 EET [2020/01/18 16:03:58 ET]
Table '2779056951 40' 9-max Seat #8 is the button
Seat 1: Ka4eBHuK 777 (2694 in chips) is sitting out
Seat 2: matalaha (8861 in chips) 
Seat 3: VitalikX77 (19400 in chips) 
Seat 4: schlier4 (6437 in chips) 
Seat 5: mjmj1971 (12784 in chips) 
Seat 6: GunDolfAA (8758 in chips) 
Seat 7: Oliver N76 (15198 in chips) 
Seat 8: No Brakes357 (4717 in chips) 
Seat 9: jcarlos.vale (9596 in chips) 
Ka4eBHuK 777: posts the ante 22
matalaha: posts the ante 22
VitalikX77: posts the ante 22
schlier4: posts the ante 22
mjmj1971: posts the ante 22
GunDolfAA: posts the ante 22
Oliver N76: posts the ante 22
No Brakes357: posts the ante 22
jcarlos.vale: posts the ante 22
jcarlos.vale: posts small blind 150
Ka4eBHuK 777: posts big blind 300
*** HOLE CARDS ***
Dealt to jcarlos.vale [6s 7d]
matalaha: folds 
VitalikX77: raises 360 to 660
schlier4: folds 
mjmj1971: raises 12102 to 12762 and is all-in
GunDolfAA: folds 
Oliver N76: folds 
No Brakes357: calls 4695 and is all-in
jcarlos.vale: folds 
Ka4eBHuK 777: folds 
VitalikX77: folds 
Uncalled bet (8067) returned to mjmj1971
*** FLOP *** [Qc 8h 3s]
*** TURN *** [Qc 8h 3s] [Kd]
*** RIVER *** [Qc 8h 3s Kd] [3h]
*** SHOW DOWN ***
mjmj1971: shows [Qs Ac] (two pair, Queens and Threes)
No Brakes357: shows [Qd Qh] (a full house, Queens full of Threes)
No Brakes357 collected 10698 from pot
*** SUMMARY ***
Total pot 10698 | Rake 0 
Board [Qc 8h 3s Kd 3h]
Seat 1: Ka4eBHuK 777 (big blind) folded before Flop
Seat 2: matalaha folded before Flop (didn't bet)
Seat 3: VitalikX77 folded before Flop
Seat 4: schlier4 folded before Flop (didn't bet)
Seat 5: mjmj1971 showed [Qs Ac] and lost with two pair, Queens and Threes
Seat 6: GunDolfAA folded before Flop (didn't bet)
Seat 7: Oliver N76 folded before Flop (didn't bet)
Seat 8: No Brakes357 (button) showed [Qd Qh] and won (10698) with a full house, Queens full of Threes
Seat 9: jcarlos.vale (small blind) folded before Flop



PokerStars Hand #208299271925: Tournament #2779056951, $0.49+$0.06 USD Hold'em No Limit - Level XII (200/400) - 2020/01/18 23:04:42 EET [2020/01/18 16:04:42 ET]
Table '2779056951 40' 9-max Seat #9 is the button
Seat 1: Ka4eBHuK 777 (2372 in chips) is sitting out
Seat 2: matalaha (8839 in chips) 
Seat 3: VitalikX77 (18718 in chips) 
Seat 4: schlier4 (6415 in chips) 
Seat 5: mjmj1971 (8067 in chips) 
Seat 6: GunDolfAA (8736 in chips) 
Seat 7: Oliver N76 (15176 in chips) 
Seat 8: No Brakes357 (10698 in chips) 
Seat 9: jcarlos.vale (9424 in chips) 
Ka4eBHuK 777: posts the ante 25
matalaha: posts the ante 25
VitalikX77: posts the ante 25
schlier4: posts the ante 25
mjmj1971: posts the ante 25
GunDolfAA: posts the ante 25
Oliver N76: posts the ante 25
No Brakes357: posts the ante 25
jcarlos.vale: posts the ante 25
Ka4eBHuK 777: posts small blind 200
matalaha: posts big blind 400
*** HOLE CARDS ***
Dealt to jcarlos.vale [Tc Qc]
VitalikX77: folds 
schlier4: folds 
mjmj1971: raises 7642 to 8042 and is all-in
GunDolfAA: folds 
Oliver N76: folds 
No Brakes357: folds 
jcarlos.vale: folds 
Ka4eBHuK 777: folds 
matalaha: folds 
Uncalled bet (7642) returned to mjmj1971
mjmj1971 collected 1225 from pot
mjmj1971: doesn't show handDTO
*** SUMMARY ***
Total pot 1225 | Rake 0 
Seat 1: Ka4eBHuK 777 (small blind) folded before Flop
Seat 2: matalaha (big blind) folded before Flop
Seat 3: VitalikX77 folded before Flop (didn't bet)
Seat 4: schlier4 folded before Flop (didn't bet)
Seat 5: mjmj1971 collected (1225)
Seat 6: GunDolfAA folded before Flop (didn't bet)
Seat 7: Oliver N76 folded before Flop (didn't bet)
Seat 8: No Brakes357 folded before Flop (didn't bet)
Seat 9: jcarlos.vale (button) folded before Flop (didn't bet)



PokerStars Hand #208299285747: Tournament #2779056951, $0.49+$0.06 USD Hold'em No Limit - Level XII (200/400) - 2020/01/18 23:05:04 EET [2020/01/18 16:05:04 ET]
Table '2779056951 40' 9-max Seat #1 is the button
Seat 1: Ka4eBHuK 777 (2147 in chips) is sitting out
Seat 2: matalaha (8414 in chips) 
Seat 3: VitalikX77 (18693 in chips) 
Seat 4: schlier4 (6390 in chips) 
Seat 5: mjmj1971 (8867 in chips) 
Seat 6: GunDolfAA (8711 in chips) 
Seat 7: Oliver N76 (15151 in chips) 
Seat 8: No Brakes357 (10673 in chips) 
Seat 9: jcarlos.vale (9399 in chips) 
Ka4eBHuK 777: posts the ante 25
matalaha: posts the ante 25
VitalikX77: posts the ante 25
schlier4: posts the ante 25
mjmj1971: posts the ante 25
GunDolfAA: posts the ante 25
Oliver N76: posts the ante 25
No Brakes357: posts the ante 25
jcarlos.vale: posts the ante 25
matalaha: posts small blind 200
VitalikX77: posts big blind 400
*** HOLE CARDS ***
Dealt to jcarlos.vale [Kc Kh]
schlier4: folds 
mjmj1971: folds 
GunDolfAA: folds 
Oliver N76: folds 
No Brakes357: folds 
jcarlos.vale: raises 800 to 1200
Ka4eBHuK 777: folds 
matalaha: folds 
VitalikX77: raises 17468 to 18668 and is all-in
jcarlos.vale: calls 8174 and is all-in
Uncalled bet (9294) returned to VitalikX77
*** FLOP *** [6c 8c Ts]
*** TURN *** [6c 8c Ts] [Ks]
*** RIVER *** [6c 8c Ts Ks] [Js]
*** SHOW DOWN ***
VitalikX77: shows [As Tc] (a pair of Tens)
jcarlos.vale: shows [Kc Kh] (three of a kind, Kings)
jcarlos.vale collected 19173 from pot
*** SUMMARY ***
Total pot 19173 | Rake 0 
Board [6c 8c Ts Ks Js]
Seat 1: Ka4eBHuK 777 (button) folded before Flop (didn't bet)
Seat 2: matalaha (small blind) folded before Flop
Seat 3: VitalikX77 (big blind) showed [As Tc] and lost with a pair of Tens
Seat 4: schlier4 folded before Flop (didn't bet)
Seat 5: mjmj1971 folded before Flop (didn't bet)
Seat 6: GunDolfAA folded before Flop (didn't bet)
Seat 7: Oliver N76 folded before Flop (didn't bet)
Seat 8: No Brakes357 folded before Flop (didn't bet)
Seat 9: jcarlos.vale showed [Kc Kh] and won (19173) with three of a kind, Kings



PokerStars Hand #208299313090: Tournament #2779056951, $0.49+$0.06 USD Hold'em No Limit - Level XII (200/400) - 2020/01/18 23:05:48 EET [2020/01/18 16:05:48 ET]
Table '2779056951 40' 9-max Seat #2 is the button
Seat 1: Ka4eBHuK 777 (2122 in chips) is sitting out
Seat 2: matalaha (8189 in chips) 
Seat 3: VitalikX77 (9294 in chips) 
Seat 4: schlier4 (6365 in chips) 
Seat 5: mjmj1971 (8842 in chips) 
Seat 6: GunDolfAA (8686 in chips) 
Seat 7: Oliver N76 (15126 in chips) 
Seat 8: No Brakes357 (10648 in chips) 
Seat 9: jcarlos.vale (19173 in chips) 
Ka4eBHuK 777: posts the ante 25
matalaha: posts the ante 25
VitalikX77: posts the ante 25
schlier4: posts the ante 25
mjmj1971: posts the ante 25
GunDolfAA: posts the ante 25
Oliver N76: posts the ante 25
No Brakes357: posts the ante 25
jcarlos.vale: posts the ante 25
VitalikX77: posts small blind 200
schlier4: posts big blind 400
*** HOLE CARDS ***
Dealt to jcarlos.vale [2s Jd]
mjmj1971: folds 
GunDolfAA: calls 400
Oliver N76: folds 
No Brakes357: calls 400
jcarlos.vale: folds 
Ka4eBHuK 777: folds 
matalaha: folds 
VitalikX77: calls 200
schlier4: checks 
*** FLOP *** [9h 4d 8c]
VitalikX77: bets 1000
schlier4: folds 
GunDolfAA: folds 
No Brakes357: folds 
Uncalled bet (1000) returned to VitalikX77
VitalikX77 collected 1825 from pot
*** SUMMARY ***
Total pot 1825 | Rake 0 
Board [9h 4d 8c]
Seat 1: Ka4eBHuK 777 folded before Flop (didn't bet)
Seat 2: matalaha (button) folded before Flop (didn't bet)
Seat 3: VitalikX77 (small blind) collected (1825)
Seat 4: schlier4 (big blind) folded on the Flop
Seat 5: mjmj1971 folded before Flop (didn't bet)
Seat 6: GunDolfAA folded on the Flop
Seat 7: Oliver N76 folded before Flop (didn't bet)
Seat 8: No Brakes357 folded on the Flop
Seat 9: jcarlos.vale folded before Flop (didn't bet)



PokerStars Hand #208299329367: Tournament #2779056951, $0.49+$0.06 USD Hold'em No Limit - Level XII (200/400) - 2020/01/18 23:06:14 EET [2020/01/18 16:06:14 ET]
Table '2779056951 40' 9-max Seat #3 is the button
Seat 1: Ka4eBHuK 777 (2097 in chips) is sitting out
Seat 2: matalaha (8164 in chips) 
Seat 3: VitalikX77 (10694 in chips) 
Seat 4: schlier4 (5940 in chips) 
Seat 5: mjmj1971 (8817 in chips) 
Seat 6: GunDolfAA (8261 in chips) 
Seat 7: Oliver N76 (15101 in chips) 
Seat 8: No Brakes357 (10223 in chips) 
Seat 9: jcarlos.vale (19148 in chips) 
Ka4eBHuK 777: posts the ante 25
matalaha: posts the ante 25
VitalikX77: posts the ante 25
schlier4: posts the ante 25
mjmj1971: posts the ante 25
GunDolfAA: posts the ante 25
Oliver N76: posts the ante 25
No Brakes357: posts the ante 25
jcarlos.vale: posts the ante 25
schlier4: posts small blind 200
mjmj1971: posts big blind 400
*** HOLE CARDS ***
Dealt to jcarlos.vale [3s 4c]
GunDolfAA: raises 400 to 800
Oliver N76: folds 
No Brakes357: folds 
jcarlos.vale: folds 
Ka4eBHuK 777: folds 
matalaha has timed out
matalaha: folds 
matalaha is sitting out
VitalikX77: folds 
schlier4: calls 600
mjmj1971: calls 400
*** FLOP *** [Kc Kd 2h]
schlier4: checks 
mjmj1971: checks 
GunDolfAA: bets 1200
schlier4: calls 1200
mjmj1971: folds 
*** TURN *** [Kc Kd 2h] [9c]
schlier4: checks 
GunDolfAA: bets 2000
schlier4: raises 1915 to 3915 and is all-in
GunDolfAA: calls 1915
*** RIVER *** [Kc Kd 2h 9c] [6c]
*** SHOW DOWN ***
schlier4: shows [Js Jd] (two pair, Kings and Jacks)
GunDolfAA: shows [Jh Ac] (a pair of Kings)
schlier4 collected 12855 from pot
*** SUMMARY ***
Total pot 12855 | Rake 0 
Board [Kc Kd 2h 9c 6c]
Seat 1: Ka4eBHuK 777 folded before Flop (didn't bet)
Seat 2: matalaha folded before Flop (didn't bet)
Seat 3: VitalikX77 (button) folded before Flop (didn't bet)
Seat 4: schlier4 (small blind) showed [Js Jd] and won (12855) with two pair, Kings and Jacks
Seat 5: mjmj1971 (big blind) folded on the Flop
Seat 6: GunDolfAA showed [Jh Ac] and lost with a pair of Kings
Seat 7: Oliver N76 folded before Flop (didn't bet)
Seat 8: No Brakes357 folded before Flop (didn't bet)
Seat 9: jcarlos.vale folded before Flop (didn't bet)



PokerStars Hand #208299363219: Tournament #2779056951, $0.49+$0.06 USD Hold'em No Limit - Level XII (200/400) - 2020/01/18 23:07:09 EET [2020/01/18 16:07:09 ET]
Table '2779056951 40' 9-max Seat #4 is the button
Seat 1: Ka4eBHuK 777 (2072 in chips) is sitting out
Seat 2: matalaha (8139 in chips) is sitting out
Seat 3: VitalikX77 (10669 in chips) 
Seat 4: schlier4 (12855 in chips) 
Seat 5: mjmj1971 (7992 in chips) 
Seat 6: GunDolfAA (2321 in chips) 
Seat 7: Oliver N76 (15076 in chips) 
Seat 8: No Brakes357 (10198 in chips) 
Seat 9: jcarlos.vale (19123 in chips) 
Ka4eBHuK 777: posts the ante 25
matalaha: posts the ante 25
VitalikX77: posts the ante 25
schlier4: posts the ante 25
mjmj1971: posts the ante 25
GunDolfAA: posts the ante 25
Oliver N76: posts the ante 25
No Brakes357: posts the ante 25
jcarlos.vale: posts the ante 25
mjmj1971: posts small blind 200
GunDolfAA: posts big blind 400
*** HOLE CARDS ***
Dealt to jcarlos.vale [Qc 8s]
Oliver N76: folds 
No Brakes357: folds 
jcarlos.vale: folds 
Ka4eBHuK 777: folds 
matalaha: folds 
VitalikX77: folds 
schlier4: folds 
mjmj1971: calls 200
GunDolfAA: checks 
*** FLOP *** [8c 9s 5h]
mjmj1971: checks 
GunDolfAA: bets 1896 and is all-in
mjmj1971: folds 
Uncalled bet (1896) returned to GunDolfAA
GunDolfAA collected 1025 from pot
*** SUMMARY ***
Total pot 1025 | Rake 0 
Board [8c 9s 5h]
Seat 1: Ka4eBHuK 777 folded before Flop (didn't bet)
Seat 2: matalaha folded before Flop (didn't bet)
Seat 3: VitalikX77 folded before Flop (didn't bet)
Seat 4: schlier4 (button) folded before Flop (didn't bet)
Seat 5: mjmj1971 (small blind) folded on the Flop
Seat 6: GunDolfAA (big blind) collected (1025)
Seat 7: Oliver N76 folded before Flop (didn't bet)
Seat 8: No Brakes357 folded before Flop (didn't bet)
Seat 9: jcarlos.vale folded before Flop (didn't bet)



PokerStars Hand #208299376082: Tournament #2779056951, $0.49+$0.06 USD Hold'em No Limit - Level XII (200/400) - 2020/01/18 23:07:30 EET [2020/01/18 16:07:30 ET]
Table '2779056951 40' 9-max Seat #5 is the button
Seat 1: Ka4eBHuK 777 (2047 in chips) is sitting out
Seat 2: matalaha (8114 in chips) is sitting out
Seat 3: VitalikX77 (10644 in chips) 
Seat 4: schlier4 (12830 in chips) 
Seat 5: mjmj1971 (7567 in chips) 
Seat 6: GunDolfAA (2921 in chips) 
Seat 7: Oliver N76 (15051 in chips) 
Seat 8: No Brakes357 (10173 in chips) 
Seat 9: jcarlos.vale (19098 in chips) 
Ka4eBHuK 777: posts the ante 25
matalaha: posts the ante 25
VitalikX77: posts the ante 25
schlier4: posts the ante 25
mjmj1971: posts the ante 25
GunDolfAA: posts the ante 25
Oliver N76: posts the ante 25
No Brakes357: posts the ante 25
jcarlos.vale: posts the ante 25
GunDolfAA: posts small blind 200
Oliver N76: posts big blind 400
*** HOLE CARDS ***
Dealt to jcarlos.vale [5d 6h]
No Brakes357: folds 
jcarlos.vale: folds 
Ka4eBHuK 777: folds 
matalaha: folds 
VitalikX77: raises 560 to 960
schlier4: folds 
mjmj1971: folds 
GunDolfAA: calls 760
Oliver N76: folds 
*** FLOP *** [Tc As Kd]
GunDolfAA: checks 
VitalikX77: bets 764
GunDolfAA: calls 764
*** TURN *** [Tc As Kd] [9d]
GunDolfAA: checks 
VitalikX77: bets 1222
GunDolfAA: calls 1172 and is all-in
Uncalled bet (50) returned to VitalikX77
*** RIVER *** [Tc As Kd 9d] [4d]
*** SHOW DOWN ***
GunDolfAA: shows [Kc 6s] (a pair of Kings)
VitalikX77: shows [8c 9s] (a pair of Nines)
GunDolfAA collected 6417 from pot
*** SUMMARY ***
Total pot 6417 | Rake 0 
Board [Tc As Kd 9d 4d]
Seat 1: Ka4eBHuK 777 folded before Flop (didn't bet)
Seat 2: matalaha folded before Flop (didn't bet)
Seat 3: VitalikX77 showed [8c 9s] and lost with a pair of Nines
Seat 4: schlier4 folded before Flop (didn't bet)
Seat 5: mjmj1971 (button) folded before Flop (didn't bet)
Seat 6: GunDolfAA (small blind) showed [Kc 6s] and won (6417) with a pair of Kings
Seat 7: Oliver N76 (big blind) folded before Flop
Seat 8: No Brakes357 folded before Flop (didn't bet)
Seat 9: jcarlos.vale folded before Flop (didn't bet)



PokerStars Hand #208299402985: Tournament #2779056951, $0.49+$0.06 USD Hold'em No Limit - Level XII (200/400) - 2020/01/18 23:08:14 EET [2020/01/18 16:08:14 ET]
Table '2779056951 40' 9-max Seat #6 is the button
Seat 1: Ka4eBHuK 777 (2022 in chips) is sitting out
Seat 2: matalaha (8089 in chips) is sitting out
Seat 3: VitalikX77 (7723 in chips) 
Seat 4: schlier4 (12805 in chips) 
Seat 5: mjmj1971 (7542 in chips) 
Seat 6: GunDolfAA (6417 in chips) 
Seat 7: Oliver N76 (14626 in chips) 
Seat 8: No Brakes357 (10148 in chips) 
Seat 9: jcarlos.vale (19073 in chips) 
Ka4eBHuK 777: posts the ante 25
matalaha: posts the ante 25
VitalikX77: posts the ante 25
schlier4: posts the ante 25
mjmj1971: posts the ante 25
GunDolfAA: posts the ante 25
Oliver N76: posts the ante 25
No Brakes357: posts the ante 25
jcarlos.vale: posts the ante 25
Oliver N76: posts small blind 200
No Brakes357: posts big blind 400
*** HOLE CARDS ***
Dealt to jcarlos.vale [3h 6c]
jcarlos.vale: folds 
Ka4eBHuK 777: folds 
matalaha: folds 
VitalikX77: folds 
schlier4: folds 
mjmj1971: folds 
GunDolfAA: raises 800 to 1200
Oliver N76: folds 
No Brakes357: folds 
Uncalled bet (800) returned to GunDolfAA
GunDolfAA collected 1225 from pot
GunDolfAA: doesn't show handDTO
*** SUMMARY ***
Total pot 1225 | Rake 0 
Seat 1: Ka4eBHuK 777 folded before Flop (didn't bet)
Seat 2: matalaha folded before Flop (didn't bet)
Seat 3: VitalikX77 folded before Flop (didn't bet)
Seat 4: schlier4 folded before Flop (didn't bet)
Seat 5: mjmj1971 folded before Flop (didn't bet)
Seat 6: GunDolfAA (button) collected (1225)
Seat 7: Oliver N76 (small blind) folded before Flop
Seat 8: No Brakes357 (big blind) folded before Flop
Seat 9: jcarlos.vale folded before Flop (didn't bet)



PokerStars Hand #208299415523: Tournament #2779056951, $0.49+$0.06 USD Hold'em No Limit - Level XII (200/400) - 2020/01/18 23:08:34 EET [2020/01/18 16:08:34 ET]
Table '2779056951 40' 9-max Seat #7 is the button
Seat 1: Ka4eBHuK 777 (1997 in chips) is sitting out
Seat 2: matalaha (8064 in chips) is sitting out
Seat 3: VitalikX77 (7698 in chips) 
Seat 4: schlier4 (12780 in chips) 
Seat 5: mjmj1971 (7517 in chips) 
Seat 6: GunDolfAA (7217 in chips) 
Seat 7: Oliver N76 (14401 in chips) 
Seat 8: No Brakes357 (9723 in chips) 
Seat 9: jcarlos.vale (19048 in chips) 
Ka4eBHuK 777: posts the ante 25
matalaha: posts the ante 25
VitalikX77: posts the ante 25
schlier4: posts the ante 25
mjmj1971: posts the ante 25
GunDolfAA: posts the ante 25
Oliver N76: posts the ante 25
No Brakes357: posts the ante 25
jcarlos.vale: posts the ante 25
No Brakes357: posts small blind 200
jcarlos.vale: posts big blind 400
*** HOLE CARDS ***
Dealt to jcarlos.vale [3c 2c]
Ka4eBHuK 777: folds 
matalaha: folds 
VitalikX77: folds 
schlier4: folds 
mjmj1971: raises 400 to 800
GunDolfAA: folds 
Oliver N76: folds 
No Brakes357: calls 600
matalaha has returned
jcarlos.vale: folds 
*** FLOP *** [Kc 7h Qh]
No Brakes357: checks 
mjmj1971: bets 800
No Brakes357: calls 800
*** TURN *** [Kc 7h Qh] [5d]
No Brakes357: checks 
mjmj1971: bets 5892 and is all-in
No Brakes357: folds 
Uncalled bet (5892) returned to mjmj1971
mjmj1971 collected 3825 from pot
mjmj1971: doesn't show handDTO
*** SUMMARY ***
Total pot 3825 | Rake 0 
Board [Kc 7h Qh 5d]
Seat 1: Ka4eBHuK 777 folded before Flop (didn't bet)
Seat 2: matalaha folded before Flop (didn't bet)
Seat 3: VitalikX77 folded before Flop (didn't bet)
Seat 4: schlier4 folded before Flop (didn't bet)
Seat 5: mjmj1971 collected (3825)
Seat 6: GunDolfAA folded before Flop (didn't bet)
Seat 7: Oliver N76 (button) folded before Flop (didn't bet)
Seat 8: No Brakes357 (small blind) folded on the Turn
Seat 9: jcarlos.vale (big blind) folded before Flop



PokerStars Hand #208299455500: Tournament #2779056951, $0.49+$0.06 USD Hold'em No Limit - Level XII (200/400) - 2020/01/18 23:09:39 EET [2020/01/18 16:09:39 ET]
Table '2779056951 40' 9-max Seat #8 is the button
Seat 1: Ka4eBHuK 777 (1972 in chips) is sitting out
Seat 2: matalaha (8039 in chips) 
Seat 3: VitalikX77 (7673 in chips) 
Seat 4: schlier4 (12755 in chips) 
Seat 5: mjmj1971 (9717 in chips) 
Seat 6: GunDolfAA (7192 in chips) 
Seat 7: Oliver N76 (14376 in chips) 
Seat 8: No Brakes357 (8098 in chips) 
Seat 9: jcarlos.vale (18623 in chips) 
Ka4eBHuK 777: posts the ante 25
matalaha: posts the ante 25
VitalikX77: posts the ante 25
schlier4: posts the ante 25
mjmj1971: posts the ante 25
GunDolfAA: posts the ante 25
Oliver N76: posts the ante 25
No Brakes357: posts the ante 25
jcarlos.vale: posts the ante 25
jcarlos.vale: posts small blind 200
Ka4eBHuK 777: posts big blind 400
*** HOLE CARDS ***
Dealt to jcarlos.vale [4s 6d]
matalaha: folds 
VitalikX77: folds 
schlier4: folds 
mjmj1971: folds 
GunDolfAA: folds 
Oliver N76: raises 440 to 840
No Brakes357: calls 840
jcarlos.vale: folds 
Ka4eBHuK 777: folds 
*** FLOP *** [Jc 9s As]
Oliver N76: bets 752
No Brakes357: folds 
Uncalled bet (752) returned to Oliver N76
Oliver N76 collected 2505 from pot
Oliver N76: doesn't show handDTO
*** SUMMARY ***
Total pot 2505 | Rake 0 
Board [Jc 9s As]
Seat 1: Ka4eBHuK 777 (big blind) folded before Flop
Seat 2: matalaha folded before Flop (didn't bet)
Seat 3: VitalikX77 folded before Flop (didn't bet)
Seat 4: schlier4 folded before Flop (didn't bet)
Seat 5: mjmj1971 folded before Flop (didn't bet)
Seat 6: GunDolfAA folded before Flop (didn't bet)
Seat 7: Oliver N76 collected (2505)
Seat 8: No Brakes357 (button) folded on the Flop
Seat 9: jcarlos.vale (small blind) folded before Flop



PokerStars Hand #208299494267: Tournament #2779056951, $0.49+$0.06 USD Hold'em No Limit - Level XII (200/400) - 2020/01/18 23:10:42 EET [2020/01/18 16:10:42 ET]
Table '2779056951 40' 9-max Seat #9 is the button
Seat 1: Ka4eBHuK 777 (1547 in chips) is sitting out
Seat 2: matalaha (8014 in chips) 
Seat 3: VitalikX77 (7648 in chips) 
Seat 4: schlier4 (12730 in chips) 
Seat 5: mjmj1971 (9692 in chips) 
Seat 6: GunDolfAA (7167 in chips) 
Seat 7: Oliver N76 (16016 in chips) 
Seat 8: No Brakes357 (7233 in chips) 
Seat 9: jcarlos.vale (18398 in chips) 
Ka4eBHuK 777: posts the ante 25
matalaha: posts the ante 25
VitalikX77: posts the ante 25
schlier4: posts the ante 25
mjmj1971: posts the ante 25
GunDolfAA: posts the ante 25
Oliver N76: posts the ante 25
No Brakes357: posts the ante 25
jcarlos.vale: posts the ante 25
Ka4eBHuK 777: posts small blind 200
matalaha: posts big blind 400
*** HOLE CARDS ***
Dealt to jcarlos.vale [5c 4h]
VitalikX77: raises 560 to 960
schlier4: folds 
mjmj1971: folds 
GunDolfAA: folds 
Oliver N76: folds 
No Brakes357: folds 
jcarlos.vale: folds 
Ka4eBHuK 777: folds 
matalaha: folds 
Uncalled bet (560) returned to VitalikX77
VitalikX77 collected 1225 from pot
*** SUMMARY ***
Total pot 1225 | Rake 0 
Seat 1: Ka4eBHuK 777 (small blind) folded before Flop
Seat 2: matalaha (big blind) folded before Flop
Seat 3: VitalikX77 collected (1225)
Seat 4: schlier4 folded before Flop (didn't bet)
Seat 5: mjmj1971 folded before Flop (didn't bet)
Seat 6: GunDolfAA folded before Flop (didn't bet)
Seat 7: Oliver N76 folded before Flop (didn't bet)
Seat 8: No Brakes357 folded before Flop (didn't bet)
Seat 9: jcarlos.vale (button) folded before Flop (didn't bet)



PokerStars Hand #208299508169: Tournament #2779056951, $0.49+$0.06 USD Hold'em No Limit - Level XII (200/400) - 2020/01/18 23:11:04 EET [2020/01/18 16:11:04 ET]
Table '2779056951 40' 9-max Seat #1 is the button
Seat 1: Ka4eBHuK 777 (1322 in chips) is sitting out
Seat 2: matalaha (7589 in chips) 
Seat 3: VitalikX77 (8448 in chips) 
Seat 4: schlier4 (12705 in chips) 
Seat 5: mjmj1971 (9667 in chips) 
Seat 6: GunDolfAA (7142 in chips) 
Seat 7: Oliver N76 (15991 in chips) 
Seat 8: No Brakes357 (7208 in chips) 
Seat 9: jcarlos.vale (18373 in chips) 
Ka4eBHuK 777: posts the ante 25
matalaha: posts the ante 25
VitalikX77: posts the ante 25
schlier4: posts the ante 25
mjmj1971: posts the ante 25
GunDolfAA: posts the ante 25
Oliver N76: posts the ante 25
No Brakes357: posts the ante 25
jcarlos.vale: posts the ante 25
matalaha: posts small blind 200
VitalikX77: posts big blind 400
*** HOLE CARDS ***
Dealt to jcarlos.vale [4d Th]
schlier4: folds 
mjmj1971: folds 
GunDolfAA: folds 
Oliver N76: folds 
No Brakes357: calls 400
jcarlos.vale: folds 
Ka4eBHuK 777: folds 
matalaha: calls 200
VitalikX77: checks 
*** FLOP *** [Ks 5c 3c]
matalaha: checks 
VitalikX77: bets 428
No Brakes357: calls 428
matalaha: folds 
*** TURN *** [Ks 5c 3c] [4c]
VitalikX77: checks 
No Brakes357: bets 1600
VitalikX77: folds 
Uncalled bet (1600) returned to No Brakes357
No Brakes357 collected 2281 from pot
No Brakes357: doesn't show handDTO
*** SUMMARY ***
Total pot 2281 | Rake 0 
Board [Ks 5c 3c 4c]
Seat 1: Ka4eBHuK 777 (button) folded before Flop (didn't bet)
Seat 2: matalaha (small blind) folded on the Flop
Seat 3: VitalikX77 (big blind) folded on the Turn
Seat 4: schlier4 folded before Flop (didn't bet)
Seat 5: mjmj1971 folded before Flop (didn't bet)
Seat 6: GunDolfAA folded before Flop (didn't bet)
Seat 7: Oliver N76 folded before Flop (didn't bet)
Seat 8: No Brakes357 collected (2281)
Seat 9: jcarlos.vale folded before Flop (didn't bet)



PokerStars Hand #208299541602: Tournament #2779056951, $0.49+$0.06 USD Hold'em No Limit - Level XII (200/400) - 2020/01/18 23:11:58 EET [2020/01/18 16:11:58 ET]
Table '2779056951 40' 9-max Seat #2 is the button
Seat 1: Ka4eBHuK 777 (1297 in chips) is sitting out
Seat 2: matalaha (7164 in chips) 
Seat 3: VitalikX77 (7595 in chips) 
Seat 4: schlier4 (12680 in chips) 
Seat 5: mjmj1971 (9642 in chips) 
Seat 6: GunDolfAA (7117 in chips) 
Seat 7: Oliver N76 (15966 in chips) 
Seat 8: No Brakes357 (8636 in chips) 
Seat 9: jcarlos.vale (18348 in chips) 
Ka4eBHuK 777: posts the ante 25
matalaha: posts the ante 25
VitalikX77: posts the ante 25
schlier4: posts the ante 25
mjmj1971: posts the ante 25
GunDolfAA: posts the ante 25
Oliver N76: posts the ante 25
No Brakes357: posts the ante 25
jcarlos.vale: posts the ante 25
VitalikX77: posts small blind 200
schlier4: posts big blind 400
*** HOLE CARDS ***
Dealt to jcarlos.vale [5d 4h]
mjmj1971: folds 
GunDolfAA: folds 
Oliver N76: folds 
No Brakes357: calls 400
jcarlos.vale: folds 
Ka4eBHuK 777: folds 
matalaha: folds 
VitalikX77: raises 7170 to 7570 and is all-in
schlier4: folds 
No Brakes357: folds 
Uncalled bet (7170) returned to VitalikX77
VitalikX77 collected 1425 from pot
*** SUMMARY ***
Total pot 1425 | Rake 0 
Seat 1: Ka4eBHuK 777 folded before Flop (didn't bet)
Seat 2: matalaha (button) folded before Flop (didn't bet)
Seat 3: VitalikX77 (small blind) collected (1425)
Seat 4: schlier4 (big blind) folded before Flop
Seat 5: mjmj1971 folded before Flop (didn't bet)
Seat 6: GunDolfAA folded before Flop (didn't bet)
Seat 7: Oliver N76 folded before Flop (didn't bet)
Seat 8: No Brakes357 folded before Flop
Seat 9: jcarlos.vale folded before Flop (didn't bet)



PokerStars Hand #208299561983: Tournament #2779056951, $0.49+$0.06 USD Hold'em No Limit - Level XII (200/400) - 2020/01/18 23:12:31 EET [2020/01/18 16:12:31 ET]
Table '2779056951 40' 9-max Seat #3 is the button
Seat 1: Ka4eBHuK 777 (1272 in chips) is sitting out
Seat 2: matalaha (7139 in chips) 
Seat 3: VitalikX77 (8595 in chips) 
Seat 4: schlier4 (12255 in chips) 
Seat 5: mjmj1971 (9617 in chips) 
Seat 6: GunDolfAA (7092 in chips) 
Seat 7: Oliver N76 (15941 in chips) 
Seat 8: No Brakes357 (8211 in chips) 
Seat 9: jcarlos.vale (18323 in chips) 
Ka4eBHuK 777: posts the ante 25
matalaha: posts the ante 25
VitalikX77: posts the ante 25
schlier4: posts the ante 25
mjmj1971: posts the ante 25
GunDolfAA: posts the ante 25
Oliver N76: posts the ante 25
No Brakes357: posts the ante 25
jcarlos.vale: posts the ante 25
schlier4: posts small blind 200
mjmj1971: posts big blind 400
*** HOLE CARDS ***
Dealt to jcarlos.vale [Kh 2d]
GunDolfAA: calls 400
Oliver N76: folds 
No Brakes357: folds 
jcarlos.vale: folds 
Ka4eBHuK 777: folds 
matalaha: folds 
VitalikX77: raises 8170 to 8570 and is all-in
schlier4: folds 
mjmj1971: folds 
GunDolfAA: calls 6667 and is all-in
Uncalled bet (1503) returned to VitalikX77
*** FLOP *** [Qc 2h Ac]
*** TURN *** [Qc 2h Ac] [8c]
*** RIVER *** [Qc 2h Ac 8c] [8h]
*** SHOW DOWN ***
GunDolfAA: shows [3s 3d] (two pair, Eights and Threes)
VitalikX77: shows [Qs As] (two pair, Aces and Queens)
VitalikX77 collected 14959 from pot
GunDolfAA finished the tournament in 883rd place
*** SUMMARY ***
Total pot 14959 | Rake 0 
Board [Qc 2h Ac 8c 8h]
Seat 1: Ka4eBHuK 777 folded before Flop (didn't bet)
Seat 2: matalaha folded before Flop (didn't bet)
Seat 3: VitalikX77 (button) showed [Qs As] and won (14959) with two pair, Aces and Queens
Seat 4: schlier4 (small blind) folded before Flop
Seat 5: mjmj1971 (big blind) folded before Flop
Seat 6: GunDolfAA showed [3s 3d] and lost with two pair, Eights and Threes
Seat 7: Oliver N76 folded before Flop (didn't bet)
Seat 8: No Brakes357 folded before Flop (didn't bet)
Seat 9: jcarlos.vale folded before Flop (didn't bet)



PokerStars Hand #208299620259: Tournament #2779056951, $0.49+$0.06 USD Hold'em No Limit - Level XII (200/400) - 2020/01/18 23:13:57 EET [2020/01/18 16:13:57 ET]
Table '2779056951 123' 9-max Seat #6 is the button
Seat 1: jcarlos.vale (18298 in chips) 
Seat 2: scottcraig (4200 in chips) 
Seat 3: eniksenik (8394 in chips) 
Seat 4: Parodave (16217 in chips) 
Seat 5: coyote710 (2279 in chips) 
Seat 6: paul 196481 (18015 in chips) 
Seat 7: adri_nik (11205 in chips) 
Seat 8: Kril82 (10554 in chips) 
Seat 9: lallelyk'lig (13679 in chips) is sitting out
jcarlos.vale: posts the ante 25
scottcraig: posts the ante 25
eniksenik: posts the ante 25
Parodave: posts the ante 25
coyote710: posts the ante 25
paul 196481: posts the ante 25
adri_nik: posts the ante 25
Kril82: posts the ante 25
lallelyk'lig: posts the ante 25
adri_nik: posts small blind 200
Kril82: posts big blind 400
*** HOLE CARDS ***
Dealt to jcarlos.vale [2d 3d]
lallelyk'lig: folds 
jcarlos.vale: folds 
scottcraig: folds 
eniksenik: folds 
Parodave: raises 400 to 800
coyote710: folds 
paul 196481: folds 
adri_nik: calls 600
Kril82: folds 
*** FLOP *** [4h 8s 8c]
adri_nik: checks 
Parodave: checks 
*** TURN *** [4h 8s 8c] [Ac]
adri_nik: checks 
Parodave: bets 800
adri_nik: folds 
Uncalled bet (800) returned to Parodave
Parodave collected 2225 from pot
*** SUMMARY ***
Total pot 2225 | Rake 0 
Board [4h 8s 8c Ac]
Seat 1: jcarlos.vale folded before Flop (didn't bet)
Seat 2: scottcraig folded before Flop (didn't bet)
Seat 3: eniksenik folded before Flop (didn't bet)
Seat 4: Parodave collected (2225)
Seat 5: coyote710 folded before Flop (didn't bet)
Seat 6: paul 196481 (button) folded before Flop (didn't bet)
Seat 7: adri_nik (small blind) folded on the Turn
Seat 8: Kril82 (big blind) folded before Flop
Seat 9: lallelyk'lig folded before Flop (didn't bet)



PokerStars Hand #208299640160: Tournament #2779056951, $0.49+$0.06 USD Hold'em No Limit - Level XII (200/400) - 2020/01/18 23:14:29 EET [2020/01/18 16:14:29 ET]
Table '2779056951 123' 9-max Seat #7 is the button
Seat 1: jcarlos.vale (18273 in chips) 
Seat 2: scottcraig (4175 in chips) 
Seat 3: eniksenik (8369 in chips) 
Seat 4: Parodave (17617 in chips) 
Seat 5: coyote710 (2254 in chips) 
Seat 6: paul 196481 (17990 in chips) 
Seat 7: adri_nik (10380 in chips) 
Seat 8: Kril82 (10129 in chips) 
Seat 9: lallelyk'lig (13654 in chips) is sitting out
jcarlos.vale: posts the ante 25
scottcraig: posts the ante 25
eniksenik: posts the ante 25
Parodave: posts the ante 25
coyote710: posts the ante 25
paul 196481: posts the ante 25
adri_nik: posts the ante 25
Kril82: posts the ante 25
lallelyk'lig: posts the ante 25
Kril82: posts small blind 200
lallelyk'lig: posts big blind 400
*** HOLE CARDS ***
Dealt to jcarlos.vale [Th 9c]
jcarlos.vale: folds 
scottcraig: raises 3750 to 4150 and is all-in
eniksenik: folds 
Parodave: folds 
coyote710: folds 
paul 196481: folds 
adri_nik: folds 
Kril82: folds 
lallelyk'lig: folds 
Uncalled bet (3750) returned to scottcraig
scottcraig collected 1225 from pot
scottcraig: doesn't show handDTO
*** SUMMARY ***
Total pot 1225 | Rake 0 
Seat 1: jcarlos.vale folded before Flop (didn't bet)
Seat 2: scottcraig collected (1225)
Seat 3: eniksenik folded before Flop (didn't bet)
Seat 4: Parodave folded before Flop (didn't bet)
Seat 5: coyote710 folded before Flop (didn't bet)
Seat 6: paul 196481 folded before Flop (didn't bet)
Seat 7: adri_nik (button) folded before Flop (didn't bet)
Seat 8: Kril82 (small blind) folded before Flop
Seat 9: lallelyk'lig (big blind) folded before Flop



PokerStars Hand #208299654991: Tournament #2779056951, $0.49+$0.06 USD Hold'em No Limit - Level XIII (250/500) - 2020/01/18 23:14:53 EET [2020/01/18 16:14:53 ET]
Table '2779056951 123' 9-max Seat #8 is the button
Seat 1: jcarlos.vale (18248 in chips) 
Seat 2: scottcraig (4975 in chips) 
Seat 3: eniksenik (8344 in chips) 
Seat 4: Parodave (17592 in chips) 
Seat 5: coyote710 (2229 in chips) 
Seat 6: paul 196481 (17965 in chips) 
Seat 7: adri_nik (10355 in chips) 
Seat 8: Kril82 (9904 in chips) 
Seat 9: lallelyk'lig (13229 in chips) is sitting out
jcarlos.vale: posts the ante 30
scottcraig: posts the ante 30
eniksenik: posts the ante 30
Parodave: posts the ante 30
coyote710: posts the ante 30
paul 196481: posts the ante 30
adri_nik: posts the ante 30
Kril82: posts the ante 30
lallelyk'lig: posts the ante 30
lallelyk'lig: posts small blind 250
jcarlos.vale: posts big blind 500
*** HOLE CARDS ***
Dealt to jcarlos.vale [6c Tc]
scottcraig: folds 
eniksenik: folds 
Parodave: folds 
coyote710: folds 
paul 196481: calls 500
adri_nik: folds 
Kril82: folds 
lallelyk'lig: folds 
jcarlos.vale: checks 
*** FLOP *** [Qs Ts Js]
jcarlos.vale: bets 500
paul 196481: calls 500
*** TURN *** [Qs Ts Js] [8s]
jcarlos.vale: checks 
paul 196481: bets 500
jcarlos.vale: folds 
Uncalled bet (500) returned to paul 196481
paul 196481 collected 2520 from pot
paul 196481: doesn't show handDTO
*** SUMMARY ***
Total pot 2520 | Rake 0 
Board [Qs Ts Js 8s]
Seat 1: jcarlos.vale (big blind) folded on the Turn
Seat 2: scottcraig folded before Flop (didn't bet)
Seat 3: eniksenik folded before Flop (didn't bet)
Seat 4: Parodave folded before Flop (didn't bet)
Seat 5: coyote710 folded before Flop (didn't bet)
Seat 6: paul 196481 collected (2520)
Seat 7: adri_nik folded before Flop (didn't bet)
Seat 8: Kril82 (button) folded before Flop (didn't bet)
Seat 9: lallelyk'lig (small blind) folded before Flop



PokerStars Hand #208299676763: Tournament #2779056951, $0.49+$0.06 USD Hold'em No Limit - Level XIII (250/500) - 2020/01/18 23:15:27 EET [2020/01/18 16:15:27 ET]
Table '2779056951 123' 9-max Seat #9 is the button
Seat 1: jcarlos.vale (17218 in chips) 
Seat 2: scottcraig (4945 in chips) 
Seat 3: eniksenik (8314 in chips) 
Seat 4: Parodave (17562 in chips) 
Seat 5: coyote710 (2199 in chips) 
Seat 6: paul 196481 (19455 in chips) 
Seat 7: adri_nik (10325 in chips) 
Seat 8: Kril82 (9874 in chips) 
Seat 9: lallelyk'lig (12949 in chips) is sitting out
jcarlos.vale: posts the ante 30
scottcraig: posts the ante 30
eniksenik: posts the ante 30
Parodave: posts the ante 30
coyote710: posts the ante 30
paul 196481: posts the ante 30
adri_nik: posts the ante 30
Kril82: posts the ante 30
lallelyk'lig: posts the ante 30
jcarlos.vale: posts small blind 250
scottcraig: posts big blind 500
*** HOLE CARDS ***
Dealt to jcarlos.vale [5s 4d]
eniksenik: folds 
Parodave: folds 
coyote710: folds 
paul 196481: calls 500
adri_nik: folds 
Kril82: calls 500
lallelyk'lig: folds 
jcarlos.vale: calls 250
scottcraig: checks 
*** FLOP *** [8h 7d 7h]
jcarlos.vale: checks 
scottcraig: checks 
paul 196481: bets 500
Kril82: calls 500
jcarlos.vale: folds 
scottcraig: calls 500
*** TURN *** [8h 7d 7h] [Kc]
scottcraig: checks 
paul 196481: bets 500
Kril82: raises 1250 to 1750
scottcraig: raises 2165 to 3915 and is all-in
paul 196481: folds 
Kril82: calls 2165
*** RIVER *** [8h 7d 7h Kc] [6d]
*** SHOW DOWN ***
scottcraig: shows [3d 7c] (three of a kind, Sevens)
Kril82: shows [Kd 8d] (two pair, Kings and Eights)
scottcraig collected 12100 from pot
*** SUMMARY ***
Total pot 12100 | Rake 0 
Board [8h 7d 7h Kc 6d]
Seat 1: jcarlos.vale (small blind) folded on the Flop
Seat 2: scottcraig (big blind) showed [3d 7c] and won (12100) with three of a kind, Sevens
Seat 3: eniksenik folded before Flop (didn't bet)
Seat 4: Parodave folded before Flop (didn't bet)
Seat 5: coyote710 folded before Flop (didn't bet)
Seat 6: paul 196481 folded on the Turn
Seat 7: adri_nik folded before Flop (didn't bet)
Seat 8: Kril82 showed [Kd 8d] and lost with two pair, Kings and Eights
Seat 9: lallelyk'lig (button) folded before Flop (didn't bet)



PokerStars Hand #208299720929: Tournament #2779056951, $0.49+$0.06 USD Hold'em No Limit - Level XIII (250/500) - 2020/01/18 23:16:37 EET [2020/01/18 16:16:37 ET]
Table '2779056951 123' 9-max Seat #1 is the button
Seat 1: jcarlos.vale (16688 in chips) 
Seat 2: scottcraig (12100 in chips) 
Seat 3: eniksenik (8284 in chips) 
Seat 4: Parodave (17532 in chips) 
Seat 5: coyote710 (2169 in chips) 
Seat 6: paul 196481 (17925 in chips) 
Seat 7: adri_nik (10295 in chips) 
Seat 8: Kril82 (4929 in chips) 
Seat 9: lallelyk'lig (12919 in chips) is sitting out
jcarlos.vale: posts the ante 30
scottcraig: posts the ante 30
eniksenik: posts the ante 30
Parodave: posts the ante 30
coyote710: posts the ante 30
paul 196481: posts the ante 30
adri_nik: posts the ante 30
Kril82: posts the ante 30
lallelyk'lig: posts the ante 30
scottcraig: posts small blind 250
eniksenik: posts big blind 500
*** HOLE CARDS ***
Dealt to jcarlos.vale [4h 8h]
Parodave: folds 
coyote710: folds 
paul 196481: folds 
adri_nik: calls 500
Kril82: calls 500
lallelyk'lig: folds 
jcarlos.vale: folds 
scottcraig: calls 250
eniksenik: checks 
*** FLOP *** [8s 3h 4c]
scottcraig: checks 
eniksenik: checks 
adri_nik: checks 
Kril82: checks 
*** TURN *** [8s 3h 4c] [Jd]
scottcraig: checks 
eniksenik: checks 
adri_nik: checks 
Kril82: checks 
*** RIVER *** [8s 3h 4c Jd] [Ac]
scottcraig: checks 
eniksenik: bets 1500
adri_nik: folds 
Kril82: raises 1500 to 3000
scottcraig: folds 
eniksenik: folds 
Uncalled bet (1500) returned to Kril82
Kril82 collected 5270 from pot
Kril82: doesn't show handDTO
*** SUMMARY ***
Total pot 5270 | Rake 0 
Board [8s 3h 4c Jd Ac]
Seat 1: jcarlos.vale (button) folded before Flop (didn't bet)
Seat 2: scottcraig (small blind) folded on the River
Seat 3: eniksenik (big blind) folded on the River
Seat 4: Parodave folded before Flop (didn't bet)
Seat 5: coyote710 folded before Flop (didn't bet)
Seat 6: paul 196481 folded before Flop (didn't bet)
Seat 7: adri_nik folded on the River
Seat 8: Kril82 collected (5270)
Seat 9: lallelyk'lig folded before Flop (didn't bet)



PokerStars Hand #208299765878: Tournament #2779056951, $0.49+$0.06 USD Hold'em No Limit - Level XIII (250/500) - 2020/01/18 23:17:48 EET [2020/01/18 16:17:48 ET]
Table '2779056951 123' 9-max Seat #2 is the button
Seat 1: jcarlos.vale (16658 in chips) 
Seat 2: scottcraig (11570 in chips) 
Seat 3: eniksenik (6254 in chips) 
Seat 4: Parodave (17502 in chips) 
Seat 5: coyote710 (2139 in chips) 
Seat 6: paul 196481 (17895 in chips) 
Seat 7: adri_nik (9765 in chips) 
Seat 8: Kril82 (8169 in chips) 
Seat 9: lallelyk'lig (12889 in chips) is sitting out
jcarlos.vale: posts the ante 30
scottcraig: posts the ante 30
eniksenik: posts the ante 30
Parodave: posts the ante 30
coyote710: posts the ante 30
paul 196481: posts the ante 30
adri_nik: posts the ante 30
Kril82: posts the ante 30
lallelyk'lig: posts the ante 30
eniksenik: posts small blind 250
Parodave: posts big blind 500
*** HOLE CARDS ***
Dealt to jcarlos.vale [Ks As]
coyote710: folds 
paul 196481: folds 
adri_nik: folds 
Kril82: folds 
lallelyk'lig: folds 
jcarlos.vale: raises 750 to 1250
scottcraig: folds 
eniksenik: folds 
Parodave: calls 750
*** FLOP *** [3c 3d Jh]
Parodave: checks 
jcarlos.vale: checks 
*** TURN *** [3c 3d Jh] [8d]
Parodave: checks 
jcarlos.vale: checks 
*** RIVER *** [3c 3d Jh 8d] [4c]
Parodave: checks 
jcarlos.vale: checks 
*** SHOW DOWN ***
Parodave: shows [Qc Ah] (a pair of Threes)
jcarlos.vale: shows [Ks As] (a pair of Threes - Ace+King kicker)
jcarlos.vale collected 3020 from pot
*** SUMMARY ***
Total pot 3020 | Rake 0 
Board [3c 3d Jh 8d 4c]
Seat 1: jcarlos.vale showed [Ks As] and won (3020) with a pair of Threes
Seat 2: scottcraig (button) folded before Flop (didn't bet)
Seat 3: eniksenik (small blind) folded before Flop
Seat 4: Parodave (big blind) showed [Qc Ah] and lost with a pair of Threes
Seat 5: coyote710 folded before Flop (didn't bet)
Seat 6: paul 196481 folded before Flop (didn't bet)
Seat 7: adri_nik folded before Flop (didn't bet)
Seat 8: Kril82 folded before Flop (didn't bet)
Seat 9: lallelyk'lig folded before Flop (didn't bet)



PokerStars Hand #208299809926: Tournament #2779056951, $0.49+$0.06 USD Hold'em No Limit - Level XIII (250/500) - 2020/01/18 23:18:57 EET [2020/01/18 16:18:57 ET]
Table '2779056951 123' 9-max Seat #3 is the button
Seat 1: jcarlos.vale (18398 in chips) 
Seat 2: scottcraig (11540 in chips) 
Seat 3: eniksenik (5974 in chips) 
Seat 4: Parodave (16222 in chips) 
Seat 5: coyote710 (2109 in chips) 
Seat 6: paul 196481 (17865 in chips) 
Seat 7: adri_nik (9735 in chips) 
Seat 8: Kril82 (8139 in chips) 
Seat 9: lallelyk'lig (12859 in chips) is sitting out
jcarlos.vale: posts the ante 30
scottcraig: posts the ante 30
eniksenik: posts the ante 30
Parodave: posts the ante 30
coyote710: posts the ante 30
paul 196481: posts the ante 30
adri_nik: posts the ante 30
Kril82: posts the ante 30
lallelyk'lig: posts the ante 30
Parodave: posts small blind 250
coyote710: posts big blind 500
*** HOLE CARDS ***
Dealt to jcarlos.vale [8c 3h]
paul 196481: calls 500
adri_nik: folds 
Kril82: folds 
lallelyk'lig: folds 
jcarlos.vale: folds 
scottcraig: folds 
eniksenik: calls 500
Parodave: folds 
coyote710: checks 
*** FLOP *** [6s 7d Th]
coyote710: checks 
paul 196481: bets 500
eniksenik: folds 
coyote710: calls 500
*** TURN *** [6s 7d Th] [3s]
coyote710: checks 
paul 196481: bets 500
coyote710: raises 579 to 1079 and is all-in
paul 196481: calls 579
*** RIVER *** [6s 7d Th 3s] [Qh]
*** SHOW DOWN ***
coyote710: shows [8h 9h] (a straight, Six to Ten)
paul 196481: shows [6c 7c] (two pair, Sevens and Sixes)
coyote710 collected 5178 from pot
*** SUMMARY ***
Total pot 5178 | Rake 0 
Board [6s 7d Th 3s Qh]
Seat 1: jcarlos.vale folded before Flop (didn't bet)
Seat 2: scottcraig folded before Flop (didn't bet)
Seat 3: eniksenik (button) folded on the Flop
Seat 4: Parodave (small blind) folded before Flop
Seat 5: coyote710 (big blind) showed [8h 9h] and won (5178) with a straight, Six to Ten
Seat 6: paul 196481 showed [6c 7c] and lost with two pair, Sevens and Sixes
Seat 7: adri_nik folded before Flop (didn't bet)
Seat 8: Kril82 folded before Flop (didn't bet)
Seat 9: lallelyk'lig folded before Flop (didn't bet)



PokerStars Hand #208299843362: Tournament #2779056951, $0.49+$0.06 USD Hold'em No Limit - Level XIII (250/500) - 2020/01/18 23:19:50 EET [2020/01/18 16:19:50 ET]
Table '2779056951 123' 9-max Seat #4 is the button
Seat 1: jcarlos.vale (18368 in chips) 
Seat 2: scottcraig (11510 in chips) 
Seat 3: eniksenik (5444 in chips) 
Seat 4: Parodave (15942 in chips) 
Seat 5: coyote710 (5178 in chips) 
Seat 6: paul 196481 (15756 in chips) 
Seat 7: adri_nik (9705 in chips) 
Seat 8: Kril82 (8109 in chips) 
Seat 9: lallelyk'lig (12829 in chips) is sitting out
jcarlos.vale: posts the ante 30
scottcraig: posts the ante 30
eniksenik: posts the ante 30
Parodave: posts the ante 30
coyote710: posts the ante 30
paul 196481: posts the ante 30
adri_nik: posts the ante 30
Kril82: posts the ante 30
lallelyk'lig: posts the ante 30
coyote710: posts small blind 250
paul 196481: posts big blind 500
*** HOLE CARDS ***
Dealt to jcarlos.vale [2c 8h]
adri_nik: folds 
Kril82: raises 7579 to 8079 and is all-in
lallelyk'lig: folds 
jcarlos.vale: folds 
scottcraig: folds 
eniksenik: folds 
Parodave: folds 
coyote710: folds 
paul 196481: folds 
Uncalled bet (7579) returned to Kril82
Kril82 collected 1520 from pot
Kril82: doesn't show handDTO
*** SUMMARY ***
Total pot 1520 | Rake 0 
Seat 1: jcarlos.vale folded before Flop (didn't bet)
Seat 2: scottcraig folded before Flop (didn't bet)
Seat 3: eniksenik folded before Flop (didn't bet)
Seat 4: Parodave (button) folded before Flop (didn't bet)
Seat 5: coyote710 (small blind) folded before Flop
Seat 6: paul 196481 (big blind) folded before Flop
Seat 7: adri_nik folded before Flop (didn't bet)
Seat 8: Kril82 collected (1520)
Seat 9: lallelyk'lig folded before Flop (didn't bet)



PokerStars Hand #208299858029: Tournament #2779056951, $0.49+$0.06 USD Hold'em No Limit - Level XIII (250/500) - 2020/01/18 23:20:13 EET [2020/01/18 16:20:13 ET]
Table '2779056951 123' 9-max Seat #5 is the button
Seat 1: jcarlos.vale (18338 in chips) 
Seat 2: scottcraig (11480 in chips) 
Seat 3: eniksenik (5414 in chips) 
Seat 4: Parodave (15912 in chips) 
Seat 5: coyote710 (4898 in chips) 
Seat 6: paul 196481 (15226 in chips) 
Seat 7: adri_nik (9675 in chips) 
Seat 8: Kril82 (9099 in chips) 
Seat 9: lallelyk'lig (12799 in chips) is sitting out
jcarlos.vale: posts the ante 30
scottcraig: posts the ante 30
eniksenik: posts the ante 30
Parodave: posts the ante 30
coyote710: posts the ante 30
paul 196481: posts the ante 30
adri_nik: posts the ante 30
Kril82: posts the ante 30
lallelyk'lig: posts the ante 30
paul 196481: posts small blind 250
adri_nik: posts big blind 500
*** HOLE CARDS ***
Dealt to jcarlos.vale [8s 2s]
Kril82: folds 
lallelyk'lig: folds 
jcarlos.vale: folds 
scottcraig: folds 
lallelyk'lig has returned
eniksenik: folds 
Parodave: folds 
coyote710: folds 
paul 196481: calls 250
adri_nik: checks 
*** FLOP *** [2c 2d 8d]
paul 196481: checks 
adri_nik: checks 
*** TURN *** [2c 2d 8d] [Tc]
paul 196481: checks 
adri_nik: checks 
*** RIVER *** [2c 2d 8d Tc] [Ad]
paul 196481: bets 500
adri_nik: folds 
Uncalled bet (500) returned to paul 196481
paul 196481 collected 1270 from pot
paul 196481: doesn't show handDTO
*** SUMMARY ***
Total pot 1270 | Rake 0 
Board [2c 2d 8d Tc Ad]
Seat 1: jcarlos.vale folded before Flop (didn't bet)
Seat 2: scottcraig folded before Flop (didn't bet)
Seat 3: eniksenik folded before Flop (didn't bet)
Seat 4: Parodave folded before Flop (didn't bet)
Seat 5: coyote710 (button) folded before Flop (didn't bet)
Seat 6: paul 196481 (small blind) collected (1270)
Seat 7: adri_nik (big blind) folded on the River
Seat 8: Kril82 folded before Flop (didn't bet)
Seat 9: lallelyk'lig folded before Flop (didn't bet)



PokerStars Hand #208299891049: Tournament #2779056951, $0.49+$0.06 USD Hold'em No Limit - Level XIII (250/500) - 2020/01/18 23:20:55 EET [2020/01/18 16:20:55 ET]
Table '2779056951 123' 9-max Seat #6 is the button
Seat 1: jcarlos.vale (18308 in chips) 
Seat 2: scottcraig (11450 in chips) 
Seat 3: eniksenik (5384 in chips) 
Seat 4: Parodave (15882 in chips) 
Seat 5: coyote710 (4868 in chips) 
Seat 6: paul 196481 (15966 in chips) 
Seat 7: adri_nik (9145 in chips) 
Seat 8: Kril82 (9069 in chips) 
Seat 9: lallelyk'lig (12769 in chips) 
jcarlos.vale: posts the ante 30
scottcraig: posts the ante 30
eniksenik: posts the ante 30
Parodave: posts the ante 30
coyote710: posts the ante 30
paul 196481: posts the ante 30
adri_nik: posts the ante 30
Kril82: posts the ante 30
lallelyk'lig: posts the ante 30
adri_nik: posts small blind 250
Kril82: posts big blind 500
*** HOLE CARDS ***
Dealt to jcarlos.vale [9h 2h]
lallelyk'lig: raises 1000 to 1500
jcarlos.vale: folds 
scottcraig: folds 
eniksenik: folds 
Parodave: folds 
coyote710: folds 
paul 196481: raises 4020 to 5520
adri_nik: folds 
Kril82: folds 
lallelyk'lig: folds 
Uncalled bet (4020) returned to paul 196481
paul 196481 collected 4020 from pot
paul 196481: doesn't show handDTO
*** SUMMARY ***
Total pot 4020 | Rake 0 
Seat 1: jcarlos.vale folded before Flop (didn't bet)
Seat 2: scottcraig folded before Flop (didn't bet)
Seat 3: eniksenik folded before Flop (didn't bet)
Seat 4: Parodave folded before Flop (didn't bet)
Seat 5: coyote710 folded before Flop (didn't bet)
Seat 6: paul 196481 (button) collected (4020)
Seat 7: adri_nik (small blind) folded before Flop
Seat 8: Kril82 (big blind) folded before Flop
Seat 9: lallelyk'lig folded before Flop



PokerStars Hand #208299921211: Tournament #2779056951, $0.49+$0.06 USD Hold'em No Limit - Level XIII (250/500) - 2020/01/18 23:21:43 EET [2020/01/18 16:21:43 ET]
Table '2779056951 123' 9-max Seat #7 is the button
Seat 1: jcarlos.vale (18278 in chips) 
Seat 2: scottcraig (11420 in chips) 
Seat 3: eniksenik (5354 in chips) 
Seat 4: Parodave (15852 in chips) 
Seat 5: coyote710 (4838 in chips) 
Seat 6: paul 196481 (18456 in chips) 
Seat 7: adri_nik (8865 in chips) 
Seat 8: Kril82 (8539 in chips) 
Seat 9: lallelyk'lig (11239 in chips) 
jcarlos.vale: posts the ante 30
scottcraig: posts the ante 30
eniksenik: posts the ante 30
Parodave: posts the ante 30
coyote710: posts the ante 30
paul 196481: posts the ante 30
adri_nik: posts the ante 30
Kril82: posts the ante 30
lallelyk'lig: posts the ante 30
Kril82: posts small blind 250
lallelyk'lig: posts big blind 500
*** HOLE CARDS ***
Dealt to jcarlos.vale [9s 3c]
jcarlos.vale: folds 
scottcraig: folds 
eniksenik: folds 
Parodave: folds 
coyote710: raises 750 to 1250
paul 196481: folds 
adri_nik: folds 
Kril82: raises 7259 to 8509 and is all-in
lallelyk'lig: folds 
coyote710: folds 
Uncalled bet (7259) returned to Kril82
Kril82 collected 3270 from pot
Kril82: doesn't show handDTO
*** SUMMARY ***
Total pot 3270 | Rake 0 
Seat 1: jcarlos.vale folded before Flop (didn't bet)
Seat 2: scottcraig folded before Flop (didn't bet)
Seat 3: eniksenik folded before Flop (didn't bet)
Seat 4: Parodave folded before Flop (didn't bet)
Seat 5: coyote710 folded before Flop
Seat 6: paul 196481 folded before Flop (didn't bet)
Seat 7: adri_nik (button) folded before Flop (didn't bet)
Seat 8: Kril82 (small blind) collected (3270)
Seat 9: lallelyk'lig (big blind) folded before Flop



PokerStars Hand #208299949773: Tournament #2779056951, $0.49+$0.06 USD Hold'em No Limit - Level XIII (250/500) - 2020/01/18 23:22:28 EET [2020/01/18 16:22:28 ET]
Table '2779056951 123' 9-max Seat #8 is the button
Seat 1: jcarlos.vale (18248 in chips) 
Seat 2: scottcraig (11390 in chips) 
Seat 3: eniksenik (5324 in chips) 
Seat 4: Parodave (15822 in chips) 
Seat 5: coyote710 (3558 in chips) 
Seat 6: paul 196481 (18426 in chips) 
Seat 7: adri_nik (8835 in chips) 
Seat 8: Kril82 (10529 in chips) 
Seat 9: lallelyk'lig (10709 in chips) 
jcarlos.vale: posts the ante 30
scottcraig: posts the ante 30
eniksenik: posts the ante 30
Parodave: posts the ante 30
coyote710: posts the ante 30
paul 196481: posts the ante 30
adri_nik: posts the ante 30
Kril82: posts the ante 30
lallelyk'lig: posts the ante 30
lallelyk'lig: posts small blind 250
jcarlos.vale: posts big blind 500
*** HOLE CARDS ***
Dealt to jcarlos.vale [Ah 8h]
scottcraig: folds 
eniksenik: folds 
Parodave: folds 
coyote710: folds 
paul 196481: folds 
adri_nik: folds 
Kril82: folds 
lallelyk'lig: calls 250
jcarlos.vale: checks 
*** FLOP *** [2d 7c 6d]
lallelyk'lig: bets 1270
jcarlos.vale: folds 
Uncalled bet (1270) returned to lallelyk'lig
lallelyk'lig collected 1270 from pot
lallelyk'lig: doesn't show handDTO
*** SUMMARY ***
Total pot 1270 | Rake 0 
Board [2d 7c 6d]
Seat 1: jcarlos.vale (big blind) folded on the Flop
Seat 2: scottcraig folded before Flop (didn't bet)
Seat 3: eniksenik folded before Flop (didn't bet)
Seat 4: Parodave folded before Flop (didn't bet)
Seat 5: coyote710 folded before Flop (didn't bet)
Seat 6: paul 196481 folded before Flop (didn't bet)
Seat 7: adri_nik folded before Flop (didn't bet)
Seat 8: Kril82 (button) folded before Flop (didn't bet)
Seat 9: lallelyk'lig (small blind) collected (1270)



PokerStars Hand #208299987074: Tournament #2779056951, $0.49+$0.06 USD Hold'em No Limit - Level XIII (250/500) - 2020/01/18 23:23:27 EET [2020/01/18 16:23:27 ET]
Table '2779056951 123' 9-max Seat #9 is the button
Seat 1: jcarlos.vale (17718 in chips) 
Seat 2: scottcraig (11360 in chips) 
Seat 3: eniksenik (5294 in chips) 
Seat 4: Parodave (15792 in chips) 
Seat 5: coyote710 (3528 in chips) 
Seat 6: paul 196481 (18396 in chips) 
Seat 7: adri_nik (8805 in chips) 
Seat 8: Kril82 (10499 in chips) 
Seat 9: lallelyk'lig (11449 in chips) 
jcarlos.vale: posts the ante 30
scottcraig: posts the ante 30
eniksenik: posts the ante 30
Parodave: posts the ante 30
coyote710: posts the ante 30
paul 196481: posts the ante 30
adri_nik: posts the ante 30
Kril82: posts the ante 30
lallelyk'lig: posts the ante 30
jcarlos.vale: posts small blind 250
scottcraig: posts big blind 500
*** HOLE CARDS ***
Dealt to jcarlos.vale [Qc Ad]
eniksenik: folds 
Parodave: raises 500 to 1000
coyote710: folds 
paul 196481: folds 
adri_nik: folds 
Kril82: folds 
lallelyk'lig: folds 
jcarlos.vale: calls 750
scottcraig: calls 500
*** FLOP *** [Qs Tc Th]
jcarlos.vale: bets 1635
scottcraig: folds 
Parodave: folds 
Uncalled bet (1635) returned to jcarlos.vale
jcarlos.vale collected 3270 from pot
jcarlos.vale: doesn't show handDTO
*** SUMMARY ***
Total pot 3270 | Rake 0 
Board [Qs Tc Th]
Seat 1: jcarlos.vale (small blind) collected (3270)
Seat 2: scottcraig (big blind) folded on the Flop
Seat 3: eniksenik folded before Flop (didn't bet)
Seat 4: Parodave folded on the Flop
Seat 5: coyote710 folded before Flop (didn't bet)
Seat 6: paul 196481 folded before Flop (didn't bet)
Seat 7: adri_nik folded before Flop (didn't bet)
Seat 8: Kril82 folded before Flop (didn't bet)
Seat 9: lallelyk'lig (button) folded before Flop (didn't bet)



PokerStars Hand #208300012638: Tournament #2779056951, $0.49+$0.06 USD Hold'em No Limit - Level XIII (250/500) - 2020/01/18 23:24:08 EET [2020/01/18 16:24:08 ET]
Table '2779056951 123' 9-max Seat #1 is the button
Seat 1: jcarlos.vale (19958 in chips) 
Seat 2: scottcraig (10330 in chips) 
Seat 3: eniksenik (5264 in chips) 
Seat 4: Parodave (14762 in chips) 
Seat 5: coyote710 (3498 in chips) 
Seat 6: paul 196481 (18366 in chips) 
Seat 7: adri_nik (8775 in chips) 
Seat 8: Kril82 (10469 in chips) 
Seat 9: lallelyk'lig (11419 in chips) 
jcarlos.vale: posts the ante 30
scottcraig: posts the ante 30
eniksenik: posts the ante 30
Parodave: posts the ante 30
coyote710: posts the ante 30
paul 196481: posts the ante 30
adri_nik: posts the ante 30
Kril82: posts the ante 30
lallelyk'lig: posts the ante 30
scottcraig: posts small blind 250
eniksenik: posts big blind 500
*** HOLE CARDS ***
Dealt to jcarlos.vale [5c As]
Parodave: folds 
coyote710: folds 
paul 196481: calls 500
adri_nik: folds 
Kril82: folds 
lallelyk'lig: raises 1000 to 1500
jcarlos.vale: folds 
scottcraig: folds 
eniksenik: folds 
paul 196481: calls 1000
*** FLOP *** [Kc Tc 7s]
paul 196481: checks 
lallelyk'lig: checks 
*** TURN *** [Kc Tc 7s] [Ad]
paul 196481: bets 500
lallelyk'lig: raises 1000 to 1500
paul 196481: calls 1000
*** RIVER *** [Kc Tc 7s Ad] [9d]
paul 196481: bets 500
lallelyk'lig: raises 1000 to 1500
paul 196481: calls 1000
*** SHOW DOWN ***
lallelyk'lig: shows [7c 7h] (three of a kind, Sevens)
paul 196481: mucks handDTO
lallelyk'lig collected 10020 from pot
*** SUMMARY ***
Total pot 10020 | Rake 0 
Board [Kc Tc 7s Ad 9d]
Seat 1: jcarlos.vale (button) folded before Flop (didn't bet)
Seat 2: scottcraig (small blind) folded before Flop
Seat 3: eniksenik (big blind) folded before Flop
Seat 4: Parodave folded before Flop (didn't bet)
Seat 5: coyote710 folded before Flop (didn't bet)
Seat 6: paul 196481 mucked [Kd 3d]
Seat 7: adri_nik folded before Flop (didn't bet)
Seat 8: Kril82 folded before Flop (didn't bet)
Seat 9: lallelyk'lig showed [7c 7h] and won (10020) with three of a kind, Sevens



PokerStars Hand #208300041145: Tournament #2779056951, $0.49+$0.06 USD Hold'em No Limit - Level XIV (300/600) - 2020/01/18 23:24:53 EET [2020/01/18 16:24:53 ET]
Table '2779056951 123' 9-max Seat #2 is the button
Seat 1: jcarlos.vale (19928 in chips) 
Seat 2: scottcraig (10050 in chips) 
Seat 3: eniksenik (4734 in chips) 
Seat 4: Parodave (14732 in chips) 
Seat 5: coyote710 (3468 in chips) 
Seat 6: paul 196481 (13836 in chips) 
Seat 7: adri_nik (8745 in chips) 
Seat 8: Kril82 (10439 in chips) 
Seat 9: lallelyk'lig (16909 in chips) 
jcarlos.vale: posts the ante 40
scottcraig: posts the ante 40
eniksenik: posts the ante 40
Parodave: posts the ante 40
coyote710: posts the ante 40
paul 196481: posts the ante 40
adri_nik: posts the ante 40
Kril82: posts the ante 40
lallelyk'lig: posts the ante 40
eniksenik: posts small blind 300
Parodave: posts big blind 600
*** HOLE CARDS ***
Dealt to jcarlos.vale [5c Qs]
coyote710: raises 900 to 1500
paul 196481: folds 
adri_nik: folds 
Kril82: folds 
lallelyk'lig: folds 
jcarlos.vale: folds 
scottcraig: folds 
eniksenik: folds 
Parodave: folds 
Uncalled bet (900) returned to coyote710
coyote710 collected 1860 from pot
coyote710: doesn't show handDTO
*** SUMMARY ***
Total pot 1860 | Rake 0 
Seat 1: jcarlos.vale folded before Flop (didn't bet)
Seat 2: scottcraig (button) folded before Flop (didn't bet)
Seat 3: eniksenik (small blind) folded before Flop
Seat 4: Parodave (big blind) folded before Flop
Seat 5: coyote710 collected (1860)
Seat 6: paul 196481 folded before Flop (didn't bet)
Seat 7: adri_nik folded before Flop (didn't bet)
Seat 8: Kril82 folded before Flop (didn't bet)
Seat 9: lallelyk'lig folded before Flop (didn't bet)



PokerStars Hand #208300056677: Tournament #2779056951, $0.49+$0.06 USD Hold'em No Limit - Level XIV (300/600) - 2020/01/18 23:25:18 EET [2020/01/18 16:25:18 ET]
Table '2779056951 123' 9-max Seat #3 is the button
Seat 1: jcarlos.vale (19888 in chips) 
Seat 2: scottcraig (10010 in chips) 
Seat 3: eniksenik (4394 in chips) 
Seat 4: Parodave (14092 in chips) 
Seat 5: coyote710 (4688 in chips) 
Seat 6: paul 196481 (13796 in chips) 
Seat 7: adri_nik (8705 in chips) 
Seat 8: Kril82 (10399 in chips) 
Seat 9: lallelyk'lig (16869 in chips) 
jcarlos.vale: posts the ante 40
scottcraig: posts the ante 40
eniksenik: posts the ante 40
Parodave: posts the ante 40
coyote710: posts the ante 40
paul 196481: posts the ante 40
adri_nik: posts the ante 40
Kril82: posts the ante 40
lallelyk'lig: posts the ante 40
Parodave: posts small blind 300
coyote710: posts big blind 600
*** HOLE CARDS ***
Dealt to jcarlos.vale [Qs Jc]
paul 196481: calls 600
adri_nik: folds 
Kril82: folds 
lallelyk'lig: calls 600
jcarlos.vale: calls 600
scottcraig: folds 
eniksenik: folds 
Parodave: folds 
coyote710: checks 
*** FLOP *** [Kd 6c As]
coyote710: checks 
paul 196481: checks 
lallelyk'lig: checks 
jcarlos.vale: checks 
*** TURN *** [Kd 6c As] [6d]
coyote710: checks 
paul 196481: checks 
lallelyk'lig: checks 
jcarlos.vale: checks 
*** RIVER *** [Kd 6c As 6d] [Kc]
coyote710: checks 
paul 196481: checks 
lallelyk'lig: checks 
jcarlos.vale: checks 
*** SHOW DOWN ***
coyote710: shows [5c 2c] (two pair, Kings and Sixes)
paul 196481: shows [8s 9s] (two pair, Kings and Sixes)
lallelyk'lig: shows [Qh 9d] (two pair, Kings and Sixes)
jcarlos.vale: shows [Qs Jc] (two pair, Kings and Sixes)
coyote710 collected 765 from pot
paul 196481 collected 765 from pot
lallelyk'lig collected 765 from pot
jcarlos.vale collected 765 from pot
*** SUMMARY ***
Total pot 3060 | Rake 0 
Board [Kd 6c As 6d Kc]
Seat 1: jcarlos.vale showed [Qs Jc] and won (765) with two pair, Kings and Sixes
Seat 2: scottcraig folded before Flop (didn't bet)
Seat 3: eniksenik (button) folded before Flop (didn't bet)
Seat 4: Parodave (small blind) folded before Flop
Seat 5: coyote710 (big blind) showed [5c 2c] and won (765) with two pair, Kings and Sixes
Seat 6: paul 196481 showed [8s 9s] and won (765) with two pair, Kings and Sixes
Seat 7: adri_nik folded before Flop (didn't bet)
Seat 8: Kril82 folded before Flop (didn't bet)
Seat 9: lallelyk'lig showed [Qh 9d] and won (765) with two pair, Kings and Sixes



PokerStars Hand #208300094983: Tournament #2779056951, $0.49+$0.06 USD Hold'em No Limit - Level XIV (300/600) - 2020/01/18 23:26:19 EET [2020/01/18 16:26:19 ET]
Table '2779056951 123' 9-max Seat #4 is the button
Seat 1: jcarlos.vale (20013 in chips) 
Seat 2: scottcraig (9970 in chips) 
Seat 3: eniksenik (4354 in chips) 
Seat 4: Parodave (13752 in chips) 
Seat 5: coyote710 (4813 in chips) 
Seat 6: paul 196481 (13921 in chips) 
Seat 7: adri_nik (8665 in chips) 
Seat 8: Kril82 (10359 in chips) 
Seat 9: lallelyk'lig (16994 in chips) 
jcarlos.vale: posts the ante 40
scottcraig: posts the ante 40
eniksenik: posts the ante 40
Parodave: posts the ante 40
coyote710: posts the ante 40
paul 196481: posts the ante 40
adri_nik: posts the ante 40
Kril82: posts the ante 40
lallelyk'lig: posts the ante 40
coyote710: posts small blind 300
paul 196481: posts big blind 600
*** HOLE CARDS ***
Dealt to jcarlos.vale [5c Ah]
adri_nik: calls 600
Kril82: folds 
lallelyk'lig: folds 
jcarlos.vale: folds 
scottcraig: folds 
eniksenik: folds 
Parodave: folds 
coyote710: folds 
paul 196481: checks 
*** FLOP *** [As 8s Ks]
paul 196481: bets 600
adri_nik: calls 600
*** TURN *** [As 8s Ks] [6h]
paul 196481: bets 1200
adri_nik: calls 1200
*** RIVER *** [As 8s Ks 6h] [4c]
paul 196481: bets 3000
adri_nik: folds 
Uncalled bet (3000) returned to paul 196481
paul 196481 collected 5460 from pot
paul 196481: doesn't show handDTO
*** SUMMARY ***
Total pot 5460 | Rake 0 
Board [As 8s Ks 6h 4c]
Seat 1: jcarlos.vale folded before Flop (didn't bet)
Seat 2: scottcraig folded before Flop (didn't bet)
Seat 3: eniksenik folded before Flop (didn't bet)
Seat 4: Parodave (button) folded before Flop (didn't bet)
Seat 5: coyote710 (small blind) folded before Flop
Seat 6: paul 196481 (big blind) collected (5460)
Seat 7: adri_nik folded on the River
Seat 8: Kril82 folded before Flop (didn't bet)
Seat 9: lallelyk'lig folded before Flop (didn't bet)



PokerStars Hand #208300130684: Tournament #2779056951, $0.49+$0.06 USD Hold'em No Limit - Level XIV (300/600) - 2020/01/18 23:27:15 EET [2020/01/18 16:27:15 ET]
Table '2779056951 123' 9-max Seat #5 is the button
Seat 1: jcarlos.vale (19973 in chips) 
Seat 2: scottcraig (9930 in chips) 
Seat 3: eniksenik (4314 in chips) 
Seat 4: Parodave (13712 in chips) 
Seat 5: coyote710 (4473 in chips) 
Seat 6: paul 196481 (16941 in chips) 
Seat 7: adri_nik (6225 in chips) 
Seat 8: Kril82 (10319 in chips) 
Seat 9: lallelyk'lig (16954 in chips) 
jcarlos.vale: posts the ante 40
scottcraig: posts the ante 40
eniksenik: posts the ante 40
Parodave: posts the ante 40
coyote710: posts the ante 40
paul 196481: posts the ante 40
adri_nik: posts the ante 40
Kril82: posts the ante 40
lallelyk'lig: posts the ante 40
paul 196481: posts small blind 300
adri_nik: posts big blind 600
*** HOLE CARDS ***
Dealt to jcarlos.vale [5c 3d]
Kril82: folds 
lallelyk'lig: raises 1200 to 1800
jcarlos.vale: folds 
scottcraig: folds 
eniksenik: folds 
Parodave: folds 
coyote710: folds 
paul 196481: folds 
adri_nik: raises 4385 to 6185 and is all-in
lallelyk'lig: calls 4385
*** FLOP *** [7s 2c 6h]
*** TURN *** [7s 2c 6h] [4s]
*** RIVER *** [7s 2c 6h 4s] [4h]
*** SHOW DOWN ***
adri_nik: shows [9d 9s] (two pair, Nines and Fours)
lallelyk'lig: shows [As Jc] (a pair of Fours)
adri_nik collected 13030 from pot
*** SUMMARY ***
Total pot 13030 | Rake 0 
Board [7s 2c 6h 4s 4h]
Seat 1: jcarlos.vale folded before Flop (didn't bet)
Seat 2: scottcraig folded before Flop (didn't bet)
Seat 3: eniksenik folded before Flop (didn't bet)
Seat 4: Parodave folded before Flop (didn't bet)
Seat 5: coyote710 (button) folded before Flop (didn't bet)
Seat 6: paul 196481 (small blind) folded before Flop
Seat 7: adri_nik (big blind) showed [9d 9s] and won (13030) with two pair, Nines and Fours
Seat 8: Kril82 folded before Flop (didn't bet)
Seat 9: lallelyk'lig showed [As Jc] and lost with a pair of Fours



PokerStars Hand #208300150421: Tournament #2779056951, $0.49+$0.06 USD Hold'em No Limit - Level XIV (300/600) - 2020/01/18 23:27:47 EET [2020/01/18 16:27:47 ET]
Table '2779056951 123' 9-max Seat #6 is the button
Seat 1: jcarlos.vale (19933 in chips) 
Seat 2: scottcraig (9890 in chips) 
Seat 3: eniksenik (4274 in chips) 
Seat 4: Parodave (13672 in chips) 
Seat 5: coyote710 (4433 in chips) 
Seat 6: paul 196481 (16601 in chips) 
Seat 7: adri_nik (13030 in chips) 
Seat 8: Kril82 (10279 in chips) 
Seat 9: lallelyk'lig (10729 in chips) 
jcarlos.vale: posts the ante 40
scottcraig: posts the ante 40
eniksenik: posts the ante 40
Parodave: posts the ante 40
coyote710: posts the ante 40
paul 196481: posts the ante 40
adri_nik: posts the ante 40
Kril82: posts the ante 40
lallelyk'lig: posts the ante 40
adri_nik: posts small blind 300
Kril82: posts big blind 600
*** HOLE CARDS ***
Dealt to jcarlos.vale [6c 3s]
lallelyk'lig: folds 
jcarlos.vale: folds 
scottcraig: calls 600
eniksenik: folds 
Parodave: folds 
coyote710: folds 
paul 196481: folds 
adri_nik: calls 300
Kril82: checks 
*** FLOP *** [8s Kd 6s]
adri_nik: checks 
Kril82: checks 
scottcraig: bets 1200
adri_nik: calls 1200
Kril82: folds 
*** TURN *** [8s Kd 6s] [5c]
adri_nik: checks 
scottcraig: checks 
*** RIVER *** [8s Kd 6s 5c] [Ks]
adri_nik: bets 2400
scottcraig: folds 
Uncalled bet (2400) returned to adri_nik
adri_nik collected 4560 from pot
adri_nik: doesn't show handDTO
*** SUMMARY ***
Total pot 4560 | Rake 0 
Board [8s Kd 6s 5c Ks]
Seat 1: jcarlos.vale folded before Flop (didn't bet)
Seat 2: scottcraig folded on the River
Seat 3: eniksenik folded before Flop (didn't bet)
Seat 4: Parodave folded before Flop (didn't bet)
Seat 5: coyote710 folded before Flop (didn't bet)
Seat 6: paul 196481 (button) folded before Flop (didn't bet)
Seat 7: adri_nik (small blind) collected (4560)
Seat 8: Kril82 (big blind) folded on the Flop
Seat 9: lallelyk'lig folded before Flop (didn't bet)



PokerStars Hand #208300192320: Tournament #2779056951, $0.49+$0.06 USD Hold'em No Limit - Level XIV (300/600) - 2020/01/18 23:28:41 EET [2020/01/18 16:28:41 ET]
Table '2779056951 123' 9-max Seat #7 is the button
Seat 1: jcarlos.vale (19893 in chips) 
Seat 2: scottcraig (8050 in chips) 
Seat 3: eniksenik (4234 in chips) 
Seat 4: Parodave (13632 in chips) 
Seat 5: coyote710 (4393 in chips) 
Seat 6: paul 196481 (16561 in chips) 
Seat 7: adri_nik (15750 in chips) 
Seat 8: Kril82 (9639 in chips) 
Seat 9: lallelyk'lig (10689 in chips) 
jcarlos.vale: posts the ante 40
scottcraig: posts the ante 40
eniksenik: posts the ante 40
Parodave: posts the ante 40
coyote710: posts the ante 40
paul 196481: posts the ante 40
adri_nik: posts the ante 40
Kril82: posts the ante 40
lallelyk'lig: posts the ante 40
Kril82: posts small blind 300
lallelyk'lig: posts big blind 600
*** HOLE CARDS ***
Dealt to jcarlos.vale [6h 9h]
jcarlos.vale: folds 
scottcraig: raises 7410 to 8010 and is all-in
eniksenik: folds 
Parodave: folds 
coyote710: folds 
paul 196481: folds 
adri_nik: folds 
Kril82: folds 
lallelyk'lig: folds 
Uncalled bet (7410) returned to scottcraig
scottcraig collected 1860 from pot
*** SUMMARY ***
Total pot 1860 | Rake 0 
Seat 1: jcarlos.vale folded before Flop (didn't bet)
Seat 2: scottcraig collected (1860)
Seat 3: eniksenik folded before Flop (didn't bet)
Seat 4: Parodave folded before Flop (didn't bet)
Seat 5: coyote710 folded before Flop (didn't bet)
Seat 6: paul 196481 folded before Flop (didn't bet)
Seat 7: adri_nik (button) folded before Flop (didn't bet)
Seat 8: Kril82 (small blind) folded before Flop
Seat 9: lallelyk'lig (big blind) folded before Flop



PokerStars Hand #208300209529: Tournament #2779056951, $0.49+$0.06 USD Hold'em No Limit - Level XIV (300/600) - 2020/01/18 23:29:08 EET [2020/01/18 16:29:08 ET]
Table '2779056951 123' 9-max Seat #8 is the button
Seat 1: jcarlos.vale (19853 in chips) 
Seat 2: scottcraig (9270 in chips) 
Seat 3: eniksenik (4194 in chips) 
Seat 4: Parodave (13592 in chips) 
Seat 5: coyote710 (4353 in chips) 
Seat 6: paul 196481 (16521 in chips) 
Seat 7: adri_nik (15710 in chips) 
Seat 8: Kril82 (9299 in chips) 
Seat 9: lallelyk'lig (10049 in chips) 
jcarlos.vale: posts the ante 40
scottcraig: posts the ante 40
eniksenik: posts the ante 40
Parodave: posts the ante 40
coyote710: posts the ante 40
paul 196481: posts the ante 40
adri_nik: posts the ante 40
Kril82: posts the ante 40
lallelyk'lig: posts the ante 40
lallelyk'lig: posts small blind 300
jcarlos.vale: posts big blind 600
*** HOLE CARDS ***
Dealt to jcarlos.vale [8h Th]
scottcraig: folds 
eniksenik: raises 3554 to 4154 and is all-in
Parodave: folds 
coyote710: folds 
paul 196481: folds 
adri_nik: folds 
Kril82: folds 
lallelyk'lig has timed out
lallelyk'lig: folds 
lallelyk'lig is sitting out
jcarlos.vale: folds 
Uncalled bet (3554) returned to eniksenik
eniksenik collected 1860 from pot
eniksenik: doesn't show handDTO
*** SUMMARY ***
Total pot 1860 | Rake 0 
Seat 1: jcarlos.vale (big blind) folded before Flop
Seat 2: scottcraig folded before Flop (didn't bet)
Seat 3: eniksenik collected (1860)
Seat 4: Parodave folded before Flop (didn't bet)
Seat 5: coyote710 folded before Flop (didn't bet)
Seat 6: paul 196481 folded before Flop (didn't bet)
Seat 7: adri_nik folded before Flop (didn't bet)
Seat 8: Kril82 (button) folded before Flop (didn't bet)
Seat 9: lallelyk'lig (small blind) folded before Flop



PokerStars Hand #208300238703: Tournament #2779056951, $0.49+$0.06 USD Hold'em No Limit - Level XIV (300/600) - 2020/01/18 23:29:54 EET [2020/01/18 16:29:54 ET]
Table '2779056951 123' 9-max Seat #9 is the button
Seat 1: jcarlos.vale (19213 in chips) 
Seat 2: scottcraig (9230 in chips) 
Seat 3: eniksenik (5414 in chips) 
Seat 4: Parodave (13552 in chips) 
Seat 5: coyote710 (4313 in chips) 
Seat 6: paul 196481 (16481 in chips) 
Seat 7: adri_nik (15670 in chips) 
Seat 8: Kril82 (9259 in chips) 
Seat 9: lallelyk'lig (9709 in chips) is sitting out
jcarlos.vale: posts the ante 40
scottcraig: posts the ante 40
eniksenik: posts the ante 40
Parodave: posts the ante 40
coyote710: posts the ante 40
paul 196481: posts the ante 40
adri_nik: posts the ante 40
Kril82: posts the ante 40
lallelyk'lig: posts the ante 40
jcarlos.vale: posts small blind 300
scottcraig: posts big blind 600
*** HOLE CARDS ***
Dealt to jcarlos.vale [Qs 8c]
eniksenik: folds 
Parodave: folds 
coyote710: folds 
paul 196481: folds 
adri_nik: folds 
Kril82: raises 900 to 1500
lallelyk'lig: folds 
jcarlos.vale: folds 
lallelyk'lig has returned
scottcraig: folds 
Uncalled bet (900) returned to Kril82
Kril82 collected 1860 from pot
Kril82: doesn't show handDTO
*** SUMMARY ***
Total pot 1860 | Rake 0 
Seat 1: jcarlos.vale (small blind) folded before Flop
Seat 2: scottcraig (big blind) folded before Flop
Seat 3: eniksenik folded before Flop (didn't bet)
Seat 4: Parodave folded before Flop (didn't bet)
Seat 5: coyote710 folded before Flop (didn't bet)
Seat 6: paul 196481 folded before Flop (didn't bet)
Seat 7: adri_nik folded before Flop (didn't bet)
Seat 8: Kril82 collected (1860)
Seat 9: lallelyk'lig (button) folded before Flop (didn't bet)



PokerStars Hand #208300255316: Tournament #2779056951, $0.49+$0.06 USD Hold'em No Limit - Level XIV (300/600) - 2020/01/18 23:30:21 EET [2020/01/18 16:30:21 ET]
Table '2779056951 123' 9-max Seat #1 is the button
Seat 1: jcarlos.vale (18873 in chips) 
Seat 2: scottcraig (8590 in chips) 
Seat 3: eniksenik (5374 in chips) 
Seat 4: Parodave (13512 in chips) 
Seat 5: coyote710 (4273 in chips) 
Seat 6: paul 196481 (16441 in chips) 
Seat 7: adri_nik (15630 in chips) 
Seat 8: Kril82 (10479 in chips) 
Seat 9: lallelyk'lig (9669 in chips) 
jcarlos.vale: posts the ante 40
scottcraig: posts the ante 40
eniksenik: posts the ante 40
Parodave: posts the ante 40
coyote710: posts the ante 40
paul 196481: posts the ante 40
adri_nik: posts the ante 40
Kril82: posts the ante 40
lallelyk'lig: posts the ante 40
scottcraig: posts small blind 300
eniksenik: posts big blind 600
*** HOLE CARDS ***
Dealt to jcarlos.vale [9c 7s]
Parodave: folds 
coyote710: raises 3633 to 4233 and is all-in
paul 196481: folds 
adri_nik: folds 
Kril82: folds 
lallelyk'lig: calls 4233
jcarlos.vale: folds 
scottcraig has timed out
scottcraig: folds 
scottcraig is sitting out
eniksenik: folds 
*** FLOP *** [Qs 7c 9d]
*** TURN *** [Qs 7c 9d] [2c]
*** RIVER *** [Qs 7c 9d 2c] [3c]
*** SHOW DOWN ***
coyote710: shows [Qc Qd] (three of a kind, Queens)
lallelyk'lig: shows [Qh Kh] (a pair of Queens)
coyote710 collected 9726 from pot
*** SUMMARY ***
Total pot 9726 | Rake 0 
Board [Qs 7c 9d 2c 3c]
Seat 1: jcarlos.vale (button) folded before Flop (didn't bet)
Seat 2: scottcraig (small blind) folded before Flop
Seat 3: eniksenik (big blind) folded before Flop
Seat 4: Parodave folded before Flop (didn't bet)
Seat 5: coyote710 showed [Qc Qd] and won (9726) with three of a kind, Queens
Seat 6: paul 196481 folded before Flop (didn't bet)
Seat 7: adri_nik folded before Flop (didn't bet)
Seat 8: Kril82 folded before Flop (didn't bet)
Seat 9: lallelyk'lig showed [Qh Kh] and lost with a pair of Queens



PokerStars Hand #208300312305: Tournament #2779056951, $0.49+$0.06 USD Hold'em No Limit - Level XIV (300/600) - 2020/01/18 23:31:52 EET [2020/01/18 16:31:52 ET]
Table '2779056951 123' 9-max Seat #2 is the button
Seat 1: jcarlos.vale (18833 in chips) 
Seat 2: scottcraig (8250 in chips) is sitting out
Seat 3: eniksenik (4734 in chips) 
Seat 4: Parodave (13472 in chips) 
Seat 5: coyote710 (9726 in chips) 
Seat 6: paul 196481 (16401 in chips) 
Seat 7: adri_nik (15590 in chips) 
Seat 8: Kril82 (10439 in chips) 
Seat 9: lallelyk'lig (5396 in chips) 
jcarlos.vale: posts the ante 40
scottcraig: posts the ante 40
eniksenik: posts the ante 40
Parodave: posts the ante 40
coyote710: posts the ante 40
paul 196481: posts the ante 40
adri_nik: posts the ante 40
Kril82: posts the ante 40
lallelyk'lig: posts the ante 40
eniksenik: posts small blind 300
Parodave: posts big blind 600
*** HOLE CARDS ***
Dealt to jcarlos.vale [Jc As]
coyote710: folds 
paul 196481: calls 600
adri_nik: folds 
Kril82: folds 
lallelyk'lig: folds 
jcarlos.vale: raises 660 to 1260
scottcraig: folds 
scottcraig has returned
eniksenik: folds 
Parodave: folds 
paul 196481: calls 660
*** FLOP *** [3c 2h Kc]
paul 196481: checks 
jcarlos.vale: checks 
*** TURN *** [3c 2h Kc] [9d]
paul 196481: checks 
jcarlos.vale: checks 
*** RIVER *** [3c 2h Kc 9d] [Ad]
paul 196481: bets 600
jcarlos.vale: calls 600
*** SHOW DOWN ***
paul 196481: shows [Jd Ts] (high pairOfCards Ace)
jcarlos.vale: shows [Jc As] (a pair of Aces)
jcarlos.vale collected 4980 from pot
*** SUMMARY ***
Total pot 4980 | Rake 0 
Board [3c 2h Kc 9d Ad]
Seat 1: jcarlos.vale showed [Jc As] and won (4980) with a pair of Aces
Seat 2: scottcraig (button) folded before Flop (didn't bet)
Seat 3: eniksenik (small blind) folded before Flop
Seat 4: Parodave (big blind) folded before Flop
Seat 5: coyote710 folded before Flop (didn't bet)
Seat 6: paul 196481 showed [Jd Ts] and lost with high pairOfCards Ace
Seat 7: adri_nik folded before Flop (didn't bet)
Seat 8: Kril82 folded before Flop (didn't bet)
Seat 9: lallelyk'lig folded before Flop (didn't bet)



PokerStars Hand #208300343255: Tournament #2779056951, $0.49+$0.06 USD Hold'em No Limit - Level XIV (300/600) - 2020/01/18 23:32:41 EET [2020/01/18 16:32:41 ET]
Table '2779056951 123' 9-max Seat #3 is the button
Seat 1: jcarlos.vale (21913 in chips) 
Seat 2: scottcraig (8210 in chips) 
Seat 3: eniksenik (4394 in chips) 
Seat 4: Parodave (12832 in chips) 
Seat 5: coyote710 (9686 in chips) 
Seat 6: paul 196481 (14501 in chips) 
Seat 7: adri_nik (15550 in chips) 
Seat 8: Kril82 (10399 in chips) 
Seat 9: lallelyk'lig (5356 in chips) 
jcarlos.vale: posts the ante 40
scottcraig: posts the ante 40
eniksenik: posts the ante 40
Parodave: posts the ante 40
coyote710: posts the ante 40
paul 196481: posts the ante 40
adri_nik: posts the ante 40
Kril82: posts the ante 40
lallelyk'lig: posts the ante 40
Parodave: posts small blind 300
coyote710: posts big blind 600
*** HOLE CARDS ***
Dealt to jcarlos.vale [2s 4d]
paul 196481: raises 600 to 1200
adri_nik: folds 
Kril82: folds 
lallelyk'lig: folds 
jcarlos.vale: folds 
scottcraig is disconnected 
scottcraig has timed out while disconnected
scottcraig: folds 
scottcraig is sitting out
eniksenik: folds 
Parodave: folds 
coyote710: calls 600
*** FLOP *** [Ac Js Qh]
coyote710: checks 
paul 196481: bets 1800
coyote710: raises 6646 to 8446 and is all-in
paul 196481: calls 6646
*** TURN *** [Ac Js Qh] [9d]
*** RIVER *** [Ac Js Qh 9d] [3c]
*** SHOW DOWN ***
coyote710: shows [Ad Qs] (two pair, Aces and Queens)
paul 196481: shows [Th Ts] (a pair of Tens)
coyote710 collected 19952 from pot
*** SUMMARY ***
Total pot 19952 | Rake 0 
Board [Ac Js Qh 9d 3c]
Seat 1: jcarlos.vale folded before Flop (didn't bet)
Seat 2: scottcraig folded before Flop (didn't bet)
Seat 3: eniksenik (button) folded before Flop (didn't bet)
Seat 4: Parodave (small blind) folded before Flop
Seat 5: coyote710 (big blind) showed [Ad Qs] and won (19952) with two pair, Aces and Queens
Seat 6: paul 196481 showed [Th Ts] and lost with a pair of Tens
Seat 7: adri_nik folded before Flop (didn't bet)
Seat 8: Kril82 folded before Flop (didn't bet)
Seat 9: lallelyk'lig folded before Flop (didn't bet)



PokerStars Hand #208300382554: Tournament #2779056951, $0.49+$0.06 USD Hold'em No Limit - Level XIV (300/600) - 2020/01/18 23:33:44 EET [2020/01/18 16:33:44 ET]
Table '2779056951 123' 9-max Seat #4 is the button
Seat 1: jcarlos.vale (21873 in chips) 
Seat 2: scottcraig (8170 in chips) is sitting out
Seat 3: eniksenik (4354 in chips) 
Seat 4: Parodave (12492 in chips) 
Seat 5: coyote710 (19952 in chips) 
Seat 6: paul 196481 (4815 in chips) 
Seat 7: adri_nik (15510 in chips) 
Seat 8: Kril82 (10359 in chips) 
Seat 9: lallelyk'lig (5316 in chips) 
jcarlos.vale: posts the ante 40
scottcraig: posts the ante 40
eniksenik: posts the ante 40
Parodave: posts the ante 40
coyote710: posts the ante 40
paul 196481: posts the ante 40
adri_nik: posts the ante 40
Kril82: posts the ante 40
lallelyk'lig: posts the ante 40
coyote710: posts small blind 300
paul 196481: posts big blind 600
*** HOLE CARDS ***
Dealt to jcarlos.vale [7c 4d]
adri_nik: calls 600
Kril82: folds 
lallelyk'lig: raises 2460 to 3060
jcarlos.vale: folds 
scottcraig: folds 
eniksenik: folds 
Parodave: folds 
coyote710: folds 
paul 196481: raises 1715 to 4775 and is all-in
adri_nik: calls 4175
lallelyk'lig: calls 1715
*** FLOP *** [2s Jh 7h]
adri_nik: checks 
lallelyk'lig: bets 501 and is all-in
adri_nik: calls 501
*** TURN *** [2s Jh 7h] [5s]
*** RIVER *** [2s Jh 7h 5s] [2c]
*** SHOW DOWN ***
adri_nik: shows [Jd Kh] (two pair, Jacks and Deuces)
lallelyk'lig: shows [Qd Qs] (two pair, Queens and Deuces)
lallelyk'lig collected 1002 from side pot
paul 196481: shows [Th Ts] (two pair, Tens and Deuces)
lallelyk'lig collected 14985 from main pot
paul 196481 finished the tournament in 626th place
*** SUMMARY ***
Total pot 15987 Main pot 14985. Side pot 1002. | Rake 0 
Board [2s Jh 7h 5s 2c]
Seat 1: jcarlos.vale folded before Flop (didn't bet)
Seat 2: scottcraig folded before Flop (didn't bet)
Seat 3: eniksenik folded before Flop (didn't bet)
Seat 4: Parodave (button) folded before Flop (didn't bet)
Seat 5: coyote710 (small blind) folded before Flop
Seat 6: paul 196481 (big blind) showed [Th Ts] and lost with two pair, Tens and Deuces
Seat 7: adri_nik showed [Jd Kh] and lost with two pair, Jacks and Deuces
Seat 8: Kril82 folded before Flop (didn't bet)
Seat 9: lallelyk'lig showed [Qd Qs] and won (15987) with two pair, Queens and Deuces



PokerStars Hand #208300406068: Tournament #2779056951, $0.49+$0.06 USD Hold'em No Limit - Level XIV (300/600) - 2020/01/18 23:34:22 EET [2020/01/18 16:34:22 ET]
Table '2779056951 123' 9-max Seat #5 is the button
Seat 1: jcarlos.vale (21833 in chips) 
Seat 2: scottcraig (8130 in chips) is sitting out
Seat 3: eniksenik (4314 in chips) 
Seat 4: Parodave (12452 in chips) 
Seat 5: coyote710 (19612 in chips) 
Seat 7: adri_nik (10194 in chips) 
Seat 8: Kril82 (10319 in chips) 
Seat 9: lallelyk'lig (15987 in chips) 
jcarlos.vale: posts the ante 40
scottcraig: posts the ante 40
eniksenik: posts the ante 40
Parodave: posts the ante 40
coyote710: posts the ante 40
adri_nik: posts the ante 40
Kril82: posts the ante 40
lallelyk'lig: posts the ante 40
adri_nik: posts small blind 300
Kril82: posts big blind 600
*** HOLE CARDS ***
Dealt to jcarlos.vale [8s 8c]
lallelyk'lig: folds 
jcarlos.vale: raises 660 to 1260
scottcraig: folds 
lallelyk'lig is sitting out
eniksenik: folds 
Parodave: folds 
coyote710: calls 1260
adri_nik: folds 
Kril82: folds 
*** FLOP *** [5h Th Ah]
jcarlos.vale: bets 1200
coyote710: calls 1200
*** TURN *** [5h Th Ah] [Kh]
jcarlos.vale: checks 
coyote710: checks 
*** RIVER *** [5h Th Ah Kh] [2c]
jcarlos.vale: checks 
coyote710: checks 
*** SHOW DOWN ***
jcarlos.vale: shows [8s 8c] (a pair of Eights)
coyote710: shows [Ad 5d] (two pair, Aces and Fives)
coyote710 collected 6140 from pot
*** SUMMARY ***
Total pot 6140 | Rake 0 
Board [5h Th Ah Kh 2c]
Seat 1: jcarlos.vale showed [8s 8c] and lost with a pair of Eights
Seat 2: scottcraig folded before Flop (didn't bet)
Seat 3: eniksenik folded before Flop (didn't bet)
Seat 4: Parodave folded before Flop (didn't bet)
Seat 5: coyote710 (button) showed [Ad 5d] and won (6140) with two pair, Aces and Fives
Seat 7: adri_nik (small blind) folded before Flop
Seat 8: Kril82 (big blind) folded before Flop
Seat 9: lallelyk'lig folded before Flop (didn't bet)



PokerStars Hand #208300434179: Tournament #2779056951, $0.49+$0.06 USD Hold'em No Limit - Level XV (350/700) - 2020/01/18 23:35:06 EET [2020/01/18 16:35:06 ET]
Table '2779056951 123' 9-max Seat #7 is the button
Seat 1: jcarlos.vale (19333 in chips) 
Seat 2: scottcraig (8090 in chips) is sitting out
Seat 3: eniksenik (4274 in chips) 
Seat 4: Parodave (12412 in chips) 
Seat 5: coyote710 (23252 in chips) 
Seat 6: guest362 (16954 in chips) 
Seat 7: adri_nik (9854 in chips) 
Seat 8: Kril82 (9679 in chips) 
Seat 9: lallelyk'lig (15947 in chips) is sitting out
jcarlos.vale: posts the ante 50
scottcraig: posts the ante 50
eniksenik: posts the ante 50
Parodave: posts the ante 50
coyote710: posts the ante 50
guest362: posts the ante 50
adri_nik: posts the ante 50
Kril82: posts the ante 50
lallelyk'lig: posts the ante 50
Kril82: posts small blind 350
lallelyk'lig: posts big blind 700
*** HOLE CARDS ***
Dealt to jcarlos.vale [Js 9s]
jcarlos.vale: folds 
scottcraig: folds 
eniksenik: folds 
Parodave: folds 
coyote710: raises 1050 to 1750
guest362: folds 
adri_nik: raises 8054 to 9804 and is all-in
Kril82: folds 
lallelyk'lig: folds 
lallelyk'lig has returned
coyote710: folds 
Uncalled bet (8054) returned to adri_nik
adri_nik collected 5000 from pot
adri_nik: doesn't show handDTO
*** SUMMARY ***
Total pot 5000 | Rake 0 
Seat 1: jcarlos.vale folded before Flop (didn't bet)
Seat 2: scottcraig folded before Flop (didn't bet)
Seat 3: eniksenik folded before Flop (didn't bet)
Seat 4: Parodave folded before Flop (didn't bet)
Seat 5: coyote710 folded before Flop
Seat 6: guest362 folded before Flop (didn't bet)
Seat 7: adri_nik (button) collected (5000)
Seat 8: Kril82 (small blind) folded before Flop
Seat 9: lallelyk'lig (big blind) folded before Flop



PokerStars Hand #208300461650: Tournament #2779056951, $0.49+$0.06 USD Hold'em No Limit - Level XV (350/700) - 2020/01/18 23:35:51 EET [2020/01/18 16:35:51 ET]
Table '2779056951 123' 9-max Seat #8 is the button
Seat 1: jcarlos.vale (19283 in chips) 
Seat 2: scottcraig (8040 in chips) is sitting out
Seat 3: eniksenik (4224 in chips) 
Seat 4: Parodave (12362 in chips) 
Seat 5: coyote710 (21452 in chips) 
Seat 6: guest362 (16904 in chips) 
Seat 7: adri_nik (13054 in chips) 
Seat 8: Kril82 (9279 in chips) 
Seat 9: lallelyk'lig (15197 in chips) 
jcarlos.vale: posts the ante 50
scottcraig: posts the ante 50
eniksenik: posts the ante 50
Parodave: posts the ante 50
coyote710: posts the ante 50
guest362: posts the ante 50
adri_nik: posts the ante 50
Kril82: posts the ante 50
lallelyk'lig: posts the ante 50
lallelyk'lig: posts small blind 350
jcarlos.vale: posts big blind 700
*** HOLE CARDS ***
Dealt to jcarlos.vale [6s Qh]
scottcraig: folds 
eniksenik: folds 
Parodave: folds 
coyote710: folds 
guest362: folds 
adri_nik: folds 
Kril82: raises 8529 to 9229 and is all-in
lallelyk'lig: folds 
jcarlos.vale: folds 
Uncalled bet (8529) returned to Kril82
Kril82 collected 2200 from pot
Kril82: doesn't show handDTO
*** SUMMARY ***
Total pot 2200 | Rake 0 
Seat 1: jcarlos.vale (big blind) folded before Flop
Seat 2: scottcraig folded before Flop (didn't bet)
Seat 3: eniksenik folded before Flop (didn't bet)
Seat 4: Parodave folded before Flop (didn't bet)
Seat 5: coyote710 folded before Flop (didn't bet)
Seat 6: guest362 folded before Flop (didn't bet)
Seat 7: adri_nik folded before Flop (didn't bet)
Seat 8: Kril82 (button) collected (2200)
Seat 9: lallelyk'lig (small blind) folded before Flop



PokerStars Hand #208300478733: Tournament #2779056951, $0.49+$0.06 USD Hold'em No Limit - Level XV (350/700) - 2020/01/18 23:36:18 EET [2020/01/18 16:36:18 ET]
Table '2779056951 123' 9-max Seat #9 is the button
Seat 1: jcarlos.vale (18533 in chips) 
Seat 2: scottcraig (7990 in chips) is sitting out
Seat 3: eniksenik (4174 in chips) 
Seat 4: Parodave (12312 in chips) 
Seat 5: coyote710 (21402 in chips) 
Seat 6: guest362 (16854 in chips) 
Seat 7: adri_nik (13004 in chips) 
Seat 8: Kril82 (10729 in chips) 
Seat 9: lallelyk'lig (14797 in chips) 
jcarlos.vale: posts the ante 50
scottcraig: posts the ante 50
eniksenik: posts the ante 50
Parodave: posts the ante 50
coyote710: posts the ante 50
guest362: posts the ante 50
adri_nik: posts the ante 50
Kril82: posts the ante 50
lallelyk'lig: posts the ante 50
jcarlos.vale: posts small blind 350
scottcraig: posts big blind 700
*** HOLE CARDS ***
Dealt to jcarlos.vale [4c 9c]
eniksenik: folds 
Parodave: folds 
coyote710: folds 
guest362: calls 700
adri_nik: folds 
Kril82: folds 
lallelyk'lig: folds 
jcarlos.vale: calls 350
scottcraig: folds 
*** FLOP *** [4d Jc 2s]
jcarlos.vale: checks 
guest362: checks 
*** TURN *** [4d Jc 2s] [7s]
jcarlos.vale: checks 
guest362: bets 16104 and is all-in
jcarlos.vale: folds 
Uncalled bet (16104) returned to guest362
guest362 collected 2550 from pot
guest362: doesn't show handDTO
*** SUMMARY ***
Total pot 2550 | Rake 0 
Board [4d Jc 2s 7s]
Seat 1: jcarlos.vale (small blind) folded on the Turn
Seat 2: scottcraig (big blind) folded before Flop
Seat 3: eniksenik folded before Flop (didn't bet)
Seat 4: Parodave folded before Flop (didn't bet)
Seat 5: coyote710 folded before Flop (didn't bet)
Seat 6: guest362 collected (2550)
Seat 7: adri_nik folded before Flop (didn't bet)
Seat 8: Kril82 folded before Flop (didn't bet)
Seat 9: lallelyk'lig (button) folded before Flop (didn't bet)



PokerStars Hand #208300503529: Tournament #2779056951, $0.49+$0.06 USD Hold'em No Limit - Level XV (350/700) - 2020/01/18 23:36:58 EET [2020/01/18 16:36:58 ET]
Table '2779056951 123' 9-max Seat #1 is the button
Seat 1: jcarlos.vale (17783 in chips) 
Seat 2: scottcraig (7240 in chips) is sitting out
Seat 3: eniksenik (4124 in chips) 
Seat 4: Parodave (12262 in chips) 
Seat 5: coyote710 (21352 in chips) 
Seat 6: guest362 (18654 in chips) 
Seat 7: adri_nik (12954 in chips) 
Seat 8: Kril82 (10679 in chips) 
Seat 9: lallelyk'lig (14747 in chips) 
jcarlos.vale: posts the ante 50
scottcraig: posts the ante 50
eniksenik: posts the ante 50
Parodave: posts the ante 50
coyote710: posts the ante 50
guest362: posts the ante 50
adri_nik: posts the ante 50
Kril82: posts the ante 50
lallelyk'lig: posts the ante 50
scottcraig: posts small blind 350
eniksenik: posts big blind 700
*** HOLE CARDS ***
Dealt to jcarlos.vale [2h 4c]
Parodave: folds 
coyote710: folds 
guest362: calls 700
adri_nik: folds 
Kril82: folds 
lallelyk'lig: raises 1400 to 2100
jcarlos.vale: folds 
scottcraig: folds 
eniksenik: raises 1974 to 4074 and is all-in
guest362: calls 3374
lallelyk'lig: calls 1974
*** FLOP *** [4h Tc 3d]
guest362: checks 
lallelyk'lig: bets 1400
guest362: calls 1400
*** TURN *** [4h Tc 3d] [2s]
guest362: bets 13130 and is all-in
lallelyk'lig: folds 
Uncalled bet (13130) returned to guest362
*** RIVER *** [4h Tc 3d 2s] [4s]
*** SHOW DOWN ***
guest362: shows [9c Kc] (a pair of Fours)
guest362 collected 2800 from side pot
eniksenik: shows [Kh Qh] (a pair of Fours - King+Queen kicker)
eniksenik collected 13022 from main pot
*** SUMMARY ***
Total pot 15822 Main pot 13022. Side pot 2800. | Rake 0 
Board [4h Tc 3d 2s 4s]
Seat 1: jcarlos.vale (button) folded before Flop (didn't bet)
Seat 2: scottcraig (small blind) folded before Flop
Seat 3: eniksenik (big blind) showed [Kh Qh] and won (13022) with a pair of Fours
Seat 4: Parodave folded before Flop (didn't bet)
Seat 5: coyote710 folded before Flop (didn't bet)
Seat 6: guest362 showed [9c Kc] and won (2800) with a pair of Fours
Seat 7: adri_nik folded before Flop (didn't bet)
Seat 8: Kril82 folded before Flop (didn't bet)
Seat 9: lallelyk'lig folded on the Turn



PokerStars Hand #208300558944: Tournament #2779056951, $0.49+$0.06 USD Hold'em No Limit - Level XV (350/700) - 2020/01/18 23:38:20 EET [2020/01/18 16:38:20 ET]
Table '2779056951 123' 9-max Seat #2 is the button
Seat 1: jcarlos.vale (17733 in chips) 
Seat 2: scottcraig (6840 in chips) is sitting out
Seat 3: eniksenik (13022 in chips) 
Seat 4: Parodave (12212 in chips) 
Seat 5: coyote710 (21302 in chips) 
Seat 6: guest362 (15930 in chips) 
Seat 7: adri_nik (12904 in chips) 
Seat 8: Kril82 (10629 in chips) 
Seat 9: lallelyk'lig (9223 in chips) 
jcarlos.vale: posts the ante 50
scottcraig: posts the ante 50
eniksenik: posts the ante 50
Parodave: posts the ante 50
coyote710: posts the ante 50
guest362: posts the ante 50
adri_nik: posts the ante 50
Kril82: posts the ante 50
lallelyk'lig: posts the ante 50
eniksenik: posts small blind 350
Parodave: posts big blind 700
*** HOLE CARDS ***
Dealt to jcarlos.vale [Jc 4c]
coyote710: folds 
guest362: folds 
adri_nik: folds 
Kril82: folds 
lallelyk'lig: raises 1400 to 2100
jcarlos.vale: folds 
scottcraig: folds 
eniksenik: folds 
Parodave: folds 
Uncalled bet (1400) returned to lallelyk'lig
lallelyk'lig collected 2200 from pot
lallelyk'lig: doesn't show handDTO
*** SUMMARY ***
Total pot 2200 | Rake 0 
Seat 1: jcarlos.vale folded before Flop (didn't bet)
Seat 2: scottcraig (button) folded before Flop (didn't bet)
Seat 3: eniksenik (small blind) folded before Flop
Seat 4: Parodave (big blind) folded before Flop
Seat 5: coyote710 folded before Flop (didn't bet)
Seat 6: guest362 folded before Flop (didn't bet)
Seat 7: adri_nik folded before Flop (didn't bet)
Seat 8: Kril82 folded before Flop (didn't bet)
Seat 9: lallelyk'lig collected (2200)



PokerStars Hand #208300577509: Tournament #2779056951, $0.49+$0.06 USD Hold'em No Limit - Level XV (350/700) - 2020/01/18 23:38:43 EET [2020/01/18 16:38:43 ET]
Table '2779056951 123' 9-max Seat #3 is the button
Seat 1: jcarlos.vale (17683 in chips) 
Seat 2: scottcraig (6790 in chips) is sitting out
Seat 3: eniksenik (12622 in chips) 
Seat 4: Parodave (11462 in chips) 
Seat 5: coyote710 (21252 in chips) 
Seat 6: guest362 (15880 in chips) 
Seat 7: adri_nik (12854 in chips) 
Seat 8: Kril82 (10579 in chips) 
Seat 9: lallelyk'lig (10673 in chips) 
jcarlos.vale: posts the ante 50
scottcraig: posts the ante 50
eniksenik: posts the ante 50
Parodave: posts the ante 50
coyote710: posts the ante 50
guest362: posts the ante 50
adri_nik: posts the ante 50
Kril82: posts the ante 50
lallelyk'lig: posts the ante 50
Parodave: posts small blind 350
coyote710: posts big blind 700
*** HOLE CARDS ***
Dealt to jcarlos.vale [2c Qs]
guest362: folds 
adri_nik: folds 
Kril82: folds 
lallelyk'lig: folds 
jcarlos.vale: folds 
scottcraig: folds 
eniksenik: folds 
Parodave: folds 
Uncalled bet (350) returned to coyote710
coyote710 collected 1150 from pot
coyote710: doesn't show handDTO
*** SUMMARY ***
Total pot 1150 | Rake 0 
Seat 1: jcarlos.vale folded before Flop (didn't bet)
Seat 2: scottcraig folded before Flop (didn't bet)
Seat 3: eniksenik (button) folded before Flop (didn't bet)
Seat 4: Parodave (small blind) folded before Flop
Seat 5: coyote710 (big blind) collected (1150)
Seat 6: guest362 folded before Flop (didn't bet)
Seat 7: adri_nik folded before Flop (didn't bet)
Seat 8: Kril82 folded before Flop (didn't bet)
Seat 9: lallelyk'lig folded before Flop (didn't bet)



PokerStars Hand #208300584936: Tournament #2779056951, $0.49+$0.06 USD Hold'em No Limit - Level XV (350/700) - 2020/01/18 23:38:55 EET [2020/01/18 16:38:55 ET]
Table '2779056951 123' 9-max Seat #4 is the button
Seat 1: jcarlos.vale (17633 in chips) 
Seat 2: scottcraig (6740 in chips) is sitting out
Seat 3: eniksenik (12572 in chips) 
Seat 4: Parodave (11062 in chips) 
Seat 5: coyote710 (22002 in chips) 
Seat 6: guest362 (15830 in chips) 
Seat 7: adri_nik (12804 in chips) 
Seat 8: Kril82 (10529 in chips) 
Seat 9: lallelyk'lig (10623 in chips) 
jcarlos.vale: posts the ante 50
scottcraig: posts the ante 50
eniksenik: posts the ante 50
Parodave: posts the ante 50
coyote710: posts the ante 50
guest362: posts the ante 50
adri_nik: posts the ante 50
Kril82: posts the ante 50
lallelyk'lig: posts the ante 50
coyote710: posts small blind 350
guest362: posts big blind 700
*** HOLE CARDS ***
Dealt to jcarlos.vale [2c Ah]
adri_nik: folds 
Kril82: folds 
lallelyk'lig: folds 
jcarlos.vale: folds 
scottcraig: folds 
eniksenik: folds 
Parodave: folds 
coyote710: folds 
Uncalled bet (350) returned to guest362
guest362 collected 1150 from pot
guest362: doesn't show handDTO
*** SUMMARY ***
Total pot 1150 | Rake 0 
Seat 1: jcarlos.vale folded before Flop (didn't bet)
Seat 2: scottcraig folded before Flop (didn't bet)
Seat 3: eniksenik folded before Flop (didn't bet)
Seat 4: Parodave (button) folded before Flop (didn't bet)
Seat 5: coyote710 (small blind) folded before Flop
Seat 6: guest362 (big blind) collected (1150)
Seat 7: adri_nik folded before Flop (didn't bet)
Seat 8: Kril82 folded before Flop (didn't bet)
Seat 9: lallelyk'lig folded before Flop (didn't bet)



PokerStars Hand #208300605552: Tournament #2779056951, $0.49+$0.06 USD Hold'em No Limit - Level XV (350/700) - 2020/01/18 23:39:29 EET [2020/01/18 16:39:29 ET]
Table '2779056951 123' 9-max Seat #5 is the button
Seat 1: jcarlos.vale (17583 in chips) 
Seat 2: scottcraig (6690 in chips) is sitting out
Seat 3: eniksenik (12522 in chips) 
Seat 4: Parodave (11012 in chips) 
Seat 5: coyote710 (21602 in chips) 
Seat 6: guest362 (16580 in chips) 
Seat 7: adri_nik (12754 in chips) 
Seat 8: Kril82 (10479 in chips) 
Seat 9: lallelyk'lig (10573 in chips) 
jcarlos.vale: posts the ante 50
scottcraig: posts the ante 50
eniksenik: posts the ante 50
Parodave: posts the ante 50
coyote710: posts the ante 50
guest362: posts the ante 50
adri_nik: posts the ante 50
Kril82: posts the ante 50
lallelyk'lig: posts the ante 50
guest362: posts small blind 350
adri_nik: posts big blind 700
*** HOLE CARDS ***
Dealt to jcarlos.vale [Ts 9d]
Kril82: folds 
lallelyk'lig: folds 
jcarlos.vale: folds 
scottcraig: folds 
eniksenik: folds 
Parodave: folds 
coyote710: folds 
guest362: calls 350
adri_nik: checks 
*** FLOP *** [Jd 7d 3h]
guest362: checks 
adri_nik: checks 
*** TURN *** [Jd 7d 3h] [2c]
guest362: checks 
adri_nik: checks 
*** RIVER *** [Jd 7d 3h 2c] [5d]
guest362: bets 700
adri_nik: calls 700
*** SHOW DOWN ***
guest362: shows [7h Qh] (a pair of Sevens)
adri_nik: mucks handDTO
guest362 collected 3250 from pot
*** SUMMARY ***
Total pot 3250 | Rake 0 
Board [Jd 7d 3h 2c 5d]
Seat 1: jcarlos.vale folded before Flop (didn't bet)
Seat 2: scottcraig folded before Flop (didn't bet)
Seat 3: eniksenik folded before Flop (didn't bet)
Seat 4: Parodave folded before Flop (didn't bet)
Seat 5: coyote710 (button) folded before Flop (didn't bet)
Seat 6: guest362 (small blind) showed [7h Qh] and won (3250) with a pair of Sevens
Seat 7: adri_nik (big blind) mucked [5c Tc]
Seat 8: Kril82 folded before Flop (didn't bet)
Seat 9: lallelyk'lig folded before Flop (didn't bet)



PokerStars Hand #208300629202: Tournament #2779056951, $0.49+$0.06 USD Hold'em No Limit - Level XV (350/700) - 2020/01/18 23:40:07 EET [2020/01/18 16:40:07 ET]
Table '2779056951 123' 9-max Seat #6 is the button
Seat 1: jcarlos.vale (17533 in chips) 
Seat 2: scottcraig (6640 in chips) is sitting out
Seat 3: eniksenik (12472 in chips) 
Seat 4: Parodave (10962 in chips) 
Seat 5: coyote710 (21552 in chips) 
Seat 6: guest362 (18380 in chips) 
Seat 7: adri_nik (11304 in chips) 
Seat 8: Kril82 (10429 in chips) 
Seat 9: lallelyk'lig (10523 in chips) 
jcarlos.vale: posts the ante 50
scottcraig: posts the ante 50
eniksenik: posts the ante 50
Parodave: posts the ante 50
coyote710: posts the ante 50
guest362: posts the ante 50
adri_nik: posts the ante 50
Kril82: posts the ante 50
lallelyk'lig: posts the ante 50
adri_nik: posts small blind 350
Kril82: posts big blind 700
*** HOLE CARDS ***
Dealt to jcarlos.vale [Jh 8h]
lallelyk'lig: calls 700
jcarlos.vale: folds 
scottcraig: folds 
eniksenik: folds 
Parodave: folds 
scottcraig has returned
coyote710: folds 
guest362: calls 700
adri_nik: calls 350
Kril82: checks 
*** FLOP *** [7c 9s 2h]
adri_nik: checks 
Kril82: checks 
lallelyk'lig: checks 
guest362: checks 
*** TURN *** [7c 9s 2h] [Jc]
adri_nik: checks 
Kril82: checks 
lallelyk'lig: bets 1625
guest362: raises 16005 to 17630 and is all-in
adri_nik: folds 
Kril82: folds 
lallelyk'lig: calls 8148 and is all-in
Uncalled bet (7857) returned to guest362
*** RIVER *** [7c 9s 2h Jc] [Qs]
*** SHOW DOWN ***
lallelyk'lig: shows [Js Tc] (a pair of Jacks)
guest362: shows [Ac 5c] (high pairOfCards Ace)
lallelyk'lig collected 22796 from pot
*** SUMMARY ***
Total pot 22796 | Rake 0 
Board [7c 9s 2h Jc Qs]
Seat 1: jcarlos.vale folded before Flop (didn't bet)
Seat 2: scottcraig folded before Flop (didn't bet)
Seat 3: eniksenik folded before Flop (didn't bet)
Seat 4: Parodave folded before Flop (didn't bet)
Seat 5: coyote710 folded before Flop (didn't bet)
Seat 6: guest362 (button) showed [Ac 5c] and lost with high pairOfCards Ace
Seat 7: adri_nik (small blind) folded on the Turn
Seat 8: Kril82 (big blind) folded on the Turn
Seat 9: lallelyk'lig showed [Js Tc] and won (22796) with a pair of Jacks



PokerStars Hand #208300686670: Tournament #2779056951, $0.49+$0.06 USD Hold'em No Limit - Level XV (350/700) - 2020/01/18 23:41:41 EET [2020/01/18 16:41:41 ET]
Table '2779056951 123' 9-max Seat #7 is the button
Seat 1: jcarlos.vale (17483 in chips) 
Seat 2: scottcraig (6590 in chips) 
Seat 3: eniksenik (12422 in chips) 
Seat 4: Parodave (10912 in chips) 
Seat 5: coyote710 (21502 in chips) 
Seat 6: guest362 (7857 in chips) 
Seat 7: adri_nik (10554 in chips) 
Seat 8: Kril82 (9679 in chips) 
Seat 9: lallelyk'lig (22796 in chips) 
jcarlos.vale: posts the ante 50
scottcraig: posts the ante 50
eniksenik: posts the ante 50
Parodave: posts the ante 50
coyote710: posts the ante 50
guest362: posts the ante 50
adri_nik: posts the ante 50
Kril82: posts the ante 50
lallelyk'lig: posts the ante 50
Kril82: posts small blind 350
lallelyk'lig: posts big blind 700
*** HOLE CARDS ***
Dealt to jcarlos.vale [Ad Jh]
jcarlos.vale: raises 770 to 1470
scottcraig has timed out
scottcraig: folds 
scottcraig is sitting out
eniksenik: folds 
Parodave: folds 
coyote710: folds 
guest362: calls 1470
adri_nik: folds 
Kril82: folds 
lallelyk'lig: calls 770
*** FLOP *** [Tc 5s 2c]
lallelyk'lig: checks 
jcarlos.vale: checks 
guest362: bets 6337 and is all-in
lallelyk'lig: folds 
jcarlos.vale: folds 
Uncalled bet (6337) returned to guest362
guest362 collected 5210 from pot
guest362: doesn't show handDTO
*** SUMMARY ***
Total pot 5210 | Rake 0 
Board [Tc 5s 2c]
Seat 1: jcarlos.vale folded on the Flop
Seat 2: scottcraig folded before Flop (didn't bet)
Seat 3: eniksenik folded before Flop (didn't bet)
Seat 4: Parodave folded before Flop (didn't bet)
Seat 5: coyote710 folded before Flop (didn't bet)
Seat 6: guest362 collected (5210)
Seat 7: adri_nik (button) folded before Flop (didn't bet)
Seat 8: Kril82 (small blind) folded before Flop
Seat 9: lallelyk'lig (big blind) folded on the Flop



PokerStars Hand #208300732047: Tournament #2779056951, $0.49+$0.06 USD Hold'em No Limit - Level XV (350/700) - 2020/01/18 23:42:55 EET [2020/01/18 16:42:55 ET]
Table '2779056951 123' 9-max Seat #8 is the button
Seat 1: jcarlos.vale (15963 in chips) 
Seat 2: scottcraig (6540 in chips) is sitting out
Seat 3: eniksenik (12372 in chips) 
Seat 4: Parodave (10862 in chips) 
Seat 5: coyote710 (21452 in chips) 
Seat 6: guest362 (11547 in chips) 
Seat 7: adri_nik (10504 in chips) 
Seat 8: Kril82 (9279 in chips) 
Seat 9: lallelyk'lig (21276 in chips) 
jcarlos.vale: posts the ante 50
scottcraig: posts the ante 50
eniksenik: posts the ante 50
Parodave: posts the ante 50
coyote710: posts the ante 50
guest362: posts the ante 50
adri_nik: posts the ante 50
Kril82: posts the ante 50
lallelyk'lig: posts the ante 50
lallelyk'lig: posts small blind 350
jcarlos.vale: posts big blind 700
*** HOLE CARDS ***
Dealt to jcarlos.vale [7s 4s]
scottcraig: folds 
eniksenik: folds 
Parodave: folds 
coyote710: folds 
guest362: folds 
adri_nik: folds 
Kril82: folds 
lallelyk'lig: calls 350
jcarlos.vale: checks 
*** FLOP *** [8d 5c 9c]
lallelyk'lig: checks 
jcarlos.vale: checks 
*** TURN *** [8d 5c 9c] [Ac]
lallelyk'lig: bets 700
jcarlos.vale: folds 
Uncalled bet (700) returned to lallelyk'lig
lallelyk'lig collected 1850 from pot
lallelyk'lig: doesn't show handDTO
*** SUMMARY ***
Total pot 1850 | Rake 0 
Board [8d 5c 9c Ac]
Seat 1: jcarlos.vale (big blind) folded on the Turn
Seat 2: scottcraig folded before Flop (didn't bet)
Seat 3: eniksenik folded before Flop (didn't bet)
Seat 4: Parodave folded before Flop (didn't bet)
Seat 5: coyote710 folded before Flop (didn't bet)
Seat 6: guest362 folded before Flop (didn't bet)
Seat 7: adri_nik folded before Flop (didn't bet)
Seat 8: Kril82 (button) folded before Flop (didn't bet)
Seat 9: lallelyk'lig (small blind) collected (1850)



PokerStars Hand #208300754682: Tournament #2779056951, $0.49+$0.06 USD Hold'em No Limit - Level XV (350/700) - 2020/01/18 23:43:32 EET [2020/01/18 16:43:32 ET]
Table '2779056951 123' 9-max Seat #9 is the button
Seat 1: jcarlos.vale (15213 in chips) 
Seat 2: scottcraig (6490 in chips) is sitting out
Seat 3: eniksenik (12322 in chips) 
Seat 4: Parodave (10812 in chips) 
Seat 5: coyote710 (21402 in chips) 
Seat 6: guest362 (11497 in chips) 
Seat 7: adri_nik (10454 in chips) 
Seat 8: Kril82 (9229 in chips) 
Seat 9: lallelyk'lig (22376 in chips) 
jcarlos.vale: posts the ante 50
scottcraig: posts the ante 50
eniksenik: posts the ante 50
Parodave: posts the ante 50
coyote710: posts the ante 50
guest362: posts the ante 50
adri_nik: posts the ante 50
Kril82: posts the ante 50
lallelyk'lig: posts the ante 50
jcarlos.vale: posts small blind 350
scottcraig: posts big blind 700
*** HOLE CARDS ***
Dealt to jcarlos.vale [3c 4c]
eniksenik: folds 
Parodave: folds 
coyote710: raises 2200 to 2900
guest362: raises 2200 to 5100
adri_nik: folds 
Kril82: folds 
lallelyk'lig: folds 
jcarlos.vale: folds 
scottcraig: folds 
coyote710: raises 16252 to 21352 and is all-in
guest362: calls 6347 and is all-in
Uncalled bet (9905) returned to coyote710
*** FLOP *** [4h Ah 4d]
*** TURN *** [4h Ah 4d] [6c]
*** RIVER *** [4h Ah 4d 6c] [Kh]
*** SHOW DOWN ***
coyote710: shows [Qs Qc] (two pair, Queens and Fours)
guest362: shows [Jc Jh] (two pair, Jacks and Fours)
coyote710 collected 24394 from pot
guest362 finished the tournament in 547th place
*** SUMMARY ***
Total pot 24394 | Rake 0 
Board [4h Ah 4d 6c Kh]
Seat 1: jcarlos.vale (small blind) folded before Flop
Seat 2: scottcraig (big blind) folded before Flop
Seat 3: eniksenik folded before Flop (didn't bet)
Seat 4: Parodave folded before Flop (didn't bet)
Seat 5: coyote710 showed [Qs Qc] and won (24394) with two pair, Queens and Fours
Seat 6: guest362 showed [Jc Jh] and lost with two pair, Jacks and Fours
Seat 7: adri_nik folded before Flop (didn't bet)
Seat 8: Kril82 folded before Flop (didn't bet)
Seat 9: lallelyk'lig (button) folded before Flop (didn't bet)



PokerStars Hand #208300804452: Tournament #2779056951, $0.49+$0.06 USD Hold'em No Limit - Level XVI (400/800) - 2020/01/18 23:44:38 EET [2020/01/18 16:44:38 ET]
Table '2779056951 123' 9-max Seat #1 is the button
Seat 1: jcarlos.vale (14813 in chips) 
Seat 2: scottcraig (5740 in chips) is sitting out
Seat 3: eniksenik (12272 in chips) 
Seat 4: Parodave (10762 in chips) 
Seat 5: coyote710 (34299 in chips) 
Seat 7: adri_nik (10404 in chips) 
Seat 8: Kril82 (9179 in chips) 
Seat 9: lallelyk'lig (22326 in chips) 
jcarlos.vale: posts the ante 65
scottcraig: posts the ante 65
eniksenik: posts the ante 65
Parodave: posts the ante 65
coyote710: posts the ante 65
adri_nik: posts the ante 65
Kril82: posts the ante 65
lallelyk'lig: posts the ante 65
scottcraig: posts small blind 400
eniksenik: posts big blind 800
*** HOLE CARDS ***
Dealt to jcarlos.vale [5c 6c]
Parodave: folds 
coyote710: folds 
adri_nik: folds 
Kril82: raises 800 to 1600
lallelyk'lig: folds 
jcarlos.vale: folds 
scottcraig: folds 
eniksenik: calls 800
*** FLOP *** [2c Js 8h]
eniksenik: checks 
Kril82: bets 2000
eniksenik: folds 
Uncalled bet (2000) returned to Kril82
Kril82 collected 4120 from pot
Kril82: doesn't show handDTO
*** SUMMARY ***
Total pot 4120 | Rake 0 
Board [2c Js 8h]
Seat 1: jcarlos.vale (button) folded before Flop (didn't bet)
Seat 2: scottcraig (small blind) folded before Flop
Seat 3: eniksenik (big blind) folded on the Flop
Seat 4: Parodave folded before Flop (didn't bet)
Seat 5: coyote710 folded before Flop (didn't bet)
Seat 7: adri_nik folded before Flop (didn't bet)
Seat 8: Kril82 collected (4120)
Seat 9: lallelyk'lig folded before Flop (didn't bet)



PokerStars Hand #208300827696: Tournament #2779056951, $0.49+$0.06 USD Hold'em No Limit - Level XVI (400/800) - 2020/01/18 23:45:16 EET [2020/01/18 16:45:16 ET]
Table '2779056951 123' 9-max Seat #2 is the button
Seat 1: jcarlos.vale (14748 in chips) 
Seat 2: scottcraig (5275 in chips) is sitting out
Seat 3: eniksenik (10607 in chips) 
Seat 4: Parodave (10697 in chips) 
Seat 5: coyote710 (34234 in chips) 
Seat 7: adri_nik (10339 in chips) 
Seat 8: Kril82 (11634 in chips) 
Seat 9: lallelyk'lig (22261 in chips) 
jcarlos.vale: posts the ante 65
scottcraig: posts the ante 65
eniksenik: posts the ante 65
Parodave: posts the ante 65
coyote710: posts the ante 65
adri_nik: posts the ante 65
Kril82: posts the ante 65
lallelyk'lig: posts the ante 65
eniksenik: posts small blind 400
Parodave: posts big blind 800
*** HOLE CARDS ***
Dealt to jcarlos.vale [3s Ac]
coyote710: folds 
adri_nik: calls 800
Kril82: folds 
lallelyk'lig: folds 
jcarlos.vale: folds 
scottcraig: folds 
eniksenik: folds 
Parodave: checks 
*** FLOP *** [8h 2s 3c]
Parodave: checks 
adri_nik: bets 1600
Parodave: folds 
Uncalled bet (1600) returned to adri_nik
adri_nik collected 2520 from pot
adri_nik: doesn't show handDTO
*** SUMMARY ***
Total pot 2520 | Rake 0 
Board [8h 2s 3c]
Seat 1: jcarlos.vale folded before Flop (didn't bet)
Seat 2: scottcraig (button) folded before Flop (didn't bet)
Seat 3: eniksenik (small blind) folded before Flop
Seat 4: Parodave (big blind) folded on the Flop
Seat 5: coyote710 folded before Flop (didn't bet)
Seat 7: adri_nik collected (2520)
Seat 8: Kril82 folded before Flop (didn't bet)
Seat 9: lallelyk'lig folded before Flop (didn't bet)



PokerStars Hand #208300865728: Tournament #2779056951, $0.49+$0.06 USD Hold'em No Limit - Level XVI (400/800) - 2020/01/18 23:46:17 EET [2020/01/18 16:46:17 ET]
Table '2779056951 123' 9-max Seat #3 is the button
Seat 1: jcarlos.vale (14683 in chips) 
Seat 2: scottcraig (5210 in chips) is sitting out
Seat 3: eniksenik (10142 in chips) 
Seat 4: Parodave (9832 in chips) 
Seat 5: coyote710 (34169 in chips) 
Seat 7: adri_nik (11994 in chips) 
Seat 8: Kril82 (11569 in chips) 
Seat 9: lallelyk'lig (22196 in chips) 
jcarlos.vale: posts the ante 65
scottcraig: posts the ante 65
eniksenik: posts the ante 65
Parodave: posts the ante 65
coyote710: posts the ante 65
adri_nik: posts the ante 65
Kril82: posts the ante 65
lallelyk'lig: posts the ante 65
Parodave: posts small blind 400
coyote710: posts big blind 800
*** HOLE CARDS ***
Dealt to jcarlos.vale [Kh Jc]
adri_nik: folds 
Kril82: folds 
lallelyk'lig: folds 
scottcraig has returned
jcarlos.vale: raises 880 to 1680
scottcraig: folds 
eniksenik: raises 8397 to 10077 and is all-in
Parodave: folds 
coyote710: folds 
jcarlos.vale: folds 
Uncalled bet (8397) returned to eniksenik
eniksenik collected 5080 from pot
eniksenik: doesn't show handDTO
*** SUMMARY ***
Total pot 5080 | Rake 0 
Seat 1: jcarlos.vale folded before Flop
Seat 2: scottcraig folded before Flop (didn't bet)
Seat 3: eniksenik (button) collected (5080)
Seat 4: Parodave (small blind) folded before Flop
Seat 5: coyote710 (big blind) folded before Flop
Seat 7: adri_nik folded before Flop (didn't bet)
Seat 8: Kril82 folded before Flop (didn't bet)
Seat 9: lallelyk'lig folded before Flop (didn't bet)



PokerStars Hand #208300888790: Tournament #2779056951, $0.49+$0.06 USD Hold'em No Limit - Level XVI (400/800) - 2020/01/18 23:46:55 EET [2020/01/18 16:46:55 ET]
Table '2779056951 123' 9-max Seat #4 is the button
Seat 1: jcarlos.vale (12938 in chips) 
Seat 2: scottcraig (5145 in chips) 
Seat 3: eniksenik (13477 in chips) 
Seat 4: Parodave (9367 in chips) 
Seat 5: coyote710 (33304 in chips) 
Seat 6: xiruspitao (66022 in chips) 
Seat 7: adri_nik (11929 in chips) 
Seat 8: Kril82 (11504 in chips) 
Seat 9: lallelyk'lig (22131 in chips) 
jcarlos.vale: posts the ante 65
scottcraig: posts the ante 65
eniksenik: posts the ante 65
Parodave: posts the ante 65
coyote710: posts the ante 65
xiruspitao: posts the ante 65
adri_nik: posts the ante 65
Kril82: posts the ante 65
lallelyk'lig: posts the ante 65
coyote710: posts small blind 400
xiruspitao: posts big blind 800
*** HOLE CARDS ***
Dealt to jcarlos.vale [6c 9d]
adri_nik: calls 800
Kril82: folds 
lallelyk'lig: folds 
jcarlos.vale: folds 
scottcraig: folds 
eniksenik: folds 
Parodave: folds 
coyote710: folds 
xiruspitao: checks 
*** FLOP *** [5d 8d Ts]
xiruspitao: checks 
adri_nik: checks 
*** TURN *** [5d 8d Ts] [Ks]
xiruspitao: checks 
adri_nik: bets 1600
xiruspitao: folds [3c 6d]
Uncalled bet (1600) returned to adri_nik
adri_nik collected 2585 from pot
adri_nik: doesn't show handDTO
*** SUMMARY ***
Total pot 2585 | Rake 0 
Board [5d 8d Ts Ks]
Seat 1: jcarlos.vale folded before Flop (didn't bet)
Seat 2: scottcraig folded before Flop (didn't bet)
Seat 3: eniksenik folded before Flop (didn't bet)
Seat 4: Parodave (button) folded before Flop (didn't bet)
Seat 5: coyote710 (small blind) folded before Flop
Seat 6: xiruspitao (big blind) folded on the Turn
Seat 7: adri_nik collected (2585)
Seat 8: Kril82 folded before Flop (didn't bet)
Seat 9: lallelyk'lig folded before Flop (didn't bet)



PokerStars Hand #208300924890: Tournament #2779056951, $0.49+$0.06 USD Hold'em No Limit - Level XVI (400/800) - 2020/01/18 23:47:53 EET [2020/01/18 16:47:53 ET]
Table '2779056951 123' 9-max Seat #5 is the button
Seat 1: jcarlos.vale (12873 in chips) 
Seat 2: scottcraig (5080 in chips) 
Seat 3: eniksenik (13412 in chips) 
Seat 4: Parodave (9302 in chips) 
Seat 5: coyote710 (32839 in chips) 
Seat 6: xiruspitao (65157 in chips) 
Seat 7: adri_nik (13649 in chips) 
Seat 8: Kril82 (11439 in chips) 
Seat 9: lallelyk'lig (22066 in chips) 
jcarlos.vale: posts the ante 65
scottcraig: posts the ante 65
eniksenik: posts the ante 65
Parodave: posts the ante 65
coyote710: posts the ante 65
xiruspitao: posts the ante 65
adri_nik: posts the ante 65
Kril82: posts the ante 65
lallelyk'lig: posts the ante 65
xiruspitao: posts small blind 400
adri_nik: posts big blind 800
*** HOLE CARDS ***
Dealt to jcarlos.vale [6s Ah]
Kril82: folds 
lallelyk'lig is connected 
lallelyk'lig has timed out
lallelyk'lig: folds 
lallelyk'lig is sitting out
jcarlos.vale: folds 
scottcraig: folds 
eniksenik: raises 12547 to 13347 and is all-in
Parodave: folds 
coyote710: folds 
xiruspitao: folds 
adri_nik: folds 
Uncalled bet (12547) returned to eniksenik
eniksenik collected 2585 from pot
eniksenik: doesn't show handDTO
*** SUMMARY ***
Total pot 2585 | Rake 0 
Seat 1: jcarlos.vale folded before Flop (didn't bet)
Seat 2: scottcraig folded before Flop (didn't bet)
Seat 3: eniksenik collected (2585)
Seat 4: Parodave folded before Flop (didn't bet)
Seat 5: coyote710 (button) folded before Flop (didn't bet)
Seat 6: xiruspitao (small blind) folded before Flop
Seat 7: adri_nik (big blind) folded before Flop
Seat 8: Kril82 folded before Flop (didn't bet)
Seat 9: lallelyk'lig folded before Flop (didn't bet)



PokerStars Hand #208300952810: Tournament #2779056951, $0.49+$0.06 USD Hold'em No Limit - Level XVI (400/800) - 2020/01/18 23:48:39 EET [2020/01/18 16:48:39 ET]
Table '2779056951 123' 9-max Seat #6 is the button
Seat 1: jcarlos.vale (12808 in chips) 
Seat 2: scottcraig (5015 in chips) 
Seat 3: eniksenik (15132 in chips) 
Seat 4: Parodave (9237 in chips) 
Seat 5: coyote710 (32774 in chips) 
Seat 6: xiruspitao (64692 in chips) 
Seat 7: adri_nik (12784 in chips) 
Seat 8: Kril82 (11374 in chips) 
Seat 9: lallelyk'lig (22001 in chips) is sitting out
jcarlos.vale: posts the ante 65
scottcraig: posts the ante 65
eniksenik: posts the ante 65
Parodave: posts the ante 65
coyote710: posts the ante 65
xiruspitao: posts the ante 65
adri_nik: posts the ante 65
Kril82: posts the ante 65
lallelyk'lig: posts the ante 65
adri_nik: posts small blind 400
Kril82: posts big blind 800
*** HOLE CARDS ***
Dealt to jcarlos.vale [Ac Jc]
lallelyk'lig: folds 
lallelyk'lig is disconnected 
jcarlos.vale: raises 1000 to 1800
scottcraig has timed out
scottcraig: folds 
scottcraig is sitting out
eniksenik: folds 
Parodave: folds 
coyote710: folds 
xiruspitao: folds 
adri_nik: folds 
scottcraig has returned
Kril82: folds 
Uncalled bet (1000) returned to jcarlos.vale
jcarlos.vale collected 2585 from pot
jcarlos.vale: doesn't show handDTO
*** SUMMARY ***
Total pot 2585 | Rake 0 
Seat 1: jcarlos.vale collected (2585)
Seat 2: scottcraig folded before Flop (didn't bet)
Seat 3: eniksenik folded before Flop (didn't bet)
Seat 4: Parodave folded before Flop (didn't bet)
Seat 5: coyote710 folded before Flop (didn't bet)
Seat 6: xiruspitao (button) folded before Flop (didn't bet)
Seat 7: adri_nik (small blind) folded before Flop
Seat 8: Kril82 (big blind) folded before Flop
Seat 9: lallelyk'lig folded before Flop (didn't bet)



PokerStars Hand #208300982540: Tournament #2779056951, $0.49+$0.06 USD Hold'em No Limit - Level XVI (400/800) - 2020/01/18 23:49:27 EET [2020/01/18 16:49:27 ET]
Table '2779056951 123' 9-max Seat #7 is the button
Seat 1: jcarlos.vale (14528 in chips) 
Seat 2: scottcraig (4950 in chips) 
Seat 3: eniksenik (15067 in chips) 
Seat 4: Parodave (9172 in chips) 
Seat 5: coyote710 (32709 in chips) 
Seat 6: xiruspitao (64627 in chips) 
Seat 7: adri_nik (12319 in chips) 
Seat 8: Kril82 (10509 in chips) 
Seat 9: lallelyk'lig (21936 in chips) is sitting out
jcarlos.vale: posts the ante 65
scottcraig: posts the ante 65
eniksenik: posts the ante 65
Parodave: posts the ante 65
coyote710: posts the ante 65
xiruspitao: posts the ante 65
adri_nik: posts the ante 65
Kril82: posts the ante 65
lallelyk'lig: posts the ante 65
Kril82: posts small blind 400
lallelyk'lig: posts big blind 800
*** HOLE CARDS ***
Dealt to jcarlos.vale [6c Qd]
lallelyk'lig has returned
jcarlos.vale: folds 
scottcraig: calls 800
eniksenik: raises 14202 to 15002 and is all-in
Parodave: folds 
coyote710: folds 
xiruspitao: folds 
adri_nik: folds 
Kril82: folds 
lallelyk'lig: folds 
scottcraig has timed out
scottcraig: folds 
scottcraig is sitting out
Uncalled bet (14202) returned to eniksenik
eniksenik collected 3385 from pot
eniksenik: doesn't show handDTO
scottcraig has returned
*** SUMMARY ***
Total pot 3385 | Rake 0 
Seat 1: jcarlos.vale folded before Flop (didn't bet)
Seat 2: scottcraig folded before Flop
Seat 3: eniksenik collected (3385)
Seat 4: Parodave folded before Flop (didn't bet)
Seat 5: coyote710 folded before Flop (didn't bet)
Seat 6: xiruspitao folded before Flop (didn't bet)
Seat 7: adri_nik (button) folded before Flop (didn't bet)
Seat 8: Kril82 (small blind) folded before Flop
Seat 9: lallelyk'lig (big blind) folded before Flop



PokerStars Hand #208301016040: Tournament #2779056951, $0.49+$0.06 USD Hold'em No Limit - Level XVI (400/800) - 2020/01/18 23:50:21 EET [2020/01/18 16:50:21 ET]
Table '2779056951 123' 9-max Seat #8 is the button
Seat 1: jcarlos.vale (14463 in chips) 
Seat 2: scottcraig (4085 in chips) 
Seat 3: eniksenik (17587 in chips) 
Seat 4: Parodave (9107 in chips) 
Seat 5: coyote710 (32644 in chips) 
Seat 6: xiruspitao (64562 in chips) 
Seat 7: adri_nik (12254 in chips) 
Seat 8: Kril82 (10044 in chips) 
Seat 9: lallelyk'lig (21071 in chips) 
jcarlos.vale: posts the ante 65
scottcraig: posts the ante 65
eniksenik: posts the ante 65
Parodave: posts the ante 65
coyote710: posts the ante 65
xiruspitao: posts the ante 65
adri_nik: posts the ante 65
Kril82: posts the ante 65
lallelyk'lig: posts the ante 65
lallelyk'lig: posts small blind 400
jcarlos.vale: posts big blind 800
*** HOLE CARDS ***
Dealt to jcarlos.vale [Jc 9s]
scottcraig has timed out
scottcraig: folds 
scottcraig is sitting out
eniksenik: folds 
Parodave: folds 
coyote710: folds 
xiruspitao: folds 
adri_nik: folds 
Kril82: folds 
scottcraig has returned
lallelyk'lig: calls 400
jcarlos.vale: checks 
*** FLOP *** [Js 7c 3c]
lallelyk'lig: bets 800
jcarlos.vale: calls 800
*** TURN *** [Js 7c 3c] [Ac]
lallelyk'lig: bets 800
jcarlos.vale: calls 800
*** RIVER *** [Js 7c 3c Ac] [Kc]
lallelyk'lig: bets 1092
jcarlos.vale: calls 1092
*** SHOW DOWN ***
lallelyk'lig: shows [7h 9c] (a flush, Ace high)
jcarlos.vale: shows [Jc 9s] (a flush, Ace high - Jack higher)
jcarlos.vale collected 7569 from pot
*** SUMMARY ***
Total pot 7569 | Rake 0 
Board [Js 7c 3c Ac Kc]
Seat 1: jcarlos.vale (big blind) showed [Jc 9s] and won (7569) with a flush, Ace high
Seat 2: scottcraig folded before Flop (didn't bet)
Seat 3: eniksenik folded before Flop (didn't bet)
Seat 4: Parodave folded before Flop (didn't bet)
Seat 5: coyote710 folded before Flop (didn't bet)
Seat 6: xiruspitao folded before Flop (didn't bet)
Seat 7: adri_nik folded before Flop (didn't bet)
Seat 8: Kril82 (button) folded before Flop (didn't bet)
Seat 9: lallelyk'lig (small blind) showed [7h 9c] and lost with a flush, Ace high



PokerStars Hand #208301088055: Tournament #2779056951, $0.49+$0.06 USD Hold'em No Limit - Level XVI (400/800) - 2020/01/18 23:52:18 EET [2020/01/18 16:52:18 ET]
Table '2779056951 123' 9-max Seat #9 is the button
Seat 1: jcarlos.vale (18475 in chips) 
Seat 2: scottcraig (4020 in chips) 
Seat 3: eniksenik (17522 in chips) 
Seat 4: Parodave (9042 in chips) 
Seat 5: coyote710 (32579 in chips) 
Seat 6: xiruspitao (64497 in chips) 
Seat 7: adri_nik (12189 in chips) 
Seat 8: Kril82 (9979 in chips) 
Seat 9: lallelyk'lig (17514 in chips) 
jcarlos.vale: posts the ante 65
scottcraig: posts the ante 65
eniksenik: posts the ante 65
Parodave: posts the ante 65
coyote710: posts the ante 65
xiruspitao: posts the ante 65
adri_nik: posts the ante 65
Kril82: posts the ante 65
lallelyk'lig: posts the ante 65
jcarlos.vale: posts small blind 400
scottcraig: posts big blind 800
*** HOLE CARDS ***
Dealt to jcarlos.vale [3h Kd]
eniksenik: raises 800 to 1600
Parodave: folds 
coyote710 has timed out
coyote710: folds 
coyote710 is sitting out
xiruspitao: folds 
adri_nik: folds 
Kril82: folds 
lallelyk'lig: folds 
jcarlos.vale: folds 
scottcraig: folds 
Uncalled bet (800) returned to eniksenik
eniksenik collected 2585 from pot
eniksenik: doesn't show handDTO
*** SUMMARY ***
Total pot 2585 | Rake 0 
Seat 1: jcarlos.vale (small blind) folded before Flop
Seat 2: scottcraig (big blind) folded before Flop
Seat 3: eniksenik collected (2585)
Seat 4: Parodave folded before Flop (didn't bet)
Seat 5: coyote710 folded before Flop (didn't bet)
Seat 6: xiruspitao folded before Flop (didn't bet)
Seat 7: adri_nik folded before Flop (didn't bet)
Seat 8: Kril82 folded before Flop (didn't bet)
Seat 9: lallelyk'lig (button) folded before Flop (didn't bet)



PokerStars Hand #208301129952: Tournament #2779056951, $0.49+$0.06 USD Hold'em No Limit - Level XVI (400/800) - 2020/01/18 23:53:26 EET [2020/01/18 16:53:26 ET]
Table '2779056951 123' 9-max Seat #1 is the button
Seat 1: jcarlos.vale (18010 in chips) 
Seat 2: scottcraig (3155 in chips) 
Seat 3: eniksenik (19242 in chips) 
Seat 4: Parodave (8977 in chips) 
Seat 5: coyote710 (32514 in chips) is sitting out
Seat 6: xiruspitao (64432 in chips) 
Seat 7: adri_nik (12124 in chips) 
Seat 8: Kril82 (9914 in chips) 
Seat 9: lallelyk'lig (17449 in chips) 
jcarlos.vale: posts the ante 65
scottcraig: posts the ante 65
eniksenik: posts the ante 65
Parodave: posts the ante 65
coyote710: posts the ante 65
xiruspitao: posts the ante 65
adri_nik: posts the ante 65
Kril82: posts the ante 65
lallelyk'lig: posts the ante 65
scottcraig: posts small blind 400
eniksenik: posts big blind 800
*** HOLE CARDS ***
Dealt to jcarlos.vale [6c 5h]
Parodave: folds 
coyote710: folds 
xiruspitao: folds 
adri_nik: folds 
Kril82: folds 
lallelyk'lig: raises 1600 to 2400
jcarlos.vale: folds 
scottcraig: raises 690 to 3090 and is all-in
eniksenik: folds 
lallelyk'lig: calls 690
*** FLOP *** [7s 8d 6d]
*** TURN *** [7s 8d 6d] [7d]
*** RIVER *** [7s 8d 6d 7d] [8s]
*** SHOW DOWN ***
scottcraig: shows [9c Kc] (two pair, Eights and Sevens)
lallelyk'lig: shows [Js Jh] (two pair, Jacks and Eights)
lallelyk'lig collected 7565 from pot
scottcraig finished the tournament in 503rd place and received $0.87.
*** SUMMARY ***
Total pot 7565 | Rake 0 
Board [7s 8d 6d 7d 8s]
Seat 1: jcarlos.vale (button) folded before Flop (didn't bet)
Seat 2: scottcraig (small blind) showed [9c Kc] and lost with two pair, Eights and Sevens
Seat 3: eniksenik (big blind) folded before Flop
Seat 4: Parodave folded before Flop (didn't bet)
Seat 5: coyote710 folded before Flop (didn't bet)
Seat 6: xiruspitao folded before Flop (didn't bet)
Seat 7: adri_nik folded before Flop (didn't bet)
Seat 8: Kril82 folded before Flop (didn't bet)
Seat 9: lallelyk'lig showed [Js Jh] and won (7565) with two pair, Jacks and Eights



PokerStars Hand #208301153687: Tournament #2779056951, $0.49+$0.06 USD Hold'em No Limit - Level XVI (400/800) - 2020/01/18 23:54:04 EET [2020/01/18 16:54:04 ET]
Table '2779056951 123' 9-max Seat #3 is the button
Seat 1: jcarlos.vale (17945 in chips) 
Seat 3: eniksenik (18377 in chips) 
Seat 4: Parodave (8912 in chips) 
Seat 5: coyote710 (32449 in chips) is sitting out
Seat 6: xiruspitao (64367 in chips) 
Seat 7: adri_nik (12059 in chips) 
Seat 8: Kril82 (9849 in chips) 
Seat 9: lallelyk'lig (21859 in chips) 
jcarlos.vale: posts the ante 65
eniksenik: posts the ante 65
Parodave: posts the ante 65
coyote710: posts the ante 65
xiruspitao: posts the ante 65
adri_nik: posts the ante 65
Kril82: posts the ante 65
lallelyk'lig: posts the ante 65
Parodave: posts small blind 400
coyote710: posts big blind 800
*** HOLE CARDS ***
Dealt to jcarlos.vale [7h Js]
xiruspitao: raises 1600 to 2400
adri_nik: folds 
Kril82: folds 
lallelyk'lig: calls 2400
jcarlos.vale: folds 
eniksenik: folds 
Parodave: folds 
coyote710: folds 
*** FLOP *** [9d 6h 4c]
xiruspitao: checks 
lallelyk'lig: checks 
*** TURN *** [9d 6h 4c] [3s]
xiruspitao: checks 
lallelyk'lig: bets 1600
xiruspitao: calls 1600
*** RIVER *** [9d 6h 4c 3s] [Qs]
xiruspitao: checks 
lallelyk'lig: bets 1600
xiruspitao: folds 
Uncalled bet (1600) returned to lallelyk'lig
lallelyk'lig collected 9720 from pot
lallelyk'lig: doesn't show handDTO
*** SUMMARY ***
Total pot 9720 | Rake 0 
Board [9d 6h 4c 3s Qs]
Seat 1: jcarlos.vale folded before Flop (didn't bet)
Seat 3: eniksenik (button) folded before Flop (didn't bet)
Seat 4: Parodave (small blind) folded before Flop
Seat 5: coyote710 (big blind) folded before Flop
Seat 6: xiruspitao folded on the River
Seat 7: adri_nik folded before Flop (didn't bet)
Seat 8: Kril82 folded before Flop (didn't bet)
Seat 9: lallelyk'lig collected (9720)



PokerStars Hand #208301193583: Tournament #2779056951, $0.49+$0.06 USD Hold'em No Limit - Level XVII (500/1000) - 2020/01/18 23:55:09 EET [2020/01/18 16:55:09 ET]
Table '2779056951 123' 9-max Seat #4 is the button
Seat 1: jcarlos.vale (17880 in chips) 
Seat 2: Madika2010 (3579 in chips) is sitting out
Seat 3: eniksenik (18312 in chips) 
Seat 4: Parodave (8447 in chips) 
Seat 5: coyote710 (31584 in chips) is sitting out
Seat 6: xiruspitao (60302 in chips) 
Seat 7: adri_nik (11994 in chips) 
Seat 8: Kril82 (9784 in chips) 
Seat 9: lallelyk'lig (27514 in chips) 
jcarlos.vale: posts the ante 75
Madika2010: posts the ante 75
eniksenik: posts the ante 75
Parodave: posts the ante 75
coyote710: posts the ante 75
xiruspitao: posts the ante 75
adri_nik: posts the ante 75
Kril82: posts the ante 75
lallelyk'lig: posts the ante 75
coyote710: posts small blind 500
xiruspitao: posts big blind 1000
*** HOLE CARDS ***
Dealt to jcarlos.vale [8c 2h]
adri_nik: folds 
Kril82: folds 
lallelyk'lig: folds 
jcarlos.vale: folds 
Madika2010: folds 
eniksenik: folds 
Parodave: raises 7372 to 8372 and is all-in
coyote710: folds 
xiruspitao: folds 
Uncalled bet (7372) returned to Parodave
Parodave collected 3175 from pot
*** SUMMARY ***
Total pot 3175 | Rake 0 
Seat 1: jcarlos.vale folded before Flop (didn't bet)
Seat 2: Madika2010 folded before Flop (didn't bet)
Seat 3: eniksenik folded before Flop (didn't bet)
Seat 4: Parodave (button) collected (3175)
Seat 5: coyote710 (small blind) folded before Flop
Seat 6: xiruspitao (big blind) folded before Flop
Seat 7: adri_nik folded before Flop (didn't bet)
Seat 8: Kril82 folded before Flop (didn't bet)
Seat 9: lallelyk'lig folded before Flop (didn't bet)



PokerStars Hand #208301388759: Tournament #2779056951, $0.49+$0.06 USD Hold'em No Limit - Level XVII (500/1000) - 2020/01/19 0:01:43 EET [2020/01/18 17:01:43 ET]
Table '2779056951 123' 9-max Seat #5 is the button
Seat 1: jcarlos.vale (17805 in chips) 
Seat 2: Madika2010 (3504 in chips) is sitting out
Seat 3: eniksenik (18237 in chips) 
Seat 4: Parodave (10547 in chips) 
Seat 5: coyote710 (31009 in chips) is sitting out
Seat 6: xiruspitao (59227 in chips) 
Seat 7: adri_nik (11919 in chips) 
Seat 8: Kril82 (9709 in chips) 
Seat 9: lallelyk'lig (27439 in chips) 
jcarlos.vale: posts the ante 75
Madika2010: posts the ante 75
eniksenik: posts the ante 75
Parodave: posts the ante 75
coyote710: posts the ante 75
xiruspitao: posts the ante 75
adri_nik: posts the ante 75
Kril82: posts the ante 75
lallelyk'lig: posts the ante 75
xiruspitao: posts small blind 500
adri_nik: posts big blind 1000
*** HOLE CARDS ***
Dealt to jcarlos.vale [7c Kd]
Kril82: folds 
lallelyk'lig has timed out
lallelyk'lig: folds 
lallelyk'lig is sitting out
jcarlos.vale: folds 
Madika2010: folds 
eniksenik: folds 
Parodave: folds 
coyote710: folds 
xiruspitao: folds 
Uncalled bet (500) returned to adri_nik
adri_nik collected 1675 from pot
adri_nik: doesn't show handDTO
*** SUMMARY ***
Total pot 1675 | Rake 0 
Seat 1: jcarlos.vale folded before Flop (didn't bet)
Seat 2: Madika2010 folded before Flop (didn't bet)
Seat 3: eniksenik folded before Flop (didn't bet)
Seat 4: Parodave folded before Flop (didn't bet)
Seat 5: coyote710 (button) folded before Flop (didn't bet)
Seat 6: xiruspitao (small blind) folded before Flop
Seat 7: adri_nik (big blind) collected (1675)
Seat 8: Kril82 folded before Flop (didn't bet)
Seat 9: lallelyk'lig folded before Flop (didn't bet)



PokerStars Hand #208301408760: Tournament #2779056951, $0.49+$0.06 USD Hold'em No Limit - Level XVII (500/1000) - 2020/01/19 0:02:16 EET [2020/01/18 17:02:16 ET]
Table '2779056951 123' 9-max Seat #6 is the button
Seat 1: jcarlos.vale (17730 in chips) 
Seat 2: Madika2010 (3429 in chips) is sitting out
Seat 3: eniksenik (18162 in chips) 
Seat 4: Parodave (10472 in chips) 
Seat 5: coyote710 (30934 in chips) is sitting out
Seat 6: xiruspitao (58652 in chips) 
Seat 7: adri_nik (13019 in chips) 
Seat 8: Kril82 (9634 in chips) 
Seat 9: lallelyk'lig (27364 in chips) is sitting out
jcarlos.vale: posts the ante 75
Madika2010: posts the ante 75
eniksenik: posts the ante 75
Parodave: posts the ante 75
coyote710: posts the ante 75
xiruspitao: posts the ante 75
adri_nik: posts the ante 75
Kril82: posts the ante 75
lallelyk'lig: posts the ante 75
adri_nik: posts small blind 500
Kril82: posts big blind 1000
*** HOLE CARDS ***
Dealt to jcarlos.vale [Kh 8c]
lallelyk'lig: folds 
jcarlos.vale: folds 
Madika2010: folds 
eniksenik: folds 
lallelyk'lig has returned
Parodave: raises 9397 to 10397 and is all-in
coyote710: folds 
xiruspitao: folds 
adri_nik: folds 
Kril82: folds 
Uncalled bet (9397) returned to Parodave
Parodave collected 3175 from pot
*** SUMMARY ***
Total pot 3175 | Rake 0 
Seat 1: jcarlos.vale folded before Flop (didn't bet)
Seat 2: Madika2010 folded before Flop (didn't bet)
Seat 3: eniksenik folded before Flop (didn't bet)
Seat 4: Parodave collected (3175)
Seat 5: coyote710 folded before Flop (didn't bet)
Seat 6: xiruspitao (button) folded before Flop (didn't bet)
Seat 7: adri_nik (small blind) folded before Flop
Seat 8: Kril82 (big blind) folded before Flop
Seat 9: lallelyk'lig folded before Flop (didn't bet)



PokerStars Hand #208301443692: Tournament #2779056951, $0.49+$0.06 USD Hold'em No Limit - Level XVII (500/1000) - 2020/01/19 0:02:59 EET [2020/01/18 17:02:59 ET]
Table '2779056951 123' 9-max Seat #7 is the button
Seat 1: jcarlos.vale (17655 in chips) 
Seat 2: Madika2010 (3354 in chips) is sitting out
Seat 3: eniksenik (18087 in chips) 
Seat 4: Parodave (12572 in chips) 
Seat 5: coyote710 (30859 in chips) is sitting out
Seat 6: xiruspitao (58577 in chips) 
Seat 7: adri_nik (12444 in chips) 
Seat 8: Kril82 (8559 in chips) 
Seat 9: lallelyk'lig (27289 in chips) 
jcarlos.vale: posts the ante 75
Madika2010: posts the ante 75
eniksenik: posts the ante 75
Parodave: posts the ante 75
coyote710: posts the ante 75
xiruspitao: posts the ante 75
adri_nik: posts the ante 75
Kril82: posts the ante 75
lallelyk'lig: posts the ante 75
Kril82: posts small blind 500
lallelyk'lig: posts big blind 1000
*** HOLE CARDS ***
Dealt to jcarlos.vale [8h 3h]
jcarlos.vale: folds 
Madika2010: folds 
eniksenik: folds 
Parodave: folds 
coyote710: folds 
xiruspitao: raises 2000 to 3000
adri_nik: folds 
Kril82: folds 
lallelyk'lig: folds 
Uncalled bet (2000) returned to xiruspitao
xiruspitao collected 3175 from pot
*** SUMMARY ***
Total pot 3175 | Rake 0 
Seat 1: jcarlos.vale folded before Flop (didn't bet)
Seat 2: Madika2010 folded before Flop (didn't bet)
Seat 3: eniksenik folded before Flop (didn't bet)
Seat 4: Parodave folded before Flop (didn't bet)
Seat 5: coyote710 folded before Flop (didn't bet)
Seat 6: xiruspitao collected (3175)
Seat 7: adri_nik (button) folded before Flop (didn't bet)
Seat 8: Kril82 (small blind) folded before Flop
Seat 9: lallelyk'lig (big blind) folded before Flop



PokerStars Hand #208301463821: Tournament #2779056951, $0.49+$0.06 USD Hold'em No Limit - Level XVII (500/1000) - 2020/01/19 0:03:32 EET [2020/01/18 17:03:32 ET]
Table '2779056951 123' 9-max Seat #8 is the button
Seat 1: jcarlos.vale (17580 in chips) 
Seat 2: Madika2010 (3279 in chips) is sitting out
Seat 3: eniksenik (18012 in chips) 
Seat 4: Parodave (12497 in chips) 
Seat 5: coyote710 (30784 in chips) is sitting out
Seat 6: xiruspitao (60677 in chips) 
Seat 7: adri_nik (12369 in chips) 
Seat 8: Kril82 (7984 in chips) 
Seat 9: lallelyk'lig (26214 in chips) 
jcarlos.vale: posts the ante 75
Madika2010: posts the ante 75
eniksenik: posts the ante 75
Parodave: posts the ante 75
coyote710: posts the ante 75
xiruspitao: posts the ante 75
adri_nik: posts the ante 75
Kril82: posts the ante 75
lallelyk'lig: posts the ante 75
lallelyk'lig: posts small blind 500
jcarlos.vale: posts big blind 1000
*** HOLE CARDS ***
Dealt to jcarlos.vale [4c Ad]
Madika2010: folds 
eniksenik: folds 
Parodave: folds 
coyote710: folds 
coyote710 has returned
xiruspitao: raises 1200 to 2200
adri_nik: raises 10094 to 12294 and is all-in
Kril82: folds 
lallelyk'lig: folds 
jcarlos.vale: folds 
xiruspitao: calls 10094
*** FLOP *** [8h Kc 3d]
*** TURN *** [8h Kc 3d] [Qh]
*** RIVER *** [8h Kc 3d Qh] [Qs]
*** SHOW DOWN ***
xiruspitao: shows [Ah 6s] (a pair of Queens)
adri_nik: shows [4d 4h] (two pair, Queens and Fours)
adri_nik collected 26763 from pot
*** SUMMARY ***
Total pot 26763 | Rake 0 
Board [8h Kc 3d Qh Qs]
Seat 1: jcarlos.vale (big blind) folded before Flop
Seat 2: Madika2010 folded before Flop (didn't bet)
Seat 3: eniksenik folded before Flop (didn't bet)
Seat 4: Parodave folded before Flop (didn't bet)
Seat 5: coyote710 folded before Flop (didn't bet)
Seat 6: xiruspitao showed [Ah 6s] and lost with a pair of Queens
Seat 7: adri_nik showed [4d 4h] and won (26763) with two pair, Queens and Fours
Seat 8: Kril82 (button) folded before Flop (didn't bet)
Seat 9: lallelyk'lig (small blind) folded before Flop



PokerStars Hand #208301487573: Tournament #2779056951, $0.49+$0.06 USD Hold'em No Limit - Level XVII (500/1000) - 2020/01/19 0:04:11 EET [2020/01/18 17:04:11 ET]
Table '2779056951 123' 9-max Seat #9 is the button
Seat 1: jcarlos.vale (16505 in chips) 
Seat 2: Madika2010 (3204 in chips) is sitting out
Seat 3: eniksenik (17937 in chips) 
Seat 4: Parodave (12422 in chips) 
Seat 5: coyote710 (30709 in chips) 
Seat 6: xiruspitao (48308 in chips) 
Seat 7: adri_nik (26763 in chips) 
Seat 8: Kril82 (7909 in chips) 
Seat 9: lallelyk'lig (25639 in chips) 
jcarlos.vale: posts the ante 75
Madika2010: posts the ante 75
eniksenik: posts the ante 75
Parodave: posts the ante 75
coyote710: posts the ante 75
xiruspitao: posts the ante 75
adri_nik: posts the ante 75
Kril82: posts the ante 75
lallelyk'lig: posts the ante 75
jcarlos.vale: posts small blind 500
Madika2010: posts big blind 1000
*** HOLE CARDS ***
Dealt to jcarlos.vale [2h 7h]
eniksenik: folds 
Parodave: folds 
coyote710: folds 
xiruspitao: folds 
adri_nik: folds 
Kril82: folds 
lallelyk'lig: folds 
jcarlos.vale: raises 1000 to 2000
Madika2010: folds 
Uncalled bet (1000) returned to jcarlos.vale
jcarlos.vale collected 2675 from pot
jcarlos.vale: doesn't show handDTO
*** SUMMARY ***
Total pot 2675 | Rake 0 
Seat 1: jcarlos.vale (small blind) collected (2675)
Seat 2: Madika2010 (big blind) folded before Flop
Seat 3: eniksenik folded before Flop (didn't bet)
Seat 4: Parodave folded before Flop (didn't bet)
Seat 5: coyote710 folded before Flop (didn't bet)
Seat 6: xiruspitao folded before Flop (didn't bet)
Seat 7: adri_nik folded before Flop (didn't bet)
Seat 8: Kril82 folded before Flop (didn't bet)
Seat 9: lallelyk'lig (button) folded before Flop (didn't bet)



PokerStars Hand #208301501073: Tournament #2779056951, $0.49+$0.06 USD Hold'em No Limit - Level XVII (500/1000) - 2020/01/19 0:04:33 EET [2020/01/18 17:04:33 ET]
Table '2779056951 123' 9-max Seat #1 is the button
Seat 1: jcarlos.vale (18105 in chips) 
Seat 2: Madika2010 (2129 in chips) is sitting out
Seat 3: eniksenik (17862 in chips) 
Seat 4: Parodave (12347 in chips) 
Seat 5: coyote710 (30634 in chips) 
Seat 6: xiruspitao (48233 in chips) 
Seat 7: adri_nik (26688 in chips) 
Seat 8: Kril82 (7834 in chips) 
Seat 9: lallelyk'lig (25564 in chips) 
jcarlos.vale: posts the ante 75
Madika2010: posts the ante 75
eniksenik: posts the ante 75
Parodave: posts the ante 75
coyote710: posts the ante 75
xiruspitao: posts the ante 75
adri_nik: posts the ante 75
Kril82: posts the ante 75
lallelyk'lig: posts the ante 75
Madika2010: posts small blind 500
eniksenik: posts big blind 1000
*** HOLE CARDS ***
Dealt to jcarlos.vale [Kd Kc]
Parodave: folds 
coyote710: raises 1000 to 2000
xiruspitao: folds 
adri_nik: folds 
Kril82: folds 
lallelyk'lig: folds 
jcarlos.vale: raises 3000 to 5000
Madika2010: folds 
eniksenik: folds 
coyote710: calls 3000
*** FLOP *** [7d 5d 6s]
coyote710: checks 
jcarlos.vale: bets 7000
coyote710: folds 
Uncalled bet (7000) returned to jcarlos.vale
jcarlos.vale collected 12175 from pot
jcarlos.vale: doesn't show handDTO
*** SUMMARY ***
Total pot 12175 | Rake 0 
Board [7d 5d 6s]
Seat 1: jcarlos.vale (button) collected (12175)
Seat 2: Madika2010 (small blind) folded before Flop
Seat 3: eniksenik (big blind) folded before Flop
Seat 4: Parodave folded before Flop (didn't bet)
Seat 5: coyote710 folded on the Flop
Seat 6: xiruspitao folded before Flop (didn't bet)
Seat 7: adri_nik folded before Flop (didn't bet)
Seat 8: Kril82 folded before Flop (didn't bet)
Seat 9: lallelyk'lig folded before Flop (didn't bet)



PokerStars Hand #208301524866: Tournament #2779056951, $0.49+$0.06 USD Hold'em No Limit - Level XVII (500/1000) - 2020/01/19 0:05:11 EET [2020/01/18 17:05:11 ET]
Table '2779056951 123' 9-max Seat #2 is the button
Seat 1: jcarlos.vale (25205 in chips) 
Seat 2: Madika2010 (1554 in chips) is sitting out
Seat 3: eniksenik (16787 in chips) 
Seat 4: Parodave (12272 in chips) 
Seat 5: coyote710 (25559 in chips) 
Seat 6: xiruspitao (48158 in chips) 
Seat 7: adri_nik (26613 in chips) 
Seat 8: Kril82 (7759 in chips) 
Seat 9: lallelyk'lig (25489 in chips) 
jcarlos.vale: posts the ante 75
Madika2010: posts the ante 75
eniksenik: posts the ante 75
Parodave: posts the ante 75
coyote710: posts the ante 75
xiruspitao: posts the ante 75
adri_nik: posts the ante 75
Kril82: posts the ante 75
lallelyk'lig: posts the ante 75
eniksenik: posts small blind 500
Parodave: posts big blind 1000
*** HOLE CARDS ***
Dealt to jcarlos.vale [Qc Kd]
coyote710: folds 
xiruspitao: folds 
adri_nik: calls 1000
Kril82: folds 
lallelyk'lig: raises 2000 to 3000
jcarlos.vale: folds 
Madika2010: folds 
eniksenik: calls 2500
Parodave: folds 
adri_nik: calls 2000
*** FLOP *** [Ac 2h Jh]
eniksenik: checks 
adri_nik: checks 
lallelyk'lig: bets 3000
eniksenik: folds 
adri_nik: calls 3000
*** TURN *** [Ac 2h Jh] [Ad]
adri_nik: checks 
lallelyk'lig: checks 
*** RIVER *** [Ac 2h Jh Ad] [Ts]
adri_nik: bets 3000
lallelyk'lig: raises 4000 to 7000
adri_nik: calls 4000
*** SHOW DOWN ***
lallelyk'lig: shows [As 9s] (three of a kind, Aces)
adri_nik: mucks handDTO
lallelyk'lig collected 30675 from pot
*** SUMMARY ***
Total pot 30675 | Rake 0 
Board [Ac 2h Jh Ad Ts]
Seat 1: jcarlos.vale folded before Flop (didn't bet)
Seat 2: Madika2010 (button) folded before Flop (didn't bet)
Seat 3: eniksenik (small blind) folded on the Flop
Seat 4: Parodave (big blind) folded before Flop
Seat 5: coyote710 folded before Flop (didn't bet)
Seat 6: xiruspitao folded before Flop (didn't bet)
Seat 7: adri_nik mucked [Jc Kh]
Seat 8: Kril82 folded before Flop (didn't bet)
Seat 9: lallelyk'lig showed [As 9s] and won (30675) with three of a kind, Aces



PokerStars Hand #208301555907: Tournament #2779056951, $0.49+$0.06 USD Hold'em No Limit - Level XVII (500/1000) - 2020/01/19 0:06:02 EET [2020/01/18 17:06:02 ET]
Table '2779056951 123' 9-max Seat #3 is the button
Seat 1: jcarlos.vale (25130 in chips) 
Seat 2: Madika2010 (1479 in chips) is sitting out
Seat 3: eniksenik (13712 in chips) 
Seat 4: Parodave (11197 in chips) 
Seat 5: coyote710 (25484 in chips) 
Seat 6: xiruspitao (48083 in chips) 
Seat 7: adri_nik (13538 in chips) 
Seat 8: Kril82 (7684 in chips) 
Seat 9: lallelyk'lig (43089 in chips) 
jcarlos.vale: posts the ante 75
Madika2010: posts the ante 75
eniksenik: posts the ante 75
Parodave: posts the ante 75
coyote710: posts the ante 75
xiruspitao: posts the ante 75
adri_nik: posts the ante 75
Kril82: posts the ante 75
lallelyk'lig: posts the ante 75
Parodave: posts small blind 500
coyote710: posts big blind 1000
*** HOLE CARDS ***
Dealt to jcarlos.vale [Tc 7h]
xiruspitao: folds 
adri_nik: calls 1000
Kril82: raises 6609 to 7609 and is all-in
lallelyk'lig: folds 
jcarlos.vale: folds 
Madika2010: folds 
eniksenik: folds 
Parodave: folds 
coyote710: folds 
adri_nik: calls 6609
*** FLOP *** [Qs Qd 2h]
*** TURN *** [Qs Qd 2h] [6d]
*** RIVER *** [Qs Qd 2h 6d] [9s]
*** SHOW DOWN ***
adri_nik: shows [6s 6c] (a full house, Sixes full of Queens)
Kril82: shows [7d 7s] (two pair, Queens and Sevens)
adri_nik collected 17393 from pot
Kril82 finished the tournament in 440th place and received $0.87.
*** SUMMARY ***
Total pot 17393 | Rake 0 
Board [Qs Qd 2h 6d 9s]
Seat 1: jcarlos.vale folded before Flop (didn't bet)
Seat 2: Madika2010 folded before Flop (didn't bet)
Seat 3: eniksenik (button) folded before Flop (didn't bet)
Seat 4: Parodave (small blind) folded before Flop
Seat 5: coyote710 (big blind) folded before Flop
Seat 6: xiruspitao folded before Flop (didn't bet)
Seat 7: adri_nik showed [6s 6c] and won (17393) with a full house, Sixes full of Queens
Seat 8: Kril82 showed [7d 7s] and lost with two pair, Queens and Sevens
Seat 9: lallelyk'lig folded before Flop (didn't bet)



PokerStars Hand #208301579714: Tournament #2779056951, $0.49+$0.06 USD Hold'em No Limit - Level XVII (500/1000) - 2020/01/19 0:06:41 EET [2020/01/18 17:06:41 ET]
Table '2779056951 123' 9-max Seat #4 is the button
Seat 1: jcarlos.vale (25055 in chips) 
Seat 2: Madika2010 (1404 in chips) is sitting out
Seat 3: eniksenik (13637 in chips) 
Seat 4: Parodave (10622 in chips) 
Seat 5: coyote710 (24409 in chips) 
Seat 6: xiruspitao (48008 in chips) 
Seat 7: adri_nik (23247 in chips) 
Seat 9: lallelyk'lig (43014 in chips) 
jcarlos.vale: posts the ante 75
Madika2010: posts the ante 75
eniksenik: posts the ante 75
Parodave: posts the ante 75
coyote710: posts the ante 75
xiruspitao: posts the ante 75
adri_nik: posts the ante 75
lallelyk'lig: posts the ante 75
coyote710: posts small blind 500
xiruspitao: posts big blind 1000
*** HOLE CARDS ***
Dealt to jcarlos.vale [6h Ah]
adri_nik: calls 1000
lallelyk'lig: calls 1000
jcarlos.vale: folds 
Madika2010: folds 
eniksenik: folds 
Parodave: folds 
coyote710: calls 500
xiruspitao: checks 
*** FLOP *** [7c Tc Jh]
coyote710: checks 
xiruspitao: checks 
adri_nik: bets 2000
lallelyk'lig: raises 3000 to 5000
coyote710: folds 
xiruspitao: folds 
adri_nik: calls 3000
*** TURN *** [7c Tc Jh] [2d]
adri_nik: checks 
lallelyk'lig: bets 5000
adri_nik: calls 5000
*** RIVER *** [7c Tc Jh 2d] [Qs]
adri_nik: bets 12172 and is all-in
lallelyk'lig: folds 
Uncalled bet (12172) returned to adri_nik
adri_nik collected 24600 from pot
adri_nik: doesn't show handDTO
*** SUMMARY ***
Total pot 24600 | Rake 0 
Board [7c Tc Jh 2d Qs]
Seat 1: jcarlos.vale folded before Flop (didn't bet)
Seat 2: Madika2010 folded before Flop (didn't bet)
Seat 3: eniksenik folded before Flop (didn't bet)
Seat 4: Parodave (button) folded before Flop (didn't bet)
Seat 5: coyote710 (small blind) folded on the Flop
Seat 6: xiruspitao (big blind) folded on the Flop
Seat 7: adri_nik collected (24600)
Seat 9: lallelyk'lig folded on the River



PokerStars Hand #208301640734: Tournament #2779056951, $0.49+$0.06 USD Hold'em No Limit - Level XVII (500/1000) - 2020/01/19 0:08:19 EET [2020/01/18 17:08:19 ET]
Table '2779056951 123' 9-max Seat #5 is the button
Seat 1: jcarlos.vale (24980 in chips) 
Seat 2: Madika2010 (1329 in chips) is sitting out
Seat 3: eniksenik (13562 in chips) 
Seat 4: Parodave (10547 in chips) 
Seat 5: coyote710 (23334 in chips) 
Seat 6: xiruspitao (46933 in chips) 
Seat 7: adri_nik (36772 in chips) 
Seat 8: baboyras (88372 in chips) 
Seat 9: lallelyk'lig (31939 in chips) 
jcarlos.vale: posts the ante 75
Madika2010: posts the ante 75
eniksenik: posts the ante 75
Parodave: posts the ante 75
coyote710: posts the ante 75
xiruspitao: posts the ante 75
adri_nik: posts the ante 75
baboyras: posts the ante 75
lallelyk'lig: posts the ante 75
xiruspitao: posts small blind 500
adri_nik: posts big blind 1000
*** HOLE CARDS ***
Dealt to jcarlos.vale [8c 5h]
baboyras: calls 1000
lallelyk'lig: raises 2000 to 3000
jcarlos.vale: folds 
Madika2010: folds 
eniksenik: folds 
Parodave: folds 
coyote710: folds 
xiruspitao: folds 
adri_nik: folds 
baboyras: calls 2000
*** FLOP *** [Kh 2d 3h]
baboyras: bets 1000
lallelyk'lig: calls 1000
*** TURN *** [Kh 2d 3h] [Qs]
baboyras: checks 
lallelyk'lig: bets 2000
baboyras: calls 2000
*** RIVER *** [Kh 2d 3h Qs] [7s]
baboyras: checks 
lallelyk'lig: bets 3000
baboyras: folds 
Uncalled bet (3000) returned to lallelyk'lig
lallelyk'lig collected 14175 from pot
lallelyk'lig: doesn't show handDTO
*** SUMMARY ***
Total pot 14175 | Rake 0 
Board [Kh 2d 3h Qs 7s]
Seat 1: jcarlos.vale folded before Flop (didn't bet)
Seat 2: Madika2010 folded before Flop (didn't bet)
Seat 3: eniksenik folded before Flop (didn't bet)
Seat 4: Parodave folded before Flop (didn't bet)
Seat 5: coyote710 (button) folded before Flop (didn't bet)
Seat 6: xiruspitao (small blind) folded before Flop
Seat 7: adri_nik (big blind) folded before Flop
Seat 8: baboyras folded on the River
Seat 9: lallelyk'lig collected (14175)



PokerStars Hand #208301666135: Tournament #2779056951, $0.49+$0.06 USD Hold'em No Limit - Level XVII (500/1000) - 2020/01/19 0:09:01 EET [2020/01/18 17:09:01 ET]
Table '2779056951 123' 9-max Seat #6 is the button
Seat 1: jcarlos.vale (24905 in chips) 
Seat 2: Madika2010 (1254 in chips) is sitting out
Seat 3: eniksenik (13487 in chips) 
Seat 4: Parodave (10472 in chips) 
Seat 5: coyote710 (23259 in chips) 
Seat 6: xiruspitao (46358 in chips) 
Seat 7: adri_nik (35697 in chips) 
Seat 8: baboyras (82297 in chips) 
Seat 9: lallelyk'lig (40039 in chips) 
jcarlos.vale: posts the ante 75
Madika2010: posts the ante 75
eniksenik: posts the ante 75
Parodave: posts the ante 75
coyote710: posts the ante 75
xiruspitao: posts the ante 75
adri_nik: posts the ante 75
baboyras: posts the ante 75
lallelyk'lig: posts the ante 75
adri_nik: posts small blind 500
baboyras: posts big blind 1000
*** HOLE CARDS ***
Dealt to jcarlos.vale [2d Kd]
lallelyk'lig: folds 
jcarlos.vale: folds 
Madika2010: folds 
eniksenik: folds 
Parodave: folds 
coyote710: folds 
xiruspitao: folds 
adri_nik: calls 500
baboyras: checks 
*** FLOP *** [As 3d Qc]
adri_nik: checks 
baboyras: bets 1000
adri_nik: calls 1000
*** TURN *** [As 3d Qc] [6d]
adri_nik: checks 
baboyras: checks 
*** RIVER *** [As 3d Qc 6d] [4s]
adri_nik: bets 2000
baboyras: folds 
Uncalled bet (2000) returned to adri_nik
adri_nik collected 4675 from pot
adri_nik: doesn't show handDTO
*** SUMMARY ***
Total pot 4675 | Rake 0 
Board [As 3d Qc 6d 4s]
Seat 1: jcarlos.vale folded before Flop (didn't bet)
Seat 2: Madika2010 folded before Flop (didn't bet)
Seat 3: eniksenik folded before Flop (didn't bet)
Seat 4: Parodave folded before Flop (didn't bet)
Seat 5: coyote710 folded before Flop (didn't bet)
Seat 6: xiruspitao (button) folded before Flop (didn't bet)
Seat 7: adri_nik (small blind) collected (4675)
Seat 8: baboyras (big blind) folded on the River
Seat 9: lallelyk'lig folded before Flop (didn't bet)



PokerStars Hand #208301703308: Tournament #2779056951, $0.49+$0.06 USD Hold'em No Limit - Level XVII (500/1000) - 2020/01/19 0:10:02 EET [2020/01/18 17:10:02 ET]
Table '2779056951 123' 9-max Seat #7 is the button
Seat 1: jcarlos.vale (24830 in chips) 
Seat 2: Madika2010 (1179 in chips) is sitting out
Seat 3: eniksenik (13412 in chips) 
Seat 4: Parodave (10397 in chips) 
Seat 5: coyote710 (23184 in chips) 
Seat 6: xiruspitao (46283 in chips) 
Seat 7: adri_nik (38297 in chips) 
Seat 8: baboyras (80222 in chips) 
Seat 9: lallelyk'lig (39964 in chips) 
jcarlos.vale: posts the ante 75
Madika2010: posts the ante 75
eniksenik: posts the ante 75
Parodave: posts the ante 75
coyote710: posts the ante 75
xiruspitao: posts the ante 75
adri_nik: posts the ante 75
baboyras: posts the ante 75
lallelyk'lig: posts the ante 75
baboyras: posts small blind 500
lallelyk'lig: posts big blind 1000
*** HOLE CARDS ***
Dealt to jcarlos.vale [Kc 5d]
jcarlos.vale: folds 
Madika2010: folds 
eniksenik: folds 
Parodave: folds 
coyote710: folds 
xiruspitao: folds 
adri_nik: folds 
baboyras: raises 1000 to 2000
lallelyk'lig: calls 1000
*** FLOP *** [7h Qs 5c]
baboyras: bets 1000
lallelyk'lig: raises 3338 to 4338
baboyras: folds 
Uncalled bet (3338) returned to lallelyk'lig
lallelyk'lig collected 6675 from pot
lallelyk'lig: doesn't show handDTO
*** SUMMARY ***
Total pot 6675 | Rake 0 
Board [7h Qs 5c]
Seat 1: jcarlos.vale folded before Flop (didn't bet)
Seat 2: Madika2010 folded before Flop (didn't bet)
Seat 3: eniksenik folded before Flop (didn't bet)
Seat 4: Parodave folded before Flop (didn't bet)
Seat 5: coyote710 folded before Flop (didn't bet)
Seat 6: xiruspitao folded before Flop (didn't bet)
Seat 7: adri_nik (button) folded before Flop (didn't bet)
Seat 8: baboyras (small blind) folded on the Flop
Seat 9: lallelyk'lig (big blind) collected (6675)



PokerStars Hand #208301733361: Tournament #2779056951, $0.49+$0.06 USD Hold'em No Limit - Level XVII (500/1000) - 2020/01/19 0:10:51 EET [2020/01/18 17:10:51 ET]
Table '2779056951 123' 9-max Seat #8 is the button
Seat 1: jcarlos.vale (24755 in chips) 
Seat 2: Madika2010 (1104 in chips) is sitting out
Seat 3: eniksenik (13337 in chips) 
Seat 4: Parodave (10322 in chips) 
Seat 5: coyote710 (23109 in chips) 
Seat 6: xiruspitao (46208 in chips) 
Seat 7: adri_nik (38222 in chips) 
Seat 8: baboyras (77147 in chips) 
Seat 9: lallelyk'lig (43564 in chips) 
jcarlos.vale: posts the ante 75
Madika2010: posts the ante 75
eniksenik: posts the ante 75
Parodave: posts the ante 75
coyote710: posts the ante 75
xiruspitao: posts the ante 75
adri_nik: posts the ante 75
baboyras: posts the ante 75
lallelyk'lig: posts the ante 75
lallelyk'lig: posts small blind 500
jcarlos.vale: posts big blind 1000
*** HOLE CARDS ***
Dealt to jcarlos.vale [9c Jc]
Madika2010: folds 
eniksenik: raises 12262 to 13262 and is all-in
Parodave: folds 
coyote710: folds 
xiruspitao: folds 
adri_nik: folds 
baboyras: folds 
lallelyk'lig: calls 12762
jcarlos.vale: folds 
*** FLOP *** [6s Ks 4c]
*** TURN *** [6s Ks 4c] [Jh]
*** RIVER *** [6s Ks 4c Jh] [Td]
*** SHOW DOWN ***
lallelyk'lig: shows [4d 4h] (three of a kind, Fours)
eniksenik: shows [Qs Kc] (a pair of Kings)
lallelyk'lig collected 28199 from pot
eniksenik finished the tournament in 389th place and received $0.87.
*** SUMMARY ***
Total pot 28199 | Rake 0 
Board [6s Ks 4c Jh Td]
Seat 1: jcarlos.vale (big blind) folded before Flop
Seat 2: Madika2010 folded before Flop (didn't bet)
Seat 3: eniksenik showed [Qs Kc] and lost with a pair of Kings
Seat 4: Parodave folded before Flop (didn't bet)
Seat 5: coyote710 folded before Flop (didn't bet)
Seat 6: xiruspitao folded before Flop (didn't bet)
Seat 7: adri_nik folded before Flop (didn't bet)
Seat 8: baboyras (button) folded before Flop (didn't bet)
Seat 9: lallelyk'lig (small blind) showed [4d 4h] and won (28199) with three of a kind, Fours



PokerStars Hand #208301761270: Tournament #2779056951, $0.49+$0.06 USD Hold'em No Limit - Level XVIII (600/1200) - 2020/01/19 0:11:37 EET [2020/01/18 17:11:37 ET]
Table '2779056951 123' 9-max Seat #9 is the button
Seat 1: jcarlos.vale (23680 in chips) 
Seat 2: Madika2010 (1029 in chips) is sitting out
Seat 3: marcinho888 (15356 in chips) 
Seat 4: Parodave (10247 in chips) 
Seat 5: coyote710 (23034 in chips) 
Seat 6: xiruspitao (46133 in chips) 
Seat 7: adri_nik (38147 in chips) 
Seat 8: baboyras (77072 in chips) 
Seat 9: lallelyk'lig (58426 in chips) 
jcarlos.vale: posts the ante 90
Madika2010: posts the ante 90
marcinho888: posts the ante 90
Parodave: posts the ante 90
coyote710: posts the ante 90
xiruspitao: posts the ante 90
adri_nik: posts the ante 90
baboyras: posts the ante 90
lallelyk'lig: posts the ante 90
jcarlos.vale: posts small blind 600
Madika2010: posts big blind 939 and is all-in
*** HOLE CARDS ***
Dealt to jcarlos.vale [7c 8c]
marcinho888: folds 
Parodave: folds 
coyote710: folds 
xiruspitao: folds 
adri_nik: folds 
baboyras: calls 1200
lallelyk'lig: calls 1200
jcarlos.vale: calls 600
Madika2010: folds 
*** FLOP *** [2d 5s Ks]
jcarlos.vale: checks 
baboyras: bets 1200
lallelyk'lig: calls 1200
jcarlos.vale: folds 
*** TURN *** [2d 5s Ks] [6d]
baboyras: bets 4800
lallelyk'lig: folds 
Uncalled bet (4800) returned to baboyras
baboyras collected 7749 from pot
Madika2010 finished the tournament in 379th place and received $0.87.
baboyras: doesn't show handDTO
*** SUMMARY ***
Total pot 7749 | Rake 0 
Board [2d 5s Ks 6d]
Seat 1: jcarlos.vale (small blind) folded on the Flop
Seat 2: Madika2010 (big blind) folded before Flop
Seat 3: marcinho888 folded before Flop (didn't bet)
Seat 4: Parodave folded before Flop (didn't bet)
Seat 5: coyote710 folded before Flop (didn't bet)
Seat 6: xiruspitao folded before Flop (didn't bet)
Seat 7: adri_nik folded before Flop (didn't bet)
Seat 8: baboyras collected (7749)
Seat 9: lallelyk'lig (button) folded on the Turn



PokerStars Hand #208301846220: Tournament #2779056951, $0.49+$0.06 USD Hold'em No Limit - Level XVIII (600/1200) - 2020/01/19 0:13:51 EET [2020/01/18 17:13:51 ET]
Table '2779056951 104' 9-max Seat #5 is the button
Seat 1: GARRRN (102041 in chips) 
Seat 2: allex jacob (5858 in chips) 
Seat 3: Ablon2012 (23800 in chips) is sitting out
Seat 4: jcarlos.vale (22390 in chips) 
Seat 5: maxkenig (29030 in chips) 
Seat 6: veto1975 (41852 in chips) 
Seat 7: stonywerner (3534 in chips) 
Seat 8: Nichtlieb307 (68689 in chips) 
Seat 9: BARSS5588 (27131 in chips) 
GARRRN: posts the ante 90
allex jacob: posts the ante 90
Ablon2012: posts the ante 90
jcarlos.vale: posts the ante 90
maxkenig: posts the ante 90
veto1975: posts the ante 90
stonywerner: posts the ante 90
Nichtlieb307: posts the ante 90
BARSS5588: posts the ante 90
veto1975: posts small blind 600
stonywerner: posts big blind 1200
*** HOLE CARDS ***
Dealt to jcarlos.vale [5h Jh]
Nichtlieb307: calls 1200
BARSS5588: calls 1200
GARRRN: folds 
allex jacob: folds 
Ablon2012: folds 
jcarlos.vale: folds 
maxkenig: folds 
Ablon2012 has returned
veto1975: calls 600
stonywerner: raises 2244 to 3444 and is all-in
Nichtlieb307: calls 2244
BARSS5588: calls 2244
veto1975: calls 2244
*** FLOP *** [Kc Td 6h]
veto1975: checks 
Nichtlieb307: checks 
BARSS5588: checks 
*** TURN *** [Kc Td 6h] [7c]
veto1975: checks 
Nichtlieb307: bets 1200
BARSS5588: calls 1200
veto1975: calls 1200
*** RIVER *** [Kc Td 6h 7c] [3s]
veto1975: checks 
Nichtlieb307: checks 
BARSS5588: checks 
*** SHOW DOWN ***
veto1975: shows [7s Js] (a pair of Sevens)
Nichtlieb307: shows [8c 8s] (a pair of Eights)
BARSS5588: mucks handDTO
Nichtlieb307 collected 3600 from side pot
stonywerner: shows [Kh Ks] (three of a kind, Kings)
stonywerner collected 14586 from main pot
*** SUMMARY ***
Total pot 18186 Main pot 14586. Side pot 3600. | Rake 0 
Board [Kc Td 6h 7c 3s]
Seat 1: GARRRN folded before Flop (didn't bet)
Seat 2: allex jacob folded before Flop (didn't bet)
Seat 3: Ablon2012 folded before Flop (didn't bet)
Seat 4: jcarlos.vale folded before Flop (didn't bet)
Seat 5: maxkenig (button) folded before Flop (didn't bet)
Seat 6: veto1975 (small blind) showed [7s Js] and lost with a pair of Sevens
Seat 7: stonywerner (big blind) showed [Kh Ks] and won (14586) with three of a kind, Kings
Seat 8: Nichtlieb307 showed [8c 8s] and won (3600) with a pair of Eights
Seat 9: BARSS5588 mucked [Ad Jd]



PokerStars Hand #208301890106: Tournament #2779056951, $0.49+$0.06 USD Hold'em No Limit - Level XVIII (600/1200) - 2020/01/19 0:15:03 EET [2020/01/18 17:15:03 ET]
Table '2779056951 104' 9-max Seat #6 is the button
Seat 1: GARRRN (101951 in chips) 
Seat 2: allex jacob (5768 in chips) 
Seat 3: Ablon2012 (23710 in chips) 
Seat 4: jcarlos.vale (22300 in chips) 
Seat 5: maxkenig (28940 in chips) 
Seat 6: veto1975 (37118 in chips) 
Seat 7: stonywerner (14586 in chips) 
Seat 8: Nichtlieb307 (67555 in chips) 
Seat 9: BARSS5588 (22397 in chips) 
GARRRN: posts the ante 90
allex jacob: posts the ante 90
Ablon2012: posts the ante 90
jcarlos.vale: posts the ante 90
maxkenig: posts the ante 90
veto1975: posts the ante 90
stonywerner: posts the ante 90
Nichtlieb307: posts the ante 90
BARSS5588: posts the ante 90
stonywerner: posts small blind 600
Nichtlieb307: posts big blind 1200
*** HOLE CARDS ***
Dealt to jcarlos.vale [8s 3d]
BARSS5588: calls 1200
GARRRN: raises 2400 to 3600
allex jacob: folds 
Ablon2012: folds 
jcarlos.vale: folds 
maxkenig: folds 
veto1975: raises 33428 to 37028 and is all-in
stonywerner: folds 
Nichtlieb307: folds 
BARSS5588: calls 21107 and is all-in
GARRRN: folds 
Uncalled bet (14721) returned to veto1975
*** FLOP *** [Ac Kc Js]
*** TURN *** [Ac Kc Js] [6c]
*** RIVER *** [Ac Kc Js 6c] [3c]
*** SHOW DOWN ***
BARSS5588: shows [Kh Qd] (a pair of Kings)
veto1975: shows [As Kd] (two pair, Aces and Kings)
veto1975 collected 50824 from pot
BARSS5588 finished the tournament in 352nd place and received $1.18.
*** SUMMARY ***
Total pot 50824 | Rake 0 
Board [Ac Kc Js 6c 3c]
Seat 1: GARRRN folded before Flop
Seat 2: allex jacob folded before Flop (didn't bet)
Seat 3: Ablon2012 folded before Flop (didn't bet)
Seat 4: jcarlos.vale folded before Flop (didn't bet)
Seat 5: maxkenig folded before Flop (didn't bet)
Seat 6: veto1975 (button) showed [As Kd] and won (50824) with two pair, Aces and Kings
Seat 7: stonywerner (small blind) folded before Flop
Seat 8: Nichtlieb307 (big blind) folded before Flop
Seat 9: BARSS5588 showed [Kh Qd] and lost with a pair of Kings



PokerStars Hand #208301963865: Tournament #2779056951, $0.49+$0.06 USD Hold'em No Limit - Level XVIII (600/1200) - 2020/01/19 0:17:06 EET [2020/01/18 17:17:06 ET]
Table '2779056951 35' 9-max Seat #6 is the button
Seat 1: x-like-dotix (79457 in chips) 
Seat 2: assokappa788 (82007 in chips) 
Seat 3: jcarlos.vale (22210 in chips) 
Seat 4: capitaNMCBRE (37592 in chips) 
Seat 5: Vlk56 (18955 in chips) 
Seat 6: Petra. F.44 (16460 in chips) 
Seat 7: NAVI CARTER (8367 in chips) 
Seat 8: Johannkasi2222 (143273 in chips) 
Seat 9: 721339 71147 (18895 in chips) 
x-like-dotix: posts the ante 90
assokappa788: posts the ante 90
jcarlos.vale: posts the ante 90
capitaNMCBRE: posts the ante 90
Vlk56: posts the ante 90
Petra. F.44: posts the ante 90
NAVI CARTER: posts the ante 90
Johannkasi2222: posts the ante 90
721339 71147: posts the ante 90
NAVI CARTER: posts small blind 600
Johannkasi2222: posts big blind 1200
*** HOLE CARDS ***
Dealt to jcarlos.vale [9s 3d]
721339 71147: folds 
x-like-dotix: folds 
assokappa788: raises 1200 to 2400
jcarlos.vale: folds 
capitaNMCBRE: folds 
Vlk56: folds 
Petra. F.44: folds 
NAVI CARTER: folds 
Johannkasi2222: raises 140783 to 143183 and is all-in
assokappa788: folds 
Uncalled bet (140783) returned to Johannkasi2222
Johannkasi2222 collected 6210 from pot
*** SUMMARY ***
Total pot 6210 | Rake 0 
Seat 1: x-like-dotix folded before Flop (didn't bet)
Seat 2: assokappa788 folded before Flop
Seat 3: jcarlos.vale folded before Flop (didn't bet)
Seat 4: capitaNMCBRE folded before Flop (didn't bet)
Seat 5: Vlk56 folded before Flop (didn't bet)
Seat 6: Petra. F.44 (button) folded before Flop (didn't bet)
Seat 7: NAVI CARTER (small blind) folded before Flop
Seat 8: Johannkasi2222 (big blind) collected (6210)
Seat 9: 721339 71147 folded before Flop (didn't bet)



PokerStars Hand #208301979949: Tournament #2779056951, $0.49+$0.06 USD Hold'em No Limit - Level XVIII (600/1200) - 2020/01/19 0:17:33 EET [2020/01/18 17:17:33 ET]
Table '2779056951 35' 9-max Seat #7 is the button
Seat 1: x-like-dotix (79367 in chips) 
Seat 2: assokappa788 (79517 in chips) 
Seat 3: jcarlos.vale (22120 in chips) 
Seat 4: capitaNMCBRE (37502 in chips) 
Seat 5: Vlk56 (18865 in chips) 
Seat 6: Petra. F.44 (16370 in chips) 
Seat 7: NAVI CARTER (7677 in chips) 
Seat 8: Johannkasi2222 (146993 in chips) 
Seat 9: 721339 71147 (18805 in chips) 
x-like-dotix: posts the ante 90
assokappa788: posts the ante 90
jcarlos.vale: posts the ante 90
capitaNMCBRE: posts the ante 90
Vlk56: posts the ante 90
Petra. F.44: posts the ante 90
NAVI CARTER: posts the ante 90
Johannkasi2222: posts the ante 90
721339 71147: posts the ante 90
Johannkasi2222: posts small blind 600
721339 71147: posts big blind 1200
*** HOLE CARDS ***
Dealt to jcarlos.vale [5h Jc]
x-like-dotix: folds 
assokappa788: folds 
jcarlos.vale: folds 
capitaNMCBRE: folds 
Vlk56: calls 1200
Petra. F.44: calls 1200
NAVI CARTER: folds 
Johannkasi2222: folds 
721339 71147: raises 17515 to 18715 and is all-in
Vlk56: folds 
Petra. F.44: folds 
Uncalled bet (17515) returned to 721339 71147
721339 71147 collected 5010 from pot
721339 71147: doesn't show handDTO
*** SUMMARY ***
Total pot 5010 | Rake 0 
Seat 1: x-like-dotix folded before Flop (didn't bet)
Seat 2: assokappa788 folded before Flop (didn't bet)
Seat 3: jcarlos.vale folded before Flop (didn't bet)
Seat 4: capitaNMCBRE folded before Flop (didn't bet)
Seat 5: Vlk56 folded before Flop
Seat 6: Petra. F.44 folded before Flop
Seat 7: NAVI CARTER (button) folded before Flop (didn't bet)
Seat 8: Johannkasi2222 (small blind) folded before Flop
Seat 9: 721339 71147 (big blind) collected (5010)



PokerStars Hand #208302004935: Tournament #2779056951, $0.49+$0.06 USD Hold'em No Limit - Level XVIII (600/1200) - 2020/01/19 0:18:15 EET [2020/01/18 17:18:15 ET]
Table '2779056951 35' 9-max Seat #8 is the button
Seat 1: x-like-dotix (79277 in chips) 
Seat 2: assokappa788 (79427 in chips) 
Seat 3: jcarlos.vale (22030 in chips) 
Seat 4: capitaNMCBRE (37412 in chips) 
Seat 5: Vlk56 (17575 in chips) 
Seat 6: Petra. F.44 (15080 in chips) 
Seat 7: NAVI CARTER (7587 in chips) 
Seat 8: Johannkasi2222 (146303 in chips) 
Seat 9: 721339 71147 (22525 in chips) 
x-like-dotix: posts the ante 90
assokappa788: posts the ante 90
jcarlos.vale: posts the ante 90
capitaNMCBRE: posts the ante 90
Vlk56: posts the ante 90
Petra. F.44: posts the ante 90
NAVI CARTER: posts the ante 90
Johannkasi2222: posts the ante 90
721339 71147: posts the ante 90
721339 71147: posts small blind 600
x-like-dotix: posts big blind 1200
*** HOLE CARDS ***
Dealt to jcarlos.vale [5h Ad]
assokappa788: folds 
jcarlos.vale: folds 
capitaNMCBRE: raises 1420 to 2620
Vlk56: folds 
Petra. F.44: folds 
NAVI CARTER: folds 
Johannkasi2222: folds 
721339 71147: folds 
x-like-dotix: calls 1420
*** FLOP *** [2d 2h Td]
x-like-dotix: checks 
capitaNMCBRE: bets 2192
x-like-dotix: calls 2192
*** TURN *** [2d 2h Td] [7d]
x-like-dotix: checks 
capitaNMCBRE: checks 
*** RIVER *** [2d 2h Td 7d] [5d]
x-like-dotix: bets 4800
capitaNMCBRE: folds 
Uncalled bet (4800) returned to x-like-dotix
x-like-dotix collected 11034 from pot
x-like-dotix: doesn't show handDTO
*** SUMMARY ***
Total pot 11034 | Rake 0 
Board [2d 2h Td 7d 5d]
Seat 1: x-like-dotix (big blind) collected (11034)
Seat 2: assokappa788 folded before Flop (didn't bet)
Seat 3: jcarlos.vale folded before Flop (didn't bet)
Seat 4: capitaNMCBRE folded on the River
Seat 5: Vlk56 folded before Flop (didn't bet)
Seat 6: Petra. F.44 folded before Flop (didn't bet)
Seat 7: NAVI CARTER folded before Flop (didn't bet)
Seat 8: Johannkasi2222 (button) folded before Flop (didn't bet)
Seat 9: 721339 71147 (small blind) folded before Flop



PokerStars Hand #208302058414: Tournament #2779056951, $0.49+$0.06 USD Hold'em No Limit - Level XVIII (600/1200) - 2020/01/19 0:19:33 EET [2020/01/18 17:19:33 ET]
Table '2779056951 35' 9-max Seat #9 is the button
Seat 1: x-like-dotix (85409 in chips) 
Seat 2: assokappa788 (79337 in chips) 
Seat 3: jcarlos.vale (21940 in chips) 
Seat 4: capitaNMCBRE (32510 in chips) 
Seat 5: Vlk56 (17485 in chips) 
Seat 6: Petra. F.44 (14990 in chips) 
Seat 7: NAVI CARTER (7497 in chips) 
Seat 8: Johannkasi2222 (146213 in chips) 
Seat 9: 721339 71147 (21835 in chips) 
x-like-dotix: posts the ante 90
assokappa788: posts the ante 90
jcarlos.vale: posts the ante 90
capitaNMCBRE: posts the ante 90
Vlk56: posts the ante 90
Petra. F.44: posts the ante 90
NAVI CARTER: posts the ante 90
Johannkasi2222: posts the ante 90
721339 71147: posts the ante 90
x-like-dotix: posts small blind 600
assokappa788: posts big blind 1200
*** HOLE CARDS ***
Dealt to jcarlos.vale [Tc Jc]
jcarlos.vale: folds 
capitaNMCBRE: folds 
Vlk56: raises 3600 to 4800
Petra. F.44: folds 
NAVI CARTER: folds 
Johannkasi2222: folds 
721339 71147: folds 
x-like-dotix: folds 
assokappa788: calls 3600
*** FLOP *** [3d 8c 5s]
assokappa788: checks 
Vlk56: bets 12595 and is all-in
assokappa788: calls 12595
*** TURN *** [3d 8c 5s] [Jh]
*** RIVER *** [3d 8c 5s Jh] [Td]
*** SHOW DOWN ***
assokappa788: shows [4c 5h] (a pair of Fives)
Vlk56: shows [Ac As] (a pair of Aces)
Vlk56 collected 36200 from pot
*** SUMMARY ***
Total pot 36200 | Rake 0 
Board [3d 8c 5s Jh Td]
Seat 1: x-like-dotix (small blind) folded before Flop
Seat 2: assokappa788 (big blind) showed [4c 5h] and lost with a pair of Fives
Seat 3: jcarlos.vale folded before Flop (didn't bet)
Seat 4: capitaNMCBRE folded before Flop (didn't bet)
Seat 5: Vlk56 showed [Ac As] and won (36200) with a pair of Aces
Seat 6: Petra. F.44 folded before Flop (didn't bet)
Seat 7: NAVI CARTER folded before Flop (didn't bet)
Seat 8: Johannkasi2222 folded before Flop (didn't bet)
Seat 9: 721339 71147 (button) folded before Flop (didn't bet)



PokerStars Hand #208302093613: Tournament #2779056951, $0.49+$0.06 USD Hold'em No Limit - Level XVIII (600/1200) - 2020/01/19 0:20:32 EET [2020/01/18 17:20:32 ET]
Table '2779056951 35' 9-max Seat #1 is the button
Seat 1: x-like-dotix (84719 in chips) 
Seat 2: assokappa788 (61852 in chips) 
Seat 3: jcarlos.vale (21850 in chips) 
Seat 4: capitaNMCBRE (32420 in chips) 
Seat 5: Vlk56 (36200 in chips) 
Seat 6: Petra. F.44 (14900 in chips) 
Seat 7: NAVI CARTER (7407 in chips) 
Seat 8: Johannkasi2222 (146123 in chips) 
Seat 9: 721339 71147 (21745 in chips) 
x-like-dotix: posts the ante 90
assokappa788: posts the ante 90
jcarlos.vale: posts the ante 90
capitaNMCBRE: posts the ante 90
Vlk56: posts the ante 90
Petra. F.44: posts the ante 90
NAVI CARTER: posts the ante 90
Johannkasi2222: posts the ante 90
721339 71147: posts the ante 90
assokappa788: posts small blind 600
jcarlos.vale: posts big blind 1200
*** HOLE CARDS ***
Dealt to jcarlos.vale [7h 8d]
capitaNMCBRE: folds 
Vlk56: calls 1200
Petra. F.44: folds 
NAVI CARTER: folds 
Johannkasi2222: folds 
721339 71147: folds 
x-like-dotix: folds 
assokappa788: calls 600
jcarlos.vale: checks 
*** FLOP *** [Kc Qd 2c]
assokappa788: bets 1200
jcarlos.vale: folds 
Vlk56: raises 4800 to 6000
assokappa788: calls 4800
*** TURN *** [Kc Qd 2c] [9h]
assokappa788: checks 
Vlk56: bets 28910 and is all-in
assokappa788: calls 28910
*** RIVER *** [Kc Qd 2c 9h] [Qs]
*** SHOW DOWN ***
assokappa788: shows [Td Jd] (a straight, Nine to King)
Vlk56: shows [Jh Kd] (two pair, Kings and Queens)
assokappa788 collected 74230 from pot
Vlk56 finished the tournament in 320th place and received $1.18.
*** SUMMARY ***
Total pot 74230 | Rake 0 
Board [Kc Qd 2c 9h Qs]
Seat 1: x-like-dotix (button) folded before Flop (didn't bet)
Seat 2: assokappa788 (small blind) showed [Td Jd] and won (74230) with a straight, Nine to King
Seat 3: jcarlos.vale (big blind) folded on the Flop
Seat 4: capitaNMCBRE folded before Flop (didn't bet)
Seat 5: Vlk56 showed [Jh Kd] and lost with two pair, Kings and Queens
Seat 6: Petra. F.44 folded before Flop (didn't bet)
Seat 7: NAVI CARTER folded before Flop (didn't bet)
Seat 8: Johannkasi2222 folded before Flop (didn't bet)
Seat 9: 721339 71147 folded before Flop (didn't bet)



PokerStars Hand #208302143445: Tournament #2779056951, $0.49+$0.06 USD Hold'em No Limit - Level XIX (700/1400) - 2020/01/19 0:21:45 EET [2020/01/18 17:21:45 ET]
Table '2779056951 35' 9-max Seat #2 is the button
Seat 1: x-like-dotix (84629 in chips) 
Seat 2: assokappa788 (99882 in chips) 
Seat 3: jcarlos.vale (20560 in chips) 
Seat 4: capitaNMCBRE (32330 in chips) 
Seat 6: Petra. F.44 (14810 in chips) 
Seat 7: NAVI CARTER (7317 in chips) 
Seat 8: Johannkasi2222 (146033 in chips) 
Seat 9: 721339 71147 (21655 in chips) 
x-like-dotix: posts the ante 100
assokappa788: posts the ante 100
jcarlos.vale: posts the ante 100
capitaNMCBRE: posts the ante 100
Petra. F.44: posts the ante 100
NAVI CARTER: posts the ante 100
Johannkasi2222: posts the ante 100
721339 71147: posts the ante 100
jcarlos.vale: posts small blind 700
capitaNMCBRE: posts big blind 1400
*** HOLE CARDS ***
Dealt to jcarlos.vale [8c 2c]
Petra. F.44: folds 
NAVI CARTER: raises 5817 to 7217 and is all-in
Johannkasi2222: folds 
721339 71147: folds 
x-like-dotix: calls 7217
assokappa788: folds 
jcarlos.vale: folds 
capitaNMCBRE: folds 
*** FLOP *** [Jc 6h Jh]
*** TURN *** [Jc 6h Jh] [9d]
*** RIVER *** [Jc 6h Jh 9d] [Th]
*** SHOW DOWN ***
NAVI CARTER: shows [Qh Qs] (two pair, Queens and Jacks)
x-like-dotix: shows [Kc Ac] (a pair of Jacks)
NAVI CARTER collected 17334 from pot
*** SUMMARY ***
Total pot 17334 | Rake 0 
Board [Jc 6h Jh 9d Th]
Seat 1: x-like-dotix showed [Kc Ac] and lost with a pair of Jacks
Seat 2: assokappa788 (button) folded before Flop (didn't bet)
Seat 3: jcarlos.vale (small blind) folded before Flop
Seat 4: capitaNMCBRE (big blind) folded before Flop
Seat 6: Petra. F.44 folded before Flop (didn't bet)
Seat 7: NAVI CARTER showed [Qh Qs] and won (17334) with two pair, Queens and Jacks
Seat 8: Johannkasi2222 folded before Flop (didn't bet)
Seat 9: 721339 71147 folded before Flop (didn't bet)



PokerStars Hand #208302167688: Tournament #2779056951, $0.49+$0.06 USD Hold'em No Limit - Level XIX (700/1400) - 2020/01/19 0:22:26 EET [2020/01/18 17:22:26 ET]
Table '2779056951 35' 9-max Seat #3 is the button
Seat 1: x-like-dotix (77312 in chips) 
Seat 2: assokappa788 (99782 in chips) 
Seat 3: jcarlos.vale (19760 in chips) 
Seat 4: capitaNMCBRE (30830 in chips) 
Seat 5: qpAPMA3OH (99398 in chips) 
Seat 6: Petra. F.44 (14710 in chips) 
Seat 7: NAVI CARTER (17334 in chips) 
Seat 8: Johannkasi2222 (145933 in chips) 
Seat 9: 721339 71147 (21555 in chips) 
x-like-dotix: posts the ante 100
assokappa788: posts the ante 100
jcarlos.vale: posts the ante 100
capitaNMCBRE: posts the ante 100
qpAPMA3OH: posts the ante 100
Petra. F.44: posts the ante 100
NAVI CARTER: posts the ante 100
Johannkasi2222: posts the ante 100
721339 71147: posts the ante 100
capitaNMCBRE: posts small blind 700
qpAPMA3OH: posts big blind 1400
*** HOLE CARDS ***
Dealt to jcarlos.vale [Ah 5d]
Petra. F.44: folds 
NAVI CARTER: raises 15834 to 17234 and is all-in
Johannkasi2222: folds 
721339 71147: folds 
x-like-dotix: folds 
assokappa788: folds 
jcarlos.vale: folds 
capitaNMCBRE: folds 
qpAPMA3OH: folds 
Uncalled bet (15834) returned to NAVI CARTER
NAVI CARTER collected 4400 from pot
*** SUMMARY ***
Total pot 4400 | Rake 0 
Seat 1: x-like-dotix folded before Flop (didn't bet)
Seat 2: assokappa788 folded before Flop (didn't bet)
Seat 3: jcarlos.vale (button) folded before Flop (didn't bet)
Seat 4: capitaNMCBRE (small blind) folded before Flop
Seat 5: qpAPMA3OH (big blind) folded before Flop
Seat 6: Petra. F.44 folded before Flop (didn't bet)
Seat 7: NAVI CARTER collected (4400)
Seat 8: Johannkasi2222 folded before Flop (didn't bet)
Seat 9: 721339 71147 folded before Flop (didn't bet)



PokerStars Hand #208302175103: Tournament #2779056951, $0.49+$0.06 USD Hold'em No Limit - Level XIX (700/1400) - 2020/01/19 0:22:39 EET [2020/01/18 17:22:39 ET]
Table '2779056951 35' 9-max Seat #4 is the button
Seat 1: x-like-dotix (77212 in chips) 
Seat 2: assokappa788 (99682 in chips) 
Seat 3: jcarlos.vale (19660 in chips) 
Seat 4: capitaNMCBRE (30030 in chips) 
Seat 5: qpAPMA3OH (97898 in chips) 
Seat 6: Petra. F.44 (14610 in chips) 
Seat 7: NAVI CARTER (20234 in chips) 
Seat 8: Johannkasi2222 (145833 in chips) 
Seat 9: 721339 71147 (21455 in chips) 
x-like-dotix: posts the ante 100
assokappa788: posts the ante 100
jcarlos.vale: posts the ante 100
capitaNMCBRE: posts the ante 100
qpAPMA3OH: posts the ante 100
Petra. F.44: posts the ante 100
NAVI CARTER: posts the ante 100
Johannkasi2222: posts the ante 100
721339 71147: posts the ante 100
qpAPMA3OH: posts small blind 700
Petra. F.44: posts big blind 1400
*** HOLE CARDS ***
Dealt to jcarlos.vale [7d Qc]
NAVI CARTER: folds 
Johannkasi2222: folds 
721339 71147: folds 
x-like-dotix: raises 2100 to 3500
assokappa788: folds 
jcarlos.vale: folds 
capitaNMCBRE: folds 
qpAPMA3OH: calls 2800
Petra. F.44: folds 
*** FLOP *** [6s Td 9d]
qpAPMA3OH: checks 
x-like-dotix: bets 3080
qpAPMA3OH: calls 3080
*** TURN *** [6s Td 9d] [8s]
qpAPMA3OH: bets 8400
x-like-dotix: folds 
Uncalled bet (8400) returned to qpAPMA3OH
qpAPMA3OH collected 15460 from pot
qpAPMA3OH: doesn't show handDTO
*** SUMMARY ***
Total pot 15460 | Rake 0 
Board [6s Td 9d 8s]
Seat 1: x-like-dotix folded on the Turn
Seat 2: assokappa788 folded before Flop (didn't bet)
Seat 3: jcarlos.vale folded before Flop (didn't bet)
Seat 4: capitaNMCBRE (button) folded before Flop (didn't bet)
Seat 5: qpAPMA3OH (small blind) collected (15460)
Seat 6: Petra. F.44 (big blind) folded before Flop
Seat 7: NAVI CARTER folded before Flop (didn't bet)
Seat 8: Johannkasi2222 folded before Flop (didn't bet)
Seat 9: 721339 71147 folded before Flop (didn't bet)



PokerStars Hand #208302199079: Tournament #2779056951, $0.49+$0.06 USD Hold'em No Limit - Level XIX (700/1400) - 2020/01/19 0:23:19 EET [2020/01/18 17:23:19 ET]
Table '2779056951 35' 9-max Seat #5 is the button
Seat 1: x-like-dotix (70532 in chips) 
Seat 2: assokappa788 (99582 in chips) 
Seat 3: jcarlos.vale (19560 in chips) 
Seat 4: capitaNMCBRE (29930 in chips) 
Seat 5: qpAPMA3OH (106678 in chips) 
Seat 6: Petra. F.44 (13110 in chips) 
Seat 7: NAVI CARTER (20134 in chips) 
Seat 8: Johannkasi2222 (145733 in chips) 
Seat 9: 721339 71147 (21355 in chips) 
x-like-dotix: posts the ante 100
assokappa788: posts the ante 100
jcarlos.vale: posts the ante 100
capitaNMCBRE: posts the ante 100
qpAPMA3OH: posts the ante 100
Petra. F.44: posts the ante 100
NAVI CARTER: posts the ante 100
Johannkasi2222: posts the ante 100
721339 71147: posts the ante 100
Petra. F.44: posts small blind 700
NAVI CARTER: posts big blind 1400
*** HOLE CARDS ***
Dealt to jcarlos.vale [9h Kd]
Johannkasi2222: folds 
721339 71147: folds 
x-like-dotix: raises 2100 to 3500
assokappa788: folds 
jcarlos.vale: folds 
capitaNMCBRE: calls 3500
qpAPMA3OH: folds 
Petra. F.44: folds 
NAVI CARTER: folds 
*** FLOP *** [5d Ah Tc]
x-like-dotix: bets 3500
capitaNMCBRE: calls 3500
*** TURN *** [5d Ah Tc] [7d]
x-like-dotix: bets 8400
capitaNMCBRE: folds 
Uncalled bet (8400) returned to x-like-dotix
x-like-dotix collected 17000 from pot
x-like-dotix: doesn't show handDTO
*** SUMMARY ***
Total pot 17000 | Rake 0 
Board [5d Ah Tc 7d]
Seat 1: x-like-dotix collected (17000)
Seat 2: assokappa788 folded before Flop (didn't bet)
Seat 3: jcarlos.vale folded before Flop (didn't bet)
Seat 4: capitaNMCBRE folded on the Turn
Seat 5: qpAPMA3OH (button) folded before Flop (didn't bet)
Seat 6: Petra. F.44 (small blind) folded before Flop
Seat 7: NAVI CARTER (big blind) folded before Flop
Seat 8: Johannkasi2222 folded before Flop (didn't bet)
Seat 9: 721339 71147 folded before Flop (didn't bet)



PokerStars Hand #208302241629: Tournament #2779056951, $0.49+$0.06 USD Hold'em No Limit - Level XIX (700/1400) - 2020/01/19 0:24:31 EET [2020/01/18 17:24:31 ET]
Table '2779056951 35' 9-max Seat #6 is the button
Seat 1: x-like-dotix (80432 in chips) 
Seat 2: assokappa788 (99482 in chips) 
Seat 3: jcarlos.vale (19460 in chips) 
Seat 4: capitaNMCBRE (22830 in chips) 
Seat 5: qpAPMA3OH (106578 in chips) 
Seat 6: Petra. F.44 (12310 in chips) 
Seat 7: NAVI CARTER (18634 in chips) 
Seat 8: Johannkasi2222 (145633 in chips) 
Seat 9: 721339 71147 (21255 in chips) 
x-like-dotix: posts the ante 100
assokappa788: posts the ante 100
jcarlos.vale: posts the ante 100
capitaNMCBRE: posts the ante 100
qpAPMA3OH: posts the ante 100
Petra. F.44: posts the ante 100
NAVI CARTER: posts the ante 100
Johannkasi2222: posts the ante 100
721339 71147: posts the ante 100
NAVI CARTER: posts small blind 700
Johannkasi2222: posts big blind 1400
*** HOLE CARDS ***
Dealt to jcarlos.vale [9s Qh]
721339 71147: folds 
x-like-dotix: folds 
assokappa788 has timed out
assokappa788: folds 
assokappa788 is sitting out
jcarlos.vale: folds 
capitaNMCBRE: folds 
qpAPMA3OH: folds 
Petra. F.44: folds 
NAVI CARTER: raises 17134 to 18534 and is all-in
Johannkasi2222: calls 17134
*** FLOP *** [8c Ac 7s]
*** TURN *** [8c Ac 7s] [8d]
assokappa788 has returned
*** RIVER *** [8c Ac 7s 8d] [As]
*** SHOW DOWN ***
NAVI CARTER: shows [9c Jc] (two pair, Aces and Eights)
Johannkasi2222: shows [Tc Qc] (two pair, Aces and Eights - Queen kicker)
Johannkasi2222 collected 37968 from pot
NAVI CARTER finished the tournament in 292nd place and received $1.18.
*** SUMMARY ***
Total pot 37968 | Rake 0 
Board [8c Ac 7s 8d As]
Seat 1: x-like-dotix folded before Flop (didn't bet)
Seat 2: assokappa788 folded before Flop (didn't bet)
Seat 3: jcarlos.vale folded before Flop (didn't bet)
Seat 4: capitaNMCBRE folded before Flop (didn't bet)
Seat 5: qpAPMA3OH folded before Flop (didn't bet)
Seat 6: Petra. F.44 (button) folded before Flop (didn't bet)
Seat 7: NAVI CARTER (small blind) showed [9c Jc] and lost with two pair, Aces and Eights
Seat 8: Johannkasi2222 (big blind) showed [Tc Qc] and won (37968) with two pair, Aces and Eights
Seat 9: 721339 71147 folded before Flop (didn't bet)



PokerStars Hand #208302272969: Tournament #2779056951, $0.49+$0.06 USD Hold'em No Limit - Level XIX (700/1400) - 2020/01/19 0:25:25 EET [2020/01/18 17:25:25 ET]
Table '2779056951 35' 9-max Seat #8 is the button
Seat 1: x-like-dotix (80332 in chips) 
Seat 2: assokappa788 (99382 in chips) 
Seat 3: jcarlos.vale (19360 in chips) 
Seat 4: capitaNMCBRE (22730 in chips) 
Seat 5: qpAPMA3OH (106478 in chips) 
Seat 6: Petra. F.44 (12210 in chips) 
Seat 8: Johannkasi2222 (164967 in chips) 
Seat 9: 721339 71147 (21155 in chips) 
x-like-dotix: posts the ante 100
assokappa788: posts the ante 100
jcarlos.vale: posts the ante 100
capitaNMCBRE: posts the ante 100
qpAPMA3OH: posts the ante 100
Petra. F.44: posts the ante 100
Johannkasi2222: posts the ante 100
721339 71147: posts the ante 100
721339 71147: posts small blind 700
x-like-dotix: posts big blind 1400
*** HOLE CARDS ***
Dealt to jcarlos.vale [6s 7d]
assokappa788: folds 
jcarlos.vale: folds 
capitaNMCBRE: folds 
qpAPMA3OH: raises 2800 to 4200
Petra. F.44: folds 
Johannkasi2222: folds 
721339 71147: raises 16855 to 21055 and is all-in
x-like-dotix: folds 
qpAPMA3OH: calls 16855
*** FLOP *** [4d Ac Qc]
*** TURN *** [4d Ac Qc] [8s]
*** RIVER *** [4d Ac Qc 8s] [9d]
*** SHOW DOWN ***
721339 71147: shows [9h 9s] (three of a kind, Nines)
qpAPMA3OH: shows [Ts Ad] (a pair of Aces)
721339 71147 collected 44310 from pot
*** SUMMARY ***
Total pot 44310 | Rake 0 
Board [4d Ac Qc 8s 9d]
Seat 1: x-like-dotix (big blind) folded before Flop
Seat 2: assokappa788 folded before Flop (didn't bet)
Seat 3: jcarlos.vale folded before Flop (didn't bet)
Seat 4: capitaNMCBRE folded before Flop (didn't bet)
Seat 5: qpAPMA3OH showed [Ts Ad] and lost with a pair of Aces
Seat 6: Petra. F.44 folded before Flop (didn't bet)
Seat 8: Johannkasi2222 (button) folded before Flop (didn't bet)
Seat 9: 721339 71147 (small blind) showed [9h 9s] and won (44310) with three of a kind, Nines



PokerStars Hand #208302301990: Tournament #2779056951, $0.49+$0.06 USD Hold'em No Limit - Level XIX (700/1400) - 2020/01/19 0:26:14 EET [2020/01/18 17:26:14 ET]
Table '2779056951 35' 9-max Seat #9 is the button
Seat 1: x-like-dotix (78832 in chips) 
Seat 2: assokappa788 (99282 in chips) 
Seat 3: jcarlos.vale (19260 in chips) 
Seat 4: capitaNMCBRE (22630 in chips) 
Seat 5: qpAPMA3OH (85323 in chips) 
Seat 6: Petra. F.44 (12110 in chips) 
Seat 7: lallelyk'lig (53916 in chips) 
Seat 8: Johannkasi2222 (164867 in chips) 
Seat 9: 721339 71147 (44310 in chips) 
x-like-dotix: posts the ante 100
assokappa788: posts the ante 100
jcarlos.vale: posts the ante 100
capitaNMCBRE: posts the ante 100
qpAPMA3OH: posts the ante 100
Petra. F.44: posts the ante 100
lallelyk'lig: posts the ante 100
Johannkasi2222: posts the ante 100
721339 71147: posts the ante 100
x-like-dotix: posts small blind 700
assokappa788: posts big blind 1400
*** HOLE CARDS ***
Dealt to jcarlos.vale [5d Th]
jcarlos.vale: folds 
capitaNMCBRE: folds 
qpAPMA3OH: folds 
Petra. F.44: folds 
lallelyk'lig: folds 
Johannkasi2222: calls 1400
721339 71147: folds 
x-like-dotix: raises 4200 to 5600
assokappa788: calls 4200
Johannkasi2222: folds 
*** FLOP *** [7s Ts Qh]
x-like-dotix: bets 4900
assokappa788: calls 4900
*** TURN *** [7s Ts Qh] [8s]
x-like-dotix: bets 7000
assokappa788: folds 
Uncalled bet (7000) returned to x-like-dotix
x-like-dotix collected 23300 from pot
x-like-dotix: doesn't show handDTO
*** SUMMARY ***
Total pot 23300 | Rake 0 
Board [7s Ts Qh 8s]
Seat 1: x-like-dotix (small blind) collected (23300)
Seat 2: assokappa788 (big blind) folded on the Turn
Seat 3: jcarlos.vale folded before Flop (didn't bet)
Seat 4: capitaNMCBRE folded before Flop (didn't bet)
Seat 5: qpAPMA3OH folded before Flop (didn't bet)
Seat 6: Petra. F.44 folded before Flop (didn't bet)
Seat 7: lallelyk'lig folded before Flop (didn't bet)
Seat 8: Johannkasi2222 folded before Flop
Seat 9: 721339 71147 (button) folded before Flop (didn't bet)



PokerStars Hand #208302336907: Tournament #2779056951, $0.49+$0.06 USD Hold'em No Limit - Level XIX (700/1400) - 2020/01/19 0:27:15 EET [2020/01/18 17:27:15 ET]
Table '2779056951 35' 9-max Seat #1 is the button
Seat 1: x-like-dotix (91532 in chips) 
Seat 2: assokappa788 (88682 in chips) 
Seat 3: jcarlos.vale (19160 in chips) 
Seat 4: capitaNMCBRE (22530 in chips) 
Seat 5: qpAPMA3OH (85223 in chips) 
Seat 6: Petra. F.44 (12010 in chips) 
Seat 7: lallelyk'lig (53816 in chips) 
Seat 8: Johannkasi2222 (163367 in chips) 
Seat 9: 721339 71147 (44210 in chips) 
x-like-dotix: posts the ante 100
assokappa788: posts the ante 100
jcarlos.vale: posts the ante 100
capitaNMCBRE: posts the ante 100
qpAPMA3OH: posts the ante 100
Petra. F.44: posts the ante 100
lallelyk'lig: posts the ante 100
Johannkasi2222: posts the ante 100
721339 71147: posts the ante 100
assokappa788: posts small blind 700
jcarlos.vale: posts big blind 1400
*** HOLE CARDS ***
Dealt to jcarlos.vale [4c Kd]
capitaNMCBRE: folds 
qpAPMA3OH: folds 
Petra. F.44: folds 
lallelyk'lig: folds 
Johannkasi2222: folds 
721339 71147: raises 1680 to 3080
x-like-dotix: folds 
assokappa788: folds 
jcarlos.vale: folds 
Uncalled bet (1680) returned to 721339 71147
721339 71147 collected 4400 from pot
721339 71147: doesn't show handDTO
*** SUMMARY ***
Total pot 4400 | Rake 0 
Seat 1: x-like-dotix (button) folded before Flop (didn't bet)
Seat 2: assokappa788 (small blind) folded before Flop
Seat 3: jcarlos.vale (big blind) folded before Flop
Seat 4: capitaNMCBRE folded before Flop (didn't bet)
Seat 5: qpAPMA3OH folded before Flop (didn't bet)
Seat 6: Petra. F.44 folded before Flop (didn't bet)
Seat 7: lallelyk'lig folded before Flop (didn't bet)
Seat 8: Johannkasi2222 folded before Flop (didn't bet)
Seat 9: 721339 71147 collected (4400)



PokerStars Hand #208302366565: Tournament #2779056951, $0.49+$0.06 USD Hold'em No Limit - Level XIX (700/1400) - 2020/01/19 0:27:49 EET [2020/01/18 17:27:49 ET]
Table '2779056951 35' 9-max Seat #2 is the button
Seat 1: x-like-dotix (91432 in chips) 
Seat 2: assokappa788 (87882 in chips) 
Seat 3: jcarlos.vale (17660 in chips) 
Seat 4: capitaNMCBRE (22430 in chips) 
Seat 5: qpAPMA3OH (85123 in chips) 
Seat 6: Petra. F.44 (11910 in chips) 
Seat 7: lallelyk'lig (53716 in chips) 
Seat 8: Johannkasi2222 (163267 in chips) 
Seat 9: 721339 71147 (47110 in chips) 
x-like-dotix: posts the ante 100
assokappa788: posts the ante 100
jcarlos.vale: posts the ante 100
capitaNMCBRE: posts the ante 100
qpAPMA3OH: posts the ante 100
Petra. F.44: posts the ante 100
lallelyk'lig: posts the ante 100
Johannkasi2222: posts the ante 100
721339 71147: posts the ante 100
jcarlos.vale: posts small blind 700
capitaNMCBRE: posts big blind 1400
*** HOLE CARDS ***
Dealt to jcarlos.vale [Ac Ad]
qpAPMA3OH: folds 
Petra. F.44: folds 
lallelyk'lig: folds 
Johannkasi2222: folds 
721339 71147: folds 
x-like-dotix: folds 
assokappa788: raises 86382 to 87782 and is all-in
jcarlos.vale: calls 16860 and is all-in
capitaNMCBRE: folds 
Uncalled bet (70222) returned to assokappa788
*** FLOP *** [4s Jd 8d]
*** TURN *** [4s Jd 8d] [8s]
*** RIVER *** [4s Jd 8d 8s] [9s]
*** SHOW DOWN ***
jcarlos.vale: shows [Ac Ad] (two pair, Aces and Eights)
assokappa788: shows [As 6d] (a pair of Eights)
jcarlos.vale collected 37420 from pot
*** SUMMARY ***
Total pot 37420 | Rake 0 
Board [4s Jd 8d 8s 9s]
Seat 1: x-like-dotix folded before Flop (didn't bet)
Seat 2: assokappa788 (button) showed [As 6d] and lost with a pair of Eights
Seat 3: jcarlos.vale (small blind) showed [Ac Ad] and won (37420) with two pair, Aces and Eights
Seat 4: capitaNMCBRE (big blind) folded before Flop
Seat 5: qpAPMA3OH folded before Flop (didn't bet)
Seat 6: Petra. F.44 folded before Flop (didn't bet)
Seat 7: lallelyk'lig folded before Flop (didn't bet)
Seat 8: Johannkasi2222 folded before Flop (didn't bet)
Seat 9: 721339 71147 folded before Flop (didn't bet)



PokerStars Hand #208302388600: Tournament #2779056951, $0.49+$0.06 USD Hold'em No Limit - Level XIX (700/1400) - 2020/01/19 0:28:27 EET [2020/01/18 17:28:27 ET]
Table '2779056951 35' 9-max Seat #3 is the button
Seat 1: x-like-dotix (91332 in chips) 
Seat 2: assokappa788 (70222 in chips) 
Seat 3: jcarlos.vale (37420 in chips) 
Seat 4: capitaNMCBRE (20930 in chips) 
Seat 5: qpAPMA3OH (85023 in chips) 
Seat 6: Petra. F.44 (11810 in chips) 
Seat 7: lallelyk'lig (53616 in chips) 
Seat 8: Johannkasi2222 (163167 in chips) 
Seat 9: 721339 71147 (47010 in chips) 
x-like-dotix: posts the ante 100
assokappa788: posts the ante 100
jcarlos.vale: posts the ante 100
capitaNMCBRE: posts the ante 100
qpAPMA3OH: posts the ante 100
Petra. F.44: posts the ante 100
lallelyk'lig: posts the ante 100
Johannkasi2222: posts the ante 100
721339 71147: posts the ante 100
capitaNMCBRE: posts small blind 700
qpAPMA3OH: posts big blind 1400
*** HOLE CARDS ***
Dealt to jcarlos.vale [8d Tc]
Petra. F.44: folds 
lallelyk'lig: folds 
Johannkasi2222: folds 
721339 71147: folds 
x-like-dotix: folds 
assokappa788: raises 1400 to 2800
jcarlos.vale: folds 
capitaNMCBRE: folds 
qpAPMA3OH: folds 
Uncalled bet (1400) returned to assokappa788
assokappa788 collected 4400 from pot
assokappa788: doesn't show handDTO
*** SUMMARY ***
Total pot 4400 | Rake 0 
Seat 1: x-like-dotix folded before Flop (didn't bet)
Seat 2: assokappa788 collected (4400)
Seat 3: jcarlos.vale (button) folded before Flop (didn't bet)
Seat 4: capitaNMCBRE (small blind) folded before Flop
Seat 5: qpAPMA3OH (big blind) folded before Flop
Seat 6: Petra. F.44 folded before Flop (didn't bet)
Seat 7: lallelyk'lig folded before Flop (didn't bet)
Seat 8: Johannkasi2222 folded before Flop (didn't bet)
Seat 9: 721339 71147 folded before Flop (didn't bet)



PokerStars Hand #208302404036: Tournament #2779056951, $0.49+$0.06 USD Hold'em No Limit - Level XIX (700/1400) - 2020/01/19 0:28:54 EET [2020/01/18 17:28:54 ET]
Table '2779056951 35' 9-max Seat #4 is the button
Seat 1: x-like-dotix (91232 in chips) 
Seat 2: assokappa788 (73122 in chips) 
Seat 3: jcarlos.vale (37320 in chips) 
Seat 4: capitaNMCBRE (20130 in chips) 
Seat 5: qpAPMA3OH (83523 in chips) 
Seat 6: Petra. F.44 (11710 in chips) 
Seat 7: lallelyk'lig (53516 in chips) 
Seat 8: Johannkasi2222 (163067 in chips) 
Seat 9: 721339 71147 (46910 in chips) 
x-like-dotix: posts the ante 100
assokappa788: posts the ante 100
jcarlos.vale: posts the ante 100
capitaNMCBRE: posts the ante 100
qpAPMA3OH: posts the ante 100
Petra. F.44: posts the ante 100
lallelyk'lig: posts the ante 100
Johannkasi2222: posts the ante 100
721339 71147: posts the ante 100
qpAPMA3OH: posts small blind 700
Petra. F.44: posts big blind 1400
*** HOLE CARDS ***
Dealt to jcarlos.vale [Kd Qh]
lallelyk'lig: folds 
Johannkasi2222: folds 
721339 71147: folds 
x-like-dotix: folds 
assokappa788: raises 1400 to 2800
jcarlos.vale: calls 2800
capitaNMCBRE: folds 
qpAPMA3OH: folds 
Petra. F.44: calls 1400
*** FLOP *** [Ks Kc Ah]
Petra. F.44: checks 
assokappa788: bets 2800
jcarlos.vale: calls 2800
Petra. F.44: folds 
*** TURN *** [Ks Kc Ah] [8s]
assokappa788: checks 
jcarlos.vale: bets 4200
assokappa788: folds 
Uncalled bet (4200) returned to jcarlos.vale
jcarlos.vale collected 15600 from pot
jcarlos.vale: doesn't show handDTO
*** SUMMARY ***
Total pot 15600 | Rake 0 
Board [Ks Kc Ah 8s]
Seat 1: x-like-dotix folded before Flop (didn't bet)
Seat 2: assokappa788 folded on the Turn
Seat 3: jcarlos.vale collected (15600)
Seat 4: capitaNMCBRE (button) folded before Flop (didn't bet)
Seat 5: qpAPMA3OH (small blind) folded before Flop
Seat 6: Petra. F.44 (big blind) folded on the Flop
Seat 7: lallelyk'lig folded before Flop (didn't bet)
Seat 8: Johannkasi2222 folded before Flop (didn't bet)
Seat 9: 721339 71147 folded before Flop (didn't bet)



PokerStars Hand #208302435427: Tournament #2779056951, $0.49+$0.06 USD Hold'em No Limit - Level XIX (700/1400) - 2020/01/19 0:29:48 EET [2020/01/18 17:29:48 ET]
Table '2779056951 35' 9-max Seat #5 is the button
Seat 1: x-like-dotix (91132 in chips) 
Seat 2: assokappa788 (67422 in chips) 
Seat 3: jcarlos.vale (47220 in chips) 
Seat 4: capitaNMCBRE (20030 in chips) 
Seat 5: qpAPMA3OH (82723 in chips) 
Seat 6: Petra. F.44 (8810 in chips) 
Seat 7: lallelyk'lig (53416 in chips) 
Seat 8: Johannkasi2222 (162967 in chips) 
Seat 9: 721339 71147 (46810 in chips) 
x-like-dotix: posts the ante 100
assokappa788: posts the ante 100
jcarlos.vale: posts the ante 100
capitaNMCBRE: posts the ante 100
qpAPMA3OH: posts the ante 100
Petra. F.44: posts the ante 100
lallelyk'lig: posts the ante 100
Johannkasi2222: posts the ante 100
721339 71147: posts the ante 100
Petra. F.44: posts small blind 700
lallelyk'lig: posts big blind 1400
*** HOLE CARDS ***
Dealt to jcarlos.vale [2c Kd]
Johannkasi2222: folds 
721339 71147: raises 1680 to 3080
x-like-dotix: folds 
assokappa788: folds 
jcarlos.vale: folds 
capitaNMCBRE: folds 
qpAPMA3OH: folds 
Petra. F.44: folds 
lallelyk'lig: folds 
Uncalled bet (1680) returned to 721339 71147
721339 71147 collected 4400 from pot
721339 71147: doesn't show handDTO
*** SUMMARY ***
Total pot 4400 | Rake 0 
Seat 1: x-like-dotix folded before Flop (didn't bet)
Seat 2: assokappa788 folded before Flop (didn't bet)
Seat 3: jcarlos.vale folded before Flop (didn't bet)
Seat 4: capitaNMCBRE folded before Flop (didn't bet)
Seat 5: qpAPMA3OH (button) folded before Flop (didn't bet)
Seat 6: Petra. F.44 (small blind) folded before Flop
Seat 7: lallelyk'lig (big blind) folded before Flop
Seat 8: Johannkasi2222 folded before Flop (didn't bet)
Seat 9: 721339 71147 collected (4400)



PokerStars Hand #208302453150: Tournament #2779056951, $0.49+$0.06 USD Hold'em No Limit - Level XIX (700/1400) - 2020/01/19 0:30:18 EET [2020/01/18 17:30:18 ET]
Table '2779056951 35' 9-max Seat #6 is the button
Seat 1: x-like-dotix (91032 in chips) 
Seat 2: assokappa788 (67322 in chips) 
Seat 3: jcarlos.vale (47120 in chips) 
Seat 4: capitaNMCBRE (19930 in chips) 
Seat 5: qpAPMA3OH (82623 in chips) 
Seat 6: Petra. F.44 (8010 in chips) 
Seat 7: lallelyk'lig (51916 in chips) 
Seat 8: Johannkasi2222 (162867 in chips) 
Seat 9: 721339 71147 (49710 in chips) 
x-like-dotix: posts the ante 100
assokappa788: posts the ante 100
jcarlos.vale: posts the ante 100
capitaNMCBRE: posts the ante 100
qpAPMA3OH: posts the ante 100
Petra. F.44: posts the ante 100
lallelyk'lig: posts the ante 100
Johannkasi2222: posts the ante 100
721339 71147: posts the ante 100
lallelyk'lig: posts small blind 700
Johannkasi2222: posts big blind 1400
*** HOLE CARDS ***
Dealt to jcarlos.vale [6s 3h]
721339 71147: raises 1680 to 3080
x-like-dotix: folds 
assokappa788 has timed out
assokappa788: folds 
assokappa788 is sitting out
jcarlos.vale: folds 
capitaNMCBRE: folds 
qpAPMA3OH: folds 
Petra. F.44: folds 
lallelyk'lig: folds 
Johannkasi2222: calls 1680
*** FLOP *** [4s 4h 7c]
Johannkasi2222: checks 
721339 71147: checks 
*** TURN *** [4s 4h 7c] [7d]
Johannkasi2222: checks 
721339 71147: bets 3850
Johannkasi2222: folds 
Uncalled bet (3850) returned to 721339 71147
721339 71147 collected 7760 from pot
721339 71147: doesn't show handDTO
*** SUMMARY ***
Total pot 7760 | Rake 0 
Board [4s 4h 7c 7d]
Seat 1: x-like-dotix folded before Flop (didn't bet)
Seat 2: assokappa788 folded before Flop (didn't bet)
Seat 3: jcarlos.vale folded before Flop (didn't bet)
Seat 4: capitaNMCBRE folded before Flop (didn't bet)
Seat 5: qpAPMA3OH folded before Flop (didn't bet)
Seat 6: Petra. F.44 (button) folded before Flop (didn't bet)
Seat 7: lallelyk'lig (small blind) folded before Flop
Seat 8: Johannkasi2222 (big blind) folded on the Turn
Seat 9: 721339 71147 collected (7760)



PokerStars Hand #208302492387: Tournament #2779056951, $0.49+$0.06 USD Hold'em No Limit - Level XX (800/1600) - 2020/01/19 0:31:25 EET [2020/01/18 17:31:25 ET]
Table '2779056951 35' 9-max Seat #7 is the button
Seat 1: x-like-dotix (90932 in chips) 
Seat 2: assokappa788 (67222 in chips) is sitting out
Seat 3: jcarlos.vale (47020 in chips) 
Seat 4: capitaNMCBRE (19830 in chips) 
Seat 5: qpAPMA3OH (82523 in chips) 
Seat 6: Petra. F.44 (7910 in chips) 
Seat 7: lallelyk'lig (51116 in chips) 
Seat 8: Johannkasi2222 (159687 in chips) 
Seat 9: 721339 71147 (54290 in chips) 
x-like-dotix: posts the ante 125
assokappa788: posts the ante 125
jcarlos.vale: posts the ante 125
capitaNMCBRE: posts the ante 125
qpAPMA3OH: posts the ante 125
Petra. F.44: posts the ante 125
lallelyk'lig: posts the ante 125
Johannkasi2222: posts the ante 125
721339 71147: posts the ante 125
Johannkasi2222: posts small blind 800
721339 71147: posts big blind 1600
*** HOLE CARDS ***
Dealt to jcarlos.vale [Jh Ad]
x-like-dotix: folds 
assokappa788: folds 
jcarlos.vale: raises 1760 to 3360
capitaNMCBRE: folds 
qpAPMA3OH: folds 
Petra. F.44: folds 
lallelyk'lig: calls 3360
Johannkasi2222: folds 
721339 71147: calls 1760
*** FLOP *** [Jd Kc 9d]
assokappa788 has returned
721339 71147: checks 
jcarlos.vale: bets 4800
lallelyk'lig: calls 4800
721339 71147: calls 4800
*** TURN *** [Jd Kc 9d] [Qh]
721339 71147: checks 
jcarlos.vale: bets 4800
lallelyk'lig: raises 38031 to 42831 and is all-in
721339 71147: folds 
jcarlos.vale: folds 
Uncalled bet (38031) returned to lallelyk'lig
lallelyk'lig collected 36005 from pot
lallelyk'lig: doesn't show handDTO
*** SUMMARY ***
Total pot 36005 | Rake 0 
Board [Jd Kc 9d Qh]
Seat 1: x-like-dotix folded before Flop (didn't bet)
Seat 2: assokappa788 folded before Flop (didn't bet)
Seat 3: jcarlos.vale folded on the Turn
Seat 4: capitaNMCBRE folded before Flop (didn't bet)
Seat 5: qpAPMA3OH folded before Flop (didn't bet)
Seat 6: Petra. F.44 folded before Flop (didn't bet)
Seat 7: lallelyk'lig (button) collected (36005)
Seat 8: Johannkasi2222 (small blind) folded before Flop
Seat 9: 721339 71147 (big blind) folded on the Turn



PokerStars Hand #208302534950: Tournament #2779056951, $0.49+$0.06 USD Hold'em No Limit - Level XX (800/1600) - 2020/01/19 0:32:38 EET [2020/01/18 17:32:38 ET]
Table '2779056951 35' 9-max Seat #8 is the button
Seat 1: x-like-dotix (90807 in chips) 
Seat 2: assokappa788 (67097 in chips) 
Seat 3: jcarlos.vale (33935 in chips) 
Seat 4: capitaNMCBRE (19705 in chips) 
Seat 5: qpAPMA3OH (82398 in chips) 
Seat 6: Petra. F.44 (7785 in chips) 
Seat 7: lallelyk'lig (74036 in chips) 
Seat 8: Johannkasi2222 (158762 in chips) 
Seat 9: 721339 71147 (46005 in chips) 
x-like-dotix: posts the ante 125
assokappa788: posts the ante 125
jcarlos.vale: posts the ante 125
capitaNMCBRE: posts the ante 125
qpAPMA3OH: posts the ante 125
Petra. F.44: posts the ante 125
lallelyk'lig: posts the ante 125
Johannkasi2222: posts the ante 125
721339 71147: posts the ante 125
721339 71147: posts small blind 800
x-like-dotix: posts big blind 1600
*** HOLE CARDS ***
Dealt to jcarlos.vale [Kh 2s]
assokappa788: calls 1600
jcarlos.vale: folds 
capitaNMCBRE: folds 
qpAPMA3OH: folds 
Petra. F.44: folds 
lallelyk'lig: folds 
Johannkasi2222: folds 
721339 71147: calls 800
x-like-dotix: checks 
*** FLOP *** [8h Qc 5d]
721339 71147: checks 
x-like-dotix: checks 
assokappa788: bets 3200
721339 71147: calls 3200
x-like-dotix: folds 
*** TURN *** [8h Qc 5d] [Th]
721339 71147: checks 
assokappa788: checks 
*** RIVER *** [8h Qc 5d Th] [Qs]
721339 71147: checks 
assokappa788: bets 6400
721339 71147: folds 
Uncalled bet (6400) returned to assokappa788
assokappa788 collected 12325 from pot
assokappa788: doesn't show handDTO
*** SUMMARY ***
Total pot 12325 | Rake 0 
Board [8h Qc 5d Th Qs]
Seat 1: x-like-dotix (big blind) folded on the Flop
Seat 2: assokappa788 collected (12325)
Seat 3: jcarlos.vale folded before Flop (didn't bet)
Seat 4: capitaNMCBRE folded before Flop (didn't bet)
Seat 5: qpAPMA3OH folded before Flop (didn't bet)
Seat 6: Petra. F.44 folded before Flop (didn't bet)
Seat 7: lallelyk'lig folded before Flop (didn't bet)
Seat 8: Johannkasi2222 (button) folded before Flop (didn't bet)
Seat 9: 721339 71147 (small blind) folded on the River



PokerStars Hand #208302572640: Tournament #2779056951, $0.49+$0.06 USD Hold'em No Limit - Level XX (800/1600) - 2020/01/19 0:33:44 EET [2020/01/18 17:33:44 ET]
Table '2779056951 35' 9-max Seat #9 is the button
Seat 1: x-like-dotix (89082 in chips) 
Seat 2: assokappa788 (74497 in chips) 
Seat 3: jcarlos.vale (33810 in chips) 
Seat 4: capitaNMCBRE (19580 in chips) 
Seat 5: qpAPMA3OH (82273 in chips) 
Seat 6: Petra. F.44 (7660 in chips) 
Seat 7: lallelyk'lig (73911 in chips) 
Seat 8: Johannkasi2222 (158637 in chips) 
Seat 9: 721339 71147 (41080 in chips) 
x-like-dotix: posts the ante 125
assokappa788: posts the ante 125
jcarlos.vale: posts the ante 125
capitaNMCBRE: posts the ante 125
qpAPMA3OH: posts the ante 125
Petra. F.44: posts the ante 125
lallelyk'lig: posts the ante 125
Johannkasi2222: posts the ante 125
721339 71147: posts the ante 125
x-like-dotix: posts small blind 800
assokappa788: posts big blind 1600
*** HOLE CARDS ***
Dealt to jcarlos.vale [As 9s]
jcarlos.vale: folds 
capitaNMCBRE: folds 
qpAPMA3OH: folds 
Petra. F.44: folds 
lallelyk'lig: folds 
Johannkasi2222: folds 
721339 71147: folds 
x-like-dotix: folds 
Uncalled bet (800) returned to assokappa788
assokappa788 collected 2725 from pot
assokappa788: doesn't show handDTO
*** SUMMARY ***
Total pot 2725 | Rake 0 
Seat 1: x-like-dotix (small blind) folded before Flop
Seat 2: assokappa788 (big blind) collected (2725)
Seat 3: jcarlos.vale folded before Flop (didn't bet)
Seat 4: capitaNMCBRE folded before Flop (didn't bet)
Seat 5: qpAPMA3OH folded before Flop (didn't bet)
Seat 6: Petra. F.44 folded before Flop (didn't bet)
Seat 7: lallelyk'lig folded before Flop (didn't bet)
Seat 8: Johannkasi2222 folded before Flop (didn't bet)
Seat 9: 721339 71147 (button) folded before Flop (didn't bet)



PokerStars Hand #208302593566: Tournament #2779056951, $0.49+$0.06 USD Hold'em No Limit - Level XX (800/1600) - 2020/01/19 0:34:20 EET [2020/01/18 17:34:20 ET]
Table '2779056951 35' 9-max Seat #1 is the button
Seat 1: x-like-dotix (88157 in chips) 
Seat 2: assokappa788 (76297 in chips) 
Seat 3: jcarlos.vale (33685 in chips) 
Seat 4: capitaNMCBRE (19455 in chips) 
Seat 5: qpAPMA3OH (82148 in chips) 
Seat 6: Petra. F.44 (7535 in chips) 
Seat 7: lallelyk'lig (73786 in chips) 
Seat 8: Johannkasi2222 (158512 in chips) 
Seat 9: 721339 71147 (40955 in chips) 
x-like-dotix: posts the ante 125
assokappa788: posts the ante 125
jcarlos.vale: posts the ante 125
capitaNMCBRE: posts the ante 125
qpAPMA3OH: posts the ante 125
Petra. F.44: posts the ante 125
lallelyk'lig: posts the ante 125
Johannkasi2222: posts the ante 125
721339 71147: posts the ante 125
assokappa788: posts small blind 800
jcarlos.vale: posts big blind 1600
*** HOLE CARDS ***
Dealt to jcarlos.vale [Kh Td]
capitaNMCBRE: folds 
qpAPMA3OH: folds 
Petra. F.44: raises 5810 to 7410 and is all-in
lallelyk'lig: folds 
Johannkasi2222: folds 
721339 71147: folds 
x-like-dotix: calls 7410
assokappa788: folds 
jcarlos.vale: folds 
*** FLOP *** [Tc Kd 3h]
*** TURN *** [Tc Kd 3h] [8s]
*** RIVER *** [Tc Kd 3h 8s] [7d]
*** SHOW DOWN ***
Petra. F.44: shows [Th Jc] (a pair of Tens)
x-like-dotix: shows [5h Ah] (high pairOfCards Ace)
Petra. F.44 collected 18345 from pot
*** SUMMARY ***
Total pot 18345 | Rake 0 
Board [Tc Kd 3h 8s 7d]
Seat 1: x-like-dotix (button) showed [5h Ah] and lost with high pairOfCards Ace
Seat 2: assokappa788 (small blind) folded before Flop
Seat 3: jcarlos.vale (big blind) folded before Flop
Seat 4: capitaNMCBRE folded before Flop (didn't bet)
Seat 5: qpAPMA3OH folded before Flop (didn't bet)
Seat 6: Petra. F.44 showed [Th Jc] and won (18345) with a pair of Tens
Seat 7: lallelyk'lig folded before Flop (didn't bet)
Seat 8: Johannkasi2222 folded before Flop (didn't bet)
Seat 9: 721339 71147 folded before Flop (didn't bet)



PokerStars Hand #208302610181: Tournament #2779056951, $0.49+$0.06 USD Hold'em No Limit - Level XX (800/1600) - 2020/01/19 0:34:49 EET [2020/01/18 17:34:49 ET]
Table '2779056951 35' 9-max Seat #2 is the button
Seat 1: x-like-dotix (80622 in chips) 
Seat 2: assokappa788 (75372 in chips) 
Seat 3: jcarlos.vale (31960 in chips) 
Seat 4: capitaNMCBRE (19330 in chips) 
Seat 5: qpAPMA3OH (82023 in chips) 
Seat 6: Petra. F.44 (18345 in chips) 
Seat 7: lallelyk'lig (73661 in chips) 
Seat 8: Johannkasi2222 (158387 in chips) 
Seat 9: 721339 71147 (40830 in chips) 
x-like-dotix: posts the ante 125
assokappa788: posts the ante 125
jcarlos.vale: posts the ante 125
capitaNMCBRE: posts the ante 125
qpAPMA3OH: posts the ante 125
Petra. F.44: posts the ante 125
lallelyk'lig: posts the ante 125
Johannkasi2222: posts the ante 125
721339 71147: posts the ante 125
jcarlos.vale: posts small blind 800
capitaNMCBRE: posts big blind 1600
*** HOLE CARDS ***
Dealt to jcarlos.vale [Ah 8h]
qpAPMA3OH: raises 5125 to 6725
Petra. F.44: folds 
lallelyk'lig: folds 
Johannkasi2222: folds 
721339 71147: folds 
x-like-dotix: folds 
assokappa788: folds 
jcarlos.vale: folds 
capitaNMCBRE: folds 
Uncalled bet (5125) returned to qpAPMA3OH
qpAPMA3OH collected 5125 from pot
qpAPMA3OH: doesn't show handDTO
*** SUMMARY ***
Total pot 5125 | Rake 0 
Seat 1: x-like-dotix folded before Flop (didn't bet)
Seat 2: assokappa788 (button) folded before Flop (didn't bet)
Seat 3: jcarlos.vale (small blind) folded before Flop
Seat 4: capitaNMCBRE (big blind) folded before Flop
Seat 5: qpAPMA3OH collected (5125)
Seat 6: Petra. F.44 folded before Flop (didn't bet)
Seat 7: lallelyk'lig folded before Flop (didn't bet)
Seat 8: Johannkasi2222 folded before Flop (didn't bet)
Seat 9: 721339 71147 folded before Flop (didn't bet)



PokerStars Hand #208302625864: Tournament #2779056951, $0.49+$0.06 USD Hold'em No Limit - Level XX (800/1600) - 2020/01/19 0:35:16 EET [2020/01/18 17:35:16 ET]
Table '2779056951 35' 9-max Seat #3 is the button
Seat 1: x-like-dotix (80497 in chips) 
Seat 2: assokappa788 (75247 in chips) 
Seat 3: jcarlos.vale (31035 in chips) 
Seat 4: capitaNMCBRE (17605 in chips) 
Seat 5: qpAPMA3OH (85423 in chips) 
Seat 6: Petra. F.44 (18220 in chips) 
Seat 7: lallelyk'lig (73536 in chips) 
Seat 8: Johannkasi2222 (158262 in chips) 
Seat 9: 721339 71147 (40705 in chips) 
x-like-dotix: posts the ante 125
assokappa788: posts the ante 125
jcarlos.vale: posts the ante 125
capitaNMCBRE: posts the ante 125
qpAPMA3OH: posts the ante 125
Petra. F.44: posts the ante 125
lallelyk'lig: posts the ante 125
Johannkasi2222: posts the ante 125
721339 71147: posts the ante 125
capitaNMCBRE: posts small blind 800
qpAPMA3OH: posts big blind 1600
*** HOLE CARDS ***
Dealt to jcarlos.vale [5s 3c]
Petra. F.44: folds 
lallelyk'lig: folds 
Johannkasi2222: folds 
721339 71147: folds 
x-like-dotix: folds 
assokappa788: raises 1600 to 3200
jcarlos.vale: folds 
capitaNMCBRE: folds 
qpAPMA3OH: calls 1600
*** FLOP *** [8s Kc Kd]
qpAPMA3OH: checks 
assokappa788: bets 3200
qpAPMA3OH: folds 
Uncalled bet (3200) returned to assokappa788
assokappa788 collected 8325 from pot
assokappa788: doesn't show handDTO
*** SUMMARY ***
Total pot 8325 | Rake 0 
Board [8s Kc Kd]
Seat 1: x-like-dotix folded before Flop (didn't bet)
Seat 2: assokappa788 collected (8325)
Seat 3: jcarlos.vale (button) folded before Flop (didn't bet)
Seat 4: capitaNMCBRE (small blind) folded before Flop
Seat 5: qpAPMA3OH (big blind) folded on the Flop
Seat 6: Petra. F.44 folded before Flop (didn't bet)
Seat 7: lallelyk'lig folded before Flop (didn't bet)
Seat 8: Johannkasi2222 folded before Flop (didn't bet)
Seat 9: 721339 71147 folded before Flop (didn't bet)



PokerStars Hand #208302654364: Tournament #2779056951, $0.49+$0.06 USD Hold'em No Limit - Level XX (800/1600) - 2020/01/19 0:36:06 EET [2020/01/18 17:36:06 ET]
Table '2779056951 35' 9-max Seat #4 is the button
Seat 1: x-like-dotix (80372 in chips) 
Seat 2: assokappa788 (80247 in chips) 
Seat 3: jcarlos.vale (30910 in chips) 
Seat 4: capitaNMCBRE (16680 in chips) 
Seat 5: qpAPMA3OH (82098 in chips) 
Seat 6: Petra. F.44 (18095 in chips) 
Seat 7: lallelyk'lig (73411 in chips) 
Seat 8: Johannkasi2222 (158137 in chips) 
Seat 9: 721339 71147 (40580 in chips) 
x-like-dotix: posts the ante 125
assokappa788: posts the ante 125
jcarlos.vale: posts the ante 125
capitaNMCBRE: posts the ante 125
qpAPMA3OH: posts the ante 125
Petra. F.44: posts the ante 125
lallelyk'lig: posts the ante 125
Johannkasi2222: posts the ante 125
721339 71147: posts the ante 125
qpAPMA3OH: posts small blind 800
Petra. F.44: posts big blind 1600
*** HOLE CARDS ***
Dealt to jcarlos.vale [Js 7s]
lallelyk'lig: folds 
Johannkasi2222: folds 
721339 71147: folds 
x-like-dotix: raises 2400 to 4000
assokappa788: folds 
jcarlos.vale: folds 
capitaNMCBRE: raises 12555 to 16555 and is all-in
qpAPMA3OH: folds 
Petra. F.44: folds 
x-like-dotix: calls 12555
*** FLOP *** [Qd 7h 7c]
*** TURN *** [Qd 7h 7c] [Kd]
*** RIVER *** [Qd 7h 7c Kd] [Kc]
*** SHOW DOWN ***
x-like-dotix: shows [6c 6d] (two pair, Kings and Sevens)
capitaNMCBRE: shows [9c 9s] (two pair, Kings and Nines)
capitaNMCBRE collected 36635 from pot
*** SUMMARY ***
Total pot 36635 | Rake 0 
Board [Qd 7h 7c Kd Kc]
Seat 1: x-like-dotix showed [6c 6d] and lost with two pair, Kings and Sevens
Seat 2: assokappa788 folded before Flop (didn't bet)
Seat 3: jcarlos.vale folded before Flop (didn't bet)
Seat 4: capitaNMCBRE (button) showed [9c 9s] and won (36635) with two pair, Kings and Nines
Seat 5: qpAPMA3OH (small blind) folded before Flop
Seat 6: Petra. F.44 (big blind) folded before Flop
Seat 7: lallelyk'lig folded before Flop (didn't bet)
Seat 8: Johannkasi2222 folded before Flop (didn't bet)
Seat 9: 721339 71147 folded before Flop (didn't bet)



PokerStars Hand #208302689180: Tournament #2779056951, $0.49+$0.06 USD Hold'em No Limit - Level XX (800/1600) - 2020/01/19 0:37:08 EET [2020/01/18 17:37:08 ET]
Table '2779056951 35' 9-max Seat #5 is the button
Seat 1: x-like-dotix (63692 in chips) 
Seat 2: assokappa788 (80122 in chips) 
Seat 3: jcarlos.vale (30785 in chips) 
Seat 4: capitaNMCBRE (36635 in chips) 
Seat 5: qpAPMA3OH (81173 in chips) 
Seat 6: Petra. F.44 (16370 in chips) 
Seat 7: lallelyk'lig (73286 in chips) 
Seat 8: Johannkasi2222 (158012 in chips) 
Seat 9: 721339 71147 (40455 in chips) 
x-like-dotix: posts the ante 125
assokappa788: posts the ante 125
jcarlos.vale: posts the ante 125
capitaNMCBRE: posts the ante 125
qpAPMA3OH: posts the ante 125
Petra. F.44: posts the ante 125
lallelyk'lig: posts the ante 125
Johannkasi2222: posts the ante 125
721339 71147: posts the ante 125
Petra. F.44: posts small blind 800
lallelyk'lig: posts big blind 1600
*** HOLE CARDS ***
Dealt to jcarlos.vale [9d Td]
Johannkasi2222: folds 
721339 71147: folds 
x-like-dotix: folds 
assokappa788: folds 
jcarlos.vale: raises 1760 to 3360
capitaNMCBRE: calls 3360
qpAPMA3OH: folds 
Petra. F.44: folds 
lallelyk'lig: calls 1760
*** FLOP *** [Ts Ah 5d]
lallelyk'lig: checks 
jcarlos.vale: bets 3200
capitaNMCBRE: calls 3200
lallelyk'lig: folds 
*** TURN *** [Ts Ah 5d] [2h]
jcarlos.vale: bets 3200
capitaNMCBRE: folds 
Uncalled bet (3200) returned to jcarlos.vale
jcarlos.vale collected 18405 from pot
jcarlos.vale: doesn't show handDTO
*** SUMMARY ***
Total pot 18405 | Rake 0 
Board [Ts Ah 5d 2h]
Seat 1: x-like-dotix folded before Flop (didn't bet)
Seat 2: assokappa788 folded before Flop (didn't bet)
Seat 3: jcarlos.vale collected (18405)
Seat 4: capitaNMCBRE folded on the Turn
Seat 5: qpAPMA3OH (button) folded before Flop (didn't bet)
Seat 6: Petra. F.44 (small blind) folded before Flop
Seat 7: lallelyk'lig (big blind) folded on the Flop
Seat 8: Johannkasi2222 folded before Flop (didn't bet)
Seat 9: 721339 71147 folded before Flop (didn't bet)



PokerStars Hand #208302723853: Tournament #2779056951, $0.49+$0.06 USD Hold'em No Limit - Level XX (800/1600) - 2020/01/19 0:38:08 EET [2020/01/18 17:38:08 ET]
Table '2779056951 35' 9-max Seat #6 is the button
Seat 1: x-like-dotix (63567 in chips) 
Seat 2: assokappa788 (79997 in chips) 
Seat 3: jcarlos.vale (42505 in chips) 
Seat 4: capitaNMCBRE (29950 in chips) 
Seat 5: qpAPMA3OH (81048 in chips) 
Seat 6: Petra. F.44 (15445 in chips) 
Seat 7: lallelyk'lig (69801 in chips) 
Seat 8: Johannkasi2222 (157887 in chips) 
Seat 9: 721339 71147 (40330 in chips) 
x-like-dotix: posts the ante 125
assokappa788: posts the ante 125
jcarlos.vale: posts the ante 125
capitaNMCBRE: posts the ante 125
qpAPMA3OH: posts the ante 125
Petra. F.44: posts the ante 125
lallelyk'lig: posts the ante 125
Johannkasi2222: posts the ante 125
721339 71147: posts the ante 125
lallelyk'lig: posts small blind 800
Johannkasi2222: posts big blind 1600
*** HOLE CARDS ***
Dealt to jcarlos.vale [2d 4d]
721339 71147: folds 
x-like-dotix: folds 
assokappa788: raises 3200 to 4800
jcarlos.vale: folds 
capitaNMCBRE: folds 
qpAPMA3OH: folds 
Petra. F.44: folds 
lallelyk'lig: folds 
Johannkasi2222: folds 
Uncalled bet (3200) returned to assokappa788
assokappa788 collected 5125 from pot
assokappa788: doesn't show handDTO
*** SUMMARY ***
Total pot 5125 | Rake 0 
Seat 1: x-like-dotix folded before Flop (didn't bet)
Seat 2: assokappa788 collected (5125)
Seat 3: jcarlos.vale folded before Flop (didn't bet)
Seat 4: capitaNMCBRE folded before Flop (didn't bet)
Seat 5: qpAPMA3OH folded before Flop (didn't bet)
Seat 6: Petra. F.44 (button) folded before Flop (didn't bet)
Seat 7: lallelyk'lig (small blind) folded before Flop
Seat 8: Johannkasi2222 (big blind) folded before Flop
Seat 9: 721339 71147 folded before Flop (didn't bet)



PokerStars Hand #208302738301: Tournament #2779056951, $0.49+$0.06 USD Hold'em No Limit - Level XX (800/1600) - 2020/01/19 0:38:34 EET [2020/01/18 17:38:34 ET]
Table '2779056951 35' 9-max Seat #7 is the button
Seat 1: x-like-dotix (63442 in chips) 
Seat 2: assokappa788 (83397 in chips) 
Seat 3: jcarlos.vale (42380 in chips) 
Seat 4: capitaNMCBRE (29825 in chips) 
Seat 5: qpAPMA3OH (80923 in chips) 
Seat 6: Petra. F.44 (15320 in chips) 
Seat 7: lallelyk'lig (68876 in chips) 
Seat 8: Johannkasi2222 (156162 in chips) 
Seat 9: 721339 71147 (40205 in chips) 
x-like-dotix: posts the ante 125
assokappa788: posts the ante 125
jcarlos.vale: posts the ante 125
capitaNMCBRE: posts the ante 125
qpAPMA3OH: posts the ante 125
Petra. F.44: posts the ante 125
lallelyk'lig: posts the ante 125
Johannkasi2222: posts the ante 125
721339 71147: posts the ante 125
Johannkasi2222: posts small blind 800
721339 71147: posts big blind 1600
*** HOLE CARDS ***
Dealt to jcarlos.vale [6h Kh]
x-like-dotix: folds 
assokappa788: folds 
jcarlos.vale: folds 
capitaNMCBRE: folds 
qpAPMA3OH: folds 
Petra. F.44: folds 
lallelyk'lig: folds 
Johannkasi2222: raises 154437 to 156037 and is all-in
721339 71147: folds 
Uncalled bet (154437) returned to Johannkasi2222
Johannkasi2222 collected 4325 from pot
*** SUMMARY ***
Total pot 4325 | Rake 0 
Seat 1: x-like-dotix folded before Flop (didn't bet)
Seat 2: assokappa788 folded before Flop (didn't bet)
Seat 3: jcarlos.vale folded before Flop (didn't bet)
Seat 4: capitaNMCBRE folded before Flop (didn't bet)
Seat 5: qpAPMA3OH folded before Flop (didn't bet)
Seat 6: Petra. F.44 folded before Flop (didn't bet)
Seat 7: lallelyk'lig (button) folded before Flop (didn't bet)
Seat 8: Johannkasi2222 (small blind) collected (4325)
Seat 9: 721339 71147 (big blind) folded before Flop



PokerStars Hand #208302754285: Tournament #2779056951, $0.49+$0.06 USD Hold'em No Limit - Level XX (800/1600) - 2020/01/19 0:39:02 EET [2020/01/18 17:39:02 ET]
Table '2779056951 35' 9-max Seat #8 is the button
Seat 1: x-like-dotix (63317 in chips) 
Seat 2: assokappa788 (83272 in chips) 
Seat 3: jcarlos.vale (42255 in chips) 
Seat 4: capitaNMCBRE (29700 in chips) 
Seat 5: qpAPMA3OH (80798 in chips) 
Seat 6: Petra. F.44 (15195 in chips) 
Seat 7: lallelyk'lig (68751 in chips) 
Seat 8: Johannkasi2222 (158762 in chips) 
Seat 9: 721339 71147 (38480 in chips) 
x-like-dotix: posts the ante 125
assokappa788: posts the ante 125
jcarlos.vale: posts the ante 125
capitaNMCBRE: posts the ante 125
qpAPMA3OH: posts the ante 125
Petra. F.44: posts the ante 125
lallelyk'lig: posts the ante 125
Johannkasi2222: posts the ante 125
721339 71147: posts the ante 125
721339 71147: posts small blind 800
x-like-dotix: posts big blind 1600
*** HOLE CARDS ***
Dealt to jcarlos.vale [9h Kc]
assokappa788: folds 
jcarlos.vale: folds 
capitaNMCBRE: folds 
qpAPMA3OH: folds 
Petra. F.44: folds 
lallelyk'lig: raises 3200 to 4800
Johannkasi2222: folds 
721339 71147: raises 33555 to 38355 and is all-in
x-like-dotix: folds 
lallelyk'lig: folds 
Uncalled bet (33555) returned to 721339 71147
721339 71147 collected 12325 from pot
721339 71147: doesn't show handDTO
*** SUMMARY ***
Total pot 12325 | Rake 0 
Seat 1: x-like-dotix (big blind) folded before Flop
Seat 2: assokappa788 folded before Flop (didn't bet)
Seat 3: jcarlos.vale folded before Flop (didn't bet)
Seat 4: capitaNMCBRE folded before Flop (didn't bet)
Seat 5: qpAPMA3OH folded before Flop (didn't bet)
Seat 6: Petra. F.44 folded before Flop (didn't bet)
Seat 7: lallelyk'lig folded before Flop
Seat 8: Johannkasi2222 (button) folded before Flop (didn't bet)
Seat 9: 721339 71147 (small blind) collected (12325)



PokerStars Hand #208302776847: Tournament #2779056951, $0.49+$0.06 USD Hold'em No Limit - Level XX (800/1600) - 2020/01/19 0:39:42 EET [2020/01/18 17:39:42 ET]
Table '2779056951 35' 9-max Seat #9 is the button
Seat 1: x-like-dotix (61592 in chips) 
Seat 2: assokappa788 (83147 in chips) 
Seat 3: jcarlos.vale (42130 in chips) 
Seat 4: capitaNMCBRE (29575 in chips) 
Seat 5: qpAPMA3OH (80673 in chips) 
Seat 6: Petra. F.44 (15070 in chips) 
Seat 7: lallelyk'lig (63826 in chips) 
Seat 8: Johannkasi2222 (158637 in chips) 
Seat 9: 721339 71147 (45880 in chips) 
x-like-dotix: posts the ante 125
assokappa788: posts the ante 125
jcarlos.vale: posts the ante 125
capitaNMCBRE: posts the ante 125
qpAPMA3OH: posts the ante 125
Petra. F.44: posts the ante 125
lallelyk'lig: posts the ante 125
Johannkasi2222: posts the ante 125
721339 71147: posts the ante 125
x-like-dotix: posts small blind 800
assokappa788: posts big blind 1600
*** HOLE CARDS ***
Dealt to jcarlos.vale [4s Js]
jcarlos.vale: folds 
capitaNMCBRE: folds 
qpAPMA3OH: folds 
Petra. F.44: folds 
lallelyk'lig: folds 
Johannkasi2222: folds 
721339 71147: folds 
x-like-dotix: raises 2400 to 4000
assokappa788: calls 2400
*** FLOP *** [3h 7h Qd]
x-like-dotix: bets 3200
assokappa788: folds 
Uncalled bet (3200) returned to x-like-dotix
x-like-dotix collected 9125 from pot
x-like-dotix: doesn't show handDTO
*** SUMMARY ***
Total pot 9125 | Rake 0 
Board [3h 7h Qd]
Seat 1: x-like-dotix (small blind) collected (9125)
Seat 2: assokappa788 (big blind) folded on the Flop
Seat 3: jcarlos.vale folded before Flop (didn't bet)
Seat 4: capitaNMCBRE folded before Flop (didn't bet)
Seat 5: qpAPMA3OH folded before Flop (didn't bet)
Seat 6: Petra. F.44 folded before Flop (didn't bet)
Seat 7: lallelyk'lig folded before Flop (didn't bet)
Seat 8: Johannkasi2222 folded before Flop (didn't bet)
Seat 9: 721339 71147 (button) folded before Flop (didn't bet)



PokerStars Hand #208302822191: Tournament #2779056951, $0.49+$0.06 USD Hold'em No Limit - Level XX (800/1600) - 2020/01/19 0:40:57 EET [2020/01/18 17:40:57 ET]
Table '2779056951 35' 9-max Seat #1 is the button
Seat 1: x-like-dotix (66592 in chips) 
Seat 2: assokappa788 (79022 in chips) 
Seat 3: jcarlos.vale (42005 in chips) 
Seat 4: capitaNMCBRE (29450 in chips) 
Seat 5: qpAPMA3OH (80548 in chips) 
Seat 6: Petra. F.44 (14945 in chips) 
Seat 7: lallelyk'lig (63701 in chips) 
Seat 8: Johannkasi2222 (158512 in chips) 
Seat 9: 721339 71147 (45755 in chips) 
x-like-dotix: posts the ante 125
assokappa788: posts the ante 125
jcarlos.vale: posts the ante 125
capitaNMCBRE: posts the ante 125
qpAPMA3OH: posts the ante 125
Petra. F.44: posts the ante 125
lallelyk'lig: posts the ante 125
Johannkasi2222: posts the ante 125
721339 71147: posts the ante 125
assokappa788: posts small blind 800
jcarlos.vale: posts big blind 1600
*** HOLE CARDS ***
Dealt to jcarlos.vale [Qs Kd]
capitaNMCBRE: folds 
qpAPMA3OH: folds 
Petra. F.44: folds 
lallelyk'lig: folds 
Johannkasi2222: folds 
721339 71147: folds 
x-like-dotix: folds 
assokappa788: calls 800
jcarlos.vale: checks 
*** FLOP *** [Jc 6h 4s]
assokappa788: bets 1600
jcarlos.vale: folds 
Uncalled bet (1600) returned to assokappa788
assokappa788 collected 4325 from pot
assokappa788: doesn't show handDTO
*** SUMMARY ***
Total pot 4325 | Rake 0 
Board [Jc 6h 4s]
Seat 1: x-like-dotix (button) folded before Flop (didn't bet)
Seat 2: assokappa788 (small blind) collected (4325)
Seat 3: jcarlos.vale (big blind) folded on the Flop
Seat 4: capitaNMCBRE folded before Flop (didn't bet)
Seat 5: qpAPMA3OH folded before Flop (didn't bet)
Seat 6: Petra. F.44 folded before Flop (didn't bet)
Seat 7: lallelyk'lig folded before Flop (didn't bet)
Seat 8: Johannkasi2222 folded before Flop (didn't bet)
Seat 9: 721339 71147 folded before Flop (didn't bet)



PokerStars Hand #208302847048: Tournament #2779056951, $0.49+$0.06 USD Hold'em No Limit - Level XXI (900/1800) - 2020/01/19 0:41:41 EET [2020/01/18 17:41:41 ET]
Table '2779056951 35' 9-max Seat #2 is the button
Seat 1: x-like-dotix (66467 in chips) 
Seat 2: assokappa788 (81622 in chips) 
Seat 3: jcarlos.vale (40280 in chips) 
Seat 4: capitaNMCBRE (29325 in chips) 
Seat 5: qpAPMA3OH (80423 in chips) 
Seat 6: Petra. F.44 (14820 in chips) 
Seat 7: lallelyk'lig (63576 in chips) 
Seat 8: Johannkasi2222 (158387 in chips) 
Seat 9: 721339 71147 (45630 in chips) 
x-like-dotix: posts the ante 150
assokappa788: posts the ante 150
jcarlos.vale: posts the ante 150
capitaNMCBRE: posts the ante 150
qpAPMA3OH: posts the ante 150
Petra. F.44: posts the ante 150
lallelyk'lig: posts the ante 150
Johannkasi2222: posts the ante 150
721339 71147: posts the ante 150
jcarlos.vale: posts small blind 900
capitaNMCBRE: posts big blind 1800
*** HOLE CARDS ***
Dealt to jcarlos.vale [4s 6h]
qpAPMA3OH: raises 1800 to 3600
Petra. F.44: folds 
lallelyk'lig: calls 3600
Johannkasi2222: folds 
721339 71147: folds 
x-like-dotix: folds 
assokappa788: calls 3600
jcarlos.vale: folds 
capitaNMCBRE: raises 25575 to 29175 and is all-in
qpAPMA3OH: folds 
lallelyk'lig: calls 25575
assokappa788: folds 
*** FLOP *** [5s Ac 9d]
*** TURN *** [5s Ac 9d] [8s]
*** RIVER *** [5s Ac 9d 8s] [Jc]
*** SHOW DOWN ***
capitaNMCBRE: shows [Jd Jh] (three of a kind, Jacks)
lallelyk'lig: shows [6c 6d] (a pair of Sixes)
capitaNMCBRE collected 67800 from pot
*** SUMMARY ***
Total pot 67800 | Rake 0 
Board [5s Ac 9d 8s Jc]
Seat 1: x-like-dotix folded before Flop (didn't bet)
Seat 2: assokappa788 (button) folded before Flop
Seat 3: jcarlos.vale (small blind) folded before Flop
Seat 4: capitaNMCBRE (big blind) showed [Jd Jh] and won (67800) with three of a kind, Jacks
Seat 5: qpAPMA3OH folded before Flop
Seat 6: Petra. F.44 folded before Flop (didn't bet)
Seat 7: lallelyk'lig showed [6c 6d] and lost with a pair of Sixes
Seat 8: Johannkasi2222 folded before Flop (didn't bet)
Seat 9: 721339 71147 folded before Flop (didn't bet)



PokerStars Hand #208302887132: Tournament #2779056951, $0.49+$0.06 USD Hold'em No Limit - Level XXI (900/1800) - 2020/01/19 0:42:53 EET [2020/01/18 17:42:53 ET]
Table '2779056951 35' 9-max Seat #3 is the button
Seat 1: x-like-dotix (66317 in chips) 
Seat 2: assokappa788 (77872 in chips) 
Seat 3: jcarlos.vale (39230 in chips) 
Seat 4: capitaNMCBRE (67800 in chips) 
Seat 5: qpAPMA3OH (76673 in chips) 
Seat 6: Petra. F.44 (14670 in chips) 
Seat 7: lallelyk'lig (34251 in chips) 
Seat 8: Johannkasi2222 (158237 in chips) 
Seat 9: 721339 71147 (45480 in chips) 
x-like-dotix: posts the ante 150
assokappa788: posts the ante 150
jcarlos.vale: posts the ante 150
capitaNMCBRE: posts the ante 150
qpAPMA3OH: posts the ante 150
Petra. F.44: posts the ante 150
lallelyk'lig: posts the ante 150
Johannkasi2222: posts the ante 150
721339 71147: posts the ante 150
capitaNMCBRE: posts small blind 900
qpAPMA3OH: posts big blind 1800
*** HOLE CARDS ***
Dealt to jcarlos.vale [Jd 8s]
Petra. F.44: folds 
lallelyk'lig: folds 
Johannkasi2222: folds 
721339 71147: folds 
x-like-dotix: raises 2700 to 4500
assokappa788: folds 
jcarlos.vale: folds 
capitaNMCBRE: folds 
qpAPMA3OH: folds 
Uncalled bet (2700) returned to x-like-dotix
x-like-dotix collected 5850 from pot
x-like-dotix: doesn't show handDTO
*** SUMMARY ***
Total pot 5850 | Rake 0 
Seat 1: x-like-dotix collected (5850)
Seat 2: assokappa788 folded before Flop (didn't bet)
Seat 3: jcarlos.vale (button) folded before Flop (didn't bet)
Seat 4: capitaNMCBRE (small blind) folded before Flop
Seat 5: qpAPMA3OH (big blind) folded before Flop
Seat 6: Petra. F.44 folded before Flop (didn't bet)
Seat 7: lallelyk'lig folded before Flop (didn't bet)
Seat 8: Johannkasi2222 folded before Flop (didn't bet)
Seat 9: 721339 71147 folded before Flop (didn't bet)



PokerStars Hand #208302900717: Tournament #2779056951, $0.49+$0.06 USD Hold'em No Limit - Level XXI (900/1800) - 2020/01/19 0:43:17 EET [2020/01/18 17:43:17 ET]
Table '2779056951 35' 9-max Seat #4 is the button
Seat 1: x-like-dotix (70217 in chips) 
Seat 2: assokappa788 (77722 in chips) 
Seat 3: jcarlos.vale (39080 in chips) 
Seat 4: capitaNMCBRE (66750 in chips) 
Seat 5: qpAPMA3OH (74723 in chips) 
Seat 6: Petra. F.44 (14520 in chips) 
Seat 7: lallelyk'lig (34101 in chips) 
Seat 8: Johannkasi2222 (158087 in chips) 
Seat 9: 721339 71147 (45330 in chips) 
x-like-dotix: posts the ante 150
assokappa788: posts the ante 150
jcarlos.vale: posts the ante 150
capitaNMCBRE: posts the ante 150
qpAPMA3OH: posts the ante 150
Petra. F.44: posts the ante 150
lallelyk'lig: posts the ante 150
Johannkasi2222: posts the ante 150
721339 71147: posts the ante 150
qpAPMA3OH: posts small blind 900
Petra. F.44: posts big blind 1800
*** HOLE CARDS ***
Dealt to jcarlos.vale [6c 5s]
lallelyk'lig: folds 
Johannkasi2222: folds 
721339 71147: folds 
x-like-dotix: folds 
assokappa788: raises 1800 to 3600
jcarlos.vale: folds 
capitaNMCBRE: folds 
qpAPMA3OH: folds 
Petra. F.44: folds 
Uncalled bet (1800) returned to assokappa788
assokappa788 collected 5850 from pot
assokappa788: doesn't show handDTO
*** SUMMARY ***
Total pot 5850 | Rake 0 
Seat 1: x-like-dotix folded before Flop (didn't bet)
Seat 2: assokappa788 collected (5850)
Seat 3: jcarlos.vale folded before Flop (didn't bet)
Seat 4: capitaNMCBRE (button) folded before Flop (didn't bet)
Seat 5: qpAPMA3OH (small blind) folded before Flop
Seat 6: Petra. F.44 (big blind) folded before Flop
Seat 7: lallelyk'lig folded before Flop (didn't bet)
Seat 8: Johannkasi2222 folded before Flop (didn't bet)
Seat 9: 721339 71147 folded before Flop (didn't bet)



PokerStars Hand #208302915777: Tournament #2779056951, $0.49+$0.06 USD Hold'em No Limit - Level XXI (900/1800) - 2020/01/19 0:43:44 EET [2020/01/18 17:43:44 ET]
Table '2779056951 35' 9-max Seat #5 is the button
Seat 1: x-like-dotix (70067 in chips) 
Seat 2: assokappa788 (81622 in chips) 
Seat 3: jcarlos.vale (38930 in chips) 
Seat 4: capitaNMCBRE (66600 in chips) 
Seat 5: qpAPMA3OH (73673 in chips) 
Seat 6: Petra. F.44 (12570 in chips) 
Seat 7: lallelyk'lig (33951 in chips) 
Seat 8: Johannkasi2222 (157937 in chips) 
Seat 9: 721339 71147 (45180 in chips) 
x-like-dotix: posts the ante 150
assokappa788: posts the ante 150
jcarlos.vale: posts the ante 150
capitaNMCBRE: posts the ante 150
qpAPMA3OH: posts the ante 150
Petra. F.44: posts the ante 150
lallelyk'lig: posts the ante 150
Johannkasi2222: posts the ante 150
721339 71147: posts the ante 150
Petra. F.44: posts small blind 900
lallelyk'lig: posts big blind 1800
*** HOLE CARDS ***
Dealt to jcarlos.vale [5h 4h]
Johannkasi2222: folds 
721339 71147: raises 2160 to 3960
x-like-dotix: folds 
assokappa788: folds 
jcarlos.vale: folds 
capitaNMCBRE: calls 3960
qpAPMA3OH: folds 
Petra. F.44: folds 
lallelyk'lig: folds 
*** FLOP *** [3d 9d Ac]
721339 71147: bets 3950
capitaNMCBRE: calls 3950
*** TURN *** [3d 9d Ac] [4c]
721339 71147: bets 9900
capitaNMCBRE: calls 9900
*** RIVER *** [3d 9d Ac 4c] [7s]
721339 71147: bets 27220 and is all-in
capitaNMCBRE: calls 27220
*** SHOW DOWN ***
721339 71147: shows [9s 9h] (three of a kind, Nines)
capitaNMCBRE: shows [7h Ah] (two pair, Aces and Sevens)
721339 71147 collected 94110 from pot
*** SUMMARY ***
Total pot 94110 | Rake 0 
Board [3d 9d Ac 4c 7s]
Seat 1: x-like-dotix folded before Flop (didn't bet)
Seat 2: assokappa788 folded before Flop (didn't bet)
Seat 3: jcarlos.vale folded before Flop (didn't bet)
Seat 4: capitaNMCBRE showed [7h Ah] and lost with two pair, Aces and Sevens
Seat 5: qpAPMA3OH (button) folded before Flop (didn't bet)
Seat 6: Petra. F.44 (small blind) folded before Flop
Seat 7: lallelyk'lig (big blind) folded before Flop
Seat 8: Johannkasi2222 folded before Flop (didn't bet)
Seat 9: 721339 71147 showed [9s 9h] and won (94110) with three of a kind, Nines



PokerStars Hand #208302977636: Tournament #2779056951, $0.49+$0.06 USD Hold'em No Limit - Level XXI (900/1800) - 2020/01/19 0:45:18 EET [2020/01/18 17:45:18 ET]
Table '2779056951 35' 9-max Seat #6 is the button
Seat 1: x-like-dotix (69917 in chips) 
Seat 2: assokappa788 (81472 in chips) 
Seat 3: jcarlos.vale (38780 in chips) 
Seat 4: capitaNMCBRE (21420 in chips) 
Seat 5: qpAPMA3OH (73523 in chips) 
Seat 6: Petra. F.44 (11520 in chips) 
Seat 7: lallelyk'lig (32001 in chips) 
Seat 8: Johannkasi2222 (157787 in chips) 
Seat 9: 721339 71147 (94110 in chips) 
x-like-dotix: posts the ante 150
assokappa788: posts the ante 150
jcarlos.vale: posts the ante 150
capitaNMCBRE: posts the ante 150
qpAPMA3OH: posts the ante 150
Petra. F.44: posts the ante 150
lallelyk'lig: posts the ante 150
Johannkasi2222: posts the ante 150
721339 71147: posts the ante 150
lallelyk'lig: posts small blind 900
Johannkasi2222: posts big blind 1800
*** HOLE CARDS ***
Dealt to jcarlos.vale [Td Kh]
721339 71147: folds 
x-like-dotix: folds 
assokappa788: raises 1800 to 3600
jcarlos.vale: folds 
capitaNMCBRE: calls 3600
qpAPMA3OH: folds 
Petra. F.44: raises 7770 to 11370 and is all-in
lallelyk'lig: folds 
Johannkasi2222: folds 
assokappa788: raises 7770 to 19140
capitaNMCBRE: raises 2130 to 21270 and is all-in
assokappa788: calls 2130
*** FLOP *** [6c 4d 3h]
*** TURN *** [6c 4d 3h] [3d]
*** RIVER *** [6c 4d 3h 3d] [Js]
*** SHOW DOWN ***
assokappa788: shows [9d Ac] (a pair of Threes)
capitaNMCBRE: shows [Qs 9s] (a pair of Threes - lower kicker)
assokappa788 collected 19800 from side pot
Petra. F.44: shows [Kc Kd] (two pair, Kings and Threes)
Petra. F.44 collected 38160 from main pot
capitaNMCBRE finished the tournament in 221st place and received $1.50.
*** SUMMARY ***
Total pot 57960 Main pot 38160. Side pot 19800. | Rake 0 
Board [6c 4d 3h 3d Js]
Seat 1: x-like-dotix folded before Flop (didn't bet)
Seat 2: assokappa788 showed [9d Ac] and won (19800) with a pair of Threes
Seat 3: jcarlos.vale folded before Flop (didn't bet)
Seat 4: capitaNMCBRE showed [Qs 9s] and lost with a pair of Threes
Seat 5: qpAPMA3OH folded before Flop (didn't bet)
Seat 6: Petra. F.44 (button) showed [Kc Kd] and won (38160) with two pair, Kings and Threes
Seat 7: lallelyk'lig (small blind) folded before Flop
Seat 8: Johannkasi2222 (big blind) folded before Flop
Seat 9: 721339 71147 folded before Flop (didn't bet)



PokerStars Hand #208303021549: Tournament #2779056951, $0.49+$0.06 USD Hold'em No Limit - Level XXI (900/1800) - 2020/01/19 0:46:37 EET [2020/01/18 17:46:37 ET]
Table '2779056951 35' 9-max Seat #7 is the button
Seat 1: x-like-dotix (69767 in chips) 
Seat 2: assokappa788 (79852 in chips) 
Seat 3: jcarlos.vale (38630 in chips) 
Seat 5: qpAPMA3OH (73373 in chips) 
Seat 6: Petra. F.44 (38160 in chips) 
Seat 7: lallelyk'lig (30951 in chips) 
Seat 8: Johannkasi2222 (155837 in chips) 
Seat 9: 721339 71147 (93960 in chips) 
x-like-dotix: posts the ante 150
assokappa788: posts the ante 150
jcarlos.vale: posts the ante 150
qpAPMA3OH: posts the ante 150
Petra. F.44: posts the ante 150
lallelyk'lig: posts the ante 150
Johannkasi2222: posts the ante 150
721339 71147: posts the ante 150
Johannkasi2222: posts small blind 900
721339 71147: posts big blind 1800
*** HOLE CARDS ***
Dealt to jcarlos.vale [Ah As]
x-like-dotix: folds 
assokappa788: folds 
jcarlos.vale: raises 2700 to 4500
qpAPMA3OH: folds 
Petra. F.44: folds 
lallelyk'lig: folds 
Johannkasi2222: folds 
721339 71147: calls 2700
*** FLOP *** [3d 6s Qh]
721339 71147: checks 
jcarlos.vale: bets 5400
721339 71147: calls 5400
*** TURN *** [3d 6s Qh] [7s]
721339 71147: checks 
jcarlos.vale: bets 12600
721339 71147: calls 12600
*** RIVER *** [3d 6s Qh 7s] [2d]
721339 71147: checks 
jcarlos.vale: bets 15980 and is all-in
721339 71147: folds 
Uncalled bet (15980) returned to jcarlos.vale
jcarlos.vale collected 47100 from pot
jcarlos.vale: doesn't show handDTO
*** SUMMARY ***
Total pot 47100 | Rake 0 
Board [3d 6s Qh 7s 2d]
Seat 1: x-like-dotix folded before Flop (didn't bet)
Seat 2: assokappa788 folded before Flop (didn't bet)
Seat 3: jcarlos.vale collected (47100)
Seat 5: qpAPMA3OH folded before Flop (didn't bet)
Seat 6: Petra. F.44 folded before Flop (didn't bet)
Seat 7: lallelyk'lig (button) folded before Flop (didn't bet)
Seat 8: Johannkasi2222 (small blind) folded before Flop
Seat 9: 721339 71147 (big blind) folded on the River



PokerStars Hand #208303070490: Tournament #2779056951, $0.49+$0.06 USD Hold'em No Limit - Level XXI (900/1800) - 2020/01/19 0:48:05 EET [2020/01/18 17:48:05 ET]
Table '2779056951 35' 9-max Seat #8 is the button
Seat 1: x-like-dotix (69617 in chips) 
Seat 2: assokappa788 (79702 in chips) 
Seat 3: jcarlos.vale (63080 in chips) 
Seat 4: GARRRN (28906 in chips) 
Seat 5: qpAPMA3OH (73223 in chips) 
Seat 6: Petra. F.44 (38010 in chips) 
Seat 7: lallelyk'lig (30801 in chips) 
Seat 8: Johannkasi2222 (154787 in chips) 
Seat 9: 721339 71147 (71310 in chips) 
x-like-dotix: posts the ante 150
assokappa788: posts the ante 150
jcarlos.vale: posts the ante 150
GARRRN: posts the ante 150
qpAPMA3OH: posts the ante 150
Petra. F.44: posts the ante 150
lallelyk'lig: posts the ante 150
Johannkasi2222: posts the ante 150
721339 71147: posts the ante 150
721339 71147: posts small blind 900
x-like-dotix: posts big blind 1800
*** HOLE CARDS ***
Dealt to jcarlos.vale [7h 4c]
assokappa788 has timed out
assokappa788: folds 
assokappa788 is sitting out
assokappa788 has returned
jcarlos.vale: folds 
GARRRN: folds 
qpAPMA3OH: folds 
Petra. F.44: folds 
lallelyk'lig has timed out
lallelyk'lig: folds 
lallelyk'lig is sitting out
lallelyk'lig has returned
Johannkasi2222: calls 1800
721339 71147: calls 900
x-like-dotix: checks 
*** FLOP *** [Tc 5h 6h]
lallelyk'lig is disconnected 
721339 71147: checks 
x-like-dotix: checks 
Johannkasi2222: bets 6750
721339 71147: calls 6750
x-like-dotix: folds 
*** TURN *** [Tc 5h 6h] [Ah]
721339 71147: checks 
Johannkasi2222: bets 20250
721339 71147: folds 
Uncalled bet (20250) returned to Johannkasi2222
Johannkasi2222 collected 20250 from pot
*** SUMMARY ***
Total pot 20250 | Rake 0 
Board [Tc 5h 6h Ah]
Seat 1: x-like-dotix (big blind) folded on the Flop
Seat 2: assokappa788 folded before Flop (didn't bet)
Seat 3: jcarlos.vale folded before Flop (didn't bet)
Seat 4: GARRRN folded before Flop (didn't bet)
Seat 5: qpAPMA3OH folded before Flop (didn't bet)
Seat 6: Petra. F.44 folded before Flop (didn't bet)
Seat 7: lallelyk'lig folded before Flop (didn't bet)
Seat 8: Johannkasi2222 (button) collected (20250)
Seat 9: 721339 71147 (small blind) folded on the Turn



PokerStars Hand #208303129338: Tournament #2779056951, $0.49+$0.06 USD Hold'em No Limit - Level XXI (900/1800) - 2020/01/19 0:49:52 EET [2020/01/18 17:49:52 ET]
Table '2779056951 35' 9-max Seat #9 is the button
Seat 1: x-like-dotix (67667 in chips) 
Seat 2: assokappa788 (79552 in chips) 
Seat 3: jcarlos.vale (62930 in chips) 
Seat 4: GARRRN (28756 in chips) 
Seat 5: qpAPMA3OH (73073 in chips) 
Seat 6: Petra. F.44 (37860 in chips) 
Seat 7: lallelyk'lig (30651 in chips) 
Seat 8: Johannkasi2222 (166337 in chips) 
Seat 9: 721339 71147 (62610 in chips) 
x-like-dotix: posts the ante 150
assokappa788: posts the ante 150
jcarlos.vale: posts the ante 150
GARRRN: posts the ante 150
qpAPMA3OH: posts the ante 150
Petra. F.44: posts the ante 150
lallelyk'lig: posts the ante 150
Johannkasi2222: posts the ante 150
721339 71147: posts the ante 150
x-like-dotix: posts small blind 900
assokappa788: posts big blind 1800
*** HOLE CARDS ***
Dealt to jcarlos.vale [7d 2h]
jcarlos.vale: folds 
GARRRN: folds 
qpAPMA3OH: folds 
Petra. F.44: folds 
lallelyk'lig is connected 
lallelyk'lig has timed out
lallelyk'lig: folds 
lallelyk'lig is sitting out
lallelyk'lig has returned
Johannkasi2222: folds 
721339 71147: folds 
x-like-dotix: folds 
Uncalled bet (900) returned to assokappa788
assokappa788 collected 3150 from pot
assokappa788: doesn't show handDTO
*** SUMMARY ***
Total pot 3150 | Rake 0 
Seat 1: x-like-dotix (small blind) folded before Flop
Seat 2: assokappa788 (big blind) collected (3150)
Seat 3: jcarlos.vale folded before Flop (didn't bet)
Seat 4: GARRRN folded before Flop (didn't bet)
Seat 5: qpAPMA3OH folded before Flop (didn't bet)
Seat 6: Petra. F.44 folded before Flop (didn't bet)
Seat 7: lallelyk'lig folded before Flop (didn't bet)
Seat 8: Johannkasi2222 folded before Flop (didn't bet)
Seat 9: 721339 71147 (button) folded before Flop (didn't bet)



PokerStars Hand #208303151253: Tournament #2779056951, $0.49+$0.06 USD Hold'em No Limit - Level XXI (900/1800) - 2020/01/19 0:50:33 EET [2020/01/18 17:50:33 ET]
Table '2779056951 35' 9-max Seat #1 is the button
Seat 1: x-like-dotix (66617 in chips) 
Seat 2: assokappa788 (81652 in chips) 
Seat 3: jcarlos.vale (62780 in chips) 
Seat 4: GARRRN (28606 in chips) 
Seat 5: qpAPMA3OH (72923 in chips) 
Seat 6: Petra. F.44 (37710 in chips) 
Seat 7: lallelyk'lig (30501 in chips) 
Seat 8: Johannkasi2222 (166187 in chips) 
Seat 9: 721339 71147 (62460 in chips) 
x-like-dotix: posts the ante 150
assokappa788: posts the ante 150
jcarlos.vale: posts the ante 150
GARRRN: posts the ante 150
qpAPMA3OH: posts the ante 150
Petra. F.44: posts the ante 150
lallelyk'lig: posts the ante 150
Johannkasi2222: posts the ante 150
721339 71147: posts the ante 150
assokappa788: posts small blind 900
jcarlos.vale: posts big blind 1800
*** HOLE CARDS ***
Dealt to jcarlos.vale [7c Ks]
GARRRN: folds 
qpAPMA3OH: calls 1800
Petra. F.44: folds 
lallelyk'lig has timed out
lallelyk'lig: folds 
lallelyk'lig is sitting out
Johannkasi2222: folds 
lallelyk'lig has returned
721339 71147: raises 4500 to 6300
x-like-dotix: folds 
assokappa788: calls 5400
jcarlos.vale: folds 
qpAPMA3OH: calls 4500
*** FLOP *** [Qd Jc Jh]
assokappa788: checks 
qpAPMA3OH: checks 
721339 71147: checks 
*** TURN *** [Qd Jc Jh] [2c]
assokappa788: bets 9000
qpAPMA3OH: calls 9000
721339 71147: folds 
*** RIVER *** [Qd Jc Jh 2c] [2s]
assokappa788: bets 10800
qpAPMA3OH: calls 10800
*** SHOW DOWN ***
assokappa788: shows [7s 7d] (two pair, Jacks and Sevens)
qpAPMA3OH: shows [Kd 2d] (a full house, Deuces full of Jacks)
qpAPMA3OH collected 61650 from pot
*** SUMMARY ***
Total pot 61650 | Rake 0 
Board [Qd Jc Jh 2c 2s]
Seat 1: x-like-dotix (button) folded before Flop (didn't bet)
Seat 2: assokappa788 (small blind) showed [7s 7d] and lost with two pair, Jacks and Sevens
Seat 3: jcarlos.vale (big blind) folded before Flop
Seat 4: GARRRN folded before Flop (didn't bet)
Seat 5: qpAPMA3OH showed [Kd 2d] and won (61650) with a full house, Deuces full of Jacks
Seat 6: Petra. F.44 folded before Flop (didn't bet)
Seat 7: lallelyk'lig folded before Flop (didn't bet)
Seat 8: Johannkasi2222 folded before Flop (didn't bet)
Seat 9: 721339 71147 folded on the Turn



PokerStars Hand #208303202460: Tournament #2779056951, $0.49+$0.06 USD Hold'em No Limit - Level XXII (1000/2000) - 2020/01/19 0:52:08 EET [2020/01/18 17:52:08 ET]
Table '2779056951 35' 9-max Seat #2 is the button
Seat 1: x-like-dotix (66467 in chips) 
Seat 2: assokappa788 (55402 in chips) 
Seat 3: jcarlos.vale (60830 in chips) 
Seat 4: GARRRN (28456 in chips) 
Seat 5: qpAPMA3OH (108323 in chips) 
Seat 6: Petra. F.44 (37560 in chips) 
Seat 7: lallelyk'lig (30351 in chips) 
Seat 8: Johannkasi2222 (166037 in chips) 
Seat 9: 721339 71147 (56010 in chips) 
x-like-dotix: posts the ante 175
assokappa788: posts the ante 175
jcarlos.vale: posts the ante 175
GARRRN: posts the ante 175
qpAPMA3OH: posts the ante 175
Petra. F.44: posts the ante 175
lallelyk'lig: posts the ante 175
Johannkasi2222: posts the ante 175
721339 71147: posts the ante 175
jcarlos.vale: posts small blind 1000
GARRRN: posts big blind 2000
*** HOLE CARDS ***
Dealt to jcarlos.vale [Qh 3h]
qpAPMA3OH: raises 6575 to 8575
Petra. F.44: folds 
lallelyk'lig: folds 
Johannkasi2222: folds 
721339 71147: folds 
x-like-dotix: folds 
assokappa788: folds 
jcarlos.vale: folds 
GARRRN: folds 
Uncalled bet (6575) returned to qpAPMA3OH
qpAPMA3OH collected 6575 from pot
qpAPMA3OH: doesn't show handDTO
*** SUMMARY ***
Total pot 6575 | Rake 0 
Seat 1: x-like-dotix folded before Flop (didn't bet)
Seat 2: assokappa788 (button) folded before Flop (didn't bet)
Seat 3: jcarlos.vale (small blind) folded before Flop
Seat 4: GARRRN (big blind) folded before Flop
Seat 5: qpAPMA3OH collected (6575)
Seat 6: Petra. F.44 folded before Flop (didn't bet)
Seat 7: lallelyk'lig folded before Flop (didn't bet)
Seat 8: Johannkasi2222 folded before Flop (didn't bet)
Seat 9: 721339 71147 folded before Flop (didn't bet)



PokerStars Hand #208303221975: Tournament #2779056951, $0.49+$0.06 USD Hold'em No Limit - Level XXII (1000/2000) - 2020/01/19 0:52:44 EET [2020/01/18 17:52:44 ET]
Table '2779056951 35' 9-max Seat #3 is the button
Seat 1: x-like-dotix (66292 in chips) 
Seat 2: assokappa788 (55227 in chips) 
Seat 3: jcarlos.vale (59655 in chips) 
Seat 4: GARRRN (26281 in chips) 
Seat 5: qpAPMA3OH (112723 in chips) 
Seat 6: Petra. F.44 (37385 in chips) 
Seat 7: lallelyk'lig (30176 in chips) 
Seat 8: Johannkasi2222 (165862 in chips) 
Seat 9: 721339 71147 (55835 in chips) 
x-like-dotix: posts the ante 175
assokappa788: posts the ante 175
jcarlos.vale: posts the ante 175
GARRRN: posts the ante 175
qpAPMA3OH: posts the ante 175
Petra. F.44: posts the ante 175
lallelyk'lig: posts the ante 175
Johannkasi2222: posts the ante 175
721339 71147: posts the ante 175
GARRRN: posts small blind 1000
qpAPMA3OH: posts big blind 2000
*** HOLE CARDS ***
Dealt to jcarlos.vale [9c Js]
Petra. F.44: folds 
lallelyk'lig: folds 
Johannkasi2222: folds 
721339 71147: folds 
x-like-dotix: folds 
assokappa788: raises 2000 to 4000
jcarlos.vale: folds 
GARRRN: folds 
qpAPMA3OH: folds 
Uncalled bet (2000) returned to assokappa788
assokappa788 collected 6575 from pot
assokappa788: doesn't show handDTO
*** SUMMARY ***
Total pot 6575 | Rake 0 
Seat 1: x-like-dotix folded before Flop (didn't bet)
Seat 2: assokappa788 collected (6575)
Seat 3: jcarlos.vale (button) folded before Flop (didn't bet)
Seat 4: GARRRN (small blind) folded before Flop
Seat 5: qpAPMA3OH (big blind) folded before Flop
Seat 6: Petra. F.44 folded before Flop (didn't bet)
Seat 7: lallelyk'lig folded before Flop (didn't bet)
Seat 8: Johannkasi2222 folded before Flop (didn't bet)
Seat 9: 721339 71147 folded before Flop (didn't bet)



PokerStars Hand #208303246865: Tournament #2779056951, $0.49+$0.06 USD Hold'em No Limit - Level XXII (1000/2000) - 2020/01/19 0:53:30 EET [2020/01/18 17:53:30 ET]
Table '2779056951 35' 9-max Seat #4 is the button
Seat 1: x-like-dotix (66117 in chips) 
Seat 2: assokappa788 (59627 in chips) 
Seat 3: jcarlos.vale (59480 in chips) 
Seat 4: GARRRN (25106 in chips) 
Seat 5: qpAPMA3OH (110548 in chips) 
Seat 6: Petra. F.44 (37210 in chips) 
Seat 7: lallelyk'lig (30001 in chips) 
Seat 8: Johannkasi2222 (165687 in chips) 
Seat 9: 721339 71147 (55660 in chips) 
x-like-dotix: posts the ante 175
assokappa788: posts the ante 175
jcarlos.vale: posts the ante 175
GARRRN: posts the ante 175
qpAPMA3OH: posts the ante 175
Petra. F.44: posts the ante 175
lallelyk'lig: posts the ante 175
Johannkasi2222: posts the ante 175
721339 71147: posts the ante 175
qpAPMA3OH: posts small blind 1000
Petra. F.44: posts big blind 2000
*** HOLE CARDS ***
Dealt to jcarlos.vale [6h 8c]
lallelyk'lig: folds 
Johannkasi2222: folds 
721339 71147: raises 2400 to 4400
x-like-dotix: raises 7600 to 12000
assokappa788: folds 
jcarlos.vale: folds 
GARRRN: folds 
qpAPMA3OH: folds 
Petra. F.44: folds 
721339 71147: raises 43485 to 55485 and is all-in
x-like-dotix: calls 43485
*** FLOP *** [2d 4h 5s]
*** TURN *** [2d 4h 5s] [Ac]
*** RIVER *** [2d 4h 5s Ac] [5h]
*** SHOW DOWN ***
721339 71147: shows [Kc Ad] (two pair, Aces and Fives)
x-like-dotix: shows [Js Jd] (two pair, Jacks and Fives)
721339 71147 collected 115545 from pot
*** SUMMARY ***
Total pot 115545 | Rake 0 
Board [2d 4h 5s Ac 5h]
Seat 1: x-like-dotix showed [Js Jd] and lost with two pair, Jacks and Fives
Seat 2: assokappa788 folded before Flop (didn't bet)
Seat 3: jcarlos.vale folded before Flop (didn't bet)
Seat 4: GARRRN (button) folded before Flop (didn't bet)
Seat 5: qpAPMA3OH (small blind) folded before Flop
Seat 6: Petra. F.44 (big blind) folded before Flop
Seat 7: lallelyk'lig folded before Flop (didn't bet)
Seat 8: Johannkasi2222 folded before Flop (didn't bet)
Seat 9: 721339 71147 showed [Kc Ad] and won (115545) with two pair, Aces and Fives



PokerStars Hand #208303279178: Tournament #2779056951, $0.49+$0.06 USD Hold'em No Limit - Level XXII (1000/2000) - 2020/01/19 0:54:31 EET [2020/01/18 17:54:31 ET]
Table '2779056951 35' 9-max Seat #5 is the button
Seat 1: x-like-dotix (10457 in chips) 
Seat 2: assokappa788 (59452 in chips) 
Seat 3: jcarlos.vale (59305 in chips) 
Seat 4: GARRRN (24931 in chips) 
Seat 5: qpAPMA3OH (109373 in chips) 
Seat 6: Petra. F.44 (35035 in chips) 
Seat 7: lallelyk'lig (29826 in chips) 
Seat 8: Johannkasi2222 (165512 in chips) 
Seat 9: 721339 71147 (115545 in chips) 
x-like-dotix: posts the ante 175
assokappa788: posts the ante 175
jcarlos.vale: posts the ante 175
GARRRN: posts the ante 175
qpAPMA3OH: posts the ante 175
Petra. F.44: posts the ante 175
lallelyk'lig: posts the ante 175
Johannkasi2222: posts the ante 175
721339 71147: posts the ante 175
Petra. F.44: posts small blind 1000
lallelyk'lig: posts big blind 2000
*** HOLE CARDS ***
Dealt to jcarlos.vale [Ts 6c]
Johannkasi2222: folds 
721339 71147: folds 
x-like-dotix: folds 
assokappa788: folds 
jcarlos.vale: folds 
GARRRN: folds 
qpAPMA3OH: folds 
Petra. F.44: calls 1000
lallelyk'lig: checks 
*** FLOP *** [8d As Td]
Petra. F.44: checks 
lallelyk'lig: checks 
*** TURN *** [8d As Td] [2c]
Petra. F.44: checks 
lallelyk'lig: checks 
*** RIVER *** [8d As Td 2c] [Jc]
Petra. F.44: checks 
lallelyk'lig: checks 
*** SHOW DOWN ***
Petra. F.44: shows [Qs 7h] (high pairOfCards Ace)
lallelyk'lig: shows [3d Qc] (high pairOfCards Ace)
Petra. F.44 collected 2788 from pot
lallelyk'lig collected 2787 from pot
*** SUMMARY ***
Total pot 5575 | Rake 0 
Board [8d As Td 2c Jc]
Seat 1: x-like-dotix folded before Flop (didn't bet)
Seat 2: assokappa788 folded before Flop (didn't bet)
Seat 3: jcarlos.vale folded before Flop (didn't bet)
Seat 4: GARRRN folded before Flop (didn't bet)
Seat 5: qpAPMA3OH (button) folded before Flop (didn't bet)
Seat 6: Petra. F.44 (small blind) showed [Qs 7h] and won (2788) with high pairOfCards Ace
Seat 7: lallelyk'lig (big blind) showed [3d Qc] and won (2787) with high pairOfCards Ace
Seat 8: Johannkasi2222 folded before Flop (didn't bet)
Seat 9: 721339 71147 folded before Flop (didn't bet)



PokerStars Hand #208303451104: Tournament #2779056951, $0.49+$0.06 USD Hold'em No Limit - Level XXII (1000/2000) - 2020/01/19 1:00:56 EET [2020/01/18 18:00:56 ET]
Table '2779056951 35' 9-max Seat #6 is the button
Seat 1: x-like-dotix (10282 in chips) 
Seat 2: assokappa788 (59277 in chips) 
Seat 3: jcarlos.vale (59130 in chips) 
Seat 4: GARRRN (24756 in chips) 
Seat 5: qpAPMA3OH (109198 in chips) 
Seat 6: Petra. F.44 (35648 in chips) 
Seat 7: lallelyk'lig (30438 in chips) 
Seat 8: Johannkasi2222 (165337 in chips) 
Seat 9: 721339 71147 (115370 in chips) 
x-like-dotix: posts the ante 175
assokappa788: posts the ante 175
jcarlos.vale: posts the ante 175
GARRRN: posts the ante 175
qpAPMA3OH: posts the ante 175
Petra. F.44: posts the ante 175
lallelyk'lig: posts the ante 175
Johannkasi2222: posts the ante 175
721339 71147: posts the ante 175
lallelyk'lig: posts small blind 1000
Johannkasi2222: posts big blind 2000
*** HOLE CARDS ***
Dealt to jcarlos.vale [8d Tc]
721339 71147: folds 
x-like-dotix: folds 
assokappa788: folds 
jcarlos.vale: folds 
GARRRN: folds 
qpAPMA3OH: folds 
Petra. F.44: folds 
lallelyk'lig has timed out
lallelyk'lig: folds 
lallelyk'lig is sitting out
Uncalled bet (1000) returned to Johannkasi2222
Johannkasi2222 collected 3575 from pot
*** SUMMARY ***
Total pot 3575 | Rake 0 
Seat 1: x-like-dotix folded before Flop (didn't bet)
Seat 2: assokappa788 folded before Flop (didn't bet)
Seat 3: jcarlos.vale folded before Flop (didn't bet)
Seat 4: GARRRN folded before Flop (didn't bet)
Seat 5: qpAPMA3OH folded before Flop (didn't bet)
Seat 6: Petra. F.44 (button) folded before Flop (didn't bet)
Seat 7: lallelyk'lig (small blind) folded before Flop
Seat 8: Johannkasi2222 (big blind) collected (3575)
Seat 9: 721339 71147 folded before Flop (didn't bet)



PokerStars Hand #208303468361: Tournament #2779056951, $0.49+$0.06 USD Hold'em No Limit - Level XXII (1000/2000) - 2020/01/19 1:01:31 EET [2020/01/18 18:01:31 ET]
Table '2779056951 35' 9-max Seat #7 is the button
Seat 1: x-like-dotix (10107 in chips) 
Seat 2: assokappa788 (59102 in chips) 
Seat 3: jcarlos.vale (58955 in chips) 
Seat 4: GARRRN (24581 in chips) 
Seat 5: qpAPMA3OH (109023 in chips) 
Seat 6: Petra. F.44 (35473 in chips) 
Seat 7: lallelyk'lig (29263 in chips) is sitting out
Seat 8: Johannkasi2222 (167737 in chips) 
Seat 9: 721339 71147 (115195 in chips) 
x-like-dotix: posts the ante 175
assokappa788: posts the ante 175
jcarlos.vale: posts the ante 175
GARRRN: posts the ante 175
qpAPMA3OH: posts the ante 175
Petra. F.44: posts the ante 175
lallelyk'lig: posts the ante 175
Johannkasi2222: posts the ante 175
721339 71147: posts the ante 175
Johannkasi2222: posts small blind 1000
721339 71147: posts big blind 2000
*** HOLE CARDS ***
Dealt to jcarlos.vale [4d 3c]
x-like-dotix: folds 
assokappa788: folds 
jcarlos.vale: folds 
GARRRN: folds 
qpAPMA3OH: raises 4000 to 6000
Petra. F.44: folds 
lallelyk'lig: folds 
Johannkasi2222: raises 161562 to 167562 and is all-in
721339 71147: folds 
qpAPMA3OH: folds 
Uncalled bet (161562) returned to Johannkasi2222
Johannkasi2222 collected 15575 from pot
*** SUMMARY ***
Total pot 15575 | Rake 0 
Seat 1: x-like-dotix folded before Flop (didn't bet)
Seat 2: assokappa788 folded before Flop (didn't bet)
Seat 3: jcarlos.vale folded before Flop (didn't bet)
Seat 4: GARRRN folded before Flop (didn't bet)
Seat 5: qpAPMA3OH folded before Flop
Seat 6: Petra. F.44 folded before Flop (didn't bet)
Seat 7: lallelyk'lig (button) folded before Flop (didn't bet)
Seat 8: Johannkasi2222 (small blind) collected (15575)
Seat 9: 721339 71147 (big blind) folded before Flop



PokerStars Hand #208303495140: Tournament #2779056951, $0.49+$0.06 USD Hold'em No Limit - Level XXII (1000/2000) - 2020/01/19 1:02:10 EET [2020/01/18 18:02:10 ET]
Table '2779056951 35' 9-max Seat #8 is the button
Seat 1: x-like-dotix (9932 in chips) 
Seat 2: assokappa788 (58927 in chips) 
Seat 3: jcarlos.vale (58780 in chips) 
Seat 4: GARRRN (24406 in chips) 
Seat 5: qpAPMA3OH (102848 in chips) 
Seat 6: Petra. F.44 (35298 in chips) 
Seat 7: lallelyk'lig (29088 in chips) is sitting out
Seat 8: Johannkasi2222 (177137 in chips) 
Seat 9: 721339 71147 (113020 in chips) 
x-like-dotix: posts the ante 175
assokappa788: posts the ante 175
jcarlos.vale: posts the ante 175
GARRRN: posts the ante 175
qpAPMA3OH: posts the ante 175
Petra. F.44: posts the ante 175
lallelyk'lig: posts the ante 175
Johannkasi2222: posts the ante 175
721339 71147: posts the ante 175
721339 71147: posts small blind 1000
x-like-dotix: posts big blind 2000
*** HOLE CARDS ***
Dealt to jcarlos.vale [2d Ad]
assokappa788: raises 2000 to 4000
jcarlos.vale: folds 
GARRRN: folds 
qpAPMA3OH: folds 
Petra. F.44: folds 
lallelyk'lig: folds 
Johannkasi2222: folds 
721339 71147: folds 
x-like-dotix: calls 2000
*** FLOP *** [2h 5s Ac]
x-like-dotix: checks 
assokappa788: bets 4000
x-like-dotix: folds 
Uncalled bet (4000) returned to assokappa788
assokappa788 collected 10575 from pot
assokappa788: doesn't show handDTO
*** SUMMARY ***
Total pot 10575 | Rake 0 
Board [2h 5s Ac]
Seat 1: x-like-dotix (big blind) folded on the Flop
Seat 2: assokappa788 collected (10575)
Seat 3: jcarlos.vale folded before Flop (didn't bet)
Seat 4: GARRRN folded before Flop (didn't bet)
Seat 5: qpAPMA3OH folded before Flop (didn't bet)
Seat 6: Petra. F.44 folded before Flop (didn't bet)
Seat 7: lallelyk'lig folded before Flop (didn't bet)
Seat 8: Johannkasi2222 (button) folded before Flop (didn't bet)
Seat 9: 721339 71147 (small blind) folded before Flop



PokerStars Hand #208303522993: Tournament #2779056951, $0.49+$0.06 USD Hold'em No Limit - Level XXII (1000/2000) - 2020/01/19 1:03:03 EET [2020/01/18 18:03:03 ET]
Table '2779056951 35' 9-max Seat #9 is the button
Seat 1: x-like-dotix (5757 in chips) 
Seat 2: assokappa788 (65327 in chips) 
Seat 3: jcarlos.vale (58605 in chips) 
Seat 4: GARRRN (24231 in chips) 
Seat 5: qpAPMA3OH (102673 in chips) 
Seat 6: Petra. F.44 (35123 in chips) 
Seat 7: lallelyk'lig (28913 in chips) is sitting out
Seat 8: Johannkasi2222 (176962 in chips) 
Seat 9: 721339 71147 (111845 in chips) 
x-like-dotix: posts the ante 175
assokappa788: posts the ante 175
jcarlos.vale: posts the ante 175
GARRRN: posts the ante 175
qpAPMA3OH: posts the ante 175
Petra. F.44: posts the ante 175
lallelyk'lig: posts the ante 175
Johannkasi2222: posts the ante 175
721339 71147: posts the ante 175
x-like-dotix: posts small blind 1000
assokappa788: posts big blind 2000
*** HOLE CARDS ***
Dealt to jcarlos.vale [Qd Ad]
jcarlos.vale: raises 2200 to 4200
GARRRN: folds 
qpAPMA3OH: calls 4200
Petra. F.44: folds 
lallelyk'lig: folds 
Johannkasi2222: folds 
721339 71147: folds 
x-like-dotix: folds 
assokappa788: calls 2200
*** FLOP *** [Qc 3c 5s]
assokappa788: checks 
jcarlos.vale: bets 6000
qpAPMA3OH: folds 
assokappa788: calls 6000
*** TURN *** [Qc 3c 5s] [4s]
assokappa788: checks 
jcarlos.vale: bets 6000
assokappa788: calls 6000
*** RIVER *** [Qc 3c 5s 4s] [8s]
assokappa788: checks 
jcarlos.vale: bets 6000
assokappa788: calls 6000
*** SHOW DOWN ***
jcarlos.vale: shows [Qd Ad] (a pair of Queens)
assokappa788: mucks handDTO
jcarlos.vale collected 51175 from pot
*** SUMMARY ***
Total pot 51175 | Rake 0 
Board [Qc 3c 5s 4s 8s]
Seat 1: x-like-dotix (small blind) folded before Flop
Seat 2: assokappa788 (big blind) mucked [7h 4c]
Seat 3: jcarlos.vale showed [Qd Ad] and won (51175) with a pair of Queens
Seat 4: GARRRN folded before Flop (didn't bet)
Seat 5: qpAPMA3OH folded on the Flop
Seat 6: Petra. F.44 folded before Flop (didn't bet)
Seat 7: lallelyk'lig folded before Flop (didn't bet)
Seat 8: Johannkasi2222 folded before Flop (didn't bet)
Seat 9: 721339 71147 (button) folded before Flop (didn't bet)



PokerStars Hand #208303559069: Tournament #2779056951, $0.49+$0.06 USD Hold'em No Limit - Level XXII (1000/2000) - 2020/01/19 1:04:12 EET [2020/01/18 18:04:12 ET]
Table '2779056951 35' 9-max Seat #1 is the button
Seat 1: x-like-dotix (4582 in chips) 
Seat 2: assokappa788 (42952 in chips) 
Seat 3: jcarlos.vale (87405 in chips) 
Seat 4: GARRRN (24056 in chips) 
Seat 5: qpAPMA3OH (98298 in chips) 
Seat 6: Petra. F.44 (34948 in chips) 
Seat 7: lallelyk'lig (28738 in chips) is sitting out
Seat 8: Johannkasi2222 (176787 in chips) 
Seat 9: 721339 71147 (111670 in chips) 
x-like-dotix: posts the ante 175
assokappa788: posts the ante 175
jcarlos.vale: posts the ante 175
GARRRN: posts the ante 175
qpAPMA3OH: posts the ante 175
Petra. F.44: posts the ante 175
lallelyk'lig: posts the ante 175
Johannkasi2222: posts the ante 175
721339 71147: posts the ante 175
assokappa788: posts small blind 1000
jcarlos.vale: posts big blind 2000
*** HOLE CARDS ***
Dealt to jcarlos.vale [6s 9h]
GARRRN: raises 21881 to 23881 and is all-in
qpAPMA3OH: folds 
Petra. F.44: folds 
lallelyk'lig: folds 
Johannkasi2222: folds 
721339 71147: folds 
x-like-dotix: calls 4407 and is all-in
assokappa788: folds 
jcarlos.vale: folds 
Uncalled bet (19474) returned to GARRRN
*** FLOP *** [7h 2d 5h]
*** TURN *** [7h 2d 5h] [Qs]
*** RIVER *** [7h 2d 5h Qs] [6c]
*** SHOW DOWN ***
GARRRN: shows [Kc Qc] (a pair of Queens)
x-like-dotix: shows [Jc Jh] (a pair of Jacks)
GARRRN collected 13389 from pot
x-like-dotix finished the tournament in 182nd place and received $1.83.
*** SUMMARY ***
Total pot 13389 | Rake 0 
Board [7h 2d 5h Qs 6c]
Seat 1: x-like-dotix (button) showed [Jc Jh] and lost with a pair of Jacks
Seat 2: assokappa788 (small blind) folded before Flop
Seat 3: jcarlos.vale (big blind) folded before Flop
Seat 4: GARRRN showed [Kc Qc] and won (13389) with a pair of Queens
Seat 5: qpAPMA3OH folded before Flop (didn't bet)
Seat 6: Petra. F.44 folded before Flop (didn't bet)
Seat 7: lallelyk'lig folded before Flop (didn't bet)
Seat 8: Johannkasi2222 folded before Flop (didn't bet)
Seat 9: 721339 71147 folded before Flop (didn't bet)



PokerStars Hand #208303580751: Tournament #2779056951, $0.49+$0.06 USD Hold'em No Limit - Level XXII (1000/2000) - 2020/01/19 1:04:54 EET [2020/01/18 18:04:54 ET]
Table '2779056951 35' 9-max Seat #2 is the button
Seat 2: assokappa788 (41777 in chips) 
Seat 3: jcarlos.vale (85230 in chips) 
Seat 4: GARRRN (32863 in chips) 
Seat 5: qpAPMA3OH (98123 in chips) 
Seat 6: Petra. F.44 (34773 in chips) 
Seat 7: lallelyk'lig (28563 in chips) is sitting out
Seat 8: Johannkasi2222 (176612 in chips) 
Seat 9: 721339 71147 (111495 in chips) 
assokappa788: posts the ante 175
jcarlos.vale: posts the ante 175
GARRRN: posts the ante 175
qpAPMA3OH: posts the ante 175
Petra. F.44: posts the ante 175
lallelyk'lig: posts the ante 175
Johannkasi2222: posts the ante 175
721339 71147: posts the ante 175
jcarlos.vale: posts small blind 1000
GARRRN: posts big blind 2000
*** HOLE CARDS ***
Dealt to jcarlos.vale [4s 4h]
qpAPMA3OH: folds 
Petra. F.44: folds 
lallelyk'lig: folds 
Johannkasi2222: folds 
721339 71147: raises 2000 to 4000
assokappa788: calls 4000
jcarlos.vale: calls 3000
lallelyk'lig is disconnected 
GARRRN: folds 
*** FLOP *** [Jh 4d 8c]
jcarlos.vale: checks 
721339 71147: checks 
assokappa788: checks 
*** TURN *** [Jh 4d 8c] [3h]
jcarlos.vale: bets 6000
721339 71147: folds 
assokappa788: folds 
Uncalled bet (6000) returned to jcarlos.vale
jcarlos.vale collected 15400 from pot
jcarlos.vale: doesn't show handDTO
*** SUMMARY ***
Total pot 15400 | Rake 0 
Board [Jh 4d 8c 3h]
Seat 2: assokappa788 (button) folded on the Turn
Seat 3: jcarlos.vale (small blind) collected (15400)
Seat 4: GARRRN (big blind) folded before Flop
Seat 5: qpAPMA3OH folded before Flop (didn't bet)
Seat 6: Petra. F.44 folded before Flop (didn't bet)
Seat 7: lallelyk'lig folded before Flop (didn't bet)
Seat 8: Johannkasi2222 folded before Flop (didn't bet)
Seat 9: 721339 71147 folded on the Turn



PokerStars Hand #208303611662: Tournament #2779056951, $0.49+$0.06 USD Hold'em No Limit - Level XXII (1000/2000) - 2020/01/19 1:05:53 EET [2020/01/18 18:05:53 ET]
Table '2779056951 35' 9-max Seat #3 is the button
Seat 1: bullbond (89135 in chips) 
Seat 2: assokappa788 (37602 in chips) 
Seat 3: jcarlos.vale (96455 in chips) 
Seat 4: GARRRN (30688 in chips) 
Seat 5: qpAPMA3OH (97948 in chips) 
Seat 6: Petra. F.44 (34598 in chips) 
Seat 7: lallelyk'lig (28388 in chips) is sitting out
Seat 8: Johannkasi2222 (176437 in chips) 
Seat 9: 721339 71147 (107320 in chips) 
bullbond: posts the ante 175
assokappa788: posts the ante 175
jcarlos.vale: posts the ante 175
GARRRN: posts the ante 175
qpAPMA3OH: posts the ante 175
Petra. F.44: posts the ante 175
lallelyk'lig: posts the ante 175
Johannkasi2222: posts the ante 175
721339 71147: posts the ante 175
GARRRN: posts small blind 1000
qpAPMA3OH: posts big blind 2000
*** HOLE CARDS ***
Dealt to jcarlos.vale [9c 5d]
Petra. F.44: folds 
lallelyk'lig: folds 
Johannkasi2222: folds 
721339 71147: folds 
bullbond: calls 2000
assokappa788: folds 
jcarlos.vale: folds 
GARRRN: calls 1000
qpAPMA3OH: checks 
*** FLOP *** [4s Ah Qc]
GARRRN: checks 
qpAPMA3OH: checks 
bullbond: bets 3788
GARRRN: folds 
qpAPMA3OH: folds 
Uncalled bet (3788) returned to bullbond
bullbond collected 7575 from pot
*** SUMMARY ***
Total pot 7575 | Rake 0 
Board [4s Ah Qc]
Seat 1: bullbond collected (7575)
Seat 2: assokappa788 folded before Flop (didn't bet)
Seat 3: jcarlos.vale (button) folded before Flop (didn't bet)
Seat 4: GARRRN (small blind) folded on the Flop
Seat 5: qpAPMA3OH (big blind) folded on the Flop
Seat 6: Petra. F.44 folded before Flop (didn't bet)
Seat 7: lallelyk'lig folded before Flop (didn't bet)
Seat 8: Johannkasi2222 folded before Flop (didn't bet)
Seat 9: 721339 71147 folded before Flop (didn't bet)



PokerStars Hand #208303630527: Tournament #2779056951, $0.49+$0.06 USD Hold'em No Limit - Level XXII (1000/2000) - 2020/01/19 1:06:29 EET [2020/01/18 18:06:29 ET]
Table '2779056951 35' 9-max Seat #4 is the button
Seat 1: bullbond (94535 in chips) 
Seat 2: assokappa788 (37427 in chips) 
Seat 3: jcarlos.vale (96280 in chips) 
Seat 4: GARRRN (28513 in chips) 
Seat 5: qpAPMA3OH (95773 in chips) 
Seat 6: Petra. F.44 (34423 in chips) 
Seat 7: lallelyk'lig (28213 in chips) is sitting out
Seat 8: Johannkasi2222 (176262 in chips) 
Seat 9: 721339 71147 (107145 in chips) 
bullbond: posts the ante 175
assokappa788: posts the ante 175
jcarlos.vale: posts the ante 175
GARRRN: posts the ante 175
qpAPMA3OH: posts the ante 175
Petra. F.44: posts the ante 175
lallelyk'lig: posts the ante 175
Johannkasi2222: posts the ante 175
721339 71147: posts the ante 175
qpAPMA3OH: posts small blind 1000
Petra. F.44: posts big blind 2000
*** HOLE CARDS ***
Dealt to jcarlos.vale [Tc 7h]
lallelyk'lig: folds 
Johannkasi2222: folds 
721339 71147: raises 2400 to 4400
bullbond: folds 
assokappa788: calls 4400
jcarlos.vale: folds 
GARRRN: folds 
qpAPMA3OH: folds 
Petra. F.44: calls 2400
*** FLOP *** [Ks As Js]
Petra. F.44: checks 
721339 71147: checks 
assokappa788: checks 
*** TURN *** [Ks As Js] [6c]
Petra. F.44: checks 
721339 71147: checks 
assokappa788: bets 4000
Petra. F.44: folds 
721339 71147: calls 4000
*** RIVER *** [Ks As Js 6c] [Qs]
721339 71147: checks 
assokappa788: checks 
*** SHOW DOWN ***
721339 71147: shows [Qc Ac] (two pair, Aces and Queens)
assokappa788: mucks handDTO
721339 71147 collected 23775 from pot
*** SUMMARY ***
Total pot 23775 | Rake 0 
Board [Ks As Js 6c Qs]
Seat 1: bullbond folded before Flop (didn't bet)
Seat 2: assokappa788 mucked [9c 9d]
Seat 3: jcarlos.vale folded before Flop (didn't bet)
Seat 4: GARRRN (button) folded before Flop (didn't bet)
Seat 5: qpAPMA3OH (small blind) folded before Flop
Seat 6: Petra. F.44 (big blind) folded on the Turn
Seat 7: lallelyk'lig folded before Flop (didn't bet)
Seat 8: Johannkasi2222 folded before Flop (didn't bet)
Seat 9: 721339 71147 showed [Qc Ac] and won (23775) with two pair, Aces and Queens



PokerStars Hand #208303684298: Tournament #2779056951, $0.49+$0.06 USD Hold'em No Limit - Level XXIII (1250/2500) - 2020/01/19 1:08:08 EET [2020/01/18 18:08:08 ET]
Table '2779056951 35' 9-max Seat #5 is the button
Seat 1: bullbond (94360 in chips) 
Seat 2: assokappa788 (28852 in chips) 
Seat 3: jcarlos.vale (96105 in chips) 
Seat 4: GARRRN (28338 in chips) 
Seat 5: qpAPMA3OH (94598 in chips) 
Seat 6: Petra. F.44 (29848 in chips) 
Seat 7: lallelyk'lig (28038 in chips) is sitting out
Seat 8: Johannkasi2222 (176087 in chips) 
Seat 9: 721339 71147 (122345 in chips) 
bullbond: posts the ante 200
assokappa788: posts the ante 200
jcarlos.vale: posts the ante 200
GARRRN: posts the ante 200
qpAPMA3OH: posts the ante 200
Petra. F.44: posts the ante 200
lallelyk'lig: posts the ante 200
Johannkasi2222: posts the ante 200
721339 71147: posts the ante 200
Petra. F.44: posts small blind 1250
lallelyk'lig: posts big blind 2500
*** HOLE CARDS ***
Dealt to jcarlos.vale [Jh 6c]
Johannkasi2222: folds 
721339 71147: folds 
bullbond: raises 5000 to 7500
assokappa788: folds 
jcarlos.vale: folds 
GARRRN: folds 
qpAPMA3OH: folds 
Petra. F.44: folds 
lallelyk'lig: folds 
Uncalled bet (5000) returned to bullbond
bullbond collected 8050 from pot
*** SUMMARY ***
Total pot 8050 | Rake 0 
Seat 1: bullbond collected (8050)
Seat 2: assokappa788 folded before Flop (didn't bet)
Seat 3: jcarlos.vale folded before Flop (didn't bet)
Seat 4: GARRRN folded before Flop (didn't bet)
Seat 5: qpAPMA3OH (button) folded before Flop (didn't bet)
Seat 6: Petra. F.44 (small blind) folded before Flop
Seat 7: lallelyk'lig (big blind) folded before Flop
Seat 8: Johannkasi2222 folded before Flop (didn't bet)
Seat 9: 721339 71147 folded before Flop (didn't bet)



PokerStars Hand #208303693576: Tournament #2779056951, $0.49+$0.06 USD Hold'em No Limit - Level XXIII (1250/2500) - 2020/01/19 1:08:26 EET [2020/01/18 18:08:26 ET]
Table '2779056951 35' 9-max Seat #6 is the button
Seat 1: bullbond (99710 in chips) 
Seat 2: assokappa788 (28652 in chips) 
Seat 3: jcarlos.vale (95905 in chips) 
Seat 4: GARRRN (28138 in chips) 
Seat 5: qpAPMA3OH (94398 in chips) 
Seat 6: Petra. F.44 (28398 in chips) 
Seat 7: lallelyk'lig (25338 in chips) is sitting out
Seat 8: Johannkasi2222 (175887 in chips) 
Seat 9: 721339 71147 (122145 in chips) 
bullbond: posts the ante 200
assokappa788: posts the ante 200
jcarlos.vale: posts the ante 200
GARRRN: posts the ante 200
qpAPMA3OH: posts the ante 200
Petra. F.44: posts the ante 200
lallelyk'lig: posts the ante 200
Johannkasi2222: posts the ante 200
721339 71147: posts the ante 200
lallelyk'lig: posts small blind 1250
Johannkasi2222: posts big blind 2500
*** HOLE CARDS ***
Dealt to jcarlos.vale [Ts 5h]
721339 71147: folds 
bullbond: folds 
assokappa788: folds 
jcarlos.vale: folds 
GARRRN: folds 
qpAPMA3OH: folds 
Petra. F.44: folds 
lallelyk'lig: folds 
Uncalled bet (1250) returned to Johannkasi2222
Johannkasi2222 collected 4300 from pot
*** SUMMARY ***
Total pot 4300 | Rake 0 
Seat 1: bullbond folded before Flop (didn't bet)
Seat 2: assokappa788 folded before Flop (didn't bet)
Seat 3: jcarlos.vale folded before Flop (didn't bet)
Seat 4: GARRRN folded before Flop (didn't bet)
Seat 5: qpAPMA3OH folded before Flop (didn't bet)
Seat 6: Petra. F.44 (button) folded before Flop (didn't bet)
Seat 7: lallelyk'lig (small blind) folded before Flop
Seat 8: Johannkasi2222 (big blind) collected (4300)
Seat 9: 721339 71147 folded before Flop (didn't bet)



PokerStars Hand #208303703314: Tournament #2779056951, $0.49+$0.06 USD Hold'em No Limit - Level XXIII (1250/2500) - 2020/01/19 1:08:45 EET [2020/01/18 18:08:45 ET]
Table '2779056951 35' 9-max Seat #7 is the button
Seat 1: bullbond (99510 in chips) 
Seat 2: assokappa788 (28452 in chips) 
Seat 3: jcarlos.vale (95705 in chips) 
Seat 4: GARRRN (27938 in chips) 
Seat 5: qpAPMA3OH (94198 in chips) 
Seat 6: Petra. F.44 (28198 in chips) 
Seat 7: lallelyk'lig (23888 in chips) is sitting out
Seat 8: Johannkasi2222 (178737 in chips) 
Seat 9: 721339 71147 (121945 in chips) 
bullbond: posts the ante 200
assokappa788: posts the ante 200
jcarlos.vale: posts the ante 200
GARRRN: posts the ante 200
qpAPMA3OH: posts the ante 200
Petra. F.44: posts the ante 200
lallelyk'lig: posts the ante 200
Johannkasi2222: posts the ante 200
721339 71147: posts the ante 200
Johannkasi2222: posts small blind 1250
721339 71147: posts big blind 2500
*** HOLE CARDS ***
Dealt to jcarlos.vale [4d 5d]
bullbond: folds 
assokappa788: calls 2500
jcarlos.vale: folds 
GARRRN: folds 
qpAPMA3OH: folds 
Petra. F.44: folds 
lallelyk'lig: folds 
Johannkasi2222: folds 
721339 71147: checks 
*** FLOP *** [5h 8s As]
721339 71147: checks 
assokappa788: bets 2500
721339 71147: folds 
Uncalled bet (2500) returned to assokappa788
assokappa788 collected 8050 from pot
assokappa788: doesn't show handDTO
*** SUMMARY ***
Total pot 8050 | Rake 0 
Board [5h 8s As]
Seat 1: bullbond folded before Flop (didn't bet)
Seat 2: assokappa788 collected (8050)
Seat 3: jcarlos.vale folded before Flop (didn't bet)
Seat 4: GARRRN folded before Flop (didn't bet)
Seat 5: qpAPMA3OH folded before Flop (didn't bet)
Seat 6: Petra. F.44 folded before Flop (didn't bet)
Seat 7: lallelyk'lig (button) folded before Flop (didn't bet)
Seat 8: Johannkasi2222 (small blind) folded before Flop
Seat 9: 721339 71147 (big blind) folded on the Flop



PokerStars Hand #208303727236: Tournament #2779056951, $0.49+$0.06 USD Hold'em No Limit - Level XXIII (1250/2500) - 2020/01/19 1:09:31 EET [2020/01/18 18:09:31 ET]
Table '2779056951 35' 9-max Seat #8 is the button
Seat 1: bullbond (99310 in chips) 
Seat 2: assokappa788 (33802 in chips) 
Seat 3: jcarlos.vale (95505 in chips) 
Seat 4: GARRRN (27738 in chips) 
Seat 5: qpAPMA3OH (93998 in chips) 
Seat 6: Petra. F.44 (27998 in chips) 
Seat 7: lallelyk'lig (23688 in chips) is sitting out
Seat 8: Johannkasi2222 (177287 in chips) 
Seat 9: 721339 71147 (119245 in chips) 
bullbond: posts the ante 200
assokappa788: posts the ante 200
jcarlos.vale: posts the ante 200
GARRRN: posts the ante 200
qpAPMA3OH: posts the ante 200
Petra. F.44: posts the ante 200
lallelyk'lig: posts the ante 200
Johannkasi2222: posts the ante 200
721339 71147: posts the ante 200
721339 71147: posts small blind 1250
bullbond: posts big blind 2500
*** HOLE CARDS ***
Dealt to jcarlos.vale [2c 8s]
assokappa788: folds 
jcarlos.vale: folds 
GARRRN: folds 
qpAPMA3OH: folds 
Petra. F.44: folds 
lallelyk'lig: folds 
Johannkasi2222: folds 
721339 71147: folds 
Uncalled bet (1250) returned to bullbond
bullbond collected 4300 from pot
*** SUMMARY ***
Total pot 4300 | Rake 0 
Seat 1: bullbond (big blind) collected (4300)
Seat 2: assokappa788 folded before Flop (didn't bet)
Seat 3: jcarlos.vale folded before Flop (didn't bet)
Seat 4: GARRRN folded before Flop (didn't bet)
Seat 5: qpAPMA3OH folded before Flop (didn't bet)
Seat 6: Petra. F.44 folded before Flop (didn't bet)
Seat 7: lallelyk'lig folded before Flop (didn't bet)
Seat 8: Johannkasi2222 (button) folded before Flop (didn't bet)
Seat 9: 721339 71147 (small blind) folded before Flop



PokerStars Hand #208303739992: Tournament #2779056951, $0.49+$0.06 USD Hold'em No Limit - Level XXIII (1250/2500) - 2020/01/19 1:09:56 EET [2020/01/18 18:09:56 ET]
Table '2779056951 35' 9-max Seat #9 is the button
Seat 1: bullbond (102160 in chips) 
Seat 2: assokappa788 (33602 in chips) 
Seat 3: jcarlos.vale (95305 in chips) 
Seat 4: GARRRN (27538 in chips) 
Seat 5: qpAPMA3OH (93798 in chips) 
Seat 6: Petra. F.44 (27798 in chips) 
Seat 7: lallelyk'lig (23488 in chips) is sitting out
Seat 8: Johannkasi2222 (177087 in chips) 
Seat 9: 721339 71147 (117795 in chips) 
bullbond: posts the ante 200
assokappa788: posts the ante 200
jcarlos.vale: posts the ante 200
GARRRN: posts the ante 200
qpAPMA3OH: posts the ante 200
Petra. F.44: posts the ante 200
lallelyk'lig: posts the ante 200
Johannkasi2222: posts the ante 200
721339 71147: posts the ante 200
bullbond: posts small blind 1250
assokappa788: posts big blind 2500
*** HOLE CARDS ***
Dealt to jcarlos.vale [4d Jh]
jcarlos.vale: folds 
GARRRN: folds 
qpAPMA3OH: folds 
Petra. F.44: folds 
lallelyk'lig: folds 
Johannkasi2222: raises 174387 to 176887 and is all-in
721339 71147: folds 
bullbond: folds 
assokappa788: folds 
Uncalled bet (174387) returned to Johannkasi2222
Johannkasi2222 collected 8050 from pot
*** SUMMARY ***
Total pot 8050 | Rake 0 
Seat 1: bullbond (small blind) folded before Flop
Seat 2: assokappa788 (big blind) folded before Flop
Seat 3: jcarlos.vale folded before Flop (didn't bet)
Seat 4: GARRRN folded before Flop (didn't bet)
Seat 5: qpAPMA3OH folded before Flop (didn't bet)
Seat 6: Petra. F.44 folded before Flop (didn't bet)
Seat 7: lallelyk'lig folded before Flop (didn't bet)
Seat 8: Johannkasi2222 collected (8050)
Seat 9: 721339 71147 (button) folded before Flop (didn't bet)



PokerStars Hand #208303751468: Tournament #2779056951, $0.49+$0.06 USD Hold'em No Limit - Level XXIII (1250/2500) - 2020/01/19 1:10:18 EET [2020/01/18 18:10:18 ET]
Table '2779056951 35' 9-max Seat #1 is the button
Seat 1: bullbond (100710 in chips) 
Seat 2: assokappa788 (30902 in chips) 
Seat 3: jcarlos.vale (95105 in chips) 
Seat 4: GARRRN (27338 in chips) 
Seat 5: qpAPMA3OH (93598 in chips) 
Seat 6: Petra. F.44 (27598 in chips) 
Seat 7: lallelyk'lig (23288 in chips) is sitting out
Seat 8: Johannkasi2222 (182437 in chips) 
Seat 9: 721339 71147 (117595 in chips) 
bullbond: posts the ante 200
assokappa788: posts the ante 200
jcarlos.vale: posts the ante 200
GARRRN: posts the ante 200
qpAPMA3OH: posts the ante 200
Petra. F.44: posts the ante 200
lallelyk'lig: posts the ante 200
Johannkasi2222: posts the ante 200
721339 71147: posts the ante 200
assokappa788: posts small blind 1250
jcarlos.vale: posts big blind 2500
*** HOLE CARDS ***
Dealt to jcarlos.vale [Qs 5c]
GARRRN: folds 
qpAPMA3OH: folds 
Petra. F.44: folds 
lallelyk'lig: folds 
Johannkasi2222: folds 
721339 71147: folds 
bullbond: folds 
assokappa788: calls 1250
jcarlos.vale: checks 
*** FLOP *** [As Ts 2s]
assokappa788: bets 2500
jcarlos.vale: calls 2500
*** TURN *** [As Ts 2s] [Tc]
assokappa788: bets 2500
jcarlos.vale: calls 2500
*** RIVER *** [As Ts 2s Tc] [2d]
assokappa788: bets 2500
jcarlos.vale: calls 2500
*** SHOW DOWN ***
assokappa788: shows [2c 4d] (a full house, Deuces full of Tens)
jcarlos.vale: mucks handDTO
assokappa788 collected 21800 from pot
*** SUMMARY ***
Total pot 21800 | Rake 0 
Board [As Ts 2s Tc 2d]
Seat 1: bullbond (button) folded before Flop (didn't bet)
Seat 2: assokappa788 (small blind) showed [2c 4d] and won (21800) with a full house, Deuces full of Tens
Seat 3: jcarlos.vale (big blind) mucked [Qs 5c]
Seat 4: GARRRN folded before Flop (didn't bet)
Seat 5: qpAPMA3OH folded before Flop (didn't bet)
Seat 6: Petra. F.44 folded before Flop (didn't bet)
Seat 7: lallelyk'lig folded before Flop (didn't bet)
Seat 8: Johannkasi2222 folded before Flop (didn't bet)
Seat 9: 721339 71147 folded before Flop (didn't bet)



PokerStars Hand #208303772114: Tournament #2779056951, $0.49+$0.06 USD Hold'em No Limit - Level XXIII (1250/2500) - 2020/01/19 1:10:57 EET [2020/01/18 18:10:57 ET]
Table '2779056951 35' 9-max Seat #2 is the button
Seat 1: bullbond (100510 in chips) 
Seat 2: assokappa788 (42502 in chips) 
Seat 3: jcarlos.vale (84905 in chips) 
Seat 4: GARRRN (27138 in chips) 
Seat 5: qpAPMA3OH (93398 in chips) 
Seat 6: Petra. F.44 (27398 in chips) 
Seat 7: lallelyk'lig (23088 in chips) is sitting out
Seat 8: Johannkasi2222 (182237 in chips) 
Seat 9: 721339 71147 (117395 in chips) 
bullbond: posts the ante 200
assokappa788: posts the ante 200
jcarlos.vale: posts the ante 200
GARRRN: posts the ante 200
qpAPMA3OH: posts the ante 200
Petra. F.44: posts the ante 200
lallelyk'lig: posts the ante 200
Johannkasi2222: posts the ante 200
721339 71147: posts the ante 200
jcarlos.vale: posts small blind 1250
GARRRN: posts big blind 2500
*** HOLE CARDS ***
Dealt to jcarlos.vale [4h 5d]
qpAPMA3OH: folds 
Petra. F.44: folds 
lallelyk'lig: folds 
Johannkasi2222: folds 
721339 71147: raises 3000 to 5500
bullbond: folds 
assokappa788: folds 
jcarlos.vale: folds 
GARRRN: calls 3000
*** FLOP *** [2s 5c 7s]
GARRRN: checks 
721339 71147: checks 
*** TURN *** [2s 5c 7s] [6s]
GARRRN: bets 5000
721339 71147: folds 
Uncalled bet (5000) returned to GARRRN
GARRRN collected 14050 from pot
*** SUMMARY ***
Total pot 14050 | Rake 0 
Board [2s 5c 7s 6s]
Seat 1: bullbond folded before Flop (didn't bet)
Seat 2: assokappa788 (button) folded before Flop (didn't bet)
Seat 3: jcarlos.vale (small blind) folded before Flop
Seat 4: GARRRN (big blind) collected (14050)
Seat 5: qpAPMA3OH folded before Flop (didn't bet)
Seat 6: Petra. F.44 folded before Flop (didn't bet)
Seat 7: lallelyk'lig folded before Flop (didn't bet)
Seat 8: Johannkasi2222 folded before Flop (didn't bet)
Seat 9: 721339 71147 folded on the Turn



PokerStars Hand #208303799124: Tournament #2779056951, $0.49+$0.06 USD Hold'em No Limit - Level XXIII (1250/2500) - 2020/01/19 1:11:50 EET [2020/01/18 18:11:50 ET]
Table '2779056951 35' 9-max Seat #3 is the button
Seat 1: bullbond (100310 in chips) 
Seat 2: assokappa788 (42302 in chips) 
Seat 3: jcarlos.vale (83455 in chips) 
Seat 4: GARRRN (35488 in chips) 
Seat 5: qpAPMA3OH (93198 in chips) 
Seat 6: Petra. F.44 (27198 in chips) 
Seat 7: lallelyk'lig (22888 in chips) is sitting out
Seat 8: Johannkasi2222 (182037 in chips) 
Seat 9: 721339 71147 (111695 in chips) 
bullbond: posts the ante 200
assokappa788: posts the ante 200
jcarlos.vale: posts the ante 200
GARRRN: posts the ante 200
qpAPMA3OH: posts the ante 200
Petra. F.44: posts the ante 200
lallelyk'lig: posts the ante 200
Johannkasi2222: posts the ante 200
721339 71147: posts the ante 200
GARRRN: posts small blind 1250
qpAPMA3OH: posts big blind 2500
*** HOLE CARDS ***
Dealt to jcarlos.vale [6h 4c]
Petra. F.44: folds 
lallelyk'lig: folds 
Johannkasi2222: folds 
721339 71147: raises 3000 to 5500
bullbond: folds 
lallelyk'lig has returned
assokappa788: calls 5500
jcarlos.vale: folds 
GARRRN: folds 
qpAPMA3OH: folds 
*** FLOP *** [5d 5s 9s]
721339 71147: checks 
assokappa788: checks 
*** TURN *** [5d 5s 9s] [Qs]
721339 71147: checks 
assokappa788: bets 5000
721339 71147: folds 
Uncalled bet (5000) returned to assokappa788
assokappa788 collected 16550 from pot
assokappa788: doesn't show handDTO
*** SUMMARY ***
Total pot 16550 | Rake 0 
Board [5d 5s 9s Qs]
Seat 1: bullbond folded before Flop (didn't bet)
Seat 2: assokappa788 collected (16550)
Seat 3: jcarlos.vale (button) folded before Flop (didn't bet)
Seat 4: GARRRN (small blind) folded before Flop
Seat 5: qpAPMA3OH (big blind) folded before Flop
Seat 6: Petra. F.44 folded before Flop (didn't bet)
Seat 7: lallelyk'lig folded before Flop (didn't bet)
Seat 8: Johannkasi2222 folded before Flop (didn't bet)
Seat 9: 721339 71147 folded on the Turn



PokerStars Hand #208303846954: Tournament #2779056951, $0.49+$0.06 USD Hold'em No Limit - Level XXIII (1250/2500) - 2020/01/19 1:13:07 EET [2020/01/18 18:13:07 ET]
Table '2779056951 35' 9-max Seat #4 is the button
Seat 1: bullbond (100110 in chips) 
Seat 2: assokappa788 (53152 in chips) 
Seat 3: jcarlos.vale (83255 in chips) 
Seat 4: GARRRN (34038 in chips) 
Seat 5: qpAPMA3OH (90498 in chips) 
Seat 6: Petra. F.44 (26998 in chips) 
Seat 7: lallelyk'lig (22688 in chips) 
Seat 8: Johannkasi2222 (181837 in chips) 
Seat 9: 721339 71147 (105995 in chips) 
bullbond: posts the ante 200
assokappa788: posts the ante 200
jcarlos.vale: posts the ante 200
GARRRN: posts the ante 200
qpAPMA3OH: posts the ante 200
Petra. F.44: posts the ante 200
lallelyk'lig: posts the ante 200
Johannkasi2222: posts the ante 200
721339 71147: posts the ante 200
qpAPMA3OH: posts small blind 1250
Petra. F.44: posts big blind 2500
*** HOLE CARDS ***
Dealt to jcarlos.vale [5s 2c]
lallelyk'lig has timed out
lallelyk'lig: folds 
lallelyk'lig is sitting out
Johannkasi2222: folds 
721339 71147: folds 
bullbond: folds 
assokappa788: raises 2500 to 5000
jcarlos.vale: folds 
GARRRN: folds 
qpAPMA3OH: folds 
Petra. F.44: calls 2500
*** FLOP *** [2s 4c Tc]
Petra. F.44: checks 
assokappa788: checks 
*** TURN *** [2s 4c Tc] [3h]
lallelyk'lig has returned
Petra. F.44: checks 
assokappa788: bets 2500
Petra. F.44: calls 2500
*** RIVER *** [2s 4c Tc 3h] [9s]
Petra. F.44: checks 
assokappa788: checks 
*** SHOW DOWN ***
Petra. F.44: shows [6d 3d] (a pair of Threes)
assokappa788: mucks handDTO
Petra. F.44 collected 18050 from pot
*** SUMMARY ***
Total pot 18050 | Rake 0 
Board [2s 4c Tc 3h 9s]
Seat 1: bullbond folded before Flop (didn't bet)
Seat 2: assokappa788 mucked [Qc Ad]
Seat 3: jcarlos.vale folded before Flop (didn't bet)
Seat 4: GARRRN (button) folded before Flop (didn't bet)
Seat 5: qpAPMA3OH (small blind) folded before Flop
Seat 6: Petra. F.44 (big blind) showed [6d 3d] and won (18050) with a pair of Threes
Seat 7: lallelyk'lig folded before Flop (didn't bet)
Seat 8: Johannkasi2222 folded before Flop (didn't bet)
Seat 9: 721339 71147 folded before Flop (didn't bet)



PokerStars Hand #208303868946: Tournament #2779056951, $0.49+$0.06 USD Hold'em No Limit - Level XXIII (1250/2500) - 2020/01/19 1:13:50 EET [2020/01/18 18:13:50 ET]
Table '2779056951 35' 9-max Seat #5 is the button
Seat 1: bullbond (99910 in chips) 
Seat 2: assokappa788 (45452 in chips) 
Seat 3: jcarlos.vale (83055 in chips) 
Seat 4: GARRRN (33838 in chips) 
Seat 5: qpAPMA3OH (89048 in chips) 
Seat 6: Petra. F.44 (37348 in chips) 
Seat 7: lallelyk'lig (22488 in chips) 
Seat 8: Johannkasi2222 (181637 in chips) 
Seat 9: 721339 71147 (105795 in chips) 
bullbond: posts the ante 200
assokappa788: posts the ante 200
jcarlos.vale: posts the ante 200
GARRRN: posts the ante 200
qpAPMA3OH: posts the ante 200
Petra. F.44: posts the ante 200
lallelyk'lig: posts the ante 200
Johannkasi2222: posts the ante 200
721339 71147: posts the ante 200
Petra. F.44: posts small blind 1250
lallelyk'lig: posts big blind 2500
*** HOLE CARDS ***
Dealt to jcarlos.vale [Qd Jh]
Johannkasi2222: folds 
721339 71147: folds 
bullbond: calls 2500
assokappa788: folds 
jcarlos.vale: raises 2750 to 5250
GARRRN: folds 
qpAPMA3OH: folds 
Petra. F.44: folds 
lallelyk'lig: folds 
bullbond: calls 2750
*** FLOP *** [2c 6s 3d]
bullbond: checks 
jcarlos.vale: checks 
*** TURN *** [2c 6s 3d] [Kc]
bullbond: checks 
jcarlos.vale: bets 7500
bullbond: calls 7500
*** RIVER *** [2c 6s 3d Kc] [2h]
bullbond: checks 
jcarlos.vale: checks 
*** SHOW DOWN ***
bullbond: shows [5s Ah] (a pair of Deuces)
jcarlos.vale: mucks handDTO
bullbond collected 31050 from pot
*** SUMMARY ***
Total pot 31050 | Rake 0 
Board [2c 6s 3d Kc 2h]
Seat 1: bullbond showed [5s Ah] and won (31050) with a pair of Deuces
Seat 2: assokappa788 folded before Flop (didn't bet)
Seat 3: jcarlos.vale mucked [Qd Jh]
Seat 4: GARRRN folded before Flop (didn't bet)
Seat 5: qpAPMA3OH (button) folded before Flop (didn't bet)
Seat 6: Petra. F.44 (small blind) folded before Flop
Seat 7: lallelyk'lig (big blind) folded before Flop
Seat 8: Johannkasi2222 folded before Flop (didn't bet)
Seat 9: 721339 71147 folded before Flop (didn't bet)



PokerStars Hand #208303892419: Tournament #2779056951, $0.49+$0.06 USD Hold'em No Limit - Level XXIII (1250/2500) - 2020/01/19 1:14:36 EET [2020/01/18 18:14:36 ET]
Table '2779056951 35' 9-max Seat #6 is the button
Seat 1: bullbond (118010 in chips) 
Seat 2: assokappa788 (45252 in chips) 
Seat 3: jcarlos.vale (70105 in chips) 
Seat 4: GARRRN (33638 in chips) 
Seat 5: qpAPMA3OH (88848 in chips) 
Seat 6: Petra. F.44 (35898 in chips) 
Seat 7: lallelyk'lig (19788 in chips) 
Seat 8: Johannkasi2222 (181437 in chips) 
Seat 9: 721339 71147 (105595 in chips) 
bullbond: posts the ante 200
assokappa788: posts the ante 200
jcarlos.vale: posts the ante 200
GARRRN: posts the ante 200
qpAPMA3OH: posts the ante 200
Petra. F.44: posts the ante 200
lallelyk'lig: posts the ante 200
Johannkasi2222: posts the ante 200
721339 71147: posts the ante 200
lallelyk'lig: posts small blind 1250
Johannkasi2222: posts big blind 2500
*** HOLE CARDS ***
Dealt to jcarlos.vale [Kc 3s]
721339 71147: folds 
bullbond: folds 
assokappa788: raises 2500 to 5000
jcarlos.vale: folds 
GARRRN: folds 
qpAPMA3OH: folds 
Petra. F.44: folds 
lallelyk'lig: raises 14588 to 19588 and is all-in
Johannkasi2222: folds 
assokappa788: calls 14588
*** FLOP *** [Qs Jc As]
*** TURN *** [Qs Jc As] [Kh]
*** RIVER *** [Qs Jc As Kh] [2s]
*** SHOW DOWN ***
lallelyk'lig: shows [9d 9s] (a pair of Nines)
assokappa788: shows [Jh Ac] (two pair, Aces and Jacks)
assokappa788 collected 43476 from pot
lallelyk'lig finished the tournament in 159th place and received $1.83.
*** SUMMARY ***
Total pot 43476 | Rake 0 
Board [Qs Jc As Kh 2s]
Seat 1: bullbond folded before Flop (didn't bet)
Seat 2: assokappa788 showed [Jh Ac] and won (43476) with two pair, Aces and Jacks
Seat 3: jcarlos.vale folded before Flop (didn't bet)
Seat 4: GARRRN folded before Flop (didn't bet)
Seat 5: qpAPMA3OH folded before Flop (didn't bet)
Seat 6: Petra. F.44 (button) folded before Flop (didn't bet)
Seat 7: lallelyk'lig (small blind) showed [9d 9s] and lost with a pair of Nines
Seat 8: Johannkasi2222 (big blind) folded before Flop
Seat 9: 721339 71147 folded before Flop (didn't bet)



PokerStars Hand #208303911727: Tournament #2779056951, $0.49+$0.06 USD Hold'em No Limit - Level XXIII (1250/2500) - 2020/01/19 1:15:14 EET [2020/01/18 18:15:14 ET]
Table '2779056951 35' 9-max Seat #8 is the button
Seat 1: bullbond (117810 in chips) 
Seat 2: assokappa788 (68940 in chips) 
Seat 3: jcarlos.vale (69905 in chips) 
Seat 4: GARRRN (33438 in chips) 
Seat 5: qpAPMA3OH (88648 in chips) 
Seat 6: Petra. F.44 (35698 in chips) 
Seat 8: Johannkasi2222 (178737 in chips) 
Seat 9: 721339 71147 (105395 in chips) 
bullbond: posts the ante 200
assokappa788: posts the ante 200
jcarlos.vale: posts the ante 200
GARRRN: posts the ante 200
qpAPMA3OH: posts the ante 200
Petra. F.44: posts the ante 200
Johannkasi2222: posts the ante 200
721339 71147: posts the ante 200
721339 71147: posts small blind 1250
bullbond: posts big blind 2500
*** HOLE CARDS ***
Dealt to jcarlos.vale [7d 4c]
assokappa788: folds 
jcarlos.vale: folds 
GARRRN: raises 30738 to 33238 and is all-in
qpAPMA3OH: folds 
Petra. F.44: folds 
Johannkasi2222: folds 
721339 71147: folds 
bullbond: folds 
Uncalled bet (30738) returned to GARRRN
GARRRN collected 7850 from pot
*** SUMMARY ***
Total pot 7850 | Rake 0 
Seat 1: bullbond (big blind) folded before Flop
Seat 2: assokappa788 folded before Flop (didn't bet)
Seat 3: jcarlos.vale folded before Flop (didn't bet)
Seat 4: GARRRN collected (7850)
Seat 5: qpAPMA3OH folded before Flop (didn't bet)
Seat 6: Petra. F.44 folded before Flop (didn't bet)
Seat 8: Johannkasi2222 (button) folded before Flop (didn't bet)
Seat 9: 721339 71147 (small blind) folded before Flop



PokerStars Hand #208303923879: Tournament #2779056951, $0.49+$0.06 USD Hold'em No Limit - Level XXIII (1250/2500) - 2020/01/19 1:15:38 EET [2020/01/18 18:15:38 ET]
Table '2779056951 35' 9-max Seat #9 is the button
Seat 1: bullbond (115110 in chips) 
Seat 2: assokappa788 (68740 in chips) 
Seat 3: jcarlos.vale (69705 in chips) 
Seat 4: GARRRN (38588 in chips) 
Seat 5: qpAPMA3OH (88448 in chips) 
Seat 6: Petra. F.44 (35498 in chips) 
Seat 8: Johannkasi2222 (178537 in chips) 
Seat 9: 721339 71147 (103945 in chips) 
bullbond: posts the ante 200
assokappa788: posts the ante 200
jcarlos.vale: posts the ante 200
GARRRN: posts the ante 200
qpAPMA3OH: posts the ante 200
Petra. F.44: posts the ante 200
Johannkasi2222: posts the ante 200
721339 71147: posts the ante 200
bullbond: posts small blind 1250
assokappa788: posts big blind 2500
*** HOLE CARDS ***
Dealt to jcarlos.vale [7c 9c]
jcarlos.vale: folds 
GARRRN: folds 
qpAPMA3OH: folds 
Petra. F.44: folds 
Johannkasi2222: folds 
721339 71147: raises 3000 to 5500
bullbond: calls 4250
assokappa788: calls 3000
*** FLOP *** [2s Ah As]
bullbond: checks 
assokappa788: checks 
721339 71147: bets 5973
bullbond: folds 
assokappa788: folds 
Uncalled bet (5973) returned to 721339 71147
721339 71147 collected 18100 from pot
721339 71147: doesn't show handDTO
*** SUMMARY ***
Total pot 18100 | Rake 0 
Board [2s Ah As]
Seat 1: bullbond (small blind) folded on the Flop
Seat 2: assokappa788 (big blind) folded on the Flop
Seat 3: jcarlos.vale folded before Flop (didn't bet)
Seat 4: GARRRN folded before Flop (didn't bet)
Seat 5: qpAPMA3OH folded before Flop (didn't bet)
Seat 6: Petra. F.44 folded before Flop (didn't bet)
Seat 8: Johannkasi2222 folded before Flop (didn't bet)
Seat 9: 721339 71147 (button) collected (18100)



PokerStars Hand #208303947299: Tournament #2779056951, $0.49+$0.06 USD Hold'em No Limit - Level XXIII (1250/2500) - 2020/01/19 1:16:25 EET [2020/01/18 18:16:25 ET]
Table '2779056951 35' 9-max Seat #1 is the button
Seat 1: bullbond (109410 in chips) 
Seat 2: assokappa788 (63040 in chips) 
Seat 3: jcarlos.vale (69505 in chips) 
Seat 4: GARRRN (38388 in chips) 
Seat 5: qpAPMA3OH (88248 in chips) 
Seat 6: Petra. F.44 (35298 in chips) 
Seat 8: Johannkasi2222 (178337 in chips) 
Seat 9: 721339 71147 (116345 in chips) 
bullbond: posts the ante 200
assokappa788: posts the ante 200
jcarlos.vale: posts the ante 200
GARRRN: posts the ante 200
qpAPMA3OH: posts the ante 200
Petra. F.44: posts the ante 200
Johannkasi2222: posts the ante 200
721339 71147: posts the ante 200
assokappa788: posts small blind 1250
jcarlos.vale: posts big blind 2500
*** HOLE CARDS ***
Dealt to jcarlos.vale [Qh 9s]
GARRRN: folds 
qpAPMA3OH: raises 85548 to 88048 and is all-in
Petra. F.44: folds 
Johannkasi2222: folds 
721339 71147: folds 
bullbond: folds 
assokappa788: folds 
jcarlos.vale: folds 
Uncalled bet (85548) returned to qpAPMA3OH
qpAPMA3OH collected 7850 from pot
qpAPMA3OH: doesn't show handDTO
*** SUMMARY ***
Total pot 7850 | Rake 0 
Seat 1: bullbond (button) folded before Flop (didn't bet)
Seat 2: assokappa788 (small blind) folded before Flop
Seat 3: jcarlos.vale (big blind) folded before Flop
Seat 4: GARRRN folded before Flop (didn't bet)
Seat 5: qpAPMA3OH collected (7850)
Seat 6: Petra. F.44 folded before Flop (didn't bet)
Seat 8: Johannkasi2222 folded before Flop (didn't bet)
Seat 9: 721339 71147 folded before Flop (didn't bet)



PokerStars Hand #208303959851: Tournament #2779056951, $0.49+$0.06 USD Hold'em No Limit - Level XXIII (1250/2500) - 2020/01/19 1:16:50 EET [2020/01/18 18:16:50 ET]
Table '2779056951 35' 9-max Seat #2 is the button
Seat 1: bullbond (109210 in chips) 
Seat 2: assokappa788 (61590 in chips) 
Seat 3: jcarlos.vale (66805 in chips) 
Seat 4: GARRRN (38188 in chips) 
Seat 5: qpAPMA3OH (93398 in chips) 
Seat 6: Petra. F.44 (35098 in chips) 
Seat 8: Johannkasi2222 (178137 in chips) 
Seat 9: 721339 71147 (116145 in chips) 
bullbond: posts the ante 200
assokappa788: posts the ante 200
jcarlos.vale: posts the ante 200
GARRRN: posts the ante 200
qpAPMA3OH: posts the ante 200
Petra. F.44: posts the ante 200
Johannkasi2222: posts the ante 200
721339 71147: posts the ante 200
jcarlos.vale: posts small blind 1250
GARRRN: posts big blind 2500
*** HOLE CARDS ***
Dealt to jcarlos.vale [Jc Ah]
qpAPMA3OH: folds 
Petra. F.44: folds 
Johannkasi2222: folds 
721339 71147: folds 
bullbond: folds 
assokappa788: raises 2500 to 5000
jcarlos.vale: calls 3750
GARRRN: raises 32988 to 37988 and is all-in
assokappa788: folds 
jcarlos.vale: calls 32988
*** FLOP *** [9c 2c 7c]
*** TURN *** [9c 2c 7c] [Ks]
*** RIVER *** [9c 2c 7c Ks] [8d]
*** SHOW DOWN ***
jcarlos.vale: shows [Jc Ah] (high pairOfCards Ace)
GARRRN: shows [7d As] (a pair of Sevens)
GARRRN collected 82576 from pot
*** SUMMARY ***
Total pot 82576 | Rake 0 
Board [9c 2c 7c Ks 8d]
Seat 1: bullbond folded before Flop (didn't bet)
Seat 2: assokappa788 (button) folded before Flop
Seat 3: jcarlos.vale (small blind) showed [Jc Ah] and lost with high pairOfCards Ace
Seat 4: GARRRN (big blind) showed [7d As] and won (82576) with a pair of Sevens
Seat 5: qpAPMA3OH folded before Flop (didn't bet)
Seat 6: Petra. F.44 folded before Flop (didn't bet)
Seat 8: Johannkasi2222 folded before Flop (didn't bet)
Seat 9: 721339 71147 folded before Flop (didn't bet)



PokerStars Hand #208303986518: Tournament #2779056951, $0.49+$0.06 USD Hold'em No Limit - Level XXIV (1500/3000) - 2020/01/19 1:17:43 EET [2020/01/18 18:17:43 ET]
Table '2779056951 35' 9-max Seat #3 is the button
Seat 1: bullbond (109010 in chips) 
Seat 2: assokappa788 (56390 in chips) 
Seat 3: jcarlos.vale (28617 in chips) 
Seat 4: GARRRN (82576 in chips) 
Seat 5: qpAPMA3OH (93198 in chips) 
Seat 6: Petra. F.44 (34898 in chips) 
Seat 8: Johannkasi2222 (177937 in chips) 
Seat 9: 721339 71147 (115945 in chips) 
bullbond: posts the ante 225
assokappa788: posts the ante 225
jcarlos.vale: posts the ante 225
GARRRN: posts the ante 225
qpAPMA3OH: posts the ante 225
Petra. F.44: posts the ante 225
Johannkasi2222: posts the ante 225
721339 71147: posts the ante 225
GARRRN: posts small blind 1500
qpAPMA3OH: posts big blind 3000
*** HOLE CARDS ***
Dealt to jcarlos.vale [5c 2s]
Petra. F.44: folds 
Johannkasi2222: folds 
721339 71147: raises 3600 to 6600
bullbond: folds 
assokappa788: folds 
jcarlos.vale: folds 
GARRRN: folds 
qpAPMA3OH: folds 
Uncalled bet (3600) returned to 721339 71147
721339 71147 collected 9300 from pot
721339 71147: doesn't show handDTO
*** SUMMARY ***
Total pot 9300 | Rake 0 
Seat 1: bullbond folded before Flop (didn't bet)
Seat 2: assokappa788 folded before Flop (didn't bet)
Seat 3: jcarlos.vale (button) folded before Flop (didn't bet)
Seat 4: GARRRN (small blind) folded before Flop
Seat 5: qpAPMA3OH (big blind) folded before Flop
Seat 6: Petra. F.44 folded before Flop (didn't bet)
Seat 8: Johannkasi2222 folded before Flop (didn't bet)
Seat 9: 721339 71147 collected (9300)



PokerStars Hand #208303999580: Tournament #2779056951, $0.49+$0.06 USD Hold'em No Limit - Level XXIV (1500/3000) - 2020/01/19 1:18:09 EET [2020/01/18 18:18:09 ET]
Table '2779056951 35' 9-max Seat #4 is the button
Seat 1: bullbond (108785 in chips) 
Seat 2: assokappa788 (56165 in chips) 
Seat 3: jcarlos.vale (28392 in chips) 
Seat 4: GARRRN (80851 in chips) 
Seat 5: qpAPMA3OH (89973 in chips) 
Seat 6: Petra. F.44 (34673 in chips) 
Seat 8: Johannkasi2222 (177712 in chips) 
Seat 9: 721339 71147 (122020 in chips) 
bullbond: posts the ante 225
assokappa788: posts the ante 225
jcarlos.vale: posts the ante 225
GARRRN: posts the ante 225
qpAPMA3OH: posts the ante 225
Petra. F.44: posts the ante 225
Johannkasi2222: posts the ante 225
721339 71147: posts the ante 225
qpAPMA3OH: posts small blind 1500
Petra. F.44: posts big blind 3000
*** HOLE CARDS ***
Dealt to jcarlos.vale [2c 8c]
Johannkasi2222: folds 
721339 71147: folds 
bullbond: folds 
assokappa788: folds 
jcarlos.vale: folds 
GARRRN: raises 3000 to 6000
qpAPMA3OH: calls 4500
Petra. F.44: calls 3000
*** FLOP *** [8d 8s 7s]
qpAPMA3OH: checks 
Petra. F.44: bets 28448 and is all-in
GARRRN: raises 46178 to 74626 and is all-in
qpAPMA3OH: folds 
Uncalled bet (46178) returned to GARRRN
*** TURN *** [8d 8s 7s] [6c]
*** RIVER *** [8d 8s 7s 6c] [Jc]
*** SHOW DOWN ***
Petra. F.44: shows [6d 9s] (two pair, Eights and Sixes)
GARRRN: shows [As Qs] (a pair of Eights)
Petra. F.44 collected 76696 from pot
*** SUMMARY ***
Total pot 76696 | Rake 0 
Board [8d 8s 7s 6c Jc]
Seat 1: bullbond folded before Flop (didn't bet)
Seat 2: assokappa788 folded before Flop (didn't bet)
Seat 3: jcarlos.vale folded before Flop (didn't bet)
Seat 4: GARRRN (button) showed [As Qs] and lost with a pair of Eights
Seat 5: qpAPMA3OH (small blind) folded on the Flop
Seat 6: Petra. F.44 (big blind) showed [6d 9s] and won (76696) with two pair, Eights and Sixes
Seat 8: Johannkasi2222 folded before Flop (didn't bet)
Seat 9: 721339 71147 folded before Flop (didn't bet)



PokerStars Hand #208304038292: Tournament #2779056951, $0.49+$0.06 USD Hold'em No Limit - Level XXIV (1500/3000) - 2020/01/19 1:19:26 EET [2020/01/18 18:19:26 ET]
Table '2779056951 35' 9-max Seat #5 is the button
Seat 1: bullbond (108560 in chips) 
Seat 2: assokappa788 (55940 in chips) 
Seat 3: jcarlos.vale (28167 in chips) 
Seat 4: GARRRN (46178 in chips) 
Seat 5: qpAPMA3OH (83748 in chips) 
Seat 6: Petra. F.44 (76696 in chips) 
Seat 7: freddy2109 (37857 in chips) 
Seat 8: Johannkasi2222 (177487 in chips) 
Seat 9: 721339 71147 (121795 in chips) 
bullbond: posts the ante 225
assokappa788: posts the ante 225
jcarlos.vale: posts the ante 225
GARRRN: posts the ante 225
qpAPMA3OH: posts the ante 225
Petra. F.44: posts the ante 225
freddy2109: posts the ante 225
Johannkasi2222: posts the ante 225
721339 71147: posts the ante 225
Petra. F.44: posts small blind 1500
freddy2109: posts big blind 3000
*** HOLE CARDS ***
Dealt to jcarlos.vale [6s 8d]
Johannkasi2222: folds 
721339 71147: raises 3600 to 6600
bullbond: folds 
assokappa788: folds 
jcarlos.vale: folds 
GARRRN: folds 
qpAPMA3OH: folds 
Petra. F.44: folds 
freddy2109: folds 
Uncalled bet (3600) returned to 721339 71147
721339 71147 collected 9525 from pot
721339 71147: doesn't show handDTO
*** SUMMARY ***
Total pot 9525 | Rake 0 
Seat 1: bullbond folded before Flop (didn't bet)
Seat 2: assokappa788 folded before Flop (didn't bet)
Seat 3: jcarlos.vale folded before Flop (didn't bet)
Seat 4: GARRRN folded before Flop (didn't bet)
Seat 5: qpAPMA3OH (button) folded before Flop (didn't bet)
Seat 6: Petra. F.44 (small blind) folded before Flop
Seat 7: freddy2109 (big blind) folded before Flop
Seat 8: Johannkasi2222 folded before Flop (didn't bet)
Seat 9: 721339 71147 collected (9525)



PokerStars Hand #208304054220: Tournament #2779056951, $0.49+$0.06 USD Hold'em No Limit - Level XXIV (1500/3000) - 2020/01/19 1:19:58 EET [2020/01/18 18:19:58 ET]
Table '2779056951 35' 9-max Seat #6 is the button
Seat 1: bullbond (108335 in chips) 
Seat 2: assokappa788 (55715 in chips) 
Seat 3: jcarlos.vale (27942 in chips) 
Seat 4: GARRRN (45953 in chips) 
Seat 5: qpAPMA3OH (83523 in chips) 
Seat 6: Petra. F.44 (74971 in chips) 
Seat 7: freddy2109 (34632 in chips) 
Seat 8: Johannkasi2222 (177262 in chips) 
Seat 9: 721339 71147 (128095 in chips) 
bullbond: posts the ante 225
assokappa788: posts the ante 225
jcarlos.vale: posts the ante 225
GARRRN: posts the ante 225
qpAPMA3OH: posts the ante 225
Petra. F.44: posts the ante 225
freddy2109: posts the ante 225
Johannkasi2222: posts the ante 225
721339 71147: posts the ante 225
freddy2109: posts small blind 1500
Johannkasi2222: posts big blind 3000
*** HOLE CARDS ***
Dealt to jcarlos.vale [8d 7s]
721339 71147: folds 
bullbond: folds 
assokappa788 has timed out
assokappa788: folds 
assokappa788 is sitting out
jcarlos.vale: folds 
assokappa788 has returned
GARRRN: raises 42728 to 45728 and is all-in
qpAPMA3OH: folds 
Petra. F.44: folds 
freddy2109: folds 
Johannkasi2222: folds 
Uncalled bet (42728) returned to GARRRN
GARRRN collected 9525 from pot
*** SUMMARY ***
Total pot 9525 | Rake 0 
Seat 1: bullbond folded before Flop (didn't bet)
Seat 2: assokappa788 folded before Flop (didn't bet)
Seat 3: jcarlos.vale folded before Flop (didn't bet)
Seat 4: GARRRN collected (9525)
Seat 5: qpAPMA3OH folded before Flop (didn't bet)
Seat 6: Petra. F.44 (button) folded before Flop (didn't bet)
Seat 7: freddy2109 (small blind) folded before Flop
Seat 8: Johannkasi2222 (big blind) folded before Flop
Seat 9: 721339 71147 folded before Flop (didn't bet)



PokerStars Hand #208304078394: Tournament #2779056951, $0.49+$0.06 USD Hold'em No Limit - Level XXIV (1500/3000) - 2020/01/19 1:20:47 EET [2020/01/18 18:20:47 ET]
Table '2779056951 35' 9-max Seat #7 is the button
Seat 1: bullbond (108110 in chips) 
Seat 2: assokappa788 (55490 in chips) 
Seat 3: jcarlos.vale (27717 in chips) 
Seat 4: GARRRN (52253 in chips) 
Seat 5: qpAPMA3OH (83298 in chips) 
Seat 6: Petra. F.44 (74746 in chips) 
Seat 7: freddy2109 (32907 in chips) 
Seat 8: Johannkasi2222 (174037 in chips) 
Seat 9: 721339 71147 (127870 in chips) 
bullbond: posts the ante 225
assokappa788: posts the ante 225
jcarlos.vale: posts the ante 225
GARRRN: posts the ante 225
qpAPMA3OH: posts the ante 225
Petra. F.44: posts the ante 225
freddy2109: posts the ante 225
Johannkasi2222: posts the ante 225
721339 71147: posts the ante 225
Johannkasi2222: posts small blind 1500
721339 71147: posts big blind 3000
*** HOLE CARDS ***
Dealt to jcarlos.vale [Ah 3c]
bullbond: folds 
assokappa788: folds 
jcarlos.vale: folds 
GARRRN: folds 
qpAPMA3OH: raises 80073 to 83073 and is all-in
Petra. F.44: folds 
freddy2109: folds 
Johannkasi2222: folds 
721339 71147: folds 
Uncalled bet (80073) returned to qpAPMA3OH
qpAPMA3OH collected 9525 from pot
qpAPMA3OH: doesn't show handDTO
*** SUMMARY ***
Total pot 9525 | Rake 0 
Seat 1: bullbond folded before Flop (didn't bet)
Seat 2: assokappa788 folded before Flop (didn't bet)
Seat 3: jcarlos.vale folded before Flop (didn't bet)
Seat 4: GARRRN folded before Flop (didn't bet)
Seat 5: qpAPMA3OH collected (9525)
Seat 6: Petra. F.44 folded before Flop (didn't bet)
Seat 7: freddy2109 (button) folded before Flop (didn't bet)
Seat 8: Johannkasi2222 (small blind) folded before Flop
Seat 9: 721339 71147 (big blind) folded before Flop



PokerStars Hand #208304093639: Tournament #2779056951, $0.49+$0.06 USD Hold'em No Limit - Level XXIV (1500/3000) - 2020/01/19 1:21:17 EET [2020/01/18 18:21:17 ET]
Table '2779056951 35' 9-max Seat #8 is the button
Seat 1: bullbond (107885 in chips) 
Seat 2: assokappa788 (55265 in chips) 
Seat 3: jcarlos.vale (27492 in chips) 
Seat 4: GARRRN (52028 in chips) 
Seat 5: qpAPMA3OH (89598 in chips) 
Seat 6: Petra. F.44 (74521 in chips) 
Seat 7: freddy2109 (32682 in chips) 
Seat 8: Johannkasi2222 (172312 in chips) 
Seat 9: 721339 71147 (124645 in chips) 
bullbond: posts the ante 225
assokappa788: posts the ante 225
jcarlos.vale: posts the ante 225
GARRRN: posts the ante 225
qpAPMA3OH: posts the ante 225
Petra. F.44: posts the ante 225
freddy2109: posts the ante 225
Johannkasi2222: posts the ante 225
721339 71147: posts the ante 225
721339 71147: posts small blind 1500
bullbond: posts big blind 3000
*** HOLE CARDS ***
Dealt to jcarlos.vale [5c 5d]
assokappa788: folds 
jcarlos.vale: raises 24267 to 27267 and is all-in
GARRRN: folds 
qpAPMA3OH: folds 
Petra. F.44: calls 27267
freddy2109: folds 
Johannkasi2222: raises 144820 to 172087 and is all-in
721339 71147: folds 
bullbond: folds 
Petra. F.44: calls 47029 and is all-in
Uncalled bet (97791) returned to Johannkasi2222
*** FLOP *** [8s Qh Td]
*** TURN *** [8s Qh Td] [Kd]
*** RIVER *** [8s Qh Td Kd] [4s]
*** SHOW DOWN ***
Petra. F.44: shows [Ad Ah] (a pair of Aces)
Johannkasi2222: shows [Js Ac] (a straight, Ten to Ace)
Johannkasi2222 collected 94058 from side pot
jcarlos.vale: shows [5c 5d] (a pair of Fives)
Johannkasi2222 collected 88326 from main pot
Petra. F.44 finished the tournament in 142nd place and received $2.19.
jcarlos.vale finished the tournament in 143rd place and received $2.19.
*** SUMMARY ***
Total pot 182384 Main pot 88326. Side pot 94058. | Rake 0 
Board [8s Qh Td Kd 4s]
Seat 1: bullbond (big blind) folded before Flop
Seat 2: assokappa788 folded before Flop (didn't bet)
Seat 3: jcarlos.vale showed [5c 5d] and lost with a pair of Fives
Seat 4: GARRRN folded before Flop (didn't bet)
Seat 5: qpAPMA3OH folded before Flop (didn't bet)
Seat 6: Petra. F.44 showed [Ad Ah] and lost with a pair of Aces
Seat 7: freddy2109 folded before Flop (didn't bet)
Seat 8: Johannkasi2222 (button) showed [Js Ac] and won (182384) with a straight, Ten to Ace
Seat 9: 721339 71147 (small blind) folded before Flop



