PokerStars Hand #221582700422: Tournament #3074230175, $0.98+$0.12 USD Hold'em No Limit - Level I (15/30) - 2020/12/18 22:30:03 EET [2020/12/18 15:30:03 ET]
Table '3074230175 2' 9-max Seat #1 is the button
Seat 1: LauriOy (3000 in chips) 
Seat 2: LEE MARVIN17 (3000 in chips) 
Seat 3: Gerason93 (3000 in chips) 
Seat 4: Gj,tlf777 (3000 in chips) 
Seat 5: jcarlos.vale (3000 in chips) 
Seat 6: SoChute (3000 in chips) 
Seat 7: Phisie (3000 in chips) 
Seat 8: Elena19years (3000 in chips) 
Seat 9: evstraliss (3000 in chips) 
LauriOy: posts the ante 4
LEE MARVIN17: posts the ante 4
Gerason93: posts the ante 4
Gj,tlf777: posts the ante 4
jcarlos.vale: posts the ante 4
SoChute: posts the ante 4
Phisie: posts the ante 4
Elena19years: posts the ante 4
evstraliss: posts the ante 4
LEE MARVIN17: posts small blind 15
Gerason93: posts big blind 30
*** HOLE CARDS ***
Dealt to jcarlos.vale [7h Ks]
Phisie is disconnected 
Gj,tlf777: folds 
jcarlos.vale: folds 
SoChute: folds 
Phisie: folds 
Elena19years: folds 
evstraliss: folds 
LauriOy: calls 30
LEE MARVIN17: folds 
Gerason93: checks 
*** FLOP *** [9d Qd Qs]
Gerason93: checks 
LauriOy: bets 30
Gerason93: folds 
Uncalled bet (30) returned to LauriOy
LauriOy collected 111 from pot
LauriOy: doesn't show handDTO
*** SUMMARY ***
Total pot 111 | Rake 0 
Board [9d Qd Qs]
Seat 1: LauriOy (button) collected (111)
Seat 2: LEE MARVIN17 (small blind) folded before Flop
Seat 3: Gerason93 (big blind) folded on the Flop
Seat 4: Gj,tlf777 folded before Flop (didn't bet)
Seat 5: jcarlos.vale folded before Flop (didn't bet)
Seat 6: SoChute folded before Flop (didn't bet)
Seat 7: Phisie folded before Flop (didn't bet)
Seat 8: Elena19years folded before Flop (didn't bet)
Seat 9: evstraliss folded before Flop (didn't bet)



PokerStars Hand #221582732118: Tournament #3074230175, $0.98+$0.12 USD Hold'em No Limit - Level I (15/30) - 2020/12/18 22:30:46 EET [2020/12/18 15:30:46 ET]
Table '3074230175 2' 9-max Seat #2 is the button
Seat 1: LauriOy (3077 in chips) 
Seat 2: LEE MARVIN17 (2981 in chips) 
Seat 3: Gerason93 (2966 in chips) 
Seat 5: jcarlos.vale (2996 in chips) 
Seat 6: SoChute (2996 in chips) 
Seat 7: Phisie (2996 in chips) 
Seat 8: Elena19years (2996 in chips) 
Seat 9: evstraliss (2996 in chips) 
LauriOy: posts the ante 4
LEE MARVIN17: posts the ante 4
Gerason93: posts the ante 4
jcarlos.vale: posts the ante 4
SoChute: posts the ante 4
Phisie: posts the ante 4
Elena19years: posts the ante 4
evstraliss: posts the ante 4
Gerason93: posts small blind 15
jcarlos.vale: posts big blind 30
*** HOLE CARDS ***
Dealt to jcarlos.vale [Kh 2h]
SoChute: folds 
Phisie: folds 
Elena19years: folds 
evstraliss: folds 
LauriOy: calls 30
LEE MARVIN17: calls 30
Gerason93: folds 
jcarlos.vale: checks 
*** FLOP *** [2s 6h 2d]
jcarlos.vale: checks 
LauriOy: checks 
LEE MARVIN17: bets 60
jcarlos.vale: calls 60
LauriOy: folds 
*** TURN *** [2s 6h 2d] [Ts]
jcarlos.vale: bets 120
LEE MARVIN17: folds 
Uncalled bet (120) returned to jcarlos.vale
jcarlos.vale collected 257 from pot
jcarlos.vale: doesn't show handDTO
*** SUMMARY ***
Total pot 257 | Rake 0 
Board [2s 6h 2d Ts]
Seat 1: LauriOy folded on the Flop
Seat 2: LEE MARVIN17 (button) folded on the Turn
Seat 3: Gerason93 (small blind) folded before Flop
Seat 5: jcarlos.vale (big blind) collected (257)
Seat 6: SoChute folded before Flop (didn't bet)
Seat 7: Phisie folded before Flop (didn't bet)
Seat 8: Elena19years folded before Flop (didn't bet)
Seat 9: evstraliss folded before Flop (didn't bet)



PokerStars Hand #221582774825: Tournament #3074230175, $0.98+$0.12 USD Hold'em No Limit - Level I (15/30) - 2020/12/18 22:31:45 EET [2020/12/18 15:31:45 ET]
Table '3074230175 2' 9-max Seat #3 is the button
Seat 1: LauriOy (3043 in chips) 
Seat 2: LEE MARVIN17 (2887 in chips) 
Seat 3: Gerason93 (2947 in chips) 
Seat 4: lucaasiilva3 (3000 in chips) out of handDTO (moved from another table into small blind)
Seat 5: jcarlos.vale (3159 in chips) 
Seat 6: SoChute (2992 in chips) 
Seat 7: Phisie (2992 in chips) 
Seat 8: Elena19years (2992 in chips) 
Seat 9: evstraliss (2992 in chips) 
lucaasiilva3 will be allowed to play after the button
LauriOy: posts the ante 4
LEE MARVIN17: posts the ante 4
Gerason93: posts the ante 4
jcarlos.vale: posts the ante 4
SoChute: posts the ante 4
Phisie: posts the ante 4
Elena19years: posts the ante 4
evstraliss: posts the ante 4
jcarlos.vale: posts small blind 15
SoChute: posts big blind 30
*** HOLE CARDS ***
Dealt to jcarlos.vale [5h 9c]
Phisie: folds 
Elena19years: folds 
evstraliss: folds 
LauriOy: calls 30
LEE MARVIN17: folds 
Gerason93: folds 
jcarlos.vale: calls 15
SoChute: raises 2958 to 2988 and is all-in
LauriOy: folds 
jcarlos.vale: folds 
Uncalled bet (2958) returned to SoChute
SoChute collected 122 from pot
SoChute: doesn't show handDTO
*** SUMMARY ***
Total pot 122 | Rake 0 
Seat 1: LauriOy folded before Flop
Seat 2: LEE MARVIN17 folded before Flop (didn't bet)
Seat 3: Gerason93 (button) folded before Flop (didn't bet)
Seat 5: jcarlos.vale (small blind) folded before Flop
Seat 6: SoChute (big blind) collected (122)
Seat 7: Phisie folded before Flop (didn't bet)
Seat 8: Elena19years folded before Flop (didn't bet)
Seat 9: evstraliss folded before Flop (didn't bet)



PokerStars Hand #221582808082: Tournament #3074230175, $0.98+$0.12 USD Hold'em No Limit - Level I (15/30) - 2020/12/18 22:32:30 EET [2020/12/18 15:32:30 ET]
Table '3074230175 2' 9-max Seat #5 is the button
Seat 1: LauriOy (3009 in chips) 
Seat 2: LEE MARVIN17 (2883 in chips) 
Seat 3: Gerason93 (2943 in chips) 
Seat 4: lucaasiilva3 (3000 in chips) 
Seat 5: jcarlos.vale (3125 in chips) 
Seat 6: SoChute (3080 in chips) 
Seat 7: Phisie (2988 in chips) 
Seat 8: Elena19years (2988 in chips) 
Seat 9: evstraliss (2988 in chips) 
LauriOy: posts the ante 4
LEE MARVIN17: posts the ante 4
Gerason93: posts the ante 4
lucaasiilva3: posts the ante 4
jcarlos.vale: posts the ante 4
SoChute: posts the ante 4
Phisie: posts the ante 4
Elena19years: posts the ante 4
evstraliss: posts the ante 4
SoChute: posts small blind 15
Phisie: posts big blind 30
*** HOLE CARDS ***
Dealt to jcarlos.vale [7h 6d]
Elena19years: folds 
evstraliss: folds 
LauriOy: calls 30
LEE MARVIN17: folds 
Gerason93: folds 
lucaasiilva3: folds 
jcarlos.vale: folds 
SoChute: calls 15
Phisie: raises 90 to 120
LauriOy: calls 90
SoChute: folds 
*** FLOP *** [Ks Qc 7s]
Phisie: bets 153
LauriOy: calls 153
*** TURN *** [Ks Qc 7s] [Kc]
Phisie: bets 306
LauriOy: folds 
Uncalled bet (306) returned to Phisie
Phisie collected 612 from pot
Phisie: doesn't show handDTO
*** SUMMARY ***
Total pot 612 | Rake 0 
Board [Ks Qc 7s Kc]
Seat 1: LauriOy folded on the Turn
Seat 2: LEE MARVIN17 folded before Flop (didn't bet)
Seat 3: Gerason93 folded before Flop (didn't bet)
Seat 4: lucaasiilva3 folded before Flop (didn't bet)
Seat 5: jcarlos.vale (button) folded before Flop (didn't bet)
Seat 6: SoChute (small blind) folded before Flop
Seat 7: Phisie (big blind) collected (612)
Seat 8: Elena19years folded before Flop (didn't bet)
Seat 9: evstraliss folded before Flop (didn't bet)



PokerStars Hand #221582862160: Tournament #3074230175, $0.98+$0.12 USD Hold'em No Limit - Level I (15/30) - 2020/12/18 22:33:44 EET [2020/12/18 15:33:44 ET]
Table '3074230175 2' 9-max Seat #6 is the button
Seat 1: LauriOy (2732 in chips) 
Seat 2: LEE MARVIN17 (2879 in chips) 
Seat 3: Gerason93 (2939 in chips) 
Seat 4: lucaasiilva3 (2996 in chips) 
Seat 5: jcarlos.vale (3121 in chips) 
Seat 6: SoChute (3046 in chips) 
Seat 7: Phisie (3323 in chips) 
Seat 8: Elena19years (2984 in chips) 
Seat 9: evstraliss (2984 in chips) 
LauriOy: posts the ante 4
LEE MARVIN17: posts the ante 4
Gerason93: posts the ante 4
lucaasiilva3: posts the ante 4
jcarlos.vale: posts the ante 4
SoChute: posts the ante 4
Phisie: posts the ante 4
Elena19years: posts the ante 4
evstraliss: posts the ante 4
Phisie: posts small blind 15
Elena19years: posts big blind 30
*** HOLE CARDS ***
Dealt to jcarlos.vale [Ad Kc]
evstraliss: folds 
LauriOy: calls 30
LEE MARVIN17: folds 
Gerason93: folds 
lucaasiilva3: folds 
jcarlos.vale: raises 60 to 90
SoChute: calls 90
Phisie: folds 
Elena19years: folds 
LauriOy: calls 60
*** FLOP *** [Kh 8d 6d]
LauriOy: bets 30
jcarlos.vale: raises 90 to 120
SoChute: folds 
LauriOy: calls 90
*** TURN *** [Kh 8d 6d] [5h]
LauriOy: bets 30
jcarlos.vale: raises 120 to 150
LauriOy: calls 120
*** RIVER *** [Kh 8d 6d 5h] [Ac]
LauriOy: checks 
jcarlos.vale: bets 180
LauriOy: folds 
Uncalled bet (180) returned to jcarlos.vale
jcarlos.vale collected 891 from pot
jcarlos.vale: doesn't show handDTO
*** SUMMARY ***
Total pot 891 | Rake 0 
Board [Kh 8d 6d 5h Ac]
Seat 1: LauriOy folded on the River
Seat 2: LEE MARVIN17 folded before Flop (didn't bet)
Seat 3: Gerason93 folded before Flop (didn't bet)
Seat 4: lucaasiilva3 folded before Flop (didn't bet)
Seat 5: jcarlos.vale collected (891)
Seat 6: SoChute (button) folded on the Flop
Seat 7: Phisie (small blind) folded before Flop
Seat 8: Elena19years (big blind) folded before Flop
Seat 9: evstraliss folded before Flop (didn't bet)



PokerStars Hand #221582925342: Tournament #3074230175, $0.98+$0.12 USD Hold'em No Limit - Level I (15/30) - 2020/12/18 22:35:12 EET [2020/12/18 15:35:12 ET]
Table '3074230175 2' 9-max Seat #7 is the button
Seat 1: LauriOy (2368 in chips) 
Seat 2: LEE MARVIN17 (2875 in chips) 
Seat 3: Gerason93 (2935 in chips) 
Seat 4: lucaasiilva3 (2992 in chips) 
Seat 5: jcarlos.vale (3648 in chips) 
Seat 6: SoChute (2952 in chips) 
Seat 7: Phisie (3304 in chips) 
Seat 8: Elena19years (2950 in chips) 
Seat 9: evstraliss (2980 in chips) 
LauriOy: posts the ante 4
LEE MARVIN17: posts the ante 4
Gerason93: posts the ante 4
lucaasiilva3: posts the ante 4
jcarlos.vale: posts the ante 4
SoChute: posts the ante 4
Phisie: posts the ante 4
Elena19years: posts the ante 4
evstraliss: posts the ante 4
Elena19years: posts small blind 15
evstraliss: posts big blind 30
*** HOLE CARDS ***
Dealt to jcarlos.vale [2s 6s]
LauriOy: calls 30
LEE MARVIN17: folds 
Gerason93: folds 
lucaasiilva3: folds 
jcarlos.vale: folds 
SoChute: raises 60 to 90
Phisie: folds 
Elena19years: folds 
evstraliss: folds 
LauriOy: calls 60
*** FLOP *** [7h 4c Ts]
LauriOy: bets 30
SoChute: raises 161 to 191
LauriOy: raises 289 to 480
SoChute: calls 289
*** TURN *** [7h 4c Ts] [3d]
LauriOy: bets 1794 and is all-in
SoChute: folds 
Uncalled bet (1794) returned to LauriOy
LauriOy collected 1221 from pot
LauriOy: doesn't show handDTO
*** SUMMARY ***
Total pot 1221 | Rake 0 
Board [7h 4c Ts 3d]
Seat 1: LauriOy collected (1221)
Seat 2: LEE MARVIN17 folded before Flop (didn't bet)
Seat 3: Gerason93 folded before Flop (didn't bet)
Seat 4: lucaasiilva3 folded before Flop (didn't bet)
Seat 5: jcarlos.vale folded before Flop (didn't bet)
Seat 6: SoChute folded on the Turn
Seat 7: Phisie (button) folded before Flop (didn't bet)
Seat 8: Elena19years (small blind) folded before Flop
Seat 9: evstraliss (big blind) folded before Flop



PokerStars Hand #221582972196: Tournament #3074230175, $0.98+$0.12 USD Hold'em No Limit - Level I (15/30) - 2020/12/18 22:36:17 EET [2020/12/18 15:36:17 ET]
Table '3074230175 2' 9-max Seat #8 is the button
Seat 1: LauriOy (3015 in chips) 
Seat 2: LEE MARVIN17 (2871 in chips) 
Seat 3: Gerason93 (2931 in chips) 
Seat 4: lucaasiilva3 (2988 in chips) 
Seat 5: jcarlos.vale (3644 in chips) 
Seat 6: SoChute (2378 in chips) 
Seat 7: Phisie (3300 in chips) 
Seat 8: Elena19years (2931 in chips) 
Seat 9: evstraliss (2946 in chips) 
LauriOy: posts the ante 4
LEE MARVIN17: posts the ante 4
Gerason93: posts the ante 4
lucaasiilva3: posts the ante 4
jcarlos.vale: posts the ante 4
SoChute: posts the ante 4
Phisie: posts the ante 4
Elena19years: posts the ante 4
evstraliss: posts the ante 4
evstraliss: posts small blind 15
LauriOy: posts big blind 30
*** HOLE CARDS ***
Dealt to jcarlos.vale [7h Ad]
LEE MARVIN17: folds 
Gerason93: folds 
lucaasiilva3: folds 
jcarlos.vale: folds 
SoChute: folds 
Phisie: folds 
Elena19years: folds 
evstraliss: folds 
Uncalled bet (15) returned to LauriOy
LauriOy collected 66 from pot
LauriOy: doesn't show handDTO
*** SUMMARY ***
Total pot 66 | Rake 0 
Seat 1: LauriOy (big blind) collected (66)
Seat 2: LEE MARVIN17 folded before Flop (didn't bet)
Seat 3: Gerason93 folded before Flop (didn't bet)
Seat 4: lucaasiilva3 folded before Flop (didn't bet)
Seat 5: jcarlos.vale folded before Flop (didn't bet)
Seat 6: SoChute folded before Flop (didn't bet)
Seat 7: Phisie folded before Flop (didn't bet)
Seat 8: Elena19years (button) folded before Flop (didn't bet)
Seat 9: evstraliss (small blind) folded before Flop



PokerStars Hand #221582995109: Tournament #3074230175, $0.98+$0.12 USD Hold'em No Limit - Level I (15/30) - 2020/12/18 22:36:48 EET [2020/12/18 15:36:48 ET]
Table '3074230175 2' 9-max Seat #9 is the button
Seat 1: LauriOy (3062 in chips) 
Seat 2: LEE MARVIN17 (2867 in chips) 
Seat 3: Gerason93 (2927 in chips) 
Seat 4: lucaasiilva3 (2984 in chips) 
Seat 5: jcarlos.vale (3640 in chips) 
Seat 6: SoChute (2374 in chips) 
Seat 7: Phisie (3296 in chips) 
Seat 8: Elena19years (2927 in chips) 
Seat 9: evstraliss (2927 in chips) 
LauriOy: posts the ante 4
LEE MARVIN17: posts the ante 4
Gerason93: posts the ante 4
lucaasiilva3: posts the ante 4
jcarlos.vale: posts the ante 4
SoChute: posts the ante 4
Phisie: posts the ante 4
Elena19years: posts the ante 4
evstraliss: posts the ante 4
LauriOy: posts small blind 15
LEE MARVIN17: posts big blind 30
*** HOLE CARDS ***
Dealt to jcarlos.vale [4c Qc]
Gerason93: folds 
lucaasiilva3: folds 
jcarlos.vale: folds 
SoChute: raises 30 to 60
Phisie: folds 
Elena19years: folds 
evstraliss: raises 165 to 225
LauriOy: folds 
LEE MARVIN17: folds 
SoChute: calls 165
*** FLOP *** [7s 6s 4h]
SoChute: checks 
evstraliss: bets 175
SoChute: raises 1970 to 2145 and is all-in
evstraliss: folds 
Uncalled bet (1970) returned to SoChute
SoChute collected 881 from pot
SoChute: doesn't show handDTO
*** SUMMARY ***
Total pot 881 | Rake 0 
Board [7s 6s 4h]
Seat 1: LauriOy (small blind) folded before Flop
Seat 2: LEE MARVIN17 (big blind) folded before Flop
Seat 3: Gerason93 folded before Flop (didn't bet)
Seat 4: lucaasiilva3 folded before Flop (didn't bet)
Seat 5: jcarlos.vale folded before Flop (didn't bet)
Seat 6: SoChute collected (881)
Seat 7: Phisie folded before Flop (didn't bet)
Seat 8: Elena19years folded before Flop (didn't bet)
Seat 9: evstraliss (button) folded on the Flop



PokerStars Hand #221583034578: Tournament #3074230175, $0.98+$0.12 USD Hold'em No Limit - Level I (15/30) - 2020/12/18 22:37:42 EET [2020/12/18 15:37:42 ET]
Table '3074230175 2' 9-max Seat #1 is the button
Seat 1: LauriOy (3043 in chips) 
Seat 2: LEE MARVIN17 (2833 in chips) 
Seat 3: Gerason93 (2923 in chips) 
Seat 4: lucaasiilva3 (2980 in chips) 
Seat 5: jcarlos.vale (3636 in chips) 
Seat 6: SoChute (2851 in chips) 
Seat 7: Phisie (3292 in chips) 
Seat 8: Elena19years (2923 in chips) 
Seat 9: evstraliss (2523 in chips) 
LauriOy: posts the ante 4
LEE MARVIN17: posts the ante 4
Gerason93: posts the ante 4
lucaasiilva3: posts the ante 4
jcarlos.vale: posts the ante 4
SoChute: posts the ante 4
Phisie: posts the ante 4
Elena19years: posts the ante 4
evstraliss: posts the ante 4
LEE MARVIN17: posts small blind 15
Gerason93: posts big blind 30
*** HOLE CARDS ***
Dealt to jcarlos.vale [4d 5d]
lucaasiilva3: folds 
jcarlos.vale: folds 
SoChute: raises 30 to 60
Phisie: folds 
Elena19years: calls 60
evstraliss: folds 
LauriOy: calls 60
LEE MARVIN17: calls 45
Gerason93: raises 150 to 210
SoChute: folds 
Elena19years: calls 150
LauriOy: folds 
LEE MARVIN17: folds 
*** FLOP *** [Td Qs 4c]
Gerason93: checks 
Elena19years: bets 165
Gerason93: calls 165
*** TURN *** [Td Qs 4c] [5c]
Gerason93: checks 
Elena19years: bets 251
Gerason93: calls 251
*** RIVER *** [Td Qs 4c 5c] [Kh]
Gerason93: checks 
Elena19years: bets 382
Gerason93: calls 382
*** SHOW DOWN ***
Elena19years: shows [4h 4s] (three of a kind, Fours)
Gerason93: mucks handDTO
Elena19years collected 2232 from pot
*** SUMMARY ***
Total pot 2232 | Rake 0 
Board [Td Qs 4c 5c Kh]
Seat 1: LauriOy (button) folded before Flop
Seat 2: LEE MARVIN17 (small blind) folded before Flop
Seat 3: Gerason93 (big blind) mucked [Ad Kc]
Seat 4: lucaasiilva3 folded before Flop (didn't bet)
Seat 5: jcarlos.vale folded before Flop (didn't bet)
Seat 6: SoChute folded before Flop
Seat 7: Phisie folded before Flop (didn't bet)
Seat 8: Elena19years showed [4h 4s] and won (2232) with three of a kind, Fours
Seat 9: evstraliss folded before Flop (didn't bet)



PokerStars Hand #221583114965: Tournament #3074230175, $0.98+$0.12 USD Hold'em No Limit - Level I (15/30) - 2020/12/18 22:39:21 EET [2020/12/18 15:39:21 ET]
Table '3074230175 2' 9-max Seat #2 is the button
Seat 1: LauriOy (2979 in chips) 
Seat 2: LEE MARVIN17 (2769 in chips) 
Seat 3: Gerason93 (1911 in chips) 
Seat 4: lucaasiilva3 (2976 in chips) 
Seat 5: jcarlos.vale (3632 in chips) 
Seat 6: SoChute (2787 in chips) 
Seat 7: Phisie (3288 in chips) 
Seat 8: Elena19years (4143 in chips) 
Seat 9: evstraliss (2519 in chips) 
LauriOy: posts the ante 4
LEE MARVIN17: posts the ante 4
Gerason93: posts the ante 4
lucaasiilva3: posts the ante 4
jcarlos.vale: posts the ante 4
SoChute: posts the ante 4
Phisie: posts the ante 4
Elena19years: posts the ante 4
evstraliss: posts the ante 4
Gerason93: posts small blind 15
lucaasiilva3: posts big blind 30
*** HOLE CARDS ***
Dealt to jcarlos.vale [4d 5h]
jcarlos.vale: folds 
SoChute: raises 60 to 90
Phisie: folds 
Elena19years: folds 
evstraliss: calls 90
LauriOy: calls 90
LEE MARVIN17: folds 
Gerason93: folds 
lucaasiilva3: folds 
*** FLOP *** [8c 7s Qs]
SoChute: bets 176
evstraliss: folds 
LauriOy: calls 176
*** TURN *** [8c 7s Qs] [Kc]
SoChute: checks 
LauriOy: checks 
*** RIVER *** [8c 7s Qs Kc] [Kh]
SoChute: bets 352
LauriOy: folds 
Uncalled bet (352) returned to SoChute
SoChute collected 703 from pot
SoChute: doesn't show handDTO
*** SUMMARY ***
Total pot 703 | Rake 0 
Board [8c 7s Qs Kc Kh]
Seat 1: LauriOy folded on the River
Seat 2: LEE MARVIN17 (button) folded before Flop (didn't bet)
Seat 3: Gerason93 (small blind) folded before Flop
Seat 4: lucaasiilva3 (big blind) folded before Flop
Seat 5: jcarlos.vale folded before Flop (didn't bet)
Seat 6: SoChute collected (703)
Seat 7: Phisie folded before Flop (didn't bet)
Seat 8: Elena19years folded before Flop (didn't bet)
Seat 9: evstraliss folded on the Flop



PokerStars Hand #221583159159: Tournament #3074230175, $0.98+$0.12 USD Hold'em No Limit - Level II (20/40) - 2020/12/18 22:40:22 EET [2020/12/18 15:40:22 ET]
Table '3074230175 2' 9-max Seat #3 is the button
Seat 1: LauriOy (2709 in chips) 
Seat 2: LEE MARVIN17 (2765 in chips) 
Seat 3: Gerason93 (1892 in chips) 
Seat 4: lucaasiilva3 (2942 in chips) 
Seat 5: jcarlos.vale (3628 in chips) 
Seat 6: SoChute (3220 in chips) 
Seat 7: Phisie (3284 in chips) 
Seat 8: Elena19years (4139 in chips) 
Seat 9: evstraliss (2425 in chips) 
LauriOy: posts the ante 5
LEE MARVIN17: posts the ante 5
Gerason93: posts the ante 5
lucaasiilva3: posts the ante 5
jcarlos.vale: posts the ante 5
SoChute: posts the ante 5
Phisie: posts the ante 5
Elena19years: posts the ante 5
evstraliss: posts the ante 5
lucaasiilva3: posts small blind 20
jcarlos.vale: posts big blind 40
*** HOLE CARDS ***
Dealt to jcarlos.vale [Ac 2h]
SoChute: calls 40
Phisie: calls 40
Elena19years: folds 
evstraliss: folds 
LauriOy: calls 40
LEE MARVIN17: calls 40
Gerason93: folds 
lucaasiilva3: calls 20
jcarlos.vale: checks 
*** FLOP *** [2d 5s 7d]
lucaasiilva3: checks 
jcarlos.vale: checks 
SoChute: bets 40
Phisie: raises 365 to 405
LauriOy: folds 
LEE MARVIN17: folds 
lucaasiilva3: folds 
jcarlos.vale: folds 
SoChute: calls 365
*** TURN *** [2d 5s 7d] [Ks]
SoChute: checks 
Phisie: bets 1095
SoChute: calls 1095
*** RIVER *** [2d 5s 7d Ks] [3d]
SoChute: bets 1675 and is all-in
Phisie: folds 
Uncalled bet (1675) returned to SoChute
SoChute collected 3285 from pot
SoChute: doesn't show handDTO
*** SUMMARY ***
Total pot 3285 | Rake 0 
Board [2d 5s 7d Ks 3d]
Seat 1: LauriOy folded on the Flop
Seat 2: LEE MARVIN17 folded on the Flop
Seat 3: Gerason93 (button) folded before Flop (didn't bet)
Seat 4: lucaasiilva3 (small blind) folded on the Flop
Seat 5: jcarlos.vale (big blind) folded on the Flop
Seat 6: SoChute collected (3285)
Seat 7: Phisie folded on the River
Seat 8: Elena19years folded before Flop (didn't bet)
Seat 9: evstraliss folded before Flop (didn't bet)



PokerStars Hand #221583227281: Tournament #3074230175, $0.98+$0.12 USD Hold'em No Limit - Level II (20/40) - 2020/12/18 22:41:56 EET [2020/12/18 15:41:56 ET]
Table '3074230175 2' 9-max Seat #4 is the button
Seat 1: LauriOy (2664 in chips) 
Seat 2: LEE MARVIN17 (2720 in chips) 
Seat 3: Gerason93 (1887 in chips) 
Seat 4: lucaasiilva3 (2897 in chips) 
Seat 5: jcarlos.vale (3583 in chips) 
Seat 6: SoChute (4960 in chips) 
Seat 7: Phisie (1739 in chips) 
Seat 8: Elena19years (4134 in chips) 
Seat 9: evstraliss (2420 in chips) 
LauriOy: posts the ante 5
LEE MARVIN17: posts the ante 5
Gerason93: posts the ante 5
lucaasiilva3: posts the ante 5
jcarlos.vale: posts the ante 5
SoChute: posts the ante 5
Phisie: posts the ante 5
Elena19years: posts the ante 5
evstraliss: posts the ante 5
jcarlos.vale: posts small blind 20
SoChute: posts big blind 40
*** HOLE CARDS ***
Dealt to jcarlos.vale [4s 6c]
Phisie: folds 
Elena19years: folds 
evstraliss: raises 48 to 88
LauriOy: calls 88
LEE MARVIN17: calls 88
Gerason93: folds 
lucaasiilva3: raises 532 to 620
jcarlos.vale: folds 
SoChute: folds 
evstraliss: folds 
LauriOy: folds 
LEE MARVIN17: folds 
Uncalled bet (532) returned to lucaasiilva3
lucaasiilva3 collected 457 from pot
*** SUMMARY ***
Total pot 457 | Rake 0 
Seat 1: LauriOy folded before Flop
Seat 2: LEE MARVIN17 folded before Flop
Seat 3: Gerason93 folded before Flop (didn't bet)
Seat 4: lucaasiilva3 (button) collected (457)
Seat 5: jcarlos.vale (small blind) folded before Flop
Seat 6: SoChute (big blind) folded before Flop
Seat 7: Phisie folded before Flop (didn't bet)
Seat 8: Elena19years folded before Flop (didn't bet)
Seat 9: evstraliss folded before Flop



PokerStars Hand #221583267665: Tournament #3074230175, $0.98+$0.12 USD Hold'em No Limit - Level II (20/40) - 2020/12/18 22:42:52 EET [2020/12/18 15:42:52 ET]
Table '3074230175 2' 9-max Seat #5 is the button
Seat 1: LauriOy (2571 in chips) 
Seat 2: LEE MARVIN17 (2627 in chips) 
Seat 3: Gerason93 (1882 in chips) 
Seat 4: lucaasiilva3 (3261 in chips) 
Seat 5: jcarlos.vale (3558 in chips) 
Seat 6: SoChute (4915 in chips) 
Seat 7: Phisie (1734 in chips) 
Seat 8: Elena19years (4129 in chips) 
Seat 9: evstraliss (2327 in chips) 
LauriOy: posts the ante 5
LEE MARVIN17: posts the ante 5
Gerason93: posts the ante 5
lucaasiilva3: posts the ante 5
jcarlos.vale: posts the ante 5
SoChute: posts the ante 5
Phisie: posts the ante 5
Elena19years: posts the ante 5
evstraliss: posts the ante 5
SoChute: posts small blind 20
Phisie: posts big blind 40
*** HOLE CARDS ***
Dealt to jcarlos.vale [Ks Kd]
Elena19years: folds 
evstraliss: folds 
LauriOy: folds 
LEE MARVIN17: folds 
Gerason93: folds 
lucaasiilva3: folds 
jcarlos.vale: raises 64 to 104
SoChute: calls 84
Phisie: folds 
*** FLOP *** [Js 8h Jc]
SoChute: checks 
jcarlos.vale: bets 120
SoChute: raises 120 to 240
jcarlos.vale: calls 120
*** TURN *** [Js 8h Jc] [6d]
SoChute: bets 387
jcarlos.vale: folds 
Uncalled bet (387) returned to SoChute
SoChute collected 773 from pot
SoChute: doesn't show handDTO
*** SUMMARY ***
Total pot 773 | Rake 0 
Board [Js 8h Jc 6d]
Seat 1: LauriOy folded before Flop (didn't bet)
Seat 2: LEE MARVIN17 folded before Flop (didn't bet)
Seat 3: Gerason93 folded before Flop (didn't bet)
Seat 4: lucaasiilva3 folded before Flop (didn't bet)
Seat 5: jcarlos.vale (button) folded on the Turn
Seat 6: SoChute (small blind) collected (773)
Seat 7: Phisie (big blind) folded before Flop
Seat 8: Elena19years folded before Flop (didn't bet)
Seat 9: evstraliss folded before Flop (didn't bet)



PokerStars Hand #221583315618: Tournament #3074230175, $0.98+$0.12 USD Hold'em No Limit - Level II (20/40) - 2020/12/18 22:43:58 EET [2020/12/18 15:43:58 ET]
Table '3074230175 2' 9-max Seat #6 is the button
Seat 1: LauriOy (2566 in chips) 
Seat 2: LEE MARVIN17 (2622 in chips) 
Seat 3: Gerason93 (1877 in chips) 
Seat 4: lucaasiilva3 (3256 in chips) 
Seat 5: jcarlos.vale (3209 in chips) 
Seat 6: SoChute (5339 in chips) 
Seat 7: Phisie (1689 in chips) 
Seat 8: Elena19years (4124 in chips) 
Seat 9: evstraliss (2322 in chips) 
LauriOy: posts the ante 5
LEE MARVIN17: posts the ante 5
Gerason93: posts the ante 5
lucaasiilva3: posts the ante 5
jcarlos.vale: posts the ante 5
SoChute: posts the ante 5
Phisie: posts the ante 5
Elena19years: posts the ante 5
evstraliss: posts the ante 5
Phisie: posts small blind 20
Elena19years: posts big blind 40
*** HOLE CARDS ***
Dealt to jcarlos.vale [Tc 7s]
evstraliss: raises 48 to 88
LauriOy: calls 88
LEE MARVIN17: folds 
Gerason93: folds 
lucaasiilva3: calls 88
jcarlos.vale: folds 
SoChute: calls 88
Phisie: folds 
Elena19years: calls 48
*** FLOP *** [Qh As 3s]
Elena19years: checks 
evstraliss: bets 167
LauriOy: calls 167
lucaasiilva3: folds 
SoChute: folds 
Elena19years: folds 
*** TURN *** [Qh As 3s] [8h]
evstraliss: bets 559
LauriOy: raises 559 to 1118
evstraliss: raises 944 to 2062 and is all-in
LauriOy: calls 944
*** RIVER *** [Qh As 3s 8h] [9c]
*** SHOW DOWN ***
evstraliss: shows [Kc Ac] (a pair of Aces)
LauriOy: shows [Ad 3h] (two pair, Aces and Threes)
LauriOy collected 4963 from pot
evstraliss finished the tournament
*** SUMMARY ***
Total pot 4963 | Rake 0 
Board [Qh As 3s 8h 9c]
Seat 1: LauriOy showed [Ad 3h] and won (4963) with two pair, Aces and Threes
Seat 2: LEE MARVIN17 folded before Flop (didn't bet)
Seat 3: Gerason93 folded before Flop (didn't bet)
Seat 4: lucaasiilva3 folded on the Flop
Seat 5: jcarlos.vale folded before Flop (didn't bet)
Seat 6: SoChute (button) folded on the Flop
Seat 7: Phisie (small blind) folded before Flop
Seat 8: Elena19years (big blind) folded on the Flop
Seat 9: evstraliss showed [Kc Ac] and lost with a pair of Aces



PokerStars Hand #221583365384: Tournament #3074230175, $0.98+$0.12 USD Hold'em No Limit - Level II (20/40) - 2020/12/18 22:45:07 EET [2020/12/18 15:45:07 ET]
Table '3074230175 2' 9-max Seat #7 is the button
Seat 1: LauriOy (5207 in chips) 
Seat 2: LEE MARVIN17 (2617 in chips) 
Seat 3: Gerason93 (1872 in chips) 
Seat 4: lucaasiilva3 (3163 in chips) 
Seat 5: jcarlos.vale (3204 in chips) 
Seat 6: SoChute (5246 in chips) 
Seat 7: Phisie (1664 in chips) 
Seat 8: Elena19years (4031 in chips) 
LauriOy: posts the ante 5
LEE MARVIN17: posts the ante 5
Gerason93: posts the ante 5
lucaasiilva3: posts the ante 5
jcarlos.vale: posts the ante 5
SoChute: posts the ante 5
Phisie: posts the ante 5
Elena19years: posts the ante 5
Elena19years: posts small blind 20
LauriOy: posts big blind 40
*** HOLE CARDS ***
Dealt to jcarlos.vale [9h 8d]
LEE MARVIN17: folds 
Gerason93: folds 
lucaasiilva3: raises 1000 to 1040
jcarlos.vale: folds 
SoChute: folds 
Phisie: folds 
Elena19years: folds 
LauriOy: folds 
Uncalled bet (1000) returned to lucaasiilva3
lucaasiilva3 collected 140 from pot
*** SUMMARY ***
Total pot 140 | Rake 0 
Seat 1: LauriOy (big blind) folded before Flop
Seat 2: LEE MARVIN17 folded before Flop (didn't bet)
Seat 3: Gerason93 folded before Flop (didn't bet)
Seat 4: lucaasiilva3 collected (140)
Seat 5: jcarlos.vale folded before Flop (didn't bet)
Seat 6: SoChute folded before Flop (didn't bet)
Seat 7: Phisie (button) folded before Flop (didn't bet)
Seat 8: Elena19years (small blind) folded before Flop



PokerStars Hand #221583384787: Tournament #3074230175, $0.98+$0.12 USD Hold'em No Limit - Level II (20/40) - 2020/12/18 22:45:34 EET [2020/12/18 15:45:34 ET]
Table '3074230175 2' 9-max Seat #8 is the button
Seat 1: LauriOy (5162 in chips) 
Seat 2: LEE MARVIN17 (2612 in chips) 
Seat 3: Gerason93 (1867 in chips) 
Seat 4: lucaasiilva3 (3258 in chips) 
Seat 5: jcarlos.vale (3199 in chips) 
Seat 6: SoChute (5241 in chips) 
Seat 7: Phisie (1659 in chips) 
Seat 8: Elena19years (4006 in chips) 
Seat 9: supersonic223 (3000 in chips) out of handDTO (moved from another table into small blind)
supersonic223 will be allowed to play after the button
LauriOy: posts the ante 5
LEE MARVIN17: posts the ante 5
Gerason93: posts the ante 5
lucaasiilva3: posts the ante 5
jcarlos.vale: posts the ante 5
SoChute: posts the ante 5
Phisie: posts the ante 5
Elena19years: posts the ante 5
LauriOy: posts small blind 20
LEE MARVIN17: posts big blind 40
*** HOLE CARDS ***
Dealt to jcarlos.vale [Td Ks]
Gerason93: folds 
lucaasiilva3: folds 
jcarlos.vale: folds 
SoChute: raises 40 to 80
Phisie: folds 
Elena19years: folds 
LauriOy: calls 60
LEE MARVIN17: folds 
*** FLOP *** [2s Th 4s]
LauriOy: checks 
SoChute: bets 120
LauriOy: calls 120
*** TURN *** [2s Th 4s] [3h]
LauriOy: checks 
SoChute: bets 240
LauriOy: folds 
Uncalled bet (240) returned to SoChute
SoChute collected 480 from pot
SoChute: doesn't show handDTO
*** SUMMARY ***
Total pot 480 | Rake 0 
Board [2s Th 4s 3h]
Seat 1: LauriOy (small blind) folded on the Turn
Seat 2: LEE MARVIN17 (big blind) folded before Flop
Seat 3: Gerason93 folded before Flop (didn't bet)
Seat 4: lucaasiilva3 folded before Flop (didn't bet)
Seat 5: jcarlos.vale folded before Flop (didn't bet)
Seat 6: SoChute collected (480)
Seat 7: Phisie folded before Flop (didn't bet)
Seat 8: Elena19years (button) folded before Flop (didn't bet)



PokerStars Hand #221583416272: Tournament #3074230175, $0.98+$0.12 USD Hold'em No Limit - Level II (20/40) - 2020/12/18 22:46:17 EET [2020/12/18 15:46:17 ET]
Table '3074230175 2' 9-max Seat #1 is the button
Seat 1: LauriOy (4957 in chips) 
Seat 2: LEE MARVIN17 (2567 in chips) 
Seat 3: Gerason93 (1862 in chips) 
Seat 4: lucaasiilva3 (3253 in chips) 
Seat 5: jcarlos.vale (3194 in chips) 
Seat 6: SoChute (5516 in chips) 
Seat 7: Phisie (1654 in chips) 
Seat 8: Elena19years (4001 in chips) 
Seat 9: supersonic223 (3000 in chips) 
LauriOy: posts the ante 5
LEE MARVIN17: posts the ante 5
Gerason93: posts the ante 5
lucaasiilva3: posts the ante 5
jcarlos.vale: posts the ante 5
SoChute: posts the ante 5
Phisie: posts the ante 5
Elena19years: posts the ante 5
supersonic223: posts the ante 5
LEE MARVIN17: posts small blind 20
Gerason93: posts big blind 40
*** HOLE CARDS ***
Dealt to jcarlos.vale [8d 3d]
lucaasiilva3: raises 40 to 80
jcarlos.vale: folds 
SoChute: folds 
Phisie: folds 
Elena19years: raises 200 to 280
supersonic223: folds 
LauriOy: folds 
LEE MARVIN17: folds 
Gerason93: folds 
lucaasiilva3: raises 400 to 680
Elena19years: raises 3316 to 3996 and is all-in
lucaasiilva3: calls 2568 and is all-in
Uncalled bet (748) returned to Elena19years
*** FLOP *** [4s 7h Jc]
*** TURN *** [4s 7h Jc] [As]
*** RIVER *** [4s 7h Jc As] [Qc]
*** SHOW DOWN ***
lucaasiilva3: shows [Ac Ad] (three of a kind, Aces)
Elena19years: shows [Qs Qd] (three of a kind, Queens)
lucaasiilva3 collected 6601 from pot
*** SUMMARY ***
Total pot 6601 | Rake 0 
Board [4s 7h Jc As Qc]
Seat 1: LauriOy (button) folded before Flop (didn't bet)
Seat 2: LEE MARVIN17 (small blind) folded before Flop
Seat 3: Gerason93 (big blind) folded before Flop
Seat 4: lucaasiilva3 showed [Ac Ad] and won (6601) with three of a kind, Aces
Seat 5: jcarlos.vale folded before Flop (didn't bet)
Seat 6: SoChute folded before Flop (didn't bet)
Seat 7: Phisie folded before Flop (didn't bet)
Seat 8: Elena19years showed [Qs Qd] and lost with three of a kind, Queens
Seat 9: supersonic223 folded before Flop (didn't bet)



PokerStars Hand #221583445606: Tournament #3074230175, $0.98+$0.12 USD Hold'em No Limit - Level II (20/40) - 2020/12/18 22:46:58 EET [2020/12/18 15:46:58 ET]
Table '3074230175 2' 9-max Seat #2 is the button
Seat 1: LauriOy (4952 in chips) 
Seat 2: LEE MARVIN17 (2542 in chips) 
Seat 3: Gerason93 (1817 in chips) 
Seat 4: lucaasiilva3 (6601 in chips) 
Seat 5: jcarlos.vale (3189 in chips) 
Seat 6: SoChute (5511 in chips) 
Seat 7: Phisie (1649 in chips) 
Seat 8: Elena19years (748 in chips) 
Seat 9: supersonic223 (2995 in chips) 
LauriOy: posts the ante 5
LEE MARVIN17: posts the ante 5
Gerason93: posts the ante 5
lucaasiilva3: posts the ante 5
jcarlos.vale: posts the ante 5
SoChute: posts the ante 5
Phisie: posts the ante 5
Elena19years: posts the ante 5
supersonic223: posts the ante 5
Gerason93: posts small blind 20
lucaasiilva3: posts big blind 40
*** HOLE CARDS ***
Dealt to jcarlos.vale [Tc 9h]
jcarlos.vale: folds 
SoChute: folds 
Phisie: folds 
Elena19years: folds 
supersonic223: raises 40 to 80
LauriOy: calls 80
LEE MARVIN17: calls 80
Gerason93: folds 
lucaasiilva3: calls 40
*** FLOP *** [Th 6d Ac]
lucaasiilva3: checks 
supersonic223: checks 
LauriOy: checks 
LEE MARVIN17: bets 100
lucaasiilva3: calls 100
supersonic223: calls 100
LauriOy: calls 100
*** TURN *** [Th 6d Ac] [Ad]
lucaasiilva3: checks 
supersonic223: bets 200
LauriOy: folds 
LEE MARVIN17: raises 260 to 460
lucaasiilva3: folds 
supersonic223: folds 
Uncalled bet (260) returned to LEE MARVIN17
LEE MARVIN17 collected 1185 from pot
*** SUMMARY ***
Total pot 1185 | Rake 0 
Board [Th 6d Ac Ad]
Seat 1: LauriOy folded on the Turn
Seat 2: LEE MARVIN17 (button) collected (1185)
Seat 3: Gerason93 (small blind) folded before Flop
Seat 4: lucaasiilva3 (big blind) folded on the Turn
Seat 5: jcarlos.vale folded before Flop (didn't bet)
Seat 6: SoChute folded before Flop (didn't bet)
Seat 7: Phisie folded before Flop (didn't bet)
Seat 8: Elena19years folded before Flop (didn't bet)
Seat 9: supersonic223 folded on the Turn



PokerStars Hand #221583554092: Tournament #3074230175, $0.98+$0.12 USD Hold'em No Limit - Level II (20/40) - 2020/12/18 22:49:30 EET [2020/12/18 15:49:30 ET]
Table '3074230175 2' 9-max Seat #3 is the button
Seat 1: LauriOy (4767 in chips) 
Seat 2: LEE MARVIN17 (3342 in chips) 
Seat 3: Gerason93 (1792 in chips) 
Seat 4: lucaasiilva3 (6416 in chips) 
Seat 5: jcarlos.vale (3184 in chips) 
Seat 6: SoChute (5506 in chips) 
Seat 7: Phisie (1644 in chips) 
Seat 8: Elena19years (743 in chips) 
Seat 9: supersonic223 (2610 in chips) 
LauriOy: posts the ante 5
LEE MARVIN17: posts the ante 5
Gerason93: posts the ante 5
lucaasiilva3: posts the ante 5
jcarlos.vale: posts the ante 5
SoChute: posts the ante 5
Phisie: posts the ante 5
Elena19years: posts the ante 5
supersonic223: posts the ante 5
lucaasiilva3: posts small blind 20
jcarlos.vale: posts big blind 40
*** HOLE CARDS ***
Dealt to jcarlos.vale [Kh Jc]
SoChute: folds 
Phisie: folds 
Elena19years: folds 
supersonic223: calls 40
LauriOy: calls 40
LEE MARVIN17: folds 
Gerason93: folds 
lucaasiilva3: raises 180 to 220
jcarlos.vale: folds 
supersonic223: calls 180
LauriOy: folds 
*** FLOP *** [3d Tc 5d]
lucaasiilva3: bets 364
supersonic223: calls 364
*** TURN *** [3d Tc 5d] [9s]
lucaasiilva3: bets 375
supersonic223: calls 375
*** RIVER *** [3d Tc 5d 9s] [Jh]
lucaasiilva3: checks 
supersonic223: bets 1646 and is all-in
lucaasiilva3: folds 
Uncalled bet (1646) returned to supersonic223
supersonic223 collected 2043 from pot
supersonic223: doesn't show handDTO
*** SUMMARY ***
Total pot 2043 | Rake 0 
Board [3d Tc 5d 9s Jh]
Seat 1: LauriOy folded before Flop
Seat 2: LEE MARVIN17 folded before Flop (didn't bet)
Seat 3: Gerason93 (button) folded before Flop (didn't bet)
Seat 4: lucaasiilva3 (small blind) folded on the River
Seat 5: jcarlos.vale (big blind) folded before Flop
Seat 6: SoChute folded before Flop (didn't bet)
Seat 7: Phisie folded before Flop (didn't bet)
Seat 8: Elena19years folded before Flop (didn't bet)
Seat 9: supersonic223 collected (2043)



PokerStars Hand #221583643074: Tournament #3074230175, $0.98+$0.12 USD Hold'em No Limit - Level III (25/50) - 2020/12/18 22:51:35 EET [2020/12/18 15:51:35 ET]
Table '3074230175 2' 9-max Seat #4 is the button
Seat 1: LauriOy (4722 in chips) 
Seat 2: LEE MARVIN17 (3337 in chips) 
Seat 3: Gerason93 (1787 in chips) 
Seat 4: lucaasiilva3 (5452 in chips) 
Seat 5: jcarlos.vale (3139 in chips) 
Seat 6: SoChute (5501 in chips) 
Seat 7: Phisie (1639 in chips) 
Seat 8: Elena19years (738 in chips) 
Seat 9: supersonic223 (3689 in chips) 
LauriOy: posts the ante 6
LEE MARVIN17: posts the ante 6
Gerason93: posts the ante 6
lucaasiilva3: posts the ante 6
jcarlos.vale: posts the ante 6
SoChute: posts the ante 6
Phisie: posts the ante 6
Elena19years: posts the ante 6
supersonic223: posts the ante 6
jcarlos.vale: posts small blind 25
SoChute: posts big blind 50
*** HOLE CARDS ***
Dealt to jcarlos.vale [2s 9c]
Phisie: folds 
Elena19years: folds 
supersonic223: calls 50
LauriOy: calls 50
LEE MARVIN17: folds 
Gerason93: folds 
lucaasiilva3: folds 
jcarlos.vale: calls 25
SoChute: checks 
*** FLOP *** [Kd 7d Ah]
jcarlos.vale: checks 
SoChute: checks 
supersonic223: checks 
LauriOy: checks 
*** TURN *** [Kd 7d Ah] [7h]
jcarlos.vale: checks 
SoChute: checks 
supersonic223: checks 
lucaasiilva3 is sitting out
LauriOy: checks 
*** RIVER *** [Kd 7d Ah 7h] [4h]
jcarlos.vale: checks 
SoChute: bets 127
supersonic223: folds 
LauriOy: folds 
jcarlos.vale: folds 
Uncalled bet (127) returned to SoChute
SoChute collected 254 from pot
SoChute: doesn't show handDTO
*** SUMMARY ***
Total pot 254 | Rake 0 
Board [Kd 7d Ah 7h 4h]
Seat 1: LauriOy folded on the River
Seat 2: LEE MARVIN17 folded before Flop (didn't bet)
Seat 3: Gerason93 folded before Flop (didn't bet)
Seat 4: lucaasiilva3 (button) folded before Flop (didn't bet)
Seat 5: jcarlos.vale (small blind) folded on the River
Seat 6: SoChute (big blind) collected (254)
Seat 7: Phisie folded before Flop (didn't bet)
Seat 8: Elena19years folded before Flop (didn't bet)
Seat 9: supersonic223 folded on the River



PokerStars Hand #221583688455: Tournament #3074230175, $0.98+$0.12 USD Hold'em No Limit - Level III (25/50) - 2020/12/18 22:52:39 EET [2020/12/18 15:52:39 ET]
Table '3074230175 2' 9-max Seat #5 is the button
Seat 1: LauriOy (4666 in chips) 
Seat 2: LEE MARVIN17 (3331 in chips) 
Seat 3: Gerason93 (1781 in chips) 
Seat 4: lucaasiilva3 (5446 in chips) is sitting out
Seat 5: jcarlos.vale (3083 in chips) 
Seat 6: SoChute (5699 in chips) 
Seat 7: Phisie (1633 in chips) 
Seat 8: Elena19years (732 in chips) 
Seat 9: supersonic223 (3633 in chips) 
LauriOy: posts the ante 6
LEE MARVIN17: posts the ante 6
Gerason93: posts the ante 6
lucaasiilva3: posts the ante 6
jcarlos.vale: posts the ante 6
SoChute: posts the ante 6
Phisie: posts the ante 6
Elena19years: posts the ante 6
supersonic223: posts the ante 6
SoChute: posts small blind 25
Phisie: posts big blind 50
*** HOLE CARDS ***
Dealt to jcarlos.vale [6s Ac]
lucaasiilva3 has returned
Elena19years: folds 
supersonic223: calls 50
LauriOy: calls 50
LEE MARVIN17: folds 
Gerason93: folds 
lucaasiilva3: folds 
lucaasiilva3 is sitting out
jcarlos.vale: folds 
SoChute: raises 250 to 300
Phisie: folds 
supersonic223: folds 
LauriOy: calls 250
*** FLOP *** [9h 9d 8d]
SoChute: bets 377
LauriOy: folds 
Uncalled bet (377) returned to SoChute
SoChute collected 754 from pot
SoChute: doesn't show handDTO
*** SUMMARY ***
Total pot 754 | Rake 0 
Board [9h 9d 8d]
Seat 1: LauriOy folded on the Flop
Seat 2: LEE MARVIN17 folded before Flop (didn't bet)
Seat 3: Gerason93 folded before Flop (didn't bet)
Seat 4: lucaasiilva3 folded before Flop (didn't bet)
Seat 5: jcarlos.vale (button) folded before Flop (didn't bet)
Seat 6: SoChute (small blind) collected (754)
Seat 7: Phisie (big blind) folded before Flop
Seat 8: Elena19years folded before Flop (didn't bet)
Seat 9: supersonic223 folded before Flop



PokerStars Hand #221583721241: Tournament #3074230175, $0.98+$0.12 USD Hold'em No Limit - Level III (25/50) - 2020/12/18 22:53:25 EET [2020/12/18 15:53:25 ET]
Table '3074230175 2' 9-max Seat #6 is the button
Seat 1: LauriOy (4360 in chips) 
Seat 2: LEE MARVIN17 (3325 in chips) 
Seat 3: Gerason93 (1775 in chips) 
Seat 4: lucaasiilva3 (5440 in chips) is sitting out
Seat 5: jcarlos.vale (3077 in chips) 
Seat 6: SoChute (6147 in chips) 
Seat 7: Phisie (1577 in chips) 
Seat 8: Elena19years (726 in chips) 
Seat 9: supersonic223 (3577 in chips) 
LauriOy: posts the ante 6
LEE MARVIN17: posts the ante 6
Gerason93: posts the ante 6
lucaasiilva3: posts the ante 6
jcarlos.vale: posts the ante 6
SoChute: posts the ante 6
Phisie: posts the ante 6
Elena19years: posts the ante 6
supersonic223: posts the ante 6
Phisie: posts small blind 25
Elena19years: posts big blind 50
*** HOLE CARDS ***
Dealt to jcarlos.vale [As 5c]
supersonic223: folds 
LauriOy: calls 50
LEE MARVIN17: folds 
Gerason93: folds 
lucaasiilva3: folds 
jcarlos.vale: folds 
SoChute: raises 50 to 100
Phisie: folds 
Elena19years: folds 
LauriOy: calls 50
*** FLOP *** [8h 5h 4s]
LauriOy: checks 
SoChute: checks 
*** TURN *** [8h 5h 4s] [6c]
LauriOy: checks 
SoChute: bets 165
LauriOy: calls 165
*** RIVER *** [8h 5h 4s 6c] [7h]
LauriOy: bets 300
SoChute: raises 730 to 1030
LauriOy: raises 730 to 1760
SoChute: calls 730
*** SHOW DOWN ***
LauriOy: shows [Ac 9s] (a straight, Five to Nine)
SoChute: mucks handDTO
LauriOy collected 4179 from pot
*** SUMMARY ***
Total pot 4179 | Rake 0 
Board [8h 5h 4s 6c 7h]
Seat 1: LauriOy showed [Ac 9s] and won (4179) with a straight, Five to Nine
Seat 2: LEE MARVIN17 folded before Flop (didn't bet)
Seat 3: Gerason93 folded before Flop (didn't bet)
Seat 4: lucaasiilva3 folded before Flop (didn't bet)
Seat 5: jcarlos.vale folded before Flop (didn't bet)
Seat 6: SoChute (button) mucked [Ad 7d]
Seat 7: Phisie (small blind) folded before Flop
Seat 8: Elena19years (big blind) folded before Flop
Seat 9: supersonic223 folded before Flop (didn't bet)



PokerStars Hand #221583773090: Tournament #3074230175, $0.98+$0.12 USD Hold'em No Limit - Level III (25/50) - 2020/12/18 22:54:38 EET [2020/12/18 15:54:38 ET]
Table '3074230175 2' 9-max Seat #7 is the button
Seat 1: LauriOy (6508 in chips) 
Seat 2: LEE MARVIN17 (3319 in chips) 
Seat 3: Gerason93 (1769 in chips) 
Seat 4: lucaasiilva3 (5434 in chips) is sitting out
Seat 5: jcarlos.vale (3071 in chips) 
Seat 6: SoChute (4116 in chips) 
Seat 7: Phisie (1546 in chips) 
Seat 8: Elena19years (670 in chips) 
Seat 9: supersonic223 (3571 in chips) 
LauriOy: posts the ante 6
LEE MARVIN17: posts the ante 6
Gerason93: posts the ante 6
lucaasiilva3: posts the ante 6
jcarlos.vale: posts the ante 6
SoChute: posts the ante 6
Phisie: posts the ante 6
Elena19years: posts the ante 6
supersonic223: posts the ante 6
Elena19years: posts small blind 25
supersonic223: posts big blind 50
*** HOLE CARDS ***
Dealt to jcarlos.vale [Ac 6c]
LauriOy: calls 50
LEE MARVIN17: folds 
Gerason93: folds 
lucaasiilva3: folds 
jcarlos.vale: calls 50
SoChute: raises 50 to 100
Phisie: folds 
Elena19years: folds 
supersonic223: calls 50
LauriOy: calls 50
jcarlos.vale: calls 50
*** FLOP *** [Ts 8s Jh]
supersonic223: checks 
LauriOy: checks 
jcarlos.vale: checks 
SoChute: bets 240
supersonic223: calls 240
LauriOy: calls 240
jcarlos.vale: folds 
*** TURN *** [Ts 8s Jh] [Ks]
supersonic223: checks 
LauriOy: checks 
SoChute: bets 300
supersonic223: folds 
LauriOy: folds 
Uncalled bet (300) returned to SoChute
SoChute collected 1199 from pot
SoChute: doesn't show handDTO
*** SUMMARY ***
Total pot 1199 | Rake 0 
Board [Ts 8s Jh Ks]
Seat 1: LauriOy folded on the Turn
Seat 2: LEE MARVIN17 folded before Flop (didn't bet)
Seat 3: Gerason93 folded before Flop (didn't bet)
Seat 4: lucaasiilva3 folded before Flop (didn't bet)
Seat 5: jcarlos.vale folded on the Flop
Seat 6: SoChute collected (1199)
Seat 7: Phisie (button) folded before Flop (didn't bet)
Seat 8: Elena19years (small blind) folded before Flop
Seat 9: supersonic223 (big blind) folded on the Turn



PokerStars Hand #221584020591: Tournament #3074230175, $0.98+$0.12 USD Hold'em No Limit - Level III (25/50) - 2020/12/18 23:01:57 EET [2020/12/18 16:01:57 ET]
Table '3074230175 55' 9-max Seat #1 is the button
Seat 1: MrFerns6 (2645 in chips) 
Seat 2: BLNDIK (3723 in chips) 
Seat 3: maciel1986 (2775 in chips) 
Seat 4: jcarlos.vale (2965 in chips) 
Seat 5: ImCrazyFish (2370 in chips) 
Seat 6: fern46 (2424 in chips) 
Seat 7: Efumchik1164 (10580 in chips) 
Seat 8: BMW 812 (1455 in chips) 
Seat 9: civicburnout420 (5238 in chips) 
MrFerns6: posts the ante 6
BLNDIK: posts the ante 6
maciel1986: posts the ante 6
jcarlos.vale: posts the ante 6
ImCrazyFish: posts the ante 6
fern46: posts the ante 6
Efumchik1164: posts the ante 6
BMW 812: posts the ante 6
civicburnout420: posts the ante 6
BLNDIK: posts small blind 25
maciel1986: posts big blind 50
*** HOLE CARDS ***
Dealt to jcarlos.vale [Ts Kd]
jcarlos.vale: folds 
ImCrazyFish: folds 
fern46: folds 
Efumchik1164: raises 100 to 150
BMW 812: folds 
civicburnout420: calls 150
MrFerns6: calls 150
BLNDIK: folds 
maciel1986: folds 
*** FLOP *** [4d 5c 2h]
Efumchik1164: bets 290
civicburnout420: folds 
MrFerns6: calls 290
*** TURN *** [4d 5c 2h] [7c]
Efumchik1164: bets 580
MrFerns6: folds 
Uncalled bet (580) returned to Efumchik1164
Efumchik1164 collected 1159 from pot
*** SUMMARY ***
Total pot 1159 | Rake 0 
Board [4d 5c 2h 7c]
Seat 1: MrFerns6 (button) folded on the Turn
Seat 2: BLNDIK (small blind) folded before Flop
Seat 3: maciel1986 (big blind) folded before Flop
Seat 4: jcarlos.vale folded before Flop (didn't bet)
Seat 5: ImCrazyFish folded before Flop (didn't bet)
Seat 6: fern46 folded before Flop (didn't bet)
Seat 7: Efumchik1164 collected (1159)
Seat 8: BMW 812 folded before Flop (didn't bet)
Seat 9: civicburnout420 folded on the Flop



PokerStars Hand #221584076160: Tournament #3074230175, $0.98+$0.12 USD Hold'em No Limit - Level III (25/50) - 2020/12/18 23:03:17 EET [2020/12/18 16:03:17 ET]
Table '3074230175 55' 9-max Seat #2 is the button
Seat 1: MrFerns6 (2199 in chips) 
Seat 2: BLNDIK (3692 in chips) 
Seat 3: maciel1986 (2719 in chips) 
Seat 4: jcarlos.vale (2959 in chips) 
Seat 5: ImCrazyFish (2364 in chips) 
Seat 6: fern46 (2418 in chips) 
Seat 7: Efumchik1164 (11293 in chips) 
Seat 8: BMW 812 (1449 in chips) 
Seat 9: civicburnout420 (5082 in chips) 
MrFerns6: posts the ante 6
BLNDIK: posts the ante 6
maciel1986: posts the ante 6
jcarlos.vale: posts the ante 6
ImCrazyFish: posts the ante 6
fern46: posts the ante 6
Efumchik1164: posts the ante 6
BMW 812: posts the ante 6
civicburnout420: posts the ante 6
maciel1986: posts small blind 25
jcarlos.vale: posts big blind 50
*** HOLE CARDS ***
Dealt to jcarlos.vale [6d 2c]
ImCrazyFish: folds 
fern46: calls 50
Efumchik1164: raises 229 to 279
BMW 812: calls 279
civicburnout420: folds 
MrFerns6: calls 279
BLNDIK: folds 
maciel1986: folds 
jcarlos.vale: folds 
fern46: folds 
*** FLOP *** [Ac Kd Qd]
Efumchik1164: bets 50
BMW 812: folds 
MrFerns6: calls 50
*** TURN *** [Ac Kd Qd] [Jc]
Efumchik1164: bets 558
MrFerns6: folds 
Uncalled bet (558) returned to Efumchik1164
Efumchik1164 collected 1116 from pot
*** SUMMARY ***
Total pot 1116 | Rake 0 
Board [Ac Kd Qd Jc]
Seat 1: MrFerns6 folded on the Turn
Seat 2: BLNDIK (button) folded before Flop (didn't bet)
Seat 3: maciel1986 (small blind) folded before Flop
Seat 4: jcarlos.vale (big blind) folded before Flop
Seat 5: ImCrazyFish folded before Flop (didn't bet)
Seat 6: fern46 folded before Flop
Seat 7: Efumchik1164 collected (1116)
Seat 8: BMW 812 folded on the Flop
Seat 9: civicburnout420 folded before Flop (didn't bet)



PokerStars Hand #221584114544: Tournament #3074230175, $0.98+$0.12 USD Hold'em No Limit - Level III (25/50) - 2020/12/18 23:04:10 EET [2020/12/18 16:04:10 ET]
Table '3074230175 55' 9-max Seat #3 is the button
Seat 1: MrFerns6 (1864 in chips) 
Seat 2: BLNDIK (3686 in chips) 
Seat 3: maciel1986 (2688 in chips) 
Seat 4: jcarlos.vale (2903 in chips) 
Seat 5: ImCrazyFish (2358 in chips) 
Seat 6: fern46 (2362 in chips) 
Seat 7: Efumchik1164 (12074 in chips) 
Seat 8: BMW 812 (1164 in chips) 
Seat 9: civicburnout420 (5076 in chips) 
MrFerns6: posts the ante 6
BLNDIK: posts the ante 6
maciel1986: posts the ante 6
jcarlos.vale: posts the ante 6
ImCrazyFish: posts the ante 6
fern46: posts the ante 6
Efumchik1164: posts the ante 6
BMW 812: posts the ante 6
civicburnout420: posts the ante 6
jcarlos.vale: posts small blind 25
ImCrazyFish: posts big blind 50
*** HOLE CARDS ***
Dealt to jcarlos.vale [Jh 2h]
fern46: folds 
Efumchik1164: raises 100 to 150
BMW 812: calls 150
civicburnout420: folds 
MrFerns6: folds 
BLNDIK: folds 
maciel1986: folds 
jcarlos.vale: folds 
ImCrazyFish: folds 
*** FLOP *** [7d 5c 4c]
Efumchik1164: checks 
BMW 812: checks 
*** TURN *** [7d 5c 4c] [Js]
Efumchik1164: bets 215
BMW 812: raises 215 to 430
Efumchik1164: calls 215
*** RIVER *** [7d 5c 4c Js] [As]
Efumchik1164: checks 
BMW 812: bets 500
Efumchik1164: calls 500
*** SHOW DOWN ***
BMW 812: shows [Qs Jd] (a pair of Jacks)
Efumchik1164: mucks handDTO
BMW 812 collected 2289 from pot
*** SUMMARY ***
Total pot 2289 | Rake 0 
Board [7d 5c 4c Js As]
Seat 1: MrFerns6 folded before Flop (didn't bet)
Seat 2: BLNDIK folded before Flop (didn't bet)
Seat 3: maciel1986 (button) folded before Flop (didn't bet)
Seat 4: jcarlos.vale (small blind) folded before Flop
Seat 5: ImCrazyFish (big blind) folded before Flop
Seat 6: fern46 folded before Flop (didn't bet)
Seat 7: Efumchik1164 mucked [Ks Th]
Seat 8: BMW 812 showed [Qs Jd] and won (2289) with a pair of Jacks
Seat 9: civicburnout420 folded before Flop (didn't bet)



PokerStars Hand #221584170395: Tournament #3074230175, $0.98+$0.12 USD Hold'em No Limit - Level III (25/50) - 2020/12/18 23:05:28 EET [2020/12/18 16:05:28 ET]
Table '3074230175 55' 9-max Seat #4 is the button
Seat 1: MrFerns6 (1858 in chips) 
Seat 2: BLNDIK (3680 in chips) 
Seat 3: maciel1986 (2682 in chips) 
Seat 4: jcarlos.vale (2872 in chips) 
Seat 5: ImCrazyFish (2302 in chips) 
Seat 6: fern46 (2356 in chips) 
Seat 7: Efumchik1164 (10988 in chips) 
Seat 8: BMW 812 (2367 in chips) 
Seat 9: civicburnout420 (5070 in chips) 
MrFerns6: posts the ante 6
BLNDIK: posts the ante 6
maciel1986: posts the ante 6
jcarlos.vale: posts the ante 6
ImCrazyFish: posts the ante 6
fern46: posts the ante 6
Efumchik1164: posts the ante 6
BMW 812: posts the ante 6
civicburnout420: posts the ante 6
ImCrazyFish: posts small blind 25
fern46: posts big blind 50
*** HOLE CARDS ***
Dealt to jcarlos.vale [Kc 8d]
Efumchik1164: folds 
BMW 812: raises 100 to 150
civicburnout420: calls 150
MrFerns6: folds 
BLNDIK: folds 
maciel1986: folds 
jcarlos.vale: folds 
ImCrazyFish: folds 
fern46: folds 
*** FLOP *** [4h Ts 4d]
BMW 812: checks 
civicburnout420: checks 
*** TURN *** [4h Ts 4d] [7s]
BMW 812: bets 200
civicburnout420: calls 200
*** RIVER *** [4h Ts 4d 7s] [4c]
BMW 812: checks 
civicburnout420: checks 
*** SHOW DOWN ***
BMW 812: shows [As 4s] (four of a kind, Fours)
civicburnout420: mucks handDTO
BMW 812 collected 829 from pot
*** SUMMARY ***
Total pot 829 | Rake 0 
Board [4h Ts 4d 7s 4c]
Seat 1: MrFerns6 folded before Flop (didn't bet)
Seat 2: BLNDIK folded before Flop (didn't bet)
Seat 3: maciel1986 folded before Flop (didn't bet)
Seat 4: jcarlos.vale (button) folded before Flop (didn't bet)
Seat 5: ImCrazyFish (small blind) folded before Flop
Seat 6: fern46 (big blind) folded before Flop
Seat 7: Efumchik1164 folded before Flop (didn't bet)
Seat 8: BMW 812 showed [As 4s] and won (829) with four of a kind, Fours
Seat 9: civicburnout420 mucked [Kh 3d]



PokerStars Hand #221584206855: Tournament #3074230175, $0.98+$0.12 USD Hold'em No Limit - Level III (25/50) - 2020/12/18 23:06:19 EET [2020/12/18 16:06:19 ET]
Table '3074230175 55' 9-max Seat #5 is the button
Seat 1: MrFerns6 (1852 in chips) 
Seat 2: BLNDIK (3674 in chips) 
Seat 3: maciel1986 (2676 in chips) 
Seat 4: jcarlos.vale (2866 in chips) 
Seat 5: ImCrazyFish (2271 in chips) 
Seat 6: fern46 (2300 in chips) 
Seat 7: Efumchik1164 (10982 in chips) 
Seat 8: BMW 812 (2840 in chips) 
Seat 9: civicburnout420 (4714 in chips) 
MrFerns6: posts the ante 6
BLNDIK: posts the ante 6
maciel1986: posts the ante 6
jcarlos.vale: posts the ante 6
ImCrazyFish: posts the ante 6
fern46: posts the ante 6
Efumchik1164: posts the ante 6
BMW 812: posts the ante 6
civicburnout420: posts the ante 6
fern46: posts small blind 25
Efumchik1164: posts big blind 50
*** HOLE CARDS ***
Dealt to jcarlos.vale [Ah 6d]
BMW 812: folds 
civicburnout420: folds 
MrFerns6: folds 
BLNDIK: folds 
maciel1986: folds 
jcarlos.vale: raises 80 to 130
ImCrazyFish: calls 130
fern46: folds 
Efumchik1164: folds 
*** FLOP *** [2d Qd Jc]
jcarlos.vale: checks 
ImCrazyFish: bets 2135 and is all-in
jcarlos.vale: folds 
Uncalled bet (2135) returned to ImCrazyFish
ImCrazyFish collected 389 from pot
ImCrazyFish: doesn't show handDTO
*** SUMMARY ***
Total pot 389 | Rake 0 
Board [2d Qd Jc]
Seat 1: MrFerns6 folded before Flop (didn't bet)
Seat 2: BLNDIK folded before Flop (didn't bet)
Seat 3: maciel1986 folded before Flop (didn't bet)
Seat 4: jcarlos.vale folded on the Flop
Seat 5: ImCrazyFish (button) collected (389)
Seat 6: fern46 (small blind) folded before Flop
Seat 7: Efumchik1164 (big blind) folded before Flop
Seat 8: BMW 812 folded before Flop (didn't bet)
Seat 9: civicburnout420 folded before Flop (didn't bet)



PokerStars Hand #221584232249: Tournament #3074230175, $0.98+$0.12 USD Hold'em No Limit - Level III (25/50) - 2020/12/18 23:06:54 EET [2020/12/18 16:06:54 ET]
Table '3074230175 55' 9-max Seat #6 is the button
Seat 1: MrFerns6 (1846 in chips) 
Seat 2: BLNDIK (3668 in chips) 
Seat 3: maciel1986 (2670 in chips) 
Seat 4: jcarlos.vale (2730 in chips) 
Seat 5: ImCrazyFish (2524 in chips) 
Seat 6: fern46 (2269 in chips) 
Seat 7: Efumchik1164 (10926 in chips) 
Seat 8: BMW 812 (2834 in chips) 
Seat 9: civicburnout420 (4708 in chips) 
MrFerns6: posts the ante 6
BLNDIK: posts the ante 6
maciel1986: posts the ante 6
jcarlos.vale: posts the ante 6
ImCrazyFish: posts the ante 6
fern46: posts the ante 6
Efumchik1164: posts the ante 6
BMW 812: posts the ante 6
civicburnout420: posts the ante 6
Efumchik1164: posts small blind 25
BMW 812: posts big blind 50
*** HOLE CARDS ***
Dealt to jcarlos.vale [6c Tc]
civicburnout420: folds 
MrFerns6: folds 
BLNDIK: folds 
maciel1986: folds 
jcarlos.vale: folds 
ImCrazyFish: folds 
fern46: folds 
Efumchik1164: calls 25
BMW 812: checks 
*** FLOP *** [4s Ad Ac]
Efumchik1164: checks 
BMW 812: checks 
*** TURN *** [4s Ad Ac] [8d]
Efumchik1164: checks 
BMW 812: bets 50
Efumchik1164: calls 50
*** RIVER *** [4s Ad Ac 8d] [2s]
Efumchik1164: bets 50
BMW 812: calls 50
*** SHOW DOWN ***
Efumchik1164: shows [Td 2c] (two pair, Aces and Deuces)
BMW 812: shows [8s 7c] (two pair, Aces and Eights)
BMW 812 collected 354 from pot
*** SUMMARY ***
Total pot 354 | Rake 0 
Board [4s Ad Ac 8d 2s]
Seat 1: MrFerns6 folded before Flop (didn't bet)
Seat 2: BLNDIK folded before Flop (didn't bet)
Seat 3: maciel1986 folded before Flop (didn't bet)
Seat 4: jcarlos.vale folded before Flop (didn't bet)
Seat 5: ImCrazyFish folded before Flop (didn't bet)
Seat 6: fern46 (button) folded before Flop (didn't bet)
Seat 7: Efumchik1164 (small blind) showed [Td 2c] and lost with two pair, Aces and Deuces
Seat 8: BMW 812 (big blind) showed [8s 7c] and won (354) with two pair, Aces and Eights
Seat 9: civicburnout420 folded before Flop (didn't bet)



PokerStars Hand #221584269761: Tournament #3074230175, $0.98+$0.12 USD Hold'em No Limit - Level IV (30/60) - 2020/12/18 23:07:45 EET [2020/12/18 16:07:45 ET]
Table '3074230175 55' 9-max Seat #7 is the button
Seat 1: MrFerns6 (1840 in chips) 
Seat 2: BLNDIK (3662 in chips) 
Seat 3: maciel1986 (2664 in chips) 
Seat 4: jcarlos.vale (2724 in chips) 
Seat 5: ImCrazyFish (2518 in chips) 
Seat 6: fern46 (2263 in chips) 
Seat 7: Efumchik1164 (10770 in chips) 
Seat 8: BMW 812 (3032 in chips) 
MrFerns6: posts the ante 7
BLNDIK: posts the ante 7
maciel1986: posts the ante 7
jcarlos.vale: posts the ante 7
ImCrazyFish: posts the ante 7
fern46: posts the ante 7
Efumchik1164: posts the ante 7
BMW 812: posts the ante 7
BMW 812: posts small blind 30
MrFerns6: posts big blind 60
*** HOLE CARDS ***
Dealt to jcarlos.vale [9h 2c]
BLNDIK: folds 
maciel1986: folds 
jcarlos.vale: folds 
ImCrazyFish: folds 
fern46: calls 60
Efumchik1164: folds 
BMW 812: calls 30
MrFerns6: checks 
*** FLOP *** [7h Js As]
BMW 812: checks 
MrFerns6: checks 
fern46: checks 
*** TURN *** [7h Js As] [5d]
BMW 812: bets 60
MrFerns6: folds 
fern46: folds 
Uncalled bet (60) returned to BMW 812
BMW 812 collected 236 from pot
BMW 812: doesn't show handDTO
*** SUMMARY ***
Total pot 236 | Rake 0 
Board [7h Js As 5d]
Seat 1: MrFerns6 (big blind) folded on the Turn
Seat 2: BLNDIK folded before Flop (didn't bet)
Seat 3: maciel1986 folded before Flop (didn't bet)
Seat 4: jcarlos.vale folded before Flop (didn't bet)
Seat 5: ImCrazyFish folded before Flop (didn't bet)
Seat 6: fern46 folded on the Turn
Seat 7: Efumchik1164 (button) folded before Flop (didn't bet)
Seat 8: BMW 812 (small blind) collected (236)



PokerStars Hand #221584295389: Tournament #3074230175, $0.98+$0.12 USD Hold'em No Limit - Level IV (30/60) - 2020/12/18 23:08:21 EET [2020/12/18 16:08:21 ET]
Table '3074230175 55' 9-max Seat #8 is the button
Seat 1: MrFerns6 (1773 in chips) 
Seat 2: BLNDIK (3655 in chips) 
Seat 3: maciel1986 (2657 in chips) 
Seat 4: jcarlos.vale (2717 in chips) 
Seat 5: ImCrazyFish (2511 in chips) 
Seat 6: fern46 (2196 in chips) 
Seat 7: Efumchik1164 (10763 in chips) 
Seat 8: BMW 812 (3201 in chips) 
Seat 9: cyeav22 (3000 in chips) out of handDTO (moved from another table into small blind)
cyeav22 will be allowed to play after the button
MrFerns6: posts the ante 7
BLNDIK: posts the ante 7
maciel1986: posts the ante 7
jcarlos.vale: posts the ante 7
ImCrazyFish: posts the ante 7
fern46: posts the ante 7
Efumchik1164: posts the ante 7
BMW 812: posts the ante 7
MrFerns6: posts small blind 30
BLNDIK: posts big blind 60
*** HOLE CARDS ***
Dealt to jcarlos.vale [Ah 8d]
maciel1986: folds 
jcarlos.vale: folds 
ImCrazyFish: folds 
fern46: folds 
Efumchik1164: raises 120 to 180
BMW 812: folds 
MrFerns6: folds 
BLNDIK: calls 120
*** FLOP *** [Ts 7h Js]
BLNDIK: checks 
Efumchik1164: bets 60
BLNDIK: raises 175 to 235
Efumchik1164: calls 175
*** TURN *** [Ts 7h Js] [9c]
BLNDIK: bets 284
Efumchik1164: calls 284
*** RIVER *** [Ts 7h Js 9c] [5h]
BLNDIK: bets 960
Efumchik1164: folds 
Uncalled bet (960) returned to BLNDIK
BLNDIK collected 1484 from pot
BLNDIK: doesn't show handDTO
*** SUMMARY ***
Total pot 1484 | Rake 0 
Board [Ts 7h Js 9c 5h]
Seat 1: MrFerns6 (small blind) folded before Flop
Seat 2: BLNDIK (big blind) collected (1484)
Seat 3: maciel1986 folded before Flop (didn't bet)
Seat 4: jcarlos.vale folded before Flop (didn't bet)
Seat 5: ImCrazyFish folded before Flop (didn't bet)
Seat 6: fern46 folded before Flop (didn't bet)
Seat 7: Efumchik1164 folded on the River
Seat 8: BMW 812 (button) folded before Flop (didn't bet)



PokerStars Hand #221584368054: Tournament #3074230175, $0.98+$0.12 USD Hold'em No Limit - Level IV (30/60) - 2020/12/18 23:10:01 EET [2020/12/18 16:10:01 ET]
Table '3074230175 55' 9-max Seat #1 is the button
Seat 1: MrFerns6 (1736 in chips) 
Seat 2: BLNDIK (4433 in chips) 
Seat 3: maciel1986 (2650 in chips) 
Seat 4: jcarlos.vale (2710 in chips) 
Seat 5: ImCrazyFish (2504 in chips) 
Seat 6: fern46 (2189 in chips) 
Seat 7: Efumchik1164 (10057 in chips) 
Seat 8: BMW 812 (3194 in chips) 
Seat 9: cyeav22 (3000 in chips) 
MrFerns6: posts the ante 7
BLNDIK: posts the ante 7
maciel1986: posts the ante 7
jcarlos.vale: posts the ante 7
ImCrazyFish: posts the ante 7
fern46: posts the ante 7
Efumchik1164: posts the ante 7
BMW 812: posts the ante 7
cyeav22: posts the ante 7
BLNDIK: posts small blind 30
maciel1986: posts big blind 60
*** HOLE CARDS ***
Dealt to jcarlos.vale [Ah 8d]
jcarlos.vale: folds 
ImCrazyFish: folds 
fern46: folds 
Efumchik1164: folds 
BMW 812: raises 180 to 240
cyeav22: folds 
MrFerns6: calls 240
BLNDIK: folds 
maciel1986: calls 180
*** FLOP *** [9c 7c 8s]
maciel1986: checks 
BMW 812: bets 480
MrFerns6: calls 480
maciel1986: folds 
*** TURN *** [9c 7c 8s] [6s]
BMW 812: bets 1773
MrFerns6: calls 1009 and is all-in
Uncalled bet (764) returned to BMW 812
*** RIVER *** [9c 7c 8s 6s] [5d]
*** SHOW DOWN ***
BMW 812: shows [Kc Jc] (a straight, Five to Nine)
MrFerns6: shows [Qs Jh] (a straight, Five to Nine)
BMW 812 collected 1896 from pot
MrFerns6 collected 1895 from pot
*** SUMMARY ***
Total pot 3791 | Rake 0 
Board [9c 7c 8s 6s 5d]
Seat 1: MrFerns6 (button) showed [Qs Jh] and won (1895) with a straight, Five to Nine
Seat 2: BLNDIK (small blind) folded before Flop
Seat 3: maciel1986 (big blind) folded on the Flop
Seat 4: jcarlos.vale folded before Flop (didn't bet)
Seat 5: ImCrazyFish folded before Flop (didn't bet)
Seat 6: fern46 folded before Flop (didn't bet)
Seat 7: Efumchik1164 folded before Flop (didn't bet)
Seat 8: BMW 812 showed [Kc Jc] and won (1896) with a straight, Five to Nine
Seat 9: cyeav22 folded before Flop (didn't bet)



PokerStars Hand #221584438893: Tournament #3074230175, $0.98+$0.12 USD Hold'em No Limit - Level IV (30/60) - 2020/12/18 23:11:39 EET [2020/12/18 16:11:39 ET]
Table '3074230175 55' 9-max Seat #2 is the button
Seat 1: MrFerns6 (1895 in chips) 
Seat 2: BLNDIK (4396 in chips) 
Seat 3: maciel1986 (2403 in chips) 
Seat 4: jcarlos.vale (2703 in chips) 
Seat 5: ImCrazyFish (2497 in chips) 
Seat 6: fern46 (2182 in chips) 
Seat 7: Efumchik1164 (10050 in chips) 
Seat 8: BMW 812 (3354 in chips) 
Seat 9: cyeav22 (2993 in chips) 
MrFerns6: posts the ante 7
BLNDIK: posts the ante 7
maciel1986: posts the ante 7
jcarlos.vale: posts the ante 7
ImCrazyFish: posts the ante 7
fern46: posts the ante 7
Efumchik1164: posts the ante 7
BMW 812: posts the ante 7
cyeav22: posts the ante 7
maciel1986: posts small blind 30
jcarlos.vale: posts big blind 60
*** HOLE CARDS ***
Dealt to jcarlos.vale [2h Qc]
ImCrazyFish: folds 
fern46: folds 
Efumchik1164: folds 
BMW 812: folds 
cyeav22: raises 60 to 120
MrFerns6: folds 
BLNDIK: calls 120
maciel1986: folds 
jcarlos.vale: folds 
*** FLOP *** [6d 7s Qd]
cyeav22: bets 130
BLNDIK: folds 
Uncalled bet (130) returned to cyeav22
cyeav22 collected 393 from pot
cyeav22: doesn't show handDTO
*** SUMMARY ***
Total pot 393 | Rake 0 
Board [6d 7s Qd]
Seat 1: MrFerns6 folded before Flop (didn't bet)
Seat 2: BLNDIK (button) folded on the Flop
Seat 3: maciel1986 (small blind) folded before Flop
Seat 4: jcarlos.vale (big blind) folded before Flop
Seat 5: ImCrazyFish folded before Flop (didn't bet)
Seat 6: fern46 folded before Flop (didn't bet)
Seat 7: Efumchik1164 folded before Flop (didn't bet)
Seat 8: BMW 812 folded before Flop (didn't bet)
Seat 9: cyeav22 collected (393)



PokerStars Hand #221584487934: Tournament #3074230175, $0.98+$0.12 USD Hold'em No Limit - Level IV (30/60) - 2020/12/18 23:12:47 EET [2020/12/18 16:12:47 ET]
Table '3074230175 55' 9-max Seat #3 is the button
Seat 1: MrFerns6 (1888 in chips) 
Seat 2: BLNDIK (4269 in chips) 
Seat 3: maciel1986 (2366 in chips) 
Seat 4: jcarlos.vale (2636 in chips) 
Seat 5: ImCrazyFish (2490 in chips) 
Seat 6: fern46 (2175 in chips) 
Seat 7: Efumchik1164 (10043 in chips) 
Seat 8: BMW 812 (3347 in chips) 
Seat 9: cyeav22 (3259 in chips) 
MrFerns6: posts the ante 7
BLNDIK: posts the ante 7
maciel1986: posts the ante 7
jcarlos.vale: posts the ante 7
ImCrazyFish: posts the ante 7
fern46: posts the ante 7
Efumchik1164: posts the ante 7
BMW 812: posts the ante 7
cyeav22: posts the ante 7
jcarlos.vale: posts small blind 30
ImCrazyFish: posts big blind 60
*** HOLE CARDS ***
Dealt to jcarlos.vale [Ts 7c]
fern46: folds 
Efumchik1164: raises 60 to 120
BMW 812: folds 
cyeav22: folds 
MrFerns6: folds 
BLNDIK: folds 
maciel1986: folds 
jcarlos.vale: folds 
ImCrazyFish: folds 
Uncalled bet (60) returned to Efumchik1164
Efumchik1164 collected 213 from pot
*** SUMMARY ***
Total pot 213 | Rake 0 
Seat 1: MrFerns6 folded before Flop (didn't bet)
Seat 2: BLNDIK folded before Flop (didn't bet)
Seat 3: maciel1986 (button) folded before Flop (didn't bet)
Seat 4: jcarlos.vale (small blind) folded before Flop
Seat 5: ImCrazyFish (big blind) folded before Flop
Seat 6: fern46 folded before Flop (didn't bet)
Seat 7: Efumchik1164 collected (213)
Seat 8: BMW 812 folded before Flop (didn't bet)
Seat 9: cyeav22 folded before Flop (didn't bet)



PokerStars Hand #221584512401: Tournament #3074230175, $0.98+$0.12 USD Hold'em No Limit - Level IV (30/60) - 2020/12/18 23:13:21 EET [2020/12/18 16:13:21 ET]
Table '3074230175 55' 9-max Seat #4 is the button
Seat 1: MrFerns6 (1881 in chips) 
Seat 2: BLNDIK (4262 in chips) 
Seat 3: maciel1986 (2359 in chips) 
Seat 4: jcarlos.vale (2599 in chips) 
Seat 5: ImCrazyFish (2423 in chips) 
Seat 6: fern46 (2168 in chips) 
Seat 7: Efumchik1164 (10189 in chips) 
Seat 8: BMW 812 (3340 in chips) 
Seat 9: cyeav22 (3252 in chips) 
MrFerns6: posts the ante 7
BLNDIK: posts the ante 7
maciel1986: posts the ante 7
jcarlos.vale: posts the ante 7
ImCrazyFish: posts the ante 7
fern46: posts the ante 7
Efumchik1164: posts the ante 7
BMW 812: posts the ante 7
cyeav22: posts the ante 7
ImCrazyFish: posts small blind 30
fern46: posts big blind 60
*** HOLE CARDS ***
Dealt to jcarlos.vale [4s Qc]
Efumchik1164: raises 213 to 273
BMW 812: folds 
cyeav22: folds 
MrFerns6: folds 
BLNDIK: folds 
maciel1986: folds 
jcarlos.vale: folds 
ImCrazyFish: calls 243
fern46: folds 
*** FLOP *** [4c Td 5h]
ImCrazyFish: checks 
Efumchik1164: bets 669
ImCrazyFish has timed out
ImCrazyFish: folds 
ImCrazyFish is sitting out
Uncalled bet (669) returned to Efumchik1164
Efumchik1164 collected 669 from pot
*** SUMMARY ***
Total pot 669 | Rake 0 
Board [4c Td 5h]
Seat 1: MrFerns6 folded before Flop (didn't bet)
Seat 2: BLNDIK folded before Flop (didn't bet)
Seat 3: maciel1986 folded before Flop (didn't bet)
Seat 4: jcarlos.vale (button) folded before Flop (didn't bet)
Seat 5: ImCrazyFish (small blind) folded on the Flop
Seat 6: fern46 (big blind) folded before Flop
Seat 7: Efumchik1164 collected (669)
Seat 8: BMW 812 folded before Flop (didn't bet)
Seat 9: cyeav22 folded before Flop (didn't bet)



PokerStars Hand #221584559172: Tournament #3074230175, $0.98+$0.12 USD Hold'em No Limit - Level IV (30/60) - 2020/12/18 23:14:26 EET [2020/12/18 16:14:26 ET]
Table '3074230175 55' 9-max Seat #5 is the button
Seat 1: MrFerns6 (1874 in chips) 
Seat 2: BLNDIK (4255 in chips) 
Seat 3: maciel1986 (2352 in chips) 
Seat 4: jcarlos.vale (2592 in chips) 
Seat 5: ImCrazyFish (2143 in chips) is sitting out
Seat 6: fern46 (2101 in chips) 
Seat 7: Efumchik1164 (10578 in chips) 
Seat 8: BMW 812 (3333 in chips) 
Seat 9: cyeav22 (3245 in chips) 
MrFerns6: posts the ante 7
BLNDIK: posts the ante 7
maciel1986: posts the ante 7
jcarlos.vale: posts the ante 7
ImCrazyFish: posts the ante 7
fern46: posts the ante 7
Efumchik1164: posts the ante 7
BMW 812: posts the ante 7
cyeav22: posts the ante 7
fern46: posts small blind 30
Efumchik1164: posts big blind 60
*** HOLE CARDS ***
Dealt to jcarlos.vale [8d As]
BMW 812: folds 
cyeav22: folds 
MrFerns6: folds 
BLNDIK: folds 
maciel1986: folds 
jcarlos.vale: raises 96 to 156
ImCrazyFish: folds 
fern46: folds 
Efumchik1164: folds 
Uncalled bet (96) returned to jcarlos.vale
jcarlos.vale collected 213 from pot
jcarlos.vale: doesn't show handDTO
*** SUMMARY ***
Total pot 213 | Rake 0 
Seat 1: MrFerns6 folded before Flop (didn't bet)
Seat 2: BLNDIK folded before Flop (didn't bet)
Seat 3: maciel1986 folded before Flop (didn't bet)
Seat 4: jcarlos.vale collected (213)
Seat 5: ImCrazyFish (button) folded before Flop (didn't bet)
Seat 6: fern46 (small blind) folded before Flop
Seat 7: Efumchik1164 (big blind) folded before Flop
Seat 8: BMW 812 folded before Flop (didn't bet)
Seat 9: cyeav22 folded before Flop (didn't bet)



PokerStars Hand #221584575160: Tournament #3074230175, $0.98+$0.12 USD Hold'em No Limit - Level IV (30/60) - 2020/12/18 23:14:48 EET [2020/12/18 16:14:48 ET]
Table '3074230175 55' 9-max Seat #6 is the button
Seat 1: MrFerns6 (1867 in chips) 
Seat 2: BLNDIK (4248 in chips) 
Seat 3: maciel1986 (2345 in chips) 
Seat 4: jcarlos.vale (2738 in chips) 
Seat 5: ImCrazyFish (2136 in chips) is sitting out
Seat 6: fern46 (2064 in chips) 
Seat 7: Efumchik1164 (10511 in chips) 
Seat 8: BMW 812 (3326 in chips) 
Seat 9: cyeav22 (3238 in chips) 
MrFerns6: posts the ante 7
BLNDIK: posts the ante 7
maciel1986: posts the ante 7
jcarlos.vale: posts the ante 7
ImCrazyFish: posts the ante 7
fern46: posts the ante 7
Efumchik1164: posts the ante 7
BMW 812: posts the ante 7
cyeav22: posts the ante 7
Efumchik1164: posts small blind 30
BMW 812: posts big blind 60
*** HOLE CARDS ***
Dealt to jcarlos.vale [Qs 9c]
cyeav22: folds 
MrFerns6: folds 
BLNDIK: calls 60
maciel1986: calls 60
jcarlos.vale: folds 
ImCrazyFish: folds 
fern46: folds 
Efumchik1164: raises 120 to 180
BMW 812: calls 120
BLNDIK: calls 120
maciel1986: calls 120
*** FLOP *** [Ts Jd Td]
Efumchik1164: bets 783
BMW 812: folds 
BLNDIK: folds 
maciel1986: folds 
Uncalled bet (783) returned to Efumchik1164
Efumchik1164 collected 783 from pot
*** SUMMARY ***
Total pot 783 | Rake 0 
Board [Ts Jd Td]
Seat 1: MrFerns6 folded before Flop (didn't bet)
Seat 2: BLNDIK folded on the Flop
Seat 3: maciel1986 folded on the Flop
Seat 4: jcarlos.vale folded before Flop (didn't bet)
Seat 5: ImCrazyFish folded before Flop (didn't bet)
Seat 6: fern46 (button) folded before Flop (didn't bet)
Seat 7: Efumchik1164 (small blind) collected (783)
Seat 8: BMW 812 (big blind) folded on the Flop
Seat 9: cyeav22 folded before Flop (didn't bet)



PokerStars Hand #221584639248: Tournament #3074230175, $0.98+$0.12 USD Hold'em No Limit - Level IV (30/60) - 2020/12/18 23:16:14 EET [2020/12/18 16:16:14 ET]
Table '3074230175 55' 9-max Seat #7 is the button
Seat 1: MrFerns6 (1860 in chips) 
Seat 2: BLNDIK (4061 in chips) 
Seat 3: maciel1986 (2158 in chips) 
Seat 4: jcarlos.vale (2731 in chips) 
Seat 5: ImCrazyFish (2129 in chips) is sitting out
Seat 6: fern46 (2057 in chips) 
Seat 7: Efumchik1164 (11107 in chips) 
Seat 8: BMW 812 (3139 in chips) 
Seat 9: cyeav22 (3231 in chips) 
MrFerns6: posts the ante 7
BLNDIK: posts the ante 7
maciel1986: posts the ante 7
jcarlos.vale: posts the ante 7
ImCrazyFish: posts the ante 7
fern46: posts the ante 7
Efumchik1164: posts the ante 7
BMW 812: posts the ante 7
cyeav22: posts the ante 7
BMW 812: posts small blind 30
cyeav22: posts big blind 60
*** HOLE CARDS ***
Dealt to jcarlos.vale [8h 4c]
MrFerns6: folds 
BLNDIK: folds 
maciel1986: raises 72 to 132
jcarlos.vale: folds 
ImCrazyFish: folds 
fern46: folds 
Efumchik1164: folds 
BMW 812: calls 102
cyeav22: calls 72
*** FLOP *** [Th 9s 2h]
BMW 812: checks 
cyeav22: checks 
maciel1986: bets 151
BMW 812: folds 
cyeav22: folds 
Uncalled bet (151) returned to maciel1986
maciel1986 collected 459 from pot
maciel1986: doesn't show handDTO
*** SUMMARY ***
Total pot 459 | Rake 0 
Board [Th 9s 2h]
Seat 1: MrFerns6 folded before Flop (didn't bet)
Seat 2: BLNDIK folded before Flop (didn't bet)
Seat 3: maciel1986 collected (459)
Seat 4: jcarlos.vale folded before Flop (didn't bet)
Seat 5: ImCrazyFish folded before Flop (didn't bet)
Seat 6: fern46 folded before Flop (didn't bet)
Seat 7: Efumchik1164 (button) folded before Flop (didn't bet)
Seat 8: BMW 812 (small blind) folded on the Flop
Seat 9: cyeav22 (big blind) folded on the Flop



PokerStars Hand #221584696996: Tournament #3074230175, $0.98+$0.12 USD Hold'em No Limit - Level V (40/80) - 2020/12/18 23:17:31 EET [2020/12/18 16:17:31 ET]
Table '3074230175 55' 9-max Seat #8 is the button
Seat 1: MrFerns6 (1853 in chips) 
Seat 2: BLNDIK (4054 in chips) 
Seat 3: maciel1986 (2478 in chips) 
Seat 4: jcarlos.vale (2724 in chips) 
Seat 5: ImCrazyFish (2122 in chips) is sitting out
Seat 6: fern46 (2050 in chips) 
Seat 7: Efumchik1164 (11100 in chips) 
Seat 8: BMW 812 (3000 in chips) 
Seat 9: cyeav22 (3092 in chips) 
MrFerns6: posts the ante 10
BLNDIK: posts the ante 10
maciel1986: posts the ante 10
jcarlos.vale: posts the ante 10
ImCrazyFish: posts the ante 10
fern46: posts the ante 10
Efumchik1164: posts the ante 10
BMW 812: posts the ante 10
cyeav22: posts the ante 10
cyeav22: posts small blind 40
MrFerns6: posts big blind 80
*** HOLE CARDS ***
Dealt to jcarlos.vale [6h 4s]
BLNDIK: folds 
maciel1986: raises 80 to 160
jcarlos.vale: folds 
ImCrazyFish: folds 
fern46: folds 
Efumchik1164: calls 160
BMW 812: calls 160
cyeav22: folds 
MrFerns6: calls 80
*** FLOP *** [Tc Ac 8c]
MrFerns6: checks 
maciel1986: checks 
Efumchik1164: checks 
BMW 812: checks 
*** TURN *** [Tc Ac 8c] [8h]
MrFerns6: checks 
maciel1986: checks 
Efumchik1164: bets 385
BMW 812: folds 
MrFerns6: folds 
maciel1986: folds 
Uncalled bet (385) returned to Efumchik1164
Efumchik1164 collected 770 from pot
*** SUMMARY ***
Total pot 770 | Rake 0 
Board [Tc Ac 8c 8h]
Seat 1: MrFerns6 (big blind) folded on the Turn
Seat 2: BLNDIK folded before Flop (didn't bet)
Seat 3: maciel1986 folded on the Turn
Seat 4: jcarlos.vale folded before Flop (didn't bet)
Seat 5: ImCrazyFish folded before Flop (didn't bet)
Seat 6: fern46 folded before Flop (didn't bet)
Seat 7: Efumchik1164 collected (770)
Seat 8: BMW 812 (button) folded on the Turn
Seat 9: cyeav22 (small blind) folded before Flop



PokerStars Hand #221584767157: Tournament #3074230175, $0.98+$0.12 USD Hold'em No Limit - Level V (40/80) - 2020/12/18 23:19:03 EET [2020/12/18 16:19:03 ET]
Table '3074230175 55' 9-max Seat #9 is the button
Seat 1: MrFerns6 (1683 in chips) 
Seat 2: BLNDIK (4044 in chips) 
Seat 3: maciel1986 (2308 in chips) 
Seat 4: jcarlos.vale (2714 in chips) 
Seat 5: ImCrazyFish (2112 in chips) is sitting out
Seat 6: fern46 (2040 in chips) 
Seat 7: Efumchik1164 (11700 in chips) 
Seat 8: BMW 812 (2830 in chips) 
Seat 9: cyeav22 (3042 in chips) 
MrFerns6: posts the ante 10
BLNDIK: posts the ante 10
maciel1986: posts the ante 10
jcarlos.vale: posts the ante 10
ImCrazyFish: posts the ante 10
fern46: posts the ante 10
Efumchik1164: posts the ante 10
BMW 812: posts the ante 10
cyeav22: posts the ante 10
MrFerns6: posts small blind 40
BLNDIK: posts big blind 80
*** HOLE CARDS ***
Dealt to jcarlos.vale [4s 5s]
maciel1986: folds 
jcarlos.vale: folds 
ImCrazyFish: folds 
fern46: folds 
Efumchik1164: folds 
BMW 812: raises 160 to 240
cyeav22: folds 
MrFerns6: calls 200
BLNDIK: folds 
*** FLOP *** [8c 4c 7c]
MrFerns6: checks 
BMW 812: bets 650
MrFerns6: folds 
Uncalled bet (650) returned to BMW 812
BMW 812 collected 650 from pot
BMW 812: doesn't show handDTO
*** SUMMARY ***
Total pot 650 | Rake 0 
Board [8c 4c 7c]
Seat 1: MrFerns6 (small blind) folded on the Flop
Seat 2: BLNDIK (big blind) folded before Flop
Seat 3: maciel1986 folded before Flop (didn't bet)
Seat 4: jcarlos.vale folded before Flop (didn't bet)
Seat 5: ImCrazyFish folded before Flop (didn't bet)
Seat 6: fern46 folded before Flop (didn't bet)
Seat 7: Efumchik1164 folded before Flop (didn't bet)
Seat 8: BMW 812 collected (650)
Seat 9: cyeav22 (button) folded before Flop (didn't bet)



PokerStars Hand #221584820369: Tournament #3074230175, $0.98+$0.12 USD Hold'em No Limit - Level V (40/80) - 2020/12/18 23:20:14 EET [2020/12/18 16:20:14 ET]
Table '3074230175 55' 9-max Seat #1 is the button
Seat 1: MrFerns6 (1433 in chips) 
Seat 2: BLNDIK (3954 in chips) 
Seat 3: maciel1986 (2298 in chips) 
Seat 4: jcarlos.vale (2704 in chips) 
Seat 5: ImCrazyFish (2102 in chips) is sitting out
Seat 6: fern46 (2030 in chips) 
Seat 7: Efumchik1164 (11690 in chips) 
Seat 8: BMW 812 (3230 in chips) 
Seat 9: cyeav22 (3032 in chips) 
MrFerns6: posts the ante 10
BLNDIK: posts the ante 10
maciel1986: posts the ante 10
jcarlos.vale: posts the ante 10
ImCrazyFish: posts the ante 10
fern46: posts the ante 10
Efumchik1164: posts the ante 10
BMW 812: posts the ante 10
cyeav22: posts the ante 10
BLNDIK: posts small blind 40
maciel1986: posts big blind 80
*** HOLE CARDS ***
Dealt to jcarlos.vale [4c 3s]
jcarlos.vale: folds 
ImCrazyFish: folds 
fern46: folds 
Efumchik1164 has timed out
Efumchik1164: folds 
Efumchik1164 is sitting out
BMW 812: raises 160 to 240
cyeav22: folds 
MrFerns6: folds 
BLNDIK: folds 
maciel1986: folds 
Uncalled bet (160) returned to BMW 812
BMW 812 collected 290 from pot
BMW 812: doesn't show handDTO
*** SUMMARY ***
Total pot 290 | Rake 0 
Seat 1: MrFerns6 (button) folded before Flop (didn't bet)
Seat 2: BLNDIK (small blind) folded before Flop
Seat 3: maciel1986 (big blind) folded before Flop
Seat 4: jcarlos.vale folded before Flop (didn't bet)
Seat 5: ImCrazyFish folded before Flop (didn't bet)
Seat 6: fern46 folded before Flop (didn't bet)
Seat 7: Efumchik1164 folded before Flop (didn't bet)
Seat 8: BMW 812 collected (290)
Seat 9: cyeav22 folded before Flop (didn't bet)



PokerStars Hand #221584870215: Tournament #3074230175, $0.98+$0.12 USD Hold'em No Limit - Level V (40/80) - 2020/12/18 23:21:20 EET [2020/12/18 16:21:20 ET]
Table '3074230175 55' 9-max Seat #2 is the button
Seat 1: MrFerns6 (1423 in chips) 
Seat 2: BLNDIK (3904 in chips) 
Seat 3: maciel1986 (2208 in chips) 
Seat 4: jcarlos.vale (2694 in chips) 
Seat 5: ImCrazyFish (2092 in chips) is sitting out
Seat 6: fern46 (2020 in chips) 
Seat 7: Efumchik1164 (11680 in chips) is sitting out
Seat 8: BMW 812 (3430 in chips) 
Seat 9: cyeav22 (3022 in chips) 
MrFerns6: posts the ante 10
BLNDIK: posts the ante 10
maciel1986: posts the ante 10
jcarlos.vale: posts the ante 10
ImCrazyFish: posts the ante 10
fern46: posts the ante 10
Efumchik1164: posts the ante 10
BMW 812: posts the ante 10
cyeav22: posts the ante 10
maciel1986: posts small blind 40
jcarlos.vale: posts big blind 80
*** HOLE CARDS ***
Dealt to jcarlos.vale [9h Jh]
ImCrazyFish: folds 
fern46: calls 80
Efumchik1164: folds 
BMW 812: calls 80
cyeav22: folds 
Efumchik1164 has returned
MrFerns6: raises 1333 to 1413 and is all-in
BLNDIK: calls 1413
maciel1986: folds 
jcarlos.vale: folds 
fern46: folds 
BMW 812: folds 
*** FLOP *** [Ks 2c Jd]
*** TURN *** [Ks 2c Jd] [5s]
*** RIVER *** [Ks 2c Jd 5s] [9d]
*** SHOW DOWN ***
MrFerns6: shows [Jc Ac] (a pair of Jacks)
BLNDIK: shows [Kh Qd] (a pair of Kings)
BLNDIK collected 3196 from pot
MrFerns6 finished the tournament
*** SUMMARY ***
Total pot 3196 | Rake 0 
Board [Ks 2c Jd 5s 9d]
Seat 1: MrFerns6 showed [Jc Ac] and lost with a pair of Jacks
Seat 2: BLNDIK (button) showed [Kh Qd] and won (3196) with a pair of Kings
Seat 3: maciel1986 (small blind) folded before Flop
Seat 4: jcarlos.vale (big blind) folded before Flop
Seat 5: ImCrazyFish folded before Flop (didn't bet)
Seat 6: fern46 folded before Flop
Seat 7: Efumchik1164 folded before Flop (didn't bet)
Seat 8: BMW 812 folded before Flop
Seat 9: cyeav22 folded before Flop (didn't bet)



PokerStars Hand #221584896340: Tournament #3074230175, $0.98+$0.12 USD Hold'em No Limit - Level V (40/80) - 2020/12/18 23:21:55 EET [2020/12/18 16:21:55 ET]
Table '3074230175 55' 9-max Seat #3 is the button
Seat 2: BLNDIK (5677 in chips) 
Seat 3: maciel1986 (2158 in chips) 
Seat 4: jcarlos.vale (2604 in chips) 
Seat 5: ImCrazyFish (2082 in chips) is sitting out
Seat 6: fern46 (1930 in chips) 
Seat 7: Efumchik1164 (11670 in chips) 
Seat 8: BMW 812 (3340 in chips) 
Seat 9: cyeav22 (3012 in chips) 
BLNDIK: posts the ante 10
maciel1986: posts the ante 10
jcarlos.vale: posts the ante 10
ImCrazyFish: posts the ante 10
fern46: posts the ante 10
Efumchik1164: posts the ante 10
BMW 812: posts the ante 10
cyeav22: posts the ante 10
jcarlos.vale: posts small blind 40
ImCrazyFish: posts big blind 80
*** HOLE CARDS ***
Dealt to jcarlos.vale [7h Ac]
fern46: folds 
Efumchik1164: raises 160 to 240
BMW 812: folds 
cyeav22: folds 
BLNDIK: folds 
maciel1986: folds 
jcarlos.vale: folds 
ImCrazyFish: folds 
Uncalled bet (160) returned to Efumchik1164
Efumchik1164 collected 280 from pot
*** SUMMARY ***
Total pot 280 | Rake 0 
Seat 2: BLNDIK folded before Flop (didn't bet)
Seat 3: maciel1986 (button) folded before Flop (didn't bet)
Seat 4: jcarlos.vale (small blind) folded before Flop
Seat 5: ImCrazyFish (big blind) folded before Flop
Seat 6: fern46 folded before Flop (didn't bet)
Seat 7: Efumchik1164 collected (280)
Seat 8: BMW 812 folded before Flop (didn't bet)
Seat 9: cyeav22 folded before Flop (didn't bet)



PokerStars Hand #221584916008: Tournament #3074230175, $0.98+$0.12 USD Hold'em No Limit - Level V (40/80) - 2020/12/18 23:22:22 EET [2020/12/18 16:22:22 ET]
Table '3074230175 55' 9-max Seat #4 is the button
Seat 2: BLNDIK (5667 in chips) 
Seat 3: maciel1986 (2148 in chips) 
Seat 4: jcarlos.vale (2554 in chips) 
Seat 5: ImCrazyFish (1992 in chips) is sitting out
Seat 6: fern46 (1920 in chips) 
Seat 7: Efumchik1164 (11860 in chips) 
Seat 8: BMW 812 (3330 in chips) 
Seat 9: cyeav22 (3002 in chips) 
BLNDIK: posts the ante 10
maciel1986: posts the ante 10
jcarlos.vale: posts the ante 10
ImCrazyFish: posts the ante 10
fern46: posts the ante 10
Efumchik1164: posts the ante 10
BMW 812: posts the ante 10
cyeav22: posts the ante 10
ImCrazyFish: posts small blind 40
fern46: posts big blind 80
*** HOLE CARDS ***
Dealt to jcarlos.vale [3s 6c]
Efumchik1164: raises 11770 to 11850 and is all-in
BMW 812: folds 
cyeav22: folds 
BLNDIK: folds 
maciel1986: folds 
jcarlos.vale: folds 
ImCrazyFish: folds 
fern46: folds 
Uncalled bet (11770) returned to Efumchik1164
Efumchik1164 collected 280 from pot
*** SUMMARY ***
Total pot 280 | Rake 0 
Seat 2: BLNDIK folded before Flop (didn't bet)
Seat 3: maciel1986 folded before Flop (didn't bet)
Seat 4: jcarlos.vale (button) folded before Flop (didn't bet)
Seat 5: ImCrazyFish (small blind) folded before Flop
Seat 6: fern46 (big blind) folded before Flop
Seat 7: Efumchik1164 collected (280)
Seat 8: BMW 812 folded before Flop (didn't bet)
Seat 9: cyeav22 folded before Flop (didn't bet)



PokerStars Hand #221584934329: Tournament #3074230175, $0.98+$0.12 USD Hold'em No Limit - Level V (40/80) - 2020/12/18 23:22:46 EET [2020/12/18 16:22:46 ET]
Table '3074230175 55' 9-max Seat #5 is the button
Seat 2: BLNDIK (5657 in chips) 
Seat 3: maciel1986 (2138 in chips) 
Seat 4: jcarlos.vale (2544 in chips) 
Seat 5: ImCrazyFish (1942 in chips) is sitting out
Seat 6: fern46 (1830 in chips) 
Seat 7: Efumchik1164 (12050 in chips) 
Seat 8: BMW 812 (3320 in chips) 
Seat 9: cyeav22 (2992 in chips) 
BLNDIK: posts the ante 10
maciel1986: posts the ante 10
jcarlos.vale: posts the ante 10
ImCrazyFish: posts the ante 10
fern46: posts the ante 10
Efumchik1164: posts the ante 10
BMW 812: posts the ante 10
cyeav22: posts the ante 10
fern46: posts small blind 40
Efumchik1164: posts big blind 80
*** HOLE CARDS ***
Dealt to jcarlos.vale [2h 2d]
BMW 812: raises 80 to 160
cyeav22: calls 160
BLNDIK: calls 160
maciel1986: folds 
jcarlos.vale: folds 
ImCrazyFish: folds 
fern46: folds 
Efumchik1164: raises 80 to 240
BMW 812: raises 920 to 1160
cyeav22: folds 
BLNDIK: folds 
Efumchik1164: raises 920 to 2080
BMW 812: calls 920
*** FLOP *** [5h 3d 4d]
Efumchik1164: bets 2300
BMW 812: calls 1230 and is all-in
Uncalled bet (1070) returned to Efumchik1164
*** TURN *** [5h 3d 4d] [5d]
*** RIVER *** [5h 3d 4d 5d] [8c]
*** SHOW DOWN ***
Efumchik1164: shows [Jc 7c] (a pair of Fives)
BMW 812: shows [Ac Jh] (a pair of Fives - Ace kicker)
BMW 812 collected 7060 from pot
*** SUMMARY ***
Total pot 7060 | Rake 0 
Board [5h 3d 4d 5d 8c]
Seat 2: BLNDIK folded before Flop
Seat 3: maciel1986 folded before Flop (didn't bet)
Seat 4: jcarlos.vale folded before Flop (didn't bet)
Seat 5: ImCrazyFish (button) folded before Flop (didn't bet)
Seat 6: fern46 (small blind) folded before Flop
Seat 7: Efumchik1164 (big blind) showed [Jc 7c] and lost with a pair of Fives
Seat 8: BMW 812 showed [Ac Jh] and won (7060) with a pair of Fives
Seat 9: cyeav22 folded before Flop



PokerStars Hand #221584974286: Tournament #3074230175, $0.98+$0.12 USD Hold'em No Limit - Level V (40/80) - 2020/12/18 23:23:39 EET [2020/12/18 16:23:39 ET]
Table '3074230175 55' 9-max Seat #6 is the button
Seat 1: guiterman (3000 in chips) 
Seat 2: BLNDIK (5487 in chips) 
Seat 3: maciel1986 (2128 in chips) 
Seat 4: jcarlos.vale (2534 in chips) 
Seat 5: ImCrazyFish (1932 in chips) is sitting out
Seat 6: fern46 (1780 in chips) 
Seat 7: Efumchik1164 (8730 in chips) 
Seat 8: BMW 812 (7060 in chips) 
Seat 9: cyeav22 (2822 in chips) 
guiterman: posts the ante 10
BLNDIK: posts the ante 10
maciel1986: posts the ante 10
jcarlos.vale: posts the ante 10
ImCrazyFish: posts the ante 10
fern46: posts the ante 10
Efumchik1164: posts the ante 10
BMW 812: posts the ante 10
cyeav22: posts the ante 10
Efumchik1164: posts small blind 40
BMW 812: posts big blind 80
*** HOLE CARDS ***
Dealt to jcarlos.vale [Kh Ad]
cyeav22: folds 
guiterman: calls 80
BLNDIK: folds 
maciel1986: folds 
jcarlos.vale: raises 128 to 208
ImCrazyFish: folds 
fern46: folds 
Efumchik1164: raises 128 to 336
BMW 812: calls 256
guiterman: folds 
jcarlos.vale: raises 2188 to 2524 and is all-in
Efumchik1164: calls 2188
BMW 812: folds 
*** FLOP *** [Ah 7c Ts]
*** TURN *** [Ah 7c Ts] [8s]
*** RIVER *** [Ah 7c Ts 8s] [3h]
*** SHOW DOWN ***
Efumchik1164: shows [4d 5s] (high pairOfCards Ace)
jcarlos.vale: shows [Kh Ad] (a pair of Aces)
jcarlos.vale collected 5554 from pot
*** SUMMARY ***
Total pot 5554 | Rake 0 
Board [Ah 7c Ts 8s 3h]
Seat 1: guiterman folded before Flop
Seat 2: BLNDIK folded before Flop (didn't bet)
Seat 3: maciel1986 folded before Flop (didn't bet)
Seat 4: jcarlos.vale showed [Kh Ad] and won (5554) with a pair of Aces
Seat 5: ImCrazyFish folded before Flop (didn't bet)
Seat 6: fern46 (button) folded before Flop (didn't bet)
Seat 7: Efumchik1164 (small blind) showed [4d 5s] and lost with high pairOfCards Ace
Seat 8: BMW 812 (big blind) folded before Flop
Seat 9: cyeav22 folded before Flop (didn't bet)



PokerStars Hand #221585015439: Tournament #3074230175, $0.98+$0.12 USD Hold'em No Limit - Level V (40/80) - 2020/12/18 23:24:33 EET [2020/12/18 16:24:33 ET]
Table '3074230175 55' 9-max Seat #7 is the button
Seat 1: guiterman (2910 in chips) 
Seat 3: maciel1986 (2118 in chips) 
Seat 4: jcarlos.vale (5554 in chips) 
Seat 5: ImCrazyFish (1922 in chips) is sitting out
Seat 6: fern46 (1770 in chips) 
Seat 7: Efumchik1164 (6196 in chips) 
Seat 8: BMW 812 (6714 in chips) 
Seat 9: cyeav22 (2812 in chips) 
guiterman: posts the ante 10
maciel1986: posts the ante 10
jcarlos.vale: posts the ante 10
ImCrazyFish: posts the ante 10
fern46: posts the ante 10
Efumchik1164: posts the ante 10
BMW 812: posts the ante 10
cyeav22: posts the ante 10
BMW 812: posts small blind 40
cyeav22: posts big blind 80
*** HOLE CARDS ***
Dealt to jcarlos.vale [5s 8d]
guiterman: calls 80
maciel1986: folds 
jcarlos.vale: folds 
ImCrazyFish: folds 
fern46: calls 80
Efumchik1164: calls 80
BMW 812: calls 40
cyeav22: checks 
*** FLOP *** [2d 6d 8s]
BMW 812: checks 
cyeav22: checks 
guiterman: checks 
fern46: checks 
Efumchik1164: bets 6106 and is all-in
BMW 812: folds 
cyeav22: folds 
guiterman: folds 
fern46: folds 
Uncalled bet (6106) returned to Efumchik1164
Efumchik1164 collected 480 from pot
*** SUMMARY ***
Total pot 480 | Rake 0 
Board [2d 6d 8s]
Seat 1: guiterman folded on the Flop
Seat 3: maciel1986 folded before Flop (didn't bet)
Seat 4: jcarlos.vale folded before Flop (didn't bet)
Seat 5: ImCrazyFish folded before Flop (didn't bet)
Seat 6: fern46 folded on the Flop
Seat 7: Efumchik1164 (button) collected (480)
Seat 8: BMW 812 (small blind) folded on the Flop
Seat 9: cyeav22 (big blind) folded on the Flop



PokerStars Hand #221585080980: Tournament #3074230175, $0.98+$0.12 USD Hold'em No Limit - Level V (40/80) - 2020/12/18 23:26:00 EET [2020/12/18 16:26:00 ET]
Table '3074230175 55' 9-max Seat #8 is the button
Seat 1: guiterman (2820 in chips) 
Seat 2: chaoukidiv10 (3000 in chips) 
Seat 3: maciel1986 (2108 in chips) 
Seat 4: jcarlos.vale (5544 in chips) 
Seat 5: ImCrazyFish (1912 in chips) is sitting out
Seat 6: fern46 (1680 in chips) 
Seat 7: Efumchik1164 (6586 in chips) 
Seat 8: BMW 812 (6624 in chips) 
Seat 9: cyeav22 (2722 in chips) 
guiterman: posts the ante 10
chaoukidiv10: posts the ante 10
maciel1986: posts the ante 10
jcarlos.vale: posts the ante 10
ImCrazyFish: posts the ante 10
fern46: posts the ante 10
Efumchik1164: posts the ante 10
BMW 812: posts the ante 10
cyeav22: posts the ante 10
cyeav22: posts small blind 40
guiterman: posts big blind 80
*** HOLE CARDS ***
Dealt to jcarlos.vale [4s 9d]
chaoukidiv10: folds 
maciel1986: folds 
jcarlos.vale: folds 
ImCrazyFish: folds 
fern46: folds 
Efumchik1164: raises 6496 to 6576 and is all-in
BMW 812: folds 
cyeav22: folds 
guiterman: calls 2730 and is all-in
Uncalled bet (3766) returned to Efumchik1164
*** FLOP *** [Tc 9c 7s]
*** TURN *** [Tc 9c 7s] [9s]
*** RIVER *** [Tc 9c 7s 9s] [Td]
*** SHOW DOWN ***
guiterman: shows [As Ts] (a full house, Tens full of Nines)
Efumchik1164: shows [2c 7d] (two pair, Tens and Nines)
guiterman collected 5750 from pot
*** SUMMARY ***
Total pot 5750 | Rake 0 
Board [Tc 9c 7s 9s Td]
Seat 1: guiterman (big blind) showed [As Ts] and won (5750) with a full house, Tens full of Nines
Seat 2: chaoukidiv10 folded before Flop (didn't bet)
Seat 3: maciel1986 folded before Flop (didn't bet)
Seat 4: jcarlos.vale folded before Flop (didn't bet)
Seat 5: ImCrazyFish folded before Flop (didn't bet)
Seat 6: fern46 folded before Flop (didn't bet)
Seat 7: Efumchik1164 showed [2c 7d] and lost with two pair, Tens and Nines
Seat 8: BMW 812 (button) folded before Flop (didn't bet)
Seat 9: cyeav22 (small blind) folded before Flop



PokerStars Hand #221585106727: Tournament #3074230175, $0.98+$0.12 USD Hold'em No Limit - Level V (40/80) - 2020/12/18 23:26:34 EET [2020/12/18 16:26:34 ET]
Table '3074230175 55' 9-max Seat #9 is the button
Seat 1: guiterman (5750 in chips) 
Seat 2: chaoukidiv10 (2990 in chips) 
Seat 3: maciel1986 (2098 in chips) 
Seat 4: jcarlos.vale (5534 in chips) 
Seat 5: ImCrazyFish (1902 in chips) is sitting out
Seat 6: fern46 (1670 in chips) 
Seat 7: Efumchik1164 (3766 in chips) 
Seat 8: BMW 812 (6614 in chips) 
Seat 9: cyeav22 (2672 in chips) 
guiterman: posts the ante 10
chaoukidiv10: posts the ante 10
maciel1986: posts the ante 10
jcarlos.vale: posts the ante 10
ImCrazyFish: posts the ante 10
fern46: posts the ante 10
Efumchik1164: posts the ante 10
BMW 812: posts the ante 10
cyeav22: posts the ante 10
guiterman: posts small blind 40
chaoukidiv10: posts big blind 80
*** HOLE CARDS ***
Dealt to jcarlos.vale [3s Qd]
maciel1986: folds 
jcarlos.vale: folds 
ImCrazyFish: folds 
fern46: folds 
Efumchik1164: raises 3676 to 3756 and is all-in
BMW 812: raises 2848 to 6604 and is all-in
cyeav22: folds 
guiterman: folds 
chaoukidiv10: folds 
Uncalled bet (2848) returned to BMW 812
*** FLOP *** [6s Tc Ad]
*** TURN *** [6s Tc Ad] [Qh]
*** RIVER *** [6s Tc Ad Qh] [Qc]
*** SHOW DOWN ***
Efumchik1164: shows [5h 7h] (a pair of Queens)
BMW 812: shows [Ah 5c] (two pair, Aces and Queens)
BMW 812 collected 7722 from pot
Efumchik1164 finished the tournament
*** SUMMARY ***
Total pot 7722 | Rake 0 
Board [6s Tc Ad Qh Qc]
Seat 1: guiterman (small blind) folded before Flop
Seat 2: chaoukidiv10 (big blind) folded before Flop
Seat 3: maciel1986 folded before Flop (didn't bet)
Seat 4: jcarlos.vale folded before Flop (didn't bet)
Seat 5: ImCrazyFish folded before Flop (didn't bet)
Seat 6: fern46 folded before Flop (didn't bet)
Seat 7: Efumchik1164 showed [5h 7h] and lost with a pair of Queens
Seat 8: BMW 812 showed [Ah 5c] and won (7722) with two pair, Aces and Queens
Seat 9: cyeav22 (button) folded before Flop (didn't bet)



PokerStars Hand #221585137408: Tournament #3074230175, $0.98+$0.12 USD Hold'em No Limit - Level VI (50/100) - 2020/12/18 23:27:15 EET [2020/12/18 16:27:15 ET]
Table '3074230175 55' 9-max Seat #1 is the button
Seat 1: guiterman (5700 in chips) 
Seat 2: chaoukidiv10 (2900 in chips) 
Seat 3: maciel1986 (2088 in chips) 
Seat 4: jcarlos.vale (5524 in chips) 
Seat 5: ImCrazyFish (1892 in chips) is sitting out
Seat 6: fern46 (1660 in chips) 
Seat 8: BMW 812 (10570 in chips) 
Seat 9: cyeav22 (2662 in chips) 
guiterman: posts the ante 12
chaoukidiv10: posts the ante 12
maciel1986: posts the ante 12
jcarlos.vale: posts the ante 12
ImCrazyFish: posts the ante 12
fern46: posts the ante 12
BMW 812: posts the ante 12
cyeav22: posts the ante 12
chaoukidiv10: posts small blind 50
maciel1986: posts big blind 100
*** HOLE CARDS ***
Dealt to jcarlos.vale [9s 6d]
jcarlos.vale: folds 
ImCrazyFish: folds 
fern46: folds 
BMW 812: folds 
cyeav22: folds 
guiterman: folds 
chaoukidiv10: calls 50
maciel1986: checks 
*** FLOP *** [4d Td Ac]
chaoukidiv10: bets 100
maciel1986: folds 
Uncalled bet (100) returned to chaoukidiv10
chaoukidiv10 collected 296 from pot
chaoukidiv10: doesn't show handDTO
*** SUMMARY ***
Total pot 296 | Rake 0 
Board [4d Td Ac]
Seat 1: guiterman (button) folded before Flop (didn't bet)
Seat 2: chaoukidiv10 (small blind) collected (296)
Seat 3: maciel1986 (big blind) folded on the Flop
Seat 4: jcarlos.vale folded before Flop (didn't bet)
Seat 5: ImCrazyFish folded before Flop (didn't bet)
Seat 6: fern46 folded before Flop (didn't bet)
Seat 8: BMW 812 folded before Flop (didn't bet)
Seat 9: cyeav22 folded before Flop (didn't bet)



PokerStars Hand #221585171434: Tournament #3074230175, $0.98+$0.12 USD Hold'em No Limit - Level VI (50/100) - 2020/12/18 23:28:00 EET [2020/12/18 16:28:00 ET]
Table '3074230175 55' 9-max Seat #2 is the button
Seat 1: guiterman (5688 in chips) 
Seat 2: chaoukidiv10 (3084 in chips) 
Seat 3: maciel1986 (1976 in chips) 
Seat 4: jcarlos.vale (5512 in chips) 
Seat 5: ImCrazyFish (1880 in chips) is sitting out
Seat 6: fern46 (1648 in chips) 
Seat 7: Jeppekanin14 (3000 in chips) 
Seat 8: BMW 812 (10558 in chips) 
Seat 9: cyeav22 (2650 in chips) 
guiterman: posts the ante 12
chaoukidiv10: posts the ante 12
maciel1986: posts the ante 12
jcarlos.vale: posts the ante 12
ImCrazyFish: posts the ante 12
fern46: posts the ante 12
Jeppekanin14: posts the ante 12
BMW 812: posts the ante 12
cyeav22: posts the ante 12
maciel1986: posts small blind 50
jcarlos.vale: posts big blind 100
*** HOLE CARDS ***
Dealt to jcarlos.vale [Qd 7h]
ImCrazyFish: folds 
fern46: folds 
Jeppekanin14: folds 
BMW 812: raises 100 to 200
cyeav22: folds 
guiterman: calls 200
chaoukidiv10: calls 200
maciel1986: folds 
jcarlos.vale has timed out
jcarlos.vale: folds 
jcarlos.vale is sitting out
*** FLOP *** [3h 4s 4c]
jcarlos.vale has returned
BMW 812: checks 
guiterman: bets 200
chaoukidiv10: calls 200
BMW 812: calls 200
*** TURN *** [3h 4s 4c] [5c]
BMW 812: checks 
guiterman: bets 200
chaoukidiv10: calls 200
BMW 812: calls 200
*** RIVER *** [3h 4s 4c 5c] [Tc]
BMW 812: checks 
guiterman: checks 
chaoukidiv10: checks 
*** SHOW DOWN ***
BMW 812: shows [Ac 4d] (three of a kind, Fours)
guiterman: mucks handDTO
chaoukidiv10: mucks handDTO
BMW 812 collected 2058 from pot
*** SUMMARY ***
Total pot 2058 | Rake 0 
Board [3h 4s 4c 5c Tc]
Seat 1: guiterman mucked [8c 8h]
Seat 2: chaoukidiv10 (button) mucked [9h 7c]
Seat 3: maciel1986 (small blind) folded before Flop
Seat 4: jcarlos.vale (big blind) folded before Flop
Seat 5: ImCrazyFish folded before Flop (didn't bet)
Seat 6: fern46 folded before Flop (didn't bet)
Seat 7: Jeppekanin14 folded before Flop (didn't bet)
Seat 8: BMW 812 showed [Ac 4d] and won (2058) with three of a kind, Fours
Seat 9: cyeav22 folded before Flop (didn't bet)



PokerStars Hand #221585259871: Tournament #3074230175, $0.98+$0.12 USD Hold'em No Limit - Level VI (50/100) - 2020/12/18 23:29:57 EET [2020/12/18 16:29:57 ET]
Table '3074230175 55' 9-max Seat #3 is the button
Seat 1: guiterman (5076 in chips) 
Seat 2: chaoukidiv10 (2472 in chips) 
Seat 3: maciel1986 (1914 in chips) 
Seat 4: jcarlos.vale (5400 in chips) 
Seat 5: ImCrazyFish (1868 in chips) is sitting out
Seat 6: fern46 (1636 in chips) 
Seat 7: Jeppekanin14 (2988 in chips) 
Seat 8: BMW 812 (12004 in chips) 
Seat 9: cyeav22 (2638 in chips) 
guiterman: posts the ante 12
chaoukidiv10: posts the ante 12
maciel1986: posts the ante 12
jcarlos.vale: posts the ante 12
ImCrazyFish: posts the ante 12
fern46: posts the ante 12
Jeppekanin14: posts the ante 12
BMW 812: posts the ante 12
cyeav22: posts the ante 12
jcarlos.vale: posts small blind 50
ImCrazyFish: posts big blind 100
*** HOLE CARDS ***
Dealt to jcarlos.vale [2h Kh]
fern46: folds 
Jeppekanin14: raises 200 to 300
BMW 812: calls 300
cyeav22: folds 
guiterman: raises 4764 to 5064 and is all-in
chaoukidiv10: calls 2460 and is all-in
maciel1986: folds 
jcarlos.vale: folds 
ImCrazyFish: folds 
Jeppekanin14: folds 
BMW 812: folds 
Uncalled bet (2604) returned to guiterman
*** FLOP *** [4c 5c 6d]
*** TURN *** [4c 5c 6d] [5h]
*** RIVER *** [4c 5c 6d 5h] [2c]
*** SHOW DOWN ***
guiterman: shows [Qd As] (a pair of Fives)
chaoukidiv10: shows [4s 5s] (a full house, Fives full of Fours)
chaoukidiv10 collected 5778 from pot
*** SUMMARY ***
Total pot 5778 | Rake 0 
Board [4c 5c 6d 5h 2c]
Seat 1: guiterman showed [Qd As] and lost with a pair of Fives
Seat 2: chaoukidiv10 showed [4s 5s] and won (5778) with a full house, Fives full of Fours
Seat 3: maciel1986 (button) folded before Flop (didn't bet)
Seat 4: jcarlos.vale (small blind) folded before Flop
Seat 5: ImCrazyFish (big blind) folded before Flop
Seat 6: fern46 folded before Flop (didn't bet)
Seat 7: Jeppekanin14 folded before Flop
Seat 8: BMW 812 folded before Flop
Seat 9: cyeav22 folded before Flop (didn't bet)



PokerStars Hand #221585286169: Tournament #3074230175, $0.98+$0.12 USD Hold'em No Limit - Level VI (50/100) - 2020/12/18 23:30:32 EET [2020/12/18 16:30:32 ET]
Table '3074230175 55' 9-max Seat #4 is the button
Seat 1: guiterman (2604 in chips) 
Seat 2: chaoukidiv10 (5778 in chips) 
Seat 3: maciel1986 (1902 in chips) 
Seat 4: jcarlos.vale (5338 in chips) 
Seat 5: ImCrazyFish (1756 in chips) is sitting out
Seat 6: fern46 (1624 in chips) 
Seat 7: Jeppekanin14 (2676 in chips) 
Seat 8: BMW 812 (11692 in chips) 
Seat 9: cyeav22 (2626 in chips) 
guiterman: posts the ante 12
chaoukidiv10: posts the ante 12
maciel1986: posts the ante 12
jcarlos.vale: posts the ante 12
ImCrazyFish: posts the ante 12
fern46: posts the ante 12
Jeppekanin14: posts the ante 12
BMW 812: posts the ante 12
cyeav22: posts the ante 12
ImCrazyFish: posts small blind 50
fern46: posts big blind 100
*** HOLE CARDS ***
Dealt to jcarlos.vale [4h 4c]
Jeppekanin14: folds 
BMW 812: folds 
guiterman said, "so fix"
cyeav22: folds 
guiterman: calls 100
chaoukidiv10: folds 
guiterman said, "all in 4 5"
maciel1986: folds 
jcarlos.vale: raises 160 to 260
ImCrazyFish: folds 
fern46: folds 
guiterman: calls 160
*** FLOP *** [Td Qs 6c]
guiterman: checks 
jcarlos.vale: bets 300
guiterman: folds 
Uncalled bet (300) returned to jcarlos.vale
jcarlos.vale collected 778 from pot
jcarlos.vale: doesn't show handDTO
*** SUMMARY ***
Total pot 778 | Rake 0 
Board [Td Qs 6c]
Seat 1: guiterman folded on the Flop
Seat 2: chaoukidiv10 folded before Flop (didn't bet)
Seat 3: maciel1986 folded before Flop (didn't bet)
Seat 4: jcarlos.vale (button) collected (778)
Seat 5: ImCrazyFish (small blind) folded before Flop
Seat 6: fern46 (big blind) folded before Flop
Seat 7: Jeppekanin14 folded before Flop (didn't bet)
Seat 8: BMW 812 folded before Flop (didn't bet)
Seat 9: cyeav22 folded before Flop (didn't bet)



PokerStars Hand #221585330923: Tournament #3074230175, $0.98+$0.12 USD Hold'em No Limit - Level VI (50/100) - 2020/12/18 23:31:31 EET [2020/12/18 16:31:31 ET]
Table '3074230175 55' 9-max Seat #5 is the button
Seat 1: guiterman (2332 in chips) 
Seat 2: chaoukidiv10 (5766 in chips) 
Seat 3: maciel1986 (1890 in chips) 
Seat 4: jcarlos.vale (5844 in chips) 
Seat 5: ImCrazyFish (1694 in chips) is sitting out
Seat 6: fern46 (1512 in chips) 
Seat 7: Jeppekanin14 (2664 in chips) 
Seat 8: BMW 812 (11680 in chips) 
Seat 9: cyeav22 (2614 in chips) 
guiterman: posts the ante 12
chaoukidiv10: posts the ante 12
maciel1986: posts the ante 12
jcarlos.vale: posts the ante 12
ImCrazyFish: posts the ante 12
fern46: posts the ante 12
Jeppekanin14: posts the ante 12
BMW 812: posts the ante 12
cyeav22: posts the ante 12
fern46: posts small blind 50
Jeppekanin14: posts big blind 100
*** HOLE CARDS ***
Dealt to jcarlos.vale [5s 6h]
BMW 812: raises 100 to 200
cyeav22: folds 
guiterman: raises 2120 to 2320 and is all-in
chaoukidiv10: folds 
maciel1986: folds 
jcarlos.vale: folds 
ImCrazyFish: folds 
fern46: folds 
Jeppekanin14: folds 
BMW 812: calls 2120
*** FLOP *** [Qs 8h 6s]
*** TURN *** [Qs 8h 6s] [3s]
*** RIVER *** [Qs 8h 6s 3s] [4h]
*** SHOW DOWN ***
BMW 812: shows [As 7d] (high pairOfCards Ace)
guiterman: shows [Ac 9h] (high pairOfCards Ace - Queen+Nine kicker)
guiterman collected 4898 from pot
*** SUMMARY ***
Total pot 4898 | Rake 0 
Board [Qs 8h 6s 3s 4h]
Seat 1: guiterman showed [Ac 9h] and won (4898) with high pairOfCards Ace
Seat 2: chaoukidiv10 folded before Flop (didn't bet)
Seat 3: maciel1986 folded before Flop (didn't bet)
Seat 4: jcarlos.vale folded before Flop (didn't bet)
Seat 5: ImCrazyFish (button) folded before Flop (didn't bet)
Seat 6: fern46 (small blind) folded before Flop
Seat 7: Jeppekanin14 (big blind) folded before Flop
Seat 8: BMW 812 showed [As 7d] and lost with high pairOfCards Ace
Seat 9: cyeav22 folded before Flop (didn't bet)



PokerStars Hand #221585361633: Tournament #3074230175, $0.98+$0.12 USD Hold'em No Limit - Level VI (50/100) - 2020/12/18 23:32:12 EET [2020/12/18 16:32:12 ET]
Table '3074230175 55' 9-max Seat #6 is the button
Seat 1: guiterman (4898 in chips) 
Seat 2: chaoukidiv10 (5754 in chips) 
Seat 3: maciel1986 (1878 in chips) 
Seat 4: jcarlos.vale (5832 in chips) 
Seat 5: ImCrazyFish (1682 in chips) is sitting out
Seat 6: fern46 (1450 in chips) 
Seat 7: Jeppekanin14 (2552 in chips) 
Seat 8: BMW 812 (9348 in chips) 
Seat 9: cyeav22 (2602 in chips) 
guiterman: posts the ante 12
chaoukidiv10: posts the ante 12
maciel1986: posts the ante 12
jcarlos.vale: posts the ante 12
ImCrazyFish: posts the ante 12
fern46: posts the ante 12
Jeppekanin14: posts the ante 12
BMW 812: posts the ante 12
cyeav22: posts the ante 12
Jeppekanin14: posts small blind 50
BMW 812: posts big blind 100
*** HOLE CARDS ***
Dealt to jcarlos.vale [Ac Qd]
cyeav22: raises 110 to 210
guiterman: folds 
chaoukidiv10: calls 210
maciel1986: folds 
jcarlos.vale: calls 210
ImCrazyFish: folds 
fern46: folds 
Jeppekanin14: folds 
BMW 812: calls 110
*** FLOP *** [5s 2d 2s]
BMW 812: checks 
cyeav22: bets 409
chaoukidiv10: calls 409
jcarlos.vale: folds 
BMW 812: folds 
*** TURN *** [5s 2d 2s] [9h]
cyeav22: checks 
chaoukidiv10: checks 
*** RIVER *** [5s 2d 2s 9h] [Kd]
cyeav22: bets 1971 and is all-in
chaoukidiv10: folds 
Uncalled bet (1971) returned to cyeav22
cyeav22 collected 1816 from pot
cyeav22: doesn't show handDTO
*** SUMMARY ***
Total pot 1816 | Rake 0 
Board [5s 2d 2s 9h Kd]
Seat 1: guiterman folded before Flop (didn't bet)
Seat 2: chaoukidiv10 folded on the River
Seat 3: maciel1986 folded before Flop (didn't bet)
Seat 4: jcarlos.vale folded on the Flop
Seat 5: ImCrazyFish folded before Flop (didn't bet)
Seat 6: fern46 (button) folded before Flop (didn't bet)
Seat 7: Jeppekanin14 (small blind) folded before Flop
Seat 8: BMW 812 (big blind) folded on the Flop
Seat 9: cyeav22 collected (1816)



PokerStars Hand #221585412002: Tournament #3074230175, $0.98+$0.12 USD Hold'em No Limit - Level VI (50/100) - 2020/12/18 23:33:19 EET [2020/12/18 16:33:19 ET]
Table '3074230175 55' 9-max Seat #7 is the button
Seat 1: guiterman (4886 in chips) 
Seat 2: chaoukidiv10 (5123 in chips) 
Seat 3: maciel1986 (1866 in chips) 
Seat 4: jcarlos.vale (5610 in chips) 
Seat 5: ImCrazyFish (1670 in chips) is sitting out
Seat 6: fern46 (1438 in chips) 
Seat 7: Jeppekanin14 (2490 in chips) 
Seat 8: BMW 812 (9126 in chips) 
Seat 9: cyeav22 (3787 in chips) 
guiterman: posts the ante 12
chaoukidiv10: posts the ante 12
maciel1986: posts the ante 12
jcarlos.vale: posts the ante 12
ImCrazyFish: posts the ante 12
fern46: posts the ante 12
Jeppekanin14: posts the ante 12
BMW 812: posts the ante 12
cyeav22: posts the ante 12
BMW 812: posts small blind 50
cyeav22: posts big blind 100
*** HOLE CARDS ***
Dealt to jcarlos.vale [6d Kc]
guiterman: raises 4774 to 4874 and is all-in
chaoukidiv10: folds 
maciel1986: folds 
jcarlos.vale: folds 
ImCrazyFish: folds 
fern46: folds 
Jeppekanin14: calls 2478 and is all-in
BMW 812: folds 
cyeav22: folds 
Uncalled bet (2396) returned to guiterman
*** FLOP *** [Td 5s 2c]
*** TURN *** [Td 5s 2c] [Kh]
*** RIVER *** [Td 5s 2c Kh] [3h]
*** SHOW DOWN ***
guiterman: shows [8c Ac] (high pairOfCards Ace)
Jeppekanin14: shows [As 9d] (high pairOfCards Ace - King+Ten+Nine kicker)
Jeppekanin14 collected 5214 from pot
*** SUMMARY ***
Total pot 5214 | Rake 0 
Board [Td 5s 2c Kh 3h]
Seat 1: guiterman showed [8c Ac] and lost with high pairOfCards Ace
Seat 2: chaoukidiv10 folded before Flop (didn't bet)
Seat 3: maciel1986 folded before Flop (didn't bet)
Seat 4: jcarlos.vale folded before Flop (didn't bet)
Seat 5: ImCrazyFish folded before Flop (didn't bet)
Seat 6: fern46 folded before Flop (didn't bet)
Seat 7: Jeppekanin14 (button) showed [As 9d] and won (5214) with high pairOfCards Ace
Seat 8: BMW 812 (small blind) folded before Flop
Seat 9: cyeav22 (big blind) folded before Flop



PokerStars Hand #221585432097: Tournament #3074230175, $0.98+$0.12 USD Hold'em No Limit - Level VI (50/100) - 2020/12/18 23:33:45 EET [2020/12/18 16:33:45 ET]
Table '3074230175 55' 9-max Seat #8 is the button
Seat 1: guiterman (2396 in chips) 
Seat 2: chaoukidiv10 (5111 in chips) 
Seat 3: maciel1986 (1854 in chips) 
Seat 4: jcarlos.vale (5598 in chips) 
Seat 5: ImCrazyFish (1658 in chips) is sitting out
Seat 6: fern46 (1426 in chips) 
Seat 7: Jeppekanin14 (5214 in chips) 
Seat 8: BMW 812 (9064 in chips) 
Seat 9: cyeav22 (3675 in chips) 
guiterman: posts the ante 12
chaoukidiv10: posts the ante 12
maciel1986: posts the ante 12
jcarlos.vale: posts the ante 12
ImCrazyFish: posts the ante 12
fern46: posts the ante 12
Jeppekanin14: posts the ante 12
BMW 812: posts the ante 12
cyeav22: posts the ante 12
cyeav22: posts small blind 50
guiterman: posts big blind 100
*** HOLE CARDS ***
Dealt to jcarlos.vale [5s Th]
chaoukidiv10: raises 100 to 200
maciel1986: folds 
jcarlos.vale: folds 
ImCrazyFish: folds 
fern46: folds 
Jeppekanin14: calls 200
BMW 812: calls 200
cyeav22: calls 150
guiterman: calls 100
*** FLOP *** [5h 4c Qc]
cyeav22: checks 
guiterman: checks 
chaoukidiv10: bets 1108
Jeppekanin14: folds 
BMW 812: folds 
cyeav22: calls 1108
guiterman: folds 
*** TURN *** [5h 4c Qc] [8c]
cyeav22: checks 
chaoukidiv10: bets 3324
cyeav22: calls 2355 and is all-in
Uncalled bet (969) returned to chaoukidiv10
*** RIVER *** [5h 4c Qc 8c] [7h]
*** SHOW DOWN ***
cyeav22: shows [Qd Kh] (a pair of Queens)
chaoukidiv10: shows [7c 6c] (a flush, Queen high)
chaoukidiv10 collected 8034 from pot
cyeav22 finished the tournament
*** SUMMARY ***
Total pot 8034 | Rake 0 
Board [5h 4c Qc 8c 7h]
Seat 1: guiterman (big blind) folded on the Flop
Seat 2: chaoukidiv10 showed [7c 6c] and won (8034) with a flush, Queen high
Seat 3: maciel1986 folded before Flop (didn't bet)
Seat 4: jcarlos.vale folded before Flop (didn't bet)
Seat 5: ImCrazyFish folded before Flop (didn't bet)
Seat 6: fern46 folded before Flop (didn't bet)
Seat 7: Jeppekanin14 folded on the Flop
Seat 8: BMW 812 (button) folded on the Flop
Seat 9: cyeav22 (small blind) showed [Qd Kh] and lost with a pair of Queens



PokerStars Hand #221585488303: Tournament #3074230175, $0.98+$0.12 USD Hold'em No Limit - Level VI (50/100) - 2020/12/18 23:35:00 EET [2020/12/18 16:35:00 ET]
Table '3074230175 55' 9-max Seat #1 is the button
Seat 1: guiterman (2184 in chips) 
Seat 2: chaoukidiv10 (9470 in chips) 
Seat 3: maciel1986 (1842 in chips) 
Seat 4: jcarlos.vale (5586 in chips) 
Seat 5: ImCrazyFish (1646 in chips) is sitting out
Seat 6: fern46 (1414 in chips) 
Seat 7: Jeppekanin14 (5002 in chips) 
Seat 8: BMW 812 (8852 in chips) 
guiterman: posts the ante 12
chaoukidiv10: posts the ante 12
maciel1986: posts the ante 12
jcarlos.vale: posts the ante 12
ImCrazyFish: posts the ante 12
fern46: posts the ante 12
Jeppekanin14: posts the ante 12
BMW 812: posts the ante 12
chaoukidiv10: posts small blind 50
maciel1986: posts big blind 100
*** HOLE CARDS ***
Dealt to jcarlos.vale [Jc As]
jcarlos.vale: raises 160 to 260
ImCrazyFish: folds 
fern46: folds 
Jeppekanin14: folds 
BMW 812: folds 
guiterman: folds 
chaoukidiv10: folds 
maciel1986: folds 
Uncalled bet (160) returned to jcarlos.vale
jcarlos.vale collected 346 from pot
jcarlos.vale: doesn't show handDTO
*** SUMMARY ***
Total pot 346 | Rake 0 
Seat 1: guiterman (button) folded before Flop (didn't bet)
Seat 2: chaoukidiv10 (small blind) folded before Flop
Seat 3: maciel1986 (big blind) folded before Flop
Seat 4: jcarlos.vale collected (346)
Seat 5: ImCrazyFish folded before Flop (didn't bet)
Seat 6: fern46 folded before Flop (didn't bet)
Seat 7: Jeppekanin14 folded before Flop (didn't bet)
Seat 8: BMW 812 folded before Flop (didn't bet)



PokerStars Hand #221585501602: Tournament #3074230175, $0.98+$0.12 USD Hold'em No Limit - Level VI (50/100) - 2020/12/18 23:35:17 EET [2020/12/18 16:35:17 ET]
Table '3074230175 55' 9-max Seat #2 is the button
Seat 1: guiterman (2172 in chips) 
Seat 2: chaoukidiv10 (9408 in chips) 
Seat 3: maciel1986 (1730 in chips) 
Seat 4: jcarlos.vale (5820 in chips) 
Seat 5: ImCrazyFish (1634 in chips) is sitting out
Seat 6: fern46 (1402 in chips) 
Seat 7: Jeppekanin14 (4990 in chips) 
Seat 8: BMW 812 (8840 in chips) 
guiterman: posts the ante 12
chaoukidiv10: posts the ante 12
maciel1986: posts the ante 12
jcarlos.vale: posts the ante 12
ImCrazyFish: posts the ante 12
fern46: posts the ante 12
Jeppekanin14: posts the ante 12
BMW 812: posts the ante 12
maciel1986: posts small blind 50
jcarlos.vale: posts big blind 100
*** HOLE CARDS ***
Dealt to jcarlos.vale [Kh 6s]
ImCrazyFish: folds 
fern46: folds 
Jeppekanin14: folds 
BMW 812: folds 
guiterman: calls 100
chaoukidiv10: calls 100
maciel1986: calls 50
jcarlos.vale: checks 
*** FLOP *** [3h Tc Ts]
maciel1986: checks 
jcarlos.vale: checks 
guiterman: checks 
chaoukidiv10: checks 
*** TURN *** [3h Tc Ts] [9c]
maciel1986: checks 
jcarlos.vale: checks 
guiterman: checks 
chaoukidiv10: checks 
*** RIVER *** [3h Tc Ts 9c] [8h]
maciel1986: checks 
jcarlos.vale: checks 
guiterman: checks 
chaoukidiv10: checks 
*** SHOW DOWN ***
maciel1986: shows [7h 5h] (a pair of Tens)
jcarlos.vale: shows [Kh 6s] (a pair of Tens - King kicker)
guiterman: mucks handDTO
chaoukidiv10: shows [7d 9d] (two pair, Tens and Nines)
chaoukidiv10 collected 496 from pot
*** SUMMARY ***
Total pot 496 | Rake 0 
Board [3h Tc Ts 9c 8h]
Seat 1: guiterman mucked [Jh 6h]
Seat 2: chaoukidiv10 (button) showed [7d 9d] and won (496) with two pair, Tens and Nines
Seat 3: maciel1986 (small blind) showed [7h 5h] and lost with a pair of Tens
Seat 4: jcarlos.vale (big blind) showed [Kh 6s] and lost with a pair of Tens
Seat 5: ImCrazyFish folded before Flop (didn't bet)
Seat 6: fern46 folded before Flop (didn't bet)
Seat 7: Jeppekanin14 folded before Flop (didn't bet)
Seat 8: BMW 812 folded before Flop (didn't bet)



PokerStars Hand #221585559340: Tournament #3074230175, $0.98+$0.12 USD Hold'em No Limit - Level VI (50/100) - 2020/12/18 23:36:34 EET [2020/12/18 16:36:34 ET]
Table '3074230175 55' 9-max Seat #3 is the button
Seat 1: guiterman (2060 in chips) 
Seat 2: chaoukidiv10 (9792 in chips) 
Seat 3: maciel1986 (1618 in chips) 
Seat 4: jcarlos.vale (5708 in chips) 
Seat 5: ImCrazyFish (1622 in chips) is sitting out
Seat 6: fern46 (1390 in chips) 
Seat 7: Jeppekanin14 (4978 in chips) 
Seat 8: BMW 812 (8828 in chips) 
Seat 9: Oxothik385 (3000 in chips) 
guiterman: posts the ante 12
chaoukidiv10: posts the ante 12
maciel1986: posts the ante 12
jcarlos.vale: posts the ante 12
ImCrazyFish: posts the ante 12
fern46: posts the ante 12
Jeppekanin14: posts the ante 12
BMW 812: posts the ante 12
Oxothik385: posts the ante 12
jcarlos.vale: posts small blind 50
ImCrazyFish: posts big blind 100
*** HOLE CARDS ***
Dealt to jcarlos.vale [2s Qc]
Oxothik385 is disconnected 
fern46: folds 
Jeppekanin14: raises 358 to 458
BMW 812: calls 458
Oxothik385: folds 
guiterman: raises 1590 to 2048 and is all-in
chaoukidiv10: folds 
maciel1986: folds 
jcarlos.vale: folds 
ImCrazyFish: folds 
Jeppekanin14: calls 1590
BMW 812: calls 1590
*** FLOP *** [8s 6d 2d]
Jeppekanin14: checks 
BMW 812: checks 
*** TURN *** [8s 6d 2d] [7c]
Jeppekanin14: bets 2918 and is all-in
BMW 812: folds 
Uncalled bet (2918) returned to Jeppekanin14
*** RIVER *** [8s 6d 2d 7c] [Th]
*** SHOW DOWN ***
Jeppekanin14: shows [Jh Qd] (high pairOfCards Queen)
guiterman: shows [9s 9c] (a straight, Six to Ten)
guiterman collected 6402 from pot
*** SUMMARY ***
Total pot 6402 | Rake 0 
Board [8s 6d 2d 7c Th]
Seat 1: guiterman showed [9s 9c] and won (6402) with a straight, Six to Ten
Seat 2: chaoukidiv10 folded before Flop (didn't bet)
Seat 3: maciel1986 (button) folded before Flop (didn't bet)
Seat 4: jcarlos.vale (small blind) folded before Flop
Seat 5: ImCrazyFish (big blind) folded before Flop
Seat 6: fern46 folded before Flop (didn't bet)
Seat 7: Jeppekanin14 showed [Jh Qd] and lost with high pairOfCards Queen
Seat 8: BMW 812 folded on the Turn
Seat 9: Oxothik385 folded before Flop (didn't bet)



PokerStars Hand #221585595696: Tournament #3074230175, $0.98+$0.12 USD Hold'em No Limit - Level VII (60/120) - 2020/12/18 23:37:23 EET [2020/12/18 16:37:23 ET]
Table '3074230175 55' 9-max Seat #4 is the button
Seat 1: guiterman (6402 in chips) 
Seat 2: chaoukidiv10 (9780 in chips) 
Seat 3: maciel1986 (1606 in chips) 
Seat 4: jcarlos.vale (5646 in chips) 
Seat 5: ImCrazyFish (1510 in chips) is sitting out
Seat 6: fern46 (1378 in chips) 
Seat 7: Jeppekanin14 (2918 in chips) 
Seat 8: BMW 812 (6768 in chips) 
Seat 9: Oxothik385 (2988 in chips) 
guiterman: posts the ante 15
chaoukidiv10: posts the ante 15
maciel1986: posts the ante 15
jcarlos.vale: posts the ante 15
ImCrazyFish: posts the ante 15
fern46: posts the ante 15
Jeppekanin14: posts the ante 15
BMW 812: posts the ante 15
Oxothik385: posts the ante 15
ImCrazyFish: posts small blind 60
fern46: posts big blind 120
*** HOLE CARDS ***
Dealt to jcarlos.vale [7h 2d]
Jeppekanin14: folds 
BMW 812: folds 
Oxothik385: folds 
guiterman: folds 
chaoukidiv10: raises 435 to 555
maciel1986: folds 
jcarlos.vale: folds 
ImCrazyFish: folds 
fern46: folds 
Uncalled bet (435) returned to chaoukidiv10
chaoukidiv10 collected 435 from pot
chaoukidiv10: doesn't show handDTO
*** SUMMARY ***
Total pot 435 | Rake 0 
Seat 1: guiterman folded before Flop (didn't bet)
Seat 2: chaoukidiv10 collected (435)
Seat 3: maciel1986 folded before Flop (didn't bet)
Seat 4: jcarlos.vale (button) folded before Flop (didn't bet)
Seat 5: ImCrazyFish (small blind) folded before Flop
Seat 6: fern46 (big blind) folded before Flop
Seat 7: Jeppekanin14 folded before Flop (didn't bet)
Seat 8: BMW 812 folded before Flop (didn't bet)
Seat 9: Oxothik385 folded before Flop (didn't bet)



PokerStars Hand #221585619390: Tournament #3074230175, $0.98+$0.12 USD Hold'em No Limit - Level VII (60/120) - 2020/12/18 23:37:54 EET [2020/12/18 16:37:54 ET]
Table '3074230175 55' 9-max Seat #5 is the button
Seat 1: guiterman (6387 in chips) 
Seat 2: chaoukidiv10 (10080 in chips) 
Seat 3: maciel1986 (1591 in chips) 
Seat 4: jcarlos.vale (5631 in chips) 
Seat 5: ImCrazyFish (1435 in chips) is sitting out
Seat 6: fern46 (1243 in chips) 
Seat 7: Jeppekanin14 (2903 in chips) 
Seat 8: BMW 812 (6753 in chips) 
Seat 9: Oxothik385 (2973 in chips) 
guiterman: posts the ante 15
chaoukidiv10: posts the ante 15
maciel1986: posts the ante 15
jcarlos.vale: posts the ante 15
ImCrazyFish: posts the ante 15
fern46: posts the ante 15
Jeppekanin14: posts the ante 15
BMW 812: posts the ante 15
Oxothik385: posts the ante 15
fern46: posts small blind 60
Jeppekanin14: posts big blind 120
*** HOLE CARDS ***
Dealt to jcarlos.vale [Jd 4h]
BMW 812: folds 
Jeppekanin14 is disconnected 
Oxothik385: calls 120
guiterman: folds 
chaoukidiv10: folds 
maciel1986: folds 
jcarlos.vale: folds 
ImCrazyFish: folds 
fern46: calls 60
Jeppekanin14: raises 240 to 360
Oxothik385: calls 240
fern46: folds 
*** FLOP *** [Th 8c 7c]
Jeppekanin14: bets 488
Oxothik385: calls 488
*** TURN *** [Th 8c 7c] [Tc]
Jeppekanin14: bets 1951
Oxothik385: calls 1951
*** RIVER *** [Th 8c 7c Tc] [2h]
Jeppekanin14: checks 
Oxothik385: bets 120
Jeppekanin14: calls 89 and is all-in
Uncalled bet (31) returned to Oxothik385
*** SHOW DOWN ***
Oxothik385: shows [6s Jc] (a pair of Tens)
Jeppekanin14: shows [Ks As] (a pair of Tens - Ace kicker)
Jeppekanin14 collected 6031 from pot
*** SUMMARY ***
Total pot 6031 | Rake 0 
Board [Th 8c 7c Tc 2h]
Seat 1: guiterman folded before Flop (didn't bet)
Seat 2: chaoukidiv10 folded before Flop (didn't bet)
Seat 3: maciel1986 folded before Flop (didn't bet)
Seat 4: jcarlos.vale folded before Flop (didn't bet)
Seat 5: ImCrazyFish (button) folded before Flop (didn't bet)
Seat 6: fern46 (small blind) folded before Flop
Seat 7: Jeppekanin14 (big blind) showed [Ks As] and won (6031) with a pair of Tens
Seat 8: BMW 812 folded before Flop (didn't bet)
Seat 9: Oxothik385 showed [6s Jc] and lost with a pair of Tens



PokerStars Hand #221585686420: Tournament #3074230175, $0.98+$0.12 USD Hold'em No Limit - Level VII (60/120) - 2020/12/18 23:39:24 EET [2020/12/18 16:39:24 ET]
Table '3074230175 55' 9-max Seat #6 is the button
Seat 1: guiterman (6372 in chips) 
Seat 2: chaoukidiv10 (10065 in chips) 
Seat 3: maciel1986 (1576 in chips) 
Seat 4: jcarlos.vale (5616 in chips) 
Seat 5: ImCrazyFish (1420 in chips) is sitting out
Seat 6: fern46 (1108 in chips) 
Seat 7: Jeppekanin14 (6031 in chips) 
Seat 8: BMW 812 (6738 in chips) 
Seat 9: Oxothik385 (70 in chips) 
guiterman: posts the ante 15
chaoukidiv10: posts the ante 15
maciel1986: posts the ante 15
jcarlos.vale: posts the ante 15
ImCrazyFish: posts the ante 15
fern46: posts the ante 15
Jeppekanin14: posts the ante 15
BMW 812: posts the ante 15
Oxothik385: posts the ante 15
Jeppekanin14: posts small blind 60
BMW 812: posts big blind 120
*** HOLE CARDS ***
Dealt to jcarlos.vale [Qs Ts]
Oxothik385: calls 55 and is all-in
guiterman: folds 
chaoukidiv10: calls 120
maciel1986: folds 
jcarlos.vale: calls 120
ImCrazyFish: folds 
fern46: folds 
Jeppekanin14: folds 
BMW 812: checks 
*** FLOP *** [2s 6c 4c]
BMW 812: checks 
chaoukidiv10: bets 610
jcarlos.vale: folds 
BMW 812: calls 610
*** TURN *** [2s 6c 4c] [Ad]
BMW 812: checks 
chaoukidiv10: checks 
*** RIVER *** [2s 6c 4c Ad] [8h]
BMW 812: bets 1680
chaoukidiv10: folds 
Uncalled bet (1680) returned to BMW 812
*** SHOW DOWN ***
BMW 812: shows [Jh 3d] (high pairOfCards Ace)
BMW 812 collected 1420 from side pot
Oxothik385: shows [6h 7d] (a pair of Sixes)
Oxothik385 collected 410 from main pot
*** SUMMARY ***
Total pot 1830 Main pot 410. Side pot 1420. | Rake 0 
Board [2s 6c 4c Ad 8h]
Seat 1: guiterman folded before Flop (didn't bet)
Seat 2: chaoukidiv10 folded on the River
Seat 3: maciel1986 folded before Flop (didn't bet)
Seat 4: jcarlos.vale folded on the Flop
Seat 5: ImCrazyFish folded before Flop (didn't bet)
Seat 6: fern46 (button) folded before Flop (didn't bet)
Seat 7: Jeppekanin14 (small blind) folded before Flop
Seat 8: BMW 812 (big blind) showed [Jh 3d] and won (1420) with high pairOfCards Ace
Seat 9: Oxothik385 showed [6h 7d] and won (410) with a pair of Sixes



PokerStars Hand #221585731173: Tournament #3074230175, $0.98+$0.12 USD Hold'em No Limit - Level VII (60/120) - 2020/12/18 23:40:24 EET [2020/12/18 16:40:24 ET]
Table '3074230175 55' 9-max Seat #7 is the button
Seat 1: guiterman (6357 in chips) 
Seat 2: chaoukidiv10 (9320 in chips) 
Seat 3: maciel1986 (1561 in chips) 
Seat 4: jcarlos.vale (5481 in chips) 
Seat 5: ImCrazyFish (1405 in chips) is sitting out
Seat 6: fern46 (1093 in chips) 
Seat 7: Jeppekanin14 (5956 in chips) 
Seat 8: BMW 812 (7413 in chips) 
Seat 9: Oxothik385 (410 in chips) 
guiterman: posts the ante 15
chaoukidiv10: posts the ante 15
maciel1986: posts the ante 15
jcarlos.vale: posts the ante 15
ImCrazyFish: posts the ante 15
fern46: posts the ante 15
Jeppekanin14: posts the ante 15
BMW 812: posts the ante 15
Oxothik385: posts the ante 15
BMW 812: posts small blind 60
Oxothik385: posts big blind 120
*** HOLE CARDS ***
Dealt to jcarlos.vale [Kc 5d]
guiterman: folds 
chaoukidiv10: folds 
maciel1986: folds 
jcarlos.vale: folds 
ImCrazyFish: folds 
fern46: folds 
Jeppekanin14: raises 240 to 360
BMW 812: folds 
Oxothik385: calls 240
*** FLOP *** [8c Ah Ac]
Oxothik385: checks 
Jeppekanin14: checks 
*** TURN *** [8c Ah Ac] [Qh]
Oxothik385: bets 35 and is all-in
Jeppekanin14: calls 35
*** RIVER *** [8c Ah Ac Qh] [8s]
*** SHOW DOWN ***
Oxothik385: shows [6h As] (a full house, Aces full of Eights)
Jeppekanin14: shows [Qd Ad] (a full house, Aces full of Queens)
Jeppekanin14 collected 985 from pot
Oxothik385 finished the tournament
*** SUMMARY ***
Total pot 985 | Rake 0 
Board [8c Ah Ac Qh 8s]
Seat 1: guiterman folded before Flop (didn't bet)
Seat 2: chaoukidiv10 folded before Flop (didn't bet)
Seat 3: maciel1986 folded before Flop (didn't bet)
Seat 4: jcarlos.vale folded before Flop (didn't bet)
Seat 5: ImCrazyFish folded before Flop (didn't bet)
Seat 6: fern46 folded before Flop (didn't bet)
Seat 7: Jeppekanin14 (button) showed [Qd Ad] and won (985) with a full house, Aces full of Queens
Seat 8: BMW 812 (small blind) folded before Flop
Seat 9: Oxothik385 (big blind) showed [6h As] and lost with a full house, Aces full of Eights



PokerStars Hand #221585769942: Tournament #3074230175, $0.98+$0.12 USD Hold'em No Limit - Level VII (60/120) - 2020/12/18 23:41:16 EET [2020/12/18 16:41:16 ET]
Table '3074230175 55' 9-max Seat #8 is the button
Seat 1: guiterman (6342 in chips) 
Seat 2: chaoukidiv10 (9305 in chips) 
Seat 3: maciel1986 (1546 in chips) 
Seat 4: jcarlos.vale (5466 in chips) 
Seat 5: ImCrazyFish (1390 in chips) is sitting out
Seat 6: fern46 (1078 in chips) 
Seat 7: Jeppekanin14 (6531 in chips) 
Seat 8: BMW 812 (7338 in chips) 
guiterman: posts the ante 15
chaoukidiv10: posts the ante 15
maciel1986: posts the ante 15
jcarlos.vale: posts the ante 15
ImCrazyFish: posts the ante 15
fern46: posts the ante 15
Jeppekanin14: posts the ante 15
BMW 812: posts the ante 15
guiterman: posts small blind 60
chaoukidiv10: posts big blind 120
*** HOLE CARDS ***
Dealt to jcarlos.vale [Js 9c]
maciel1986: folds 
jcarlos.vale: folds 
ImCrazyFish: folds 
fern46: folds 
Jeppekanin14: raises 240 to 360
BMW 812: folds 
guiterman: folds 
chaoukidiv10: calls 240
*** FLOP *** [Jc 4h 3s]
chaoukidiv10: bets 120
Jeppekanin14: calls 120
*** TURN *** [Jc 4h 3s] [6c]
chaoukidiv10: bets 120
Jeppekanin14: raises 690 to 810
chaoukidiv10: calls 690
*** RIVER *** [Jc 4h 3s 6c] [2d]
chaoukidiv10: checks 
Jeppekanin14: bets 1380
chaoukidiv10: folds 
Uncalled bet (1380) returned to Jeppekanin14
Jeppekanin14 collected 2760 from pot
Jeppekanin14: doesn't show handDTO
*** SUMMARY ***
Total pot 2760 | Rake 0 
Board [Jc 4h 3s 6c 2d]
Seat 1: guiterman (small blind) folded before Flop
Seat 2: chaoukidiv10 (big blind) folded on the River
Seat 3: maciel1986 folded before Flop (didn't bet)
Seat 4: jcarlos.vale folded before Flop (didn't bet)
Seat 5: ImCrazyFish folded before Flop (didn't bet)
Seat 6: fern46 folded before Flop (didn't bet)
Seat 7: Jeppekanin14 collected (2760)
Seat 8: BMW 812 (button) folded before Flop (didn't bet)



PokerStars Hand #221585805320: Tournament #3074230175, $0.98+$0.12 USD Hold'em No Limit - Level VII (60/120) - 2020/12/18 23:42:05 EET [2020/12/18 16:42:05 ET]
Table '3074230175 55' 9-max Seat #1 is the button
Seat 1: guiterman (6267 in chips) 
Seat 2: chaoukidiv10 (8000 in chips) 
Seat 3: maciel1986 (1531 in chips) 
Seat 4: jcarlos.vale (5451 in chips) 
Seat 5: ImCrazyFish (1375 in chips) is sitting out
Seat 6: fern46 (1063 in chips) 
Seat 7: Jeppekanin14 (7986 in chips) 
Seat 8: BMW 812 (7323 in chips) 
guiterman: posts the ante 15
chaoukidiv10: posts the ante 15
maciel1986: posts the ante 15
jcarlos.vale: posts the ante 15
ImCrazyFish: posts the ante 15
fern46: posts the ante 15
Jeppekanin14: posts the ante 15
BMW 812: posts the ante 15
chaoukidiv10: posts small blind 60
maciel1986: posts big blind 120
*** HOLE CARDS ***
Dealt to jcarlos.vale [8c Qc]
jcarlos.vale: folds 
ImCrazyFish: folds 
fern46: folds 
Jeppekanin14: folds 
BMW 812: folds 
guiterman: folds 
chaoukidiv10: raises 7865 to 7985 and is all-in
maciel1986: folds 
Uncalled bet (7865) returned to chaoukidiv10
chaoukidiv10 collected 360 from pot
chaoukidiv10: doesn't show handDTO
*** SUMMARY ***
Total pot 360 | Rake 0 
Seat 1: guiterman (button) folded before Flop (didn't bet)
Seat 2: chaoukidiv10 (small blind) collected (360)
Seat 3: maciel1986 (big blind) folded before Flop
Seat 4: jcarlos.vale folded before Flop (didn't bet)
Seat 5: ImCrazyFish folded before Flop (didn't bet)
Seat 6: fern46 folded before Flop (didn't bet)
Seat 7: Jeppekanin14 folded before Flop (didn't bet)
Seat 8: BMW 812 folded before Flop (didn't bet)



PokerStars Hand #221585820592: Tournament #3074230175, $0.98+$0.12 USD Hold'em No Limit - Level VII (60/120) - 2020/12/18 23:42:25 EET [2020/12/18 16:42:25 ET]
Table '3074230175 55' 9-max Seat #2 is the button
Seat 1: guiterman (6252 in chips) 
Seat 2: chaoukidiv10 (8225 in chips) 
Seat 3: maciel1986 (1396 in chips) 
Seat 4: jcarlos.vale (5436 in chips) 
Seat 5: ImCrazyFish (1360 in chips) is sitting out
Seat 6: fern46 (1048 in chips) 
Seat 7: Jeppekanin14 (7971 in chips) 
Seat 8: BMW 812 (7308 in chips) 
guiterman: posts the ante 15
chaoukidiv10: posts the ante 15
maciel1986: posts the ante 15
jcarlos.vale: posts the ante 15
ImCrazyFish: posts the ante 15
fern46: posts the ante 15
Jeppekanin14: posts the ante 15
BMW 812: posts the ante 15
maciel1986: posts small blind 60
jcarlos.vale: posts big blind 120
*** HOLE CARDS ***
Dealt to jcarlos.vale [Ts 5d]
ImCrazyFish: folds 
fern46: folds 
Jeppekanin14: calls 120
BMW 812: folds 
guiterman: calls 120
chaoukidiv10: folds 
maciel1986: calls 60
jcarlos.vale: checks 
*** FLOP *** [2s 7c 3c]
maciel1986: checks 
jcarlos.vale: checks 
Jeppekanin14: checks 
guiterman: checks 
*** TURN *** [2s 7c 3c] [4h]
maciel1986: checks 
jcarlos.vale: checks 
Jeppekanin14: checks 
guiterman: bets 480
maciel1986: folds 
jcarlos.vale: folds 
Jeppekanin14: folds 
Uncalled bet (480) returned to guiterman
guiterman collected 600 from pot
guiterman: doesn't show handDTO
*** SUMMARY ***
Total pot 600 | Rake 0 
Board [2s 7c 3c 4h]
Seat 1: guiterman collected (600)
Seat 2: chaoukidiv10 (button) folded before Flop (didn't bet)
Seat 3: maciel1986 (small blind) folded on the Turn
Seat 4: jcarlos.vale (big blind) folded on the Turn
Seat 5: ImCrazyFish folded before Flop (didn't bet)
Seat 6: fern46 folded before Flop (didn't bet)
Seat 7: Jeppekanin14 folded on the Turn
Seat 8: BMW 812 folded before Flop (didn't bet)



PokerStars Hand #221585871392: Tournament #3074230175, $0.98+$0.12 USD Hold'em No Limit - Level VII (60/120) - 2020/12/18 23:43:34 EET [2020/12/18 16:43:34 ET]
Table '3074230175 55' 9-max Seat #3 is the button
Seat 1: guiterman (6717 in chips) 
Seat 2: chaoukidiv10 (8210 in chips) 
Seat 3: maciel1986 (1261 in chips) 
Seat 4: jcarlos.vale (5301 in chips) 
Seat 5: ImCrazyFish (1345 in chips) is sitting out
Seat 6: fern46 (1033 in chips) 
Seat 7: Jeppekanin14 (7836 in chips) 
Seat 8: BMW 812 (7293 in chips) 
Seat 9: luizmattoz (3000 in chips) 
guiterman: posts the ante 15
chaoukidiv10: posts the ante 15
maciel1986: posts the ante 15
jcarlos.vale: posts the ante 15
ImCrazyFish: posts the ante 15
fern46: posts the ante 15
Jeppekanin14: posts the ante 15
BMW 812: posts the ante 15
luizmattoz: posts the ante 15
jcarlos.vale: posts small blind 60
ImCrazyFish: posts big blind 120
*** HOLE CARDS ***
Dealt to jcarlos.vale [6h 3s]
fern46: folds 
Jeppekanin14: folds 
BMW 812: raises 240 to 360
luizmattoz: folds 
guiterman: folds 
chaoukidiv10: folds 
maciel1986: folds 
jcarlos.vale: folds 
ImCrazyFish: folds 
Uncalled bet (240) returned to BMW 812
BMW 812 collected 435 from pot
BMW 812: doesn't show handDTO
*** SUMMARY ***
Total pot 435 | Rake 0 
Seat 1: guiterman folded before Flop (didn't bet)
Seat 2: chaoukidiv10 folded before Flop (didn't bet)
Seat 3: maciel1986 (button) folded before Flop (didn't bet)
Seat 4: jcarlos.vale (small blind) folded before Flop
Seat 5: ImCrazyFish (big blind) folded before Flop
Seat 6: fern46 folded before Flop (didn't bet)
Seat 7: Jeppekanin14 folded before Flop (didn't bet)
Seat 8: BMW 812 collected (435)
Seat 9: luizmattoz folded before Flop (didn't bet)



PokerStars Hand #221585894477: Tournament #3074230175, $0.98+$0.12 USD Hold'em No Limit - Level VII (60/120) - 2020/12/18 23:44:06 EET [2020/12/18 16:44:06 ET]
Table '3074230175 55' 9-max Seat #4 is the button
Seat 1: guiterman (6702 in chips) 
Seat 2: chaoukidiv10 (8195 in chips) 
Seat 3: maciel1986 (1246 in chips) 
Seat 4: jcarlos.vale (5226 in chips) 
Seat 5: ImCrazyFish (1210 in chips) is sitting out
Seat 6: fern46 (1018 in chips) 
Seat 7: Jeppekanin14 (7821 in chips) 
Seat 8: BMW 812 (7593 in chips) 
Seat 9: luizmattoz (2985 in chips) 
guiterman: posts the ante 15
chaoukidiv10: posts the ante 15
maciel1986: posts the ante 15
jcarlos.vale: posts the ante 15
ImCrazyFish: posts the ante 15
fern46: posts the ante 15
Jeppekanin14: posts the ante 15
BMW 812: posts the ante 15
luizmattoz: posts the ante 15
ImCrazyFish: posts small blind 60
fern46: posts big blind 120
*** HOLE CARDS ***
Dealt to jcarlos.vale [4s Ah]
Jeppekanin14: folds 
BMW 812: folds 
luizmattoz: calls 120
guiterman: folds 
chaoukidiv10: raises 120 to 240
maciel1986: folds 
jcarlos.vale: folds 
ImCrazyFish: folds 
fern46: calls 120
luizmattoz: calls 120
*** FLOP *** [6d 4h As]
fern46: bets 763 and is all-in
luizmattoz: folds 
chaoukidiv10: calls 763
*** TURN *** [6d 4h As] [7d]
*** RIVER *** [6d 4h As 7d] [2d]
*** SHOW DOWN ***
fern46: shows [Td Ad] (a flush, Ace high)
chaoukidiv10: shows [9h 8c] (high pairOfCards Ace)
fern46 collected 2441 from pot
*** SUMMARY ***
Total pot 2441 | Rake 0 
Board [6d 4h As 7d 2d]
Seat 1: guiterman folded before Flop (didn't bet)
Seat 2: chaoukidiv10 showed [9h 8c] and lost with high pairOfCards Ace
Seat 3: maciel1986 folded before Flop (didn't bet)
Seat 4: jcarlos.vale (button) folded before Flop (didn't bet)
Seat 5: ImCrazyFish (small blind) folded before Flop
Seat 6: fern46 (big blind) showed [Td Ad] and won (2441) with a flush, Ace high
Seat 7: Jeppekanin14 folded before Flop (didn't bet)
Seat 8: BMW 812 folded before Flop (didn't bet)
Seat 9: luizmattoz folded on the Flop



PokerStars Hand #221585923918: Tournament #3074230175, $0.98+$0.12 USD Hold'em No Limit - Level VII (60/120) - 2020/12/18 23:44:46 EET [2020/12/18 16:44:46 ET]
Table '3074230175 55' 9-max Seat #5 is the button
Seat 1: guiterman (6687 in chips) 
Seat 2: chaoukidiv10 (7177 in chips) 
Seat 3: maciel1986 (1231 in chips) 
Seat 4: jcarlos.vale (5211 in chips) 
Seat 5: ImCrazyFish (1135 in chips) is sitting out
Seat 6: fern46 (2441 in chips) 
Seat 7: Jeppekanin14 (7806 in chips) 
Seat 8: BMW 812 (7578 in chips) 
Seat 9: luizmattoz (2730 in chips) 
guiterman: posts the ante 15
chaoukidiv10: posts the ante 15
maciel1986: posts the ante 15
jcarlos.vale: posts the ante 15
ImCrazyFish: posts the ante 15
fern46: posts the ante 15
Jeppekanin14: posts the ante 15
BMW 812: posts the ante 15
luizmattoz: posts the ante 15
fern46: posts small blind 60
Jeppekanin14: posts big blind 120
*** HOLE CARDS ***
Dealt to jcarlos.vale [Tc 2s]
BMW 812: folds 
luizmattoz: folds 
guiterman: folds 
chaoukidiv10: calls 120
maciel1986: folds 
jcarlos.vale: folds 
ImCrazyFish: folds 
fern46: folds 
Jeppekanin14: checks 
*** FLOP *** [4h 6s Kc]
Jeppekanin14: checks 
chaoukidiv10: bets 120
Jeppekanin14: raises 338 to 458
chaoukidiv10: calls 338
*** TURN *** [4h 6s Kc] [Qh]
Jeppekanin14: bets 676
chaoukidiv10: calls 676
*** RIVER *** [4h 6s Kc Qh] [Js]
Jeppekanin14: bets 1352
chaoukidiv10: folds 
Uncalled bet (1352) returned to Jeppekanin14
Jeppekanin14 collected 2703 from pot
Jeppekanin14: doesn't show handDTO
*** SUMMARY ***
Total pot 2703 | Rake 0 
Board [4h 6s Kc Qh Js]
Seat 1: guiterman folded before Flop (didn't bet)
Seat 2: chaoukidiv10 folded on the River
Seat 3: maciel1986 folded before Flop (didn't bet)
Seat 4: jcarlos.vale folded before Flop (didn't bet)
Seat 5: ImCrazyFish (button) folded before Flop (didn't bet)
Seat 6: fern46 (small blind) folded before Flop
Seat 7: Jeppekanin14 (big blind) collected (2703)
Seat 8: BMW 812 folded before Flop (didn't bet)
Seat 9: luizmattoz folded before Flop (didn't bet)



PokerStars Hand #221585964037: Tournament #3074230175, $0.98+$0.12 USD Hold'em No Limit - Level VII (60/120) - 2020/12/18 23:45:39 EET [2020/12/18 16:45:39 ET]
Table '3074230175 55' 9-max Seat #6 is the button
Seat 1: guiterman (6672 in chips) 
Seat 2: chaoukidiv10 (5908 in chips) 
Seat 3: maciel1986 (1216 in chips) 
Seat 4: jcarlos.vale (5196 in chips) 
Seat 5: ImCrazyFish (1120 in chips) is sitting out
Seat 6: fern46 (2366 in chips) 
Seat 7: Jeppekanin14 (9240 in chips) 
Seat 8: BMW 812 (7563 in chips) 
Seat 9: luizmattoz (2715 in chips) 
guiterman: posts the ante 15
chaoukidiv10: posts the ante 15
maciel1986: posts the ante 15
jcarlos.vale: posts the ante 15
ImCrazyFish: posts the ante 15
fern46: posts the ante 15
Jeppekanin14: posts the ante 15
BMW 812: posts the ante 15
luizmattoz: posts the ante 15
Jeppekanin14: posts small blind 60
BMW 812: posts big blind 120
*** HOLE CARDS ***
Dealt to jcarlos.vale [4h 7d]
luizmattoz: folds 
guiterman: folds 
chaoukidiv10: raises 120 to 240
maciel1986: raises 961 to 1201 and is all-in
jcarlos.vale: folds 
ImCrazyFish: folds 
fern46: folds 
Jeppekanin14: folds 
BMW 812: calls 1081
chaoukidiv10: raises 4692 to 5893 and is all-in
BMW 812: calls 4692
*** FLOP *** [5h 2s 8d]
*** TURN *** [5h 2s 8d] [Kd]
*** RIVER *** [5h 2s 8d Kd] [5d]
*** SHOW DOWN ***
BMW 812: shows [6c Ac] (a pair of Fives)
chaoukidiv10: shows [Td As] (a pair of Fives - Ace+King+Ten kicker)
chaoukidiv10 collected 9384 from side pot
maciel1986: shows [Jd Ad] (a flush, Ace high)
maciel1986 collected 3798 from main pot
*** SUMMARY ***
Total pot 13182 Main pot 3798. Side pot 9384. | Rake 0 
Board [5h 2s 8d Kd 5d]
Seat 1: guiterman folded before Flop (didn't bet)
Seat 2: chaoukidiv10 showed [Td As] and won (9384) with a pair of Fives
Seat 3: maciel1986 showed [Jd Ad] and won (3798) with a flush, Ace high
Seat 4: jcarlos.vale folded before Flop (didn't bet)
Seat 5: ImCrazyFish folded before Flop (didn't bet)
Seat 6: fern46 (button) folded before Flop (didn't bet)
Seat 7: Jeppekanin14 (small blind) folded before Flop
Seat 8: BMW 812 (big blind) showed [6c Ac] and lost with a pair of Fives
Seat 9: luizmattoz folded before Flop (didn't bet)



PokerStars Hand #221585996577: Tournament #3074230175, $0.98+$0.12 USD Hold'em No Limit - Level VII (60/120) - 2020/12/18 23:46:22 EET [2020/12/18 16:46:22 ET]
Table '3074230175 55' 9-max Seat #7 is the button
Seat 1: guiterman (6657 in chips) 
Seat 2: chaoukidiv10 (9384 in chips) 
Seat 3: maciel1986 (3798 in chips) 
Seat 4: jcarlos.vale (5181 in chips) 
Seat 5: ImCrazyFish (1105 in chips) is sitting out
Seat 6: fern46 (2351 in chips) 
Seat 7: Jeppekanin14 (9165 in chips) 
Seat 8: BMW 812 (1655 in chips) 
Seat 9: luizmattoz (2700 in chips) 
guiterman: posts the ante 15
chaoukidiv10: posts the ante 15
maciel1986: posts the ante 15
jcarlos.vale: posts the ante 15
ImCrazyFish: posts the ante 15
fern46: posts the ante 15
Jeppekanin14: posts the ante 15
BMW 812: posts the ante 15
luizmattoz: posts the ante 15
BMW 812: posts small blind 60
luizmattoz: posts big blind 120
*** HOLE CARDS ***
Dealt to jcarlos.vale [Js Ah]
guiterman: folds 
chaoukidiv10: folds 
maciel1986: folds 
jcarlos.vale: raises 192 to 312
ImCrazyFish: folds 
fern46: folds 
Jeppekanin14: folds 
BMW 812: calls 252
luizmattoz: folds 
*** FLOP *** [5s 4d 3d]
BMW 812: checks 
jcarlos.vale: checks 
*** TURN *** [5s 4d 3d] [6h]
BMW 812: checks 
jcarlos.vale: checks 
*** RIVER *** [5s 4d 3d 6h] [4h]
BMW 812: checks 
jcarlos.vale: checks 
*** SHOW DOWN ***
BMW 812: shows [8c 9h] (a pair of Fours)
jcarlos.vale: shows [Js Ah] (a pair of Fours - Ace kicker)
jcarlos.vale collected 879 from pot
*** SUMMARY ***
Total pot 879 | Rake 0 
Board [5s 4d 3d 6h 4h]
Seat 1: guiterman folded before Flop (didn't bet)
Seat 2: chaoukidiv10 folded before Flop (didn't bet)
Seat 3: maciel1986 folded before Flop (didn't bet)
Seat 4: jcarlos.vale showed [Js Ah] and won (879) with a pair of Fours
Seat 5: ImCrazyFish folded before Flop (didn't bet)
Seat 6: fern46 folded before Flop (didn't bet)
Seat 7: Jeppekanin14 (button) folded before Flop (didn't bet)
Seat 8: BMW 812 (small blind) showed [8c 9h] and lost with a pair of Fours
Seat 9: luizmattoz (big blind) folded before Flop



PokerStars Hand #221586022537: Tournament #3074230175, $0.98+$0.12 USD Hold'em No Limit - Level VII (60/120) - 2020/12/18 23:46:55 EET [2020/12/18 16:46:55 ET]
Table '3074230175 55' 9-max Seat #8 is the button
Seat 1: guiterman (6642 in chips) 
Seat 2: chaoukidiv10 (9369 in chips) 
Seat 3: maciel1986 (3783 in chips) 
Seat 4: jcarlos.vale (5733 in chips) 
Seat 5: ImCrazyFish (1090 in chips) is sitting out
Seat 6: fern46 (2336 in chips) 
Seat 7: Jeppekanin14 (9150 in chips) 
Seat 8: BMW 812 (1328 in chips) 
Seat 9: luizmattoz (2565 in chips) 
guiterman: posts the ante 15
chaoukidiv10: posts the ante 15
maciel1986: posts the ante 15
jcarlos.vale: posts the ante 15
ImCrazyFish: posts the ante 15
fern46: posts the ante 15
Jeppekanin14: posts the ante 15
BMW 812: posts the ante 15
luizmattoz: posts the ante 15
luizmattoz: posts small blind 60
guiterman: posts big blind 120
*** HOLE CARDS ***
Dealt to jcarlos.vale [6d 6h]
chaoukidiv10: folds 
maciel1986: folds 
jcarlos.vale: raises 192 to 312
ImCrazyFish: folds 
fern46: folds 
Jeppekanin14: folds 
BMW 812: calls 312
luizmattoz: folds 
guiterman: raises 6315 to 6627 and is all-in
jcarlos.vale: folds 
BMW 812: calls 1001 and is all-in
Uncalled bet (5314) returned to guiterman
*** FLOP *** [Jh 4s Tc]
*** TURN *** [Jh 4s Tc] [Jd]
*** RIVER *** [Jh 4s Tc Jd] [9c]
*** SHOW DOWN ***
guiterman: shows [Ah Ac] (two pair, Aces and Jacks)
BMW 812: shows [Kd Qh] (a straight, Nine to King)
BMW 812 collected 3133 from pot
*** SUMMARY ***
Total pot 3133 | Rake 0 
Board [Jh 4s Tc Jd 9c]
Seat 1: guiterman (big blind) showed [Ah Ac] and lost with two pair, Aces and Jacks
Seat 2: chaoukidiv10 folded before Flop (didn't bet)
Seat 3: maciel1986 folded before Flop (didn't bet)
Seat 4: jcarlos.vale folded before Flop
Seat 5: ImCrazyFish folded before Flop (didn't bet)
Seat 6: fern46 folded before Flop (didn't bet)
Seat 7: Jeppekanin14 folded before Flop (didn't bet)
Seat 8: BMW 812 (button) showed [Kd Qh] and won (3133) with a straight, Nine to King
Seat 9: luizmattoz (small blind) folded before Flop



PokerStars Hand #221586054327: Tournament #3074230175, $0.98+$0.12 USD Hold'em No Limit - Level VIII (75/150) - 2020/12/18 23:47:37 EET [2020/12/18 16:47:37 ET]
Table '3074230175 55' 9-max Seat #9 is the button
Seat 1: guiterman (5314 in chips) 
Seat 2: chaoukidiv10 (9354 in chips) 
Seat 3: maciel1986 (3768 in chips) 
Seat 4: jcarlos.vale (5406 in chips) 
Seat 5: ImCrazyFish (1075 in chips) is sitting out
Seat 6: fern46 (2321 in chips) 
Seat 7: Jeppekanin14 (9135 in chips) 
Seat 8: BMW 812 (3133 in chips) 
Seat 9: luizmattoz (2490 in chips) 
guiterman: posts the ante 20
chaoukidiv10: posts the ante 20
maciel1986: posts the ante 20
jcarlos.vale: posts the ante 20
ImCrazyFish: posts the ante 20
fern46: posts the ante 20
Jeppekanin14: posts the ante 20
BMW 812: posts the ante 20
luizmattoz: posts the ante 20
guiterman: posts small blind 75
chaoukidiv10: posts big blind 150
*** HOLE CARDS ***
Dealt to jcarlos.vale [4s 2h]
maciel1986: folds 
jcarlos.vale: folds 
ImCrazyFish: folds 
fern46: calls 150
Jeppekanin14: folds 
BMW 812: folds 
luizmattoz: folds 
guiterman: calls 75
chaoukidiv10: raises 150 to 300
fern46: folds 
guiterman: folds 
Uncalled bet (150) returned to chaoukidiv10
chaoukidiv10 collected 630 from pot
chaoukidiv10: doesn't show handDTO
*** SUMMARY ***
Total pot 630 | Rake 0 
Seat 1: guiterman (small blind) folded before Flop
Seat 2: chaoukidiv10 (big blind) collected (630)
Seat 3: maciel1986 folded before Flop (didn't bet)
Seat 4: jcarlos.vale folded before Flop (didn't bet)
Seat 5: ImCrazyFish folded before Flop (didn't bet)
Seat 6: fern46 folded before Flop
Seat 7: Jeppekanin14 folded before Flop (didn't bet)
Seat 8: BMW 812 folded before Flop (didn't bet)
Seat 9: luizmattoz (button) folded before Flop (didn't bet)



PokerStars Hand #221586082601: Tournament #3074230175, $0.98+$0.12 USD Hold'em No Limit - Level VIII (75/150) - 2020/12/18 23:48:14 EET [2020/12/18 16:48:14 ET]
Table '3074230175 55' 9-max Seat #1 is the button
Seat 1: guiterman (5144 in chips) 
Seat 2: chaoukidiv10 (9814 in chips) 
Seat 3: maciel1986 (3748 in chips) 
Seat 4: jcarlos.vale (5386 in chips) 
Seat 5: ImCrazyFish (1055 in chips) is sitting out
Seat 6: fern46 (2151 in chips) 
Seat 7: Jeppekanin14 (9115 in chips) 
Seat 8: BMW 812 (3113 in chips) 
Seat 9: luizmattoz (2470 in chips) 
guiterman: posts the ante 20
chaoukidiv10: posts the ante 20
maciel1986: posts the ante 20
jcarlos.vale: posts the ante 20
ImCrazyFish: posts the ante 20
fern46: posts the ante 20
Jeppekanin14: posts the ante 20
BMW 812: posts the ante 20
luizmattoz: posts the ante 20
chaoukidiv10: posts small blind 75
maciel1986: posts big blind 150
*** HOLE CARDS ***
Dealt to jcarlos.vale [3d 2d]
jcarlos.vale: folds 
ImCrazyFish: folds 
fern46: folds 
Jeppekanin14: folds 
BMW 812: folds 
luizmattoz: folds 
guiterman: raises 4974 to 5124 and is all-in
chaoukidiv10: calls 5049
maciel1986: folds 
*** FLOP *** [4c Qd 6c]
*** TURN *** [4c Qd 6c] [4d]
*** RIVER *** [4c Qd 6c 4d] [Kc]
*** SHOW DOWN ***
chaoukidiv10: shows [9s 8h] (a pair of Fours)
guiterman: shows [Qc Qs] (a full house, Queens full of Fours)
guiterman collected 10578 from pot
*** SUMMARY ***
Total pot 10578 | Rake 0 
Board [4c Qd 6c 4d Kc]
Seat 1: guiterman (button) showed [Qc Qs] and won (10578) with a full house, Queens full of Fours
Seat 2: chaoukidiv10 (small blind) showed [9s 8h] and lost with a pair of Fours
Seat 3: maciel1986 (big blind) folded before Flop
Seat 4: jcarlos.vale folded before Flop (didn't bet)
Seat 5: ImCrazyFish folded before Flop (didn't bet)
Seat 6: fern46 folded before Flop (didn't bet)
Seat 7: Jeppekanin14 folded before Flop (didn't bet)
Seat 8: BMW 812 folded before Flop (didn't bet)
Seat 9: luizmattoz folded before Flop (didn't bet)



PokerStars Hand #221586113047: Tournament #3074230175, $0.98+$0.12 USD Hold'em No Limit - Level VIII (75/150) - 2020/12/18 23:48:55 EET [2020/12/18 16:48:55 ET]
Table '3074230175 55' 9-max Seat #2 is the button
Seat 1: guiterman (10578 in chips) 
Seat 2: chaoukidiv10 (4670 in chips) 
Seat 3: maciel1986 (3578 in chips) 
Seat 4: jcarlos.vale (5366 in chips) 
Seat 5: ImCrazyFish (1035 in chips) is sitting out
Seat 6: fern46 (2131 in chips) 
Seat 7: Jeppekanin14 (9095 in chips) 
Seat 8: BMW 812 (3093 in chips) 
Seat 9: luizmattoz (2450 in chips) 
guiterman: posts the ante 20
chaoukidiv10: posts the ante 20
maciel1986: posts the ante 20
jcarlos.vale: posts the ante 20
ImCrazyFish: posts the ante 20
fern46: posts the ante 20
Jeppekanin14: posts the ante 20
BMW 812: posts the ante 20
luizmattoz: posts the ante 20
maciel1986: posts small blind 75
jcarlos.vale: posts big blind 150
*** HOLE CARDS ***
Dealt to jcarlos.vale [9h Jh]
ImCrazyFish: folds 
fern46: folds 
Jeppekanin14: folds 
BMW 812: raises 300 to 450
luizmattoz: folds 
guiterman: folds 
chaoukidiv10: raises 4200 to 4650 and is all-in
maciel1986: folds 
jcarlos.vale: folds 
BMW 812: calls 2623 and is all-in
Uncalled bet (1577) returned to chaoukidiv10
*** FLOP *** [8d 3d 6c]
*** TURN *** [8d 3d 6c] [5s]
*** RIVER *** [8d 3d 6c 5s] [5d]
*** SHOW DOWN ***
BMW 812: shows [Qh Ad] (a pair of Fives)
chaoukidiv10: shows [As Qc] (a pair of Fives)
BMW 812 collected 3276 from pot
chaoukidiv10 collected 3275 from pot
*** SUMMARY ***
Total pot 6551 | Rake 0 
Board [8d 3d 6c 5s 5d]
Seat 1: guiterman folded before Flop (didn't bet)
Seat 2: chaoukidiv10 (button) showed [As Qc] and won (3275) with a pair of Fives
Seat 3: maciel1986 (small blind) folded before Flop
Seat 4: jcarlos.vale (big blind) folded before Flop
Seat 5: ImCrazyFish folded before Flop (didn't bet)
Seat 6: fern46 folded before Flop (didn't bet)
Seat 7: Jeppekanin14 folded before Flop (didn't bet)
Seat 8: BMW 812 showed [Qh Ad] and won (3276) with a pair of Fives
Seat 9: luizmattoz folded before Flop (didn't bet)



PokerStars Hand #221586136059: Tournament #3074230175, $0.98+$0.12 USD Hold'em No Limit - Level VIII (75/150) - 2020/12/18 23:49:25 EET [2020/12/18 16:49:25 ET]
Table '3074230175 55' 9-max Seat #3 is the button
Seat 1: guiterman (10558 in chips) 
Seat 2: chaoukidiv10 (4852 in chips) 
Seat 3: maciel1986 (3483 in chips) 
Seat 4: jcarlos.vale (5196 in chips) 
Seat 5: ImCrazyFish (1015 in chips) is sitting out
Seat 6: fern46 (2111 in chips) 
Seat 7: Jeppekanin14 (9075 in chips) 
Seat 8: BMW 812 (3276 in chips) 
Seat 9: luizmattoz (2430 in chips) 
guiterman: posts the ante 20
chaoukidiv10: posts the ante 20
maciel1986: posts the ante 20
jcarlos.vale: posts the ante 20
ImCrazyFish: posts the ante 20
fern46: posts the ante 20
Jeppekanin14: posts the ante 20
BMW 812: posts the ante 20
luizmattoz: posts the ante 20
jcarlos.vale: posts small blind 75
ImCrazyFish: posts big blind 150
*** HOLE CARDS ***
Dealt to jcarlos.vale [Jd Qd]
fern46: folds 
Jeppekanin14: folds 
BMW 812: folds 
luizmattoz: folds 
guiterman: folds 
chaoukidiv10: raises 4682 to 4832 and is all-in
maciel1986: calls 3463 and is all-in
jcarlos.vale: folds 
ImCrazyFish: folds 
Uncalled bet (1369) returned to chaoukidiv10
*** FLOP *** [4h 3d Ad]
*** TURN *** [4h 3d Ad] [Qs]
*** RIVER *** [4h 3d Ad Qs] [Kh]
*** SHOW DOWN ***
chaoukidiv10: shows [Ac 6h] (a pair of Aces)
maciel1986: shows [7c 7d] (a pair of Sevens)
chaoukidiv10 collected 7331 from pot
maciel1986 finished the tournament in 510th place
*** SUMMARY ***
Total pot 7331 | Rake 0 
Board [4h 3d Ad Qs Kh]
Seat 1: guiterman folded before Flop (didn't bet)
Seat 2: chaoukidiv10 showed [Ac 6h] and won (7331) with a pair of Aces
Seat 3: maciel1986 (button) showed [7c 7d] and lost with a pair of Sevens
Seat 4: jcarlos.vale (small blind) folded before Flop
Seat 5: ImCrazyFish (big blind) folded before Flop
Seat 6: fern46 folded before Flop (didn't bet)
Seat 7: Jeppekanin14 folded before Flop (didn't bet)
Seat 8: BMW 812 folded before Flop (didn't bet)
Seat 9: luizmattoz folded before Flop (didn't bet)



PokerStars Hand #221586167987: Tournament #3074230175, $0.98+$0.12 USD Hold'em No Limit - Level VIII (75/150) - 2020/12/18 23:50:08 EET [2020/12/18 16:50:08 ET]
Table '3074230175 55' 9-max Seat #4 is the button
Seat 1: guiterman (10538 in chips) 
Seat 2: chaoukidiv10 (8700 in chips) 
Seat 4: jcarlos.vale (5101 in chips) 
Seat 5: ImCrazyFish (845 in chips) is sitting out
Seat 6: fern46 (2091 in chips) 
Seat 7: Jeppekanin14 (9055 in chips) 
Seat 8: BMW 812 (3256 in chips) 
Seat 9: luizmattoz (2410 in chips) 
guiterman: posts the ante 20
chaoukidiv10: posts the ante 20
jcarlos.vale: posts the ante 20
ImCrazyFish: posts the ante 20
fern46: posts the ante 20
Jeppekanin14: posts the ante 20
BMW 812: posts the ante 20
luizmattoz: posts the ante 20
ImCrazyFish: posts small blind 75
fern46: posts big blind 150
*** HOLE CARDS ***
Dealt to jcarlos.vale [Qd 7h]
Jeppekanin14: calls 150
BMW 812: folds 
luizmattoz: raises 180 to 330
guiterman: folds 
chaoukidiv10: raises 8350 to 8680 and is all-in
jcarlos.vale: folds 
ImCrazyFish: folds 
fern46: folds 
Jeppekanin14 is disconnected 
Jeppekanin14 has timed out while disconnected
Jeppekanin14: folds 
Jeppekanin14 is sitting out
luizmattoz: folds 
Uncalled bet (8350) returned to chaoukidiv10
chaoukidiv10 collected 1195 from pot
chaoukidiv10: doesn't show handDTO
*** SUMMARY ***
Total pot 1195 | Rake 0 
Seat 1: guiterman folded before Flop (didn't bet)
Seat 2: chaoukidiv10 collected (1195)
Seat 4: jcarlos.vale (button) folded before Flop (didn't bet)
Seat 5: ImCrazyFish (small blind) folded before Flop
Seat 6: fern46 (big blind) folded before Flop
Seat 7: Jeppekanin14 folded before Flop
Seat 8: BMW 812 folded before Flop (didn't bet)
Seat 9: luizmattoz folded before Flop



PokerStars Hand #221586209992: Tournament #3074230175, $0.98+$0.12 USD Hold'em No Limit - Level VIII (75/150) - 2020/12/18 23:51:04 EET [2020/12/18 16:51:04 ET]
Table '3074230175 55' 9-max Seat #5 is the button
Seat 1: guiterman (10518 in chips) 
Seat 2: chaoukidiv10 (9545 in chips) 
Seat 3: LetsFish14 (3655 in chips) 
Seat 4: jcarlos.vale (5081 in chips) 
Seat 5: ImCrazyFish (750 in chips) is sitting out
Seat 6: fern46 (1921 in chips) 
Seat 7: Jeppekanin14 (8885 in chips) is sitting out
Seat 8: BMW 812 (3236 in chips) 
Seat 9: luizmattoz (2060 in chips) 
guiterman: posts the ante 20
chaoukidiv10: posts the ante 20
LetsFish14: posts the ante 20
jcarlos.vale: posts the ante 20
ImCrazyFish: posts the ante 20
fern46: posts the ante 20
Jeppekanin14: posts the ante 20
BMW 812: posts the ante 20
luizmattoz: posts the ante 20
fern46: posts small blind 75
Jeppekanin14: posts big blind 150
*** HOLE CARDS ***
Dealt to jcarlos.vale [Ad 8s]
Jeppekanin14 has returned
BMW 812: folds 
luizmattoz: folds 
guiterman: folds 
chaoukidiv10: calls 150
LetsFish14: folds 
jcarlos.vale: folds 
ImCrazyFish: folds 
fern46: calls 75
Jeppekanin14: checks 
*** FLOP *** [3s 7s 7h]
fern46: checks 
Jeppekanin14: checks 
chaoukidiv10: checks 
*** TURN *** [3s 7s 7h] [Td]
fern46: checks 
Jeppekanin14: checks 
chaoukidiv10: checks 
*** RIVER *** [3s 7s 7h Td] [7c]
fern46: checks 
Jeppekanin14: checks 
chaoukidiv10: checks 
*** SHOW DOWN ***
fern46: shows [Ah 8d] (three of a kind, Sevens)
Jeppekanin14: mucks handDTO
chaoukidiv10: mucks handDTO
fern46 collected 630 from pot
Jeppekanin14 is sitting out
*** SUMMARY ***
Total pot 630 | Rake 0 
Board [3s 7s 7h Td 7c]
Seat 1: guiterman folded before Flop (didn't bet)
Seat 2: chaoukidiv10 mucked [5h Qs]
Seat 3: LetsFish14 folded before Flop (didn't bet)
Seat 4: jcarlos.vale folded before Flop (didn't bet)
Seat 5: ImCrazyFish (button) folded before Flop (didn't bet)
Seat 6: fern46 (small blind) showed [Ah 8d] and won (630) with three of a kind, Sevens
Seat 7: Jeppekanin14 (big blind) mucked [2h 6d]
Seat 8: BMW 812 folded before Flop (didn't bet)
Seat 9: luizmattoz folded before Flop (didn't bet)



PokerStars Hand #221586235608: Tournament #3074230175, $0.98+$0.12 USD Hold'em No Limit - Level VIII (75/150) - 2020/12/18 23:51:38 EET [2020/12/18 16:51:38 ET]
Table '3074230175 55' 9-max Seat #6 is the button
Seat 1: guiterman (10498 in chips) 
Seat 2: chaoukidiv10 (9375 in chips) 
Seat 3: LetsFish14 (3635 in chips) 
Seat 4: jcarlos.vale (5061 in chips) 
Seat 5: ImCrazyFish (730 in chips) is sitting out
Seat 6: fern46 (2381 in chips) 
Seat 7: Jeppekanin14 (8715 in chips) is sitting out
Seat 8: BMW 812 (3216 in chips) 
Seat 9: luizmattoz (2040 in chips) 
guiterman: posts the ante 20
chaoukidiv10: posts the ante 20
LetsFish14: posts the ante 20
jcarlos.vale: posts the ante 20
ImCrazyFish: posts the ante 20
fern46: posts the ante 20
Jeppekanin14: posts the ante 20
BMW 812: posts the ante 20
luizmattoz: posts the ante 20
Jeppekanin14: posts small blind 75
BMW 812: posts big blind 150
*** HOLE CARDS ***
Dealt to jcarlos.vale [Tc Ts]
Jeppekanin14 has returned
luizmattoz: folds 
guiterman: folds 
chaoukidiv10: raises 9205 to 9355 and is all-in
LetsFish14: folds 
jcarlos.vale: calls 5041 and is all-in
ImCrazyFish: folds 
fern46: folds 
Jeppekanin14: folds 
BMW 812: folds 
Uncalled bet (4314) returned to chaoukidiv10
*** FLOP *** [7s 6d Jd]
*** TURN *** [7s 6d Jd] [3s]
*** RIVER *** [7s 6d Jd 3s] [3d]
*** SHOW DOWN ***
chaoukidiv10: shows [Ah Kh] (a pair of Threes)
jcarlos.vale: shows [Tc Ts] (two pair, Tens and Threes)
jcarlos.vale collected 10487 from pot
*** SUMMARY ***
Total pot 10487 | Rake 0 
Board [7s 6d Jd 3s 3d]
Seat 1: guiterman folded before Flop (didn't bet)
Seat 2: chaoukidiv10 showed [Ah Kh] and lost with a pair of Threes
Seat 3: LetsFish14 folded before Flop (didn't bet)
Seat 4: jcarlos.vale showed [Tc Ts] and won (10487) with two pair, Tens and Threes
Seat 5: ImCrazyFish folded before Flop (didn't bet)
Seat 6: fern46 (button) folded before Flop (didn't bet)
Seat 7: Jeppekanin14 (small blind) folded before Flop
Seat 8: BMW 812 (big blind) folded before Flop
Seat 9: luizmattoz folded before Flop (didn't bet)



PokerStars Hand #221586261918: Tournament #3074230175, $0.98+$0.12 USD Hold'em No Limit - Level VIII (75/150) - 2020/12/18 23:52:13 EET [2020/12/18 16:52:13 ET]
Table '3074230175 55' 9-max Seat #7 is the button
Seat 1: guiterman (10478 in chips) 
Seat 2: chaoukidiv10 (4314 in chips) 
Seat 3: LetsFish14 (3615 in chips) 
Seat 4: jcarlos.vale (10487 in chips) 
Seat 5: ImCrazyFish (710 in chips) is sitting out
Seat 6: fern46 (2361 in chips) 
Seat 7: Jeppekanin14 (8620 in chips) 
Seat 8: BMW 812 (3046 in chips) 
Seat 9: luizmattoz (2020 in chips) 
guiterman: posts the ante 20
chaoukidiv10: posts the ante 20
LetsFish14: posts the ante 20
jcarlos.vale: posts the ante 20
ImCrazyFish: posts the ante 20
fern46: posts the ante 20
Jeppekanin14: posts the ante 20
BMW 812: posts the ante 20
luizmattoz: posts the ante 20
BMW 812: posts small blind 75
luizmattoz: posts big blind 150
*** HOLE CARDS ***
Dealt to jcarlos.vale [Ad 2c]
guiterman: folds 
chaoukidiv10: raises 4144 to 4294 and is all-in
LetsFish14: folds 
jcarlos.vale: folds 
ImCrazyFish: folds 
fern46: folds 
Jeppekanin14 has timed out
Jeppekanin14: folds 
Jeppekanin14 is sitting out
BMW 812: calls 2951 and is all-in
luizmattoz: folds 
Uncalled bet (1268) returned to chaoukidiv10
*** FLOP *** [Ks 2d 5s]
*** TURN *** [Ks 2d 5s] [Qh]
*** RIVER *** [Ks 2d 5s Qh] [Ac]
*** SHOW DOWN ***
BMW 812: shows [Th Ah] (a pair of Aces)
chaoukidiv10: shows [Ts Kd] (a pair of Kings)
BMW 812 collected 6382 from pot
*** SUMMARY ***
Total pot 6382 | Rake 0 
Board [Ks 2d 5s Qh Ac]
Seat 1: guiterman folded before Flop (didn't bet)
Seat 2: chaoukidiv10 showed [Ts Kd] and lost with a pair of Kings
Seat 3: LetsFish14 folded before Flop (didn't bet)
Seat 4: jcarlos.vale folded before Flop (didn't bet)
Seat 5: ImCrazyFish folded before Flop (didn't bet)
Seat 6: fern46 folded before Flop (didn't bet)
Seat 7: Jeppekanin14 (button) folded before Flop (didn't bet)
Seat 8: BMW 812 (small blind) showed [Th Ah] and won (6382) with a pair of Aces
Seat 9: luizmattoz (big blind) folded before Flop



PokerStars Hand #221586323032: Tournament #3074230175, $0.98+$0.12 USD Hold'em No Limit - Level VIII (75/150) - 2020/12/18 23:53:35 EET [2020/12/18 16:53:35 ET]
Table '3074230175 55' 9-max Seat #8 is the button
Seat 1: guiterman (10458 in chips) 
Seat 2: chaoukidiv10 (1268 in chips) 
Seat 3: LetsFish14 (3595 in chips) 
Seat 4: jcarlos.vale (10467 in chips) 
Seat 5: ImCrazyFish (690 in chips) is sitting out
Seat 6: fern46 (2341 in chips) 
Seat 7: Jeppekanin14 (8600 in chips) is sitting out
Seat 8: BMW 812 (6382 in chips) 
Seat 9: luizmattoz (1850 in chips) 
guiterman: posts the ante 20
chaoukidiv10: posts the ante 20
LetsFish14: posts the ante 20
jcarlos.vale: posts the ante 20
ImCrazyFish: posts the ante 20
fern46: posts the ante 20
Jeppekanin14: posts the ante 20
BMW 812: posts the ante 20
luizmattoz: posts the ante 20
luizmattoz: posts small blind 75
guiterman: posts big blind 150
*** HOLE CARDS ***
Dealt to jcarlos.vale [7s 2s]
chaoukidiv10: raises 1098 to 1248 and is all-in
LetsFish14: folds 
jcarlos.vale: folds 
ImCrazyFish: folds 
fern46: folds 
Jeppekanin14: folds 
BMW 812: calls 1248
luizmattoz: folds 
guiterman: folds 
*** FLOP *** [7c 5s 9s]
*** TURN *** [7c 5s 9s] [3c]
*** RIVER *** [7c 5s 9s 3c] [9d]
*** SHOW DOWN ***
chaoukidiv10: shows [Th 8s] (a pair of Nines)
BMW 812: shows [Ad 5c] (two pair, Nines and Fives)
BMW 812 collected 2901 from pot
chaoukidiv10 finished the tournament in 456th place
*** SUMMARY ***
Total pot 2901 | Rake 0 
Board [7c 5s 9s 3c 9d]
Seat 1: guiterman (big blind) folded before Flop
Seat 2: chaoukidiv10 showed [Th 8s] and lost with a pair of Nines
Seat 3: LetsFish14 folded before Flop (didn't bet)
Seat 4: jcarlos.vale folded before Flop (didn't bet)
Seat 5: ImCrazyFish folded before Flop (didn't bet)
Seat 6: fern46 folded before Flop (didn't bet)
Seat 7: Jeppekanin14 folded before Flop (didn't bet)
Seat 8: BMW 812 (button) showed [Ad 5c] and won (2901) with two pair, Nines and Fives
Seat 9: luizmattoz (small blind) folded before Flop



PokerStars Hand #221586338230: Tournament #3074230175, $0.98+$0.12 USD Hold'em No Limit - Level VIII (75/150) - 2020/12/18 23:53:55 EET [2020/12/18 16:53:55 ET]
Table '3074230175 55' 9-max Seat #9 is the button
Seat 1: guiterman (10288 in chips) 
Seat 3: LetsFish14 (3575 in chips) 
Seat 4: jcarlos.vale (10447 in chips) 
Seat 5: ImCrazyFish (670 in chips) is sitting out
Seat 6: fern46 (2321 in chips) 
Seat 7: Jeppekanin14 (8580 in chips) is sitting out
Seat 8: BMW 812 (8015 in chips) 
Seat 9: luizmattoz (1755 in chips) 
guiterman: posts the ante 20
LetsFish14: posts the ante 20
jcarlos.vale: posts the ante 20
ImCrazyFish: posts the ante 20
fern46: posts the ante 20
Jeppekanin14: posts the ante 20
BMW 812: posts the ante 20
luizmattoz: posts the ante 20
guiterman: posts small blind 75
LetsFish14: posts big blind 150
*** HOLE CARDS ***
Dealt to jcarlos.vale [3h 2c]
jcarlos.vale: folds 
ImCrazyFish: folds 
fern46: folds 
Jeppekanin14: folds 
BMW 812: folds 
luizmattoz: raises 1585 to 1735 and is all-in
guiterman: folds 
LetsFish14: calls 1585
*** FLOP *** [8h 6c Js]
*** TURN *** [8h 6c Js] [4h]
*** RIVER *** [8h 6c Js 4h] [As]
*** SHOW DOWN ***
LetsFish14: shows [Th Ts] (a pair of Tens)
luizmattoz: shows [9h Qd] (high pairOfCards Ace)
LetsFish14 collected 3705 from pot
luizmattoz finished the tournament in 452nd place
*** SUMMARY ***
Total pot 3705 | Rake 0 
Board [8h 6c Js 4h As]
Seat 1: guiterman (small blind) folded before Flop
Seat 3: LetsFish14 (big blind) showed [Th Ts] and won (3705) with a pair of Tens
Seat 4: jcarlos.vale folded before Flop (didn't bet)
Seat 5: ImCrazyFish folded before Flop (didn't bet)
Seat 6: fern46 folded before Flop (didn't bet)
Seat 7: Jeppekanin14 folded before Flop (didn't bet)
Seat 8: BMW 812 folded before Flop (didn't bet)
Seat 9: luizmattoz (button) showed [9h Qd] and lost with high pairOfCards Ace



PokerStars Hand #221586363596: Tournament #3074230175, $0.98+$0.12 USD Hold'em No Limit - Level VIII (75/150) - 2020/12/18 23:54:29 EET [2020/12/18 16:54:29 ET]
Table '3074230175 55' 9-max Seat #1 is the button
Seat 1: guiterman (10193 in chips) 
Seat 3: LetsFish14 (5525 in chips) 
Seat 4: jcarlos.vale (10427 in chips) 
Seat 5: ImCrazyFish (650 in chips) is sitting out
Seat 6: fern46 (2301 in chips) 
Seat 7: Jeppekanin14 (8560 in chips) is sitting out
Seat 8: BMW 812 (7995 in chips) 
guiterman: posts the ante 20
LetsFish14: posts the ante 20
jcarlos.vale: posts the ante 20
ImCrazyFish: posts the ante 20
fern46: posts the ante 20
Jeppekanin14: posts the ante 20
BMW 812: posts the ante 20
LetsFish14: posts small blind 75
jcarlos.vale: posts big blind 150
*** HOLE CARDS ***
Dealt to jcarlos.vale [8c Js]
ImCrazyFish: folds 
fern46: calls 150
Jeppekanin14: folds 
BMW 812: folds 
guiterman: folds 
LetsFish14: folds 
jcarlos.vale: checks 
*** FLOP *** [Qs 5s Jd]
jcarlos.vale: bets 258
fern46: folds 
Uncalled bet (258) returned to jcarlos.vale
jcarlos.vale collected 515 from pot
jcarlos.vale: doesn't show handDTO
*** SUMMARY ***
Total pot 515 | Rake 0 
Board [Qs 5s Jd]
Seat 1: guiterman (button) folded before Flop (didn't bet)
Seat 3: LetsFish14 (small blind) folded before Flop
Seat 4: jcarlos.vale (big blind) collected (515)
Seat 5: ImCrazyFish folded before Flop (didn't bet)
Seat 6: fern46 folded on the Flop
Seat 7: Jeppekanin14 folded before Flop (didn't bet)
Seat 8: BMW 812 folded before Flop (didn't bet)



PokerStars Hand #221586384168: Tournament #3074230175, $0.98+$0.12 USD Hold'em No Limit - Level VIII (75/150) - 2020/12/18 23:54:57 EET [2020/12/18 16:54:57 ET]
Table '3074230175 55' 9-max Seat #3 is the button
Seat 1: guiterman (10173 in chips) 
Seat 2: Sandwiches17 (7950 in chips) 
Seat 3: LetsFish14 (5430 in chips) 
Seat 4: jcarlos.vale (10772 in chips) 
Seat 5: ImCrazyFish (630 in chips) is sitting out
Seat 6: fern46 (2131 in chips) 
Seat 7: Jeppekanin14 (8540 in chips) is sitting out
Seat 8: BMW 812 (7975 in chips) 
Seat 9: gelorist (15045 in chips) 
guiterman: posts the ante 20
Sandwiches17: posts the ante 20
LetsFish14: posts the ante 20
jcarlos.vale: posts the ante 20
ImCrazyFish: posts the ante 20
fern46: posts the ante 20
Jeppekanin14: posts the ante 20
BMW 812: posts the ante 20
gelorist: posts the ante 20
jcarlos.vale: posts small blind 75
ImCrazyFish: posts big blind 150
*** HOLE CARDS ***
Dealt to jcarlos.vale [Ad 3d]
fern46: folds 
Jeppekanin14: folds 
BMW 812: folds 
gelorist: calls 150
guiterman: folds 
Sandwiches17: raises 300 to 450
LetsFish14: folds 
jcarlos.vale: folds 
ImCrazyFish: folds 
gelorist: calls 300
*** FLOP *** [4h 9d 8s]
gelorist: bets 300
Sandwiches17: calls 300
*** TURN *** [4h 9d 8s] [3h]
gelorist: bets 900
Sandwiches17: calls 900
*** RIVER *** [4h 9d 8s 3h] [2c]
gelorist: bets 2100
Sandwiches17: folds 
Uncalled bet (2100) returned to gelorist
gelorist collected 3705 from pot
gelorist: doesn't show handDTO
*** SUMMARY ***
Total pot 3705 | Rake 0 
Board [4h 9d 8s 3h 2c]
Seat 1: guiterman folded before Flop (didn't bet)
Seat 2: Sandwiches17 folded on the River
Seat 3: LetsFish14 (button) folded before Flop (didn't bet)
Seat 4: jcarlos.vale (small blind) folded before Flop
Seat 5: ImCrazyFish (big blind) folded before Flop
Seat 6: fern46 folded before Flop (didn't bet)
Seat 7: Jeppekanin14 folded before Flop (didn't bet)
Seat 8: BMW 812 folded before Flop (didn't bet)
Seat 9: gelorist collected (3705)



PokerStars Hand #221586610151: Tournament #3074230175, $0.98+$0.12 USD Hold'em No Limit - Level VIII (75/150) - 2020/12/19 0:01:32 EET [2020/12/18 17:01:32 ET]
Table '3074230175 55' 9-max Seat #4 is the button
Seat 1: guiterman (10153 in chips) 
Seat 2: Sandwiches17 (6280 in chips) 
Seat 3: LetsFish14 (5410 in chips) 
Seat 4: jcarlos.vale (10677 in chips) 
Seat 5: ImCrazyFish (460 in chips) is sitting out
Seat 6: fern46 (2111 in chips) 
Seat 7: Jeppekanin14 (8520 in chips) 
Seat 8: BMW 812 (7955 in chips) 
Seat 9: gelorist (17080 in chips) 
guiterman: posts the ante 20
Sandwiches17: posts the ante 20
LetsFish14: posts the ante 20
jcarlos.vale: posts the ante 20
ImCrazyFish: posts the ante 20
fern46: posts the ante 20
Jeppekanin14: posts the ante 20
BMW 812: posts the ante 20
gelorist: posts the ante 20
ImCrazyFish: posts small blind 75
fern46: posts big blind 150
*** HOLE CARDS ***
Dealt to jcarlos.vale [7c 4d]
Jeppekanin14 has timed out
Jeppekanin14: folds 
Jeppekanin14 is sitting out
BMW 812: raises 300 to 450
gelorist: calls 450
guiterman: folds 
Sandwiches17: folds 
LetsFish14: folds 
Jeppekanin14 has returned
jcarlos.vale: folds 
ImCrazyFish: folds 
fern46: folds 
*** FLOP *** [Kc Ah 5s]
BMW 812: bets 900
gelorist: calls 900
*** TURN *** [Kc Ah 5s] [Jh]
BMW 812: bets 1800
gelorist: calls 1800
*** RIVER *** [Kc Ah 5s Jh] [2s]
BMW 812: bets 3600
gelorist: calls 3600
*** SHOW DOWN ***
BMW 812: shows [Jd Jc] (three of a kind, Jacks)
gelorist: mucks handDTO
BMW 812 collected 13905 from pot
*** SUMMARY ***
Total pot 13905 | Rake 0 
Board [Kc Ah 5s Jh 2s]
Seat 1: guiterman folded before Flop (didn't bet)
Seat 2: Sandwiches17 folded before Flop (didn't bet)
Seat 3: LetsFish14 folded before Flop (didn't bet)
Seat 4: jcarlos.vale (button) folded before Flop (didn't bet)
Seat 5: ImCrazyFish (small blind) folded before Flop
Seat 6: fern46 (big blind) folded before Flop
Seat 7: Jeppekanin14 folded before Flop (didn't bet)
Seat 8: BMW 812 showed [Jd Jc] and won (13905) with three of a kind, Jacks
Seat 9: gelorist mucked [Ks Qd]



PokerStars Hand #221586656808: Tournament #3074230175, $0.98+$0.12 USD Hold'em No Limit - Level VIII (75/150) - 2020/12/19 0:02:36 EET [2020/12/18 17:02:36 ET]
Table '3074230175 55' 9-max Seat #5 is the button
Seat 1: guiterman (10133 in chips) 
Seat 2: Sandwiches17 (6260 in chips) 
Seat 3: LetsFish14 (5390 in chips) 
Seat 4: jcarlos.vale (10657 in chips) 
Seat 5: ImCrazyFish (365 in chips) is sitting out
Seat 6: fern46 (1941 in chips) 
Seat 7: Jeppekanin14 (8500 in chips) 
Seat 8: BMW 812 (15090 in chips) 
Seat 9: gelorist (10310 in chips) 
guiterman: posts the ante 20
Sandwiches17: posts the ante 20
LetsFish14: posts the ante 20
jcarlos.vale: posts the ante 20
ImCrazyFish: posts the ante 20
fern46: posts the ante 20
Jeppekanin14: posts the ante 20
BMW 812: posts the ante 20
gelorist: posts the ante 20
fern46: posts small blind 75
Jeppekanin14: posts big blind 150
*** HOLE CARDS ***
Dealt to jcarlos.vale [7c 6s]
BMW 812: raises 150 to 300
gelorist: calls 300
guiterman: folds 
Sandwiches17: folds 
LetsFish14: folds 
jcarlos.vale: folds 
ImCrazyFish: folds 
fern46: folds 
Jeppekanin14: calls 150
*** FLOP *** [3d 9h 4s]
Jeppekanin14: bets 578
BMW 812: folds 
gelorist: calls 578
*** TURN *** [3d 9h 4s] [5d]
Jeppekanin14: checks 
gelorist: bets 900
Jeppekanin14: raises 2056 to 2956
gelorist: folds 
Uncalled bet (2056) returned to Jeppekanin14
Jeppekanin14 collected 4111 from pot
Jeppekanin14: doesn't show handDTO
*** SUMMARY ***
Total pot 4111 | Rake 0 
Board [3d 9h 4s 5d]
Seat 1: guiterman folded before Flop (didn't bet)
Seat 2: Sandwiches17 folded before Flop (didn't bet)
Seat 3: LetsFish14 folded before Flop (didn't bet)
Seat 4: jcarlos.vale folded before Flop (didn't bet)
Seat 5: ImCrazyFish (button) folded before Flop (didn't bet)
Seat 6: fern46 (small blind) folded before Flop
Seat 7: Jeppekanin14 (big blind) collected (4111)
Seat 8: BMW 812 folded on the Flop
Seat 9: gelorist folded on the Turn



PokerStars Hand #221586700869: Tournament #3074230175, $0.98+$0.12 USD Hold'em No Limit - Level IX (100/200) - 2020/12/19 0:03:36 EET [2020/12/18 17:03:36 ET]
Table '3074230175 55' 9-max Seat #6 is the button
Seat 1: guiterman (10113 in chips) 
Seat 2: Sandwiches17 (6240 in chips) 
Seat 3: LetsFish14 (5370 in chips) 
Seat 4: jcarlos.vale (10637 in chips) 
Seat 5: ImCrazyFish (345 in chips) is sitting out
Seat 6: fern46 (1846 in chips) 
Seat 7: Jeppekanin14 (10813 in chips) 
Seat 8: BMW 812 (14770 in chips) 
Seat 9: gelorist (8512 in chips) 
guiterman: posts the ante 25
Sandwiches17: posts the ante 25
LetsFish14: posts the ante 25
jcarlos.vale: posts the ante 25
ImCrazyFish: posts the ante 25
fern46: posts the ante 25
Jeppekanin14: posts the ante 25
BMW 812: posts the ante 25
gelorist: posts the ante 25
Jeppekanin14: posts small blind 100
BMW 812: posts big blind 200
*** HOLE CARDS ***
Dealt to jcarlos.vale [5h 8s]
gelorist: raises 8287 to 8487 and is all-in
guiterman: folds 
Sandwiches17: folds 
LetsFish14: folds 
jcarlos.vale: folds 
ImCrazyFish: folds 
fern46: folds 
Jeppekanin14: folds 
BMW 812: folds 
Uncalled bet (8287) returned to gelorist
gelorist collected 725 from pot
gelorist: doesn't show handDTO
*** SUMMARY ***
Total pot 725 | Rake 0 
Seat 1: guiterman folded before Flop (didn't bet)
Seat 2: Sandwiches17 folded before Flop (didn't bet)
Seat 3: LetsFish14 folded before Flop (didn't bet)
Seat 4: jcarlos.vale folded before Flop (didn't bet)
Seat 5: ImCrazyFish folded before Flop (didn't bet)
Seat 6: fern46 (button) folded before Flop (didn't bet)
Seat 7: Jeppekanin14 (small blind) folded before Flop
Seat 8: BMW 812 (big blind) folded before Flop
Seat 9: gelorist collected (725)



PokerStars Hand #221586713229: Tournament #3074230175, $0.98+$0.12 USD Hold'em No Limit - Level IX (100/200) - 2020/12/19 0:03:52 EET [2020/12/18 17:03:52 ET]
Table '3074230175 55' 9-max Seat #7 is the button
Seat 1: guiterman (10088 in chips) 
Seat 2: Sandwiches17 (6215 in chips) 
Seat 3: LetsFish14 (5345 in chips) 
Seat 4: jcarlos.vale (10612 in chips) 
Seat 5: ImCrazyFish (320 in chips) is sitting out
Seat 6: fern46 (1821 in chips) 
Seat 7: Jeppekanin14 (10688 in chips) 
Seat 8: BMW 812 (14545 in chips) 
Seat 9: gelorist (9012 in chips) 
guiterman: posts the ante 25
Sandwiches17: posts the ante 25
LetsFish14: posts the ante 25
jcarlos.vale: posts the ante 25
ImCrazyFish: posts the ante 25
fern46: posts the ante 25
Jeppekanin14: posts the ante 25
BMW 812: posts the ante 25
gelorist: posts the ante 25
BMW 812: posts small blind 100
gelorist: posts big blind 200
*** HOLE CARDS ***
Dealt to jcarlos.vale [9h 3c]
guiterman: folds 
Sandwiches17: folds 
LetsFish14: folds 
jcarlos.vale: folds 
ImCrazyFish: folds 
fern46: folds 
Jeppekanin14: folds 
BMW 812: calls 100
gelorist: raises 600 to 800
BMW 812: calls 600
*** FLOP *** [9c 5c As]
BMW 812: checks 
gelorist: bets 600
BMW 812: raises 600 to 1200
gelorist: raises 1000 to 2200
BMW 812: folds 
Uncalled bet (1000) returned to gelorist
gelorist collected 4225 from pot
gelorist: doesn't show handDTO
*** SUMMARY ***
Total pot 4225 | Rake 0 
Board [9c 5c As]
Seat 1: guiterman folded before Flop (didn't bet)
Seat 2: Sandwiches17 folded before Flop (didn't bet)
Seat 3: LetsFish14 folded before Flop (didn't bet)
Seat 4: jcarlos.vale folded before Flop (didn't bet)
Seat 5: ImCrazyFish folded before Flop (didn't bet)
Seat 6: fern46 folded before Flop (didn't bet)
Seat 7: Jeppekanin14 (button) folded before Flop (didn't bet)
Seat 8: BMW 812 (small blind) folded on the Flop
Seat 9: gelorist (big blind) collected (4225)



PokerStars Hand #221586757042: Tournament #3074230175, $0.98+$0.12 USD Hold'em No Limit - Level IX (100/200) - 2020/12/19 0:04:51 EET [2020/12/18 17:04:51 ET]
Table '3074230175 55' 9-max Seat #8 is the button
Seat 1: guiterman (10063 in chips) 
Seat 2: Sandwiches17 (6190 in chips) 
Seat 3: LetsFish14 (5320 in chips) 
Seat 4: jcarlos.vale (10587 in chips) 
Seat 5: ImCrazyFish (295 in chips) is sitting out
Seat 6: fern46 (1796 in chips) 
Seat 7: Jeppekanin14 (10663 in chips) 
Seat 8: BMW 812 (12520 in chips) 
Seat 9: gelorist (11212 in chips) 
guiterman: posts the ante 25
Sandwiches17: posts the ante 25
LetsFish14: posts the ante 25
jcarlos.vale: posts the ante 25
ImCrazyFish: posts the ante 25
fern46: posts the ante 25
Jeppekanin14: posts the ante 25
BMW 812: posts the ante 25
gelorist: posts the ante 25
gelorist: posts small blind 100
guiterman: posts big blind 200
*** HOLE CARDS ***
Dealt to jcarlos.vale [Tc Td]
Sandwiches17: folds 
LetsFish14: folds 
jcarlos.vale: raises 320 to 520
ImCrazyFish: folds 
fern46: folds 
Jeppekanin14: raises 1180 to 1700
BMW 812: folds 
gelorist: folds 
guiterman: folds 
jcarlos.vale: folds 
Uncalled bet (1180) returned to Jeppekanin14
Jeppekanin14 collected 1565 from pot
Jeppekanin14: doesn't show handDTO
*** SUMMARY ***
Total pot 1565 | Rake 0 
Seat 1: guiterman (big blind) folded before Flop
Seat 2: Sandwiches17 folded before Flop (didn't bet)
Seat 3: LetsFish14 folded before Flop (didn't bet)
Seat 4: jcarlos.vale folded before Flop
Seat 5: ImCrazyFish folded before Flop (didn't bet)
Seat 6: fern46 folded before Flop (didn't bet)
Seat 7: Jeppekanin14 collected (1565)
Seat 8: BMW 812 (button) folded before Flop (didn't bet)
Seat 9: gelorist (small blind) folded before Flop



PokerStars Hand #221586791452: Tournament #3074230175, $0.98+$0.12 USD Hold'em No Limit - Level IX (100/200) - 2020/12/19 0:05:37 EET [2020/12/18 17:05:37 ET]
Table '3074230175 55' 9-max Seat #9 is the button
Seat 1: guiterman (9838 in chips) 
Seat 2: Sandwiches17 (6165 in chips) 
Seat 3: LetsFish14 (5295 in chips) 
Seat 4: jcarlos.vale (10042 in chips) 
Seat 5: ImCrazyFish (270 in chips) is sitting out
Seat 6: fern46 (1771 in chips) 
Seat 7: Jeppekanin14 (11683 in chips) 
Seat 8: BMW 812 (12495 in chips) 
Seat 9: gelorist (11087 in chips) 
guiterman: posts the ante 25
Sandwiches17: posts the ante 25
LetsFish14: posts the ante 25
jcarlos.vale: posts the ante 25
ImCrazyFish: posts the ante 25
fern46: posts the ante 25
Jeppekanin14: posts the ante 25
BMW 812: posts the ante 25
gelorist: posts the ante 25
guiterman: posts small blind 100
Sandwiches17: posts big blind 200
*** HOLE CARDS ***
Dealt to jcarlos.vale [4c 8h]
LetsFish14: folds 
jcarlos.vale: folds 
ImCrazyFish: folds 
fern46: folds 
Jeppekanin14: folds 
BMW 812: folds 
gelorist: calls 200
guiterman: calls 100
Sandwiches17: raises 5940 to 6140 and is all-in
gelorist: calls 5940
guiterman: folds 
*** FLOP *** [8c 9s Qc]
*** TURN *** [8c 9s Qc] [2d]
*** RIVER *** [8c 9s Qc 2d] [Qs]
*** SHOW DOWN ***
Sandwiches17: shows [Ac Kc] (a pair of Queens)
gelorist: shows [Ts Jd] (a straight, Eight to Queen)
gelorist collected 12705 from pot
Sandwiches17 finished the tournament in 409th place
*** SUMMARY ***
Total pot 12705 | Rake 0 
Board [8c 9s Qc 2d Qs]
Seat 1: guiterman (small blind) folded before Flop
Seat 2: Sandwiches17 (big blind) showed [Ac Kc] and lost with a pair of Queens
Seat 3: LetsFish14 folded before Flop (didn't bet)
Seat 4: jcarlos.vale folded before Flop (didn't bet)
Seat 5: ImCrazyFish folded before Flop (didn't bet)
Seat 6: fern46 folded before Flop (didn't bet)
Seat 7: Jeppekanin14 folded before Flop (didn't bet)
Seat 8: BMW 812 folded before Flop (didn't bet)
Seat 9: gelorist (button) showed [Ts Jd] and won (12705) with a straight, Eight to Queen



PokerStars Hand #221586835645: Tournament #3074230175, $0.98+$0.12 USD Hold'em No Limit - Level IX (100/200) - 2020/12/19 0:06:37 EET [2020/12/18 17:06:37 ET]
Table '3074230175 55' 9-max Seat #1 is the button
Seat 1: guiterman (9613 in chips) 
Seat 3: LetsFish14 (5270 in chips) 
Seat 4: jcarlos.vale (10017 in chips) 
Seat 5: ImCrazyFish (245 in chips) is sitting out
Seat 6: fern46 (1746 in chips) 
Seat 7: Jeppekanin14 (11658 in chips) 
Seat 8: BMW 812 (12470 in chips) 
Seat 9: gelorist (17627 in chips) 
guiterman: posts the ante 25
LetsFish14: posts the ante 25
jcarlos.vale: posts the ante 25
ImCrazyFish: posts the ante 25
fern46: posts the ante 25
Jeppekanin14: posts the ante 25
BMW 812: posts the ante 25
gelorist: posts the ante 25
LetsFish14: posts small blind 100
jcarlos.vale: posts big blind 200
*** HOLE CARDS ***
Dealt to jcarlos.vale [3c Kd]
ImCrazyFish: folds 
fern46: folds 
Jeppekanin14: folds 
BMW 812: folds 
gelorist: calls 200
guiterman: folds 
LetsFish14: folds 
jcarlos.vale: checks 
*** FLOP *** [Th Kc Ks]
jcarlos.vale: checks 
gelorist: checks 
*** TURN *** [Th Kc Ks] [7d]
jcarlos.vale: bets 400
gelorist: folds 
Uncalled bet (400) returned to jcarlos.vale
jcarlos.vale collected 700 from pot
jcarlos.vale: doesn't show handDTO
*** SUMMARY ***
Total pot 700 | Rake 0 
Board [Th Kc Ks 7d]
Seat 1: guiterman (button) folded before Flop (didn't bet)
Seat 3: LetsFish14 (small blind) folded before Flop
Seat 4: jcarlos.vale (big blind) collected (700)
Seat 5: ImCrazyFish folded before Flop (didn't bet)
Seat 6: fern46 folded before Flop (didn't bet)
Seat 7: Jeppekanin14 folded before Flop (didn't bet)
Seat 8: BMW 812 folded before Flop (didn't bet)
Seat 9: gelorist folded on the Turn



PokerStars Hand #221586890729: Tournament #3074230175, $0.98+$0.12 USD Hold'em No Limit - Level IX (100/200) - 2020/12/19 0:07:51 EET [2020/12/18 17:07:51 ET]
Table '3074230175 55' 9-max Seat #3 is the button
Seat 1: guiterman (9588 in chips) 
Seat 2: gerida (10826 in chips) 
Seat 3: LetsFish14 (5145 in chips) 
Seat 4: jcarlos.vale (10492 in chips) 
Seat 5: ImCrazyFish (220 in chips) is sitting out
Seat 6: fern46 (1721 in chips) 
Seat 7: Jeppekanin14 (11633 in chips) 
Seat 8: BMW 812 (12445 in chips) 
Seat 9: gelorist (17402 in chips) 
guiterman: posts the ante 25
gerida: posts the ante 25
LetsFish14: posts the ante 25
jcarlos.vale: posts the ante 25
ImCrazyFish: posts the ante 25
fern46: posts the ante 25
Jeppekanin14: posts the ante 25
BMW 812: posts the ante 25
gelorist: posts the ante 25
jcarlos.vale: posts small blind 100
ImCrazyFish: posts big blind 195 and is all-in
*** HOLE CARDS ***
Dealt to jcarlos.vale [5s 6d]
fern46: folds 
Jeppekanin14: folds 
BMW 812: folds 
gelorist: raises 605 to 800
guiterman: folds 
gerida: folds 
LetsFish14: calls 800
jcarlos.vale: folds 
ImCrazyFish: folds 
*** FLOP *** [7h 4h 2h]
gelorist: bets 1000
LetsFish14: folds 
Uncalled bet (1000) returned to gelorist
gelorist collected 2120 from pot
ImCrazyFish finished the tournament in 392nd place
gelorist: doesn't show handDTO
*** SUMMARY ***
Total pot 2120 | Rake 0 
Board [7h 4h 2h]
Seat 1: guiterman folded before Flop (didn't bet)
Seat 2: gerida folded before Flop (didn't bet)
Seat 3: LetsFish14 (button) folded on the Flop
Seat 4: jcarlos.vale (small blind) folded before Flop
Seat 5: ImCrazyFish (big blind) folded before Flop
Seat 6: fern46 folded before Flop (didn't bet)
Seat 7: Jeppekanin14 folded before Flop (didn't bet)
Seat 8: BMW 812 folded before Flop (didn't bet)
Seat 9: gelorist collected (2120)



PokerStars Hand #221586924141: Tournament #3074230175, $0.98+$0.12 USD Hold'em No Limit - Level IX (100/200) - 2020/12/19 0:08:36 EET [2020/12/18 17:08:36 ET]
Table '3074230175 55' 9-max Seat #4 is the button
Seat 1: guiterman (9563 in chips) 
Seat 2: gerida (10801 in chips) 
Seat 3: LetsFish14 (4320 in chips) 
Seat 4: jcarlos.vale (10367 in chips) 
Seat 6: fern46 (1696 in chips) 
Seat 7: Jeppekanin14 (11608 in chips) 
Seat 8: BMW 812 (12420 in chips) 
Seat 9: gelorist (18697 in chips) 
guiterman: posts the ante 25
gerida: posts the ante 25
LetsFish14: posts the ante 25
jcarlos.vale: posts the ante 25
fern46: posts the ante 25
Jeppekanin14: posts the ante 25
BMW 812: posts the ante 25
gelorist: posts the ante 25
fern46: posts small blind 100
Jeppekanin14: posts big blind 200
*** HOLE CARDS ***
Dealt to jcarlos.vale [Qh 7h]
BMW 812: folds 
gelorist: folds 
guiterman: folds 
gerida: folds 
LetsFish14: folds 
jcarlos.vale: folds 
fern46: calls 100
Jeppekanin14: checks 
*** FLOP *** [6h Tc Kh]
fern46: checks 
Jeppekanin14: checks 
*** TURN *** [6h Tc Kh] [8d]
fern46: checks 
Jeppekanin14: checks 
*** RIVER *** [6h Tc Kh 8d] [3c]
fern46: checks 
Jeppekanin14: bets 200
fern46: folds 
Uncalled bet (200) returned to Jeppekanin14
Jeppekanin14 collected 600 from pot
Jeppekanin14: doesn't show handDTO
*** SUMMARY ***
Total pot 600 | Rake 0 
Board [6h Tc Kh 8d 3c]
Seat 1: guiterman folded before Flop (didn't bet)
Seat 2: gerida folded before Flop (didn't bet)
Seat 3: LetsFish14 folded before Flop (didn't bet)
Seat 4: jcarlos.vale (button) folded before Flop (didn't bet)
Seat 6: fern46 (small blind) folded on the River
Seat 7: Jeppekanin14 (big blind) collected (600)
Seat 8: BMW 812 folded before Flop (didn't bet)
Seat 9: gelorist folded before Flop (didn't bet)



PokerStars Hand #221586966803: Tournament #3074230175, $0.98+$0.12 USD Hold'em No Limit - Level IX (100/200) - 2020/12/19 0:09:33 EET [2020/12/18 17:09:33 ET]
Table '3074230175 55' 9-max Seat #6 is the button
Seat 1: guiterman (9538 in chips) 
Seat 2: gerida (10776 in chips) 
Seat 3: LetsFish14 (4295 in chips) 
Seat 4: jcarlos.vale (10342 in chips) 
Seat 5: progreees (2880 in chips) 
Seat 6: fern46 (1471 in chips) 
Seat 7: Jeppekanin14 (11983 in chips) 
Seat 8: BMW 812 (12395 in chips) 
Seat 9: gelorist (18672 in chips) 
guiterman: posts the ante 25
gerida: posts the ante 25
LetsFish14: posts the ante 25
jcarlos.vale: posts the ante 25
progreees: posts the ante 25
fern46: posts the ante 25
Jeppekanin14: posts the ante 25
BMW 812: posts the ante 25
gelorist: posts the ante 25
Jeppekanin14: posts small blind 100
BMW 812: posts big blind 200
*** HOLE CARDS ***
Dealt to jcarlos.vale [Qd 3s]
gelorist: folds 
guiterman: calls 200
gerida: folds 
LetsFish14: folds 
jcarlos.vale: folds 
progreees: folds 
fern46: folds 
Jeppekanin14: calls 100
BMW 812: checks 
*** FLOP *** [Js Ah 8s]
Jeppekanin14: checks 
BMW 812: checks 
guiterman: checks 
*** TURN *** [Js Ah 8s] [8d]
Jeppekanin14: checks 
BMW 812: bets 600
guiterman: calls 600
Jeppekanin14: calls 600
*** RIVER *** [Js Ah 8s 8d] [9d]
Jeppekanin14: checks 
BMW 812: checks 
guiterman: bets 1400
Jeppekanin14: calls 1400
BMW 812: folds 
*** SHOW DOWN ***
guiterman: shows [8c 8h] (four of a kind, Eights)
Jeppekanin14: mucks handDTO
guiterman collected 5425 from pot
*** SUMMARY ***
Total pot 5425 | Rake 0 
Board [Js Ah 8s 8d 9d]
Seat 1: guiterman showed [8c 8h] and won (5425) with four of a kind, Eights
Seat 2: gerida folded before Flop (didn't bet)
Seat 3: LetsFish14 folded before Flop (didn't bet)
Seat 4: jcarlos.vale folded before Flop (didn't bet)
Seat 5: progreees folded before Flop (didn't bet)
Seat 6: fern46 (button) folded before Flop (didn't bet)
Seat 7: Jeppekanin14 (small blind) mucked [9s Ad]
Seat 8: BMW 812 (big blind) folded on the River
Seat 9: gelorist folded before Flop (didn't bet)



PokerStars Hand #221587020339: Tournament #3074230175, $0.98+$0.12 USD Hold'em No Limit - Level IX (100/200) - 2020/12/19 0:10:45 EET [2020/12/18 17:10:45 ET]
Table '3074230175 55' 9-max Seat #7 is the button
Seat 1: guiterman (12738 in chips) 
Seat 2: gerida (10751 in chips) 
Seat 3: LetsFish14 (4270 in chips) 
Seat 4: jcarlos.vale (10317 in chips) 
Seat 5: progreees (2855 in chips) 
Seat 6: fern46 (1446 in chips) 
Seat 7: Jeppekanin14 (9758 in chips) 
Seat 8: BMW 812 (11570 in chips) 
Seat 9: gelorist (18647 in chips) 
guiterman: posts the ante 25
gerida: posts the ante 25
LetsFish14: posts the ante 25
jcarlos.vale: posts the ante 25
progreees: posts the ante 25
fern46: posts the ante 25
Jeppekanin14: posts the ante 25
BMW 812: posts the ante 25
gelorist: posts the ante 25
BMW 812: posts small blind 100
gelorist: posts big blind 200
*** HOLE CARDS ***
Dealt to jcarlos.vale [3d Qs]
Jeppekanin14 said, "ofc"
Jeppekanin14 said, "wp"
guiterman: folds 
gerida: calls 200
LetsFish14: folds 
jcarlos.vale: folds 
progreees: folds 
fern46: folds 
Jeppekanin14: folds 
BMW 812: calls 100
gelorist: checks 
*** FLOP *** [4s Ad 2h]
BMW 812: checks 
gelorist: checks 
gerida: checks 
*** TURN *** [4s Ad 2h] [5h]
BMW 812: checks 
gelorist: bets 600
gerida: folds 
BMW 812: folds 
Uncalled bet (600) returned to gelorist
gelorist collected 825 from pot
gelorist: doesn't show handDTO
*** SUMMARY ***
Total pot 825 | Rake 0 
Board [4s Ad 2h 5h]
Seat 1: guiterman folded before Flop (didn't bet)
Seat 2: gerida folded on the Turn
Seat 3: LetsFish14 folded before Flop (didn't bet)
Seat 4: jcarlos.vale folded before Flop (didn't bet)
Seat 5: progreees folded before Flop (didn't bet)
Seat 6: fern46 folded before Flop (didn't bet)
Seat 7: Jeppekanin14 (button) folded before Flop (didn't bet)
Seat 8: BMW 812 (small blind) folded on the Turn
Seat 9: gelorist (big blind) collected (825)



PokerStars Hand #221587063171: Tournament #3074230175, $0.98+$0.12 USD Hold'em No Limit - Level IX (100/200) - 2020/12/19 0:11:43 EET [2020/12/18 17:11:43 ET]
Table '3074230175 55' 9-max Seat #8 is the button
Seat 1: guiterman (12713 in chips) 
Seat 2: gerida (10526 in chips) 
Seat 3: LetsFish14 (4245 in chips) 
Seat 4: jcarlos.vale (10292 in chips) 
Seat 5: progreees (2830 in chips) 
Seat 6: fern46 (1421 in chips) 
Seat 7: Jeppekanin14 (9733 in chips) 
Seat 8: BMW 812 (11345 in chips) 
Seat 9: gelorist (19247 in chips) 
guiterman: posts the ante 25
gerida: posts the ante 25
LetsFish14: posts the ante 25
jcarlos.vale: posts the ante 25
progreees: posts the ante 25
fern46: posts the ante 25
Jeppekanin14: posts the ante 25
BMW 812: posts the ante 25
gelorist: posts the ante 25
gelorist: posts small blind 100
guiterman: posts big blind 200
*** HOLE CARDS ***
Dealt to jcarlos.vale [Ad 8d]
gerida: folds 
LetsFish14: folds 
jcarlos.vale: raises 320 to 520
progreees: raises 2285 to 2805 and is all-in
fern46: folds 
Jeppekanin14: folds 
BMW 812: folds 
gelorist: raises 2285 to 5090
guiterman: folds 
jcarlos.vale: folds 
Uncalled bet (2285) returned to gelorist
*** FLOP *** [3s 9d 7s]
*** TURN *** [3s 9d 7s] [2h]
*** RIVER *** [3s 9d 7s 2h] [6c]
*** SHOW DOWN ***
gelorist: shows [7d 7h] (three of a kind, Sevens)
progreees: shows [Ah Qs] (high pairOfCards Ace)
gelorist collected 6555 from pot
progreees finished the tournament in 355th place
*** SUMMARY ***
Total pot 6555 | Rake 0 
Board [3s 9d 7s 2h 6c]
Seat 1: guiterman (big blind) folded before Flop
Seat 2: gerida folded before Flop (didn't bet)
Seat 3: LetsFish14 folded before Flop (didn't bet)
Seat 4: jcarlos.vale folded before Flop
Seat 5: progreees showed [Ah Qs] and lost with high pairOfCards Ace
Seat 6: fern46 folded before Flop (didn't bet)
Seat 7: Jeppekanin14 folded before Flop (didn't bet)
Seat 8: BMW 812 (button) folded before Flop (didn't bet)
Seat 9: gelorist (small blind) showed [7d 7h] and won (6555) with three of a kind, Sevens



PokerStars Hand #221587103484: Tournament #3074230175, $0.98+$0.12 USD Hold'em No Limit - Level IX (100/200) - 2020/12/19 0:12:37 EET [2020/12/18 17:12:37 ET]
Table '3074230175 55' 9-max Seat #9 is the button
Seat 1: guiterman (12488 in chips) 
Seat 2: gerida (10501 in chips) 
Seat 3: LetsFish14 (4220 in chips) 
Seat 4: jcarlos.vale (9747 in chips) 
Seat 6: fern46 (1396 in chips) 
Seat 7: Jeppekanin14 (9708 in chips) 
Seat 8: BMW 812 (11320 in chips) 
Seat 9: gelorist (22972 in chips) 
guiterman: posts the ante 25
gerida: posts the ante 25
LetsFish14: posts the ante 25
jcarlos.vale: posts the ante 25
fern46: posts the ante 25
Jeppekanin14: posts the ante 25
BMW 812: posts the ante 25
gelorist: posts the ante 25
guiterman: posts small blind 100
gerida: posts big blind 200
*** HOLE CARDS ***
Dealt to jcarlos.vale [5d Qh]
LetsFish14: folds 
jcarlos.vale: folds 
fern46: folds 
Jeppekanin14: folds 
BMW 812: folds 
gelorist: calls 200
guiterman: calls 100
gerida: checks 
*** FLOP *** [Td Ah 8d]
guiterman: bets 200
gerida: calls 200
gelorist: calls 200
*** TURN *** [Td Ah 8d] [3d]
guiterman: checks 
gerida: checks 
gelorist: checks 
*** RIVER *** [Td Ah 8d 3d] [9d]
guiterman: bets 400
gerida: folds 
gelorist: calls 400
*** SHOW DOWN ***
guiterman: shows [Qd 8c] (a flush, Queen high)
gelorist: mucks handDTO
guiterman collected 2200 from pot
*** SUMMARY ***
Total pot 2200 | Rake 0 
Board [Td Ah 8d 3d 9d]
Seat 1: guiterman (small blind) showed [Qd 8c] and won (2200) with a flush, Queen high
Seat 2: gerida (big blind) folded on the River
Seat 3: LetsFish14 folded before Flop (didn't bet)
Seat 4: jcarlos.vale folded before Flop (didn't bet)
Seat 6: fern46 folded before Flop (didn't bet)
Seat 7: Jeppekanin14 folded before Flop (didn't bet)
Seat 8: BMW 812 folded before Flop (didn't bet)
Seat 9: gelorist (button) mucked [6d As]



PokerStars Hand #221587146874: Tournament #3074230175, $0.98+$0.12 USD Hold'em No Limit - Level X (125/250) - 2020/12/19 0:13:36 EET [2020/12/18 17:13:36 ET]
Table '3074230175 55' 9-max Seat #1 is the button
Seat 1: guiterman (13863 in chips) 
Seat 2: gerida (10076 in chips) 
Seat 3: LetsFish14 (4195 in chips) 
Seat 4: jcarlos.vale (9722 in chips) 
Seat 5: Uhrenknecht (1848 in chips) 
Seat 6: fern46 (1371 in chips) 
Seat 7: Jeppekanin14 (9683 in chips) 
Seat 8: BMW 812 (11295 in chips) 
Seat 9: gelorist (22147 in chips) 
guiterman: posts the ante 30
gerida: posts the ante 30
LetsFish14: posts the ante 30
jcarlos.vale: posts the ante 30
Uhrenknecht: posts the ante 30
fern46: posts the ante 30
Jeppekanin14: posts the ante 30
BMW 812: posts the ante 30
gelorist: posts the ante 30
gerida: posts small blind 125
LetsFish14: posts big blind 250
*** HOLE CARDS ***
Dealt to jcarlos.vale [Td Kh]
jcarlos.vale: folds 
Uhrenknecht: raises 1568 to 1818 and is all-in
fern46: folds 
Jeppekanin14: folds 
BMW 812: folds 
gelorist: folds 
guiterman: folds 
gerida: folds 
LetsFish14: folds 
Uncalled bet (1568) returned to Uhrenknecht
Uhrenknecht collected 895 from pot
Uhrenknecht: doesn't show handDTO
*** SUMMARY ***
Total pot 895 | Rake 0 
Seat 1: guiterman (button) folded before Flop (didn't bet)
Seat 2: gerida (small blind) folded before Flop
Seat 3: LetsFish14 (big blind) folded before Flop
Seat 4: jcarlos.vale folded before Flop (didn't bet)
Seat 5: Uhrenknecht collected (895)
Seat 6: fern46 folded before Flop (didn't bet)
Seat 7: Jeppekanin14 folded before Flop (didn't bet)
Seat 8: BMW 812 folded before Flop (didn't bet)
Seat 9: gelorist folded before Flop (didn't bet)



PokerStars Hand #221587167484: Tournament #3074230175, $0.98+$0.12 USD Hold'em No Limit - Level X (125/250) - 2020/12/19 0:14:04 EET [2020/12/18 17:14:04 ET]
Table '3074230175 55' 9-max Seat #2 is the button
Seat 1: guiterman (13833 in chips) 
Seat 2: gerida (9921 in chips) 
Seat 3: LetsFish14 (3915 in chips) 
Seat 4: jcarlos.vale (9692 in chips) 
Seat 5: Uhrenknecht (2463 in chips) 
Seat 6: fern46 (1341 in chips) 
Seat 7: Jeppekanin14 (9653 in chips) 
Seat 8: BMW 812 (11265 in chips) 
Seat 9: gelorist (22117 in chips) 
guiterman: posts the ante 30
gerida: posts the ante 30
LetsFish14: posts the ante 30
jcarlos.vale: posts the ante 30
Uhrenknecht: posts the ante 30
fern46: posts the ante 30
Jeppekanin14: posts the ante 30
BMW 812: posts the ante 30
gelorist: posts the ante 30
LetsFish14: posts small blind 125
jcarlos.vale: posts big blind 250
*** HOLE CARDS ***
Dealt to jcarlos.vale [Jc 4h]
Uhrenknecht: folds 
fern46: folds 
Jeppekanin14: raises 500 to 750
BMW 812: folds 
gelorist: raises 2500 to 3250
guiterman: folds 
gerida: folds 
LetsFish14: folds 
jcarlos.vale: folds 
Jeppekanin14: calls 2500
*** FLOP *** [Ah 6c Th]
Jeppekanin14: bets 6373 and is all-in
gelorist: calls 6373
*** TURN *** [Ah 6c Th] [5s]
*** RIVER *** [Ah 6c Th 5s] [8h]
*** SHOW DOWN ***
Jeppekanin14: shows [Ac 9s] (a pair of Aces)
gelorist: shows [7d Ad] (a pair of Aces - lower kicker)
Jeppekanin14 collected 19891 from pot
*** SUMMARY ***
Total pot 19891 | Rake 0 
Board [Ah 6c Th 5s 8h]
Seat 1: guiterman folded before Flop (didn't bet)
Seat 2: gerida (button) folded before Flop (didn't bet)
Seat 3: LetsFish14 (small blind) folded before Flop
Seat 4: jcarlos.vale (big blind) folded before Flop
Seat 5: Uhrenknecht folded before Flop (didn't bet)
Seat 6: fern46 folded before Flop (didn't bet)
Seat 7: Jeppekanin14 showed [Ac 9s] and won (19891) with a pair of Aces
Seat 8: BMW 812 folded before Flop (didn't bet)
Seat 9: gelorist showed [7d Ad] and lost with a pair of Aces



PokerStars Hand #221587211595: Tournament #3074230175, $0.98+$0.12 USD Hold'em No Limit - Level X (125/250) - 2020/12/19 0:14:51 EET [2020/12/18 17:14:51 ET]
Table '3074230175 55' 9-max Seat #3 is the button
Seat 1: guiterman (13803 in chips) 
Seat 2: gerida (9891 in chips) 
Seat 3: LetsFish14 (3760 in chips) 
Seat 4: jcarlos.vale (9412 in chips) 
Seat 5: Uhrenknecht (2433 in chips) 
Seat 6: fern46 (1311 in chips) 
Seat 7: Jeppekanin14 (19891 in chips) 
Seat 8: BMW 812 (11235 in chips) 
Seat 9: gelorist (12464 in chips) 
guiterman: posts the ante 30
gerida: posts the ante 30
LetsFish14: posts the ante 30
jcarlos.vale: posts the ante 30
Uhrenknecht: posts the ante 30
fern46: posts the ante 30
Jeppekanin14: posts the ante 30
BMW 812: posts the ante 30
gelorist: posts the ante 30
jcarlos.vale: posts small blind 125
Uhrenknecht: posts big blind 250
*** HOLE CARDS ***
Dealt to jcarlos.vale [3h 7s]
fern46: folds 
Jeppekanin14: raises 895 to 1145
BMW 812: folds 
gelorist: folds 
guiterman: folds 
gerida: folds 
LetsFish14: folds 
jcarlos.vale: folds 
Uhrenknecht: folds 
Uncalled bet (895) returned to Jeppekanin14
Jeppekanin14 collected 895 from pot
Jeppekanin14: doesn't show handDTO
*** SUMMARY ***
Total pot 895 | Rake 0 
Seat 1: guiterman folded before Flop (didn't bet)
Seat 2: gerida folded before Flop (didn't bet)
Seat 3: LetsFish14 (button) folded before Flop (didn't bet)
Seat 4: jcarlos.vale (small blind) folded before Flop
Seat 5: Uhrenknecht (big blind) folded before Flop
Seat 6: fern46 folded before Flop (didn't bet)
Seat 7: Jeppekanin14 collected (895)
Seat 8: BMW 812 folded before Flop (didn't bet)
Seat 9: gelorist folded before Flop (didn't bet)



PokerStars Hand #221587230994: Tournament #3074230175, $0.98+$0.12 USD Hold'em No Limit - Level X (125/250) - 2020/12/19 0:15:17 EET [2020/12/18 17:15:17 ET]
Table '3074230175 55' 9-max Seat #4 is the button
Seat 1: guiterman (13773 in chips) 
Seat 2: gerida (9861 in chips) 
Seat 3: LetsFish14 (3730 in chips) 
Seat 4: jcarlos.vale (9257 in chips) 
Seat 5: Uhrenknecht (2153 in chips) 
Seat 6: fern46 (1281 in chips) 
Seat 7: Jeppekanin14 (20506 in chips) 
Seat 8: BMW 812 (11205 in chips) 
Seat 9: gelorist (12434 in chips) 
guiterman: posts the ante 30
gerida: posts the ante 30
LetsFish14: posts the ante 30
jcarlos.vale: posts the ante 30
Uhrenknecht: posts the ante 30
fern46: posts the ante 30
Jeppekanin14: posts the ante 30
BMW 812: posts the ante 30
gelorist: posts the ante 30
Uhrenknecht: posts small blind 125
fern46: posts big blind 250
*** HOLE CARDS ***
Dealt to jcarlos.vale [Kh 7h]
Jeppekanin14: folds 
BMW 812: folds 
gelorist: raises 1500 to 1750
guiterman: folds 
gerida: folds 
LetsFish14: folds 
jcarlos.vale: folds 
Uhrenknecht: folds 
fern46: folds 
Uncalled bet (1500) returned to gelorist
gelorist collected 895 from pot
gelorist: doesn't show handDTO
*** SUMMARY ***
Total pot 895 | Rake 0 
Seat 1: guiterman folded before Flop (didn't bet)
Seat 2: gerida folded before Flop (didn't bet)
Seat 3: LetsFish14 folded before Flop (didn't bet)
Seat 4: jcarlos.vale (button) folded before Flop (didn't bet)
Seat 5: Uhrenknecht (small blind) folded before Flop
Seat 6: fern46 (big blind) folded before Flop
Seat 7: Jeppekanin14 folded before Flop (didn't bet)
Seat 8: BMW 812 folded before Flop (didn't bet)
Seat 9: gelorist collected (895)



PokerStars Hand #221587255360: Tournament #3074230175, $0.98+$0.12 USD Hold'em No Limit - Level X (125/250) - 2020/12/19 0:15:50 EET [2020/12/18 17:15:50 ET]
Table '3074230175 55' 9-max Seat #5 is the button
Seat 1: guiterman (13743 in chips) 
Seat 2: gerida (9831 in chips) 
Seat 3: LetsFish14 (3700 in chips) 
Seat 4: jcarlos.vale (9227 in chips) 
Seat 5: Uhrenknecht (1998 in chips) 
Seat 6: fern46 (1001 in chips) 
Seat 7: Jeppekanin14 (20476 in chips) 
Seat 8: BMW 812 (11175 in chips) 
Seat 9: gelorist (13049 in chips) 
guiterman: posts the ante 30
gerida: posts the ante 30
LetsFish14: posts the ante 30
jcarlos.vale: posts the ante 30
Uhrenknecht: posts the ante 30
fern46: posts the ante 30
Jeppekanin14: posts the ante 30
BMW 812: posts the ante 30
gelorist: posts the ante 30
fern46: posts small blind 125
Jeppekanin14: posts big blind 250
*** HOLE CARDS ***
Dealt to jcarlos.vale [Kd Jc]
BMW 812: folds 
gelorist: calls 250
guiterman: folds 
gerida: folds 
LetsFish14: folds 
jcarlos.vale: raises 400 to 650
Uhrenknecht: folds 
fern46: folds 
Jeppekanin14: calls 400
gelorist: calls 400
*** FLOP *** [8s 9h As]
Jeppekanin14: checks 
gelorist: bets 500
jcarlos.vale: folds 
Jeppekanin14: calls 500
*** TURN *** [8s 9h As] [4d]
Jeppekanin14: checks 
gelorist: bets 1000
Jeppekanin14: calls 1000
*** RIVER *** [8s 9h As 4d] [3s]
Jeppekanin14: checks 
gelorist: bets 2250
Jeppekanin14: folds 
Uncalled bet (2250) returned to gelorist
gelorist collected 5345 from pot
gelorist: doesn't show handDTO
*** SUMMARY ***
Total pot 5345 | Rake 0 
Board [8s 9h As 4d 3s]
Seat 1: guiterman folded before Flop (didn't bet)
Seat 2: gerida folded before Flop (didn't bet)
Seat 3: LetsFish14 folded before Flop (didn't bet)
Seat 4: jcarlos.vale folded on the Flop
Seat 5: Uhrenknecht (button) folded before Flop (didn't bet)
Seat 6: fern46 (small blind) folded before Flop
Seat 7: Jeppekanin14 (big blind) folded on the River
Seat 8: BMW 812 folded before Flop (didn't bet)
Seat 9: gelorist collected (5345)



PokerStars Hand #221587310574: Tournament #3074230175, $0.98+$0.12 USD Hold'em No Limit - Level X (125/250) - 2020/12/19 0:17:05 EET [2020/12/18 17:17:05 ET]
Table '3074230175 55' 9-max Seat #6 is the button
Seat 1: guiterman (13713 in chips) 
Seat 2: gerida (9801 in chips) 
Seat 3: LetsFish14 (3670 in chips) 
Seat 4: jcarlos.vale (8547 in chips) 
Seat 5: Uhrenknecht (1968 in chips) 
Seat 6: fern46 (846 in chips) 
Seat 7: Jeppekanin14 (18296 in chips) 
Seat 8: BMW 812 (11145 in chips) 
Seat 9: gelorist (16214 in chips) 
guiterman: posts the ante 30
gerida: posts the ante 30
LetsFish14: posts the ante 30
jcarlos.vale: posts the ante 30
Uhrenknecht: posts the ante 30
fern46: posts the ante 30
Jeppekanin14: posts the ante 30
BMW 812: posts the ante 30
gelorist: posts the ante 30
Jeppekanin14: posts small blind 125
BMW 812: posts big blind 250
*** HOLE CARDS ***
Dealt to jcarlos.vale [5h Ad]
gelorist: folds 
guiterman: calls 250
gerida: folds 
LetsFish14: folds 
jcarlos.vale: folds 
Uhrenknecht: folds 
fern46: folds 
Jeppekanin14: folds 
BMW 812: checks 
*** FLOP *** [As 4h 3c]
BMW 812: checks 
guiterman: bets 250
BMW 812: calls 250
*** TURN *** [As 4h 3c] [9s]
BMW 812: checks 
guiterman: bets 250
BMW 812: folds 
Uncalled bet (250) returned to guiterman
guiterman collected 1395 from pot
guiterman: doesn't show handDTO
*** SUMMARY ***
Total pot 1395 | Rake 0 
Board [As 4h 3c 9s]
Seat 1: guiterman collected (1395)
Seat 2: gerida folded before Flop (didn't bet)
Seat 3: LetsFish14 folded before Flop (didn't bet)
Seat 4: jcarlos.vale folded before Flop (didn't bet)
Seat 5: Uhrenknecht folded before Flop (didn't bet)
Seat 6: fern46 (button) folded before Flop (didn't bet)
Seat 7: Jeppekanin14 (small blind) folded before Flop
Seat 8: BMW 812 (big blind) folded on the Turn
Seat 9: gelorist folded before Flop (didn't bet)



PokerStars Hand #221587348525: Tournament #3074230175, $0.98+$0.12 USD Hold'em No Limit - Level X (125/250) - 2020/12/19 0:17:57 EET [2020/12/18 17:17:57 ET]
Table '3074230175 55' 9-max Seat #7 is the button
Seat 1: guiterman (14578 in chips) 
Seat 2: gerida (9771 in chips) 
Seat 3: LetsFish14 (3640 in chips) 
Seat 4: jcarlos.vale (8517 in chips) 
Seat 5: Uhrenknecht (1938 in chips) 
Seat 6: fern46 (816 in chips) 
Seat 7: Jeppekanin14 (18141 in chips) 
Seat 8: BMW 812 (10615 in chips) 
Seat 9: gelorist (16184 in chips) 
guiterman: posts the ante 30
gerida: posts the ante 30
LetsFish14: posts the ante 30
jcarlos.vale: posts the ante 30
Uhrenknecht: posts the ante 30
fern46: posts the ante 30
Jeppekanin14: posts the ante 30
BMW 812: posts the ante 30
gelorist: posts the ante 30
BMW 812: posts small blind 125
gelorist: posts big blind 250
*** HOLE CARDS ***
Dealt to jcarlos.vale [6c Qd]
guiterman: calls 250
gerida: folds 
LetsFish14: folds 
jcarlos.vale: folds 
Uhrenknecht: folds 
fern46: folds 
Jeppekanin14: folds 
BMW 812: calls 125
gelorist: checks 
*** FLOP *** [Ts 4d 3d]
BMW 812: bets 1020
gelorist: raises 1730 to 2750
guiterman: folds 
BMW 812: raises 6520 to 9270
gelorist: raises 6520 to 15790
BMW 812: calls 1065 and is all-in
Uncalled bet (5455) returned to gelorist
*** TURN *** [Ts 4d 3d] [7c]
*** RIVER *** [Ts 4d 3d 7c] [Th]
*** SHOW DOWN ***
BMW 812: shows [3s 9s] (two pair, Tens and Threes)
gelorist: shows [Tc 7h] (a full house, Tens full of Sevens)
gelorist collected 21690 from pot
BMW 812 finished the tournament in 310th place
*** SUMMARY ***
Total pot 21690 | Rake 0 
Board [Ts 4d 3d 7c Th]
Seat 1: guiterman folded on the Flop
Seat 2: gerida folded before Flop (didn't bet)
Seat 3: LetsFish14 folded before Flop (didn't bet)
Seat 4: jcarlos.vale folded before Flop (didn't bet)
Seat 5: Uhrenknecht folded before Flop (didn't bet)
Seat 6: fern46 folded before Flop (didn't bet)
Seat 7: Jeppekanin14 (button) folded before Flop (didn't bet)
Seat 8: BMW 812 (small blind) showed [3s 9s] and lost with two pair, Tens and Threes
Seat 9: gelorist (big blind) showed [Tc 7h] and won (21690) with a full house, Tens full of Sevens



PokerStars Hand #221587411743: Tournament #3074230175, $0.98+$0.12 USD Hold'em No Limit - Level X (125/250) - 2020/12/19 0:19:23 EET [2020/12/18 17:19:23 ET]
Table '3074230175 55' 9-max Seat #9 is the button
Seat 1: guiterman (14298 in chips) 
Seat 2: gerida (9741 in chips) 
Seat 3: LetsFish14 (3610 in chips) 
Seat 4: jcarlos.vale (8487 in chips) 
Seat 5: Uhrenknecht (1908 in chips) 
Seat 6: fern46 (786 in chips) 
Seat 7: Jeppekanin14 (18111 in chips) 
Seat 9: gelorist (27259 in chips) 
guiterman: posts the ante 30
gerida: posts the ante 30
LetsFish14: posts the ante 30
jcarlos.vale: posts the ante 30
Uhrenknecht: posts the ante 30
fern46: posts the ante 30
Jeppekanin14: posts the ante 30
gelorist: posts the ante 30
guiterman: posts small blind 125
gerida: posts big blind 250
*** HOLE CARDS ***
Dealt to jcarlos.vale [Th 4s]
LetsFish14: folds 
jcarlos.vale: folds 
Uhrenknecht: folds 
fern46: folds 
Jeppekanin14: calls 250
gelorist: calls 250
guiterman: calls 125
gerida: checks 
*** FLOP *** [2d Js 2s]
guiterman: checks 
gerida: bets 250
Jeppekanin14: folds 
gelorist: calls 250
guiterman: folds 
*** TURN *** [2d Js 2s] [2h]
gerida: checks 
gelorist: bets 1250
gerida: folds 
Uncalled bet (1250) returned to gelorist
gelorist collected 1740 from pot
gelorist: doesn't show handDTO
*** SUMMARY ***
Total pot 1740 | Rake 0 
Board [2d Js 2s 2h]
Seat 1: guiterman (small blind) folded on the Flop
Seat 2: gerida (big blind) folded on the Turn
Seat 3: LetsFish14 folded before Flop (didn't bet)
Seat 4: jcarlos.vale folded before Flop (didn't bet)
Seat 5: Uhrenknecht folded before Flop (didn't bet)
Seat 6: fern46 folded before Flop (didn't bet)
Seat 7: Jeppekanin14 folded on the Flop
Seat 9: gelorist (button) collected (1740)



PokerStars Hand #221587466246: Tournament #3074230175, $0.98+$0.12 USD Hold'em No Limit - Level X (125/250) - 2020/12/19 0:20:38 EET [2020/12/18 17:20:38 ET]
Table '3074230175 55' 9-max Seat #1 is the button
Seat 1: guiterman (14018 in chips) 
Seat 2: gerida (9211 in chips) 
Seat 3: LetsFish14 (3580 in chips) 
Seat 4: jcarlos.vale (8457 in chips) 
Seat 5: Uhrenknecht (1878 in chips) 
Seat 6: fern46 (756 in chips) 
Seat 7: Jeppekanin14 (17831 in chips) 
Seat 8: Takk0 (11231 in chips) 
Seat 9: gelorist (28469 in chips) 
guiterman: posts the ante 30
gerida: posts the ante 30
LetsFish14: posts the ante 30
jcarlos.vale: posts the ante 30
Uhrenknecht: posts the ante 30
fern46: posts the ante 30
Jeppekanin14: posts the ante 30
Takk0: posts the ante 30
gelorist: posts the ante 30
gerida: posts small blind 125
LetsFish14: posts big blind 250
*** HOLE CARDS ***
Dealt to jcarlos.vale [3d Ah]
jcarlos.vale: folds 
Uhrenknecht: folds 
fern46: folds 
Jeppekanin14: folds 
Takk0 has timed out
Takk0: folds 
Takk0 is sitting out
gelorist: folds 
Takk0 has returned
guiterman: calls 250
gerida: calls 125
LetsFish14: checks 
*** FLOP *** [5c 9s 5h]
gerida: checks 
LetsFish14: checks 
guiterman: checks 
*** TURN *** [5c 9s 5h] [2d]
gerida: bets 250
LetsFish14: folds 
guiterman: folds 
Uncalled bet (250) returned to gerida
gerida collected 1020 from pot
gerida: doesn't show handDTO
*** SUMMARY ***
Total pot 1020 | Rake 0 
Board [5c 9s 5h 2d]
Seat 1: guiterman (button) folded on the Turn
Seat 2: gerida (small blind) collected (1020)
Seat 3: LetsFish14 (big blind) folded on the Turn
Seat 4: jcarlos.vale folded before Flop (didn't bet)
Seat 5: Uhrenknecht folded before Flop (didn't bet)
Seat 6: fern46 folded before Flop (didn't bet)
Seat 7: Jeppekanin14 folded before Flop (didn't bet)
Seat 8: Takk0 folded before Flop (didn't bet)
Seat 9: gelorist folded before Flop (didn't bet)



PokerStars Hand #221587546733: Tournament #3074230175, $0.98+$0.12 USD Hold'em No Limit - Level X (125/250) - 2020/12/19 0:22:29 EET [2020/12/18 17:22:29 ET]
Table '3074230175 55' 9-max Seat #2 is the button
Seat 1: guiterman (13738 in chips) 
Seat 2: gerida (9951 in chips) 
Seat 3: LetsFish14 (3300 in chips) 
Seat 4: jcarlos.vale (8427 in chips) 
Seat 5: Uhrenknecht (1848 in chips) 
Seat 6: fern46 (726 in chips) 
Seat 7: Jeppekanin14 (17801 in chips) 
Seat 8: Takk0 (11201 in chips) 
Seat 9: gelorist (28439 in chips) 
guiterman: posts the ante 30
gerida: posts the ante 30
LetsFish14: posts the ante 30
jcarlos.vale: posts the ante 30
Uhrenknecht: posts the ante 30
fern46: posts the ante 30
Jeppekanin14: posts the ante 30
Takk0: posts the ante 30
gelorist: posts the ante 30
LetsFish14: posts small blind 125
jcarlos.vale: posts big blind 250
*** HOLE CARDS ***
Dealt to jcarlos.vale [Ad 8d]
Uhrenknecht: folds 
fern46: folds 
Jeppekanin14: calls 250
Takk0: folds 
gelorist: raises 1000 to 1250
guiterman: folds 
gerida: folds 
LetsFish14: folds 
jcarlos.vale: folds 
Jeppekanin14 has timed out
Jeppekanin14: folds 
Jeppekanin14 is sitting out
Uncalled bet (1000) returned to gelorist
gelorist collected 1145 from pot
gelorist: doesn't show handDTO
*** SUMMARY ***
Total pot 1145 | Rake 0 
Seat 1: guiterman folded before Flop (didn't bet)
Seat 2: gerida (button) folded before Flop (didn't bet)
Seat 3: LetsFish14 (small blind) folded before Flop
Seat 4: jcarlos.vale (big blind) folded before Flop
Seat 5: Uhrenknecht folded before Flop (didn't bet)
Seat 6: fern46 folded before Flop (didn't bet)
Seat 7: Jeppekanin14 folded before Flop
Seat 8: Takk0 folded before Flop (didn't bet)
Seat 9: gelorist collected (1145)



PokerStars Hand #221587595027: Tournament #3074230175, $0.98+$0.12 USD Hold'em No Limit - Level XI (150/300) - 2020/12/19 0:23:35 EET [2020/12/18 17:23:35 ET]
Table '3074230175 55' 9-max Seat #3 is the button
Seat 1: guiterman (13708 in chips) 
Seat 2: gerida (9921 in chips) 
Seat 3: LetsFish14 (3145 in chips) 
Seat 4: jcarlos.vale (8147 in chips) 
Seat 5: Uhrenknecht (1818 in chips) 
Seat 6: fern46 (696 in chips) 
Seat 7: Jeppekanin14 (17521 in chips) is sitting out
Seat 8: Takk0 (11171 in chips) 
Seat 9: gelorist (29304 in chips) 
guiterman: posts the ante 40
gerida: posts the ante 40
LetsFish14: posts the ante 40
jcarlos.vale: posts the ante 40
Uhrenknecht: posts the ante 40
fern46: posts the ante 40
Jeppekanin14: posts the ante 40
Takk0: posts the ante 40
gelorist: posts the ante 40
jcarlos.vale: posts small blind 150
Uhrenknecht: posts big blind 300
*** HOLE CARDS ***
Dealt to jcarlos.vale [6s Qs]
fern46: folds 
Jeppekanin14: folds 
Jeppekanin14 has returned
Takk0: folds 
gelorist: folds 
guiterman: folds 
gerida: calls 300
LetsFish14: folds 
jcarlos.vale: calls 150
Uhrenknecht: checks 
*** FLOP *** [2d 8c Td]
jcarlos.vale: checks 
Uhrenknecht: checks 
gerida: bets 600
jcarlos.vale: folds 
Uhrenknecht: folds 
Uncalled bet (600) returned to gerida
gerida collected 1260 from pot
gerida: doesn't show handDTO
*** SUMMARY ***
Total pot 1260 | Rake 0 
Board [2d 8c Td]
Seat 1: guiterman folded before Flop (didn't bet)
Seat 2: gerida collected (1260)
Seat 3: LetsFish14 (button) folded before Flop (didn't bet)
Seat 4: jcarlos.vale (small blind) folded on the Flop
Seat 5: Uhrenknecht (big blind) folded on the Flop
Seat 6: fern46 folded before Flop (didn't bet)
Seat 7: Jeppekanin14 folded before Flop (didn't bet)
Seat 8: Takk0 folded before Flop (didn't bet)
Seat 9: gelorist folded before Flop (didn't bet)



PokerStars Hand #221587648673: Tournament #3074230175, $0.98+$0.12 USD Hold'em No Limit - Level XI (150/300) - 2020/12/19 0:24:49 EET [2020/12/18 17:24:49 ET]
Table '3074230175 55' 9-max Seat #4 is the button
Seat 1: guiterman (13668 in chips) 
Seat 2: gerida (10841 in chips) 
Seat 3: LetsFish14 (3105 in chips) 
Seat 4: jcarlos.vale (7807 in chips) 
Seat 5: Uhrenknecht (1478 in chips) 
Seat 6: fern46 (656 in chips) 
Seat 7: Jeppekanin14 (17481 in chips) 
Seat 8: Takk0 (11131 in chips) 
Seat 9: gelorist (29264 in chips) 
guiterman: posts the ante 40
gerida: posts the ante 40
LetsFish14: posts the ante 40
jcarlos.vale: posts the ante 40
Uhrenknecht: posts the ante 40
fern46: posts the ante 40
Jeppekanin14: posts the ante 40
Takk0: posts the ante 40
gelorist: posts the ante 40
Uhrenknecht: posts small blind 150
fern46: posts big blind 300
*** HOLE CARDS ***
Dealt to jcarlos.vale [Ac 6c]
Jeppekanin14 has timed out
Jeppekanin14: folds 
Jeppekanin14 is sitting out
Jeppekanin14 has returned
Takk0: raises 300 to 600
gelorist: raises 2700 to 3300
guiterman: folds 
gerida: folds 
LetsFish14: folds 
jcarlos.vale: folds 
Uhrenknecht: folds 
fern46: calls 316 and is all-in
Takk0: raises 7791 to 11091 and is all-in
gelorist: calls 7791
*** FLOP *** [7d Ad 4c]
*** TURN *** [7d Ad 4c] [9s]
*** RIVER *** [7d Ad 4c 9s] [5s]
*** SHOW DOWN ***
Takk0: shows [Tc Td] (a pair of Tens)
gelorist: shows [2d 2c] (a pair of Deuces)
Takk0 collected 20950 from side pot
fern46: shows [3h 5h] (a pair of Fives)
Takk0 collected 2358 from main pot
fern46 finished the tournament in 282nd place
*** SUMMARY ***
Total pot 23308 Main pot 2358. Side pot 20950. | Rake 0 
Board [7d Ad 4c 9s 5s]
Seat 1: guiterman folded before Flop (didn't bet)
Seat 2: gerida folded before Flop (didn't bet)
Seat 3: LetsFish14 folded before Flop (didn't bet)
Seat 4: jcarlos.vale (button) folded before Flop (didn't bet)
Seat 5: Uhrenknecht (small blind) folded before Flop
Seat 6: fern46 (big blind) showed [3h 5h] and lost with a pair of Fives
Seat 7: Jeppekanin14 folded before Flop (didn't bet)
Seat 8: Takk0 showed [Tc Td] and won (23308) with a pair of Tens
Seat 9: gelorist showed [2d 2c] and lost with a pair of Deuces



PokerStars Hand #221587696927: Tournament #3074230175, $0.98+$0.12 USD Hold'em No Limit - Level XI (150/300) - 2020/12/19 0:25:56 EET [2020/12/18 17:25:56 ET]
Table '3074230175 55' 9-max Seat #5 is the button
Seat 1: guiterman (13628 in chips) 
Seat 2: gerida (10801 in chips) 
Seat 3: LetsFish14 (3065 in chips) 
Seat 4: jcarlos.vale (7767 in chips) 
Seat 5: Uhrenknecht (1288 in chips) 
Seat 7: Jeppekanin14 (17441 in chips) 
Seat 8: Takk0 (23308 in chips) 
Seat 9: gelorist (18133 in chips) 
guiterman: posts the ante 40
gerida: posts the ante 40
LetsFish14: posts the ante 40
jcarlos.vale: posts the ante 40
Uhrenknecht: posts the ante 40
Jeppekanin14: posts the ante 40
Takk0: posts the ante 40
gelorist: posts the ante 40
Jeppekanin14: posts small blind 150
Takk0: posts big blind 300
*** HOLE CARDS ***
Dealt to jcarlos.vale [Kc Qc]
gelorist: folds 
guiterman: folds 
gerida: folds 
LetsFish14: folds 
jcarlos.vale: raises 480 to 780
Uhrenknecht: folds 
Jeppekanin14: calls 630
Takk0: calls 480
*** FLOP *** [4s 7d 3c]
Jeppekanin14: checks 
Takk0: checks 
jcarlos.vale: checks 
*** TURN *** [4s 7d 3c] [6c]
Jeppekanin14: bets 1330
Takk0: calls 1330
jcarlos.vale: folds 
*** RIVER *** [4s 7d 3c 6c] [3d]
Jeppekanin14: bets 15291 and is all-in
Takk0: folds 
Uncalled bet (15291) returned to Jeppekanin14
Jeppekanin14 collected 5320 from pot
Jeppekanin14: doesn't show handDTO
*** SUMMARY ***
Total pot 5320 | Rake 0 
Board [4s 7d 3c 6c 3d]
Seat 1: guiterman folded before Flop (didn't bet)
Seat 2: gerida folded before Flop (didn't bet)
Seat 3: LetsFish14 folded before Flop (didn't bet)
Seat 4: jcarlos.vale folded on the Turn
Seat 5: Uhrenknecht (button) folded before Flop (didn't bet)
Seat 7: Jeppekanin14 (small blind) collected (5320)
Seat 8: Takk0 (big blind) folded on the River
Seat 9: gelorist folded before Flop (didn't bet)



PokerStars Hand #221587755994: Tournament #3074230175, $0.98+$0.12 USD Hold'em No Limit - Level XI (150/300) - 2020/12/19 0:27:19 EET [2020/12/18 17:27:19 ET]
Table '3074230175 55' 9-max Seat #7 is the button
Seat 1: guiterman (13588 in chips) 
Seat 2: gerida (10761 in chips) 
Seat 3: LetsFish14 (3025 in chips) 
Seat 4: jcarlos.vale (6947 in chips) 
Seat 5: Uhrenknecht (1248 in chips) 
Seat 6: Fluukie (7646 in chips) 
Seat 7: Jeppekanin14 (20611 in chips) 
Seat 8: Takk0 (21158 in chips) 
Seat 9: gelorist (18093 in chips) 
guiterman: posts the ante 40
gerida: posts the ante 40
LetsFish14: posts the ante 40
jcarlos.vale: posts the ante 40
Uhrenknecht: posts the ante 40
Fluukie: posts the ante 40
Jeppekanin14: posts the ante 40
Takk0: posts the ante 40
gelorist: posts the ante 40
Takk0: posts small blind 150
gelorist: posts big blind 300
*** HOLE CARDS ***
Dealt to jcarlos.vale [2s Kh]
guiterman: folds 
gerida: folds 
LetsFish14: raises 2685 to 2985 and is all-in
jcarlos.vale: folds 
Uhrenknecht has timed out
Uhrenknecht: folds 
Uhrenknecht is sitting out
Uhrenknecht has returned
Fluukie: folds 
Jeppekanin14: folds 
Takk0: folds 
gelorist: calls 2685
*** FLOP *** [Tc 7d 3d]
*** TURN *** [Tc 7d 3d] [4h]
*** RIVER *** [Tc 7d 3d 4h] [2c]
*** SHOW DOWN ***
gelorist: shows [Qc 7s] (a pair of Sevens)
LetsFish14: shows [9d Ah] (high pairOfCards Ace)
gelorist collected 6480 from pot
LetsFish14 finished the tournament in 261st place
*** SUMMARY ***
Total pot 6480 | Rake 0 
Board [Tc 7d 3d 4h 2c]
Seat 1: guiterman folded before Flop (didn't bet)
Seat 2: gerida folded before Flop (didn't bet)
Seat 3: LetsFish14 showed [9d Ah] and lost with high pairOfCards Ace
Seat 4: jcarlos.vale folded before Flop (didn't bet)
Seat 5: Uhrenknecht folded before Flop (didn't bet)
Seat 6: Fluukie folded before Flop (didn't bet)
Seat 7: Jeppekanin14 (button) folded before Flop (didn't bet)
Seat 8: Takk0 (small blind) folded before Flop
Seat 9: gelorist (big blind) showed [Qc 7s] and won (6480) with a pair of Sevens



PokerStars Hand #221587793939: Tournament #3074230175, $0.98+$0.12 USD Hold'em No Limit - Level XI (150/300) - 2020/12/19 0:28:12 EET [2020/12/18 17:28:12 ET]
Table '3074230175 55' 9-max Seat #8 is the button
Seat 1: guiterman (13548 in chips) 
Seat 2: gerida (10721 in chips) 
Seat 4: jcarlos.vale (6907 in chips) 
Seat 5: Uhrenknecht (1208 in chips) 
Seat 6: Fluukie (7606 in chips) 
Seat 7: Jeppekanin14 (20571 in chips) 
Seat 8: Takk0 (20968 in chips) 
Seat 9: gelorist (21548 in chips) 
guiterman: posts the ante 40
gerida: posts the ante 40
jcarlos.vale: posts the ante 40
Uhrenknecht: posts the ante 40
Fluukie: posts the ante 40
Jeppekanin14: posts the ante 40
Takk0: posts the ante 40
gelorist: posts the ante 40
gelorist: posts small blind 150
guiterman: posts big blind 300
*** HOLE CARDS ***
Dealt to jcarlos.vale [7s 6s]
gerida: folds 
jcarlos.vale has timed out
jcarlos.vale: folds 
jcarlos.vale is sitting out
Uhrenknecht: folds 
jcarlos.vale has returned
Fluukie: folds 
Jeppekanin14: raises 1070 to 1370
Takk0: calls 1370
gelorist: raises 7630 to 9000
guiterman: folds 
Jeppekanin14: calls 7630
Takk0: folds 
*** FLOP *** [Kc Ac 9s]
gelorist: bets 2700
Jeppekanin14: raises 8831 to 11531 and is all-in
gelorist: calls 8831
*** TURN *** [Kc Ac 9s] [Ts]
*** RIVER *** [Kc Ac 9s Ts] [8c]
*** SHOW DOWN ***
gelorist: shows [8h 8d] (three of a kind, Eights)
Jeppekanin14: shows [Jd Kd] (a pair of Kings)
gelorist collected 43052 from pot
Jeppekanin14 finished the tournament in 253rd place
*** SUMMARY ***
Total pot 43052 | Rake 0 
Board [Kc Ac 9s Ts 8c]
Seat 1: guiterman (big blind) folded before Flop
Seat 2: gerida folded before Flop (didn't bet)
Seat 4: jcarlos.vale folded before Flop (didn't bet)
Seat 5: Uhrenknecht folded before Flop (didn't bet)
Seat 6: Fluukie folded before Flop (didn't bet)
Seat 7: Jeppekanin14 showed [Jd Kd] and lost with a pair of Kings
Seat 8: Takk0 (button) folded before Flop
Seat 9: gelorist (small blind) showed [8h 8d] and won (43052) with three of a kind, Eights



PokerStars Hand #221587912692: Tournament #3074230175, $0.98+$0.12 USD Hold'em No Limit - Level XI (150/300) - 2020/12/19 0:30:59 EET [2020/12/18 17:30:59 ET]
Table '3074230175 5' 9-max Seat #9 is the button
Seat 1: LittleBigRUS (10078 in chips) 
Seat 2: PokerArchi95 (7078 in chips) 
Seat 3: 88099686 (4010 in chips) 
Seat 4: Gary.BY (23540 in chips) 
Seat 5: salvoaoa (5934 in chips) 
Seat 6: jcarlos.vale (6867 in chips) 
Seat 7: iliaspatrik (11469 in chips) 
Seat 8: Ro8erto71 (6422 in chips) 
Seat 9: tensor6969 (3106 in chips) is sitting out
LittleBigRUS: posts the ante 40
PokerArchi95: posts the ante 40
88099686: posts the ante 40
Gary.BY: posts the ante 40
salvoaoa: posts the ante 40
jcarlos.vale: posts the ante 40
iliaspatrik: posts the ante 40
Ro8erto71: posts the ante 40
tensor6969: posts the ante 40
LittleBigRUS: posts small blind 150
PokerArchi95: posts big blind 300
*** HOLE CARDS ***
Dealt to jcarlos.vale [5d Kc]
88099686: folds 
Gary.BY: calls 300
salvoaoa: folds 
jcarlos.vale: folds 
iliaspatrik: folds 
Ro8erto71: calls 300
tensor6969: folds 
LittleBigRUS: calls 150
PokerArchi95: checks 
*** FLOP *** [3d Jc 5h]
LittleBigRUS: checks 
PokerArchi95: checks 
Gary.BY: bets 300
Ro8erto71: folds 
LittleBigRUS: folds 
PokerArchi95: folds 
Uncalled bet (300) returned to Gary.BY
Gary.BY collected 1560 from pot
Gary.BY: doesn't show handDTO
*** SUMMARY ***
Total pot 1560 | Rake 0 
Board [3d Jc 5h]
Seat 1: LittleBigRUS (small blind) folded on the Flop
Seat 2: PokerArchi95 (big blind) folded on the Flop
Seat 3: 88099686 folded before Flop (didn't bet)
Seat 4: Gary.BY collected (1560)
Seat 5: salvoaoa folded before Flop (didn't bet)
Seat 6: jcarlos.vale folded before Flop (didn't bet)
Seat 7: iliaspatrik folded before Flop (didn't bet)
Seat 8: Ro8erto71 folded on the Flop
Seat 9: tensor6969 (button) folded before Flop (didn't bet)



PokerStars Hand #221587967606: Tournament #3074230175, $0.98+$0.12 USD Hold'em No Limit - Level XI (150/300) - 2020/12/19 0:32:16 EET [2020/12/18 17:32:16 ET]
Table '3074230175 5' 9-max Seat #1 is the button
Seat 1: LittleBigRUS (9738 in chips) 
Seat 2: PokerArchi95 (6738 in chips) 
Seat 3: 88099686 (3970 in chips) 
Seat 4: Gary.BY (24760 in chips) 
Seat 5: salvoaoa (5894 in chips) 
Seat 6: jcarlos.vale (6827 in chips) 
Seat 7: iliaspatrik (11429 in chips) 
Seat 8: Ro8erto71 (6082 in chips) 
Seat 9: tensor6969 (3066 in chips) is sitting out
LittleBigRUS: posts the ante 40
PokerArchi95: posts the ante 40
88099686: posts the ante 40
Gary.BY: posts the ante 40
salvoaoa: posts the ante 40
jcarlos.vale: posts the ante 40
iliaspatrik: posts the ante 40
Ro8erto71: posts the ante 40
tensor6969: posts the ante 40
PokerArchi95: posts small blind 150
88099686: posts big blind 300
*** HOLE CARDS ***
Dealt to jcarlos.vale [9d 5s]
Gary.BY: folds 
salvoaoa: folds 
jcarlos.vale: folds 
iliaspatrik: folds 
Ro8erto71: calls 300
tensor6969: folds 
LittleBigRUS: folds 
PokerArchi95: folds 
88099686: checks 
*** FLOP *** [Th Kh 3s]
88099686: bets 600
Ro8erto71: folds 
Uncalled bet (600) returned to 88099686
88099686 collected 1110 from pot
88099686: doesn't show handDTO
*** SUMMARY ***
Total pot 1110 | Rake 0 
Board [Th Kh 3s]
Seat 1: LittleBigRUS (button) folded before Flop (didn't bet)
Seat 2: PokerArchi95 (small blind) folded before Flop
Seat 3: 88099686 (big blind) collected (1110)
Seat 4: Gary.BY folded before Flop (didn't bet)
Seat 5: salvoaoa folded before Flop (didn't bet)
Seat 6: jcarlos.vale folded before Flop (didn't bet)
Seat 7: iliaspatrik folded before Flop (didn't bet)
Seat 8: Ro8erto71 folded on the Flop
Seat 9: tensor6969 folded before Flop (didn't bet)



PokerStars Hand #221587989180: Tournament #3074230175, $0.98+$0.12 USD Hold'em No Limit - Level XI (150/300) - 2020/12/19 0:32:46 EET [2020/12/18 17:32:46 ET]
Table '3074230175 5' 9-max Seat #2 is the button
Seat 1: LittleBigRUS (9698 in chips) 
Seat 2: PokerArchi95 (6548 in chips) 
Seat 3: 88099686 (4740 in chips) 
Seat 4: Gary.BY (24720 in chips) 
Seat 5: salvoaoa (5854 in chips) 
Seat 6: jcarlos.vale (6787 in chips) 
Seat 7: iliaspatrik (11389 in chips) 
Seat 8: Ro8erto71 (5742 in chips) 
Seat 9: tensor6969 (3026 in chips) is sitting out
LittleBigRUS: posts the ante 40
PokerArchi95: posts the ante 40
88099686: posts the ante 40
Gary.BY: posts the ante 40
salvoaoa: posts the ante 40
jcarlos.vale: posts the ante 40
iliaspatrik: posts the ante 40
Ro8erto71: posts the ante 40
tensor6969: posts the ante 40
88099686: posts small blind 150
Gary.BY: posts big blind 300
*** HOLE CARDS ***
Dealt to jcarlos.vale [Ad Qd]
salvoaoa: folds 
jcarlos.vale: raises 6447 to 6747 and is all-in
iliaspatrik: folds 
Ro8erto71: folds 
tensor6969: folds 
LittleBigRUS: folds 
PokerArchi95: folds 
88099686: folds 
Gary.BY: folds 
Uncalled bet (6447) returned to jcarlos.vale
jcarlos.vale collected 1110 from pot
jcarlos.vale: doesn't show handDTO
*** SUMMARY ***
Total pot 1110 | Rake 0 
Seat 1: LittleBigRUS folded before Flop (didn't bet)
Seat 2: PokerArchi95 (button) folded before Flop (didn't bet)
Seat 3: 88099686 (small blind) folded before Flop
Seat 4: Gary.BY (big blind) folded before Flop
Seat 5: salvoaoa folded before Flop (didn't bet)
Seat 6: jcarlos.vale collected (1110)
Seat 7: iliaspatrik folded before Flop (didn't bet)
Seat 8: Ro8erto71 folded before Flop (didn't bet)
Seat 9: tensor6969 folded before Flop (didn't bet)



PokerStars Hand #221588009845: Tournament #3074230175, $0.98+$0.12 USD Hold'em No Limit - Level XI (150/300) - 2020/12/19 0:33:15 EET [2020/12/18 17:33:15 ET]
Table '3074230175 5' 9-max Seat #3 is the button
Seat 1: LittleBigRUS (9658 in chips) 
Seat 2: PokerArchi95 (6508 in chips) 
Seat 3: 88099686 (4550 in chips) 
Seat 4: Gary.BY (24380 in chips) 
Seat 5: salvoaoa (5814 in chips) 
Seat 6: jcarlos.vale (7557 in chips) 
Seat 7: iliaspatrik (11349 in chips) 
Seat 8: Ro8erto71 (5702 in chips) 
Seat 9: tensor6969 (2986 in chips) is sitting out
LittleBigRUS: posts the ante 40
PokerArchi95: posts the ante 40
88099686: posts the ante 40
Gary.BY: posts the ante 40
salvoaoa: posts the ante 40
jcarlos.vale: posts the ante 40
iliaspatrik: posts the ante 40
Ro8erto71: posts the ante 40
tensor6969: posts the ante 40
Gary.BY: posts small blind 150
salvoaoa: posts big blind 300
*** HOLE CARDS ***
Dealt to jcarlos.vale [9c 6d]
jcarlos.vale: folds 
iliaspatrik: folds 
Ro8erto71: folds 
tensor6969: folds 
LittleBigRUS: raises 360 to 660
PokerArchi95: folds 
88099686: folds 
Gary.BY: calls 510
salvoaoa: calls 360
*** FLOP *** [7c Kh 8h]
Gary.BY: bets 600
salvoaoa: calls 600
LittleBigRUS: folds 
*** TURN *** [7c Kh 8h] [4h]
Gary.BY: bets 600
salvoaoa: raises 3914 to 4514 and is all-in
Gary.BY: calls 3914
*** RIVER *** [7c Kh 8h 4h] [2c]
*** SHOW DOWN ***
Gary.BY: shows [Qs Kc] (a pair of Kings)
salvoaoa: shows [9s Ah] (high pairOfCards Ace)
Gary.BY collected 12568 from pot
salvoaoa finished the tournament in 234th place
*** SUMMARY ***
Total pot 12568 | Rake 0 
Board [7c Kh 8h 4h 2c]
Seat 1: LittleBigRUS folded on the Flop
Seat 2: PokerArchi95 folded before Flop (didn't bet)
Seat 3: 88099686 (button) folded before Flop (didn't bet)
Seat 4: Gary.BY (small blind) showed [Qs Kc] and won (12568) with a pair of Kings
Seat 5: salvoaoa (big blind) showed [9s Ah] and lost with high pairOfCards Ace
Seat 6: jcarlos.vale folded before Flop (didn't bet)
Seat 7: iliaspatrik folded before Flop (didn't bet)
Seat 8: Ro8erto71 folded before Flop (didn't bet)
Seat 9: tensor6969 folded before Flop (didn't bet)



PokerStars Hand #221588060468: Tournament #3074230175, $0.98+$0.12 USD Hold'em No Limit - Level XII (200/400) - 2020/12/19 0:34:27 EET [2020/12/18 17:34:27 ET]
Table '3074230175 5' 9-max Seat #4 is the button
Seat 1: LittleBigRUS (8958 in chips) 
Seat 2: PokerArchi95 (6468 in chips) 
Seat 3: 88099686 (4510 in chips) 
Seat 4: Gary.BY (31134 in chips) 
Seat 6: jcarlos.vale (7517 in chips) 
Seat 7: iliaspatrik (11309 in chips) 
Seat 8: Ro8erto71 (5662 in chips) 
Seat 9: tensor6969 (2946 in chips) is sitting out
LittleBigRUS: posts the ante 50
PokerArchi95: posts the ante 50
88099686: posts the ante 50
Gary.BY: posts the ante 50
jcarlos.vale: posts the ante 50
iliaspatrik: posts the ante 50
Ro8erto71: posts the ante 50
tensor6969: posts the ante 50
jcarlos.vale: posts small blind 200
iliaspatrik: posts big blind 400
*** HOLE CARDS ***
Dealt to jcarlos.vale [2c Ah]
Ro8erto71 has timed out
Ro8erto71: folds 
Ro8erto71 is sitting out
tensor6969: folds 
LittleBigRUS: raises 400 to 800
PokerArchi95: folds 
88099686: folds 
Gary.BY: folds 
jcarlos.vale: folds 
iliaspatrik: calls 400
*** FLOP *** [Qd 7h 9c]
iliaspatrik: checks 
LittleBigRUS: checks 
*** TURN *** [Qd 7h 9c] [2s]
iliaspatrik: checks 
Ro8erto71 has returned
LittleBigRUS: checks 
*** RIVER *** [Qd 7h 9c 2s] [9d]
iliaspatrik: checks 
LittleBigRUS: bets 726
iliaspatrik: folds 
Uncalled bet (726) returned to LittleBigRUS
LittleBigRUS collected 2200 from pot
*** SUMMARY ***
Total pot 2200 | Rake 0 
Board [Qd 7h 9c 2s 9d]
Seat 1: LittleBigRUS collected (2200)
Seat 2: PokerArchi95 folded before Flop (didn't bet)
Seat 3: 88099686 folded before Flop (didn't bet)
Seat 4: Gary.BY (button) folded before Flop (didn't bet)
Seat 6: jcarlos.vale (small blind) folded before Flop
Seat 7: iliaspatrik (big blind) folded on the River
Seat 8: Ro8erto71 folded before Flop (didn't bet)
Seat 9: tensor6969 folded before Flop (didn't bet)



PokerStars Hand #221588101615: Tournament #3074230175, $0.98+$0.12 USD Hold'em No Limit - Level XII (200/400) - 2020/12/19 0:35:26 EET [2020/12/18 17:35:26 ET]
Table '3074230175 5' 9-max Seat #6 is the button
Seat 1: LittleBigRUS (10308 in chips) 
Seat 2: PokerArchi95 (6418 in chips) 
Seat 3: 88099686 (4460 in chips) 
Seat 4: Gary.BY (31084 in chips) 
Seat 6: jcarlos.vale (7267 in chips) 
Seat 7: iliaspatrik (10459 in chips) 
Seat 8: Ro8erto71 (5612 in chips) 
Seat 9: tensor6969 (2896 in chips) is sitting out
LittleBigRUS: posts the ante 50
PokerArchi95: posts the ante 50
88099686: posts the ante 50
Gary.BY: posts the ante 50
jcarlos.vale: posts the ante 50
iliaspatrik: posts the ante 50
Ro8erto71: posts the ante 50
tensor6969: posts the ante 50
iliaspatrik: posts small blind 200
Ro8erto71: posts big blind 400
*** HOLE CARDS ***
Dealt to jcarlos.vale [2h 6h]
tensor6969: folds 
LittleBigRUS: folds 
PokerArchi95: raises 5968 to 6368 and is all-in
88099686: folds 
Gary.BY: folds 
jcarlos.vale: folds 
iliaspatrik: folds 
Ro8erto71: calls 5162 and is all-in
Uncalled bet (806) returned to PokerArchi95
*** FLOP *** [6c 3c 4c]
*** TURN *** [6c 3c 4c] [3d]
*** RIVER *** [6c 3c 4c 3d] [Js]
*** SHOW DOWN ***
Ro8erto71: shows [Ts Qd] (a pair of Threes)
PokerArchi95: shows [Qc Ks] (a pair of Threes - King kicker)
PokerArchi95 collected 11724 from pot
Ro8erto71 finished the tournament in 228th place
*** SUMMARY ***
Total pot 11724 | Rake 0 
Board [6c 3c 4c 3d Js]
Seat 1: LittleBigRUS folded before Flop (didn't bet)
Seat 2: PokerArchi95 showed [Qc Ks] and won (11724) with a pair of Threes
Seat 3: 88099686 folded before Flop (didn't bet)
Seat 4: Gary.BY folded before Flop (didn't bet)
Seat 6: jcarlos.vale (button) folded before Flop (didn't bet)
Seat 7: iliaspatrik (small blind) folded before Flop
Seat 8: Ro8erto71 (big blind) showed [Ts Qd] and lost with a pair of Threes
Seat 9: tensor6969 folded before Flop (didn't bet)



PokerStars Hand #221588134383: Tournament #3074230175, $0.98+$0.12 USD Hold'em No Limit - Level XII (200/400) - 2020/12/19 0:36:12 EET [2020/12/18 17:36:12 ET]
Table '3074230175 5' 9-max Seat #7 is the button
Seat 1: LittleBigRUS (10258 in chips) 
Seat 2: PokerArchi95 (12530 in chips) 
Seat 3: 88099686 (4410 in chips) 
Seat 4: Gary.BY (31034 in chips) 
Seat 6: jcarlos.vale (7217 in chips) 
Seat 7: iliaspatrik (10209 in chips) 
Seat 8: jrsebold (6577 in chips) out of handDTO (moved from another table into small blind)
Seat 9: tensor6969 (2846 in chips) is sitting out
jrsebold will be allowed to play after the button
LittleBigRUS: posts the ante 50
PokerArchi95: posts the ante 50
88099686: posts the ante 50
Gary.BY: posts the ante 50
jcarlos.vale: posts the ante 50
iliaspatrik: posts the ante 50
tensor6969: posts the ante 50
tensor6969: posts small blind 200
LittleBigRUS: posts big blind 400
*** HOLE CARDS ***
Dealt to jcarlos.vale [Tc 6c]
PokerArchi95: raises 600 to 1000
88099686: calls 1000
Gary.BY: folds 
jcarlos.vale: folds 
iliaspatrik: folds 
tensor6969: folds 
LittleBigRUS: calls 600
*** FLOP *** [7h 4s 7c]
LittleBigRUS: checks 
PokerArchi95: bets 1775
88099686: raises 1585 to 3360 and is all-in
LittleBigRUS: folds 
PokerArchi95: calls 1585
*** TURN *** [7h 4s 7c] [3h]
*** RIVER *** [7h 4s 7c 3h] [2s]
*** SHOW DOWN ***
PokerArchi95: shows [6d 6h] (two pair, Sevens and Sixes)
88099686: shows [Js Jd] (two pair, Jacks and Sevens)
88099686 collected 10270 from pot
*** SUMMARY ***
Total pot 10270 | Rake 0 
Board [7h 4s 7c 3h 2s]
Seat 1: LittleBigRUS (big blind) folded on the Flop
Seat 2: PokerArchi95 showed [6d 6h] and lost with two pair, Sevens and Sixes
Seat 3: 88099686 showed [Js Jd] and won (10270) with two pair, Jacks and Sevens
Seat 4: Gary.BY folded before Flop (didn't bet)
Seat 6: jcarlos.vale folded before Flop (didn't bet)
Seat 7: iliaspatrik (button) folded before Flop (didn't bet)
Seat 9: tensor6969 (small blind) folded before Flop



PokerStars Hand #221588162214: Tournament #3074230175, $0.98+$0.12 USD Hold'em No Limit - Level XII (200/400) - 2020/12/19 0:36:52 EET [2020/12/18 17:36:52 ET]
Table '3074230175 5' 9-max Seat #9 is the button
Seat 1: LittleBigRUS (9208 in chips) 
Seat 2: PokerArchi95 (8120 in chips) 
Seat 3: 88099686 (10270 in chips) 
Seat 4: Gary.BY (30984 in chips) 
Seat 5: AnHoCa (1937 in chips) is sitting out
Seat 6: jcarlos.vale (7167 in chips) 
Seat 7: iliaspatrik (10159 in chips) 
Seat 8: jrsebold (6577 in chips) 
Seat 9: tensor6969 (2596 in chips) is sitting out
LittleBigRUS: posts the ante 50
PokerArchi95: posts the ante 50
88099686: posts the ante 50
Gary.BY: posts the ante 50
AnHoCa: posts the ante 50
jcarlos.vale: posts the ante 50
iliaspatrik: posts the ante 50
jrsebold: posts the ante 50
tensor6969: posts the ante 50
LittleBigRUS: posts small blind 200
PokerArchi95: posts big blind 400
*** HOLE CARDS ***
Dealt to jcarlos.vale [7s 9d]
88099686: folds 
Gary.BY: folds 
AnHoCa: folds 
jcarlos.vale: folds 
iliaspatrik: folds 
jrsebold: folds 
tensor6969: folds 
LittleBigRUS: folds 
Uncalled bet (200) returned to PokerArchi95
PokerArchi95 collected 850 from pot
PokerArchi95: doesn't show handDTO
*** SUMMARY ***
Total pot 850 | Rake 0 
Seat 1: LittleBigRUS (small blind) folded before Flop
Seat 2: PokerArchi95 (big blind) collected (850)
Seat 3: 88099686 folded before Flop (didn't bet)
Seat 4: Gary.BY folded before Flop (didn't bet)
Seat 5: AnHoCa folded before Flop (didn't bet)
Seat 6: jcarlos.vale folded before Flop (didn't bet)
Seat 7: iliaspatrik folded before Flop (didn't bet)
Seat 8: jrsebold folded before Flop (didn't bet)
Seat 9: tensor6969 (button) folded before Flop (didn't bet)



PokerStars Hand #221588172346: Tournament #3074230175, $0.98+$0.12 USD Hold'em No Limit - Level XII (200/400) - 2020/12/19 0:37:07 EET [2020/12/18 17:37:07 ET]
Table '3074230175 5' 9-max Seat #1 is the button
Seat 1: LittleBigRUS (8958 in chips) 
Seat 2: PokerArchi95 (8720 in chips) 
Seat 3: 88099686 (10220 in chips) 
Seat 4: Gary.BY (30934 in chips) 
Seat 5: AnHoCa (1887 in chips) is sitting out
Seat 6: jcarlos.vale (7117 in chips) 
Seat 7: iliaspatrik (10109 in chips) 
Seat 8: jrsebold (6527 in chips) 
Seat 9: tensor6969 (2546 in chips) is sitting out
LittleBigRUS: posts the ante 50
PokerArchi95: posts the ante 50
88099686: posts the ante 50
Gary.BY: posts the ante 50
AnHoCa: posts the ante 50
jcarlos.vale: posts the ante 50
iliaspatrik: posts the ante 50
jrsebold: posts the ante 50
tensor6969: posts the ante 50
PokerArchi95: posts small blind 200
88099686: posts big blind 400
*** HOLE CARDS ***
Dealt to jcarlos.vale [6h 3s]
Gary.BY: folds 
AnHoCa: folds 
jcarlos.vale: folds 
iliaspatrik: raises 600 to 1000
jrsebold: folds 
tensor6969: folds 
LittleBigRUS: folds 
PokerArchi95: folds 
88099686: folds 
Uncalled bet (600) returned to iliaspatrik
iliaspatrik collected 1450 from pot
iliaspatrik: doesn't show handDTO
*** SUMMARY ***
Total pot 1450 | Rake 0 
Seat 1: LittleBigRUS (button) folded before Flop (didn't bet)
Seat 2: PokerArchi95 (small blind) folded before Flop
Seat 3: 88099686 (big blind) folded before Flop
Seat 4: Gary.BY folded before Flop (didn't bet)
Seat 5: AnHoCa folded before Flop (didn't bet)
Seat 6: jcarlos.vale folded before Flop (didn't bet)
Seat 7: iliaspatrik collected (1450)
Seat 8: jrsebold folded before Flop (didn't bet)
Seat 9: tensor6969 folded before Flop (didn't bet)



PokerStars Hand #221588189224: Tournament #3074230175, $0.98+$0.12 USD Hold'em No Limit - Level XII (200/400) - 2020/12/19 0:37:31 EET [2020/12/18 17:37:31 ET]
Table '3074230175 5' 9-max Seat #2 is the button
Seat 1: LittleBigRUS (8908 in chips) 
Seat 2: PokerArchi95 (8470 in chips) 
Seat 3: 88099686 (9770 in chips) 
Seat 4: Gary.BY (30884 in chips) 
Seat 5: AnHoCa (1837 in chips) is sitting out
Seat 6: jcarlos.vale (7067 in chips) 
Seat 7: iliaspatrik (11109 in chips) 
Seat 8: jrsebold (6477 in chips) 
Seat 9: tensor6969 (2496 in chips) is sitting out
LittleBigRUS: posts the ante 50
PokerArchi95: posts the ante 50
88099686: posts the ante 50
Gary.BY: posts the ante 50
AnHoCa: posts the ante 50
jcarlos.vale: posts the ante 50
iliaspatrik: posts the ante 50
jrsebold: posts the ante 50
tensor6969: posts the ante 50
88099686: posts small blind 200
Gary.BY: posts big blind 400
*** HOLE CARDS ***
Dealt to jcarlos.vale [Qs As]
AnHoCa: folds 
jcarlos.vale: raises 6617 to 7017 and is all-in
iliaspatrik: folds 
jrsebold: folds 
tensor6969: folds 
LittleBigRUS: folds 
PokerArchi95: folds 
88099686: folds 
Gary.BY: folds 
Uncalled bet (6617) returned to jcarlos.vale
jcarlos.vale collected 1450 from pot
jcarlos.vale: doesn't show handDTO
*** SUMMARY ***
Total pot 1450 | Rake 0 
Seat 1: LittleBigRUS folded before Flop (didn't bet)
Seat 2: PokerArchi95 (button) folded before Flop (didn't bet)
Seat 3: 88099686 (small blind) folded before Flop
Seat 4: Gary.BY (big blind) folded before Flop
Seat 5: AnHoCa folded before Flop (didn't bet)
Seat 6: jcarlos.vale collected (1450)
Seat 7: iliaspatrik folded before Flop (didn't bet)
Seat 8: jrsebold folded before Flop (didn't bet)
Seat 9: tensor6969 folded before Flop (didn't bet)



PokerStars Hand #221588201162: Tournament #3074230175, $0.98+$0.12 USD Hold'em No Limit - Level XII (200/400) - 2020/12/19 0:37:48 EET [2020/12/18 17:37:48 ET]
Table '3074230175 5' 9-max Seat #3 is the button
Seat 1: LittleBigRUS (8858 in chips) 
Seat 2: PokerArchi95 (8420 in chips) 
Seat 3: 88099686 (9520 in chips) 
Seat 4: Gary.BY (30434 in chips) 
Seat 5: AnHoCa (1787 in chips) is sitting out
Seat 6: jcarlos.vale (8067 in chips) 
Seat 7: iliaspatrik (11059 in chips) 
Seat 8: jrsebold (6427 in chips) 
Seat 9: tensor6969 (2446 in chips) is sitting out
LittleBigRUS: posts the ante 50
PokerArchi95: posts the ante 50
88099686: posts the ante 50
Gary.BY: posts the ante 50
AnHoCa: posts the ante 50
jcarlos.vale: posts the ante 50
iliaspatrik: posts the ante 50
jrsebold: posts the ante 50
tensor6969: posts the ante 50
Gary.BY: posts small blind 200
AnHoCa: posts big blind 400
*** HOLE CARDS ***
Dealt to jcarlos.vale [9s Jc]
jcarlos.vale: folds 
iliaspatrik: folds 
jrsebold: folds 
tensor6969: folds 
LittleBigRUS: raises 480 to 880
PokerArchi95: folds 
88099686: folds 
Gary.BY: raises 29504 to 30384 and is all-in
AnHoCa: folds 
LittleBigRUS: folds 
Uncalled bet (29504) returned to Gary.BY
Gary.BY collected 2610 from pot
Gary.BY: doesn't show handDTO
*** SUMMARY ***
Total pot 2610 | Rake 0 
Seat 1: LittleBigRUS folded before Flop
Seat 2: PokerArchi95 folded before Flop (didn't bet)
Seat 3: 88099686 (button) folded before Flop (didn't bet)
Seat 4: Gary.BY (small blind) collected (2610)
Seat 5: AnHoCa (big blind) folded before Flop
Seat 6: jcarlos.vale folded before Flop (didn't bet)
Seat 7: iliaspatrik folded before Flop (didn't bet)
Seat 8: jrsebold folded before Flop (didn't bet)
Seat 9: tensor6969 folded before Flop (didn't bet)



PokerStars Hand #221588241798: Tournament #3074230175, $0.98+$0.12 USD Hold'em No Limit - Level XII (200/400) - 2020/12/19 0:38:46 EET [2020/12/18 17:38:46 ET]
Table '3074230175 5' 9-max Seat #4 is the button
Seat 1: LittleBigRUS (7928 in chips) 
Seat 2: PokerArchi95 (8370 in chips) 
Seat 3: 88099686 (9470 in chips) 
Seat 4: Gary.BY (32114 in chips) 
Seat 5: AnHoCa (1337 in chips) is sitting out
Seat 6: jcarlos.vale (8017 in chips) 
Seat 7: iliaspatrik (11009 in chips) 
Seat 8: jrsebold (6377 in chips) 
Seat 9: tensor6969 (2396 in chips) is sitting out
LittleBigRUS: posts the ante 50
PokerArchi95: posts the ante 50
88099686: posts the ante 50
Gary.BY: posts the ante 50
AnHoCa: posts the ante 50
jcarlos.vale: posts the ante 50
iliaspatrik: posts the ante 50
jrsebold: posts the ante 50
tensor6969: posts the ante 50
AnHoCa: posts small blind 200
jcarlos.vale: posts big blind 400
*** HOLE CARDS ***
Dealt to jcarlos.vale [Tc 3c]
iliaspatrik: folds 
jrsebold: folds 
tensor6969: folds 
LittleBigRUS: folds 
PokerArchi95: folds 
88099686: folds 
Gary.BY: raises 400 to 800
AnHoCa: folds 
jcarlos.vale: folds 
Uncalled bet (400) returned to Gary.BY
Gary.BY collected 1450 from pot
Gary.BY: doesn't show handDTO
*** SUMMARY ***
Total pot 1450 | Rake 0 
Seat 1: LittleBigRUS folded before Flop (didn't bet)
Seat 2: PokerArchi95 folded before Flop (didn't bet)
Seat 3: 88099686 folded before Flop (didn't bet)
Seat 4: Gary.BY (button) collected (1450)
Seat 5: AnHoCa (small blind) folded before Flop
Seat 6: jcarlos.vale (big blind) folded before Flop
Seat 7: iliaspatrik folded before Flop (didn't bet)
Seat 8: jrsebold folded before Flop (didn't bet)
Seat 9: tensor6969 folded before Flop (didn't bet)



PokerStars Hand #221588257390: Tournament #3074230175, $0.98+$0.12 USD Hold'em No Limit - Level XII (200/400) - 2020/12/19 0:39:08 EET [2020/12/18 17:39:08 ET]
Table '3074230175 5' 9-max Seat #5 is the button
Seat 1: LittleBigRUS (7878 in chips) 
Seat 2: PokerArchi95 (8320 in chips) 
Seat 3: 88099686 (9420 in chips) 
Seat 4: Gary.BY (33114 in chips) 
Seat 5: AnHoCa (1087 in chips) is sitting out
Seat 6: jcarlos.vale (7567 in chips) 
Seat 7: iliaspatrik (10959 in chips) 
Seat 8: jrsebold (6327 in chips) 
Seat 9: tensor6969 (2346 in chips) is sitting out
LittleBigRUS: posts the ante 50
PokerArchi95: posts the ante 50
88099686: posts the ante 50
Gary.BY: posts the ante 50
AnHoCa: posts the ante 50
jcarlos.vale: posts the ante 50
iliaspatrik: posts the ante 50
jrsebold: posts the ante 50
tensor6969: posts the ante 50
jcarlos.vale: posts small blind 200
iliaspatrik: posts big blind 400
*** HOLE CARDS ***
Dealt to jcarlos.vale [Qs 3d]
jrsebold: folds 
tensor6969: folds 
LittleBigRUS: folds 
PokerArchi95: folds 
88099686: folds 
Gary.BY: raises 400 to 800
AnHoCa: folds 
jcarlos.vale: folds 
iliaspatrik: calls 400
*** FLOP *** [8d 2h 5s]
iliaspatrik: checks 
Gary.BY: bets 2250
iliaspatrik: folds 
Uncalled bet (2250) returned to Gary.BY
Gary.BY collected 2250 from pot
Gary.BY: doesn't show handDTO
*** SUMMARY ***
Total pot 2250 | Rake 0 
Board [8d 2h 5s]
Seat 1: LittleBigRUS folded before Flop (didn't bet)
Seat 2: PokerArchi95 folded before Flop (didn't bet)
Seat 3: 88099686 folded before Flop (didn't bet)
Seat 4: Gary.BY collected (2250)
Seat 5: AnHoCa (button) folded before Flop (didn't bet)
Seat 6: jcarlos.vale (small blind) folded before Flop
Seat 7: iliaspatrik (big blind) folded on the Flop
Seat 8: jrsebold folded before Flop (didn't bet)
Seat 9: tensor6969 folded before Flop (didn't bet)



PokerStars Hand #221588275238: Tournament #3074230175, $0.98+$0.12 USD Hold'em No Limit - Level XII (200/400) - 2020/12/19 0:39:34 EET [2020/12/18 17:39:34 ET]
Table '3074230175 5' 9-max Seat #6 is the button
Seat 1: LittleBigRUS (7828 in chips) 
Seat 2: PokerArchi95 (8270 in chips) 
Seat 3: 88099686 (9370 in chips) 
Seat 4: Gary.BY (34514 in chips) 
Seat 5: AnHoCa (1037 in chips) is sitting out
Seat 6: jcarlos.vale (7317 in chips) 
Seat 7: iliaspatrik (10109 in chips) 
Seat 8: jrsebold (6277 in chips) 
Seat 9: tensor6969 (2296 in chips) is sitting out
LittleBigRUS: posts the ante 50
PokerArchi95: posts the ante 50
88099686: posts the ante 50
Gary.BY: posts the ante 50
AnHoCa: posts the ante 50
jcarlos.vale: posts the ante 50
iliaspatrik: posts the ante 50
jrsebold: posts the ante 50
tensor6969: posts the ante 50
iliaspatrik: posts small blind 200
jrsebold: posts big blind 400
*** HOLE CARDS ***
Dealt to jcarlos.vale [Qs 4c]
tensor6969: folds 
LittleBigRUS: folds 
PokerArchi95: folds 
88099686: folds 
Gary.BY: folds 
AnHoCa: folds 
jcarlos.vale: folds 
iliaspatrik: calls 200
jrsebold: checks 
*** FLOP *** [Ah Th Qd]
iliaspatrik: bets 800
jrsebold: calls 800
*** TURN *** [Ah Th Qd] [Kd]
iliaspatrik: bets 1568
jrsebold: raises 3459 to 5027 and is all-in
iliaspatrik: folds 
Uncalled bet (3459) returned to jrsebold
jrsebold collected 5986 from pot
*** SUMMARY ***
Total pot 5986 | Rake 0 
Board [Ah Th Qd Kd]
Seat 1: LittleBigRUS folded before Flop (didn't bet)
Seat 2: PokerArchi95 folded before Flop (didn't bet)
Seat 3: 88099686 folded before Flop (didn't bet)
Seat 4: Gary.BY folded before Flop (didn't bet)
Seat 5: AnHoCa folded before Flop (didn't bet)
Seat 6: jcarlos.vale (button) folded before Flop (didn't bet)
Seat 7: iliaspatrik (small blind) folded on the Turn
Seat 8: jrsebold (big blind) collected (5986)
Seat 9: tensor6969 folded before Flop (didn't bet)



PokerStars Hand #221588301017: Tournament #3074230175, $0.98+$0.12 USD Hold'em No Limit - Level XII (200/400) - 2020/12/19 0:40:11 EET [2020/12/18 17:40:11 ET]
Table '3074230175 5' 9-max Seat #7 is the button
Seat 1: LittleBigRUS (7778 in chips) 
Seat 2: PokerArchi95 (8220 in chips) 
Seat 3: 88099686 (9320 in chips) 
Seat 4: Gary.BY (34464 in chips) 
Seat 5: AnHoCa (987 in chips) is sitting out
Seat 6: jcarlos.vale (7267 in chips) 
Seat 7: iliaspatrik (7291 in chips) 
Seat 8: jrsebold (9445 in chips) 
Seat 9: tensor6969 (2246 in chips) is sitting out
LittleBigRUS: posts the ante 50
PokerArchi95: posts the ante 50
88099686: posts the ante 50
Gary.BY: posts the ante 50
AnHoCa: posts the ante 50
jcarlos.vale: posts the ante 50
iliaspatrik: posts the ante 50
jrsebold: posts the ante 50
tensor6969: posts the ante 50
jrsebold: posts small blind 200
tensor6969: posts big blind 400
*** HOLE CARDS ***
Dealt to jcarlos.vale [Ks 7s]
LittleBigRUS: folds 
PokerArchi95: folds 
88099686: folds 
Gary.BY: folds 
AnHoCa: folds 
jcarlos.vale: folds 
iliaspatrik: folds 
jrsebold: raises 400 to 800
tensor6969: folds 
Uncalled bet (400) returned to jrsebold
jrsebold collected 1250 from pot
*** SUMMARY ***
Total pot 1250 | Rake 0 
Seat 1: LittleBigRUS folded before Flop (didn't bet)
Seat 2: PokerArchi95 folded before Flop (didn't bet)
Seat 3: 88099686 folded before Flop (didn't bet)
Seat 4: Gary.BY folded before Flop (didn't bet)
Seat 5: AnHoCa folded before Flop (didn't bet)
Seat 6: jcarlos.vale folded before Flop (didn't bet)
Seat 7: iliaspatrik (button) folded before Flop (didn't bet)
Seat 8: jrsebold (small blind) collected (1250)
Seat 9: tensor6969 (big blind) folded before Flop



PokerStars Hand #221588311446: Tournament #3074230175, $0.98+$0.12 USD Hold'em No Limit - Level XII (200/400) - 2020/12/19 0:40:26 EET [2020/12/18 17:40:26 ET]
Table '3074230175 5' 9-max Seat #8 is the button
Seat 1: LittleBigRUS (7728 in chips) 
Seat 3: 88099686 (9270 in chips) 
Seat 4: Gary.BY (34414 in chips) 
Seat 5: AnHoCa (937 in chips) is sitting out
Seat 6: jcarlos.vale (7217 in chips) 
Seat 7: iliaspatrik (7241 in chips) 
Seat 8: jrsebold (10245 in chips) 
Seat 9: tensor6969 (1796 in chips) is sitting out
LittleBigRUS: posts the ante 50
88099686: posts the ante 50
Gary.BY: posts the ante 50
AnHoCa: posts the ante 50
jcarlos.vale: posts the ante 50
iliaspatrik: posts the ante 50
jrsebold: posts the ante 50
tensor6969: posts the ante 50
tensor6969: posts small blind 200
LittleBigRUS: posts big blind 400
*** HOLE CARDS ***
Dealt to jcarlos.vale [4h 7c]
88099686: folds 
Gary.BY: folds 
AnHoCa: folds 
jcarlos.vale: folds 
iliaspatrik: folds 
jrsebold: raises 400 to 800
tensor6969: folds 
LittleBigRUS: calls 400
*** FLOP *** [Th 3c Tc]
LittleBigRUS: checks 
jrsebold: bets 800
LittleBigRUS: calls 800
*** TURN *** [Th 3c Tc] [4d]
LittleBigRUS: checks 
jrsebold: bets 8595 and is all-in
LittleBigRUS: folds 
Uncalled bet (8595) returned to jrsebold
jrsebold collected 3800 from pot
*** SUMMARY ***
Total pot 3800 | Rake 0 
Board [Th 3c Tc 4d]
Seat 1: LittleBigRUS (big blind) folded on the Turn
Seat 3: 88099686 folded before Flop (didn't bet)
Seat 4: Gary.BY folded before Flop (didn't bet)
Seat 5: AnHoCa folded before Flop (didn't bet)
Seat 6: jcarlos.vale folded before Flop (didn't bet)
Seat 7: iliaspatrik folded before Flop (didn't bet)
Seat 8: jrsebold (button) collected (3800)
Seat 9: tensor6969 (small blind) folded before Flop



PokerStars Hand #221588335905: Tournament #3074230175, $0.98+$0.12 USD Hold'em No Limit - Level XII (200/400) - 2020/12/19 0:41:02 EET [2020/12/18 17:41:02 ET]
Table '3074230175 5' 9-max Seat #9 is the button
Seat 1: LittleBigRUS (6078 in chips) 
Seat 3: 88099686 (9220 in chips) 
Seat 4: Gary.BY (34364 in chips) 
Seat 5: AnHoCa (887 in chips) is sitting out
Seat 6: jcarlos.vale (7167 in chips) 
Seat 7: iliaspatrik (7191 in chips) 
Seat 8: jrsebold (12395 in chips) 
Seat 9: tensor6969 (1546 in chips) is sitting out
LittleBigRUS: posts the ante 50
88099686: posts the ante 50
Gary.BY: posts the ante 50
AnHoCa: posts the ante 50
jcarlos.vale: posts the ante 50
iliaspatrik: posts the ante 50
jrsebold: posts the ante 50
tensor6969: posts the ante 50
LittleBigRUS: posts small blind 200
88099686: posts big blind 400
*** HOLE CARDS ***
Dealt to jcarlos.vale [Qd Qs]
Gary.BY: folds 
AnHoCa: folds 
jcarlos.vale has timed out
jcarlos.vale: folds 
jcarlos.vale is sitting out
iliaspatrik: folds 
jrsebold: folds 
tensor6969: folds 
LittleBigRUS: folds 
Uncalled bet (200) returned to 88099686
88099686 collected 800 from pot
88099686: doesn't show handDTO
*** SUMMARY ***
Total pot 800 | Rake 0 
Seat 1: LittleBigRUS (small blind) folded before Flop
Seat 3: 88099686 (big blind) collected (800)
Seat 4: Gary.BY folded before Flop (didn't bet)
Seat 5: AnHoCa folded before Flop (didn't bet)
Seat 6: jcarlos.vale folded before Flop (didn't bet)
Seat 7: iliaspatrik folded before Flop (didn't bet)
Seat 8: jrsebold folded before Flop (didn't bet)
Seat 9: tensor6969 (button) folded before Flop (didn't bet)



PokerStars Hand #221588349169: Tournament #3074230175, $0.98+$0.12 USD Hold'em No Limit - Level XII (200/400) - 2020/12/19 0:41:21 EET [2020/12/18 17:41:21 ET]
Table '3074230175 5' 9-max Seat #1 is the button
Seat 1: LittleBigRUS (5828 in chips) 
Seat 3: 88099686 (9770 in chips) 
Seat 4: Gary.BY (34314 in chips) 
Seat 5: AnHoCa (837 in chips) is sitting out
Seat 6: jcarlos.vale (7117 in chips) is sitting out
Seat 7: iliaspatrik (7141 in chips) 
Seat 8: jrsebold (12345 in chips) 
Seat 9: tensor6969 (1496 in chips) is sitting out
LittleBigRUS: posts the ante 50
88099686: posts the ante 50
Gary.BY: posts the ante 50
AnHoCa: posts the ante 50
jcarlos.vale: posts the ante 50
iliaspatrik: posts the ante 50
jrsebold: posts the ante 50
tensor6969: posts the ante 50
88099686: posts small blind 200
Gary.BY: posts big blind 400
*** HOLE CARDS ***
Dealt to jcarlos.vale [Ks 9d]
AnHoCa: folds 
jcarlos.vale: folds 
iliaspatrik: folds 
jrsebold: folds 
tensor6969: folds 
LittleBigRUS: folds 
88099686: calls 200
jcarlos.vale has returned
Gary.BY: checks 
*** FLOP *** [4c 3h 8c]
88099686: bets 400
Gary.BY: calls 400
*** TURN *** [4c 3h 8c] [Qh]
88099686: checks 
Gary.BY: bets 800
88099686: folds 
Uncalled bet (800) returned to Gary.BY
Gary.BY collected 2000 from pot
Gary.BY: doesn't show handDTO
*** SUMMARY ***
Total pot 2000 | Rake 0 
Board [4c 3h 8c Qh]
Seat 1: LittleBigRUS (button) folded before Flop (didn't bet)
Seat 3: 88099686 (small blind) folded on the Turn
Seat 4: Gary.BY (big blind) collected (2000)
Seat 5: AnHoCa folded before Flop (didn't bet)
Seat 6: jcarlos.vale folded before Flop (didn't bet)
Seat 7: iliaspatrik folded before Flop (didn't bet)
Seat 8: jrsebold folded before Flop (didn't bet)
Seat 9: tensor6969 folded before Flop (didn't bet)



PokerStars Hand #221588370459: Tournament #3074230175, $0.98+$0.12 USD Hold'em No Limit - Level XII (200/400) - 2020/12/19 0:41:52 EET [2020/12/18 17:41:52 ET]
Table '3074230175 5' 9-max Seat #3 is the button
Seat 1: LittleBigRUS (5778 in chips) 
Seat 3: 88099686 (8920 in chips) 
Seat 4: Gary.BY (35464 in chips) 
Seat 5: AnHoCa (787 in chips) is sitting out
Seat 6: jcarlos.vale (7067 in chips) 
Seat 7: iliaspatrik (7091 in chips) 
Seat 8: jrsebold (12295 in chips) 
Seat 9: tensor6969 (1446 in chips) is sitting out
LittleBigRUS: posts the ante 50
88099686: posts the ante 50
Gary.BY: posts the ante 50
AnHoCa: posts the ante 50
jcarlos.vale: posts the ante 50
iliaspatrik: posts the ante 50
jrsebold: posts the ante 50
tensor6969: posts the ante 50
Gary.BY: posts small blind 200
AnHoCa: posts big blind 400
*** HOLE CARDS ***
Dealt to jcarlos.vale [As 6s]
jcarlos.vale has timed out
jcarlos.vale: folds 
jcarlos.vale is sitting out
jcarlos.vale has returned
iliaspatrik: raises 600 to 1000
jrsebold: folds 
tensor6969: folds 
LittleBigRUS: folds 
88099686: folds 
Gary.BY: raises 34414 to 35414 and is all-in
AnHoCa: folds 
iliaspatrik: calls 6041 and is all-in
Uncalled bet (28373) returned to Gary.BY
*** FLOP *** [Jc Th Js]
*** TURN *** [Jc Th Js] [Jd]
*** RIVER *** [Jc Th Js Jd] [3d]
*** SHOW DOWN ***
Gary.BY: shows [7s Ah] (three of a kind, Jacks)
iliaspatrik: shows [Td Ad] (a full house, Jacks full of Tens)
iliaspatrik collected 14882 from pot
*** SUMMARY ***
Total pot 14882 | Rake 0 
Board [Jc Th Js Jd 3d]
Seat 1: LittleBigRUS folded before Flop (didn't bet)
Seat 3: 88099686 (button) folded before Flop (didn't bet)
Seat 4: Gary.BY (small blind) showed [7s Ah] and lost with three of a kind, Jacks
Seat 5: AnHoCa (big blind) folded before Flop
Seat 6: jcarlos.vale folded before Flop (didn't bet)
Seat 7: iliaspatrik showed [Td Ad] and won (14882) with a full house, Jacks full of Tens
Seat 8: jrsebold folded before Flop (didn't bet)
Seat 9: tensor6969 folded before Flop (didn't bet)



PokerStars Hand #221588402272: Tournament #3074230175, $0.98+$0.12 USD Hold'em No Limit - Level XII (200/400) - 2020/12/19 0:42:39 EET [2020/12/18 17:42:39 ET]
Table '3074230175 5' 9-max Seat #4 is the button
Seat 1: LittleBigRUS (5728 in chips) 
Seat 2: smok80 (9942 in chips) 
Seat 3: 88099686 (8870 in chips) 
Seat 4: Gary.BY (28373 in chips) 
Seat 5: AnHoCa (337 in chips) is sitting out
Seat 6: jcarlos.vale (7017 in chips) 
Seat 7: iliaspatrik (14882 in chips) 
Seat 8: jrsebold (12245 in chips) 
Seat 9: tensor6969 (1396 in chips) is sitting out
LittleBigRUS: posts the ante 50
smok80: posts the ante 50
88099686: posts the ante 50
Gary.BY: posts the ante 50
AnHoCa: posts the ante 50
jcarlos.vale: posts the ante 50
iliaspatrik: posts the ante 50
jrsebold: posts the ante 50
tensor6969: posts the ante 50
AnHoCa: posts small blind 200
jcarlos.vale: posts big blind 400
*** HOLE CARDS ***
Dealt to jcarlos.vale [8d Kc]
iliaspatrik: folds 
jrsebold: folds 
tensor6969: folds 
LittleBigRUS: folds 
smok80: folds 
88099686: calls 400
Gary.BY: raises 27923 to 28323 and is all-in
AnHoCa: folds 
jcarlos.vale: folds 
88099686: folds 
Uncalled bet (27923) returned to Gary.BY
Gary.BY collected 1850 from pot
Gary.BY: doesn't show handDTO
*** SUMMARY ***
Total pot 1850 | Rake 0 
Seat 1: LittleBigRUS folded before Flop (didn't bet)
Seat 2: smok80 folded before Flop (didn't bet)
Seat 3: 88099686 folded before Flop
Seat 4: Gary.BY (button) collected (1850)
Seat 5: AnHoCa (small blind) folded before Flop
Seat 6: jcarlos.vale (big blind) folded before Flop
Seat 7: iliaspatrik folded before Flop (didn't bet)
Seat 8: jrsebold folded before Flop (didn't bet)
Seat 9: tensor6969 folded before Flop (didn't bet)



PokerStars Hand #221588422172: Tournament #3074230175, $0.98+$0.12 USD Hold'em No Limit - Level XII (200/400) - 2020/12/19 0:43:07 EET [2020/12/18 17:43:07 ET]
Table '3074230175 5' 9-max Seat #5 is the button
Seat 1: LittleBigRUS (5678 in chips) 
Seat 2: smok80 (9892 in chips) 
Seat 3: 88099686 (8420 in chips) 
Seat 4: Gary.BY (29773 in chips) 
Seat 5: AnHoCa (87 in chips) is sitting out
Seat 6: jcarlos.vale (6567 in chips) 
Seat 7: iliaspatrik (14832 in chips) 
Seat 8: jrsebold (12195 in chips) 
Seat 9: tensor6969 (1346 in chips) is sitting out
LittleBigRUS: posts the ante 50
smok80: posts the ante 50
88099686: posts the ante 50
Gary.BY: posts the ante 50
AnHoCa: posts the ante 50
jcarlos.vale: posts the ante 50
iliaspatrik: posts the ante 50
jrsebold: posts the ante 50
tensor6969: posts the ante 50
jcarlos.vale: posts small blind 200
iliaspatrik: posts big blind 400
*** HOLE CARDS ***
Dealt to jcarlos.vale [3s 2h]
jrsebold: folds 
tensor6969: folds 
LittleBigRUS: folds 
smok80: folds 
88099686: folds 
Gary.BY: folds 
AnHoCa: folds 
jcarlos.vale: folds 
Uncalled bet (200) returned to iliaspatrik
iliaspatrik collected 850 from pot
iliaspatrik: doesn't show handDTO
*** SUMMARY ***
Total pot 850 | Rake 0 
Seat 1: LittleBigRUS folded before Flop (didn't bet)
Seat 2: smok80 folded before Flop (didn't bet)
Seat 3: 88099686 folded before Flop (didn't bet)
Seat 4: Gary.BY folded before Flop (didn't bet)
Seat 5: AnHoCa (button) folded before Flop (didn't bet)
Seat 6: jcarlos.vale (small blind) folded before Flop
Seat 7: iliaspatrik (big blind) collected (850)
Seat 8: jrsebold folded before Flop (didn't bet)
Seat 9: tensor6969 folded before Flop (didn't bet)



PokerStars Hand #221588435832: Tournament #3074230175, $0.98+$0.12 USD Hold'em No Limit - Level XII (200/400) - 2020/12/19 0:43:28 EET [2020/12/18 17:43:28 ET]
Table '3074230175 5' 9-max Seat #6 is the button
Seat 1: LittleBigRUS (5628 in chips) 
Seat 2: smok80 (9842 in chips) 
Seat 3: 88099686 (8370 in chips) 
Seat 4: Gary.BY (29723 in chips) 
Seat 5: AnHoCa (37 in chips) is sitting out
Seat 6: jcarlos.vale (6317 in chips) 
Seat 7: iliaspatrik (15432 in chips) 
Seat 8: jrsebold (12145 in chips) 
Seat 9: tensor6969 (1296 in chips) is sitting out
LittleBigRUS: posts the ante 50
smok80: posts the ante 50
88099686: posts the ante 50
Gary.BY: posts the ante 50
AnHoCa: posts the ante 37 and is all-in
jcarlos.vale: posts the ante 50
iliaspatrik: posts the ante 50
jrsebold: posts the ante 50
tensor6969: posts the ante 50
iliaspatrik: posts small blind 200
jrsebold: posts big blind 400
*** HOLE CARDS ***
Dealt to jcarlos.vale [4c 9s]
tensor6969: folds 
LittleBigRUS: folds 
smok80: raises 480 to 880
88099686: folds 
Gary.BY: calls 880
AnHoCa: folds 
jcarlos.vale: folds 
iliaspatrik: folds 
jrsebold has timed out
jrsebold: folds 
jrsebold is sitting out
*** FLOP *** [5h 2s Kc]
smok80: checks 
jrsebold has returned
Gary.BY: bets 800
smok80: folds 
Uncalled bet (800) returned to Gary.BY
Gary.BY collected 2797 from pot
AnHoCa finished the tournament in 205th place
Gary.BY: doesn't show handDTO
*** SUMMARY ***
Total pot 2797 | Rake 0 
Board [5h 2s Kc]
Seat 1: LittleBigRUS folded before Flop (didn't bet)
Seat 2: smok80 folded on the Flop
Seat 3: 88099686 folded before Flop (didn't bet)
Seat 4: Gary.BY collected (2797)
Seat 5: AnHoCa folded before Flop (didn't bet)
Seat 6: jcarlos.vale (button) folded before Flop (didn't bet)
Seat 7: iliaspatrik (small blind) folded before Flop
Seat 8: jrsebold (big blind) folded before Flop
Seat 9: tensor6969 folded before Flop (didn't bet)



PokerStars Hand #221588475761: Tournament #3074230175, $0.98+$0.12 USD Hold'em No Limit - Level XIII (250/500) - 2020/12/19 0:44:26 EET [2020/12/18 17:44:26 ET]
Table '3074230175 5' 9-max Seat #7 is the button
Seat 1: LittleBigRUS (5578 in chips) 
Seat 2: smok80 (8912 in chips) 
Seat 3: 88099686 (8320 in chips) 
Seat 4: Gary.BY (31590 in chips) 
Seat 6: jcarlos.vale (6267 in chips) 
Seat 7: iliaspatrik (15182 in chips) 
Seat 8: jrsebold (11695 in chips) 
Seat 9: tensor6969 (1246 in chips) is sitting out
LittleBigRUS: posts the ante 60
smok80: posts the ante 60
88099686: posts the ante 60
Gary.BY: posts the ante 60
jcarlos.vale: posts the ante 60
iliaspatrik: posts the ante 60
jrsebold: posts the ante 60
tensor6969: posts the ante 60
jrsebold: posts small blind 250
tensor6969: posts big blind 500
*** HOLE CARDS ***
Dealt to jcarlos.vale [2h 5h]
LittleBigRUS: folds 
smok80: folds 
88099686: folds 
Gary.BY: raises 500 to 1000
jcarlos.vale: folds 
iliaspatrik: folds 
jrsebold: folds 
tensor6969: folds 
Uncalled bet (500) returned to Gary.BY
Gary.BY collected 1730 from pot
Gary.BY: doesn't show handDTO
*** SUMMARY ***
Total pot 1730 | Rake 0 
Seat 1: LittleBigRUS folded before Flop (didn't bet)
Seat 2: smok80 folded before Flop (didn't bet)
Seat 3: 88099686 folded before Flop (didn't bet)
Seat 4: Gary.BY collected (1730)
Seat 6: jcarlos.vale folded before Flop (didn't bet)
Seat 7: iliaspatrik (button) folded before Flop (didn't bet)
Seat 8: jrsebold (small blind) folded before Flop
Seat 9: tensor6969 (big blind) folded before Flop



PokerStars Hand #221588506207: Tournament #3074230175, $0.98+$0.12 USD Hold'em No Limit - Level XIII (250/500) - 2020/12/19 0:45:01 EET [2020/12/18 17:45:01 ET]
Table '3074230175 5' 9-max Seat #8 is the button
Seat 1: LittleBigRUS (5518 in chips) 
Seat 2: smok80 (8852 in chips) 
Seat 3: 88099686 (8260 in chips) 
Seat 4: Gary.BY (32760 in chips) 
Seat 6: jcarlos.vale (6207 in chips) 
Seat 7: iliaspatrik (15122 in chips) 
Seat 8: jrsebold (11385 in chips) 
Seat 9: tensor6969 (686 in chips) is sitting out
LittleBigRUS: posts the ante 60
smok80: posts the ante 60
88099686: posts the ante 60
Gary.BY: posts the ante 60
jcarlos.vale: posts the ante 60
iliaspatrik: posts the ante 60
jrsebold: posts the ante 60
tensor6969: posts the ante 60
tensor6969: posts small blind 250
LittleBigRUS: posts big blind 500
*** HOLE CARDS ***
Dealt to jcarlos.vale [3h 3s]
smok80: raises 600 to 1100
88099686: folds 
Gary.BY: folds 
jcarlos.vale: folds 
iliaspatrik: folds 
jrsebold: folds 
tensor6969: folds 
LittleBigRUS: calls 600
*** FLOP *** [5d 9h 2d]
LittleBigRUS: checks 
smok80: bets 1963
LittleBigRUS: folds 
Uncalled bet (1963) returned to smok80
smok80 collected 2930 from pot
smok80: doesn't show handDTO
*** SUMMARY ***
Total pot 2930 | Rake 0 
Board [5d 9h 2d]
Seat 1: LittleBigRUS (big blind) folded on the Flop
Seat 2: smok80 collected (2930)
Seat 3: 88099686 folded before Flop (didn't bet)
Seat 4: Gary.BY folded before Flop (didn't bet)
Seat 6: jcarlos.vale folded before Flop (didn't bet)
Seat 7: iliaspatrik folded before Flop (didn't bet)
Seat 8: jrsebold (button) folded before Flop (didn't bet)
Seat 9: tensor6969 (small blind) folded before Flop



PokerStars Hand #221588526023: Tournament #3074230175, $0.98+$0.12 USD Hold'em No Limit - Level XIII (250/500) - 2020/12/19 0:45:30 EET [2020/12/18 17:45:30 ET]
Table '3074230175 5' 9-max Seat #9 is the button
Seat 1: LittleBigRUS (4358 in chips) 
Seat 2: smok80 (10622 in chips) 
Seat 3: 88099686 (8200 in chips) 
Seat 4: Gary.BY (32700 in chips) 
Seat 6: jcarlos.vale (6147 in chips) 
Seat 7: iliaspatrik (15062 in chips) 
Seat 8: jrsebold (11325 in chips) 
Seat 9: tensor6969 (376 in chips) is sitting out
LittleBigRUS: posts the ante 60
smok80: posts the ante 60
88099686: posts the ante 60
Gary.BY: posts the ante 60
jcarlos.vale: posts the ante 60
iliaspatrik: posts the ante 60
jrsebold: posts the ante 60
tensor6969: posts the ante 60
LittleBigRUS: posts small blind 250
smok80: posts big blind 500
*** HOLE CARDS ***
Dealt to jcarlos.vale [6h Qh]
88099686: calls 500
Gary.BY: raises 1000 to 1500
jcarlos.vale: folds 
iliaspatrik: folds 
jrsebold: folds 
tensor6969: folds 
LittleBigRUS: folds 
smok80: folds 
88099686: folds 
Uncalled bet (1000) returned to Gary.BY
Gary.BY collected 2230 from pot
Gary.BY: doesn't show handDTO
*** SUMMARY ***
Total pot 2230 | Rake 0 
Seat 1: LittleBigRUS (small blind) folded before Flop
Seat 2: smok80 (big blind) folded before Flop
Seat 3: 88099686 folded before Flop
Seat 4: Gary.BY collected (2230)
Seat 6: jcarlos.vale folded before Flop (didn't bet)
Seat 7: iliaspatrik folded before Flop (didn't bet)
Seat 8: jrsebold folded before Flop (didn't bet)
Seat 9: tensor6969 (button) folded before Flop (didn't bet)



PokerStars Hand #221588539460: Tournament #3074230175, $0.98+$0.12 USD Hold'em No Limit - Level XIII (250/500) - 2020/12/19 0:45:50 EET [2020/12/18 17:45:50 ET]
Table '3074230175 5' 9-max Seat #1 is the button
Seat 1: LittleBigRUS (4048 in chips) 
Seat 2: smok80 (10062 in chips) 
Seat 3: 88099686 (7640 in chips) 
Seat 4: Gary.BY (34370 in chips) 
Seat 6: jcarlos.vale (6087 in chips) 
Seat 7: iliaspatrik (15002 in chips) 
Seat 8: jrsebold (11265 in chips) 
Seat 9: tensor6969 (316 in chips) is sitting out
LittleBigRUS: posts the ante 60
smok80: posts the ante 60
88099686: posts the ante 60
Gary.BY: posts the ante 60
jcarlos.vale: posts the ante 60
iliaspatrik: posts the ante 60
jrsebold: posts the ante 60
tensor6969: posts the ante 60
smok80: posts small blind 250
88099686: posts big blind 500
*** HOLE CARDS ***
Dealt to jcarlos.vale [Th 8d]
Gary.BY: folds 
jcarlos.vale: folds 
iliaspatrik: folds 
jrsebold: folds 
tensor6969: folds 
LittleBigRUS: folds 
smok80: raises 9502 to 10002 and is all-in
88099686: folds 
Uncalled bet (9502) returned to smok80
smok80 collected 1480 from pot
smok80: doesn't show handDTO
*** SUMMARY ***
Total pot 1480 | Rake 0 
Seat 1: LittleBigRUS (button) folded before Flop (didn't bet)
Seat 2: smok80 (small blind) collected (1480)
Seat 3: 88099686 (big blind) folded before Flop
Seat 4: Gary.BY folded before Flop (didn't bet)
Seat 6: jcarlos.vale folded before Flop (didn't bet)
Seat 7: iliaspatrik folded before Flop (didn't bet)
Seat 8: jrsebold folded before Flop (didn't bet)
Seat 9: tensor6969 folded before Flop (didn't bet)



PokerStars Hand #221588557520: Tournament #3074230175, $0.98+$0.12 USD Hold'em No Limit - Level XIII (250/500) - 2020/12/19 0:46:16 EET [2020/12/18 17:46:16 ET]
Table '3074230175 5' 9-max Seat #2 is the button
Seat 1: LittleBigRUS (3988 in chips) 
Seat 2: smok80 (10982 in chips) 
Seat 3: 88099686 (7080 in chips) 
Seat 4: Gary.BY (34310 in chips) 
Seat 6: jcarlos.vale (6027 in chips) 
Seat 7: iliaspatrik (14942 in chips) 
Seat 8: jrsebold (11205 in chips) 
Seat 9: tensor6969 (256 in chips) is sitting out
LittleBigRUS: posts the ante 60
smok80: posts the ante 60
88099686: posts the ante 60
Gary.BY: posts the ante 60
jcarlos.vale: posts the ante 60
iliaspatrik: posts the ante 60
jrsebold: posts the ante 60
tensor6969: posts the ante 60
88099686: posts small blind 250
Gary.BY: posts big blind 500
*** HOLE CARDS ***
Dealt to jcarlos.vale [8c Kh]
jcarlos.vale: folds 
iliaspatrik: folds 
jrsebold: folds 
tensor6969: folds 
LittleBigRUS: folds 
smok80: folds 
88099686: folds 
Uncalled bet (250) returned to Gary.BY
Gary.BY collected 980 from pot
*** SUMMARY ***
Total pot 980 | Rake 0 
Seat 1: LittleBigRUS folded before Flop (didn't bet)
Seat 2: smok80 (button) folded before Flop (didn't bet)
Seat 3: 88099686 (small blind) folded before Flop
Seat 4: Gary.BY (big blind) collected (980)
Seat 6: jcarlos.vale folded before Flop (didn't bet)
Seat 7: iliaspatrik folded before Flop (didn't bet)
Seat 8: jrsebold folded before Flop (didn't bet)
Seat 9: tensor6969 folded before Flop (didn't bet)



PokerStars Hand #221588572242: Tournament #3074230175, $0.98+$0.12 USD Hold'em No Limit - Level XIII (250/500) - 2020/12/19 0:46:37 EET [2020/12/18 17:46:37 ET]
Table '3074230175 5' 9-max Seat #3 is the button
Seat 1: LittleBigRUS (3928 in chips) 
Seat 2: smok80 (10922 in chips) 
Seat 3: 88099686 (6770 in chips) 
Seat 4: Gary.BY (34980 in chips) 
Seat 6: jcarlos.vale (5967 in chips) 
Seat 7: iliaspatrik (14882 in chips) 
Seat 8: jrsebold (11145 in chips) 
Seat 9: tensor6969 (196 in chips) is sitting out
LittleBigRUS: posts the ante 60
smok80: posts the ante 60
88099686: posts the ante 60
Gary.BY: posts the ante 60
jcarlos.vale: posts the ante 60
iliaspatrik: posts the ante 60
jrsebold: posts the ante 60
tensor6969: posts the ante 60
Gary.BY: posts small blind 250
jcarlos.vale: posts big blind 500
*** HOLE CARDS ***
Dealt to jcarlos.vale [6s 8s]
iliaspatrik: raises 750 to 1250
jrsebold: folds 
tensor6969: folds 
LittleBigRUS: folds 
smok80: calls 1250
88099686: folds 
Gary.BY: folds 
jcarlos.vale: folds 
*** FLOP *** [Qc Jh 8c]
iliaspatrik: checks 
smok80: bets 1380
iliaspatrik: calls 1380
*** TURN *** [Qc Jh 8c] [5s]
iliaspatrik: checks 
smok80: bets 4348
iliaspatrik: calls 4348
*** RIVER *** [Qc Jh 8c 5s] [3h]
iliaspatrik: checks 
smok80: bets 3884 and is all-in
iliaspatrik: calls 3884
*** SHOW DOWN ***
smok80: shows [Qs Js] (two pair, Queens and Jacks)
iliaspatrik: shows [Ah As] (a pair of Aces)
smok80 collected 22954 from pot
*** SUMMARY ***
Total pot 22954 | Rake 0 
Board [Qc Jh 8c 5s 3h]
Seat 1: LittleBigRUS folded before Flop (didn't bet)
Seat 2: smok80 showed [Qs Js] and won (22954) with two pair, Queens and Jacks
Seat 3: 88099686 (button) folded before Flop (didn't bet)
Seat 4: Gary.BY (small blind) folded before Flop
Seat 6: jcarlos.vale (big blind) folded before Flop
Seat 7: iliaspatrik showed [Ah As] and lost with a pair of Aces
Seat 8: jrsebold folded before Flop (didn't bet)
Seat 9: tensor6969 folded before Flop (didn't bet)



PokerStars Hand #221588603510: Tournament #3074230175, $0.98+$0.12 USD Hold'em No Limit - Level XIII (250/500) - 2020/12/19 0:47:23 EET [2020/12/18 17:47:23 ET]
Table '3074230175 5' 9-max Seat #4 is the button
Seat 1: LittleBigRUS (3868 in chips) 
Seat 2: smok80 (22954 in chips) 
Seat 3: 88099686 (6710 in chips) 
Seat 4: Gary.BY (34670 in chips) 
Seat 6: jcarlos.vale (5407 in chips) 
Seat 7: iliaspatrik (3960 in chips) 
Seat 8: jrsebold (11085 in chips) 
Seat 9: tensor6969 (136 in chips) is sitting out
LittleBigRUS: posts the ante 60
smok80: posts the ante 60
88099686: posts the ante 60
Gary.BY: posts the ante 60
jcarlos.vale: posts the ante 60
iliaspatrik: posts the ante 60
jrsebold: posts the ante 60
tensor6969: posts the ante 60
jcarlos.vale: posts small blind 250
iliaspatrik: posts big blind 500
*** HOLE CARDS ***
Dealt to jcarlos.vale [Qd 2s]
jrsebold: folds 
tensor6969: folds 
LittleBigRUS: folds 
smok80: folds 
88099686: folds 
Gary.BY: folds 
jcarlos.vale: folds 
Uncalled bet (250) returned to iliaspatrik
iliaspatrik collected 980 from pot
iliaspatrik: doesn't show handDTO
*** SUMMARY ***
Total pot 980 | Rake 0 
Seat 1: LittleBigRUS folded before Flop (didn't bet)
Seat 2: smok80 folded before Flop (didn't bet)
Seat 3: 88099686 folded before Flop (didn't bet)
Seat 4: Gary.BY (button) folded before Flop (didn't bet)
Seat 6: jcarlos.vale (small blind) folded before Flop
Seat 7: iliaspatrik (big blind) collected (980)
Seat 8: jrsebold folded before Flop (didn't bet)
Seat 9: tensor6969 folded before Flop (didn't bet)



PokerStars Hand #221588614815: Tournament #3074230175, $0.98+$0.12 USD Hold'em No Limit - Level XIII (250/500) - 2020/12/19 0:47:40 EET [2020/12/18 17:47:40 ET]
Table '3074230175 5' 9-max Seat #6 is the button
Seat 1: LittleBigRUS (3808 in chips) 
Seat 2: smok80 (22894 in chips) 
Seat 3: 88099686 (6650 in chips) 
Seat 4: Gary.BY (34610 in chips) 
Seat 6: jcarlos.vale (5097 in chips) 
Seat 7: iliaspatrik (4630 in chips) 
Seat 8: jrsebold (11025 in chips) 
Seat 9: tensor6969 (76 in chips) is sitting out
LittleBigRUS: posts the ante 60
smok80: posts the ante 60
88099686: posts the ante 60
Gary.BY: posts the ante 60
jcarlos.vale: posts the ante 60
iliaspatrik: posts the ante 60
jrsebold: posts the ante 60
tensor6969: posts the ante 60
iliaspatrik: posts small blind 250
jrsebold: posts big blind 500
*** HOLE CARDS ***
Dealt to jcarlos.vale [3c Qd]
tensor6969: folds 
LittleBigRUS: folds 
smok80: raises 800 to 1300
88099686: folds 
Gary.BY: calls 1300
jcarlos.vale: folds 
iliaspatrik: folds 
jrsebold: raises 9665 to 10965 and is all-in
smok80: folds 
Gary.BY: folds 
Uncalled bet (9665) returned to jrsebold
jrsebold collected 4630 from pot
*** SUMMARY ***
Total pot 4630 | Rake 0 
Seat 1: LittleBigRUS folded before Flop (didn't bet)
Seat 2: smok80 folded before Flop
Seat 3: 88099686 folded before Flop (didn't bet)
Seat 4: Gary.BY folded before Flop
Seat 6: jcarlos.vale (button) folded before Flop (didn't bet)
Seat 7: iliaspatrik (small blind) folded before Flop
Seat 8: jrsebold (big blind) collected (4630)
Seat 9: tensor6969 folded before Flop (didn't bet)



PokerStars Hand #221588655360: Tournament #3074230175, $0.98+$0.12 USD Hold'em No Limit - Level XIII (250/500) - 2020/12/19 0:48:39 EET [2020/12/18 17:48:39 ET]
Table '3074230175 5' 9-max Seat #7 is the button
Seat 1: LittleBigRUS (3748 in chips) 
Seat 2: smok80 (21534 in chips) 
Seat 3: 88099686 (6590 in chips) 
Seat 4: Gary.BY (33250 in chips) 
Seat 5: jhonathanm8 (2226 in chips) 
Seat 6: jcarlos.vale (5037 in chips) 
Seat 7: iliaspatrik (4320 in chips) 
Seat 8: jrsebold (14295 in chips) 
Seat 9: tensor6969 (16 in chips) is sitting out
LittleBigRUS: posts the ante 60
smok80: posts the ante 60
88099686: posts the ante 60
Gary.BY: posts the ante 60
jhonathanm8: posts the ante 60
jcarlos.vale: posts the ante 60
iliaspatrik: posts the ante 60
jrsebold: posts the ante 60
tensor6969: posts the ante 16 and is all-in
jrsebold: posts small blind 250
*** HOLE CARDS ***
Dealt to jcarlos.vale [5h 9d]
LittleBigRUS: folds 
smok80: folds 
88099686: folds 
Gary.BY: folds 
jhonathanm8: raises 1916 to 2166 and is all-in
jcarlos.vale: folds 
iliaspatrik: folds 
jrsebold: folds 
tensor6969: folds 
Uncalled bet (1916) returned to jhonathanm8
jhonathanm8 collected 996 from pot
tensor6969 finished the tournament in 192nd place
*** SUMMARY ***
Total pot 996 | Rake 0 
Seat 1: LittleBigRUS folded before Flop (didn't bet)
Seat 2: smok80 folded before Flop (didn't bet)
Seat 3: 88099686 folded before Flop (didn't bet)
Seat 4: Gary.BY folded before Flop (didn't bet)
Seat 5: jhonathanm8 collected (996)
Seat 6: jcarlos.vale folded before Flop (didn't bet)
Seat 7: iliaspatrik (button) folded before Flop (didn't bet)
Seat 8: jrsebold (small blind) folded before Flop
Seat 9: tensor6969 folded before Flop (didn't bet)



PokerStars Hand #221588670129: Tournament #3074230175, $0.98+$0.12 USD Hold'em No Limit - Level XIII (250/500) - 2020/12/19 0:49:01 EET [2020/12/18 17:49:01 ET]
Table '3074230175 5' 9-max Seat #8 is the button
Seat 1: LittleBigRUS (3688 in chips) 
Seat 2: smok80 (21474 in chips) 
Seat 3: 88099686 (6530 in chips) 
Seat 4: Gary.BY (33190 in chips) 
Seat 5: jhonathanm8 (2912 in chips) 
Seat 6: jcarlos.vale (4977 in chips) 
Seat 7: iliaspatrik (4260 in chips) 
Seat 8: jrsebold (13985 in chips) 
LittleBigRUS: posts the ante 60
smok80: posts the ante 60
88099686: posts the ante 60
Gary.BY: posts the ante 60
jhonathanm8: posts the ante 60
jcarlos.vale: posts the ante 60
iliaspatrik: posts the ante 60
jrsebold: posts the ante 60
LittleBigRUS: posts small blind 250
smok80: posts big blind 500
*** HOLE CARDS ***
Dealt to jcarlos.vale [Ad 2h]
88099686: folds 
Gary.BY: raises 500 to 1000
jhonathanm8: folds 
jcarlos.vale: folds 
iliaspatrik: raises 3000 to 4000
jrsebold: folds 
LittleBigRUS: folds 
smok80: folds 
Gary.BY: raises 3000 to 7000
iliaspatrik: calls 200 and is all-in
Uncalled bet (2800) returned to Gary.BY
*** FLOP *** [Ts 4h Qc]
*** TURN *** [Ts 4h Qc] [6s]
*** RIVER *** [Ts 4h Qc 6s] [4c]
*** SHOW DOWN ***
Gary.BY: shows [As Jc] (a pair of Fours)
iliaspatrik: shows [Kd Jd] (a pair of Fours - lower kicker)
Gary.BY collected 9630 from pot
*** SUMMARY ***
Total pot 9630 | Rake 0 
Board [Ts 4h Qc 6s 4c]
Seat 1: LittleBigRUS (small blind) folded before Flop
Seat 2: smok80 (big blind) folded before Flop
Seat 3: 88099686 folded before Flop (didn't bet)
Seat 4: Gary.BY showed [As Jc] and won (9630) with a pair of Fours
Seat 5: jhonathanm8 folded before Flop (didn't bet)
Seat 6: jcarlos.vale folded before Flop (didn't bet)
Seat 7: iliaspatrik showed [Kd Jd] and lost with a pair of Fours
Seat 8: jrsebold (button) folded before Flop (didn't bet)



PokerStars Hand #221588744580: Tournament #3074230175, $0.98+$0.12 USD Hold'em No Limit - Level XIII (250/500) - 2020/12/19 0:50:52 EET [2020/12/18 17:50:52 ET]
Table '3074230175 5' 9-max Seat #1 is the button
Seat 1: LittleBigRUS (3378 in chips) 
Seat 2: smok80 (20914 in chips) 
Seat 3: 88099686 (6470 in chips) 
Seat 4: Gary.BY (38560 in chips) 
Seat 5: jhonathanm8 (2852 in chips) 
Seat 6: jcarlos.vale (4917 in chips) 
Seat 8: jrsebold (13925 in chips) 
Seat 9: kali155 (4998 in chips) 
LittleBigRUS: posts the ante 60
smok80: posts the ante 60
88099686: posts the ante 60
Gary.BY: posts the ante 60
jhonathanm8: posts the ante 60
jcarlos.vale: posts the ante 60
jrsebold: posts the ante 60
kali155: posts the ante 60
smok80: posts small blind 250
88099686: posts big blind 500
*** HOLE CARDS ***
Dealt to jcarlos.vale [Kh Kc]
Gary.BY: folds 
jhonathanm8: folds 
jcarlos.vale: raises 1730 to 2230
jrsebold: folds 
kali155: folds 
LittleBigRUS: folds 
smok80: folds 
88099686: folds 
Uncalled bet (1730) returned to jcarlos.vale
jcarlos.vale collected 1730 from pot
jcarlos.vale: doesn't show handDTO
*** SUMMARY ***
Total pot 1730 | Rake 0 
Seat 1: LittleBigRUS (button) folded before Flop (didn't bet)
Seat 2: smok80 (small blind) folded before Flop
Seat 3: 88099686 (big blind) folded before Flop
Seat 4: Gary.BY folded before Flop (didn't bet)
Seat 5: jhonathanm8 folded before Flop (didn't bet)
Seat 6: jcarlos.vale collected (1730)
Seat 8: jrsebold folded before Flop (didn't bet)
Seat 9: kali155 folded before Flop (didn't bet)



PokerStars Hand #221588759276: Tournament #3074230175, $0.98+$0.12 USD Hold'em No Limit - Level XIII (250/500) - 2020/12/19 0:51:14 EET [2020/12/18 17:51:14 ET]
Table '3074230175 5' 9-max Seat #2 is the button
Seat 1: LittleBigRUS (3318 in chips) 
Seat 2: smok80 (20604 in chips) 
Seat 3: 88099686 (5910 in chips) 
Seat 4: Gary.BY (38500 in chips) 
Seat 5: jhonathanm8 (2792 in chips) 
Seat 6: jcarlos.vale (6087 in chips) 
Seat 8: jrsebold (13865 in chips) 
Seat 9: kali155 (4938 in chips) 
LittleBigRUS: posts the ante 60
smok80: posts the ante 60
88099686: posts the ante 60
Gary.BY: posts the ante 60
jhonathanm8: posts the ante 60
jcarlos.vale: posts the ante 60
jrsebold: posts the ante 60
kali155: posts the ante 60
88099686: posts small blind 250
Gary.BY: posts big blind 500
*** HOLE CARDS ***
Dealt to jcarlos.vale [9d 8d]
jhonathanm8: folds 
jcarlos.vale: folds 
jrsebold: folds 
kali155: folds 
LittleBigRUS: raises 2758 to 3258 and is all-in
smok80: folds 
88099686: folds 
Gary.BY: calls 2758
*** FLOP *** [Qc Jd 6h]
*** TURN *** [Qc Jd 6h] [Ts]
*** RIVER *** [Qc Jd 6h Ts] [Th]
*** SHOW DOWN ***
Gary.BY: shows [Ac 3s] (a pair of Tens)
LittleBigRUS: shows [Kd 5s] (a pair of Tens - lower kicker)
Gary.BY collected 7246 from pot
LittleBigRUS finished the tournament in 182nd place and received $1.68.
*** SUMMARY ***
Total pot 7246 | Rake 0 
Board [Qc Jd 6h Ts Th]
Seat 1: LittleBigRUS showed [Kd 5s] and lost with a pair of Tens
Seat 2: smok80 (button) folded before Flop (didn't bet)
Seat 3: 88099686 (small blind) folded before Flop
Seat 4: Gary.BY (big blind) showed [Ac 3s] and won (7246) with a pair of Tens
Seat 5: jhonathanm8 folded before Flop (didn't bet)
Seat 6: jcarlos.vale folded before Flop (didn't bet)
Seat 8: jrsebold folded before Flop (didn't bet)
Seat 9: kali155 folded before Flop (didn't bet)



PokerStars Hand #221588777448: Tournament #3074230175, $0.98+$0.12 USD Hold'em No Limit - Level XIII (250/500) - 2020/12/19 0:51:41 EET [2020/12/18 17:51:41 ET]
Table '3074230175 5' 9-max Seat #3 is the button
Seat 2: smok80 (20544 in chips) 
Seat 3: 88099686 (5600 in chips) 
Seat 4: Gary.BY (42428 in chips) 
Seat 5: jhonathanm8 (2732 in chips) 
Seat 6: jcarlos.vale (6027 in chips) 
Seat 8: jrsebold (13805 in chips) 
Seat 9: kali155 (4878 in chips) 
smok80: posts the ante 60
88099686: posts the ante 60
Gary.BY: posts the ante 60
jhonathanm8: posts the ante 60
jcarlos.vale: posts the ante 60
jrsebold: posts the ante 60
kali155: posts the ante 60
Gary.BY: posts small blind 250
jhonathanm8: posts big blind 500
*** HOLE CARDS ***
Dealt to jcarlos.vale [Tc 9h]
jcarlos.vale: folds 
jrsebold: folds 
kali155: folds 
smok80: raises 600 to 1100
88099686: calls 1100
Gary.BY: folds 
jhonathanm8: folds 
*** FLOP *** [Jh Qd Js]
smok80: bets 2258
88099686: folds 
Uncalled bet (2258) returned to smok80
smok80 collected 3370 from pot
smok80: doesn't show handDTO
*** SUMMARY ***
Total pot 3370 | Rake 0 
Board [Jh Qd Js]
Seat 2: smok80 collected (3370)
Seat 3: 88099686 (button) folded on the Flop
Seat 4: Gary.BY (small blind) folded before Flop
Seat 5: jhonathanm8 (big blind) folded before Flop
Seat 6: jcarlos.vale folded before Flop (didn't bet)
Seat 8: jrsebold folded before Flop (didn't bet)
Seat 9: kali155 folded before Flop (didn't bet)



PokerStars Hand #221588795473: Tournament #3074230175, $0.98+$0.12 USD Hold'em No Limit - Level XIII (250/500) - 2020/12/19 0:52:08 EET [2020/12/18 17:52:08 ET]
Table '3074230175 5' 9-max Seat #4 is the button
Seat 1: eimoutso (6182 in chips) 
Seat 2: smok80 (22754 in chips) 
Seat 3: 88099686 (4440 in chips) 
Seat 4: Gary.BY (42118 in chips) 
Seat 5: jhonathanm8 (2172 in chips) 
Seat 6: jcarlos.vale (5967 in chips) 
Seat 7: matbestar (3780 in chips) 
Seat 8: jrsebold (13745 in chips) 
Seat 9: kali155 (4818 in chips) 
eimoutso: posts the ante 60
smok80: posts the ante 60
88099686: posts the ante 60
Gary.BY: posts the ante 60
jhonathanm8: posts the ante 60
jcarlos.vale: posts the ante 60
matbestar: posts the ante 60
jrsebold: posts the ante 60
kali155: posts the ante 60
jhonathanm8: posts small blind 250
jcarlos.vale: posts big blind 500
*** HOLE CARDS ***
Dealt to jcarlos.vale [9h 6s]
matbestar: folds 
jrsebold: folds 
kali155: calls 500
eimoutso: raises 3000 to 3500
smok80: folds 
88099686: folds 
Gary.BY: folds 
jhonathanm8: folds 
jcarlos.vale: folds 
kali155: folds 
Uncalled bet (3000) returned to eimoutso
eimoutso collected 2290 from pot
eimoutso: doesn't show handDTO
*** SUMMARY ***
Total pot 2290 | Rake 0 
Seat 1: eimoutso collected (2290)
Seat 2: smok80 folded before Flop (didn't bet)
Seat 3: 88099686 folded before Flop (didn't bet)
Seat 4: Gary.BY (button) folded before Flop (didn't bet)
Seat 5: jhonathanm8 (small blind) folded before Flop
Seat 6: jcarlos.vale (big blind) folded before Flop
Seat 7: matbestar folded before Flop (didn't bet)
Seat 8: jrsebold folded before Flop (didn't bet)
Seat 9: kali155 folded before Flop



PokerStars Hand #221588820328: Tournament #3074230175, $0.98+$0.12 USD Hold'em No Limit - Level XIII (250/500) - 2020/12/19 0:52:45 EET [2020/12/18 17:52:45 ET]
Table '3074230175 5' 9-max Seat #5 is the button
Seat 1: eimoutso (7912 in chips) 
Seat 2: smok80 (22694 in chips) 
Seat 3: 88099686 (4380 in chips) 
Seat 4: Gary.BY (42058 in chips) 
Seat 5: jhonathanm8 (1862 in chips) 
Seat 6: jcarlos.vale (5407 in chips) 
Seat 7: matbestar (3720 in chips) 
Seat 8: jrsebold (13685 in chips) 
Seat 9: kali155 (4258 in chips) 
eimoutso: posts the ante 60
smok80: posts the ante 60
88099686: posts the ante 60
Gary.BY: posts the ante 60
jhonathanm8: posts the ante 60
jcarlos.vale: posts the ante 60
matbestar: posts the ante 60
jrsebold: posts the ante 60
kali155: posts the ante 60
jcarlos.vale: posts small blind 250
matbestar: posts big blind 500
*** HOLE CARDS ***
Dealt to jcarlos.vale [7s 8c]
jrsebold: raises 500 to 1000
kali155: folds 
eimoutso: folds 
smok80: folds 
88099686: folds 
Gary.BY: folds 
jhonathanm8: folds 
jcarlos.vale: folds 
matbestar: folds 
Uncalled bet (500) returned to jrsebold
jrsebold collected 1790 from pot
*** SUMMARY ***
Total pot 1790 | Rake 0 
Seat 1: eimoutso folded before Flop (didn't bet)
Seat 2: smok80 folded before Flop (didn't bet)
Seat 3: 88099686 folded before Flop (didn't bet)
Seat 4: Gary.BY folded before Flop (didn't bet)
Seat 5: jhonathanm8 (button) folded before Flop (didn't bet)
Seat 6: jcarlos.vale (small blind) folded before Flop
Seat 7: matbestar (big blind) folded before Flop
Seat 8: jrsebold collected (1790)
Seat 9: kali155 folded before Flop (didn't bet)



PokerStars Hand #221588833466: Tournament #3074230175, $0.98+$0.12 USD Hold'em No Limit - Level XIII (250/500) - 2020/12/19 0:53:05 EET [2020/12/18 17:53:05 ET]
Table '3074230175 5' 9-max Seat #6 is the button
Seat 1: eimoutso (7852 in chips) 
Seat 2: smok80 (22634 in chips) 
Seat 3: 88099686 (4320 in chips) 
Seat 4: Gary.BY (41998 in chips) 
Seat 5: jhonathanm8 (1802 in chips) 
Seat 6: jcarlos.vale (5097 in chips) 
Seat 7: matbestar (3160 in chips) 
Seat 8: jrsebold (14915 in chips) 
Seat 9: kali155 (4198 in chips) 
eimoutso: posts the ante 60
smok80: posts the ante 60
88099686: posts the ante 60
Gary.BY: posts the ante 60
jhonathanm8: posts the ante 60
jcarlos.vale: posts the ante 60
matbestar: posts the ante 60
jrsebold: posts the ante 60
kali155: posts the ante 60
matbestar: posts small blind 250
jrsebold: posts big blind 500
*** HOLE CARDS ***
Dealt to jcarlos.vale [8d Jh]
kali155: folds 
eimoutso: raises 500 to 1000
smok80: folds 
88099686: folds 
Gary.BY: folds 
jhonathanm8: folds 
jcarlos.vale: folds 
matbestar: raises 2100 to 3100 and is all-in
jrsebold: folds 
eimoutso: calls 2100
*** FLOP *** [9h Jd 5h]
*** TURN *** [9h Jd 5h] [7s]
*** RIVER *** [9h Jd 5h 7s] [2h]
*** SHOW DOWN ***
matbestar: shows [Kd Ks] (a pair of Kings)
eimoutso: shows [8c 7c] (a pair of Sevens)
matbestar collected 7240 from pot
*** SUMMARY ***
Total pot 7240 | Rake 0 
Board [9h Jd 5h 7s 2h]
Seat 1: eimoutso showed [8c 7c] and lost with a pair of Sevens
Seat 2: smok80 folded before Flop (didn't bet)
Seat 3: 88099686 folded before Flop (didn't bet)
Seat 4: Gary.BY folded before Flop (didn't bet)
Seat 5: jhonathanm8 folded before Flop (didn't bet)
Seat 6: jcarlos.vale (button) folded before Flop (didn't bet)
Seat 7: matbestar (small blind) showed [Kd Ks] and won (7240) with a pair of Kings
Seat 8: jrsebold (big blind) folded before Flop
Seat 9: kali155 folded before Flop (didn't bet)



PokerStars Hand #221588857695: Tournament #3074230175, $0.98+$0.12 USD Hold'em No Limit - Level XIV (300/600) - 2020/12/19 0:53:42 EET [2020/12/18 17:53:42 ET]
Table '3074230175 5' 9-max Seat #7 is the button
Seat 1: eimoutso (4692 in chips) 
Seat 2: smok80 (22574 in chips) 
Seat 3: 88099686 (4260 in chips) 
Seat 4: Gary.BY (41938 in chips) 
Seat 5: jhonathanm8 (1742 in chips) 
Seat 6: jcarlos.vale (5037 in chips) 
Seat 7: matbestar (7240 in chips) 
Seat 8: jrsebold (14355 in chips) 
Seat 9: kali155 (4138 in chips) 
eimoutso: posts the ante 70
smok80: posts the ante 70
88099686: posts the ante 70
Gary.BY: posts the ante 70
jhonathanm8: posts the ante 70
jcarlos.vale: posts the ante 70
matbestar: posts the ante 70
jrsebold: posts the ante 70
kali155: posts the ante 70
jrsebold: posts small blind 300
kali155: posts big blind 600
*** HOLE CARDS ***
Dealt to jcarlos.vale [2d Ac]
eimoutso: folds 
smok80: raises 720 to 1320
88099686: folds 
Gary.BY: folds 
jhonathanm8: raises 352 to 1672 and is all-in
jcarlos.vale: folds 
matbestar: folds 
jrsebold: folds 
kali155: folds 
smok80: calls 352
*** FLOP *** [Jc Td 5s]
*** TURN *** [Jc Td 5s] [3h]
*** RIVER *** [Jc Td 5s 3h] [7h]
*** SHOW DOWN ***
smok80: shows [Ks Js] (a pair of Jacks)
jhonathanm8: shows [Kd Kh] (a pair of Kings)
jhonathanm8 collected 4874 from pot
*** SUMMARY ***
Total pot 4874 | Rake 0 
Board [Jc Td 5s 3h 7h]
Seat 1: eimoutso folded before Flop (didn't bet)
Seat 2: smok80 showed [Ks Js] and lost with a pair of Jacks
Seat 3: 88099686 folded before Flop (didn't bet)
Seat 4: Gary.BY folded before Flop (didn't bet)
Seat 5: jhonathanm8 showed [Kd Kh] and won (4874) with a pair of Kings
Seat 6: jcarlos.vale folded before Flop (didn't bet)
Seat 7: matbestar (button) folded before Flop (didn't bet)
Seat 8: jrsebold (small blind) folded before Flop
Seat 9: kali155 (big blind) folded before Flop



PokerStars Hand #221588874533: Tournament #3074230175, $0.98+$0.12 USD Hold'em No Limit - Level XIV (300/600) - 2020/12/19 0:54:07 EET [2020/12/18 17:54:07 ET]
Table '3074230175 5' 9-max Seat #8 is the button
Seat 1: eimoutso (4622 in chips) 
Seat 2: smok80 (20832 in chips) 
Seat 3: 88099686 (4190 in chips) 
Seat 4: Gary.BY (41868 in chips) 
Seat 5: jhonathanm8 (4874 in chips) 
Seat 6: jcarlos.vale (4967 in chips) 
Seat 7: matbestar (7170 in chips) 
Seat 8: jrsebold (13985 in chips) 
Seat 9: kali155 (3468 in chips) 
eimoutso: posts the ante 70
smok80: posts the ante 70
88099686: posts the ante 70
Gary.BY: posts the ante 70
jhonathanm8: posts the ante 70
jcarlos.vale: posts the ante 70
matbestar: posts the ante 70
jrsebold: posts the ante 70
kali155: posts the ante 70
kali155: posts small blind 300
eimoutso: posts big blind 600
*** HOLE CARDS ***
Dealt to jcarlos.vale [Qs Qh]
smok80: folds 
88099686: calls 600
Gary.BY: raises 1200 to 1800
jhonathanm8: folds 
jcarlos.vale: raises 3097 to 4897 and is all-in
matbestar: folds 
jrsebold: folds 
kali155: folds 
eimoutso: calls 3952 and is all-in
88099686: folds 
Gary.BY: calls 3097
*** FLOP *** [3h Jd 8c]
*** TURN *** [3h Jd 8c] [Th]
*** RIVER *** [3h Jd 8c Th] [Ah]
*** SHOW DOWN ***
Gary.BY: shows [7c 7s] (a pair of Sevens)
jcarlos.vale: shows [Qs Qh] (a pair of Queens)
jcarlos.vale collected 690 from side pot
eimoutso: shows [6h Ad] (a pair of Aces)
eimoutso collected 15186 from main pot
*** SUMMARY ***
Total pot 15876 Main pot 15186. Side pot 690. | Rake 0 
Board [3h Jd 8c Th Ah]
Seat 1: eimoutso (big blind) showed [6h Ad] and won (15186) with a pair of Aces
Seat 2: smok80 folded before Flop (didn't bet)
Seat 3: 88099686 folded before Flop
Seat 4: Gary.BY showed [7c 7s] and lost with a pair of Sevens
Seat 5: jhonathanm8 folded before Flop (didn't bet)
Seat 6: jcarlos.vale showed [Qs Qh] and won (690) with a pair of Queens
Seat 7: matbestar folded before Flop (didn't bet)
Seat 8: jrsebold (button) folded before Flop (didn't bet)
Seat 9: kali155 (small blind) folded before Flop



PokerStars Hand #221588897199: Tournament #3074230175, $0.98+$0.12 USD Hold'em No Limit - Level XIV (300/600) - 2020/12/19 0:54:42 EET [2020/12/18 17:54:42 ET]
Table '3074230175 5' 9-max Seat #9 is the button
Seat 1: eimoutso (15186 in chips) 
Seat 2: smok80 (20762 in chips) 
Seat 3: 88099686 (3520 in chips) 
Seat 4: Gary.BY (36901 in chips) 
Seat 5: jhonathanm8 (4804 in chips) 
Seat 6: jcarlos.vale (690 in chips) 
Seat 7: matbestar (7100 in chips) 
Seat 8: jrsebold (13915 in chips) 
Seat 9: kali155 (3098 in chips) 
eimoutso: posts the ante 70
smok80: posts the ante 70
88099686: posts the ante 70
Gary.BY: posts the ante 70
jhonathanm8: posts the ante 70
jcarlos.vale: posts the ante 70
matbestar: posts the ante 70
jrsebold: posts the ante 70
kali155: posts the ante 70
eimoutso: posts small blind 300
smok80: posts big blind 600
*** HOLE CARDS ***
Dealt to jcarlos.vale [Ks 6s]
88099686: folds 
Gary.BY: folds 
jhonathanm8: raises 4134 to 4734 and is all-in
jcarlos.vale: folds 
matbestar: folds 
jrsebold: folds 
kali155: folds 
eimoutso: folds 
smok80: folds 
Uncalled bet (4134) returned to jhonathanm8
jhonathanm8 collected 2130 from pot
*** SUMMARY ***
Total pot 2130 | Rake 0 
Seat 1: eimoutso (small blind) folded before Flop
Seat 2: smok80 (big blind) folded before Flop
Seat 3: 88099686 folded before Flop (didn't bet)
Seat 4: Gary.BY folded before Flop (didn't bet)
Seat 5: jhonathanm8 collected (2130)
Seat 6: jcarlos.vale folded before Flop (didn't bet)
Seat 7: matbestar folded before Flop (didn't bet)
Seat 8: jrsebold folded before Flop (didn't bet)
Seat 9: kali155 (button) folded before Flop (didn't bet)



PokerStars Hand #221588912149: Tournament #3074230175, $0.98+$0.12 USD Hold'em No Limit - Level XIV (300/600) - 2020/12/19 0:55:05 EET [2020/12/18 17:55:05 ET]
Table '3074230175 5' 9-max Seat #1 is the button
Seat 1: eimoutso (14816 in chips) 
Seat 2: smok80 (20092 in chips) 
Seat 3: 88099686 (3450 in chips) 
Seat 4: Gary.BY (36831 in chips) 
Seat 5: jhonathanm8 (6264 in chips) 
Seat 6: jcarlos.vale (620 in chips) 
Seat 7: matbestar (7030 in chips) 
Seat 8: jrsebold (13845 in chips) 
Seat 9: kali155 (3028 in chips) 
eimoutso: posts the ante 70
smok80: posts the ante 70
88099686: posts the ante 70
Gary.BY: posts the ante 70
jhonathanm8: posts the ante 70
jcarlos.vale: posts the ante 70
matbestar: posts the ante 70
jrsebold: posts the ante 70
kali155: posts the ante 70
smok80: posts small blind 300
88099686: posts big blind 600
*** HOLE CARDS ***
Dealt to jcarlos.vale [3c Ah]
Gary.BY: folds 
jhonathanm8: folds 
jcarlos.vale: calls 550 and is all-in
matbestar: folds 
jrsebold: folds 
kali155: folds 
eimoutso: folds 
smok80: calls 300
88099686: raises 2780 to 3380 and is all-in
smok80: folds 
Uncalled bet (2780) returned to 88099686
*** FLOP *** [6h Ac 8h]
*** TURN *** [6h Ac 8h] [5h]
*** RIVER *** [6h Ac 8h 5h] [3h]
*** SHOW DOWN ***
88099686: shows [Ad Js] (a pair of Aces)
88099686 collected 100 from side pot
jcarlos.vale: shows [3c Ah] (a flush, Ace high)
jcarlos.vale collected 2280 from main pot
*** SUMMARY ***
Total pot 2380 Main pot 2280. Side pot 100. | Rake 0 
Board [6h Ac 8h 5h 3h]
Seat 1: eimoutso (button) folded before Flop (didn't bet)
Seat 2: smok80 (small blind) folded before Flop
Seat 3: 88099686 (big blind) showed [Ad Js] and won (100) with a pair of Aces
Seat 4: Gary.BY folded before Flop (didn't bet)
Seat 5: jhonathanm8 folded before Flop (didn't bet)
Seat 6: jcarlos.vale showed [3c Ah] and won (2280) with a flush, Ace high
Seat 7: matbestar folded before Flop (didn't bet)
Seat 8: jrsebold folded before Flop (didn't bet)
Seat 9: kali155 folded before Flop (didn't bet)



PokerStars Hand #221589113439: Tournament #3074230175, $0.98+$0.12 USD Hold'em No Limit - Level XIV (300/600) - 2020/12/19 1:01:32 EET [2020/12/18 18:01:32 ET]
Table '3074230175 5' 9-max Seat #2 is the button
Seat 1: eimoutso (14746 in chips) 
Seat 2: smok80 (19422 in chips) 
Seat 3: 88099686 (2880 in chips) 
Seat 4: Gary.BY (36761 in chips) 
Seat 5: jhonathanm8 (6194 in chips) 
Seat 6: jcarlos.vale (2280 in chips) 
Seat 7: matbestar (6960 in chips) 
Seat 8: jrsebold (13775 in chips) 
Seat 9: kali155 (2958 in chips) 
eimoutso: posts the ante 70
smok80: posts the ante 70
88099686: posts the ante 70
Gary.BY: posts the ante 70
jhonathanm8: posts the ante 70
jcarlos.vale: posts the ante 70
matbestar: posts the ante 70
jrsebold: posts the ante 70
kali155: posts the ante 70
88099686: posts small blind 300
Gary.BY: posts big blind 600
*** HOLE CARDS ***
Dealt to jcarlos.vale [As 9s]
jhonathanm8: folds 
jcarlos.vale: raises 1610 to 2210 and is all-in
matbestar: folds 
jrsebold: folds 
kali155: folds 
eimoutso: raises 5950 to 8160
smok80: folds 
88099686: folds 
Gary.BY: folds 
Uncalled bet (5950) returned to eimoutso
*** FLOP *** [8d 3h 9d]
*** TURN *** [8d 3h 9d] [Ac]
*** RIVER *** [8d 3h 9d Ac] [Qh]
*** SHOW DOWN ***
jcarlos.vale: shows [As 9s] (two pair, Aces and Nines)
eimoutso: shows [9h Ah] (two pair, Aces and Nines)
jcarlos.vale collected 2975 from pot
eimoutso collected 2975 from pot
*** SUMMARY ***
Total pot 5950 | Rake 0 
Board [8d 3h 9d Ac Qh]
Seat 1: eimoutso showed [9h Ah] and won (2975) with two pair, Aces and Nines
Seat 2: smok80 (button) folded before Flop (didn't bet)
Seat 3: 88099686 (small blind) folded before Flop
Seat 4: Gary.BY (big blind) folded before Flop
Seat 5: jhonathanm8 folded before Flop (didn't bet)
Seat 6: jcarlos.vale showed [As 9s] and won (2975) with two pair, Aces and Nines
Seat 7: matbestar folded before Flop (didn't bet)
Seat 8: jrsebold folded before Flop (didn't bet)
Seat 9: kali155 folded before Flop (didn't bet)



PokerStars Hand #221589137712: Tournament #3074230175, $0.98+$0.12 USD Hold'em No Limit - Level XIV (300/600) - 2020/12/19 1:02:10 EET [2020/12/18 18:02:10 ET]
Table '3074230175 5' 9-max Seat #3 is the button
Seat 1: eimoutso (15441 in chips) 
Seat 2: smok80 (19352 in chips) 
Seat 3: 88099686 (2510 in chips) 
Seat 4: Gary.BY (36091 in chips) 
Seat 5: jhonathanm8 (6124 in chips) 
Seat 6: jcarlos.vale (2975 in chips) 
Seat 7: matbestar (6890 in chips) 
Seat 8: jrsebold (13705 in chips) 
Seat 9: kali155 (2888 in chips) 
eimoutso: posts the ante 70
smok80: posts the ante 70
88099686: posts the ante 70
Gary.BY: posts the ante 70
jhonathanm8: posts the ante 70
jcarlos.vale: posts the ante 70
matbestar: posts the ante 70
jrsebold: posts the ante 70
kali155: posts the ante 70
Gary.BY: posts small blind 300
jhonathanm8: posts big blind 600
*** HOLE CARDS ***
Dealt to jcarlos.vale [As Qs]
jcarlos.vale: raises 2305 to 2905 and is all-in
matbestar: folds 
jrsebold: folds 
kali155: folds 
eimoutso: folds 
smok80: folds 
88099686: folds 
Gary.BY: folds 
jhonathanm8: folds 
Uncalled bet (2305) returned to jcarlos.vale
jcarlos.vale collected 2130 from pot
jcarlos.vale: doesn't show handDTO
*** SUMMARY ***
Total pot 2130 | Rake 0 
Seat 1: eimoutso folded before Flop (didn't bet)
Seat 2: smok80 folded before Flop (didn't bet)
Seat 3: 88099686 (button) folded before Flop (didn't bet)
Seat 4: Gary.BY (small blind) folded before Flop
Seat 5: jhonathanm8 (big blind) folded before Flop
Seat 6: jcarlos.vale collected (2130)
Seat 7: matbestar folded before Flop (didn't bet)
Seat 8: jrsebold folded before Flop (didn't bet)
Seat 9: kali155 folded before Flop (didn't bet)



PokerStars Hand #221589151750: Tournament #3074230175, $0.98+$0.12 USD Hold'em No Limit - Level XIV (300/600) - 2020/12/19 1:02:31 EET [2020/12/18 18:02:31 ET]
Table '3074230175 5' 9-max Seat #4 is the button
Seat 1: eimoutso (15371 in chips) 
Seat 2: smok80 (19282 in chips) 
Seat 3: 88099686 (2440 in chips) 
Seat 4: Gary.BY (35721 in chips) 
Seat 5: jhonathanm8 (5454 in chips) 
Seat 6: jcarlos.vale (4435 in chips) 
Seat 7: matbestar (6820 in chips) 
Seat 8: jrsebold (13635 in chips) 
Seat 9: kali155 (2818 in chips) 
eimoutso: posts the ante 70
smok80: posts the ante 70
88099686: posts the ante 70
Gary.BY: posts the ante 70
jhonathanm8: posts the ante 70
jcarlos.vale: posts the ante 70
matbestar: posts the ante 70
jrsebold: posts the ante 70
kali155: posts the ante 70
jhonathanm8: posts small blind 300
jcarlos.vale: posts big blind 600
*** HOLE CARDS ***
Dealt to jcarlos.vale [6d 6h]
matbestar: folds 
jrsebold: folds 
kali155: calls 600
eimoutso: folds 
smok80: folds 
88099686: folds 
Gary.BY: folds 
jhonathanm8: folds 
jcarlos.vale: raises 3765 to 4365 and is all-in
kali155: calls 2148 and is all-in
Uncalled bet (1617) returned to jcarlos.vale
*** FLOP *** [4d 4h Qh]
*** TURN *** [4d 4h Qh] [2c]
*** RIVER *** [4d 4h Qh 2c] [3d]
*** SHOW DOWN ***
jcarlos.vale: shows [6d 6h] (two pair, Sixes and Fours)
kali155: shows [9d 9h] (two pair, Nines and Fours)
kali155 collected 6426 from pot
*** SUMMARY ***
Total pot 6426 | Rake 0 
Board [4d 4h Qh 2c 3d]
Seat 1: eimoutso folded before Flop (didn't bet)
Seat 2: smok80 folded before Flop (didn't bet)
Seat 3: 88099686 folded before Flop (didn't bet)
Seat 4: Gary.BY (button) folded before Flop (didn't bet)
Seat 5: jhonathanm8 (small blind) folded before Flop
Seat 6: jcarlos.vale (big blind) showed [6d 6h] and lost with two pair, Sixes and Fours
Seat 7: matbestar folded before Flop (didn't bet)
Seat 8: jrsebold folded before Flop (didn't bet)
Seat 9: kali155 showed [9d 9h] and won (6426) with two pair, Nines and Fours



PokerStars Hand #221589169331: Tournament #3074230175, $0.98+$0.12 USD Hold'em No Limit - Level XIV (300/600) - 2020/12/19 1:02:59 EET [2020/12/18 18:02:59 ET]
Table '3074230175 5' 9-max Seat #5 is the button
Seat 1: eimoutso (15301 in chips) 
Seat 2: smok80 (19212 in chips) 
Seat 3: 88099686 (2370 in chips) 
Seat 4: Gary.BY (35651 in chips) 
Seat 5: jhonathanm8 (5084 in chips) 
Seat 6: jcarlos.vale (1617 in chips) 
Seat 7: matbestar (6750 in chips) 
Seat 8: jrsebold (13565 in chips) 
Seat 9: kali155 (6426 in chips) 
eimoutso: posts the ante 70
smok80: posts the ante 70
88099686: posts the ante 70
Gary.BY: posts the ante 70
jhonathanm8: posts the ante 70
jcarlos.vale: posts the ante 70
matbestar: posts the ante 70
jrsebold: posts the ante 70
kali155: posts the ante 70
jcarlos.vale: posts small blind 300
matbestar: posts big blind 600
*** HOLE CARDS ***
Dealt to jcarlos.vale [2s Ts]
jrsebold: folds 
kali155: folds 
eimoutso: folds 
smok80: folds 
88099686: folds 
Gary.BY: folds 
jhonathanm8: folds 
jcarlos.vale has timed out
jcarlos.vale: folds 
jcarlos.vale is sitting out
Uncalled bet (300) returned to matbestar
matbestar collected 1230 from pot
matbestar: doesn't show handDTO
jcarlos.vale has returned
*** SUMMARY ***
Total pot 1230 | Rake 0 
Seat 1: eimoutso folded before Flop (didn't bet)
Seat 2: smok80 folded before Flop (didn't bet)
Seat 3: 88099686 folded before Flop (didn't bet)
Seat 4: Gary.BY folded before Flop (didn't bet)
Seat 5: jhonathanm8 (button) folded before Flop (didn't bet)
Seat 6: jcarlos.vale (small blind) folded before Flop
Seat 7: matbestar (big blind) collected (1230)
Seat 8: jrsebold folded before Flop (didn't bet)
Seat 9: kali155 folded before Flop (didn't bet)



PokerStars Hand #221589199052: Tournament #3074230175, $0.98+$0.12 USD Hold'em No Limit - Level XIV (300/600) - 2020/12/19 1:03:41 EET [2020/12/18 18:03:41 ET]
Table '3074230175 5' 9-max Seat #6 is the button
Seat 1: eimoutso (15231 in chips) 
Seat 2: smok80 (19142 in chips) 
Seat 3: 88099686 (2300 in chips) 
Seat 4: Gary.BY (35581 in chips) 
Seat 5: jhonathanm8 (5014 in chips) 
Seat 6: jcarlos.vale (1247 in chips) 
Seat 7: matbestar (7610 in chips) 
Seat 8: jrsebold (13495 in chips) 
Seat 9: kali155 (6356 in chips) 
eimoutso: posts the ante 70
smok80: posts the ante 70
88099686: posts the ante 70
Gary.BY: posts the ante 70
jhonathanm8: posts the ante 70
jcarlos.vale: posts the ante 70
matbestar: posts the ante 70
jrsebold: posts the ante 70
kali155: posts the ante 70
matbestar: posts small blind 300
jrsebold: posts big blind 600
*** HOLE CARDS ***
Dealt to jcarlos.vale [5h 2h]
kali155: folds 
eimoutso: folds 
smok80: raises 720 to 1320
88099686: folds 
Gary.BY: folds 
jhonathanm8: raises 3624 to 4944 and is all-in
jcarlos.vale: folds 
matbestar: folds 
jrsebold: raises 8481 to 13425 and is all-in
smok80: folds 
Uncalled bet (8481) returned to jrsebold
*** FLOP *** [Ah 2d Jh]
*** TURN *** [Ah 2d Jh] [5s]
*** RIVER *** [Ah 2d Jh 5s] [6s]
*** SHOW DOWN ***
jrsebold: shows [Qh Ac] (a pair of Aces)
jhonathanm8: shows [Ad Qd] (a pair of Aces)
jrsebold collected 6069 from pot
jhonathanm8 collected 6069 from pot
*** SUMMARY ***
Total pot 12138 | Rake 0 
Board [Ah 2d Jh 5s 6s]
Seat 1: eimoutso folded before Flop (didn't bet)
Seat 2: smok80 folded before Flop
Seat 3: 88099686 folded before Flop (didn't bet)
Seat 4: Gary.BY folded before Flop (didn't bet)
Seat 5: jhonathanm8 showed [Ad Qd] and won (6069) with a pair of Aces
Seat 6: jcarlos.vale (button) folded before Flop (didn't bet)
Seat 7: matbestar (small blind) folded before Flop
Seat 8: jrsebold (big blind) showed [Qh Ac] and won (6069) with a pair of Aces
Seat 9: kali155 folded before Flop (didn't bet)



PokerStars Hand #221589225890: Tournament #3074230175, $0.98+$0.12 USD Hold'em No Limit - Level XIV (300/600) - 2020/12/19 1:04:24 EET [2020/12/18 18:04:24 ET]
Table '3074230175 5' 9-max Seat #7 is the button
Seat 1: eimoutso (15161 in chips) 
Seat 2: smok80 (17752 in chips) 
Seat 3: 88099686 (2230 in chips) 
Seat 4: Gary.BY (35511 in chips) 
Seat 5: jhonathanm8 (6069 in chips) 
Seat 6: jcarlos.vale (1177 in chips) 
Seat 7: matbestar (7240 in chips) 
Seat 8: jrsebold (14550 in chips) 
Seat 9: kali155 (6286 in chips) 
eimoutso: posts the ante 70
smok80: posts the ante 70
88099686: posts the ante 70
Gary.BY: posts the ante 70
jhonathanm8: posts the ante 70
jcarlos.vale: posts the ante 70
matbestar: posts the ante 70
jrsebold: posts the ante 70
kali155: posts the ante 70
jrsebold: posts small blind 300
kali155: posts big blind 600
*** HOLE CARDS ***
Dealt to jcarlos.vale [5d 7d]
eimoutso: raises 2100 to 2700
smok80: folds 
88099686: folds 
Gary.BY: folds 
jhonathanm8: raises 3299 to 5999 and is all-in
jcarlos.vale: folds 
matbestar: folds 
jrsebold: folds 
kali155: folds 
eimoutso: calls 3299
*** FLOP *** [Jc Ac Qc]
*** TURN *** [Jc Ac Qc] [Ts]
*** RIVER *** [Jc Ac Qc Ts] [Jd]
*** SHOW DOWN ***
eimoutso: shows [Kd Ad] (a straight, Ten to Ace)
jhonathanm8: shows [9c 9s] (two pair, Jacks and Nines)
eimoutso collected 13528 from pot
jhonathanm8 finished the tournament in 157th place and received $1.68.
*** SUMMARY ***
Total pot 13528 | Rake 0 
Board [Jc Ac Qc Ts Jd]
Seat 1: eimoutso showed [Kd Ad] and won (13528) with a straight, Ten to Ace
Seat 2: smok80 folded before Flop (didn't bet)
Seat 3: 88099686 folded before Flop (didn't bet)
Seat 4: Gary.BY folded before Flop (didn't bet)
Seat 5: jhonathanm8 showed [9c 9s] and lost with two pair, Jacks and Nines
Seat 6: jcarlos.vale folded before Flop (didn't bet)
Seat 7: matbestar (button) folded before Flop (didn't bet)
Seat 8: jrsebold (small blind) folded before Flop
Seat 9: kali155 (big blind) folded before Flop



PokerStars Hand #221589246599: Tournament #3074230175, $0.98+$0.12 USD Hold'em No Limit - Level XIV (300/600) - 2020/12/19 1:04:57 EET [2020/12/18 18:04:57 ET]
Table '3074230175 5' 9-max Seat #8 is the button
Seat 1: eimoutso (22620 in chips) 
Seat 2: smok80 (17682 in chips) 
Seat 3: 88099686 (2160 in chips) 
Seat 4: Gary.BY (35441 in chips) 
Seat 6: jcarlos.vale (1107 in chips) 
Seat 7: matbestar (7170 in chips) 
Seat 8: jrsebold (14180 in chips) 
Seat 9: kali155 (5616 in chips) 
eimoutso: posts the ante 70
smok80: posts the ante 70
88099686: posts the ante 70
Gary.BY: posts the ante 70
jcarlos.vale: posts the ante 70
matbestar: posts the ante 70
jrsebold: posts the ante 70
kali155: posts the ante 70
kali155: posts small blind 300
eimoutso: posts big blind 600
*** HOLE CARDS ***
Dealt to jcarlos.vale [Ah Qc]
smok80: raises 720 to 1320
88099686: folds 
Gary.BY: folds 
jcarlos.vale: calls 1037 and is all-in
matbestar: folds 
jrsebold: folds 
kali155: folds 
eimoutso: folds 
Uncalled bet (283) returned to smok80
*** FLOP *** [6h Td 8s]
*** TURN *** [6h Td 8s] [2h]
*** RIVER *** [6h Td 8s 2h] [As]
*** SHOW DOWN ***
smok80: shows [Jd Jc] (a pair of Jacks)
jcarlos.vale: shows [Ah Qc] (a pair of Aces)
jcarlos.vale collected 3534 from pot
*** SUMMARY ***
Total pot 3534 | Rake 0 
Board [6h Td 8s 2h As]
Seat 1: eimoutso (big blind) folded before Flop
Seat 2: smok80 showed [Jd Jc] and lost with a pair of Jacks
Seat 3: 88099686 folded before Flop (didn't bet)
Seat 4: Gary.BY folded before Flop (didn't bet)
Seat 6: jcarlos.vale showed [Ah Qc] and won (3534) with a pair of Aces
Seat 7: matbestar folded before Flop (didn't bet)
Seat 8: jrsebold (button) folded before Flop (didn't bet)
Seat 9: kali155 (small blind) folded before Flop



PokerStars Hand #221589266503: Tournament #3074230175, $0.98+$0.12 USD Hold'em No Limit - Level XIV (300/600) - 2020/12/19 1:05:27 EET [2020/12/18 18:05:27 ET]
Table '3074230175 5' 9-max Seat #9 is the button
Seat 1: eimoutso (21950 in chips) 
Seat 2: smok80 (16575 in chips) 
Seat 3: 88099686 (2090 in chips) 
Seat 4: Gary.BY (35371 in chips) 
Seat 5: DLeeLegend (25438 in chips) 
Seat 6: jcarlos.vale (3534 in chips) 
Seat 7: matbestar (7100 in chips) 
Seat 8: jrsebold (14110 in chips) 
Seat 9: kali155 (5246 in chips) 
eimoutso: posts the ante 70
smok80: posts the ante 70
88099686: posts the ante 70
Gary.BY: posts the ante 70
DLeeLegend: posts the ante 70
jcarlos.vale: posts the ante 70
matbestar: posts the ante 70
jrsebold: posts the ante 70
kali155: posts the ante 70
eimoutso: posts small blind 300
smok80: posts big blind 600
*** HOLE CARDS ***
Dealt to jcarlos.vale [6c Ad]
88099686: folds 
Gary.BY: folds 
DLeeLegend: calls 600
jcarlos.vale: folds 
matbestar: folds 
jrsebold: raises 1200 to 1800
kali155: folds 
eimoutso: folds 
smok80: folds 
DLeeLegend: calls 1200
*** FLOP *** [9c 9d Ks]
DLeeLegend: checks 
jrsebold: checks 
*** TURN *** [9c 9d Ks] [2d]
DLeeLegend: checks 
jrsebold: checks 
*** RIVER *** [9c 9d Ks 2d] [3s]
DLeeLegend: checks 
jrsebold: checks 
*** SHOW DOWN ***
DLeeLegend: shows [Ac 4c] (a pair of Nines)
jrsebold: shows [Jh Jd] (two pair, Jacks and Nines)
jrsebold collected 5130 from pot
*** SUMMARY ***
Total pot 5130 | Rake 0 
Board [9c 9d Ks 2d 3s]
Seat 1: eimoutso (small blind) folded before Flop
Seat 2: smok80 (big blind) folded before Flop
Seat 3: 88099686 folded before Flop (didn't bet)
Seat 4: Gary.BY folded before Flop (didn't bet)
Seat 5: DLeeLegend showed [Ac 4c] and lost with a pair of Nines
Seat 6: jcarlos.vale folded before Flop (didn't bet)
Seat 7: matbestar folded before Flop (didn't bet)
Seat 8: jrsebold showed [Jh Jd] and won (5130) with two pair, Jacks and Nines
Seat 9: kali155 (button) folded before Flop (didn't bet)



PokerStars Hand #221589289643: Tournament #3074230175, $0.98+$0.12 USD Hold'em No Limit - Level XIV (300/600) - 2020/12/19 1:06:03 EET [2020/12/18 18:06:03 ET]
Table '3074230175 5' 9-max Seat #1 is the button
Seat 1: eimoutso (21580 in chips) 
Seat 2: smok80 (15905 in chips) 
Seat 3: 88099686 (2020 in chips) 
Seat 4: Gary.BY (35301 in chips) 
Seat 5: DLeeLegend (23568 in chips) 
Seat 6: jcarlos.vale (3464 in chips) 
Seat 7: matbestar (7030 in chips) 
Seat 8: jrsebold (17370 in chips) 
Seat 9: kali155 (5176 in chips) 
eimoutso: posts the ante 70
smok80: posts the ante 70
88099686: posts the ante 70
Gary.BY: posts the ante 70
DLeeLegend: posts the ante 70
jcarlos.vale: posts the ante 70
matbestar: posts the ante 70
jrsebold: posts the ante 70
kali155: posts the ante 70
smok80: posts small blind 300
88099686: posts big blind 600
*** HOLE CARDS ***
Dealt to jcarlos.vale [4h Ah]
Gary.BY: folds 
DLeeLegend: raises 600 to 1200
jcarlos.vale: folds 
matbestar: folds 
jrsebold: calls 1200
kali155: folds 
eimoutso: folds 
smok80: calls 900
88099686: folds 
*** FLOP *** [Jd Ts 7s]
smok80: checks 
DLeeLegend: checks 
jrsebold: checks 
*** TURN *** [Jd Ts 7s] [6d]
smok80: checks 
DLeeLegend: bets 2400
jrsebold: folds 
smok80: calls 2400
*** RIVER *** [Jd Ts 7s 6d] [5c]
smok80: checks 
DLeeLegend: bets 19898 and is all-in
smok80: folds 
Uncalled bet (19898) returned to DLeeLegend
DLeeLegend collected 9630 from pot
DLeeLegend: doesn't show handDTO
*** SUMMARY ***
Total pot 9630 | Rake 0 
Board [Jd Ts 7s 6d 5c]
Seat 1: eimoutso (button) folded before Flop (didn't bet)
Seat 2: smok80 (small blind) folded on the River
Seat 3: 88099686 (big blind) folded before Flop
Seat 4: Gary.BY folded before Flop (didn't bet)
Seat 5: DLeeLegend collected (9630)
Seat 6: jcarlos.vale folded before Flop (didn't bet)
Seat 7: matbestar folded before Flop (didn't bet)
Seat 8: jrsebold folded on the Turn
Seat 9: kali155 folded before Flop (didn't bet)



PokerStars Hand #221589323344: Tournament #3074230175, $0.98+$0.12 USD Hold'em No Limit - Level XIV (300/600) - 2020/12/19 1:06:56 EET [2020/12/18 18:06:56 ET]
Table '3074230175 5' 9-max Seat #2 is the button
Seat 1: eimoutso (21510 in chips) 
Seat 2: smok80 (12235 in chips) 
Seat 3: 88099686 (1350 in chips) 
Seat 4: Gary.BY (35231 in chips) 
Seat 5: DLeeLegend (29528 in chips) 
Seat 6: jcarlos.vale (3394 in chips) 
Seat 7: matbestar (6960 in chips) 
Seat 8: jrsebold (16100 in chips) 
Seat 9: kali155 (5106 in chips) 
eimoutso: posts the ante 70
smok80: posts the ante 70
88099686: posts the ante 70
Gary.BY: posts the ante 70
DLeeLegend: posts the ante 70
jcarlos.vale: posts the ante 70
matbestar: posts the ante 70
jrsebold: posts the ante 70
kali155: posts the ante 70
88099686: posts small blind 300
Gary.BY: posts big blind 600
*** HOLE CARDS ***
Dealt to jcarlos.vale [Js Tc]
DLeeLegend: folds 
jcarlos.vale: folds 
matbestar: folds 
jrsebold: folds 
kali155: folds 
eimoutso: folds 
smok80: folds 
88099686: raises 680 to 1280 and is all-in
Gary.BY: folds 
Uncalled bet (680) returned to 88099686
88099686 collected 1830 from pot
88099686: doesn't show handDTO
*** SUMMARY ***
Total pot 1830 | Rake 0 
Seat 1: eimoutso folded before Flop (didn't bet)
Seat 2: smok80 (button) folded before Flop (didn't bet)
Seat 3: 88099686 (small blind) collected (1830)
Seat 4: Gary.BY (big blind) folded before Flop
Seat 5: DLeeLegend folded before Flop (didn't bet)
Seat 6: jcarlos.vale folded before Flop (didn't bet)
Seat 7: matbestar folded before Flop (didn't bet)
Seat 8: jrsebold folded before Flop (didn't bet)
Seat 9: kali155 folded before Flop (didn't bet)



PokerStars Hand #221589344818: Tournament #3074230175, $0.98+$0.12 USD Hold'em No Limit - Level XIV (300/600) - 2020/12/19 1:07:29 EET [2020/12/18 18:07:29 ET]
Table '3074230175 5' 9-max Seat #3 is the button
Seat 1: eimoutso (21440 in chips) 
Seat 2: smok80 (12165 in chips) 
Seat 3: 88099686 (2510 in chips) 
Seat 4: Gary.BY (34561 in chips) 
Seat 5: DLeeLegend (29458 in chips) 
Seat 6: jcarlos.vale (3324 in chips) 
Seat 7: matbestar (6890 in chips) 
Seat 8: jrsebold (16030 in chips) 
Seat 9: kali155 (5036 in chips) 
eimoutso: posts the ante 70
smok80: posts the ante 70
88099686: posts the ante 70
Gary.BY: posts the ante 70
DLeeLegend: posts the ante 70
jcarlos.vale: posts the ante 70
matbestar: posts the ante 70
jrsebold: posts the ante 70
kali155: posts the ante 70
Gary.BY: posts small blind 300
DLeeLegend: posts big blind 600
*** HOLE CARDS ***
Dealt to jcarlos.vale [2d As]
jcarlos.vale: folds 
matbestar: folds 
jrsebold: folds 
kali155: folds 
eimoutso: folds 
smok80: folds 
88099686: folds 
Gary.BY: raises 600 to 1200
DLeeLegend: calls 600
*** FLOP *** [6c 9d Kd]
Gary.BY: bets 1200
DLeeLegend: calls 1200
*** TURN *** [6c 9d Kd] [Jh]
Gary.BY: bets 2715
DLeeLegend: calls 2715
*** RIVER *** [6c 9d Kd Jh] [Kc]
Gary.BY: checks 
DLeeLegend: checks 
*** SHOW DOWN ***
Gary.BY: shows [7h 7c] (two pair, Kings and Sevens)
DLeeLegend: shows [Ts Th] (two pair, Kings and Tens)
DLeeLegend collected 10860 from pot
*** SUMMARY ***
Total pot 10860 | Rake 0 
Board [6c 9d Kd Jh Kc]
Seat 1: eimoutso folded before Flop (didn't bet)
Seat 2: smok80 folded before Flop (didn't bet)
Seat 3: 88099686 (button) folded before Flop (didn't bet)
Seat 4: Gary.BY (small blind) showed [7h 7c] and lost with two pair, Kings and Sevens
Seat 5: DLeeLegend (big blind) showed [Ts Th] and won (10860) with two pair, Kings and Tens
Seat 6: jcarlos.vale folded before Flop (didn't bet)
Seat 7: matbestar folded before Flop (didn't bet)
Seat 8: jrsebold folded before Flop (didn't bet)
Seat 9: kali155 folded before Flop (didn't bet)



PokerStars Hand #221589373720: Tournament #3074230175, $0.98+$0.12 USD Hold'em No Limit - Level XIV (300/600) - 2020/12/19 1:08:14 EET [2020/12/18 18:08:14 ET]
Table '3074230175 5' 9-max Seat #4 is the button
Seat 1: eimoutso (21370 in chips) 
Seat 2: smok80 (12095 in chips) 
Seat 3: 88099686 (2440 in chips) 
Seat 4: Gary.BY (29376 in chips) 
Seat 5: DLeeLegend (35133 in chips) 
Seat 6: jcarlos.vale (3254 in chips) 
Seat 7: matbestar (6820 in chips) 
Seat 8: jrsebold (15960 in chips) 
Seat 9: kali155 (4966 in chips) 
eimoutso: posts the ante 70
smok80: posts the ante 70
88099686: posts the ante 70
Gary.BY: posts the ante 70
DLeeLegend: posts the ante 70
jcarlos.vale: posts the ante 70
matbestar: posts the ante 70
jrsebold: posts the ante 70
kali155: posts the ante 70
DLeeLegend: posts small blind 300
jcarlos.vale: posts big blind 600
*** HOLE CARDS ***
Dealt to jcarlos.vale [8s 9s]
matbestar: folds 
jrsebold: folds 
kali155: folds 
eimoutso: folds 
smok80: folds 
88099686: folds 
Gary.BY: calls 600
DLeeLegend: calls 300
jcarlos.vale: raises 2584 to 3184 and is all-in
Gary.BY: calls 2584
DLeeLegend: calls 2584
*** FLOP *** [Ac 4s As]
DLeeLegend: checks 
Gary.BY: checks 
*** TURN *** [Ac 4s As] [Ad]
DLeeLegend: checks 
Gary.BY: checks 
*** RIVER *** [Ac 4s As Ad] [3s]
DLeeLegend: checks 
Gary.BY: checks 
*** SHOW DOWN ***
DLeeLegend: shows [7s 6s] (a flush, Ace high)
jcarlos.vale: shows [8s 9s] (a flush, Ace high - Nine higher)
Gary.BY: mucks handDTO
jcarlos.vale collected 10182 from pot
*** SUMMARY ***
Total pot 10182 | Rake 0 
Board [Ac 4s As Ad 3s]
Seat 1: eimoutso folded before Flop (didn't bet)
Seat 2: smok80 folded before Flop (didn't bet)
Seat 3: 88099686 folded before Flop (didn't bet)
Seat 4: Gary.BY (button) mucked [5d 6d]
Seat 5: DLeeLegend (small blind) showed [7s 6s] and lost with a flush, Ace high
Seat 6: jcarlos.vale (big blind) showed [8s 9s] and won (10182) with a flush, Ace high
Seat 7: matbestar folded before Flop (didn't bet)
Seat 8: jrsebold folded before Flop (didn't bet)
Seat 9: kali155 folded before Flop (didn't bet)



PokerStars Hand #221589415136: Tournament #3074230175, $0.98+$0.12 USD Hold'em No Limit - Level XIV (300/600) - 2020/12/19 1:09:19 EET [2020/12/18 18:09:19 ET]
Table '3074230175 5' 9-max Seat #5 is the button
Seat 1: eimoutso (21300 in chips) 
Seat 2: smok80 (12025 in chips) 
Seat 3: 88099686 (2370 in chips) 
Seat 4: Gary.BY (26122 in chips) 
Seat 5: DLeeLegend (31879 in chips) 
Seat 6: jcarlos.vale (10182 in chips) 
Seat 7: matbestar (6750 in chips) 
Seat 8: jrsebold (15890 in chips) 
Seat 9: kali155 (4896 in chips) 
eimoutso: posts the ante 70
smok80: posts the ante 70
88099686: posts the ante 70
Gary.BY: posts the ante 70
DLeeLegend: posts the ante 70
jcarlos.vale: posts the ante 70
matbestar: posts the ante 70
jrsebold: posts the ante 70
kali155: posts the ante 70
jcarlos.vale: posts small blind 300
matbestar: posts big blind 600
*** HOLE CARDS ***
Dealt to jcarlos.vale [Ad 4c]
jrsebold: folds 
kali155: folds 
eimoutso: folds 
smok80: folds 
88099686: folds 
Gary.BY: folds 
DLeeLegend: folds 
jcarlos.vale: folds 
Uncalled bet (300) returned to matbestar
matbestar collected 1230 from pot
matbestar: doesn't show handDTO
*** SUMMARY ***
Total pot 1230 | Rake 0 
Seat 1: eimoutso folded before Flop (didn't bet)
Seat 2: smok80 folded before Flop (didn't bet)
Seat 3: 88099686 folded before Flop (didn't bet)
Seat 4: Gary.BY folded before Flop (didn't bet)
Seat 5: DLeeLegend (button) folded before Flop (didn't bet)
Seat 6: jcarlos.vale (small blind) folded before Flop
Seat 7: matbestar (big blind) collected (1230)
Seat 8: jrsebold folded before Flop (didn't bet)
Seat 9: kali155 folded before Flop (didn't bet)



PokerStars Hand #221589430335: Tournament #3074230175, $0.98+$0.12 USD Hold'em No Limit - Level XIV (300/600) - 2020/12/19 1:09:32 EET [2020/12/18 18:09:32 ET]
Table '3074230175 5' 9-max Seat #6 is the button
Seat 1: eimoutso (21230 in chips) 
Seat 2: smok80 (11955 in chips) 
Seat 3: 88099686 (2300 in chips) 
Seat 4: Gary.BY (26052 in chips) 
Seat 5: DLeeLegend (31809 in chips) 
Seat 6: jcarlos.vale (9812 in chips) 
Seat 7: matbestar (7610 in chips) 
Seat 8: jrsebold (15820 in chips) 
Seat 9: kali155 (4826 in chips) 
eimoutso: posts the ante 70
smok80: posts the ante 70
88099686: posts the ante 70
Gary.BY: posts the ante 70
DLeeLegend: posts the ante 70
jcarlos.vale: posts the ante 70
matbestar: posts the ante 70
jrsebold: posts the ante 70
kali155: posts the ante 70
matbestar: posts small blind 300
jrsebold: posts big blind 600
*** HOLE CARDS ***
Dealt to jcarlos.vale [7s Qd]
kali155: folds 
eimoutso: folds 
smok80: folds 
88099686: folds 
Gary.BY: folds 
DLeeLegend: raises 600 to 1200
jcarlos.vale: folds 
matbestar: folds 
jrsebold: folds 
Uncalled bet (600) returned to DLeeLegend
DLeeLegend collected 2130 from pot
DLeeLegend: doesn't show handDTO
*** SUMMARY ***
Total pot 2130 | Rake 0 
Seat 1: eimoutso folded before Flop (didn't bet)
Seat 2: smok80 folded before Flop (didn't bet)
Seat 3: 88099686 folded before Flop (didn't bet)
Seat 4: Gary.BY folded before Flop (didn't bet)
Seat 5: DLeeLegend collected (2130)
Seat 6: jcarlos.vale (button) folded before Flop (didn't bet)
Seat 7: matbestar (small blind) folded before Flop
Seat 8: jrsebold (big blind) folded before Flop
Seat 9: kali155 folded before Flop (didn't bet)



PokerStars Hand #221589440918: Tournament #3074230175, $0.98+$0.12 USD Hold'em No Limit - Level XIV (300/600) - 2020/12/19 1:09:48 EET [2020/12/18 18:09:48 ET]
Table '3074230175 5' 9-max Seat #7 is the button
Seat 1: eimoutso (21160 in chips) 
Seat 2: smok80 (11885 in chips) 
Seat 3: 88099686 (2230 in chips) 
Seat 4: Gary.BY (25982 in chips) 
Seat 5: DLeeLegend (33269 in chips) 
Seat 6: jcarlos.vale (9742 in chips) 
Seat 7: matbestar (7240 in chips) 
Seat 8: jrsebold (15150 in chips) 
Seat 9: kali155 (4756 in chips) 
eimoutso: posts the ante 70
smok80: posts the ante 70
88099686: posts the ante 70
Gary.BY: posts the ante 70
DLeeLegend: posts the ante 70
jcarlos.vale: posts the ante 70
matbestar: posts the ante 70
jrsebold: posts the ante 70
kali155: posts the ante 70
jrsebold: posts small blind 300
kali155: posts big blind 600
*** HOLE CARDS ***
Dealt to jcarlos.vale [8h Qs]
eimoutso: folds 
smok80: folds 
88099686: raises 1560 to 2160 and is all-in
Gary.BY: calls 2160
DLeeLegend: calls 2160
jcarlos.vale: folds 
matbestar: folds 
jrsebold: folds 
kali155: folds 
*** FLOP *** [Js 3d 6h]
Gary.BY: checks 
DLeeLegend: checks 
*** TURN *** [Js 3d 6h] [6s]
Gary.BY: checks 
DLeeLegend: checks 
*** RIVER *** [Js 3d 6h 6s] [2d]
Gary.BY: checks 
DLeeLegend: checks 
*** SHOW DOWN ***
88099686: shows [Ad Qd] (a pair of Sixes)
Gary.BY: mucks handDTO
DLeeLegend: mucks handDTO
88099686 collected 8010 from pot
*** SUMMARY ***
Total pot 8010 | Rake 0 
Board [Js 3d 6h 6s 2d]
Seat 1: eimoutso folded before Flop (didn't bet)
Seat 2: smok80 folded before Flop (didn't bet)
Seat 3: 88099686 showed [Ad Qd] and won (8010) with a pair of Sixes
Seat 4: Gary.BY mucked [8s As]
Seat 5: DLeeLegend mucked [Td 9d]
Seat 6: jcarlos.vale folded before Flop (didn't bet)
Seat 7: matbestar (button) folded before Flop (didn't bet)
Seat 8: jrsebold (small blind) folded before Flop
Seat 9: kali155 (big blind) folded before Flop



PokerStars Hand #221589477810: Tournament #3074230175, $0.98+$0.12 USD Hold'em No Limit - Level XV (350/700) - 2020/12/19 1:10:46 EET [2020/12/18 18:10:46 ET]
Table '3074230175 5' 9-max Seat #8 is the button
Seat 1: eimoutso (21090 in chips) 
Seat 2: smok80 (11815 in chips) 
Seat 3: 88099686 (8010 in chips) 
Seat 4: Gary.BY (23752 in chips) 
Seat 5: DLeeLegend (31039 in chips) 
Seat 6: jcarlos.vale (9672 in chips) 
Seat 7: matbestar (7170 in chips) 
Seat 8: jrsebold (14780 in chips) 
Seat 9: kali155 (4086 in chips) 
eimoutso: posts the ante 85
smok80: posts the ante 85
88099686: posts the ante 85
Gary.BY: posts the ante 85
DLeeLegend: posts the ante 85
jcarlos.vale: posts the ante 85
matbestar: posts the ante 85
jrsebold: posts the ante 85
kali155: posts the ante 85
kali155: posts small blind 350
eimoutso: posts big blind 700
*** HOLE CARDS ***
Dealt to jcarlos.vale [Td Jh]
smok80: folds 
88099686: folds 
Gary.BY: folds 
DLeeLegend: folds 
jcarlos.vale: folds 
matbestar: raises 6385 to 7085 and is all-in
jrsebold: folds 
kali155: folds 
eimoutso: folds 
Uncalled bet (6385) returned to matbestar
matbestar collected 2515 from pot
matbestar: doesn't show handDTO
*** SUMMARY ***
Total pot 2515 | Rake 0 
Seat 1: eimoutso (big blind) folded before Flop
Seat 2: smok80 folded before Flop (didn't bet)
Seat 3: 88099686 folded before Flop (didn't bet)
Seat 4: Gary.BY folded before Flop (didn't bet)
Seat 5: DLeeLegend folded before Flop (didn't bet)
Seat 6: jcarlos.vale folded before Flop (didn't bet)
Seat 7: matbestar collected (2515)
Seat 8: jrsebold (button) folded before Flop (didn't bet)
Seat 9: kali155 (small blind) folded before Flop



PokerStars Hand #221589503159: Tournament #3074230175, $0.98+$0.12 USD Hold'em No Limit - Level XV (350/700) - 2020/12/19 1:11:25 EET [2020/12/18 18:11:25 ET]
Table '3074230175 5' 9-max Seat #9 is the button
Seat 1: eimoutso (20305 in chips) 
Seat 2: smok80 (11730 in chips) 
Seat 3: 88099686 (7925 in chips) 
Seat 4: Gary.BY (23667 in chips) 
Seat 5: DLeeLegend (30954 in chips) 
Seat 6: jcarlos.vale (9587 in chips) 
Seat 7: matbestar (8900 in chips) 
Seat 8: jrsebold (14695 in chips) 
Seat 9: kali155 (3651 in chips) 
eimoutso: posts the ante 85
smok80: posts the ante 85
88099686: posts the ante 85
Gary.BY: posts the ante 85
DLeeLegend: posts the ante 85
jcarlos.vale: posts the ante 85
matbestar: posts the ante 85
jrsebold: posts the ante 85
kali155: posts the ante 85
eimoutso: posts small blind 350
smok80: posts big blind 700
*** HOLE CARDS ***
Dealt to jcarlos.vale [Js 9d]
88099686: folds 
Gary.BY: raises 700 to 1400
DLeeLegend: calls 1400
jcarlos.vale: folds 
matbestar: folds 
jrsebold: folds 
kali155: folds 
eimoutso: folds 
smok80: calls 700
*** FLOP *** [6s Qd Qh]
smok80: checks 
Gary.BY: checks 
DLeeLegend: checks 
*** TURN *** [6s Qd Qh] [Ad]
smok80: checks 
Gary.BY: checks 
DLeeLegend: checks 
*** RIVER *** [6s Qd Qh Ad] [6d]
smok80: checks 
Gary.BY: checks 
DLeeLegend: checks 
*** SHOW DOWN ***
smok80: shows [As 3s] (two pair, Aces and Queens)
Gary.BY: shows [Kc Ah] (two pair, Aces and Queens - King kicker)
DLeeLegend: mucks handDTO
Gary.BY collected 5315 from pot
*** SUMMARY ***
Total pot 5315 | Rake 0 
Board [6s Qd Qh Ad 6d]
Seat 1: eimoutso (small blind) folded before Flop
Seat 2: smok80 (big blind) showed [As 3s] and lost with two pair, Aces and Queens
Seat 3: 88099686 folded before Flop (didn't bet)
Seat 4: Gary.BY showed [Kc Ah] and won (5315) with two pair, Aces and Queens
Seat 5: DLeeLegend mucked [Th 9c]
Seat 6: jcarlos.vale folded before Flop (didn't bet)
Seat 7: matbestar folded before Flop (didn't bet)
Seat 8: jrsebold folded before Flop (didn't bet)
Seat 9: kali155 (button) folded before Flop (didn't bet)



PokerStars Hand #221589531985: Tournament #3074230175, $0.98+$0.12 USD Hold'em No Limit - Level XV (350/700) - 2020/12/19 1:12:11 EET [2020/12/18 18:12:11 ET]
Table '3074230175 5' 9-max Seat #1 is the button
Seat 1: eimoutso (19870 in chips) 
Seat 2: smok80 (10245 in chips) 
Seat 3: 88099686 (7840 in chips) 
Seat 4: Gary.BY (27497 in chips) 
Seat 5: DLeeLegend (29469 in chips) 
Seat 6: jcarlos.vale (9502 in chips) 
Seat 7: matbestar (8815 in chips) 
Seat 8: jrsebold (14610 in chips) 
Seat 9: kali155 (3566 in chips) 
eimoutso: posts the ante 85
smok80: posts the ante 85
88099686: posts the ante 85
Gary.BY: posts the ante 85
DLeeLegend: posts the ante 85
jcarlos.vale: posts the ante 85
matbestar: posts the ante 85
jrsebold: posts the ante 85
kali155: posts the ante 85
smok80: posts small blind 350
88099686: posts big blind 700
*** HOLE CARDS ***
Dealt to jcarlos.vale [6h Jh]
Gary.BY: folds 
DLeeLegend: folds 
jcarlos.vale: folds 
matbestar: folds 
jrsebold: folds 
kali155: calls 700
eimoutso: raises 2450 to 3150
smok80: folds 
88099686: folds 
kali155: raises 331 to 3481 and is all-in
eimoutso: calls 331
*** FLOP *** [5h 7c Qc]
*** TURN *** [5h 7c Qc] [Kd]
*** RIVER *** [5h 7c Qc Kd] [Kh]
*** SHOW DOWN ***
kali155: shows [Ac Kc] (three of a kind, Kings)
eimoutso: shows [Ks Ad] (three of a kind, Kings)
kali155 collected 4389 from pot
eimoutso collected 4388 from pot
*** SUMMARY ***
Total pot 8777 | Rake 0 
Board [5h 7c Qc Kd Kh]
Seat 1: eimoutso (button) showed [Ks Ad] and won (4388) with three of a kind, Kings
Seat 2: smok80 (small blind) folded before Flop
Seat 3: 88099686 (big blind) folded before Flop
Seat 4: Gary.BY folded before Flop (didn't bet)
Seat 5: DLeeLegend folded before Flop (didn't bet)
Seat 6: jcarlos.vale folded before Flop (didn't bet)
Seat 7: matbestar folded before Flop (didn't bet)
Seat 8: jrsebold folded before Flop (didn't bet)
Seat 9: kali155 showed [Ac Kc] and won (4389) with three of a kind, Kings



PokerStars Hand #221589566972: Tournament #3074230175, $0.98+$0.12 USD Hold'em No Limit - Level XV (350/700) - 2020/12/19 1:13:06 EET [2020/12/18 18:13:06 ET]
Table '3074230175 5' 9-max Seat #2 is the button
Seat 1: eimoutso (20692 in chips) 
Seat 2: smok80 (9810 in chips) 
Seat 3: 88099686 (7055 in chips) 
Seat 4: Gary.BY (27412 in chips) 
Seat 5: DLeeLegend (29384 in chips) 
Seat 6: jcarlos.vale (9417 in chips) 
Seat 7: matbestar (8730 in chips) 
Seat 8: jrsebold (14525 in chips) 
Seat 9: kali155 (4389 in chips) 
eimoutso: posts the ante 85
smok80: posts the ante 85
88099686: posts the ante 85
Gary.BY: posts the ante 85
DLeeLegend: posts the ante 85
jcarlos.vale: posts the ante 85
matbestar: posts the ante 85
jrsebold: posts the ante 85
kali155: posts the ante 85
88099686: posts small blind 350
Gary.BY: posts big blind 700
*** HOLE CARDS ***
Dealt to jcarlos.vale [2c Jc]
DLeeLegend: calls 700
jcarlos.vale: folds 
matbestar: folds 
jrsebold: folds 
kali155: folds 
eimoutso: folds 
smok80: raises 9025 to 9725 and is all-in
88099686: folds 
Gary.BY: folds 
DLeeLegend: folds 
Uncalled bet (9025) returned to smok80
smok80 collected 3215 from pot
smok80: doesn't show handDTO
*** SUMMARY ***
Total pot 3215 | Rake 0 
Seat 1: eimoutso folded before Flop (didn't bet)
Seat 2: smok80 (button) collected (3215)
Seat 3: 88099686 (small blind) folded before Flop
Seat 4: Gary.BY (big blind) folded before Flop
Seat 5: DLeeLegend folded before Flop
Seat 6: jcarlos.vale folded before Flop (didn't bet)
Seat 7: matbestar folded before Flop (didn't bet)
Seat 8: jrsebold folded before Flop (didn't bet)
Seat 9: kali155 folded before Flop (didn't bet)



PokerStars Hand #221589592351: Tournament #3074230175, $0.98+$0.12 USD Hold'em No Limit - Level XV (350/700) - 2020/12/19 1:13:46 EET [2020/12/18 18:13:46 ET]
Table '3074230175 5' 9-max Seat #3 is the button
Seat 1: eimoutso (20607 in chips) 
Seat 2: smok80 (12240 in chips) 
Seat 3: 88099686 (6620 in chips) 
Seat 4: Gary.BY (26627 in chips) 
Seat 5: DLeeLegend (28599 in chips) 
Seat 6: jcarlos.vale (9332 in chips) 
Seat 7: matbestar (8645 in chips) 
Seat 8: jrsebold (14440 in chips) 
Seat 9: kali155 (4304 in chips) 
eimoutso: posts the ante 85
smok80: posts the ante 85
88099686: posts the ante 85
Gary.BY: posts the ante 85
DLeeLegend: posts the ante 85
jcarlos.vale: posts the ante 85
matbestar: posts the ante 85
jrsebold: posts the ante 85
kali155: posts the ante 85
Gary.BY: posts small blind 350
DLeeLegend: posts big blind 700
*** HOLE CARDS ***
Dealt to jcarlos.vale [4d 2c]
jcarlos.vale: folds 
matbestar: folds 
jrsebold: raises 13655 to 14355 and is all-in
kali155: folds 
eimoutso: folds 
smok80: calls 12155 and is all-in
88099686: folds 
Gary.BY: folds 
DLeeLegend: folds 
Uncalled bet (2200) returned to jrsebold
*** FLOP *** [4s 2h 8s]
*** TURN *** [4s 2h 8s] [Jh]
*** RIVER *** [4s 2h 8s Jh] [6s]
*** SHOW DOWN ***
jrsebold: shows [Td Th] (a pair of Tens)
smok80: shows [Js Jc] (three of a kind, Jacks)
smok80 collected 26125 from pot
*** SUMMARY ***
Total pot 26125 | Rake 0 
Board [4s 2h 8s Jh 6s]
Seat 1: eimoutso folded before Flop (didn't bet)
Seat 2: smok80 showed [Js Jc] and won (26125) with three of a kind, Jacks
Seat 3: 88099686 (button) folded before Flop (didn't bet)
Seat 4: Gary.BY (small blind) folded before Flop
Seat 5: DLeeLegend (big blind) folded before Flop
Seat 6: jcarlos.vale folded before Flop (didn't bet)
Seat 7: matbestar folded before Flop (didn't bet)
Seat 8: jrsebold showed [Td Th] and lost with a pair of Tens
Seat 9: kali155 folded before Flop (didn't bet)



PokerStars Hand #221589620562: Tournament #3074230175, $0.98+$0.12 USD Hold'em No Limit - Level XV (350/700) - 2020/12/19 1:14:30 EET [2020/12/18 18:14:30 ET]
Table '3074230175 5' 9-max Seat #4 is the button
Seat 1: eimoutso (20522 in chips) 
Seat 2: smok80 (26125 in chips) 
Seat 3: 88099686 (6535 in chips) 
Seat 4: Gary.BY (26192 in chips) 
Seat 5: DLeeLegend (27814 in chips) 
Seat 6: jcarlos.vale (9247 in chips) 
Seat 7: matbestar (8560 in chips) 
Seat 8: jrsebold (2200 in chips) 
Seat 9: kali155 (4219 in chips) 
eimoutso: posts the ante 85
smok80: posts the ante 85
88099686: posts the ante 85
Gary.BY: posts the ante 85
DLeeLegend: posts the ante 85
jcarlos.vale: posts the ante 85
matbestar: posts the ante 85
jrsebold: posts the ante 85
kali155: posts the ante 85
DLeeLegend: posts small blind 350
jcarlos.vale: posts big blind 700
*** HOLE CARDS ***
Dealt to jcarlos.vale [Tc Th]
matbestar: folds 
jrsebold: folds 
kali155: folds 
eimoutso: folds 
smok80: raises 840 to 1540
88099686: folds 
Gary.BY: folds 
DLeeLegend: folds 
jcarlos.vale: raises 7622 to 9162 and is all-in
smok80: calls 7622
*** FLOP *** [5s 5h 5d]
*** TURN *** [5s 5h 5d] [9d]
*** RIVER *** [5s 5h 5d 9d] [4c]
*** SHOW DOWN ***
jcarlos.vale: shows [Tc Th] (a full house, Fives full of Tens)
smok80: shows [Jd Jc] (a full house, Fives full of Jacks)
smok80 collected 19439 from pot
jcarlos.vale finished the tournament in 128th place and received $1.68.
*** SUMMARY ***
Total pot 19439 | Rake 0 
Board [5s 5h 5d 9d 4c]
Seat 1: eimoutso folded before Flop (didn't bet)
Seat 2: smok80 showed [Jd Jc] and won (19439) with a full house, Fives full of Jacks
Seat 3: 88099686 folded before Flop (didn't bet)
Seat 4: Gary.BY (button) folded before Flop (didn't bet)
Seat 5: DLeeLegend (small blind) folded before Flop
Seat 6: jcarlos.vale (big blind) showed [Tc Th] and lost with a full house, Fives full of Tens
Seat 7: matbestar folded before Flop (didn't bet)
Seat 8: jrsebold folded before Flop (didn't bet)
Seat 9: kali155 folded before Flop (didn't bet)



