PokerStars Hand #221329367981: Tournament #3067368972, $0.25+$0.24+$0.06 USD Hold'em No Limit - Level IV (30/60) - 2020/12/11 19:52:21 EET [2020/12/11 12:52:21 ET]
Table '3067368972 53' 9-max Seat #1 is the button
Seat 1: Reinerownz (9988 in chips, $0.36 bounty) 
Seat 2: the joker726 (12201 in chips, $0.48 bounty) 
Seat 3: DiegoGutibr (7176 in chips, $0.24 bounty) 
Seat 4: Serega777690 (10147 in chips, $0.36 bounty) 
Seat 5: Aleks-080881 (4875 in chips, $0.24 bounty) 
Seat 6: 19902504 (5294 in chips, $0.24 bounty) 
Seat 7: JaneB551 (4754 in chips, $0.24 bounty) 
Seat 8: jcarlos.vale (5000 in chips, $0.24 bounty) 
Seat 9: 18ronny18 (4715 in chips, $0.24 bounty) is sitting out
Reinerownz: posts the ante 9
the joker726: posts the ante 9
DiegoGutibr: posts the ante 9
Serega777690: posts the ante 9
Aleks-080881: posts the ante 9
19902504: posts the ante 9
JaneB551: posts the ante 9
jcarlos.vale: posts the ante 9
18ronny18: posts the ante 9
the joker726: posts small blind 30
DiegoGutibr: posts big blind 60
*** HOLE CARDS ***
Dealt to jcarlos.vale [2s 7s]
Serega777690: calls 60
Aleks-080881: folds 
19902504: folds 
JaneB551: calls 60
jcarlos.vale: folds 
18ronny18: folds 
Reinerownz: folds 
the joker726: calls 30
DiegoGutibr: checks 
*** FLOP *** [Js 2d Ks]
the joker726: checks 
DiegoGutibr: checks 
Serega777690: checks 
JaneB551: checks 
*** TURN *** [Js 2d Ks] [Kc]
the joker726: checks 
DiegoGutibr: bets 96
Serega777690: calls 96
JaneB551: folds 
the joker726: folds 
*** RIVER *** [Js 2d Ks Kc] [Jc]
DiegoGutibr: bets 154
Serega777690: folds 
Uncalled bet (154) returned to DiegoGutibr
DiegoGutibr collected 513 from pot
DiegoGutibr: doesn't show handDTO
*** SUMMARY ***
Total pot 513 | Rake 0 
Board [Js 2d Ks Kc Jc]
Seat 1: Reinerownz (button) folded before Flop (didn't bet)
Seat 2: the joker726 (small blind) folded on the Turn
Seat 3: DiegoGutibr (big blind) collected (513)
Seat 4: Serega777690 folded on the River
Seat 5: Aleks-080881 folded before Flop (didn't bet)
Seat 6: 19902504 folded before Flop (didn't bet)
Seat 7: JaneB551 folded on the Turn
Seat 8: jcarlos.vale folded before Flop (didn't bet)
Seat 9: 18ronny18 folded before Flop (didn't bet)



PokerStars Hand #221329412981: Tournament #3067368972, $0.25+$0.24+$0.06 USD Hold'em No Limit - Level IV (30/60) - 2020/12/11 19:53:39 EET [2020/12/11 12:53:39 ET]
Table '3067368972 53' 9-max Seat #2 is the button
Seat 1: Reinerownz (9979 in chips, $0.36 bounty) 
Seat 2: the joker726 (12132 in chips, $0.48 bounty) 
Seat 3: DiegoGutibr (7524 in chips, $0.24 bounty) 
Seat 4: Serega777690 (9982 in chips, $0.36 bounty) 
Seat 5: Aleks-080881 (4866 in chips, $0.24 bounty) 
Seat 6: 19902504 (5285 in chips, $0.24 bounty) 
Seat 7: JaneB551 (4685 in chips, $0.24 bounty) 
Seat 8: jcarlos.vale (4991 in chips, $0.24 bounty) 
Seat 9: 18ronny18 (4706 in chips, $0.24 bounty) is sitting out
Reinerownz: posts the ante 9
the joker726: posts the ante 9
DiegoGutibr: posts the ante 9
Serega777690: posts the ante 9
Aleks-080881: posts the ante 9
19902504: posts the ante 9
JaneB551: posts the ante 9
jcarlos.vale: posts the ante 9
18ronny18: posts the ante 9
DiegoGutibr: posts small blind 30
Serega777690: posts big blind 60
*** HOLE CARDS ***
Dealt to jcarlos.vale [6d 2h]
Aleks-080881: calls 60
19902504: raises 72 to 132
JaneB551: folds 
jcarlos.vale is connected 
jcarlos.vale: folds 
18ronny18: folds 
Reinerownz: folds 
the joker726: folds 
DiegoGutibr: folds 
Serega777690: calls 72
Aleks-080881: calls 72
*** FLOP *** [Ks Ad Ah]
Serega777690: checks 
Aleks-080881: checks 
19902504: bets 120
Serega777690: folds 
Aleks-080881: folds 
Uncalled bet (120) returned to 19902504
19902504 collected 507 from pot
19902504: doesn't show handDTO
*** SUMMARY ***
Total pot 507 | Rake 0 
Board [Ks Ad Ah]
Seat 1: Reinerownz folded before Flop (didn't bet)
Seat 2: the joker726 (button) folded before Flop (didn't bet)
Seat 3: DiegoGutibr (small blind) folded before Flop
Seat 4: Serega777690 (big blind) folded on the Flop
Seat 5: Aleks-080881 folded on the Flop
Seat 6: 19902504 collected (507)
Seat 7: JaneB551 folded before Flop (didn't bet)
Seat 8: jcarlos.vale folded before Flop (didn't bet)
Seat 9: 18ronny18 folded before Flop (didn't bet)



PokerStars Hand #221329453337: Tournament #3067368972, $0.25+$0.24+$0.06 USD Hold'em No Limit - Level IV (30/60) - 2020/12/11 19:54:49 EET [2020/12/11 12:54:49 ET]
Table '3067368972 53' 9-max Seat #3 is the button
Seat 1: Reinerownz (9970 in chips, $0.36 bounty) 
Seat 2: the joker726 (12123 in chips, $0.48 bounty) 
Seat 3: DiegoGutibr (7485 in chips, $0.24 bounty) 
Seat 4: Serega777690 (9841 in chips, $0.36 bounty) 
Seat 5: Aleks-080881 (4725 in chips, $0.24 bounty) 
Seat 6: 19902504 (5651 in chips, $0.24 bounty) 
Seat 7: JaneB551 (4676 in chips, $0.24 bounty) 
Seat 8: jcarlos.vale (4982 in chips, $0.24 bounty) 
Seat 9: 18ronny18 (4697 in chips, $0.24 bounty) is sitting out
Reinerownz: posts the ante 9
the joker726: posts the ante 9
DiegoGutibr: posts the ante 9
Serega777690: posts the ante 9
Aleks-080881: posts the ante 9
19902504: posts the ante 9
JaneB551: posts the ante 9
jcarlos.vale: posts the ante 9
18ronny18: posts the ante 9
Serega777690: posts small blind 30
Aleks-080881: posts big blind 60
*** HOLE CARDS ***
Dealt to jcarlos.vale [6h 3c]
19902504: folds 
JaneB551: calls 60
jcarlos.vale: folds 
18ronny18: folds 
Reinerownz: folds 
the joker726: calls 60
DiegoGutibr: folds 
Serega777690: calls 30
Aleks-080881: checks 
*** FLOP *** [5s 2c 6d]
DiegoGutibr is sitting out
Serega777690: checks 
Aleks-080881: checks 
JaneB551: bets 60
the joker726: raises 240 to 300
Serega777690: calls 300
Aleks-080881: folds 
JaneB551: folds 
*** TURN *** [5s 2c 6d] [7h]
Serega777690: checks 
the joker726: bets 480
Serega777690: calls 480
*** RIVER *** [5s 2c 6d 7h] [Td]
Serega777690: bets 971
the joker726: calls 971
*** SHOW DOWN ***
Serega777690: shows [3h 4d] (a straight, Three to Seven)
the joker726: mucks handDTO
Serega777690 collected 3883 from pot
*** SUMMARY ***
Total pot 3883 | Rake 0 
Board [5s 2c 6d 7h Td]
Seat 1: Reinerownz folded before Flop (didn't bet)
Seat 2: the joker726 mucked [4s 6s]
Seat 3: DiegoGutibr (button) folded before Flop (didn't bet)
Seat 4: Serega777690 (small blind) showed [3h 4d] and won (3883) with a straight, Three to Seven
Seat 5: Aleks-080881 (big blind) folded on the Flop
Seat 6: 19902504 folded before Flop (didn't bet)
Seat 7: JaneB551 folded on the Flop
Seat 8: jcarlos.vale folded before Flop (didn't bet)
Seat 9: 18ronny18 folded before Flop (didn't bet)



PokerStars Hand #221329679706: Tournament #3067368972, $0.25+$0.24+$0.06 USD Hold'em No Limit - Level IV (30/60) - 2020/12/11 20:02:40 EET [2020/12/11 13:02:40 ET]
Table '3067368972 53' 9-max Seat #4 is the button
Seat 1: Reinerownz (9961 in chips, $0.36 bounty) 
Seat 2: the joker726 (10303 in chips, $0.48 bounty) 
Seat 3: DiegoGutibr (7476 in chips, $0.24 bounty) is sitting out
Seat 4: Serega777690 (11904 in chips, $0.36 bounty) 
Seat 5: Aleks-080881 (4656 in chips, $0.24 bounty) 
Seat 6: 19902504 (5642 in chips, $0.24 bounty) 
Seat 7: JaneB551 (4547 in chips, $0.24 bounty) 
Seat 8: jcarlos.vale (4973 in chips, $0.24 bounty) 
Seat 9: 18ronny18 (4688 in chips, $0.24 bounty) is sitting out
Reinerownz: posts the ante 9
the joker726: posts the ante 9
DiegoGutibr: posts the ante 9
Serega777690: posts the ante 9
Aleks-080881: posts the ante 9
19902504: posts the ante 9
JaneB551: posts the ante 9
jcarlos.vale: posts the ante 9
18ronny18: posts the ante 9
Aleks-080881: posts small blind 30
19902504: posts big blind 60
*** HOLE CARDS ***
Dealt to jcarlos.vale [3s 4s]
JaneB551: calls 60
jcarlos.vale: folds 
18ronny18: folds 
Reinerownz: calls 60
the joker726: calls 60
DiegoGutibr: folds 
DiegoGutibr has returned
Serega777690: folds 
DiegoGutibr is sitting out
Aleks-080881: folds 
19902504: checks 
*** FLOP *** [6c 6s Kc]
19902504: checks 
JaneB551: bets 60
Reinerownz: raises 471 to 531
the joker726: folds 
19902504: folds 
18ronny18 has returned
JaneB551: folds 
Uncalled bet (471) returned to Reinerownz
Reinerownz collected 471 from pot
Reinerownz: doesn't show handDTO
*** SUMMARY ***
Total pot 471 | Rake 0 
Board [6c 6s Kc]
Seat 1: Reinerownz collected (471)
Seat 2: the joker726 folded on the Flop
Seat 3: DiegoGutibr folded before Flop (didn't bet)
Seat 4: Serega777690 (button) folded before Flop (didn't bet)
Seat 5: Aleks-080881 (small blind) folded before Flop
Seat 6: 19902504 (big blind) folded on the Flop
Seat 7: JaneB551 folded on the Flop
Seat 8: jcarlos.vale folded before Flop (didn't bet)
Seat 9: 18ronny18 folded before Flop (didn't bet)



PokerStars Hand #221329717418: Tournament #3067368972, $0.25+$0.24+$0.06 USD Hold'em No Limit - Level IV (30/60) - 2020/12/11 20:03:44 EET [2020/12/11 13:03:44 ET]
Table '3067368972 53' 9-max Seat #5 is the button
Seat 1: Reinerownz (10303 in chips, $0.36 bounty) 
Seat 2: the joker726 (10234 in chips, $0.48 bounty) 
Seat 3: DiegoGutibr (7467 in chips, $0.24 bounty) is sitting out
Seat 4: Serega777690 (11895 in chips, $0.36 bounty) 
Seat 5: Aleks-080881 (4617 in chips, $0.24 bounty) 
Seat 6: 19902504 (5573 in chips, $0.24 bounty) 
Seat 7: JaneB551 (4418 in chips, $0.24 bounty) 
Seat 8: jcarlos.vale (4964 in chips, $0.24 bounty) 
Seat 9: 18ronny18 (4679 in chips, $0.24 bounty) 
Reinerownz: posts the ante 9
the joker726: posts the ante 9
DiegoGutibr: posts the ante 9
Serega777690: posts the ante 9
Aleks-080881: posts the ante 9
19902504: posts the ante 9
JaneB551: posts the ante 9
jcarlos.vale: posts the ante 9
18ronny18: posts the ante 9
19902504: posts small blind 30
JaneB551: posts big blind 60
*** HOLE CARDS ***
Dealt to jcarlos.vale [7d 5d]
jcarlos.vale: folds 
18ronny18: calls 60
Reinerownz: folds 
18ronny18 is disconnected 
the joker726: calls 60
DiegoGutibr: folds 
Serega777690: folds 
Aleks-080881: calls 60
19902504: raises 480 to 540
JaneB551: folds 
18ronny18: folds 
the joker726: calls 480
Aleks-080881: calls 480
*** FLOP *** [4s 5c 3c]
19902504: bets 1320
the joker726: folds 
Aleks-080881: raises 2748 to 4068 and is all-in
DiegoGutibr has returned
19902504: calls 2748
*** TURN *** [4s 5c 3c] [3h]
*** RIVER *** [4s 5c 3c 3h] [4c]
*** SHOW DOWN ***
19902504: shows [Ac Ah] (two pair, Aces and Fours)
Aleks-080881: shows [6d 6h] (two pair, Sixes and Fours)
19902504 collected 9957 from pot
19902504 wins $0.12 for eliminating Aleks-080881 and their own bounty increases by $0.12 to $0.36
Aleks-080881 finished the tournament
*** SUMMARY ***
Total pot 9957 | Rake 0 
Board [4s 5c 3c 3h 4c]
Seat 1: Reinerownz folded before Flop (didn't bet)
Seat 2: the joker726 folded on the Flop
Seat 3: DiegoGutibr folded before Flop (didn't bet)
Seat 4: Serega777690 folded before Flop (didn't bet)
Seat 5: Aleks-080881 (button) showed [6d 6h] and lost with two pair, Sixes and Fours
Seat 6: 19902504 (small blind) showed [Ac Ah] and won (9957) with two pair, Aces and Fours
Seat 7: JaneB551 (big blind) folded before Flop
Seat 8: jcarlos.vale folded before Flop (didn't bet)
Seat 9: 18ronny18 folded before Flop



PokerStars Hand #221329749973: Tournament #3067368972, $0.25+$0.24+$0.06 USD Hold'em No Limit - Level IV (30/60) - 2020/12/11 20:04:40 EET [2020/12/11 13:04:40 ET]
Table '3067368972 323' 9-max Seat #1 is the button
Seat 1: ronnieovkella (4531 in chips, $0.24 bounty) 
Seat 2: madmaddie92 (4652 in chips, $0.24 bounty) is sitting out
Seat 3: bezblefa (5621 in chips, $0.24 bounty) 
Seat 4: jcarlos.vale (4955 in chips, $0.24 bounty) 
Seat 5: yazvauazva (6147 in chips, $0.24 bounty) 
Seat 6: slashfloyd (5000 in chips, $0.24 bounty) 
Seat 7: P1nk7 (4296 in chips, $0.24 bounty) 
ronnieovkella: posts the ante 9
madmaddie92: posts the ante 9
bezblefa: posts the ante 9
jcarlos.vale: posts the ante 9
yazvauazva: posts the ante 9
slashfloyd: posts the ante 9
P1nk7: posts the ante 9
madmaddie92: posts small blind 30
bezblefa: posts big blind 60
*** HOLE CARDS ***
Dealt to jcarlos.vale [2h 9d]
jcarlos.vale is connected 
jcarlos.vale: folds 
yazvauazva: folds 
slashfloyd: folds 
P1nk7: raises 120 to 180
ronnieovkella: calls 180
madmaddie92: folds 
bezblefa: folds 
*** FLOP *** [4d 8c Js]
P1nk7: bets 240
ronnieovkella: folds 
Uncalled bet (240) returned to P1nk7
P1nk7 collected 513 from pot
*** SUMMARY ***
Total pot 513 | Rake 0 
Board [4d 8c Js]
Seat 1: ronnieovkella (button) folded on the Flop
Seat 2: madmaddie92 (small blind) folded before Flop
Seat 3: bezblefa (big blind) folded before Flop
Seat 4: jcarlos.vale folded before Flop (didn't bet)
Seat 5: yazvauazva folded before Flop (didn't bet)
Seat 6: slashfloyd folded before Flop (didn't bet)
Seat 7: P1nk7 collected (513)



PokerStars Hand #221329766338: Tournament #3067368972, $0.25+$0.24+$0.06 USD Hold'em No Limit - Level IV (30/60) - 2020/12/11 20:05:08 EET [2020/12/11 13:05:08 ET]
Table '3067368972 323' 9-max Seat #2 is the button
Seat 1: ronnieovkella (4342 in chips, $0.24 bounty) 
Seat 2: madmaddie92 (4613 in chips, $0.24 bounty) is sitting out
Seat 3: bezblefa (5552 in chips, $0.24 bounty) 
Seat 4: jcarlos.vale (4946 in chips, $0.24 bounty) 
Seat 5: yazvauazva (6138 in chips, $0.24 bounty) 
Seat 6: slashfloyd (4991 in chips, $0.24 bounty) 
Seat 7: P1nk7 (4620 in chips, $0.24 bounty) 
Seat 8: Lucky Schiza (3958 in chips, $0.24 bounty) 
Seat 9: neris449 (5000 in chips, $0.24 bounty) 
ronnieovkella: posts the ante 9
madmaddie92: posts the ante 9
bezblefa: posts the ante 9
jcarlos.vale: posts the ante 9
yazvauazva: posts the ante 9
slashfloyd: posts the ante 9
P1nk7: posts the ante 9
Lucky Schiza: posts the ante 9
neris449: posts the ante 9
bezblefa: posts small blind 30
jcarlos.vale: posts big blind 60
*** HOLE CARDS ***
Dealt to jcarlos.vale [4h 7h]
yazvauazva: folds 
slashfloyd: raises 72 to 132
P1nk7: folds 
Lucky Schiza: folds 
neris449: calls 132
ronnieovkella: folds 
madmaddie92: folds 
bezblefa: calls 102
jcarlos.vale: folds 
*** FLOP *** [3h Td 8d]
bezblefa: checks 
slashfloyd: bets 242
neris449: folds 
bezblefa: calls 242
*** TURN *** [3h Td 8d] [5c]
bezblefa: checks 
slashfloyd: bets 459
bezblefa: folds 
Uncalled bet (459) returned to slashfloyd
slashfloyd collected 1021 from pot
slashfloyd: doesn't show handDTO
*** SUMMARY ***
Total pot 1021 | Rake 0 
Board [3h Td 8d 5c]
Seat 1: ronnieovkella folded before Flop (didn't bet)
Seat 2: madmaddie92 (button) folded before Flop (didn't bet)
Seat 3: bezblefa (small blind) folded on the Turn
Seat 4: jcarlos.vale (big blind) folded before Flop
Seat 5: yazvauazva folded before Flop (didn't bet)
Seat 6: slashfloyd collected (1021)
Seat 7: P1nk7 folded before Flop (didn't bet)
Seat 8: Lucky Schiza folded before Flop (didn't bet)
Seat 9: neris449 folded on the Flop



PokerStars Hand #221329822031: Tournament #3067368972, $0.25+$0.24+$0.06 USD Hold'em No Limit - Level V (35/70) - 2020/12/11 20:06:43 EET [2020/12/11 13:06:43 ET]
Table '3067368972 323' 9-max Seat #3 is the button
Seat 1: ronnieovkella (4333 in chips, $0.24 bounty) 
Seat 2: madmaddie92 (4604 in chips, $0.24 bounty) is sitting out
Seat 3: bezblefa (5169 in chips, $0.24 bounty) 
Seat 4: jcarlos.vale (4877 in chips, $0.24 bounty) 
Seat 5: yazvauazva (6129 in chips, $0.24 bounty) 
Seat 6: slashfloyd (5629 in chips, $0.24 bounty) 
Seat 7: P1nk7 (4611 in chips, $0.24 bounty) 
Seat 8: Lucky Schiza (3949 in chips, $0.24 bounty) 
Seat 9: neris449 (4859 in chips, $0.24 bounty) 
ronnieovkella: posts the ante 11
madmaddie92: posts the ante 11
bezblefa: posts the ante 11
jcarlos.vale: posts the ante 11
yazvauazva: posts the ante 11
slashfloyd: posts the ante 11
P1nk7: posts the ante 11
Lucky Schiza: posts the ante 11
neris449: posts the ante 11
jcarlos.vale: posts small blind 35
yazvauazva: posts big blind 70
*** HOLE CARDS ***
Dealt to jcarlos.vale [Jd Qh]
slashfloyd: folds 
P1nk7: folds 
Lucky Schiza: folds 
neris449: calls 70
ronnieovkella: folds 
madmaddie92: folds 
bezblefa: folds 
jcarlos.vale: calls 35
yazvauazva: checks 
*** FLOP *** [Kc 4d 2s]
jcarlos.vale: checks 
yazvauazva: checks 
neris449: checks 
*** TURN *** [Kc 4d 2s] [Kd]
jcarlos.vale: checks 
yazvauazva: checks 
neris449: bets 70
jcarlos.vale: folds 
yazvauazva: folds 
Uncalled bet (70) returned to neris449
neris449 collected 309 from pot
neris449: doesn't show handDTO
*** SUMMARY ***
Total pot 309 | Rake 0 
Board [Kc 4d 2s Kd]
Seat 1: ronnieovkella folded before Flop (didn't bet)
Seat 2: madmaddie92 folded before Flop (didn't bet)
Seat 3: bezblefa (button) folded before Flop (didn't bet)
Seat 4: jcarlos.vale (small blind) folded on the Turn
Seat 5: yazvauazva (big blind) folded on the Turn
Seat 6: slashfloyd folded before Flop (didn't bet)
Seat 7: P1nk7 folded before Flop (didn't bet)
Seat 8: Lucky Schiza folded before Flop (didn't bet)
Seat 9: neris449 collected (309)



PokerStars Hand #221329877273: Tournament #3067368972, $0.25+$0.24+$0.06 USD Hold'em No Limit - Level V (35/70) - 2020/12/11 20:08:17 EET [2020/12/11 13:08:17 ET]
Table '3067368972 323' 9-max Seat #4 is the button
Seat 1: ronnieovkella (4322 in chips, $0.24 bounty) 
Seat 2: madmaddie92 (4593 in chips, $0.24 bounty) is sitting out
Seat 3: bezblefa (5158 in chips, $0.24 bounty) 
Seat 4: jcarlos.vale (4796 in chips, $0.24 bounty) 
Seat 5: yazvauazva (6048 in chips, $0.24 bounty) 
Seat 6: slashfloyd (5618 in chips, $0.24 bounty) 
Seat 7: P1nk7 (4600 in chips, $0.24 bounty) 
Seat 8: Lucky Schiza (3938 in chips, $0.24 bounty) 
Seat 9: neris449 (5087 in chips, $0.24 bounty) 
ronnieovkella: posts the ante 11
madmaddie92: posts the ante 11
bezblefa: posts the ante 11
jcarlos.vale: posts the ante 11
yazvauazva: posts the ante 11
slashfloyd: posts the ante 11
P1nk7: posts the ante 11
Lucky Schiza: posts the ante 11
neris449: posts the ante 11
yazvauazva: posts small blind 35
slashfloyd: posts big blind 70
*** HOLE CARDS ***
Dealt to jcarlos.vale [8d Td]
P1nk7: raises 140 to 210
Lucky Schiza: folds 
neris449: calls 210
ronnieovkella: calls 210
madmaddie92: folds 
bezblefa: folds 
jcarlos.vale: folds 
yazvauazva: folds 
slashfloyd: raises 420 to 630
P1nk7: raises 3959 to 4589 and is all-in
neris449: folds 
ronnieovkella: folds 
slashfloyd: calls 3959
*** FLOP *** [Js 5d 5c]
*** TURN *** [Js 5d 5c] [8h]
*** RIVER *** [Js 5d 5c 8h] [7d]
*** SHOW DOWN ***
slashfloyd: shows [Ad Qd] (a pair of Fives)
P1nk7: shows [Qc Qs] (two pair, Queens and Fives)
P1nk7 collected 9732 from pot
*** SUMMARY ***
Total pot 9732 | Rake 0 
Board [Js 5d 5c 8h 7d]
Seat 1: ronnieovkella folded before Flop
Seat 2: madmaddie92 folded before Flop (didn't bet)
Seat 3: bezblefa folded before Flop (didn't bet)
Seat 4: jcarlos.vale (button) folded before Flop (didn't bet)
Seat 5: yazvauazva (small blind) folded before Flop
Seat 6: slashfloyd (big blind) showed [Ad Qd] and lost with a pair of Fives
Seat 7: P1nk7 showed [Qc Qs] and won (9732) with two pair, Queens and Fives
Seat 8: Lucky Schiza folded before Flop (didn't bet)
Seat 9: neris449 folded before Flop



PokerStars Hand #221329915269: Tournament #3067368972, $0.25+$0.24+$0.06 USD Hold'em No Limit - Level V (35/70) - 2020/12/11 20:09:20 EET [2020/12/11 13:09:20 ET]
Table '3067368972 323' 9-max Seat #5 is the button
Seat 1: ronnieovkella (4101 in chips, $0.24 bounty) 
Seat 2: madmaddie92 (4582 in chips, $0.24 bounty) is sitting out
Seat 3: bezblefa (5147 in chips, $0.24 bounty) 
Seat 4: jcarlos.vale (4785 in chips, $0.24 bounty) 
Seat 5: yazvauazva (6002 in chips, $0.24 bounty) 
Seat 6: slashfloyd (1018 in chips, $0.24 bounty) 
Seat 7: P1nk7 (9732 in chips, $0.24 bounty) 
Seat 8: Lucky Schiza (3927 in chips, $0.24 bounty) 
Seat 9: neris449 (4866 in chips, $0.24 bounty) 
ronnieovkella: posts the ante 11
madmaddie92: posts the ante 11
bezblefa: posts the ante 11
jcarlos.vale: posts the ante 11
yazvauazva: posts the ante 11
slashfloyd: posts the ante 11
P1nk7: posts the ante 11
Lucky Schiza: posts the ante 11
neris449: posts the ante 11
slashfloyd: posts small blind 35
P1nk7: posts big blind 70
*** HOLE CARDS ***
Dealt to jcarlos.vale [As Ad]
Lucky Schiza: raises 70 to 140
neris449: calls 140
ronnieovkella: folds 
madmaddie92: folds 
bezblefa: calls 140
jcarlos.vale: raises 210 to 350
yazvauazva: folds 
slashfloyd: folds 
P1nk7: folds 
Lucky Schiza: calls 210
neris449: calls 210
bezblefa: calls 210
*** FLOP *** [5s 2s Jc]
Lucky Schiza: bets 560
neris449: calls 560
bezblefa: calls 560
jcarlos.vale: raises 3864 to 4424 and is all-in
Lucky Schiza: calls 3006 and is all-in
neris449: folds 
bezblefa: calls 3864
*** TURN *** [5s 2s Jc] [Ah]
*** RIVER *** [5s 2s Jc Ah] [Th]
*** SHOW DOWN ***
bezblefa: shows [6h 5h] (a pair of Fives)
jcarlos.vale: shows [As Ad] (three of a kind, Aces)
jcarlos.vale collected 1716 from side pot
Lucky Schiza: shows [Ks Jh] (a pair of Jacks)
jcarlos.vale collected 12862 from main pot
jcarlos.vale wins $0.12 for eliminating Lucky Schiza and their own bounty increases by $0.12 to $0.36
Lucky Schiza finished the tournament
*** SUMMARY ***
Total pot 14578 Main pot 12862. Side pot 1716. | Rake 0 
Board [5s 2s Jc Ah Th]
Seat 1: ronnieovkella folded before Flop (didn't bet)
Seat 2: madmaddie92 folded before Flop (didn't bet)
Seat 3: bezblefa showed [6h 5h] and lost with a pair of Fives
Seat 4: jcarlos.vale showed [As Ad] and won (14578) with three of a kind, Aces
Seat 5: yazvauazva (button) folded before Flop (didn't bet)
Seat 6: slashfloyd (small blind) folded before Flop
Seat 7: P1nk7 (big blind) folded before Flop
Seat 8: Lucky Schiza showed [Ks Jh] and lost with a pair of Jacks
Seat 9: neris449 folded on the Flop



PokerStars Hand #221329970640: Tournament #3067368972, $0.25+$0.24+$0.06 USD Hold'em No Limit - Level V (35/70) - 2020/12/11 20:10:53 EET [2020/12/11 13:10:53 ET]
Table '3067368972 323' 9-max Seat #6 is the button
Seat 1: ronnieovkella (4090 in chips, $0.24 bounty) 
Seat 2: madmaddie92 (4571 in chips, $0.24 bounty) is sitting out
Seat 3: bezblefa (362 in chips, $0.24 bounty) 
Seat 4: jcarlos.vale (14578 in chips, $0.36 bounty) 
Seat 5: yazvauazva (5991 in chips, $0.24 bounty) 
Seat 6: slashfloyd (972 in chips, $0.24 bounty) 
Seat 7: P1nk7 (9651 in chips, $0.24 bounty) 
Seat 9: neris449 (3945 in chips, $0.24 bounty) 
ronnieovkella: posts the ante 11
madmaddie92: posts the ante 11
bezblefa: posts the ante 11
jcarlos.vale: posts the ante 11
yazvauazva: posts the ante 11
slashfloyd: posts the ante 11
P1nk7: posts the ante 11
neris449: posts the ante 11
P1nk7: posts small blind 35
neris449: posts big blind 70
*** HOLE CARDS ***
Dealt to jcarlos.vale [Kd 4h]
ronnieovkella: folds 
madmaddie92: folds 
bezblefa: raises 70 to 140
jcarlos.vale: folds 
yazvauazva: folds 
slashfloyd: folds 
P1nk7: folds 
neris449: calls 70
*** FLOP *** [3h Tc 7c]
neris449: checks 
bezblefa: bets 211 and is all-in
neris449: calls 211
*** TURN *** [3h Tc 7c] [2c]
*** RIVER *** [3h Tc 7c 2c] [Ac]
*** SHOW DOWN ***
neris449: shows [Jh As] (a pair of Aces)
bezblefa: shows [3c Ad] (a flush, Ace high)
bezblefa collected 825 from pot
*** SUMMARY ***
Total pot 825 | Rake 0 
Board [3h Tc 7c 2c Ac]
Seat 1: ronnieovkella folded before Flop (didn't bet)
Seat 2: madmaddie92 folded before Flop (didn't bet)
Seat 3: bezblefa showed [3c Ad] and won (825) with a flush, Ace high
Seat 4: jcarlos.vale folded before Flop (didn't bet)
Seat 5: yazvauazva folded before Flop (didn't bet)
Seat 6: slashfloyd (button) folded before Flop (didn't bet)
Seat 7: P1nk7 (small blind) folded before Flop
Seat 9: neris449 (big blind) showed [Jh As] and lost with a pair of Aces



PokerStars Hand #221329997824: Tournament #3067368972, $0.25+$0.24+$0.06 USD Hold'em No Limit - Level V (35/70) - 2020/12/11 20:11:39 EET [2020/12/11 13:11:39 ET]
Table '3067368972 323' 9-max Seat #7 is the button
Seat 1: ronnieovkella (4079 in chips, $0.24 bounty) 
Seat 2: madmaddie92 (4560 in chips, $0.24 bounty) is sitting out
Seat 3: bezblefa (825 in chips, $0.24 bounty) 
Seat 4: jcarlos.vale (14567 in chips, $0.36 bounty) 
Seat 5: yazvauazva (5980 in chips, $0.24 bounty) 
Seat 6: slashfloyd (961 in chips, $0.24 bounty) 
Seat 7: P1nk7 (9605 in chips, $0.24 bounty) 
Seat 8: DartmanD1 (24662 in chips) out of handDTO (moved from another table into small blind)
Seat 9: neris449 (3583 in chips, $0.24 bounty) 
DartmanD1 will be allowed to play after the button
ronnieovkella: posts the ante 11
madmaddie92: posts the ante 11
bezblefa: posts the ante 11
jcarlos.vale: posts the ante 11
yazvauazva: posts the ante 11
slashfloyd: posts the ante 11
P1nk7: posts the ante 11
neris449: posts the ante 11
neris449: posts small blind 35
ronnieovkella: posts big blind 70
*** HOLE CARDS ***
Dealt to jcarlos.vale [6d 4h]
madmaddie92: folds 
bezblefa: raises 175 to 245
jcarlos.vale: folds 
yazvauazva: folds 
slashfloyd: folds 
P1nk7: calls 245
neris449: calls 210
ronnieovkella: folds 
*** FLOP *** [Td Tc 2d]
neris449: checks 
bezblefa: bets 268
P1nk7: folds 
neris449: folds 
Uncalled bet (268) returned to bezblefa
bezblefa collected 893 from pot
bezblefa: doesn't show handDTO
*** SUMMARY ***
Total pot 893 | Rake 0 
Board [Td Tc 2d]
Seat 1: ronnieovkella (big blind) folded before Flop
Seat 2: madmaddie92 folded before Flop (didn't bet)
Seat 3: bezblefa collected (893)
Seat 4: jcarlos.vale folded before Flop (didn't bet)
Seat 5: yazvauazva folded before Flop (didn't bet)
Seat 6: slashfloyd folded before Flop (didn't bet)
Seat 7: P1nk7 (button) folded on the Flop
Seat 9: neris449 (small blind) folded on the Flop



PokerStars Hand #221330031124: Tournament #3067368972, $0.25+$0.24+$0.06 USD Hold'em No Limit - Level V (35/70) - 2020/12/11 20:12:35 EET [2020/12/11 13:12:35 ET]
Table '3067368972 323' 9-max Seat #9 is the button
Seat 1: ronnieovkella (3998 in chips, $0.24 bounty) 
Seat 2: madmaddie92 (4549 in chips, $0.24 bounty) is sitting out
Seat 3: bezblefa (1462 in chips, $0.24 bounty) 
Seat 4: jcarlos.vale (14556 in chips, $0.36 bounty) 
Seat 5: yazvauazva (5969 in chips, $0.24 bounty) 
Seat 6: slashfloyd (950 in chips, $0.24 bounty) 
Seat 7: P1nk7 (9349 in chips, $0.24 bounty) 
Seat 8: DartmanD1 (24662 in chips, $0.60 bounty) 
Seat 9: neris449 (3327 in chips, $0.24 bounty) 
ronnieovkella: posts the ante 11
madmaddie92: posts the ante 11
bezblefa: posts the ante 11
jcarlos.vale: posts the ante 11
yazvauazva: posts the ante 11
slashfloyd: posts the ante 11
P1nk7: posts the ante 11
DartmanD1: posts the ante 11
neris449: posts the ante 11
ronnieovkella: posts small blind 35
madmaddie92: posts big blind 70
*** HOLE CARDS ***
Dealt to jcarlos.vale [6d 7c]
bezblefa: folds 
jcarlos.vale: folds 
yazvauazva: folds 
slashfloyd: folds 
P1nk7: raises 140 to 210
DartmanD1: folds 
neris449: calls 210
ronnieovkella: folds 
madmaddie92: folds 
*** FLOP *** [Ah Kh Qh]
P1nk7: bets 280
neris449: calls 280
*** TURN *** [Ah Kh Qh] [Ac]
P1nk7: bets 420
neris449: calls 420
*** RIVER *** [Ah Kh Qh Ac] [3s]
P1nk7: bets 1050
neris449: folds 
Uncalled bet (1050) returned to P1nk7
P1nk7 collected 2024 from pot
P1nk7: doesn't show handDTO
*** SUMMARY ***
Total pot 2024 | Rake 0 
Board [Ah Kh Qh Ac 3s]
Seat 1: ronnieovkella (small blind) folded before Flop
Seat 2: madmaddie92 (big blind) folded before Flop
Seat 3: bezblefa folded before Flop (didn't bet)
Seat 4: jcarlos.vale folded before Flop (didn't bet)
Seat 5: yazvauazva folded before Flop (didn't bet)
Seat 6: slashfloyd folded before Flop (didn't bet)
Seat 7: P1nk7 collected (2024)
Seat 8: DartmanD1 folded before Flop (didn't bet)
Seat 9: neris449 (button) folded on the River



PokerStars Hand #221330063707: Tournament #3067368972, $0.25+$0.24+$0.06 USD Hold'em No Limit - Level VI (40/80) - 2020/12/11 20:13:30 EET [2020/12/11 13:13:30 ET]
Table '3067368972 323' 9-max Seat #1 is the button
Seat 1: ronnieovkella (3952 in chips, $0.24 bounty) 
Seat 2: madmaddie92 (4468 in chips, $0.24 bounty) is sitting out
Seat 3: bezblefa (1451 in chips, $0.24 bounty) 
Seat 4: jcarlos.vale (14545 in chips, $0.36 bounty) 
Seat 5: yazvauazva (5958 in chips, $0.24 bounty) 
Seat 6: slashfloyd (939 in chips, $0.24 bounty) 
Seat 7: P1nk7 (10452 in chips, $0.24 bounty) 
Seat 8: DartmanD1 (24651 in chips, $0.60 bounty) 
Seat 9: neris449 (2406 in chips, $0.24 bounty) 
ronnieovkella: posts the ante 12
madmaddie92: posts the ante 12
bezblefa: posts the ante 12
jcarlos.vale: posts the ante 12
yazvauazva: posts the ante 12
slashfloyd: posts the ante 12
P1nk7: posts the ante 12
DartmanD1: posts the ante 12
neris449: posts the ante 12
madmaddie92: posts small blind 40
bezblefa: posts big blind 80
*** HOLE CARDS ***
Dealt to jcarlos.vale [3d 9d]
jcarlos.vale: folds 
yazvauazva: folds 
slashfloyd: folds 
P1nk7: raises 160 to 240
DartmanD1: calls 240
neris449: calls 240
ronnieovkella: folds 
madmaddie92: folds 
bezblefa: raises 160 to 400
P1nk7: raises 1520 to 1920
DartmanD1: folds 
neris449: folds 
bezblefa: calls 1039 and is all-in
Uncalled bet (481) returned to P1nk7
*** FLOP *** [8d Ad 7h]
*** TURN *** [8d Ad 7h] [Td]
*** RIVER *** [8d Ad 7h Td] [Tc]
*** SHOW DOWN ***
bezblefa: shows [Ah Ts] (a full house, Tens full of Aces)
P1nk7: shows [Ks As] (two pair, Aces and Tens)
bezblefa collected 3506 from pot
*** SUMMARY ***
Total pot 3506 | Rake 0 
Board [8d Ad 7h Td Tc]
Seat 1: ronnieovkella (button) folded before Flop (didn't bet)
Seat 2: madmaddie92 (small blind) folded before Flop
Seat 3: bezblefa (big blind) showed [Ah Ts] and won (3506) with a full house, Tens full of Aces
Seat 4: jcarlos.vale folded before Flop (didn't bet)
Seat 5: yazvauazva folded before Flop (didn't bet)
Seat 6: slashfloyd folded before Flop (didn't bet)
Seat 7: P1nk7 showed [Ks As] and lost with two pair, Aces and Tens
Seat 8: DartmanD1 folded before Flop
Seat 9: neris449 folded before Flop



PokerStars Hand #221330103842: Tournament #3067368972, $0.25+$0.24+$0.06 USD Hold'em No Limit - Level VI (40/80) - 2020/12/11 20:14:38 EET [2020/12/11 13:14:38 ET]
Table '3067368972 323' 9-max Seat #2 is the button
Seat 1: ronnieovkella (3940 in chips, $0.24 bounty) 
Seat 2: madmaddie92 (4416 in chips, $0.24 bounty) is sitting out
Seat 3: bezblefa (3506 in chips, $0.24 bounty) 
Seat 4: jcarlos.vale (14533 in chips, $0.36 bounty) 
Seat 5: yazvauazva (5946 in chips, $0.24 bounty) 
Seat 6: slashfloyd (927 in chips, $0.24 bounty) 
Seat 7: P1nk7 (9001 in chips, $0.24 bounty) 
Seat 8: DartmanD1 (24399 in chips, $0.60 bounty) 
Seat 9: neris449 (2154 in chips, $0.24 bounty) 
ronnieovkella: posts the ante 12
madmaddie92: posts the ante 12
bezblefa: posts the ante 12
jcarlos.vale: posts the ante 12
yazvauazva: posts the ante 12
slashfloyd: posts the ante 12
P1nk7: posts the ante 12
DartmanD1: posts the ante 12
neris449: posts the ante 12
bezblefa: posts small blind 40
jcarlos.vale: posts big blind 80
*** HOLE CARDS ***
Dealt to jcarlos.vale [Qd As]
yazvauazva: folds 
slashfloyd: raises 835 to 915 and is all-in
P1nk7: folds 
DartmanD1: folds 
neris449: calls 915
ronnieovkella: folds 
madmaddie92: folds 
bezblefa: raises 835 to 1750
jcarlos.vale: folds 
neris449: raises 392 to 2142 and is all-in
bezblefa: calls 392
*** FLOP *** [8d 8h Tc]
*** TURN *** [8d 8h Tc] [Kh]
*** RIVER *** [8d 8h Tc Kh] [5h]
*** SHOW DOWN ***
bezblefa: shows [6d 6h] (two pair, Eights and Sixes)
neris449: shows [9d Kc] (two pair, Kings and Eights)
neris449 collected 2454 from side pot
slashfloyd: shows [Qs Ad] (a pair of Eights)
neris449 collected 2933 from main pot
neris449 wins $0.12 for eliminating slashfloyd and their own bounty increases by $0.12 to $0.36
slashfloyd finished the tournament
*** SUMMARY ***
Total pot 5387 Main pot 2933. Side pot 2454. | Rake 0 
Board [8d 8h Tc Kh 5h]
Seat 1: ronnieovkella folded before Flop (didn't bet)
Seat 2: madmaddie92 (button) folded before Flop (didn't bet)
Seat 3: bezblefa (small blind) showed [6d 6h] and lost with two pair, Eights and Sixes
Seat 4: jcarlos.vale (big blind) folded before Flop
Seat 5: yazvauazva folded before Flop (didn't bet)
Seat 6: slashfloyd showed [Qs Ad] and lost with a pair of Eights
Seat 7: P1nk7 folded before Flop (didn't bet)
Seat 8: DartmanD1 folded before Flop (didn't bet)
Seat 9: neris449 showed [9d Kc] and won (5387) with two pair, Kings and Eights



PokerStars Hand #221330141478: Tournament #3067368972, $0.25+$0.24+$0.06 USD Hold'em No Limit - Level VI (40/80) - 2020/12/11 20:15:40 EET [2020/12/11 13:15:40 ET]
Table '3067368972 323' 9-max Seat #3 is the button
Seat 1: ronnieovkella (3928 in chips, $0.24 bounty) 
Seat 2: madmaddie92 (4404 in chips, $0.24 bounty) is sitting out
Seat 3: bezblefa (1352 in chips, $0.24 bounty) 
Seat 4: jcarlos.vale (14441 in chips, $0.36 bounty) 
Seat 5: yazvauazva (5934 in chips, $0.24 bounty) 
Seat 7: P1nk7 (8989 in chips, $0.24 bounty) 
Seat 8: DartmanD1 (24387 in chips, $0.60 bounty) 
Seat 9: neris449 (5387 in chips, $0.36 bounty) 
ronnieovkella: posts the ante 12
madmaddie92: posts the ante 12
bezblefa: posts the ante 12
jcarlos.vale: posts the ante 12
yazvauazva: posts the ante 12
P1nk7: posts the ante 12
DartmanD1: posts the ante 12
neris449: posts the ante 12
jcarlos.vale: posts small blind 40
yazvauazva: posts big blind 80
*** HOLE CARDS ***
Dealt to jcarlos.vale [9c Qc]
P1nk7: folds 
DartmanD1: raises 160 to 240
neris449: calls 240
ronnieovkella: folds 
madmaddie92: folds 
bezblefa: folds 
jcarlos.vale: folds 
yazvauazva: folds 
*** FLOP *** [6d 9h 3h]
DartmanD1: bets 348
neris449: calls 348
*** TURN *** [6d 9h 3h] [3c]
DartmanD1: bets 557
neris449: calls 557
*** RIVER *** [6d 9h 3h 3c] [2h]
DartmanD1: bets 877
neris449: raises 3353 to 4230 and is all-in
DartmanD1: calls 3353
*** SHOW DOWN ***
neris449: shows [4h 5h] (a flush, Nine high)
DartmanD1: shows [As Ac] (two pair, Aces and Threes)
neris449 collected 10966 from pot
*** SUMMARY ***
Total pot 10966 | Rake 0 
Board [6d 9h 3h 3c 2h]
Seat 1: ronnieovkella folded before Flop (didn't bet)
Seat 2: madmaddie92 folded before Flop (didn't bet)
Seat 3: bezblefa (button) folded before Flop (didn't bet)
Seat 4: jcarlos.vale (small blind) folded before Flop
Seat 5: yazvauazva (big blind) folded before Flop
Seat 7: P1nk7 folded before Flop (didn't bet)
Seat 8: DartmanD1 showed [As Ac] and lost with two pair, Aces and Threes
Seat 9: neris449 showed [4h 5h] and won (10966) with a flush, Nine high



PokerStars Hand #221330178828: Tournament #3067368972, $0.25+$0.24+$0.06 USD Hold'em No Limit - Level VI (40/80) - 2020/12/11 20:16:42 EET [2020/12/11 13:16:42 ET]
Table '3067368972 323' 9-max Seat #4 is the button
Seat 1: ronnieovkella (3916 in chips, $0.24 bounty) 
Seat 2: madmaddie92 (4392 in chips, $0.24 bounty) is sitting out
Seat 3: bezblefa (1340 in chips, $0.24 bounty) 
Seat 4: jcarlos.vale (14389 in chips, $0.36 bounty) 
Seat 5: yazvauazva (5842 in chips, $0.24 bounty) 
Seat 6: m1fed (4061 in chips, $0.24 bounty) 
Seat 7: P1nk7 (8977 in chips, $0.24 bounty) 
Seat 8: DartmanD1 (19000 in chips, $0.60 bounty) 
Seat 9: neris449 (10966 in chips, $0.36 bounty) 
ronnieovkella: posts the ante 12
madmaddie92: posts the ante 12
bezblefa: posts the ante 12
jcarlos.vale: posts the ante 12
yazvauazva: posts the ante 12
m1fed: posts the ante 12
P1nk7: posts the ante 12
DartmanD1: posts the ante 12
neris449: posts the ante 12
yazvauazva: posts small blind 40
m1fed: posts big blind 80
*** HOLE CARDS ***
Dealt to jcarlos.vale [As Ah]
P1nk7: folds 
DartmanD1: folds 
neris449: calls 80
ronnieovkella: folds 
madmaddie92: folds 
bezblefa: folds 
jcarlos.vale: raises 160 to 240
yazvauazva: folds 
m1fed: calls 160
neris449: calls 160
*** FLOP *** [Jc Kc Tc]
m1fed: checks 
neris449: checks 
jcarlos.vale: bets 651
m1fed: calls 651
neris449: folds 
*** TURN *** [Jc Kc Tc] [2d]
m1fed: checks 
jcarlos.vale: bets 1680
m1fed: calls 1680
*** RIVER *** [Jc Kc Tc 2d] [8h]
m1fed: checks 
jcarlos.vale: bets 4148
m1fed: calls 1478 and is all-in
Uncalled bet (2670) returned to jcarlos.vale
*** SHOW DOWN ***
jcarlos.vale: shows [As Ah] (a pair of Aces)
m1fed: shows [Ac Js] (a pair of Jacks)
jcarlos.vale collected 8486 from pot
jcarlos.vale wins $0.12 for eliminating m1fed and their own bounty increases by $0.12 to $0.48
m1fed finished the tournament
*** SUMMARY ***
Total pot 8486 | Rake 0 
Board [Jc Kc Tc 2d 8h]
Seat 1: ronnieovkella folded before Flop (didn't bet)
Seat 2: madmaddie92 folded before Flop (didn't bet)
Seat 3: bezblefa folded before Flop (didn't bet)
Seat 4: jcarlos.vale (button) showed [As Ah] and won (8486) with a pair of Aces
Seat 5: yazvauazva (small blind) folded before Flop
Seat 6: m1fed (big blind) showed [Ac Js] and lost with a pair of Jacks
Seat 7: P1nk7 folded before Flop (didn't bet)
Seat 8: DartmanD1 folded before Flop (didn't bet)
Seat 9: neris449 folded on the Flop



PokerStars Hand #221330217107: Tournament #3067368972, $0.25+$0.24+$0.06 USD Hold'em No Limit - Level VI (40/80) - 2020/12/11 20:17:46 EET [2020/12/11 13:17:46 ET]
Table '3067368972 323' 9-max Seat #5 is the button
Seat 1: ronnieovkella (3904 in chips, $0.24 bounty) 
Seat 2: madmaddie92 (4380 in chips, $0.24 bounty) is sitting out
Seat 3: bezblefa (1328 in chips, $0.24 bounty) 
Seat 4: jcarlos.vale (18814 in chips, $0.48 bounty) 
Seat 5: yazvauazva (5790 in chips, $0.24 bounty) 
Seat 7: P1nk7 (8965 in chips, $0.24 bounty) 
Seat 8: DartmanD1 (18988 in chips, $0.60 bounty) 
Seat 9: neris449 (10714 in chips, $0.36 bounty) 
ronnieovkella: posts the ante 12
madmaddie92: posts the ante 12
bezblefa: posts the ante 12
jcarlos.vale: posts the ante 12
yazvauazva: posts the ante 12
P1nk7: posts the ante 12
DartmanD1: posts the ante 12
neris449: posts the ante 12
P1nk7: posts small blind 40
DartmanD1: posts big blind 80
*** HOLE CARDS ***
Dealt to jcarlos.vale [Ks Kc]
neris449: calls 80
ronnieovkella: folds 
madmaddie92: folds 
bezblefa: folds 
jcarlos.vale: raises 160 to 240
yazvauazva: folds 
P1nk7: raises 480 to 720
DartmanD1: folds 
neris449: calls 640
jcarlos.vale: raises 2336 to 3056
P1nk7: raises 5897 to 8953 and is all-in
neris449: folds 
jcarlos.vale: calls 5897
*** FLOP *** [6d 7s Ad]
*** TURN *** [6d 7s Ad] [Kh]
*** RIVER *** [6d 7s Ad Kh] [Qh]
*** SHOW DOWN ***
P1nk7: shows [Qs Qc] (three of a kind, Queens)
jcarlos.vale: shows [Ks Kc] (three of a kind, Kings)
jcarlos.vale collected 18802 from pot
jcarlos.vale wins $0.12 for eliminating P1nk7 and their own bounty increases by $0.12 to $0.60
P1nk7 finished the tournament
*** SUMMARY ***
Total pot 18802 | Rake 0 
Board [6d 7s Ad Kh Qh]
Seat 1: ronnieovkella folded before Flop (didn't bet)
Seat 2: madmaddie92 folded before Flop (didn't bet)
Seat 3: bezblefa folded before Flop (didn't bet)
Seat 4: jcarlos.vale showed [Ks Kc] and won (18802) with three of a kind, Kings
Seat 5: yazvauazva (button) folded before Flop (didn't bet)
Seat 7: P1nk7 (small blind) showed [Qs Qc] and lost with three of a kind, Queens
Seat 8: DartmanD1 (big blind) folded before Flop
Seat 9: neris449 folded before Flop



PokerStars Hand #221330247468: Tournament #3067368972, $0.25+$0.24+$0.06 USD Hold'em No Limit - Level VI (40/80) - 2020/12/11 20:18:34 EET [2020/12/11 13:18:34 ET]
Table '3067368972 323' 9-max Seat #8 is the button
Seat 1: ronnieovkella (3892 in chips, $0.24 bounty) 
Seat 2: madmaddie92 (4368 in chips, $0.24 bounty) is sitting out
Seat 3: bezblefa (1316 in chips, $0.24 bounty) 
Seat 4: jcarlos.vale (28651 in chips, $0.60 bounty) 
Seat 5: yazvauazva (5778 in chips, $0.24 bounty) 
Seat 6: HarvesterX (2480 in chips, $0.24 bounty) 
Seat 8: DartmanD1 (18896 in chips, $0.60 bounty) 
Seat 9: neris449 (9982 in chips, $0.36 bounty) 
ronnieovkella: posts the ante 12
madmaddie92: posts the ante 12
bezblefa: posts the ante 12
jcarlos.vale: posts the ante 12
yazvauazva: posts the ante 12
HarvesterX: posts the ante 12
DartmanD1: posts the ante 12
neris449: posts the ante 12
neris449: posts small blind 40
ronnieovkella: posts big blind 80
*** HOLE CARDS ***
Dealt to jcarlos.vale [2c Th]
madmaddie92: folds 
bezblefa: folds 
jcarlos.vale: folds 
yazvauazva: folds 
HarvesterX: folds 
DartmanD1: folds 
neris449: calls 40
ronnieovkella: checks 
*** FLOP *** [3d 8h 4d]
neris449: checks 
ronnieovkella: checks 
*** TURN *** [3d 8h 4d] [2h]
neris449: checks 
ronnieovkella: checks 
*** RIVER *** [3d 8h 4d 2h] [Ac]
neris449: checks 
ronnieovkella: checks 
*** SHOW DOWN ***
neris449: shows [Kd 6d] (high pairOfCards Ace)
ronnieovkella: shows [9c Kh] (high pairOfCards Ace - King+Nine kicker)
ronnieovkella collected 256 from pot
*** SUMMARY ***
Total pot 256 | Rake 0 
Board [3d 8h 4d 2h Ac]
Seat 1: ronnieovkella (big blind) showed [9c Kh] and won (256) with high pairOfCards Ace
Seat 2: madmaddie92 folded before Flop (didn't bet)
Seat 3: bezblefa folded before Flop (didn't bet)
Seat 4: jcarlos.vale folded before Flop (didn't bet)
Seat 5: yazvauazva folded before Flop (didn't bet)
Seat 6: HarvesterX folded before Flop (didn't bet)
Seat 8: DartmanD1 (button) folded before Flop (didn't bet)
Seat 9: neris449 (small blind) showed [Kd 6d] and lost with high pairOfCards Ace



PokerStars Hand #221330269617: Tournament #3067368972, $0.25+$0.24+$0.06 USD Hold'em No Limit - Level VI (40/80) - 2020/12/11 20:19:10 EET [2020/12/11 13:19:10 ET]
Table '3067368972 323' 9-max Seat #9 is the button
Seat 1: ronnieovkella (4056 in chips, $0.24 bounty) 
Seat 2: madmaddie92 (4356 in chips, $0.24 bounty) is sitting out
Seat 3: bezblefa (1304 in chips, $0.24 bounty) 
Seat 4: jcarlos.vale (28639 in chips, $0.60 bounty) 
Seat 5: yazvauazva (5766 in chips, $0.24 bounty) 
Seat 6: HarvesterX (2468 in chips, $0.24 bounty) 
Seat 7: magatama16 (5000 in chips, $0.24 bounty) 
Seat 8: DartmanD1 (18884 in chips, $0.60 bounty) 
Seat 9: neris449 (9890 in chips, $0.36 bounty) 
ronnieovkella: posts the ante 12
madmaddie92: posts the ante 12
bezblefa: posts the ante 12
jcarlos.vale: posts the ante 12
yazvauazva: posts the ante 12
HarvesterX: posts the ante 12
magatama16: posts the ante 12
DartmanD1: posts the ante 12
neris449: posts the ante 12
ronnieovkella: posts small blind 40
madmaddie92: posts big blind 80
*** HOLE CARDS ***
Dealt to jcarlos.vale [9s 7s]
bezblefa: folds 
jcarlos.vale: folds 
yazvauazva: folds 
HarvesterX: folds 
magatama16: folds 
DartmanD1: folds 
neris449: calls 80
ronnieovkella: calls 40
madmaddie92: folds 
*** FLOP *** [4c 8d Jh]
ronnieovkella: checks 
neris449: checks 
*** TURN *** [4c 8d Jh] [7d]
ronnieovkella: checks 
neris449: checks 
*** RIVER *** [4c 8d Jh 7d] [3h]
ronnieovkella: checks 
neris449: checks 
*** SHOW DOWN ***
ronnieovkella: shows [4s 6s] (a pair of Fours)
neris449: shows [4h Qs] (a pair of Fours - Queen kicker)
neris449 collected 348 from pot
*** SUMMARY ***
Total pot 348 | Rake 0 
Board [4c 8d Jh 7d 3h]
Seat 1: ronnieovkella (small blind) showed [4s 6s] and lost with a pair of Fours
Seat 2: madmaddie92 (big blind) folded before Flop
Seat 3: bezblefa folded before Flop (didn't bet)
Seat 4: jcarlos.vale folded before Flop (didn't bet)
Seat 5: yazvauazva folded before Flop (didn't bet)
Seat 6: HarvesterX folded before Flop (didn't bet)
Seat 7: magatama16 folded before Flop (didn't bet)
Seat 8: DartmanD1 folded before Flop (didn't bet)
Seat 9: neris449 (button) showed [4h Qs] and won (348) with a pair of Fours



PokerStars Hand #221330296812: Tournament #3067368972, $0.25+$0.24+$0.06 USD Hold'em No Limit - Level VII (45/90) - 2020/12/11 20:19:56 EET [2020/12/11 13:19:56 ET]
Table '3067368972 323' 9-max Seat #1 is the button
Seat 1: ronnieovkella (3964 in chips, $0.24 bounty) 
Seat 2: madmaddie92 (4264 in chips, $0.24 bounty) is sitting out
Seat 3: bezblefa (1292 in chips, $0.24 bounty) 
Seat 4: jcarlos.vale (28627 in chips, $0.60 bounty) 
Seat 5: yazvauazva (5754 in chips, $0.24 bounty) 
Seat 6: HarvesterX (2456 in chips, $0.24 bounty) 
Seat 7: magatama16 (4988 in chips, $0.24 bounty) 
Seat 8: DartmanD1 (18872 in chips, $0.60 bounty) 
Seat 9: neris449 (10146 in chips, $0.36 bounty) 
ronnieovkella: posts the ante 14
madmaddie92: posts the ante 14
bezblefa: posts the ante 14
jcarlos.vale: posts the ante 14
yazvauazva: posts the ante 14
HarvesterX: posts the ante 14
magatama16: posts the ante 14
DartmanD1: posts the ante 14
neris449: posts the ante 14
madmaddie92: posts small blind 45
bezblefa: posts big blind 90
*** HOLE CARDS ***
Dealt to jcarlos.vale [Js 2c]
jcarlos.vale: folds 
yazvauazva: folds 
HarvesterX: folds 
magatama16: folds 
DartmanD1: folds 
neris449: calls 90
ronnieovkella: calls 90
madmaddie92: folds 
bezblefa: checks 
*** FLOP *** [8h Qd 3c]
bezblefa: checks 
neris449: checks 
ronnieovkella: checks 
*** TURN *** [8h Qd 3c] [Ah]
bezblefa: checks 
neris449: checks 
ronnieovkella: bets 90
bezblefa: calls 90
neris449: calls 90
*** RIVER *** [8h Qd 3c Ah] [5c]
bezblefa: bets 498
neris449: raises 498 to 996
ronnieovkella: calls 996
bezblefa: calls 498
*** SHOW DOWN ***
neris449: shows [Qs 5h] (two pair, Queens and Fives)
ronnieovkella: mucks handDTO
bezblefa: mucks handDTO
neris449 collected 3699 from pot
*** SUMMARY ***
Total pot 3699 | Rake 0 
Board [8h Qd 3c Ah 5c]
Seat 1: ronnieovkella (button) mucked [Ts As]
Seat 2: madmaddie92 (small blind) folded before Flop
Seat 3: bezblefa (big blind) mucked [8c 5d]
Seat 4: jcarlos.vale folded before Flop (didn't bet)
Seat 5: yazvauazva folded before Flop (didn't bet)
Seat 6: HarvesterX folded before Flop (didn't bet)
Seat 7: magatama16 folded before Flop (didn't bet)
Seat 8: DartmanD1 folded before Flop (didn't bet)
Seat 9: neris449 showed [Qs 5h] and won (3699) with two pair, Queens and Fives



PokerStars Hand #221330348361: Tournament #3067368972, $0.25+$0.24+$0.06 USD Hold'em No Limit - Level VII (45/90) - 2020/12/11 20:21:22 EET [2020/12/11 13:21:22 ET]
Table '3067368972 323' 9-max Seat #2 is the button
Seat 1: ronnieovkella (2774 in chips, $0.24 bounty) 
Seat 2: madmaddie92 (4205 in chips, $0.24 bounty) is sitting out
Seat 3: bezblefa (102 in chips, $0.24 bounty) 
Seat 4: jcarlos.vale (28613 in chips, $0.60 bounty) 
Seat 5: yazvauazva (5740 in chips, $0.24 bounty) 
Seat 6: HarvesterX (2442 in chips, $0.24 bounty) 
Seat 7: magatama16 (4974 in chips, $0.24 bounty) 
Seat 8: DartmanD1 (18858 in chips, $0.60 bounty) 
Seat 9: neris449 (12655 in chips, $0.36 bounty) 
ronnieovkella: posts the ante 14
madmaddie92: posts the ante 14
bezblefa: posts the ante 14
jcarlos.vale: posts the ante 14
yazvauazva: posts the ante 14
HarvesterX: posts the ante 14
magatama16: posts the ante 14
DartmanD1: posts the ante 14
neris449: posts the ante 14
bezblefa: posts small blind 45
jcarlos.vale: posts big blind 90
*** HOLE CARDS ***
Dealt to jcarlos.vale [5c 7d]
yazvauazva: folds 
HarvesterX: folds 
magatama16: raises 180 to 270
DartmanD1: calls 270
neris449: folds 
ronnieovkella: folds 
madmaddie92: folds 
bezblefa: calls 43 and is all-in
jcarlos.vale: folds 
*** FLOP *** [2s 4h Qs]
magatama16: bets 400
DartmanD1: raises 658 to 1058
magatama16: folds 
Uncalled bet (658) returned to DartmanD1
*** TURN *** [2s 4h Qs] [Jd]
*** RIVER *** [2s 4h Qs Jd] [As]
*** SHOW DOWN ***
DartmanD1: shows [Qd Td] (a pair of Queens)
DartmanD1 collected 1166 from side pot
bezblefa: shows [3d 5s] (a straight, Ace to Five)
bezblefa collected 478 from main pot
*** SUMMARY ***
Total pot 1644 Main pot 478. Side pot 1166. | Rake 0 
Board [2s 4h Qs Jd As]
Seat 1: ronnieovkella folded before Flop (didn't bet)
Seat 2: madmaddie92 (button) folded before Flop (didn't bet)
Seat 3: bezblefa (small blind) showed [3d 5s] and won (478) with a straight, Ace to Five
Seat 4: jcarlos.vale (big blind) folded before Flop
Seat 5: yazvauazva folded before Flop (didn't bet)
Seat 6: HarvesterX folded before Flop (didn't bet)
Seat 7: magatama16 folded on the Flop
Seat 8: DartmanD1 showed [Qd Td] and won (1166) with a pair of Queens
Seat 9: neris449 folded before Flop (didn't bet)



PokerStars Hand #221330395548: Tournament #3067368972, $0.25+$0.24+$0.06 USD Hold'em No Limit - Level VII (45/90) - 2020/12/11 20:22:41 EET [2020/12/11 13:22:41 ET]
Table '3067368972 323' 9-max Seat #3 is the button
Seat 1: ronnieovkella (2760 in chips, $0.24 bounty) 
Seat 2: madmaddie92 (4191 in chips, $0.24 bounty) is sitting out
Seat 3: bezblefa (478 in chips, $0.24 bounty) 
Seat 4: jcarlos.vale (28509 in chips, $0.60 bounty) 
Seat 5: yazvauazva (5726 in chips, $0.24 bounty) 
Seat 6: HarvesterX (2428 in chips, $0.24 bounty) 
Seat 7: magatama16 (4290 in chips, $0.24 bounty) 
Seat 8: DartmanD1 (19340 in chips, $0.60 bounty) 
Seat 9: neris449 (12641 in chips, $0.36 bounty) 
ronnieovkella: posts the ante 14
madmaddie92: posts the ante 14
bezblefa: posts the ante 14
jcarlos.vale: posts the ante 14
yazvauazva: posts the ante 14
HarvesterX: posts the ante 14
magatama16: posts the ante 14
DartmanD1: posts the ante 14
neris449: posts the ante 14
jcarlos.vale: posts small blind 45
yazvauazva: posts big blind 90
*** HOLE CARDS ***
Dealt to jcarlos.vale [6d 8d]
HarvesterX: folds 
magatama16: folds 
DartmanD1: folds 
neris449: calls 90
ronnieovkella: folds 
madmaddie92: folds 
bezblefa: folds 
jcarlos.vale: calls 45
yazvauazva: checks 
*** FLOP *** [Qh 3d Ts]
jcarlos.vale: checks 
yazvauazva: checks 
neris449: checks 
*** TURN *** [Qh 3d Ts] [Jc]
jcarlos.vale: checks 
yazvauazva: checks 
neris449: checks 
*** RIVER *** [Qh 3d Ts Jc] [4h]
jcarlos.vale: checks 
yazvauazva: bets 198
neris449: folds 
jcarlos.vale: folds 
Uncalled bet (198) returned to yazvauazva
yazvauazva collected 396 from pot
*** SUMMARY ***
Total pot 396 | Rake 0 
Board [Qh 3d Ts Jc 4h]
Seat 1: ronnieovkella folded before Flop (didn't bet)
Seat 2: madmaddie92 folded before Flop (didn't bet)
Seat 3: bezblefa (button) folded before Flop (didn't bet)
Seat 4: jcarlos.vale (small blind) folded on the River
Seat 5: yazvauazva (big blind) collected (396)
Seat 6: HarvesterX folded before Flop (didn't bet)
Seat 7: magatama16 folded before Flop (didn't bet)
Seat 8: DartmanD1 folded before Flop (didn't bet)
Seat 9: neris449 folded on the River



PokerStars Hand #221330448368: Tournament #3067368972, $0.25+$0.24+$0.06 USD Hold'em No Limit - Level VII (45/90) - 2020/12/11 20:24:09 EET [2020/12/11 13:24:09 ET]
Table '3067368972 323' 9-max Seat #4 is the button
Seat 1: ronnieovkella (2746 in chips, $0.24 bounty) 
Seat 2: madmaddie92 (4177 in chips, $0.24 bounty) is sitting out
Seat 3: bezblefa (464 in chips, $0.24 bounty) 
Seat 4: jcarlos.vale (28405 in chips, $0.60 bounty) 
Seat 5: yazvauazva (6018 in chips, $0.24 bounty) 
Seat 6: HarvesterX (2414 in chips, $0.24 bounty) 
Seat 7: magatama16 (4276 in chips, $0.24 bounty) 
Seat 8: DartmanD1 (19326 in chips, $0.60 bounty) 
Seat 9: neris449 (12537 in chips, $0.36 bounty) 
ronnieovkella: posts the ante 14
madmaddie92: posts the ante 14
bezblefa: posts the ante 14
jcarlos.vale: posts the ante 14
yazvauazva: posts the ante 14
HarvesterX: posts the ante 14
magatama16: posts the ante 14
DartmanD1: posts the ante 14
neris449: posts the ante 14
yazvauazva: posts small blind 45
HarvesterX: posts big blind 90
*** HOLE CARDS ***
Dealt to jcarlos.vale [4d 2h]
magatama16: folds 
DartmanD1: folds 
neris449: calls 90
ronnieovkella: folds 
madmaddie92: folds 
bezblefa: raises 360 to 450 and is all-in
jcarlos.vale: folds 
yazvauazva: folds 
HarvesterX: folds 
neris449: calls 360
*** FLOP *** [9d 2s As]
*** TURN *** [9d 2s As] [5c]
*** RIVER *** [9d 2s As 5c] [Kh]
*** SHOW DOWN ***
neris449: shows [3s 7h] (high pairOfCards Ace)
bezblefa: shows [7d 8c] (high pairOfCards Ace - King+Nine+Eight kicker)
bezblefa collected 1161 from pot
*** SUMMARY ***
Total pot 1161 | Rake 0 
Board [9d 2s As 5c Kh]
Seat 1: ronnieovkella folded before Flop (didn't bet)
Seat 2: madmaddie92 folded before Flop (didn't bet)
Seat 3: bezblefa showed [7d 8c] and won (1161) with high pairOfCards Ace
Seat 4: jcarlos.vale (button) folded before Flop (didn't bet)
Seat 5: yazvauazva (small blind) folded before Flop
Seat 6: HarvesterX (big blind) folded before Flop
Seat 7: magatama16 folded before Flop (didn't bet)
Seat 8: DartmanD1 folded before Flop (didn't bet)
Seat 9: neris449 showed [3s 7h] and lost with high pairOfCards Ace



PokerStars Hand #221330466542: Tournament #3067368972, $0.25+$0.24+$0.06 USD Hold'em No Limit - Level VII (45/90) - 2020/12/11 20:24:39 EET [2020/12/11 13:24:39 ET]
Table '3067368972 323' 9-max Seat #5 is the button
Seat 1: ronnieovkella (2732 in chips, $0.24 bounty) 
Seat 2: madmaddie92 (4163 in chips, $0.24 bounty) is sitting out
Seat 3: bezblefa (1161 in chips, $0.24 bounty) 
Seat 4: jcarlos.vale (28391 in chips, $0.60 bounty) 
Seat 5: yazvauazva (5959 in chips, $0.24 bounty) 
Seat 6: HarvesterX (2310 in chips, $0.24 bounty) 
Seat 7: magatama16 (4262 in chips, $0.24 bounty) 
Seat 8: DartmanD1 (19312 in chips, $0.60 bounty) 
Seat 9: neris449 (12073 in chips, $0.36 bounty) 
ronnieovkella: posts the ante 14
madmaddie92: posts the ante 14
bezblefa: posts the ante 14
jcarlos.vale: posts the ante 14
yazvauazva: posts the ante 14
HarvesterX: posts the ante 14
magatama16: posts the ante 14
DartmanD1: posts the ante 14
neris449: posts the ante 14
HarvesterX: posts small blind 45
magatama16: posts big blind 90
*** HOLE CARDS ***
Dealt to jcarlos.vale [6d 9c]
DartmanD1: folds 
neris449: calls 90
ronnieovkella: raises 2628 to 2718 and is all-in
madmaddie92: folds 
bezblefa: folds 
jcarlos.vale: folds 
yazvauazva: folds 
HarvesterX: folds 
magatama16: folds 
neris449: calls 2628
*** FLOP *** [Kd 9h 5s]
*** TURN *** [Kd 9h 5s] [8h]
*** RIVER *** [Kd 9h 5s 8h] [6s]
*** SHOW DOWN ***
neris449: shows [9s Js] (a pair of Nines)
ronnieovkella: shows [Ah 3s] (high pairOfCards Ace)
neris449 collected 5697 from pot
neris449 wins $0.12 for eliminating ronnieovkella and their own bounty increases by $0.12 to $0.48
ronnieovkella finished the tournament
*** SUMMARY ***
Total pot 5697 | Rake 0 
Board [Kd 9h 5s 8h 6s]
Seat 1: ronnieovkella showed [Ah 3s] and lost with high pairOfCards Ace
Seat 2: madmaddie92 folded before Flop (didn't bet)
Seat 3: bezblefa folded before Flop (didn't bet)
Seat 4: jcarlos.vale folded before Flop (didn't bet)
Seat 5: yazvauazva (button) folded before Flop (didn't bet)
Seat 6: HarvesterX (small blind) folded before Flop
Seat 7: magatama16 (big blind) folded before Flop
Seat 8: DartmanD1 folded before Flop (didn't bet)
Seat 9: neris449 showed [9s Js] and won (5697) with a pair of Nines



PokerStars Hand #221330491938: Tournament #3067368972, $0.25+$0.24+$0.06 USD Hold'em No Limit - Level VII (45/90) - 2020/12/11 20:25:09 EET [2020/12/11 13:25:09 ET]
Table '3067368972 323' 9-max Seat #6 is the button
Seat 2: madmaddie92 (4149 in chips, $0.24 bounty) is sitting out
Seat 3: bezblefa (1147 in chips, $0.24 bounty) 
Seat 4: jcarlos.vale (28377 in chips, $0.60 bounty) 
Seat 5: yazvauazva (5945 in chips, $0.24 bounty) 
Seat 6: HarvesterX (2251 in chips, $0.24 bounty) 
Seat 7: magatama16 (4158 in chips, $0.24 bounty) 
Seat 8: DartmanD1 (19298 in chips, $0.60 bounty) 
Seat 9: neris449 (15038 in chips, $0.48 bounty) 
madmaddie92: posts the ante 14
bezblefa: posts the ante 14
jcarlos.vale: posts the ante 14
yazvauazva: posts the ante 14
HarvesterX: posts the ante 14
magatama16: posts the ante 14
DartmanD1: posts the ante 14
neris449: posts the ante 14
magatama16: posts small blind 45
DartmanD1: posts big blind 90
*** HOLE CARDS ***
Dealt to jcarlos.vale [Jd Ac]
neris449: calls 90
madmaddie92: folds 
bezblefa: folds 
jcarlos.vale: raises 144 to 234
yazvauazva: folds 
HarvesterX: folds 
magatama16: folds 
DartmanD1: folds 
neris449: calls 144
*** FLOP *** [Qd 7h 3c]
neris449: bets 358
jcarlos.vale: folds 
Uncalled bet (358) returned to neris449
neris449 collected 715 from pot
neris449: doesn't show handDTO
*** SUMMARY ***
Total pot 715 | Rake 0 
Board [Qd 7h 3c]
Seat 2: madmaddie92 folded before Flop (didn't bet)
Seat 3: bezblefa folded before Flop (didn't bet)
Seat 4: jcarlos.vale folded on the Flop
Seat 5: yazvauazva folded before Flop (didn't bet)
Seat 6: HarvesterX (button) folded before Flop (didn't bet)
Seat 7: magatama16 (small blind) folded before Flop
Seat 8: DartmanD1 (big blind) folded before Flop
Seat 9: neris449 collected (715)



PokerStars Hand #221330528496: Tournament #3067368972, $0.25+$0.24+$0.06 USD Hold'em No Limit - Level VII (45/90) - 2020/12/11 20:26:09 EET [2020/12/11 13:26:09 ET]
Table '3067368972 323' 9-max Seat #7 is the button
Seat 1: foxyvanj (5000 in chips, $0.24 bounty) 
Seat 2: madmaddie92 (4135 in chips, $0.24 bounty) is sitting out
Seat 3: bezblefa (1133 in chips, $0.24 bounty) 
Seat 4: jcarlos.vale (28129 in chips, $0.60 bounty) 
Seat 5: yazvauazva (5931 in chips, $0.24 bounty) 
Seat 6: HarvesterX (2237 in chips, $0.24 bounty) 
Seat 7: magatama16 (4099 in chips, $0.24 bounty) 
Seat 8: DartmanD1 (19194 in chips, $0.60 bounty) 
Seat 9: neris449 (15505 in chips, $0.48 bounty) 
foxyvanj: posts the ante 14
madmaddie92: posts the ante 14
bezblefa: posts the ante 14
jcarlos.vale: posts the ante 14
yazvauazva: posts the ante 14
HarvesterX: posts the ante 14
magatama16: posts the ante 14
DartmanD1: posts the ante 14
neris449: posts the ante 14
DartmanD1: posts small blind 45
neris449: posts big blind 90
*** HOLE CARDS ***
Dealt to jcarlos.vale [Ts Kd]
foxyvanj: folds 
madmaddie92: folds 
bezblefa: folds 
jcarlos.vale: folds 
yazvauazva: folds 
HarvesterX: folds 
magatama16: raises 180 to 270
DartmanD1: folds 
neris449: calls 180
*** FLOP *** [3c 5s Jc]
neris449: checks 
magatama16: bets 250
neris449: folds 
Uncalled bet (250) returned to magatama16
magatama16 collected 711 from pot
magatama16: doesn't show handDTO
*** SUMMARY ***
Total pot 711 | Rake 0 
Board [3c 5s Jc]
Seat 1: foxyvanj folded before Flop (didn't bet)
Seat 2: madmaddie92 folded before Flop (didn't bet)
Seat 3: bezblefa folded before Flop (didn't bet)
Seat 4: jcarlos.vale folded before Flop (didn't bet)
Seat 5: yazvauazva folded before Flop (didn't bet)
Seat 6: HarvesterX folded before Flop (didn't bet)
Seat 7: magatama16 (button) collected (711)
Seat 8: DartmanD1 (small blind) folded before Flop
Seat 9: neris449 (big blind) folded on the Flop



PokerStars Hand #221330561005: Tournament #3067368972, $0.25+$0.24+$0.06 USD Hold'em No Limit - Level VIII (50/100) - 2020/12/11 20:27:03 EET [2020/12/11 13:27:03 ET]
Table '3067368972 323' 9-max Seat #8 is the button
Seat 1: foxyvanj (4986 in chips, $0.24 bounty) 
Seat 2: madmaddie92 (4121 in chips, $0.24 bounty) is sitting out
Seat 3: bezblefa (1119 in chips, $0.24 bounty) 
Seat 4: jcarlos.vale (28115 in chips, $0.60 bounty) 
Seat 5: yazvauazva (5917 in chips, $0.24 bounty) 
Seat 6: HarvesterX (2223 in chips, $0.24 bounty) 
Seat 7: magatama16 (4526 in chips, $0.24 bounty) 
Seat 8: DartmanD1 (19135 in chips, $0.60 bounty) 
Seat 9: neris449 (15221 in chips, $0.48 bounty) 
foxyvanj: posts the ante 15
madmaddie92: posts the ante 15
bezblefa: posts the ante 15
jcarlos.vale: posts the ante 15
yazvauazva: posts the ante 15
HarvesterX: posts the ante 15
magatama16: posts the ante 15
DartmanD1: posts the ante 15
neris449: posts the ante 15
neris449: posts small blind 50
foxyvanj: posts big blind 100
*** HOLE CARDS ***
Dealt to jcarlos.vale [Jd 9d]
madmaddie92: folds 
bezblefa: folds 
jcarlos.vale: folds 
yazvauazva: folds 
HarvesterX has timed out
HarvesterX: folds 
HarvesterX is sitting out
magatama16: raises 200 to 300
DartmanD1: calls 300
neris449: calls 250
foxyvanj: calls 200
*** FLOP *** [9s 7h 7d]
neris449: checks 
foxyvanj: bets 700
magatama16: calls 700
DartmanD1: folds 
neris449: calls 700
*** TURN *** [9s 7h 7d] [6s]
neris449: checks 
foxyvanj: bets 3971 and is all-in
magatama16: folds 
neris449: folds 
Uncalled bet (3971) returned to foxyvanj
foxyvanj collected 3435 from pot
foxyvanj: doesn't show handDTO
*** SUMMARY ***
Total pot 3435 | Rake 0 
Board [9s 7h 7d 6s]
Seat 1: foxyvanj (big blind) collected (3435)
Seat 2: madmaddie92 folded before Flop (didn't bet)
Seat 3: bezblefa folded before Flop (didn't bet)
Seat 4: jcarlos.vale folded before Flop (didn't bet)
Seat 5: yazvauazva folded before Flop (didn't bet)
Seat 6: HarvesterX folded before Flop (didn't bet)
Seat 7: magatama16 folded on the Turn
Seat 8: DartmanD1 (button) folded on the Flop
Seat 9: neris449 (small blind) folded on the Turn



PokerStars Hand #221330602671: Tournament #3067368972, $0.25+$0.24+$0.06 USD Hold'em No Limit - Level VIII (50/100) - 2020/12/11 20:28:12 EET [2020/12/11 13:28:12 ET]
Table '3067368972 323' 9-max Seat #9 is the button
Seat 1: foxyvanj (7406 in chips, $0.24 bounty) 
Seat 2: madmaddie92 (4106 in chips, $0.24 bounty) is sitting out
Seat 3: bezblefa (1104 in chips, $0.24 bounty) 
Seat 4: jcarlos.vale (28100 in chips, $0.60 bounty) 
Seat 5: yazvauazva (5902 in chips, $0.24 bounty) 
Seat 6: HarvesterX (2208 in chips, $0.24 bounty) is sitting out
Seat 7: magatama16 (3511 in chips, $0.24 bounty) 
Seat 8: DartmanD1 (18820 in chips, $0.60 bounty) 
Seat 9: neris449 (14206 in chips, $0.48 bounty) 
foxyvanj: posts the ante 15
madmaddie92: posts the ante 15
bezblefa: posts the ante 15
jcarlos.vale: posts the ante 15
yazvauazva: posts the ante 15
HarvesterX: posts the ante 15
magatama16: posts the ante 15
DartmanD1: posts the ante 15
neris449: posts the ante 15
foxyvanj: posts small blind 50
madmaddie92: posts big blind 100
*** HOLE CARDS ***
Dealt to jcarlos.vale [Kh 8s]
bezblefa: raises 989 to 1089 and is all-in
jcarlos.vale: folds 
yazvauazva: folds 
HarvesterX: folds 
magatama16: folds 
DartmanD1: folds 
neris449: calls 1089
foxyvanj: calls 1039
madmaddie92: folds 
*** FLOP *** [Kc 7s Qc]
foxyvanj: checks 
neris449: checks 
*** TURN *** [Kc 7s Qc] [8c]
foxyvanj: bets 1751
neris449: folds 
Uncalled bet (1751) returned to foxyvanj
*** RIVER *** [Kc 7s Qc 8c] [6h]
*** SHOW DOWN ***
foxyvanj: shows [Td Qs] (a pair of Queens)
bezblefa: shows [Ah Tc] (high pairOfCards Ace)
foxyvanj collected 3502 from pot
foxyvanj wins $0.12 for eliminating bezblefa and their own bounty increases by $0.12 to $0.36
bezblefa finished the tournament
*** SUMMARY ***
Total pot 3502 | Rake 0 
Board [Kc 7s Qc 8c 6h]
Seat 1: foxyvanj (small blind) showed [Td Qs] and won (3502) with a pair of Queens
Seat 2: madmaddie92 (big blind) folded before Flop
Seat 3: bezblefa showed [Ah Tc] and lost with high pairOfCards Ace
Seat 4: jcarlos.vale folded before Flop (didn't bet)
Seat 5: yazvauazva folded before Flop (didn't bet)
Seat 6: HarvesterX folded before Flop (didn't bet)
Seat 7: magatama16 folded before Flop (didn't bet)
Seat 8: DartmanD1 folded before Flop (didn't bet)
Seat 9: neris449 (button) folded on the Turn



PokerStars Hand #221330627577: Tournament #3067368972, $0.25+$0.24+$0.06 USD Hold'em No Limit - Level VIII (50/100) - 2020/12/11 20:28:54 EET [2020/12/11 13:28:54 ET]
Table '3067368972 323' 9-max Seat #1 is the button
Seat 1: foxyvanj (9804 in chips, $0.36 bounty) 
Seat 2: madmaddie92 (3991 in chips, $0.24 bounty) is sitting out
Seat 4: jcarlos.vale (28085 in chips, $0.60 bounty) 
Seat 5: yazvauazva (5887 in chips, $0.24 bounty) 
Seat 6: HarvesterX (2193 in chips, $0.24 bounty) is sitting out
Seat 7: magatama16 (3496 in chips, $0.24 bounty) 
Seat 8: DartmanD1 (18805 in chips, $0.60 bounty) 
Seat 9: neris449 (13102 in chips, $0.48 bounty) 
foxyvanj: posts the ante 15
madmaddie92: posts the ante 15
jcarlos.vale: posts the ante 15
yazvauazva: posts the ante 15
HarvesterX: posts the ante 15
magatama16: posts the ante 15
DartmanD1: posts the ante 15
neris449: posts the ante 15
madmaddie92: posts small blind 50
jcarlos.vale: posts big blind 100
*** HOLE CARDS ***
Dealt to jcarlos.vale [2d Ks]
yazvauazva: folds 
HarvesterX: folds 
magatama16: folds 
DartmanD1: raises 150 to 250
neris449: calls 250
foxyvanj: folds 
madmaddie92: folds 
jcarlos.vale: folds 
*** FLOP *** [4d 9c 4s]
DartmanD1: bets 308
neris449: calls 308
*** TURN *** [4d 9c 4s] [Tc]
DartmanD1: bets 1040
neris449: folds 
Uncalled bet (1040) returned to DartmanD1
DartmanD1 collected 1386 from pot
*** SUMMARY ***
Total pot 1386 | Rake 0 
Board [4d 9c 4s Tc]
Seat 1: foxyvanj (button) folded before Flop (didn't bet)
Seat 2: madmaddie92 (small blind) folded before Flop
Seat 4: jcarlos.vale (big blind) folded before Flop
Seat 5: yazvauazva folded before Flop (didn't bet)
Seat 6: HarvesterX folded before Flop (didn't bet)
Seat 7: magatama16 folded before Flop (didn't bet)
Seat 8: DartmanD1 collected (1386)
Seat 9: neris449 folded on the Turn



PokerStars Hand #221330657844: Tournament #3067368972, $0.25+$0.24+$0.06 USD Hold'em No Limit - Level VIII (50/100) - 2020/12/11 20:29:44 EET [2020/12/11 13:29:44 ET]
Table '3067368972 323' 9-max Seat #2 is the button
Seat 1: foxyvanj (9789 in chips, $0.36 bounty) 
Seat 2: madmaddie92 (3926 in chips, $0.24 bounty) is sitting out
Seat 3: Nukalex (5000 in chips) out of handDTO (moved from another table into small blind)
Seat 4: jcarlos.vale (27970 in chips, $0.60 bounty) 
Seat 5: yazvauazva (5872 in chips, $0.24 bounty) 
Seat 6: HarvesterX (2178 in chips, $0.24 bounty) is sitting out
Seat 7: magatama16 (3481 in chips, $0.24 bounty) 
Seat 8: DartmanD1 (19618 in chips, $0.60 bounty) 
Seat 9: neris449 (12529 in chips, $0.48 bounty) 
Nukalex will be allowed to play after the button
foxyvanj: posts the ante 15
madmaddie92: posts the ante 15
jcarlos.vale: posts the ante 15
yazvauazva: posts the ante 15
HarvesterX: posts the ante 15
magatama16: posts the ante 15
DartmanD1: posts the ante 15
neris449: posts the ante 15
jcarlos.vale: posts small blind 50
yazvauazva: posts big blind 100
*** HOLE CARDS ***
Dealt to jcarlos.vale [4s Ah]
HarvesterX: folds 
magatama16: folds 
DartmanD1: folds 
neris449: calls 100
foxyvanj: calls 100
madmaddie92: folds 
jcarlos.vale: calls 50
yazvauazva: checks 
*** FLOP *** [Ts 2s 7d]
jcarlos.vale: checks 
yazvauazva: checks 
neris449: checks 
foxyvanj: checks 
*** TURN *** [Ts 2s 7d] [5d]
jcarlos.vale: checks 
yazvauazva: checks 
neris449: checks 
foxyvanj: checks 
*** RIVER *** [Ts 2s 7d 5d] [Ac]
jcarlos.vale: bets 200
yazvauazva: folds 
neris449: folds 
foxyvanj: folds 
Uncalled bet (200) returned to jcarlos.vale
jcarlos.vale collected 520 from pot
jcarlos.vale: doesn't show handDTO
*** SUMMARY ***
Total pot 520 | Rake 0 
Board [Ts 2s 7d 5d Ac]
Seat 1: foxyvanj folded on the River
Seat 2: madmaddie92 (button) folded before Flop (didn't bet)
Seat 4: jcarlos.vale (small blind) collected (520)
Seat 5: yazvauazva (big blind) folded on the River
Seat 6: HarvesterX folded before Flop (didn't bet)
Seat 7: magatama16 folded before Flop (didn't bet)
Seat 8: DartmanD1 folded before Flop (didn't bet)
Seat 9: neris449 folded on the River



PokerStars Hand #221330706469: Tournament #3067368972, $0.25+$0.24+$0.06 USD Hold'em No Limit - Level VIII (50/100) - 2020/12/11 20:31:03 EET [2020/12/11 13:31:03 ET]
Table '3067368972 323' 9-max Seat #4 is the button
Seat 1: foxyvanj (9674 in chips, $0.36 bounty) 
Seat 2: madmaddie92 (3911 in chips, $0.24 bounty) is sitting out
Seat 3: Nukalex (5000 in chips, $0.24 bounty) 
Seat 4: jcarlos.vale (28375 in chips, $0.60 bounty) 
Seat 5: yazvauazva (5757 in chips, $0.24 bounty) 
Seat 6: HarvesterX (2163 in chips, $0.24 bounty) is sitting out
Seat 7: magatama16 (3466 in chips, $0.24 bounty) 
Seat 8: DartmanD1 (19603 in chips, $0.60 bounty) 
Seat 9: neris449 (12414 in chips, $0.48 bounty) 
foxyvanj: posts the ante 15
madmaddie92: posts the ante 15
Nukalex: posts the ante 15
jcarlos.vale: posts the ante 15
yazvauazva: posts the ante 15
HarvesterX: posts the ante 15
magatama16: posts the ante 15
DartmanD1: posts the ante 15
neris449: posts the ante 15
yazvauazva: posts small blind 50
HarvesterX: posts big blind 100
*** HOLE CARDS ***
Dealt to jcarlos.vale [6s Jh]
magatama16: raises 300 to 400
DartmanD1: folds 
neris449 has timed out
neris449: folds 
neris449 is sitting out
foxyvanj: folds 
madmaddie92: folds 
Nukalex: folds 
jcarlos.vale: folds 
yazvauazva: folds 
HarvesterX: folds 
Uncalled bet (300) returned to magatama16
magatama16 collected 385 from pot
magatama16: doesn't show handDTO
*** SUMMARY ***
Total pot 385 | Rake 0 
Seat 1: foxyvanj folded before Flop (didn't bet)
Seat 2: madmaddie92 folded before Flop (didn't bet)
Seat 3: Nukalex folded before Flop (didn't bet)
Seat 4: jcarlos.vale (button) folded before Flop (didn't bet)
Seat 5: yazvauazva (small blind) folded before Flop
Seat 6: HarvesterX (big blind) folded before Flop
Seat 7: magatama16 collected (385)
Seat 8: DartmanD1 folded before Flop (didn't bet)
Seat 9: neris449 folded before Flop (didn't bet)



PokerStars Hand #221330757366: Tournament #3067368972, $0.25+$0.24+$0.06 USD Hold'em No Limit - Level VIII (50/100) - 2020/12/11 20:32:24 EET [2020/12/11 13:32:24 ET]
Table '3067368972 323' 9-max Seat #5 is the button
Seat 1: foxyvanj (9659 in chips, $0.36 bounty) 
Seat 2: madmaddie92 (3896 in chips, $0.24 bounty) is sitting out
Seat 3: Nukalex (4985 in chips, $0.24 bounty) 
Seat 4: jcarlos.vale (28360 in chips, $0.60 bounty) 
Seat 5: yazvauazva (5692 in chips, $0.24 bounty) 
Seat 6: HarvesterX (2048 in chips, $0.24 bounty) is sitting out
Seat 7: magatama16 (3736 in chips, $0.24 bounty) 
Seat 8: DartmanD1 (19588 in chips, $0.60 bounty) 
Seat 9: neris449 (12399 in chips, $0.48 bounty) is sitting out
foxyvanj: posts the ante 15
madmaddie92: posts the ante 15
Nukalex: posts the ante 15
jcarlos.vale: posts the ante 15
yazvauazva: posts the ante 15
HarvesterX: posts the ante 15
magatama16: posts the ante 15
DartmanD1: posts the ante 15
neris449: posts the ante 15
HarvesterX: posts small blind 50
magatama16: posts big blind 100
*** HOLE CARDS ***
Dealt to jcarlos.vale [3h 4s]
DartmanD1: folds 
neris449: folds 
foxyvanj: folds 
madmaddie92: folds 
Nukalex: folds 
jcarlos.vale: folds 
yazvauazva: folds 
HarvesterX: folds 
Uncalled bet (50) returned to magatama16
magatama16 collected 235 from pot
magatama16: doesn't show handDTO
*** SUMMARY ***
Total pot 235 | Rake 0 
Seat 1: foxyvanj folded before Flop (didn't bet)
Seat 2: madmaddie92 folded before Flop (didn't bet)
Seat 3: Nukalex folded before Flop (didn't bet)
Seat 4: jcarlos.vale folded before Flop (didn't bet)
Seat 5: yazvauazva (button) folded before Flop (didn't bet)
Seat 6: HarvesterX (small blind) folded before Flop
Seat 7: magatama16 (big blind) collected (235)
Seat 8: DartmanD1 folded before Flop (didn't bet)
Seat 9: neris449 folded before Flop (didn't bet)



PokerStars Hand #221330769540: Tournament #3067368972, $0.25+$0.24+$0.06 USD Hold'em No Limit - Level VIII (50/100) - 2020/12/11 20:32:44 EET [2020/12/11 13:32:44 ET]
Table '3067368972 323' 9-max Seat #6 is the button
Seat 1: foxyvanj (9644 in chips, $0.36 bounty) 
Seat 2: madmaddie92 (3881 in chips, $0.24 bounty) is sitting out
Seat 3: Nukalex (4970 in chips, $0.24 bounty) 
Seat 4: jcarlos.vale (28345 in chips, $0.60 bounty) 
Seat 5: yazvauazva (5677 in chips, $0.24 bounty) 
Seat 6: HarvesterX (1983 in chips, $0.24 bounty) is sitting out
Seat 7: magatama16 (3906 in chips, $0.24 bounty) 
Seat 8: DartmanD1 (19573 in chips, $0.60 bounty) 
Seat 9: neris449 (12384 in chips, $0.48 bounty) is sitting out
foxyvanj: posts the ante 15
madmaddie92: posts the ante 15
Nukalex: posts the ante 15
jcarlos.vale: posts the ante 15
yazvauazva: posts the ante 15
HarvesterX: posts the ante 15
magatama16: posts the ante 15
DartmanD1: posts the ante 15
neris449: posts the ante 15
magatama16: posts small blind 50
DartmanD1: posts big blind 100
*** HOLE CARDS ***
Dealt to jcarlos.vale [Ts 2s]
neris449: folds 
foxyvanj: raises 200 to 300
madmaddie92: folds 
Nukalex: folds 
jcarlos.vale: folds 
yazvauazva: folds 
HarvesterX: folds 
magatama16: folds 
DartmanD1: calls 200
*** FLOP *** [Jh 4c Tc]
DartmanD1: checks 
foxyvanj: checks 
*** TURN *** [Jh 4c Tc] [9d]
DartmanD1: bets 100
foxyvanj: calls 100
*** RIVER *** [Jh 4c Tc 9d] [Jd]
DartmanD1: checks 
foxyvanj: checks 
*** SHOW DOWN ***
DartmanD1: shows [Ah 9c] (two pair, Jacks and Nines)
foxyvanj: mucks handDTO
DartmanD1 collected 985 from pot
*** SUMMARY ***
Total pot 985 | Rake 0 
Board [Jh 4c Tc 9d Jd]
Seat 1: foxyvanj mucked [Kd As]
Seat 2: madmaddie92 folded before Flop (didn't bet)
Seat 3: Nukalex folded before Flop (didn't bet)
Seat 4: jcarlos.vale folded before Flop (didn't bet)
Seat 5: yazvauazva folded before Flop (didn't bet)
Seat 6: HarvesterX (button) folded before Flop (didn't bet)
Seat 7: magatama16 (small blind) folded before Flop
Seat 8: DartmanD1 (big blind) showed [Ah 9c] and won (985) with two pair, Jacks and Nines
Seat 9: neris449 folded before Flop (didn't bet)



PokerStars Hand #221330792288: Tournament #3067368972, $0.25+$0.24+$0.06 USD Hold'em No Limit - Level VIII (50/100) - 2020/12/11 20:33:21 EET [2020/12/11 13:33:21 ET]
Table '3067368972 323' 9-max Seat #7 is the button
Seat 1: foxyvanj (9229 in chips, $0.36 bounty) 
Seat 2: madmaddie92 (3866 in chips, $0.24 bounty) is sitting out
Seat 3: Nukalex (4955 in chips, $0.24 bounty) 
Seat 4: jcarlos.vale (28330 in chips, $0.60 bounty) 
Seat 5: yazvauazva (5662 in chips, $0.24 bounty) 
Seat 6: HarvesterX (1968 in chips, $0.24 bounty) is sitting out
Seat 7: magatama16 (3841 in chips, $0.24 bounty) 
Seat 8: DartmanD1 (20143 in chips, $0.60 bounty) 
Seat 9: neris449 (12369 in chips, $0.48 bounty) is sitting out
foxyvanj: posts the ante 15
madmaddie92: posts the ante 15
Nukalex: posts the ante 15
jcarlos.vale: posts the ante 15
yazvauazva: posts the ante 15
HarvesterX: posts the ante 15
magatama16: posts the ante 15
DartmanD1: posts the ante 15
neris449: posts the ante 15
DartmanD1: posts small blind 50
neris449: posts big blind 100
*** HOLE CARDS ***
Dealt to jcarlos.vale [9d 5h]
foxyvanj: folds 
madmaddie92: folds 
Nukalex: folds 
jcarlos.vale: folds 
yazvauazva: folds 
HarvesterX: folds 
magatama16: raises 200 to 300
DartmanD1: folds 
neris449: folds 
Uncalled bet (200) returned to magatama16
magatama16 collected 385 from pot
magatama16: doesn't show handDTO
*** SUMMARY ***
Total pot 385 | Rake 0 
Seat 1: foxyvanj folded before Flop (didn't bet)
Seat 2: madmaddie92 folded before Flop (didn't bet)
Seat 3: Nukalex folded before Flop (didn't bet)
Seat 4: jcarlos.vale folded before Flop (didn't bet)
Seat 5: yazvauazva folded before Flop (didn't bet)
Seat 6: HarvesterX folded before Flop (didn't bet)
Seat 7: magatama16 (button) collected (385)
Seat 8: DartmanD1 (small blind) folded before Flop
Seat 9: neris449 (big blind) folded before Flop



PokerStars Hand #221330806713: Tournament #3067368972, $0.25+$0.24+$0.06 USD Hold'em No Limit - Level VIII (50/100) - 2020/12/11 20:33:44 EET [2020/12/11 13:33:44 ET]
Table '3067368972 323' 9-max Seat #8 is the button
Seat 1: foxyvanj (9214 in chips, $0.36 bounty) 
Seat 2: madmaddie92 (3851 in chips, $0.24 bounty) is sitting out
Seat 3: Nukalex (4940 in chips, $0.24 bounty) 
Seat 4: jcarlos.vale (28315 in chips, $0.60 bounty) 
Seat 5: yazvauazva (5647 in chips, $0.24 bounty) 
Seat 6: HarvesterX (1953 in chips, $0.24 bounty) is sitting out
Seat 7: magatama16 (4111 in chips, $0.24 bounty) 
Seat 8: DartmanD1 (20078 in chips, $0.60 bounty) 
Seat 9: neris449 (12254 in chips, $0.48 bounty) is sitting out
foxyvanj: posts the ante 15
madmaddie92: posts the ante 15
Nukalex: posts the ante 15
jcarlos.vale: posts the ante 15
yazvauazva: posts the ante 15
HarvesterX: posts the ante 15
magatama16: posts the ante 15
DartmanD1: posts the ante 15
neris449: posts the ante 15
neris449: posts small blind 50
foxyvanj: posts big blind 100
*** HOLE CARDS ***
Dealt to jcarlos.vale [9c 9s]
madmaddie92: folds 
Nukalex: folds 
jcarlos.vale: raises 160 to 260
yazvauazva: folds 
HarvesterX: folds 
magatama16: folds 
DartmanD1: folds 
neris449: folds 
foxyvanj: folds 
Uncalled bet (160) returned to jcarlos.vale
jcarlos.vale collected 385 from pot
jcarlos.vale: doesn't show handDTO
*** SUMMARY ***
Total pot 385 | Rake 0 
Seat 1: foxyvanj (big blind) folded before Flop
Seat 2: madmaddie92 folded before Flop (didn't bet)
Seat 3: Nukalex folded before Flop (didn't bet)
Seat 4: jcarlos.vale collected (385)
Seat 5: yazvauazva folded before Flop (didn't bet)
Seat 6: HarvesterX folded before Flop (didn't bet)
Seat 7: magatama16 folded before Flop (didn't bet)
Seat 8: DartmanD1 (button) folded before Flop (didn't bet)
Seat 9: neris449 (small blind) folded before Flop



PokerStars Hand #221330822490: Tournament #3067368972, $0.25+$0.24+$0.06 USD Hold'em No Limit - Level IX (60/120) - 2020/12/11 20:34:10 EET [2020/12/11 13:34:10 ET]
Table '3067368972 323' 9-max Seat #9 is the button
Seat 1: foxyvanj (9099 in chips, $0.36 bounty) 
Seat 2: madmaddie92 (3836 in chips, $0.24 bounty) is sitting out
Seat 3: Nukalex (4925 in chips, $0.24 bounty) 
Seat 4: jcarlos.vale (28585 in chips, $0.60 bounty) 
Seat 5: yazvauazva (5632 in chips, $0.24 bounty) 
Seat 6: HarvesterX (1938 in chips, $0.24 bounty) is sitting out
Seat 7: magatama16 (4096 in chips, $0.24 bounty) 
Seat 8: DartmanD1 (20063 in chips, $0.60 bounty) 
Seat 9: neris449 (12189 in chips, $0.48 bounty) is sitting out
foxyvanj: posts the ante 18
madmaddie92: posts the ante 18
Nukalex: posts the ante 18
jcarlos.vale: posts the ante 18
yazvauazva: posts the ante 18
HarvesterX: posts the ante 18
magatama16: posts the ante 18
DartmanD1: posts the ante 18
neris449: posts the ante 18
foxyvanj: posts small blind 60
madmaddie92: posts big blind 120
*** HOLE CARDS ***
Dealt to jcarlos.vale [4s 4c]
Nukalex: folds 
jcarlos.vale: folds 
yazvauazva: folds 
HarvesterX: folds 
magatama16: raises 240 to 360
DartmanD1: calls 360
neris449: folds 
foxyvanj: folds 
madmaddie92: folds 
*** FLOP *** [Kd 9c Jc]
magatama16: bets 450
DartmanD1: calls 450
*** TURN *** [Kd 9c Jc] [Ac]
magatama16: checks 
DartmanD1: bets 840
magatama16: calls 840
*** RIVER *** [Kd 9c Jc Ac] [5s]
magatama16: checks 
DartmanD1: checks 
*** SHOW DOWN ***
magatama16: shows [Qs 8c] (high pairOfCards Ace)
DartmanD1: shows [Kh Td] (a pair of Kings)
DartmanD1 collected 3642 from pot
*** SUMMARY ***
Total pot 3642 | Rake 0 
Board [Kd 9c Jc Ac 5s]
Seat 1: foxyvanj (small blind) folded before Flop
Seat 2: madmaddie92 (big blind) folded before Flop
Seat 3: Nukalex folded before Flop (didn't bet)
Seat 4: jcarlos.vale folded before Flop (didn't bet)
Seat 5: yazvauazva folded before Flop (didn't bet)
Seat 6: HarvesterX folded before Flop (didn't bet)
Seat 7: magatama16 showed [Qs 8c] and lost with high pairOfCards Ace
Seat 8: DartmanD1 showed [Kh Td] and won (3642) with a pair of Kings
Seat 9: neris449 (button) folded before Flop (didn't bet)



PokerStars Hand #221330875967: Tournament #3067368972, $0.25+$0.24+$0.06 USD Hold'em No Limit - Level IX (60/120) - 2020/12/11 20:35:36 EET [2020/12/11 13:35:36 ET]
Table '3067368972 323' 9-max Seat #1 is the button
Seat 1: foxyvanj (9021 in chips, $0.36 bounty) 
Seat 2: madmaddie92 (3698 in chips, $0.24 bounty) is sitting out
Seat 3: Nukalex (4907 in chips, $0.24 bounty) 
Seat 4: jcarlos.vale (28567 in chips, $0.60 bounty) 
Seat 5: yazvauazva (5614 in chips, $0.24 bounty) 
Seat 6: HarvesterX (1920 in chips, $0.24 bounty) is sitting out
Seat 7: magatama16 (2428 in chips, $0.24 bounty) 
Seat 8: DartmanD1 (22037 in chips, $0.60 bounty) 
Seat 9: neris449 (12171 in chips, $0.48 bounty) is sitting out
foxyvanj: posts the ante 18
madmaddie92: posts the ante 18
Nukalex: posts the ante 18
jcarlos.vale: posts the ante 18
yazvauazva: posts the ante 18
HarvesterX: posts the ante 18
magatama16: posts the ante 18
DartmanD1: posts the ante 18
neris449: posts the ante 18
madmaddie92: posts small blind 60
Nukalex: posts big blind 120
*** HOLE CARDS ***
Dealt to jcarlos.vale [5s Qc]
jcarlos.vale: folds 
yazvauazva: folds 
HarvesterX: folds 
magatama16: folds 
DartmanD1: folds 
neris449: folds 
foxyvanj: raises 240 to 360
madmaddie92: folds 
Nukalex: folds 
Uncalled bet (240) returned to foxyvanj
foxyvanj collected 462 from pot
foxyvanj: doesn't show handDTO
*** SUMMARY ***
Total pot 462 | Rake 0 
Seat 1: foxyvanj (button) collected (462)
Seat 2: madmaddie92 (small blind) folded before Flop
Seat 3: Nukalex (big blind) folded before Flop
Seat 4: jcarlos.vale folded before Flop (didn't bet)
Seat 5: yazvauazva folded before Flop (didn't bet)
Seat 6: HarvesterX folded before Flop (didn't bet)
Seat 7: magatama16 folded before Flop (didn't bet)
Seat 8: DartmanD1 folded before Flop (didn't bet)
Seat 9: neris449 folded before Flop (didn't bet)



PokerStars Hand #221330899681: Tournament #3067368972, $0.25+$0.24+$0.06 USD Hold'em No Limit - Level IX (60/120) - 2020/12/11 20:36:14 EET [2020/12/11 13:36:14 ET]
Table '3067368972 323' 9-max Seat #2 is the button
Seat 1: foxyvanj (9345 in chips, $0.36 bounty) 
Seat 2: madmaddie92 (3620 in chips, $0.24 bounty) is sitting out
Seat 3: Nukalex (4769 in chips, $0.24 bounty) 
Seat 4: jcarlos.vale (28549 in chips, $0.60 bounty) 
Seat 5: yazvauazva (5596 in chips, $0.24 bounty) 
Seat 6: HarvesterX (1902 in chips, $0.24 bounty) is sitting out
Seat 7: magatama16 (2410 in chips, $0.24 bounty) 
Seat 8: DartmanD1 (22019 in chips, $0.60 bounty) 
Seat 9: neris449 (12153 in chips, $0.48 bounty) is sitting out
foxyvanj: posts the ante 18
madmaddie92: posts the ante 18
Nukalex: posts the ante 18
jcarlos.vale: posts the ante 18
yazvauazva: posts the ante 18
HarvesterX: posts the ante 18
magatama16: posts the ante 18
DartmanD1: posts the ante 18
neris449: posts the ante 18
Nukalex: posts small blind 60
jcarlos.vale: posts big blind 120
*** HOLE CARDS ***
Dealt to jcarlos.vale [7s 4h]
yazvauazva: folds 
HarvesterX: folds 
magatama16: folds 
DartmanD1: folds 
neris449: folds 
foxyvanj: calls 120
madmaddie92: folds 
Nukalex: folds 
jcarlos.vale: checks 
*** FLOP *** [Kd 3s 6d]
jcarlos.vale: checks 
foxyvanj: checks 
*** TURN *** [Kd 3s 6d] [Qc]
jcarlos.vale: checks 
foxyvanj: bets 231
jcarlos.vale: folds 
Uncalled bet (231) returned to foxyvanj
foxyvanj collected 462 from pot
foxyvanj: doesn't show handDTO
*** SUMMARY ***
Total pot 462 | Rake 0 
Board [Kd 3s 6d Qc]
Seat 1: foxyvanj collected (462)
Seat 2: madmaddie92 (button) folded before Flop (didn't bet)
Seat 3: Nukalex (small blind) folded before Flop
Seat 4: jcarlos.vale (big blind) folded on the Turn
Seat 5: yazvauazva folded before Flop (didn't bet)
Seat 6: HarvesterX folded before Flop (didn't bet)
Seat 7: magatama16 folded before Flop (didn't bet)
Seat 8: DartmanD1 folded before Flop (didn't bet)
Seat 9: neris449 folded before Flop (didn't bet)



PokerStars Hand #221330931016: Tournament #3067368972, $0.25+$0.24+$0.06 USD Hold'em No Limit - Level IX (60/120) - 2020/12/11 20:37:05 EET [2020/12/11 13:37:05 ET]
Table '3067368972 323' 9-max Seat #3 is the button
Seat 1: foxyvanj (9669 in chips, $0.36 bounty) 
Seat 2: madmaddie92 (3602 in chips, $0.24 bounty) is sitting out
Seat 3: Nukalex (4691 in chips, $0.24 bounty) 
Seat 4: jcarlos.vale (28411 in chips, $0.60 bounty) 
Seat 5: yazvauazva (5578 in chips, $0.24 bounty) 
Seat 6: HarvesterX (1884 in chips, $0.24 bounty) is sitting out
Seat 7: magatama16 (2392 in chips, $0.24 bounty) 
Seat 8: DartmanD1 (22001 in chips, $0.60 bounty) 
Seat 9: neris449 (12135 in chips, $0.48 bounty) is sitting out
foxyvanj: posts the ante 18
madmaddie92: posts the ante 18
Nukalex: posts the ante 18
jcarlos.vale: posts the ante 18
yazvauazva: posts the ante 18
HarvesterX: posts the ante 18
magatama16: posts the ante 18
DartmanD1: posts the ante 18
neris449: posts the ante 18
jcarlos.vale: posts small blind 60
yazvauazva: posts big blind 120
*** HOLE CARDS ***
Dealt to jcarlos.vale [6c 2h]
HarvesterX: folds 
magatama16: folds 
DartmanD1: folds 
neris449: folds 
foxyvanj: folds 
madmaddie92: folds 
Nukalex: raises 139 to 259
jcarlos.vale: folds 
yazvauazva: calls 139
*** FLOP *** [3c 6s 7h]
yazvauazva: checks 
Nukalex: checks 
*** TURN *** [3c 6s 7h] [8h]
yazvauazva: checks 
Nukalex: checks 
*** RIVER *** [3c 6s 7h 8h] [Tc]
yazvauazva: checks 
Nukalex: checks 
*** SHOW DOWN ***
yazvauazva: shows [Kh Jd] (high pairOfCards King)
Nukalex: shows [Ac Jc] (high pairOfCards Ace)
Nukalex collected 740 from pot
*** SUMMARY ***
Total pot 740 | Rake 0 
Board [3c 6s 7h 8h Tc]
Seat 1: foxyvanj folded before Flop (didn't bet)
Seat 2: madmaddie92 folded before Flop (didn't bet)
Seat 3: Nukalex (button) showed [Ac Jc] and won (740) with high pairOfCards Ace
Seat 4: jcarlos.vale (small blind) folded before Flop
Seat 5: yazvauazva (big blind) showed [Kh Jd] and lost with high pairOfCards King
Seat 6: HarvesterX folded before Flop (didn't bet)
Seat 7: magatama16 folded before Flop (didn't bet)
Seat 8: DartmanD1 folded before Flop (didn't bet)
Seat 9: neris449 folded before Flop (didn't bet)



PokerStars Hand #221330980359: Tournament #3067368972, $0.25+$0.24+$0.06 USD Hold'em No Limit - Level IX (60/120) - 2020/12/11 20:38:24 EET [2020/12/11 13:38:24 ET]
Table '3067368972 323' 9-max Seat #4 is the button
Seat 1: foxyvanj (9651 in chips, $0.36 bounty) 
Seat 2: madmaddie92 (3584 in chips, $0.24 bounty) is sitting out
Seat 3: Nukalex (5154 in chips, $0.24 bounty) 
Seat 4: jcarlos.vale (28333 in chips, $0.60 bounty) 
Seat 5: yazvauazva (5301 in chips, $0.24 bounty) 
Seat 6: HarvesterX (1866 in chips, $0.24 bounty) is sitting out
Seat 7: magatama16 (2374 in chips, $0.24 bounty) 
Seat 8: DartmanD1 (21983 in chips, $0.60 bounty) 
Seat 9: neris449 (12117 in chips, $0.48 bounty) is sitting out
foxyvanj: posts the ante 18
madmaddie92: posts the ante 18
Nukalex: posts the ante 18
jcarlos.vale: posts the ante 18
yazvauazva: posts the ante 18
HarvesterX: posts the ante 18
magatama16: posts the ante 18
DartmanD1: posts the ante 18
neris449: posts the ante 18
yazvauazva: posts small blind 60
HarvesterX: posts big blind 120
*** HOLE CARDS ***
Dealt to jcarlos.vale [Qs 6s]
magatama16: folds 
DartmanD1: raises 180 to 300
neris449: folds 
foxyvanj: folds 
madmaddie92: folds 
Nukalex: folds 
jcarlos.vale: folds 
yazvauazva: folds 
HarvesterX: folds 
Uncalled bet (180) returned to DartmanD1
DartmanD1 collected 462 from pot
*** SUMMARY ***
Total pot 462 | Rake 0 
Seat 1: foxyvanj folded before Flop (didn't bet)
Seat 2: madmaddie92 folded before Flop (didn't bet)
Seat 3: Nukalex folded before Flop (didn't bet)
Seat 4: jcarlos.vale (button) folded before Flop (didn't bet)
Seat 5: yazvauazva (small blind) folded before Flop
Seat 6: HarvesterX (big blind) folded before Flop
Seat 7: magatama16 folded before Flop (didn't bet)
Seat 8: DartmanD1 collected (462)
Seat 9: neris449 folded before Flop (didn't bet)



PokerStars Hand #221330988850: Tournament #3067368972, $0.25+$0.24+$0.06 USD Hold'em No Limit - Level IX (60/120) - 2020/12/11 20:38:38 EET [2020/12/11 13:38:38 ET]
Table '3067368972 323' 9-max Seat #5 is the button
Seat 1: foxyvanj (9633 in chips, $0.36 bounty) 
Seat 2: madmaddie92 (3566 in chips, $0.24 bounty) is sitting out
Seat 3: Nukalex (5136 in chips, $0.24 bounty) 
Seat 4: jcarlos.vale (28315 in chips, $0.60 bounty) 
Seat 5: yazvauazva (5223 in chips, $0.24 bounty) 
Seat 6: HarvesterX (1728 in chips, $0.24 bounty) is sitting out
Seat 7: magatama16 (2356 in chips, $0.24 bounty) 
Seat 8: DartmanD1 (22307 in chips, $0.60 bounty) 
Seat 9: neris449 (12099 in chips, $0.48 bounty) is sitting out
foxyvanj: posts the ante 18
madmaddie92: posts the ante 18
Nukalex: posts the ante 18
jcarlos.vale: posts the ante 18
yazvauazva: posts the ante 18
HarvesterX: posts the ante 18
magatama16: posts the ante 18
DartmanD1: posts the ante 18
neris449: posts the ante 18
HarvesterX: posts small blind 60
magatama16: posts big blind 120
*** HOLE CARDS ***
Dealt to jcarlos.vale [Ad Js]
DartmanD1: folds 
neris449: folds 
foxyvanj: folds 
madmaddie92: folds 
Nukalex: folds 
jcarlos.vale: raises 192 to 312
yazvauazva: folds 
HarvesterX: folds 
magatama16: calls 192
*** FLOP *** [5h 9d 3h]
magatama16: checks 
jcarlos.vale: checks 
*** TURN *** [5h 9d 3h] [As]
magatama16: checks 
jcarlos.vale: bets 635
magatama16: folds 
Uncalled bet (635) returned to jcarlos.vale
jcarlos.vale collected 846 from pot
jcarlos.vale: doesn't show handDTO
*** SUMMARY ***
Total pot 846 | Rake 0 
Board [5h 9d 3h As]
Seat 1: foxyvanj folded before Flop (didn't bet)
Seat 2: madmaddie92 folded before Flop (didn't bet)
Seat 3: Nukalex folded before Flop (didn't bet)
Seat 4: jcarlos.vale collected (846)
Seat 5: yazvauazva (button) folded before Flop (didn't bet)
Seat 6: HarvesterX (small blind) folded before Flop
Seat 7: magatama16 (big blind) folded on the Turn
Seat 8: DartmanD1 folded before Flop (didn't bet)
Seat 9: neris449 folded before Flop (didn't bet)



PokerStars Hand #221331027265: Tournament #3067368972, $0.25+$0.24+$0.06 USD Hold'em No Limit - Level IX (60/120) - 2020/12/11 20:39:40 EET [2020/12/11 13:39:40 ET]
Table '3067368972 323' 9-max Seat #6 is the button
Seat 1: foxyvanj (9615 in chips, $0.36 bounty) 
Seat 2: madmaddie92 (3548 in chips, $0.24 bounty) is sitting out
Seat 3: Nukalex (5118 in chips, $0.24 bounty) 
Seat 4: jcarlos.vale (28831 in chips, $0.60 bounty) 
Seat 5: yazvauazva (5205 in chips, $0.24 bounty) 
Seat 6: HarvesterX (1650 in chips, $0.24 bounty) is sitting out
Seat 7: magatama16 (2026 in chips, $0.24 bounty) 
Seat 8: DartmanD1 (22289 in chips, $0.60 bounty) 
Seat 9: neris449 (12081 in chips, $0.48 bounty) is sitting out
foxyvanj: posts the ante 18
madmaddie92: posts the ante 18
Nukalex: posts the ante 18
jcarlos.vale: posts the ante 18
yazvauazva: posts the ante 18
HarvesterX: posts the ante 18
magatama16: posts the ante 18
DartmanD1: posts the ante 18
neris449: posts the ante 18
magatama16: posts small blind 60
DartmanD1: posts big blind 120
*** HOLE CARDS ***
Dealt to jcarlos.vale [8c 7c]
neris449: folds 
neris449 has returned
foxyvanj: folds 
madmaddie92: folds 
Nukalex: raises 139 to 259
jcarlos.vale: folds 
yazvauazva: folds 
HarvesterX: folds 
magatama16: folds 
DartmanD1: calls 139
*** FLOP *** [Qd 4h Qc]
DartmanD1: checks 
Nukalex: bets 222
DartmanD1: folds 
Uncalled bet (222) returned to Nukalex
Nukalex collected 740 from pot
Nukalex: doesn't show handDTO
*** SUMMARY ***
Total pot 740 | Rake 0 
Board [Qd 4h Qc]
Seat 1: foxyvanj folded before Flop (didn't bet)
Seat 2: madmaddie92 folded before Flop (didn't bet)
Seat 3: Nukalex collected (740)
Seat 4: jcarlos.vale folded before Flop (didn't bet)
Seat 5: yazvauazva folded before Flop (didn't bet)
Seat 6: HarvesterX (button) folded before Flop (didn't bet)
Seat 7: magatama16 (small blind) folded before Flop
Seat 8: DartmanD1 (big blind) folded on the Flop
Seat 9: neris449 folded before Flop (didn't bet)



PokerStars Hand #221331043834: Tournament #3067368972, $0.25+$0.24+$0.06 USD Hold'em No Limit - Level IX (60/120) - 2020/12/11 20:40:06 EET [2020/12/11 13:40:06 ET]
Table '3067368972 323' 9-max Seat #7 is the button
Seat 1: foxyvanj (9597 in chips, $0.36 bounty) 
Seat 2: madmaddie92 (3530 in chips, $0.24 bounty) is sitting out
Seat 3: Nukalex (5581 in chips, $0.24 bounty) 
Seat 4: jcarlos.vale (28813 in chips, $0.60 bounty) 
Seat 5: yazvauazva (5187 in chips, $0.24 bounty) 
Seat 6: HarvesterX (1632 in chips, $0.24 bounty) is sitting out
Seat 7: magatama16 (1948 in chips, $0.24 bounty) 
Seat 8: DartmanD1 (22012 in chips, $0.60 bounty) 
Seat 9: neris449 (12063 in chips, $0.48 bounty) 
foxyvanj: posts the ante 18
madmaddie92: posts the ante 18
Nukalex: posts the ante 18
jcarlos.vale: posts the ante 18
yazvauazva: posts the ante 18
HarvesterX: posts the ante 18
magatama16: posts the ante 18
DartmanD1: posts the ante 18
neris449: posts the ante 18
DartmanD1: posts small blind 60
neris449: posts big blind 120
*** HOLE CARDS ***
Dealt to jcarlos.vale [Ts 3s]
foxyvanj: folds 
madmaddie92: folds 
Nukalex: folds 
jcarlos.vale: folds 
yazvauazva: folds 
HarvesterX: folds 
magatama16: folds 
DartmanD1: folds 
Uncalled bet (60) returned to neris449
neris449 collected 282 from pot
neris449: doesn't show handDTO
*** SUMMARY ***
Total pot 282 | Rake 0 
Seat 1: foxyvanj folded before Flop (didn't bet)
Seat 2: madmaddie92 folded before Flop (didn't bet)
Seat 3: Nukalex folded before Flop (didn't bet)
Seat 4: jcarlos.vale folded before Flop (didn't bet)
Seat 5: yazvauazva folded before Flop (didn't bet)
Seat 6: HarvesterX folded before Flop (didn't bet)
Seat 7: magatama16 (button) folded before Flop (didn't bet)
Seat 8: DartmanD1 (small blind) folded before Flop
Seat 9: neris449 (big blind) collected (282)



PokerStars Hand #221331052251: Tournament #3067368972, $0.25+$0.24+$0.06 USD Hold'em No Limit - Level IX (60/120) - 2020/12/11 20:40:20 EET [2020/12/11 13:40:20 ET]
Table '3067368972 323' 9-max Seat #8 is the button
Seat 1: foxyvanj (9579 in chips, $0.36 bounty) 
Seat 2: madmaddie92 (3512 in chips, $0.24 bounty) is sitting out
Seat 3: Nukalex (5563 in chips, $0.24 bounty) 
Seat 4: jcarlos.vale (28795 in chips, $0.60 bounty) 
Seat 5: yazvauazva (5169 in chips, $0.24 bounty) 
Seat 6: HarvesterX (1614 in chips, $0.24 bounty) is sitting out
Seat 7: magatama16 (1930 in chips, $0.24 bounty) 
Seat 8: DartmanD1 (21934 in chips, $0.60 bounty) 
Seat 9: neris449 (12267 in chips, $0.48 bounty) 
foxyvanj: posts the ante 18
madmaddie92: posts the ante 18
Nukalex: posts the ante 18
jcarlos.vale: posts the ante 18
yazvauazva: posts the ante 18
HarvesterX: posts the ante 18
magatama16: posts the ante 18
DartmanD1: posts the ante 18
neris449: posts the ante 18
neris449: posts small blind 60
foxyvanj: posts big blind 120
*** HOLE CARDS ***
Dealt to jcarlos.vale [Jh Ad]
madmaddie92: folds 
Nukalex: folds 
jcarlos.vale: raises 192 to 312
yazvauazva: folds 
HarvesterX: folds 
magatama16: folds 
DartmanD1: folds 
neris449: calls 252
foxyvanj: calls 192
*** FLOP *** [6h Qs 7s]
neris449: checks 
foxyvanj: checks 
jcarlos.vale: checks 
*** TURN *** [6h Qs 7s] [Th]
neris449: checks 
foxyvanj: bets 549
jcarlos.vale: folds 
neris449: calls 549
*** RIVER *** [6h Qs 7s Th] [Kd]
neris449: checks 
foxyvanj: checks 
*** SHOW DOWN ***
neris449: shows [Js 5s] (high pairOfCards King)
foxyvanj: shows [Qh 2h] (a pair of Queens)
foxyvanj collected 2196 from pot
*** SUMMARY ***
Total pot 2196 | Rake 0 
Board [6h Qs 7s Th Kd]
Seat 1: foxyvanj (big blind) showed [Qh 2h] and won (2196) with a pair of Queens
Seat 2: madmaddie92 folded before Flop (didn't bet)
Seat 3: Nukalex folded before Flop (didn't bet)
Seat 4: jcarlos.vale folded on the Turn
Seat 5: yazvauazva folded before Flop (didn't bet)
Seat 6: HarvesterX folded before Flop (didn't bet)
Seat 7: magatama16 folded before Flop (didn't bet)
Seat 8: DartmanD1 (button) folded before Flop (didn't bet)
Seat 9: neris449 (small blind) showed [Js 5s] and lost with high pairOfCards King



PokerStars Hand #221331081642: Tournament #3067368972, $0.25+$0.24+$0.06 USD Hold'em No Limit - Level X (70/140) - 2020/12/11 20:41:08 EET [2020/12/11 13:41:08 ET]
Table '3067368972 323' 9-max Seat #9 is the button
Seat 1: foxyvanj (10896 in chips, $0.36 bounty) 
Seat 2: madmaddie92 (3494 in chips, $0.24 bounty) is sitting out
Seat 3: Nukalex (5545 in chips, $0.24 bounty) 
Seat 4: jcarlos.vale (28465 in chips, $0.60 bounty) 
Seat 5: yazvauazva (5151 in chips, $0.24 bounty) 
Seat 6: HarvesterX (1596 in chips, $0.24 bounty) is sitting out
Seat 7: magatama16 (1912 in chips, $0.24 bounty) 
Seat 8: DartmanD1 (21916 in chips, $0.60 bounty) 
Seat 9: neris449 (11388 in chips, $0.48 bounty) 
foxyvanj: posts the ante 21
madmaddie92: posts the ante 21
Nukalex: posts the ante 21
jcarlos.vale: posts the ante 21
yazvauazva: posts the ante 21
HarvesterX: posts the ante 21
magatama16: posts the ante 21
DartmanD1: posts the ante 21
neris449: posts the ante 21
foxyvanj: posts small blind 70
madmaddie92: posts big blind 140
*** HOLE CARDS ***
Dealt to jcarlos.vale [Qh 6c]
Nukalex: raises 162 to 302
jcarlos.vale: folds 
yazvauazva: folds 
HarvesterX: folds 
magatama16: folds 
DartmanD1: folds 
neris449: calls 302
foxyvanj: folds 
madmaddie92: folds 
*** FLOP *** [9s 5d Ks]
Nukalex: bets 301
neris449: calls 301
*** TURN *** [9s 5d Ks] [Td]
Nukalex: checks 
neris449: checks 
*** RIVER *** [9s 5d Ks Td] [2c]
Nukalex: checks 
neris449: bets 803
Nukalex: calls 803
*** SHOW DOWN ***
neris449: shows [As Th] (a pair of Tens)
Nukalex: mucks handDTO
neris449 collected 3211 from pot
*** SUMMARY ***
Total pot 3211 | Rake 0 
Board [9s 5d Ks Td 2c]
Seat 1: foxyvanj (small blind) folded before Flop
Seat 2: madmaddie92 (big blind) folded before Flop
Seat 3: Nukalex mucked [7c 7h]
Seat 4: jcarlos.vale folded before Flop (didn't bet)
Seat 5: yazvauazva folded before Flop (didn't bet)
Seat 6: HarvesterX folded before Flop (didn't bet)
Seat 7: magatama16 folded before Flop (didn't bet)
Seat 8: DartmanD1 folded before Flop (didn't bet)
Seat 9: neris449 (button) showed [As Th] and won (3211) with a pair of Tens



PokerStars Hand #221331136654: Tournament #3067368972, $0.25+$0.24+$0.06 USD Hold'em No Limit - Level X (70/140) - 2020/12/11 20:42:37 EET [2020/12/11 13:42:37 ET]
Table '3067368972 323' 9-max Seat #1 is the button
Seat 1: foxyvanj (10805 in chips, $0.36 bounty) 
Seat 2: madmaddie92 (3333 in chips, $0.24 bounty) is sitting out
Seat 3: Nukalex (4118 in chips, $0.24 bounty) 
Seat 4: jcarlos.vale (28444 in chips, $0.60 bounty) 
Seat 5: yazvauazva (5130 in chips, $0.24 bounty) 
Seat 6: HarvesterX (1575 in chips, $0.24 bounty) is sitting out
Seat 7: magatama16 (1891 in chips, $0.24 bounty) 
Seat 8: DartmanD1 (21895 in chips, $0.60 bounty) 
Seat 9: neris449 (13172 in chips, $0.48 bounty) 
foxyvanj: posts the ante 21
madmaddie92: posts the ante 21
Nukalex: posts the ante 21
jcarlos.vale: posts the ante 21
yazvauazva: posts the ante 21
HarvesterX: posts the ante 21
magatama16: posts the ante 21
DartmanD1: posts the ante 21
neris449: posts the ante 21
madmaddie92: posts small blind 70
Nukalex: posts big blind 140
*** HOLE CARDS ***
Dealt to jcarlos.vale [Js 6s]
jcarlos.vale: folds 
yazvauazva: folds 
HarvesterX: folds 
magatama16: raises 1730 to 1870 and is all-in
DartmanD1: folds 
neris449: folds 
foxyvanj: raises 8914 to 10784 and is all-in
madmaddie92: folds 
Nukalex: folds 
Uncalled bet (8914) returned to foxyvanj
*** FLOP *** [4d 3s 5d]
*** TURN *** [4d 3s 5d] [As]
*** RIVER *** [4d 3s 5d As] [8c]
*** SHOW DOWN ***
magatama16: shows [8h 8d] (three of a kind, Eights)
foxyvanj: shows [Kd Jd] (high pairOfCards Ace)
magatama16 collected 4139 from pot
*** SUMMARY ***
Total pot 4139 | Rake 0 
Board [4d 3s 5d As 8c]
Seat 1: foxyvanj (button) showed [Kd Jd] and lost with high pairOfCards Ace
Seat 2: madmaddie92 (small blind) folded before Flop
Seat 3: Nukalex (big blind) folded before Flop
Seat 4: jcarlos.vale folded before Flop (didn't bet)
Seat 5: yazvauazva folded before Flop (didn't bet)
Seat 6: HarvesterX folded before Flop (didn't bet)
Seat 7: magatama16 showed [8h 8d] and won (4139) with three of a kind, Eights
Seat 8: DartmanD1 folded before Flop (didn't bet)
Seat 9: neris449 folded before Flop (didn't bet)



PokerStars Hand #221331160416: Tournament #3067368972, $0.25+$0.24+$0.06 USD Hold'em No Limit - Level X (70/140) - 2020/12/11 20:43:15 EET [2020/12/11 13:43:15 ET]
Table '3067368972 323' 9-max Seat #2 is the button
Seat 1: foxyvanj (8914 in chips, $0.36 bounty) 
Seat 2: madmaddie92 (3242 in chips, $0.24 bounty) is sitting out
Seat 3: Nukalex (3957 in chips, $0.24 bounty) 
Seat 4: jcarlos.vale (28423 in chips, $0.60 bounty) 
Seat 5: yazvauazva (5109 in chips, $0.24 bounty) 
Seat 6: HarvesterX (1554 in chips, $0.24 bounty) is sitting out
Seat 7: magatama16 (4139 in chips, $0.24 bounty) 
Seat 8: DartmanD1 (21874 in chips, $0.60 bounty) 
Seat 9: neris449 (13151 in chips, $0.48 bounty) 
foxyvanj: posts the ante 21
madmaddie92: posts the ante 21
Nukalex: posts the ante 21
jcarlos.vale: posts the ante 21
yazvauazva: posts the ante 21
HarvesterX: posts the ante 21
magatama16: posts the ante 21
DartmanD1: posts the ante 21
neris449: posts the ante 21
Nukalex: posts small blind 70
jcarlos.vale: posts big blind 140
*** HOLE CARDS ***
Dealt to jcarlos.vale [Js 8h]
yazvauazva: folds 
HarvesterX: folds 
magatama16: folds 
DartmanD1: raises 168 to 308
neris449: calls 308
foxyvanj: folds 
madmaddie92: folds 
Nukalex: folds 
jcarlos.vale: folds 
*** FLOP *** [As Jh 3h]
DartmanD1: bets 355
neris449: calls 355
*** TURN *** [As Jh 3h] [6c]
DartmanD1: checks 
neris449: checks 
*** RIVER *** [As Jh 3h 6c] [Ks]
DartmanD1: bets 560
neris449: calls 560
*** SHOW DOWN ***
DartmanD1: shows [Tc Jc] (a pair of Jacks)
neris449: mucks handDTO
DartmanD1 collected 2845 from pot
*** SUMMARY ***
Total pot 2845 | Rake 0 
Board [As Jh 3h 6c Ks]
Seat 1: foxyvanj folded before Flop (didn't bet)
Seat 2: madmaddie92 (button) folded before Flop (didn't bet)
Seat 3: Nukalex (small blind) folded before Flop
Seat 4: jcarlos.vale (big blind) folded before Flop
Seat 5: yazvauazva folded before Flop (didn't bet)
Seat 6: HarvesterX folded before Flop (didn't bet)
Seat 7: magatama16 folded before Flop (didn't bet)
Seat 8: DartmanD1 showed [Tc Jc] and won (2845) with a pair of Jacks
Seat 9: neris449 mucked [9s Jd]



PokerStars Hand #221331182785: Tournament #3067368972, $0.25+$0.24+$0.06 USD Hold'em No Limit - Level X (70/140) - 2020/12/11 20:43:51 EET [2020/12/11 13:43:51 ET]
Table '3067368972 323' 9-max Seat #3 is the button
Seat 1: foxyvanj (8893 in chips, $0.36 bounty) 
Seat 2: madmaddie92 (3221 in chips, $0.24 bounty) is sitting out
Seat 3: Nukalex (3866 in chips, $0.24 bounty) 
Seat 4: jcarlos.vale (28262 in chips, $0.60 bounty) 
Seat 5: yazvauazva (5088 in chips, $0.24 bounty) 
Seat 6: HarvesterX (1533 in chips, $0.24 bounty) is sitting out
Seat 7: magatama16 (4118 in chips, $0.24 bounty) 
Seat 8: DartmanD1 (23475 in chips, $0.60 bounty) 
Seat 9: neris449 (11907 in chips, $0.48 bounty) 
foxyvanj: posts the ante 21
madmaddie92: posts the ante 21
Nukalex: posts the ante 21
jcarlos.vale: posts the ante 21
yazvauazva: posts the ante 21
HarvesterX: posts the ante 21
magatama16: posts the ante 21
DartmanD1: posts the ante 21
neris449: posts the ante 21
jcarlos.vale: posts small blind 70
yazvauazva: posts big blind 140
*** HOLE CARDS ***
Dealt to jcarlos.vale [6s Td]
HarvesterX: folds 
magatama16: folds 
DartmanD1: folds 
neris449: folds 
foxyvanj: folds 
madmaddie92: folds 
Nukalex: folds 
jcarlos.vale: folds 
Uncalled bet (70) returned to yazvauazva
yazvauazva collected 329 from pot
*** SUMMARY ***
Total pot 329 | Rake 0 
Seat 1: foxyvanj folded before Flop (didn't bet)
Seat 2: madmaddie92 folded before Flop (didn't bet)
Seat 3: Nukalex (button) folded before Flop (didn't bet)
Seat 4: jcarlos.vale (small blind) folded before Flop
Seat 5: yazvauazva (big blind) collected (329)
Seat 6: HarvesterX folded before Flop (didn't bet)
Seat 7: magatama16 folded before Flop (didn't bet)
Seat 8: DartmanD1 folded before Flop (didn't bet)
Seat 9: neris449 folded before Flop (didn't bet)



PokerStars Hand #221331201598: Tournament #3067368972, $0.25+$0.24+$0.06 USD Hold'em No Limit - Level X (70/140) - 2020/12/11 20:44:21 EET [2020/12/11 13:44:21 ET]
Table '3067368972 323' 9-max Seat #4 is the button
Seat 1: foxyvanj (8872 in chips, $0.36 bounty) 
Seat 2: madmaddie92 (3200 in chips, $0.24 bounty) is sitting out
Seat 3: Nukalex (3845 in chips, $0.24 bounty) 
Seat 4: jcarlos.vale (28171 in chips, $0.60 bounty) 
Seat 5: yazvauazva (5326 in chips, $0.24 bounty) 
Seat 6: HarvesterX (1512 in chips, $0.24 bounty) is sitting out
Seat 7: magatama16 (4097 in chips, $0.24 bounty) 
Seat 8: DartmanD1 (23454 in chips, $0.60 bounty) 
Seat 9: neris449 (11886 in chips, $0.48 bounty) 
foxyvanj: posts the ante 21
madmaddie92: posts the ante 21
Nukalex: posts the ante 21
jcarlos.vale: posts the ante 21
yazvauazva: posts the ante 21
HarvesterX: posts the ante 21
magatama16: posts the ante 21
DartmanD1: posts the ante 21
neris449: posts the ante 21
yazvauazva: posts small blind 70
HarvesterX: posts big blind 140
*** HOLE CARDS ***
Dealt to jcarlos.vale [2c Qs]
magatama16: raises 210 to 350
DartmanD1: folds 
neris449: calls 350
foxyvanj: folds 
madmaddie92: folds 
Nukalex: folds 
jcarlos.vale: folds 
yazvauazva: folds 
HarvesterX: folds 
*** FLOP *** [3c Kc 5h]
magatama16: checks 
neris449: checks 
*** TURN *** [3c Kc 5h] [5s]
magatama16: bets 450
neris449: calls 450
*** RIVER *** [3c Kc 5h 5s] [Jh]
magatama16: bets 700
neris449: folds 
Uncalled bet (700) returned to magatama16
magatama16 collected 1999 from pot
magatama16: doesn't show handDTO
*** SUMMARY ***
Total pot 1999 | Rake 0 
Board [3c Kc 5h 5s Jh]
Seat 1: foxyvanj folded before Flop (didn't bet)
Seat 2: madmaddie92 folded before Flop (didn't bet)
Seat 3: Nukalex folded before Flop (didn't bet)
Seat 4: jcarlos.vale (button) folded before Flop (didn't bet)
Seat 5: yazvauazva (small blind) folded before Flop
Seat 6: HarvesterX (big blind) folded before Flop
Seat 7: magatama16 collected (1999)
Seat 8: DartmanD1 folded before Flop (didn't bet)
Seat 9: neris449 folded on the River



PokerStars Hand #221331238990: Tournament #3067368972, $0.25+$0.24+$0.06 USD Hold'em No Limit - Level X (70/140) - 2020/12/11 20:45:21 EET [2020/12/11 13:45:21 ET]
Table '3067368972 323' 9-max Seat #5 is the button
Seat 1: foxyvanj (8851 in chips, $0.36 bounty) 
Seat 2: madmaddie92 (3179 in chips, $0.24 bounty) is sitting out
Seat 3: Nukalex (3824 in chips, $0.24 bounty) 
Seat 4: jcarlos.vale (28150 in chips, $0.60 bounty) 
Seat 5: yazvauazva (5235 in chips, $0.24 bounty) 
Seat 6: HarvesterX (1351 in chips, $0.24 bounty) is sitting out
Seat 7: magatama16 (5275 in chips, $0.24 bounty) 
Seat 8: DartmanD1 (23433 in chips, $0.60 bounty) 
Seat 9: neris449 (11065 in chips, $0.48 bounty) 
foxyvanj: posts the ante 21
madmaddie92: posts the ante 21
Nukalex: posts the ante 21
jcarlos.vale: posts the ante 21
yazvauazva: posts the ante 21
HarvesterX: posts the ante 21
magatama16: posts the ante 21
DartmanD1: posts the ante 21
neris449: posts the ante 21
HarvesterX: posts small blind 70
magatama16: posts big blind 140
*** HOLE CARDS ***
Dealt to jcarlos.vale [8h 3h]
DartmanD1: folds 
neris449: calls 140
foxyvanj: folds 
madmaddie92: folds 
Nukalex: folds 
jcarlos.vale: folds 
yazvauazva: folds 
HarvesterX: folds 
magatama16: checks 
*** FLOP *** [As Ad 2s]
magatama16: checks 
neris449: checks 
*** TURN *** [As Ad 2s] [2d]
magatama16: bets 539
neris449: calls 539
*** RIVER *** [As Ad 2s 2d] [Js]
magatama16: bets 1000
neris449: calls 1000
*** SHOW DOWN ***
magatama16: shows [Th Ac] (a full house, Aces full of Deuces)
neris449: mucks handDTO
magatama16 collected 3617 from pot
*** SUMMARY ***
Total pot 3617 | Rake 0 
Board [As Ad 2s 2d Js]
Seat 1: foxyvanj folded before Flop (didn't bet)
Seat 2: madmaddie92 folded before Flop (didn't bet)
Seat 3: Nukalex folded before Flop (didn't bet)
Seat 4: jcarlos.vale folded before Flop (didn't bet)
Seat 5: yazvauazva (button) folded before Flop (didn't bet)
Seat 6: HarvesterX (small blind) folded before Flop
Seat 7: magatama16 (big blind) showed [Th Ac] and won (3617) with a full house, Aces full of Deuces
Seat 8: DartmanD1 folded before Flop (didn't bet)
Seat 9: neris449 mucked [2c 4c]



PokerStars Hand #221331267864: Tournament #3067368972, $0.25+$0.24+$0.06 USD Hold'em No Limit - Level X (70/140) - 2020/12/11 20:46:08 EET [2020/12/11 13:46:08 ET]
Table '3067368972 323' 9-max Seat #6 is the button
Seat 1: foxyvanj (8830 in chips, $0.36 bounty) 
Seat 2: madmaddie92 (3158 in chips, $0.24 bounty) is sitting out
Seat 3: Nukalex (3803 in chips, $0.24 bounty) 
Seat 4: jcarlos.vale (28129 in chips, $0.60 bounty) 
Seat 5: yazvauazva (5214 in chips, $0.24 bounty) 
Seat 6: HarvesterX (1260 in chips, $0.24 bounty) is sitting out
Seat 7: magatama16 (7192 in chips, $0.24 bounty) 
Seat 8: DartmanD1 (23412 in chips, $0.60 bounty) 
Seat 9: neris449 (9365 in chips, $0.48 bounty) 
foxyvanj: posts the ante 21
madmaddie92: posts the ante 21
Nukalex: posts the ante 21
jcarlos.vale: posts the ante 21
yazvauazva: posts the ante 21
HarvesterX: posts the ante 21
magatama16: posts the ante 21
DartmanD1: posts the ante 21
neris449: posts the ante 21
magatama16: posts small blind 70
DartmanD1: posts big blind 140
*** HOLE CARDS ***
Dealt to jcarlos.vale [3c 8d]
neris449: calls 140
foxyvanj: folds 
madmaddie92: folds 
Nukalex: folds 
jcarlos.vale: folds 
yazvauazva: folds 
HarvesterX: folds 
magatama16: calls 70
DartmanD1: checks 
*** FLOP *** [3s 5s 7s]
magatama16: checks 
DartmanD1: checks 
neris449: checks 
*** TURN *** [3s 5s 7s] [Jh]
magatama16: bets 350
DartmanD1: calls 350
neris449: folds 
*** RIVER *** [3s 5s 7s Jh] [6s]
magatama16: bets 700
DartmanD1: calls 700
*** SHOW DOWN ***
magatama16: shows [9d 8s] (a flush, Eight high)
DartmanD1: shows [9s 6d] (a flush, Nine high)
DartmanD1 collected 2709 from pot
*** SUMMARY ***
Total pot 2709 | Rake 0 
Board [3s 5s 7s Jh 6s]
Seat 1: foxyvanj folded before Flop (didn't bet)
Seat 2: madmaddie92 folded before Flop (didn't bet)
Seat 3: Nukalex folded before Flop (didn't bet)
Seat 4: jcarlos.vale folded before Flop (didn't bet)
Seat 5: yazvauazva folded before Flop (didn't bet)
Seat 6: HarvesterX (button) folded before Flop (didn't bet)
Seat 7: magatama16 (small blind) showed [9d 8s] and lost with a flush, Eight high
Seat 8: DartmanD1 (big blind) showed [9s 6d] and won (2709) with a flush, Nine high
Seat 9: neris449 folded on the Turn



PokerStars Hand #221331309276: Tournament #3067368972, $0.25+$0.24+$0.06 USD Hold'em No Limit - Level X (70/140) - 2020/12/11 20:47:14 EET [2020/12/11 13:47:14 ET]
Table '3067368972 323' 9-max Seat #7 is the button
Seat 1: foxyvanj (8809 in chips, $0.36 bounty) 
Seat 2: madmaddie92 (3137 in chips, $0.24 bounty) is sitting out
Seat 3: Nukalex (3782 in chips, $0.24 bounty) 
Seat 4: jcarlos.vale (28108 in chips, $0.60 bounty) 
Seat 5: yazvauazva (5193 in chips, $0.24 bounty) 
Seat 6: HarvesterX (1239 in chips, $0.24 bounty) is sitting out
Seat 7: magatama16 (5981 in chips, $0.24 bounty) 
Seat 8: DartmanD1 (24910 in chips, $0.60 bounty) 
Seat 9: neris449 (9204 in chips, $0.48 bounty) 
foxyvanj: posts the ante 21
madmaddie92: posts the ante 21
Nukalex: posts the ante 21
jcarlos.vale: posts the ante 21
yazvauazva: posts the ante 21
HarvesterX: posts the ante 21
magatama16: posts the ante 21
DartmanD1: posts the ante 21
neris449: posts the ante 21
DartmanD1: posts small blind 70
neris449: posts big blind 140
*** HOLE CARDS ***
Dealt to jcarlos.vale [Jh Kc]
foxyvanj: folds 
madmaddie92: folds 
Nukalex: folds 
jcarlos.vale: raises 224 to 364
yazvauazva: folds 
HarvesterX: folds 
magatama16: folds 
DartmanD1: folds 
neris449: calls 224
*** FLOP *** [Ad 3d 5h]
neris449: checks 
jcarlos.vale: checks 
*** TURN *** [Ad 3d 5h] [Tc]
neris449: bets 494
jcarlos.vale: folds 
Uncalled bet (494) returned to neris449
neris449 collected 987 from pot
neris449: doesn't show handDTO
*** SUMMARY ***
Total pot 987 | Rake 0 
Board [Ad 3d 5h Tc]
Seat 1: foxyvanj folded before Flop (didn't bet)
Seat 2: madmaddie92 folded before Flop (didn't bet)
Seat 3: Nukalex folded before Flop (didn't bet)
Seat 4: jcarlos.vale folded on the Turn
Seat 5: yazvauazva folded before Flop (didn't bet)
Seat 6: HarvesterX folded before Flop (didn't bet)
Seat 7: magatama16 (button) folded before Flop (didn't bet)
Seat 8: DartmanD1 (small blind) folded before Flop
Seat 9: neris449 (big blind) collected (987)



PokerStars Hand #221331336688: Tournament #3067368972, $0.25+$0.24+$0.06 USD Hold'em No Limit - Level XI (80/160) - 2020/12/11 20:47:57 EET [2020/12/11 13:47:57 ET]
Table '3067368972 323' 9-max Seat #8 is the button
Seat 1: foxyvanj (8788 in chips, $0.36 bounty) 
Seat 2: madmaddie92 (3116 in chips, $0.24 bounty) is sitting out
Seat 3: Nukalex (3761 in chips, $0.24 bounty) 
Seat 4: jcarlos.vale (27723 in chips, $0.60 bounty) 
Seat 5: yazvauazva (5172 in chips, $0.24 bounty) 
Seat 6: HarvesterX (1218 in chips, $0.24 bounty) is sitting out
Seat 7: magatama16 (5960 in chips, $0.24 bounty) 
Seat 8: DartmanD1 (24819 in chips, $0.60 bounty) 
Seat 9: neris449 (9806 in chips, $0.48 bounty) 
foxyvanj: posts the ante 24
madmaddie92: posts the ante 24
Nukalex: posts the ante 24
jcarlos.vale: posts the ante 24
yazvauazva: posts the ante 24
HarvesterX: posts the ante 24
magatama16: posts the ante 24
DartmanD1: posts the ante 24
neris449: posts the ante 24
neris449: posts small blind 80
foxyvanj: posts big blind 160
*** HOLE CARDS ***
Dealt to jcarlos.vale [Qd 4h]
madmaddie92: folds 
Nukalex: raises 185 to 345
jcarlos.vale: folds 
yazvauazva: folds 
HarvesterX: folds 
magatama16: calls 345
DartmanD1: folds 
neris449: calls 265
foxyvanj: calls 185
*** FLOP *** [2h 8s 5d]
neris449: checks 
foxyvanj: checks 
Nukalex: checks 
magatama16: checks 
*** TURN *** [2h 8s 5d] [Qc]
neris449: checks 
foxyvanj: checks 
Nukalex: checks 
magatama16: bets 550
neris449: folds 
foxyvanj: calls 550
Nukalex: folds 
*** RIVER *** [2h 8s 5d Qc] [9c]
foxyvanj: checks 
magatama16: checks 
*** SHOW DOWN ***
foxyvanj: shows [9d 5c] (two pair, Nines and Fives)
magatama16: mucks handDTO
foxyvanj collected 2696 from pot
*** SUMMARY ***
Total pot 2696 | Rake 0 
Board [2h 8s 5d Qc 9c]
Seat 1: foxyvanj (big blind) showed [9d 5c] and won (2696) with two pair, Nines and Fives
Seat 2: madmaddie92 folded before Flop (didn't bet)
Seat 3: Nukalex folded on the Turn
Seat 4: jcarlos.vale folded before Flop (didn't bet)
Seat 5: yazvauazva folded before Flop (didn't bet)
Seat 6: HarvesterX folded before Flop (didn't bet)
Seat 7: magatama16 mucked [6h 5h]
Seat 8: DartmanD1 (button) folded before Flop (didn't bet)
Seat 9: neris449 (small blind) folded on the Turn



PokerStars Hand #221331375697: Tournament #3067368972, $0.25+$0.24+$0.06 USD Hold'em No Limit - Level XI (80/160) - 2020/12/11 20:49:00 EET [2020/12/11 13:49:00 ET]
Table '3067368972 323' 9-max Seat #9 is the button
Seat 1: foxyvanj (10565 in chips, $0.36 bounty) 
Seat 2: madmaddie92 (3092 in chips, $0.24 bounty) is sitting out
Seat 3: Nukalex (3392 in chips, $0.24 bounty) 
Seat 4: jcarlos.vale (27699 in chips, $0.60 bounty) 
Seat 5: yazvauazva (5148 in chips, $0.24 bounty) 
Seat 6: HarvesterX (1194 in chips, $0.24 bounty) is sitting out
Seat 7: magatama16 (5041 in chips, $0.24 bounty) 
Seat 8: DartmanD1 (24795 in chips, $0.60 bounty) 
Seat 9: neris449 (9437 in chips, $0.48 bounty) 
foxyvanj: posts the ante 24
madmaddie92: posts the ante 24
Nukalex: posts the ante 24
jcarlos.vale: posts the ante 24
yazvauazva: posts the ante 24
HarvesterX: posts the ante 24
magatama16: posts the ante 24
DartmanD1: posts the ante 24
neris449: posts the ante 24
foxyvanj: posts small blind 80
madmaddie92: posts big blind 160
*** HOLE CARDS ***
Dealt to jcarlos.vale [8h 6s]
Nukalex: folds 
jcarlos.vale: folds 
yazvauazva: raises 320 to 480
HarvesterX: folds 
magatama16: folds 
DartmanD1: calls 480
neris449: folds 
HarvesterX has returned
foxyvanj: calls 400
madmaddie92: folds 
*** FLOP *** [8s 2s 4h]
foxyvanj: checks 
yazvauazva: bets 960
DartmanD1: folds 
foxyvanj: calls 960
*** TURN *** [8s 2s 4h] [4d]
foxyvanj: checks 
yazvauazva: bets 3684 and is all-in
foxyvanj: calls 3684
*** RIVER *** [8s 2s 4h 4d] [9h]
*** SHOW DOWN ***
foxyvanj: shows [3d 3s] (two pair, Fours and Threes)
yazvauazva: shows [Ah As] (two pair, Aces and Fours)
yazvauazva collected 11104 from pot
*** SUMMARY ***
Total pot 11104 | Rake 0 
Board [8s 2s 4h 4d 9h]
Seat 1: foxyvanj (small blind) showed [3d 3s] and lost with two pair, Fours and Threes
Seat 2: madmaddie92 (big blind) folded before Flop
Seat 3: Nukalex folded before Flop (didn't bet)
Seat 4: jcarlos.vale folded before Flop (didn't bet)
Seat 5: yazvauazva showed [Ah As] and won (11104) with two pair, Aces and Fours
Seat 6: HarvesterX folded before Flop (didn't bet)
Seat 7: magatama16 folded before Flop (didn't bet)
Seat 8: DartmanD1 folded on the Flop
Seat 9: neris449 (button) folded before Flop (didn't bet)



PokerStars Hand #221331409990: Tournament #3067368972, $0.25+$0.24+$0.06 USD Hold'em No Limit - Level XI (80/160) - 2020/12/11 20:49:55 EET [2020/12/11 13:49:55 ET]
Table '3067368972 323' 9-max Seat #1 is the button
Seat 1: foxyvanj (5417 in chips, $0.36 bounty) 
Seat 2: madmaddie92 (2908 in chips, $0.24 bounty) is sitting out
Seat 3: Nukalex (3368 in chips, $0.24 bounty) 
Seat 4: jcarlos.vale (27675 in chips, $0.60 bounty) 
Seat 5: yazvauazva (11104 in chips, $0.24 bounty) 
Seat 6: HarvesterX (1170 in chips, $0.24 bounty) 
Seat 7: magatama16 (5017 in chips, $0.24 bounty) 
Seat 8: DartmanD1 (24291 in chips, $0.60 bounty) 
Seat 9: neris449 (9413 in chips, $0.48 bounty) 
foxyvanj: posts the ante 24
madmaddie92: posts the ante 24
Nukalex: posts the ante 24
jcarlos.vale: posts the ante 24
yazvauazva: posts the ante 24
HarvesterX: posts the ante 24
magatama16: posts the ante 24
DartmanD1: posts the ante 24
neris449: posts the ante 24
madmaddie92: posts small blind 80
Nukalex: posts big blind 160
*** HOLE CARDS ***
Dealt to jcarlos.vale [7s 5c]
jcarlos.vale: folds 
yazvauazva: folds 
HarvesterX: folds 
magatama16: folds 
DartmanD1: folds 
neris449: folds 
foxyvanj: folds 
madmaddie92: folds 
Uncalled bet (80) returned to Nukalex
Nukalex collected 376 from pot
Nukalex: doesn't show handDTO
*** SUMMARY ***
Total pot 376 | Rake 0 
Seat 1: foxyvanj (button) folded before Flop (didn't bet)
Seat 2: madmaddie92 (small blind) folded before Flop
Seat 3: Nukalex (big blind) collected (376)
Seat 4: jcarlos.vale folded before Flop (didn't bet)
Seat 5: yazvauazva folded before Flop (didn't bet)
Seat 6: HarvesterX folded before Flop (didn't bet)
Seat 7: magatama16 folded before Flop (didn't bet)
Seat 8: DartmanD1 folded before Flop (didn't bet)
Seat 9: neris449 folded before Flop (didn't bet)



PokerStars Hand #221331418937: Tournament #3067368972, $0.25+$0.24+$0.06 USD Hold'em No Limit - Level XI (80/160) - 2020/12/11 20:50:09 EET [2020/12/11 13:50:09 ET]
Table '3067368972 323' 9-max Seat #2 is the button
Seat 1: foxyvanj (5393 in chips, $0.36 bounty) 
Seat 2: madmaddie92 (2804 in chips, $0.24 bounty) is sitting out
Seat 3: Nukalex (3640 in chips, $0.24 bounty) 
Seat 4: jcarlos.vale (27651 in chips, $0.60 bounty) 
Seat 5: yazvauazva (11080 in chips, $0.24 bounty) 
Seat 6: HarvesterX (1146 in chips, $0.24 bounty) 
Seat 7: magatama16 (4993 in chips, $0.24 bounty) 
Seat 8: DartmanD1 (24267 in chips, $0.60 bounty) 
Seat 9: neris449 (9389 in chips, $0.48 bounty) 
foxyvanj: posts the ante 24
madmaddie92: posts the ante 24
Nukalex: posts the ante 24
jcarlos.vale: posts the ante 24
yazvauazva: posts the ante 24
HarvesterX: posts the ante 24
magatama16: posts the ante 24
DartmanD1: posts the ante 24
neris449: posts the ante 24
Nukalex: posts small blind 80
jcarlos.vale: posts big blind 160
*** HOLE CARDS ***
Dealt to jcarlos.vale [Jc As]
yazvauazva: folds 
HarvesterX: folds 
magatama16: folds 
DartmanD1: folds 
neris449: calls 160
foxyvanj: raises 5209 to 5369 and is all-in
madmaddie92: folds 
Nukalex: folds 
jcarlos.vale: folds 
neris449: folds 
Uncalled bet (5209) returned to foxyvanj
foxyvanj collected 776 from pot
foxyvanj: doesn't show handDTO
*** SUMMARY ***
Total pot 776 | Rake 0 
Seat 1: foxyvanj collected (776)
Seat 2: madmaddie92 (button) folded before Flop (didn't bet)
Seat 3: Nukalex (small blind) folded before Flop
Seat 4: jcarlos.vale (big blind) folded before Flop
Seat 5: yazvauazva folded before Flop (didn't bet)
Seat 6: HarvesterX folded before Flop (didn't bet)
Seat 7: magatama16 folded before Flop (didn't bet)
Seat 8: DartmanD1 folded before Flop (didn't bet)
Seat 9: neris449 folded before Flop



PokerStars Hand #221331442052: Tournament #3067368972, $0.25+$0.24+$0.06 USD Hold'em No Limit - Level XI (80/160) - 2020/12/11 20:50:47 EET [2020/12/11 13:50:47 ET]
Table '3067368972 323' 9-max Seat #3 is the button
Seat 1: foxyvanj (5985 in chips, $0.36 bounty) 
Seat 2: madmaddie92 (2780 in chips, $0.24 bounty) is sitting out
Seat 3: Nukalex (3536 in chips, $0.24 bounty) 
Seat 4: jcarlos.vale (27467 in chips, $0.60 bounty) 
Seat 5: yazvauazva (11056 in chips, $0.24 bounty) 
Seat 6: HarvesterX (1122 in chips, $0.24 bounty) 
Seat 7: magatama16 (4969 in chips, $0.24 bounty) 
Seat 8: DartmanD1 (24243 in chips, $0.60 bounty) 
Seat 9: neris449 (9205 in chips, $0.48 bounty) 
foxyvanj: posts the ante 24
madmaddie92: posts the ante 24
Nukalex: posts the ante 24
jcarlos.vale: posts the ante 24
yazvauazva: posts the ante 24
HarvesterX: posts the ante 24
magatama16: posts the ante 24
DartmanD1: posts the ante 24
neris449: posts the ante 24
jcarlos.vale: posts small blind 80
yazvauazva: posts big blind 160
*** HOLE CARDS ***
Dealt to jcarlos.vale [As Jc]
HarvesterX: calls 160
magatama16: folds 
DartmanD1: folds 
neris449: calls 160
foxyvanj: folds 
madmaddie92: folds 
Nukalex: folds 
jcarlos.vale: raises 256 to 416
yazvauazva: folds 
HarvesterX: folds 
neris449: calls 256
*** FLOP *** [Ah 5h 8d]
jcarlos.vale: bets 1026
neris449: raises 3420 to 4446
jcarlos.vale: raises 22581 to 27027 and is all-in
neris449: calls 4319 and is all-in
Uncalled bet (18262) returned to jcarlos.vale
*** TURN *** [Ah 5h 8d] [Ts]
*** RIVER *** [Ah 5h 8d Ts] [3c]
*** SHOW DOWN ***
jcarlos.vale: shows [As Jc] (a pair of Aces)
neris449: shows [5s Ad] (two pair, Aces and Fives)
neris449 collected 18898 from pot
*** SUMMARY ***
Total pot 18898 | Rake 0 
Board [Ah 5h 8d Ts 3c]
Seat 1: foxyvanj folded before Flop (didn't bet)
Seat 2: madmaddie92 folded before Flop (didn't bet)
Seat 3: Nukalex (button) folded before Flop (didn't bet)
Seat 4: jcarlos.vale (small blind) showed [As Jc] and lost with a pair of Aces
Seat 5: yazvauazva (big blind) folded before Flop
Seat 6: HarvesterX folded before Flop
Seat 7: magatama16 folded before Flop (didn't bet)
Seat 8: DartmanD1 folded before Flop (didn't bet)
Seat 9: neris449 showed [5s Ad] and won (18898) with two pair, Aces and Fives



PokerStars Hand #221331475559: Tournament #3067368972, $0.25+$0.24+$0.06 USD Hold'em No Limit - Level XI (80/160) - 2020/12/11 20:51:41 EET [2020/12/11 13:51:41 ET]
Table '3067368972 323' 9-max Seat #4 is the button
Seat 1: foxyvanj (5961 in chips, $0.36 bounty) 
Seat 2: madmaddie92 (2756 in chips, $0.24 bounty) is sitting out
Seat 3: Nukalex (3512 in chips, $0.24 bounty) 
Seat 4: jcarlos.vale (18262 in chips, $0.60 bounty) 
Seat 5: yazvauazva (10872 in chips, $0.24 bounty) 
Seat 6: HarvesterX (938 in chips, $0.24 bounty) 
Seat 7: magatama16 (4945 in chips, $0.24 bounty) 
Seat 8: DartmanD1 (24219 in chips, $0.60 bounty) 
Seat 9: neris449 (18898 in chips, $0.48 bounty) 
foxyvanj: posts the ante 24
madmaddie92: posts the ante 24
Nukalex: posts the ante 24
jcarlos.vale: posts the ante 24
yazvauazva: posts the ante 24
HarvesterX: posts the ante 24
magatama16: posts the ante 24
DartmanD1: posts the ante 24
neris449: posts the ante 24
yazvauazva: posts small blind 80
HarvesterX: posts big blind 160
*** HOLE CARDS ***
Dealt to jcarlos.vale [Ac Jd]
magatama16: folds 
DartmanD1: folds 
neris449: calls 160
foxyvanj: folds 
madmaddie92: folds 
Nukalex: folds 
jcarlos.vale: calls 160
yazvauazva: folds 
HarvesterX: checks 
*** FLOP *** [3c 9d 3d]
HarvesterX: checks 
neris449: checks 
jcarlos.vale: bets 582
HarvesterX: folds 
neris449: folds 
Uncalled bet (582) returned to jcarlos.vale
jcarlos.vale collected 776 from pot
jcarlos.vale: doesn't show handDTO
*** SUMMARY ***
Total pot 776 | Rake 0 
Board [3c 9d 3d]
Seat 1: foxyvanj folded before Flop (didn't bet)
Seat 2: madmaddie92 folded before Flop (didn't bet)
Seat 3: Nukalex folded before Flop (didn't bet)
Seat 4: jcarlos.vale (button) collected (776)
Seat 5: yazvauazva (small blind) folded before Flop
Seat 6: HarvesterX (big blind) folded on the Flop
Seat 7: magatama16 folded before Flop (didn't bet)
Seat 8: DartmanD1 folded before Flop (didn't bet)
Seat 9: neris449 folded on the Flop



PokerStars Hand #221331505490: Tournament #3067368972, $0.25+$0.24+$0.06 USD Hold'em No Limit - Level XI (80/160) - 2020/12/11 20:52:29 EET [2020/12/11 13:52:29 ET]
Table '3067368972 323' 9-max Seat #5 is the button
Seat 1: foxyvanj (5937 in chips, $0.36 bounty) 
Seat 2: madmaddie92 (2732 in chips, $0.24 bounty) is sitting out
Seat 3: Nukalex (3488 in chips, $0.24 bounty) 
Seat 4: jcarlos.vale (18854 in chips, $0.60 bounty) 
Seat 5: yazvauazva (10768 in chips, $0.24 bounty) 
Seat 6: HarvesterX (754 in chips, $0.24 bounty) 
Seat 7: magatama16 (4921 in chips, $0.24 bounty) 
Seat 8: DartmanD1 (24195 in chips, $0.60 bounty) 
Seat 9: neris449 (18714 in chips, $0.48 bounty) 
foxyvanj: posts the ante 24
madmaddie92: posts the ante 24
Nukalex: posts the ante 24
jcarlos.vale: posts the ante 24
yazvauazva: posts the ante 24
HarvesterX: posts the ante 24
magatama16: posts the ante 24
DartmanD1: posts the ante 24
neris449: posts the ante 24
HarvesterX: posts small blind 80
magatama16: posts big blind 160
*** HOLE CARDS ***
Dealt to jcarlos.vale [Jh 5d]
DartmanD1: folds 
neris449: calls 160
foxyvanj: raises 480 to 640
madmaddie92: folds 
Nukalex: folds 
jcarlos.vale: folds 
yazvauazva: folds 
HarvesterX: raises 90 to 730 and is all-in
magatama16: folds 
neris449: calls 570
foxyvanj: calls 90
*** FLOP *** [2s 3s 9s]
neris449: bets 2566
foxyvanj: raises 2617 to 5183 and is all-in
neris449: calls 2617
*** TURN *** [2s 3s 9s] [5c]
*** RIVER *** [2s 3s 9s 5c] [Tc]
*** SHOW DOWN ***
neris449: shows [Jd 9c] (a pair of Nines)
foxyvanj: shows [As Ad] (a pair of Aces)
foxyvanj collected 10366 from side pot
HarvesterX: shows [Qh Qc] (a pair of Queens)
foxyvanj collected 2566 from main pot
foxyvanj wins $0.12 for eliminating HarvesterX and their own bounty increases by $0.12 to $0.48
HarvesterX finished the tournament
*** SUMMARY ***
Total pot 12932 Main pot 2566. Side pot 10366. | Rake 0 
Board [2s 3s 9s 5c Tc]
Seat 1: foxyvanj showed [As Ad] and won (12932) with a pair of Aces
Seat 2: madmaddie92 folded before Flop (didn't bet)
Seat 3: Nukalex folded before Flop (didn't bet)
Seat 4: jcarlos.vale folded before Flop (didn't bet)
Seat 5: yazvauazva (button) folded before Flop (didn't bet)
Seat 6: HarvesterX (small blind) showed [Qh Qc] and lost with a pair of Queens
Seat 7: magatama16 (big blind) folded before Flop
Seat 8: DartmanD1 folded before Flop (didn't bet)
Seat 9: neris449 showed [Jd 9c] and lost with a pair of Nines



PokerStars Hand #221331535229: Tournament #3067368972, $0.25+$0.24+$0.06 USD Hold'em No Limit - Level XI (80/160) - 2020/12/11 20:53:18 EET [2020/12/11 13:53:18 ET]
Table '3067368972 323' 9-max Seat #7 is the button
Seat 1: foxyvanj (12932 in chips, $0.48 bounty) 
Seat 2: madmaddie92 (2708 in chips, $0.24 bounty) is sitting out
Seat 3: Nukalex (3464 in chips, $0.24 bounty) 
Seat 4: jcarlos.vale (18830 in chips, $0.60 bounty) 
Seat 5: yazvauazva (10744 in chips, $0.24 bounty) 
Seat 7: magatama16 (4737 in chips, $0.24 bounty) 
Seat 8: DartmanD1 (24171 in chips, $0.60 bounty) 
Seat 9: neris449 (12777 in chips, $0.48 bounty) 
foxyvanj: posts the ante 24
madmaddie92: posts the ante 24
Nukalex: posts the ante 24
jcarlos.vale: posts the ante 24
yazvauazva: posts the ante 24
magatama16: posts the ante 24
DartmanD1: posts the ante 24
neris449: posts the ante 24
DartmanD1: posts small blind 80
neris449: posts big blind 160
*** HOLE CARDS ***
Dealt to jcarlos.vale [6h 5d]
foxyvanj: calls 160
madmaddie92: folds 
Nukalex: folds 
jcarlos.vale: folds 
yazvauazva: folds 
magatama16: folds 
DartmanD1: calls 80
neris449: checks 
*** FLOP *** [Jc 2h 7c]
DartmanD1: checks 
neris449: bets 160
foxyvanj: calls 160
DartmanD1: calls 160
*** TURN *** [Jc 2h 7c] [4h]
DartmanD1: checks 
neris449: bets 1152
foxyvanj: calls 1152
DartmanD1: calls 1152
*** RIVER *** [Jc 2h 7c 4h] [Ts]
DartmanD1: checks 
neris449: bets 4608
foxyvanj: folds 
DartmanD1: folds 
Uncalled bet (4608) returned to neris449
neris449 collected 4608 from pot
neris449: doesn't show handDTO
*** SUMMARY ***
Total pot 4608 | Rake 0 
Board [Jc 2h 7c 4h Ts]
Seat 1: foxyvanj folded on the River
Seat 2: madmaddie92 folded before Flop (didn't bet)
Seat 3: Nukalex folded before Flop (didn't bet)
Seat 4: jcarlos.vale folded before Flop (didn't bet)
Seat 5: yazvauazva folded before Flop (didn't bet)
Seat 7: magatama16 (button) folded before Flop (didn't bet)
Seat 8: DartmanD1 (small blind) folded on the River
Seat 9: neris449 (big blind) collected (4608)



PokerStars Hand #221331576070: Tournament #3067368972, $0.25+$0.24+$0.06 USD Hold'em No Limit - Level XI (80/160) - 2020/12/11 20:54:24 EET [2020/12/11 13:54:24 ET]
Table '3067368972 323' 9-max Seat #8 is the button
Seat 1: foxyvanj (11436 in chips, $0.48 bounty) 
Seat 2: madmaddie92 (2684 in chips, $0.24 bounty) is sitting out
Seat 3: Nukalex (3440 in chips, $0.24 bounty) 
Seat 4: jcarlos.vale (18806 in chips, $0.60 bounty) 
Seat 5: yazvauazva (10720 in chips, $0.24 bounty) 
Seat 6: XottaBb14 (5000 in chips, $0.24 bounty) 
Seat 7: magatama16 (4713 in chips, $0.24 bounty) 
Seat 8: DartmanD1 (22675 in chips, $0.60 bounty) 
Seat 9: neris449 (15889 in chips, $0.48 bounty) 
foxyvanj: posts the ante 24
madmaddie92: posts the ante 24
Nukalex: posts the ante 24
jcarlos.vale: posts the ante 24
yazvauazva: posts the ante 24
XottaBb14: posts the ante 24
magatama16: posts the ante 24
DartmanD1: posts the ante 24
neris449: posts the ante 24
neris449: posts small blind 80
foxyvanj: posts big blind 160
*** HOLE CARDS ***
Dealt to jcarlos.vale [Jh 5h]
madmaddie92: folds 
Nukalex: folds 
jcarlos.vale: folds 
yazvauazva: folds 
XottaBb14: folds 
magatama16: raises 320 to 480
DartmanD1: folds 
neris449: folds 
foxyvanj: calls 320
*** FLOP *** [8d 5d 9d]
foxyvanj: bets 10932 and is all-in
magatama16: folds 
Uncalled bet (10932) returned to foxyvanj
foxyvanj collected 1256 from pot
foxyvanj: doesn't show handDTO
*** SUMMARY ***
Total pot 1256 | Rake 0 
Board [8d 5d 9d]
Seat 1: foxyvanj (big blind) collected (1256)
Seat 2: madmaddie92 folded before Flop (didn't bet)
Seat 3: Nukalex folded before Flop (didn't bet)
Seat 4: jcarlos.vale folded before Flop (didn't bet)
Seat 5: yazvauazva folded before Flop (didn't bet)
Seat 6: XottaBb14 folded before Flop (didn't bet)
Seat 7: magatama16 folded on the Flop
Seat 8: DartmanD1 (button) folded before Flop (didn't bet)
Seat 9: neris449 (small blind) folded before Flop



PokerStars Hand #221331858059: Tournament #3067368972, $0.25+$0.24+$0.06 USD Hold'em No Limit - Level XII (90/180) - 2020/12/11 21:03:00 EET [2020/12/11 14:03:00 ET]
Table '3067368972 323' 9-max Seat #9 is the button
Seat 1: foxyvanj (12188 in chips, $0.48 bounty) 
Seat 2: madmaddie92 (2660 in chips, $0.24 bounty) is sitting out
Seat 3: Nukalex (3416 in chips, $0.24 bounty) 
Seat 4: jcarlos.vale (18782 in chips, $0.60 bounty) 
Seat 5: yazvauazva (10696 in chips, $0.24 bounty) 
Seat 6: XottaBb14 (4976 in chips, $0.24 bounty) 
Seat 7: magatama16 (4209 in chips, $0.24 bounty) is sitting out
Seat 8: DartmanD1 (22651 in chips, $0.60 bounty) 
Seat 9: neris449 (15785 in chips, $0.48 bounty) 
foxyvanj: posts the ante 27
madmaddie92: posts the ante 27
Nukalex: posts the ante 27
jcarlos.vale: posts the ante 27
yazvauazva: posts the ante 27
XottaBb14: posts the ante 27
magatama16: posts the ante 27
DartmanD1: posts the ante 27
neris449: posts the ante 27
foxyvanj: posts small blind 90
madmaddie92: posts big blind 180
*** HOLE CARDS ***
Dealt to jcarlos.vale [8h As]
Nukalex: folds 
jcarlos.vale: folds 
yazvauazva: folds 
XottaBb14: folds 
magatama16: folds 
DartmanD1: raises 360 to 540
neris449: folds 
foxyvanj: folds 
madmaddie92: folds 
Uncalled bet (360) returned to DartmanD1
DartmanD1 collected 693 from pot
*** SUMMARY ***
Total pot 693 | Rake 0 
Seat 1: foxyvanj (small blind) folded before Flop
Seat 2: madmaddie92 (big blind) folded before Flop
Seat 3: Nukalex folded before Flop (didn't bet)
Seat 4: jcarlos.vale folded before Flop (didn't bet)
Seat 5: yazvauazva folded before Flop (didn't bet)
Seat 6: XottaBb14 folded before Flop (didn't bet)
Seat 7: magatama16 folded before Flop (didn't bet)
Seat 8: DartmanD1 collected (693)
Seat 9: neris449 (button) folded before Flop (didn't bet)



PokerStars Hand #221331878439: Tournament #3067368972, $0.25+$0.24+$0.06 USD Hold'em No Limit - Level XII (90/180) - 2020/12/11 21:03:32 EET [2020/12/11 14:03:32 ET]
Table '3067368972 323' 9-max Seat #1 is the button
Seat 1: foxyvanj (12071 in chips, $0.48 bounty) 
Seat 2: madmaddie92 (2453 in chips, $0.24 bounty) is sitting out
Seat 4: jcarlos.vale (18755 in chips, $0.60 bounty) 
Seat 5: yazvauazva (10669 in chips, $0.24 bounty) 
Seat 6: XottaBb14 (4949 in chips, $0.24 bounty) 
Seat 7: magatama16 (4182 in chips, $0.24 bounty) is sitting out
Seat 8: DartmanD1 (23137 in chips, $0.60 bounty) 
Seat 9: neris449 (15758 in chips, $0.48 bounty) 
foxyvanj: posts the ante 27
madmaddie92: posts the ante 27
jcarlos.vale: posts the ante 27
yazvauazva: posts the ante 27
XottaBb14: posts the ante 27
magatama16: posts the ante 27
DartmanD1: posts the ante 27
neris449: posts the ante 27
madmaddie92: posts small blind 90
jcarlos.vale: posts big blind 180
*** HOLE CARDS ***
Dealt to jcarlos.vale [7h 8c]
yazvauazva: folds 
XottaBb14: folds 
magatama16: folds 
DartmanD1: calls 180
neris449: calls 180
foxyvanj: folds 
madmaddie92: folds 
jcarlos.vale: checks 
*** FLOP *** [3c 9c Kh]
magatama16 has returned
jcarlos.vale: checks 
DartmanD1: bets 360
neris449: calls 360
jcarlos.vale: folds 
*** TURN *** [3c 9c Kh] [Qs]
DartmanD1: bets 540
neris449: folds 
Uncalled bet (540) returned to DartmanD1
DartmanD1 collected 1566 from pot
*** SUMMARY ***
Total pot 1566 | Rake 0 
Board [3c 9c Kh Qs]
Seat 1: foxyvanj (button) folded before Flop (didn't bet)
Seat 2: madmaddie92 (small blind) folded before Flop
Seat 4: jcarlos.vale (big blind) folded on the Flop
Seat 5: yazvauazva folded before Flop (didn't bet)
Seat 6: XottaBb14 folded before Flop (didn't bet)
Seat 7: magatama16 folded before Flop (didn't bet)
Seat 8: DartmanD1 collected (1566)
Seat 9: neris449 folded on the Turn



PokerStars Hand #221331912567: Tournament #3067368972, $0.25+$0.24+$0.06 USD Hold'em No Limit - Level XII (90/180) - 2020/12/11 21:04:25 EET [2020/12/11 14:04:25 ET]
Table '3067368972 323' 9-max Seat #2 is the button
Seat 1: foxyvanj (12044 in chips, $0.48 bounty) 
Seat 2: madmaddie92 (2336 in chips, $0.24 bounty) is sitting out
Seat 4: jcarlos.vale (18548 in chips, $0.60 bounty) 
Seat 5: yazvauazva (10642 in chips, $0.24 bounty) 
Seat 6: XottaBb14 (4922 in chips, $0.24 bounty) 
Seat 7: magatama16 (4155 in chips, $0.24 bounty) 
Seat 8: DartmanD1 (24136 in chips, $0.60 bounty) 
Seat 9: neris449 (15191 in chips, $0.48 bounty) 
foxyvanj: posts the ante 27
madmaddie92: posts the ante 27
jcarlos.vale: posts the ante 27
yazvauazva: posts the ante 27
XottaBb14: posts the ante 27
magatama16: posts the ante 27
DartmanD1: posts the ante 27
neris449: posts the ante 27
jcarlos.vale: posts small blind 90
yazvauazva: posts big blind 180
*** HOLE CARDS ***
Dealt to jcarlos.vale [Th Qc]
XottaBb14: folds 
magatama16: folds 
DartmanD1: folds 
neris449: folds 
foxyvanj: folds 
madmaddie92: folds 
jcarlos.vale: calls 90
yazvauazva: checks 
*** FLOP *** [Qd 6s Kc]
jcarlos.vale: bets 360
yazvauazva: folds 
Uncalled bet (360) returned to jcarlos.vale
jcarlos.vale collected 576 from pot
jcarlos.vale: doesn't show handDTO
*** SUMMARY ***
Total pot 576 | Rake 0 
Board [Qd 6s Kc]
Seat 1: foxyvanj folded before Flop (didn't bet)
Seat 2: madmaddie92 (button) folded before Flop (didn't bet)
Seat 4: jcarlos.vale (small blind) collected (576)
Seat 5: yazvauazva (big blind) folded on the Flop
Seat 6: XottaBb14 folded before Flop (didn't bet)
Seat 7: magatama16 folded before Flop (didn't bet)
Seat 8: DartmanD1 folded before Flop (didn't bet)
Seat 9: neris449 folded before Flop (didn't bet)



PokerStars Hand #221331936344: Tournament #3067368972, $0.25+$0.24+$0.06 USD Hold'em No Limit - Level XII (90/180) - 2020/12/11 21:05:01 EET [2020/12/11 14:05:01 ET]
Table '3067368972 323' 9-max Seat #4 is the button
Seat 1: foxyvanj (12017 in chips, $0.48 bounty) 
Seat 2: madmaddie92 (2309 in chips, $0.24 bounty) is sitting out
Seat 4: jcarlos.vale (18917 in chips, $0.60 bounty) 
Seat 5: yazvauazva (10435 in chips, $0.24 bounty) 
Seat 6: XottaBb14 (4895 in chips, $0.24 bounty) 
Seat 7: magatama16 (4128 in chips, $0.24 bounty) 
Seat 8: DartmanD1 (24109 in chips, $0.60 bounty) 
Seat 9: neris449 (15164 in chips, $0.48 bounty) 
foxyvanj: posts the ante 27
madmaddie92: posts the ante 27
jcarlos.vale: posts the ante 27
yazvauazva: posts the ante 27
XottaBb14: posts the ante 27
magatama16: posts the ante 27
DartmanD1: posts the ante 27
neris449: posts the ante 27
yazvauazva: posts small blind 90
XottaBb14: posts big blind 180
*** HOLE CARDS ***
Dealt to jcarlos.vale [6c Js]
magatama16: folds 
DartmanD1: folds 
neris449: calls 180
foxyvanj: folds 
madmaddie92: folds 
jcarlos.vale: folds 
yazvauazva: folds 
XottaBb14: checks 
*** FLOP *** [Jc Kh 2h]
XottaBb14: checks 
neris449: bets 333
XottaBb14: folds 
Uncalled bet (333) returned to neris449
neris449 collected 666 from pot
neris449: doesn't show handDTO
*** SUMMARY ***
Total pot 666 | Rake 0 
Board [Jc Kh 2h]
Seat 1: foxyvanj folded before Flop (didn't bet)
Seat 2: madmaddie92 folded before Flop (didn't bet)
Seat 4: jcarlos.vale (button) folded before Flop (didn't bet)
Seat 5: yazvauazva (small blind) folded before Flop
Seat 6: XottaBb14 (big blind) folded on the Flop
Seat 7: magatama16 folded before Flop (didn't bet)
Seat 8: DartmanD1 folded before Flop (didn't bet)
Seat 9: neris449 collected (666)



PokerStars Hand #221331962254: Tournament #3067368972, $0.25+$0.24+$0.06 USD Hold'em No Limit - Level XII (90/180) - 2020/12/11 21:05:41 EET [2020/12/11 14:05:41 ET]
Table '3067368972 323' 9-max Seat #5 is the button
Seat 1: foxyvanj (11990 in chips, $0.48 bounty) 
Seat 2: madmaddie92 (2282 in chips, $0.24 bounty) is sitting out
Seat 4: jcarlos.vale (18890 in chips, $0.60 bounty) 
Seat 5: yazvauazva (10318 in chips, $0.24 bounty) 
Seat 6: XottaBb14 (4688 in chips, $0.24 bounty) 
Seat 7: magatama16 (4101 in chips, $0.24 bounty) 
Seat 8: DartmanD1 (24082 in chips, $0.60 bounty) 
Seat 9: neris449 (15623 in chips, $0.48 bounty) 
foxyvanj: posts the ante 27
madmaddie92: posts the ante 27
jcarlos.vale: posts the ante 27
yazvauazva: posts the ante 27
XottaBb14: posts the ante 27
magatama16: posts the ante 27
DartmanD1: posts the ante 27
neris449: posts the ante 27
XottaBb14: posts small blind 90
magatama16: posts big blind 180
*** HOLE CARDS ***
Dealt to jcarlos.vale [9s Kd]
DartmanD1: raises 270 to 450
neris449: folds 
foxyvanj: calls 450
madmaddie92: folds 
jcarlos.vale: folds 
yazvauazva: folds 
XottaBb14: folds 
magatama16: folds 
*** FLOP *** [6s 5c 3c]
DartmanD1: checks 
foxyvanj: checks 
*** TURN *** [6s 5c 3c] [Ad]
DartmanD1: bets 693
foxyvanj: folds 
Uncalled bet (693) returned to DartmanD1
DartmanD1 collected 1386 from pot
*** SUMMARY ***
Total pot 1386 | Rake 0 
Board [6s 5c 3c Ad]
Seat 1: foxyvanj folded on the Turn
Seat 2: madmaddie92 folded before Flop (didn't bet)
Seat 4: jcarlos.vale folded before Flop (didn't bet)
Seat 5: yazvauazva (button) folded before Flop (didn't bet)
Seat 6: XottaBb14 (small blind) folded before Flop
Seat 7: magatama16 (big blind) folded before Flop
Seat 8: DartmanD1 collected (1386)
Seat 9: neris449 folded before Flop (didn't bet)



PokerStars Hand #221331988814: Tournament #3067368972, $0.25+$0.24+$0.06 USD Hold'em No Limit - Level XII (90/180) - 2020/12/11 21:06:23 EET [2020/12/11 14:06:23 ET]
Table '3067368972 323' 9-max Seat #6 is the button
Seat 1: foxyvanj (11513 in chips, $0.48 bounty) 
Seat 2: madmaddie92 (2255 in chips, $0.24 bounty) is sitting out
Seat 3: oleg 1011 (5000 in chips, $0.24 bounty) 
Seat 4: jcarlos.vale (18863 in chips, $0.60 bounty) 
Seat 5: yazvauazva (10291 in chips, $0.24 bounty) 
Seat 6: XottaBb14 (4571 in chips, $0.24 bounty) 
Seat 7: magatama16 (3894 in chips, $0.24 bounty) 
Seat 8: DartmanD1 (24991 in chips, $0.60 bounty) 
Seat 9: neris449 (15596 in chips, $0.48 bounty) 
foxyvanj: posts the ante 27
madmaddie92: posts the ante 27
oleg 1011: posts the ante 27
jcarlos.vale: posts the ante 27
yazvauazva: posts the ante 27
XottaBb14: posts the ante 27
magatama16: posts the ante 27
DartmanD1: posts the ante 27
neris449: posts the ante 27
magatama16: posts small blind 90
DartmanD1: posts big blind 180
*** HOLE CARDS ***
Dealt to jcarlos.vale [8d 7h]
neris449: calls 180
foxyvanj: folds 
madmaddie92: folds 
oleg 1011: folds 
jcarlos.vale: folds 
yazvauazva: folds 
XottaBb14: folds 
magatama16: calls 90
DartmanD1: checks 
*** FLOP *** [3d Tc 8h]
magatama16: checks 
DartmanD1: bets 180
neris449: calls 180
magatama16: folds 
*** TURN *** [3d Tc 8h] [9d]
DartmanD1: bets 360
neris449: calls 360
*** RIVER *** [3d Tc 8h 9d] [Ah]
DartmanD1: checks 
neris449: bets 932
DartmanD1: folds 
Uncalled bet (932) returned to neris449
neris449 collected 1863 from pot
neris449: doesn't show handDTO
*** SUMMARY ***
Total pot 1863 | Rake 0 
Board [3d Tc 8h 9d Ah]
Seat 1: foxyvanj folded before Flop (didn't bet)
Seat 2: madmaddie92 folded before Flop (didn't bet)
Seat 3: oleg 1011 folded before Flop (didn't bet)
Seat 4: jcarlos.vale folded before Flop (didn't bet)
Seat 5: yazvauazva folded before Flop (didn't bet)
Seat 6: XottaBb14 (button) folded before Flop (didn't bet)
Seat 7: magatama16 (small blind) folded on the Flop
Seat 8: DartmanD1 (big blind) folded on the River
Seat 9: neris449 collected (1863)



PokerStars Hand #221332040113: Tournament #3067368972, $0.25+$0.24+$0.06 USD Hold'em No Limit - Level XII (90/180) - 2020/12/11 21:07:42 EET [2020/12/11 14:07:42 ET]
Table '3067368972 323' 9-max Seat #7 is the button
Seat 1: foxyvanj (11486 in chips, $0.48 bounty) 
Seat 2: madmaddie92 (2228 in chips, $0.24 bounty) is sitting out
Seat 3: oleg 1011 (4973 in chips, $0.24 bounty) 
Seat 4: jcarlos.vale (18836 in chips, $0.60 bounty) 
Seat 5: yazvauazva (10264 in chips, $0.24 bounty) 
Seat 6: XottaBb14 (4544 in chips, $0.24 bounty) 
Seat 7: magatama16 (3687 in chips, $0.24 bounty) 
Seat 8: DartmanD1 (24244 in chips, $0.60 bounty) 
Seat 9: neris449 (16712 in chips, $0.48 bounty) 
foxyvanj: posts the ante 27
madmaddie92: posts the ante 27
oleg 1011: posts the ante 27
jcarlos.vale: posts the ante 27
yazvauazva: posts the ante 27
XottaBb14: posts the ante 27
magatama16: posts the ante 27
DartmanD1: posts the ante 27
neris449: posts the ante 27
DartmanD1: posts small blind 90
neris449: posts big blind 180
*** HOLE CARDS ***
Dealt to jcarlos.vale [5c 8c]
foxyvanj: folds 
madmaddie92: folds 
oleg 1011: folds 
jcarlos.vale: folds 
yazvauazva: folds 
XottaBb14: folds 
magatama16: folds 
DartmanD1: folds 
Uncalled bet (90) returned to neris449
neris449 collected 423 from pot
neris449: doesn't show handDTO
*** SUMMARY ***
Total pot 423 | Rake 0 
Seat 1: foxyvanj folded before Flop (didn't bet)
Seat 2: madmaddie92 folded before Flop (didn't bet)
Seat 3: oleg 1011 folded before Flop (didn't bet)
Seat 4: jcarlos.vale folded before Flop (didn't bet)
Seat 5: yazvauazva folded before Flop (didn't bet)
Seat 6: XottaBb14 folded before Flop (didn't bet)
Seat 7: magatama16 (button) folded before Flop (didn't bet)
Seat 8: DartmanD1 (small blind) folded before Flop
Seat 9: neris449 (big blind) collected (423)



PokerStars Hand #221332064468: Tournament #3067368972, $0.25+$0.24+$0.06 USD Hold'em No Limit - Level XII (90/180) - 2020/12/11 21:08:20 EET [2020/12/11 14:08:20 ET]
Table '3067368972 323' 9-max Seat #8 is the button
Seat 1: foxyvanj (11459 in chips, $0.48 bounty) 
Seat 2: madmaddie92 (2201 in chips, $0.24 bounty) is sitting out
Seat 3: oleg 1011 (4946 in chips, $0.24 bounty) 
Seat 4: jcarlos.vale (18809 in chips, $0.60 bounty) 
Seat 5: yazvauazva (10237 in chips, $0.24 bounty) 
Seat 6: XottaBb14 (4517 in chips, $0.24 bounty) 
Seat 7: magatama16 (3660 in chips, $0.24 bounty) 
Seat 8: DartmanD1 (24127 in chips, $0.60 bounty) 
Seat 9: neris449 (17018 in chips, $0.48 bounty) 
foxyvanj: posts the ante 27
madmaddie92: posts the ante 27
oleg 1011: posts the ante 27
jcarlos.vale: posts the ante 27
yazvauazva: posts the ante 27
XottaBb14: posts the ante 27
magatama16: posts the ante 27
DartmanD1: posts the ante 27
neris449: posts the ante 27
neris449: posts small blind 90
foxyvanj: posts big blind 180
*** HOLE CARDS ***
Dealt to jcarlos.vale [8d 8s]
madmaddie92: folds 
oleg 1011: folds 
jcarlos.vale: raises 288 to 468
yazvauazva: folds 
XottaBb14: folds 
magatama16: folds 
DartmanD1: calls 468
neris449: folds 
foxyvanj: folds 
*** FLOP *** [Tc 9d Kh]
jcarlos.vale: bets 725
DartmanD1: calls 725
*** TURN *** [Tc 9d Kh] [7h]
jcarlos.vale: bets 720
DartmanD1: calls 720
*** RIVER *** [Tc 9d Kh 7h] [2h]
jcarlos.vale: checks 
DartmanD1: checks 
*** SHOW DOWN ***
jcarlos.vale: shows [8d 8s] (a pair of Eights)
DartmanD1: shows [Td Qs] (a pair of Tens)
DartmanD1 collected 4339 from pot
*** SUMMARY ***
Total pot 4339 | Rake 0 
Board [Tc 9d Kh 7h 2h]
Seat 1: foxyvanj (big blind) folded before Flop
Seat 2: madmaddie92 folded before Flop (didn't bet)
Seat 3: oleg 1011 folded before Flop (didn't bet)
Seat 4: jcarlos.vale showed [8d 8s] and lost with a pair of Eights
Seat 5: yazvauazva folded before Flop (didn't bet)
Seat 6: XottaBb14 folded before Flop (didn't bet)
Seat 7: magatama16 folded before Flop (didn't bet)
Seat 8: DartmanD1 (button) showed [Td Qs] and won (4339) with a pair of Tens
Seat 9: neris449 (small blind) folded before Flop



PokerStars Hand #221332103439: Tournament #3067368972, $0.25+$0.24+$0.06 USD Hold'em No Limit - Level XII (90/180) - 2020/12/11 21:09:21 EET [2020/12/11 14:09:21 ET]
Table '3067368972 323' 9-max Seat #9 is the button
Seat 1: foxyvanj (11252 in chips, $0.48 bounty) 
Seat 2: madmaddie92 (2174 in chips, $0.24 bounty) is sitting out
Seat 3: oleg 1011 (4919 in chips, $0.24 bounty) 
Seat 4: jcarlos.vale (16869 in chips, $0.60 bounty) 
Seat 5: yazvauazva (10210 in chips, $0.24 bounty) 
Seat 6: XottaBb14 (4490 in chips, $0.24 bounty) 
Seat 7: magatama16 (3633 in chips, $0.24 bounty) 
Seat 8: DartmanD1 (26526 in chips, $0.60 bounty) 
Seat 9: neris449 (16901 in chips, $0.48 bounty) 
foxyvanj: posts the ante 27
madmaddie92: posts the ante 27
oleg 1011: posts the ante 27
jcarlos.vale: posts the ante 27
yazvauazva: posts the ante 27
XottaBb14: posts the ante 27
magatama16: posts the ante 27
DartmanD1: posts the ante 27
neris449: posts the ante 27
foxyvanj: posts small blind 90
madmaddie92: posts big blind 180
*** HOLE CARDS ***
Dealt to jcarlos.vale [3d Jh]
oleg 1011: folds 
jcarlos.vale: folds 
yazvauazva: folds 
XottaBb14: folds 
magatama16: folds 
DartmanD1: folds 
neris449: calls 180
foxyvanj: calls 90
madmaddie92: folds 
*** FLOP *** [Kh 7h 6c]
foxyvanj: checks 
neris449: checks 
*** TURN *** [Kh 7h 6c] [Jc]
foxyvanj: checks 
neris449: checks 
*** RIVER *** [Kh 7h 6c Jc] [Qc]
foxyvanj: checks 
neris449: bets 180
foxyvanj: folds 
Uncalled bet (180) returned to neris449
neris449 collected 783 from pot
neris449: doesn't show handDTO
*** SUMMARY ***
Total pot 783 | Rake 0 
Board [Kh 7h 6c Jc Qc]
Seat 1: foxyvanj (small blind) folded on the River
Seat 2: madmaddie92 (big blind) folded before Flop
Seat 3: oleg 1011 folded before Flop (didn't bet)
Seat 4: jcarlos.vale folded before Flop (didn't bet)
Seat 5: yazvauazva folded before Flop (didn't bet)
Seat 6: XottaBb14 folded before Flop (didn't bet)
Seat 7: magatama16 folded before Flop (didn't bet)
Seat 8: DartmanD1 folded before Flop (didn't bet)
Seat 9: neris449 (button) collected (783)



PokerStars Hand #221332135539: Tournament #3067368972, $0.25+$0.24+$0.06 USD Hold'em No Limit - Level XIII (100/200) - 2020/12/11 21:10:11 EET [2020/12/11 14:10:11 ET]
Table '3067368972 323' 9-max Seat #1 is the button
Seat 1: foxyvanj (11045 in chips, $0.48 bounty) 
Seat 2: madmaddie92 (1967 in chips, $0.24 bounty) is sitting out
Seat 3: oleg 1011 (4892 in chips, $0.24 bounty) 
Seat 4: jcarlos.vale (16842 in chips, $0.60 bounty) 
Seat 5: yazvauazva (10183 in chips, $0.24 bounty) 
Seat 6: XottaBb14 (4463 in chips, $0.24 bounty) 
Seat 7: magatama16 (3606 in chips, $0.24 bounty) 
Seat 8: DartmanD1 (26499 in chips, $0.60 bounty) 
Seat 9: neris449 (17477 in chips, $0.48 bounty) 
foxyvanj: posts the ante 30
madmaddie92: posts the ante 30
oleg 1011: posts the ante 30
jcarlos.vale: posts the ante 30
yazvauazva: posts the ante 30
XottaBb14: posts the ante 30
magatama16: posts the ante 30
DartmanD1: posts the ante 30
neris449: posts the ante 30
madmaddie92: posts small blind 100
oleg 1011: posts big blind 200
*** HOLE CARDS ***
Dealt to jcarlos.vale [3d 7h]
oleg 1011 said, "zdraste"
jcarlos.vale: folds 
yazvauazva: folds 
XottaBb14: raises 200 to 400
magatama16: folds 
DartmanD1: calls 400
neris449: folds 
foxyvanj: folds 
madmaddie92: folds 
oleg 1011: folds 
*** FLOP *** [Kc Th 2h]
XottaBb14: bets 1028
DartmanD1: folds 
Uncalled bet (1028) returned to XottaBb14
XottaBb14 collected 1370 from pot
*** SUMMARY ***
Total pot 1370 | Rake 0 
Board [Kc Th 2h]
Seat 1: foxyvanj (button) folded before Flop (didn't bet)
Seat 2: madmaddie92 (small blind) folded before Flop
Seat 3: oleg 1011 (big blind) folded before Flop
Seat 4: jcarlos.vale folded before Flop (didn't bet)
Seat 5: yazvauazva folded before Flop (didn't bet)
Seat 6: XottaBb14 collected (1370)
Seat 7: magatama16 folded before Flop (didn't bet)
Seat 8: DartmanD1 folded on the Flop
Seat 9: neris449 folded before Flop (didn't bet)



PokerStars Hand #221332154970: Tournament #3067368972, $0.25+$0.24+$0.06 USD Hold'em No Limit - Level XIII (100/200) - 2020/12/11 21:10:42 EET [2020/12/11 14:10:42 ET]
Table '3067368972 323' 9-max Seat #2 is the button
Seat 1: foxyvanj (11015 in chips, $0.48 bounty) 
Seat 2: madmaddie92 (1837 in chips, $0.24 bounty) is sitting out
Seat 3: oleg 1011 (4662 in chips, $0.24 bounty) 
Seat 4: jcarlos.vale (16812 in chips, $0.60 bounty) 
Seat 5: yazvauazva (10153 in chips, $0.24 bounty) 
Seat 6: XottaBb14 (5403 in chips, $0.24 bounty) 
Seat 7: magatama16 (3576 in chips, $0.24 bounty) 
Seat 8: DartmanD1 (26069 in chips, $0.60 bounty) 
Seat 9: neris449 (17447 in chips, $0.48 bounty) 
foxyvanj: posts the ante 30
madmaddie92: posts the ante 30
oleg 1011: posts the ante 30
jcarlos.vale: posts the ante 30
yazvauazva: posts the ante 30
XottaBb14: posts the ante 30
magatama16: posts the ante 30
DartmanD1: posts the ante 30
neris449: posts the ante 30
oleg 1011: posts small blind 100
jcarlos.vale: posts big blind 200
*** HOLE CARDS ***
Dealt to jcarlos.vale [4c Qd]
yazvauazva: raises 200 to 400
XottaBb14: folds 
magatama16: folds 
DartmanD1: folds 
neris449: calls 400
foxyvanj: folds 
madmaddie92: folds 
oleg 1011: folds 
jcarlos.vale: folds 
*** FLOP *** [Ah 9h 2c]
yazvauazva: checks 
neris449: checks 
*** TURN *** [Ah 9h 2c] [8d]
yazvauazva: checks 
neris449: bets 200
yazvauazva: folds 
Uncalled bet (200) returned to neris449
neris449 collected 1370 from pot
neris449: doesn't show handDTO
*** SUMMARY ***
Total pot 1370 | Rake 0 
Board [Ah 9h 2c 8d]
Seat 1: foxyvanj folded before Flop (didn't bet)
Seat 2: madmaddie92 (button) folded before Flop (didn't bet)
Seat 3: oleg 1011 (small blind) folded before Flop
Seat 4: jcarlos.vale (big blind) folded before Flop
Seat 5: yazvauazva folded on the Turn
Seat 6: XottaBb14 folded before Flop (didn't bet)
Seat 7: magatama16 folded before Flop (didn't bet)
Seat 8: DartmanD1 folded before Flop (didn't bet)
Seat 9: neris449 collected (1370)



PokerStars Hand #221332178858: Tournament #3067368972, $0.25+$0.24+$0.06 USD Hold'em No Limit - Level XIII (100/200) - 2020/12/11 21:11:19 EET [2020/12/11 14:11:19 ET]
Table '3067368972 323' 9-max Seat #3 is the button
Seat 1: foxyvanj (10985 in chips, $0.48 bounty) 
Seat 2: madmaddie92 (1807 in chips, $0.24 bounty) is sitting out
Seat 3: oleg 1011 (4532 in chips, $0.24 bounty) 
Seat 4: jcarlos.vale (16582 in chips, $0.60 bounty) 
Seat 5: yazvauazva (9723 in chips, $0.24 bounty) 
Seat 6: XottaBb14 (5373 in chips, $0.24 bounty) 
Seat 7: magatama16 (3546 in chips, $0.24 bounty) 
Seat 8: DartmanD1 (26039 in chips, $0.60 bounty) 
Seat 9: neris449 (18387 in chips, $0.48 bounty) 
foxyvanj: posts the ante 30
madmaddie92: posts the ante 30
oleg 1011: posts the ante 30
jcarlos.vale: posts the ante 30
yazvauazva: posts the ante 30
XottaBb14: posts the ante 30
magatama16: posts the ante 30
DartmanD1: posts the ante 30
neris449: posts the ante 30
jcarlos.vale: posts small blind 100
yazvauazva: posts big blind 200
*** HOLE CARDS ***
Dealt to jcarlos.vale [6c 4d]
XottaBb14: folds 
magatama16: folds 
DartmanD1: folds 
neris449: calls 200
foxyvanj: folds 
madmaddie92: folds 
oleg 1011: folds 
jcarlos.vale: calls 100
yazvauazva: raises 600 to 800
neris449: calls 600
jcarlos.vale: folds 
*** FLOP *** [3d Qc Jc]
yazvauazva: bets 1035
neris449: calls 1035
*** TURN *** [3d Qc Jc] [4h]
yazvauazva: checks 
neris449: checks 
*** RIVER *** [3d Qc Jc 4h] [5c]
yazvauazva: bets 2200
neris449: calls 2200
*** SHOW DOWN ***
yazvauazva: shows [Kc Ac] (a flush, Ace high)
neris449: mucks handDTO
yazvauazva collected 8540 from pot
*** SUMMARY ***
Total pot 8540 | Rake 0 
Board [3d Qc Jc 4h 5c]
Seat 1: foxyvanj folded before Flop (didn't bet)
Seat 2: madmaddie92 folded before Flop (didn't bet)
Seat 3: oleg 1011 (button) folded before Flop (didn't bet)
Seat 4: jcarlos.vale (small blind) folded before Flop
Seat 5: yazvauazva (big blind) showed [Kc Ac] and won (8540) with a flush, Ace high
Seat 6: XottaBb14 folded before Flop (didn't bet)
Seat 7: magatama16 folded before Flop (didn't bet)
Seat 8: DartmanD1 folded before Flop (didn't bet)
Seat 9: neris449 mucked [5s 3s]



PokerStars Hand #221332226007: Tournament #3067368972, $0.25+$0.24+$0.06 USD Hold'em No Limit - Level XIII (100/200) - 2020/12/11 21:12:32 EET [2020/12/11 14:12:32 ET]
Table '3067368972 323' 9-max Seat #4 is the button
Seat 1: foxyvanj (10955 in chips, $0.48 bounty) 
Seat 2: madmaddie92 (1777 in chips, $0.24 bounty) is sitting out
Seat 3: oleg 1011 (4502 in chips, $0.24 bounty) 
Seat 4: jcarlos.vale (16352 in chips, $0.60 bounty) 
Seat 5: yazvauazva (14198 in chips, $0.24 bounty) 
Seat 6: XottaBb14 (5343 in chips, $0.24 bounty) 
Seat 7: magatama16 (3516 in chips, $0.24 bounty) 
Seat 8: DartmanD1 (26009 in chips, $0.60 bounty) 
Seat 9: neris449 (14322 in chips, $0.48 bounty) 
foxyvanj: posts the ante 30
madmaddie92: posts the ante 30
oleg 1011: posts the ante 30
jcarlos.vale: posts the ante 30
yazvauazva: posts the ante 30
XottaBb14: posts the ante 30
magatama16: posts the ante 30
DartmanD1: posts the ante 30
neris449: posts the ante 30
yazvauazva: posts small blind 100
XottaBb14: posts big blind 200
*** HOLE CARDS ***
Dealt to jcarlos.vale [5c 2c]
magatama16: folds 
DartmanD1: folds 
neris449: calls 200
foxyvanj: raises 400 to 600
madmaddie92: folds 
oleg 1011: folds 
jcarlos.vale: folds 
yazvauazva: folds 
XottaBb14: calls 400
neris449: calls 400
*** FLOP *** [6c 7c 3h]
XottaBb14: checks 
neris449: checks 
foxyvanj: checks 
*** TURN *** [6c 7c 3h] [2s]
XottaBb14: bets 1447
neris449: folds 
foxyvanj: folds 
Uncalled bet (1447) returned to XottaBb14
XottaBb14 collected 2170 from pot
XottaBb14: doesn't show handDTO
*** SUMMARY ***
Total pot 2170 | Rake 0 
Board [6c 7c 3h 2s]
Seat 1: foxyvanj folded on the Turn
Seat 2: madmaddie92 folded before Flop (didn't bet)
Seat 3: oleg 1011 folded before Flop (didn't bet)
Seat 4: jcarlos.vale (button) folded before Flop (didn't bet)
Seat 5: yazvauazva (small blind) folded before Flop
Seat 6: XottaBb14 (big blind) collected (2170)
Seat 7: magatama16 folded before Flop (didn't bet)
Seat 8: DartmanD1 folded before Flop (didn't bet)
Seat 9: neris449 folded on the Turn



PokerStars Hand #221332248196: Tournament #3067368972, $0.25+$0.24+$0.06 USD Hold'em No Limit - Level XIII (100/200) - 2020/12/11 21:13:06 EET [2020/12/11 14:13:06 ET]
Table '3067368972 323' 9-max Seat #5 is the button
Seat 1: foxyvanj (10325 in chips, $0.48 bounty) 
Seat 2: madmaddie92 (1747 in chips, $0.24 bounty) is sitting out
Seat 3: oleg 1011 (4472 in chips, $0.24 bounty) 
Seat 4: jcarlos.vale (16322 in chips, $0.60 bounty) 
Seat 5: yazvauazva (14068 in chips, $0.24 bounty) 
Seat 6: XottaBb14 (6883 in chips, $0.24 bounty) 
Seat 7: magatama16 (3486 in chips, $0.24 bounty) 
Seat 8: DartmanD1 (25979 in chips, $0.60 bounty) 
Seat 9: neris449 (13692 in chips, $0.48 bounty) 
foxyvanj: posts the ante 30
madmaddie92: posts the ante 30
oleg 1011: posts the ante 30
jcarlos.vale: posts the ante 30
yazvauazva: posts the ante 30
XottaBb14: posts the ante 30
magatama16: posts the ante 30
DartmanD1: posts the ante 30
neris449: posts the ante 30
XottaBb14: posts small blind 100
magatama16: posts big blind 200
*** HOLE CARDS ***
Dealt to jcarlos.vale [Qd Td]
DartmanD1: folds 
neris449: folds 
foxyvanj: folds 
madmaddie92: folds 
oleg 1011: folds 
jcarlos.vale: raises 320 to 520
yazvauazva: folds 
XottaBb14: folds 
magatama16: folds 
Uncalled bet (320) returned to jcarlos.vale
jcarlos.vale collected 770 from pot
jcarlos.vale: doesn't show handDTO
*** SUMMARY ***
Total pot 770 | Rake 0 
Seat 1: foxyvanj folded before Flop (didn't bet)
Seat 2: madmaddie92 folded before Flop (didn't bet)
Seat 3: oleg 1011 folded before Flop (didn't bet)
Seat 4: jcarlos.vale collected (770)
Seat 5: yazvauazva (button) folded before Flop (didn't bet)
Seat 6: XottaBb14 (small blind) folded before Flop
Seat 7: magatama16 (big blind) folded before Flop
Seat 8: DartmanD1 folded before Flop (didn't bet)
Seat 9: neris449 folded before Flop (didn't bet)



PokerStars Hand #221332266659: Tournament #3067368972, $0.25+$0.24+$0.06 USD Hold'em No Limit - Level XIII (100/200) - 2020/12/11 21:13:34 EET [2020/12/11 14:13:34 ET]
Table '3067368972 323' 9-max Seat #6 is the button
Seat 1: foxyvanj (10295 in chips, $0.48 bounty) 
Seat 2: madmaddie92 (1717 in chips, $0.24 bounty) is sitting out
Seat 3: oleg 1011 (4442 in chips, $0.24 bounty) 
Seat 4: jcarlos.vale (16862 in chips, $0.60 bounty) 
Seat 5: yazvauazva (14038 in chips, $0.24 bounty) 
Seat 6: XottaBb14 (6753 in chips, $0.24 bounty) 
Seat 7: magatama16 (3256 in chips, $0.24 bounty) 
Seat 8: DartmanD1 (25949 in chips, $0.60 bounty) 
Seat 9: neris449 (13662 in chips, $0.48 bounty) 
foxyvanj: posts the ante 30
madmaddie92: posts the ante 30
oleg 1011: posts the ante 30
jcarlos.vale: posts the ante 30
yazvauazva: posts the ante 30
XottaBb14: posts the ante 30
magatama16: posts the ante 30
DartmanD1: posts the ante 30
neris449: posts the ante 30
magatama16: posts small blind 100
DartmanD1: posts big blind 200
*** HOLE CARDS ***
Dealt to jcarlos.vale [Jd 3c]
neris449: calls 200
foxyvanj: folds 
madmaddie92: folds 
oleg 1011: folds 
jcarlos.vale: folds 
yazvauazva: calls 200
XottaBb14: raises 800 to 1000
magatama16: folds 
DartmanD1: folds 
neris449: calls 800
yazvauazva: folds 
*** FLOP *** [3s 3d 5h]
neris449: checks 
XottaBb14: bets 914
neris449: calls 914
*** TURN *** [3s 3d 5h] [2c]
neris449: checks 
XottaBb14: checks 
*** RIVER *** [3s 3d 5h 2c] [2h]
neris449: bets 4598
XottaBb14: folds 
Uncalled bet (4598) returned to neris449
neris449 collected 4598 from pot
neris449: doesn't show handDTO
*** SUMMARY ***
Total pot 4598 | Rake 0 
Board [3s 3d 5h 2c 2h]
Seat 1: foxyvanj folded before Flop (didn't bet)
Seat 2: madmaddie92 folded before Flop (didn't bet)
Seat 3: oleg 1011 folded before Flop (didn't bet)
Seat 4: jcarlos.vale folded before Flop (didn't bet)
Seat 5: yazvauazva folded before Flop
Seat 6: XottaBb14 (button) folded on the River
Seat 7: magatama16 (small blind) folded before Flop
Seat 8: DartmanD1 (big blind) folded before Flop
Seat 9: neris449 collected (4598)



PokerStars Hand #221332310629: Tournament #3067368972, $0.25+$0.24+$0.06 USD Hold'em No Limit - Level XIII (100/200) - 2020/12/11 21:14:43 EET [2020/12/11 14:14:43 ET]
Table '3067368972 323' 9-max Seat #7 is the button
Seat 1: foxyvanj (10265 in chips, $0.48 bounty) 
Seat 2: madmaddie92 (1687 in chips, $0.24 bounty) is sitting out
Seat 3: oleg 1011 (4412 in chips, $0.24 bounty) 
Seat 4: jcarlos.vale (16832 in chips, $0.60 bounty) 
Seat 5: yazvauazva (13808 in chips, $0.24 bounty) 
Seat 6: XottaBb14 (4809 in chips, $0.24 bounty) 
Seat 7: magatama16 (3126 in chips, $0.24 bounty) 
Seat 8: DartmanD1 (25719 in chips, $0.60 bounty) 
Seat 9: neris449 (16316 in chips, $0.48 bounty) 
foxyvanj: posts the ante 30
madmaddie92: posts the ante 30
oleg 1011: posts the ante 30
jcarlos.vale: posts the ante 30
yazvauazva: posts the ante 30
XottaBb14: posts the ante 30
magatama16: posts the ante 30
DartmanD1: posts the ante 30
neris449: posts the ante 30
DartmanD1: posts small blind 100
neris449: posts big blind 200
*** HOLE CARDS ***
Dealt to jcarlos.vale [Kc As]
foxyvanj: calls 200
madmaddie92: folds 
oleg 1011: calls 200
jcarlos.vale: calls 200
yazvauazva: folds 
XottaBb14: calls 200
magatama16: raises 2896 to 3096 and is all-in
DartmanD1: folds 
neris449: calls 2896
foxyvanj: raises 7139 to 10235 and is all-in
oleg 1011: folds 
jcarlos.vale: folds 
XottaBb14: calls 4579 and is all-in
neris449: calls 7139
*** FLOP *** [Kd Jh 8c]
*** TURN *** [Kd Jh 8c] [9d]
*** RIVER *** [Kd Jh 8c 9d] [Kh]
*** SHOW DOWN ***
neris449: shows [Ks 9c] (a full house, Kings full of Nines)
foxyvanj: shows [6s 6c] (two pair, Kings and Sixes)
neris449 collected 10912 from side pot-2 
XottaBb14: shows [Js Qc] (two pair, Kings and Jacks)
neris449 collected 5049 from side pot-1 
magatama16: shows [5s 5h] (two pair, Kings and Fives)
neris449 collected 13154 from main pot
neris449 wins $0.24 for eliminating foxyvanj and their own bounty increases by $0.24 to $0.72
neris449 wins $0.12 for eliminating XottaBb14 and their own bounty increases by $0.12 to $0.84
neris449 wins $0.12 for eliminating magatama16 and their own bounty increases by $0.12 to $0.96
foxyvanj finished the tournament
XottaBb14 finished the tournament
magatama16 finished the tournament
*** SUMMARY ***
Total pot 29115 Main pot 13154. Side pot-1 5049. Side pot-2 10912. | Rake 0 
Board [Kd Jh 8c 9d Kh]
Seat 1: foxyvanj showed [6s 6c] and lost with two pair, Kings and Sixes
Seat 2: madmaddie92 folded before Flop (didn't bet)
Seat 3: oleg 1011 folded before Flop
Seat 4: jcarlos.vale folded before Flop
Seat 5: yazvauazva folded before Flop (didn't bet)
Seat 6: XottaBb14 showed [Js Qc] and lost with two pair, Kings and Jacks
Seat 7: magatama16 (button) showed [5s 5h] and lost with two pair, Kings and Fives
Seat 8: DartmanD1 (small blind) folded before Flop
Seat 9: neris449 (big blind) showed [Ks 9c] and won (29115) with a full house, Kings full of Nines



PokerStars Hand #221332342270: Tournament #3067368972, $0.25+$0.24+$0.06 USD Hold'em No Limit - Level XIII (100/200) - 2020/12/11 21:15:32 EET [2020/12/11 14:15:32 ET]
Table '3067368972 323' 9-max Seat #8 is the button
Seat 1: SJS20382 (5000 in chips, $0.24 bounty) 
Seat 2: madmaddie92 (1657 in chips, $0.24 bounty) is sitting out
Seat 3: oleg 1011 (4182 in chips, $0.24 bounty) 
Seat 4: jcarlos.vale (16602 in chips, $0.60 bounty) 
Seat 5: yazvauazva (13778 in chips, $0.24 bounty) 
Seat 6: Teoriya300 (15730 in chips, $0.24 bounty) 
Seat 7: Dirg Digler (5962 in chips, $0.24 bounty) 
Seat 8: DartmanD1 (25589 in chips, $0.60 bounty) 
Seat 9: neris449 (35166 in chips, $0.96 bounty) 
SJS20382: posts the ante 30
madmaddie92: posts the ante 30
oleg 1011: posts the ante 30
jcarlos.vale: posts the ante 30
yazvauazva: posts the ante 30
Teoriya300: posts the ante 30
Dirg Digler: posts the ante 30
DartmanD1: posts the ante 30
neris449: posts the ante 30
neris449: posts small blind 100
SJS20382: posts big blind 200
*** HOLE CARDS ***
Dealt to jcarlos.vale [2c Jc]
madmaddie92: folds 
oleg 1011: calls 200
jcarlos.vale: folds 
yazvauazva: folds 
Teoriya300: folds 
Dirg Digler: folds 
DartmanD1: raises 400 to 600
neris449: calls 500
SJS20382: calls 400
oleg 1011: calls 400
*** FLOP *** [3d 6c 2h]
neris449: bets 1335
SJS20382: raises 3035 to 4370 and is all-in
oleg 1011: folds 
DartmanD1: folds 
neris449: calls 3035
*** TURN *** [3d 6c 2h] [Ad]
*** RIVER *** [3d 6c 2h Ad] [9h]
*** SHOW DOWN ***
neris449: shows [4d 6d] (a pair of Sixes)
SJS20382: shows [Ah 6s] (two pair, Aces and Sixes)
SJS20382 collected 11410 from pot
*** SUMMARY ***
Total pot 11410 | Rake 0 
Board [3d 6c 2h Ad 9h]
Seat 1: SJS20382 (big blind) showed [Ah 6s] and won (11410) with two pair, Aces and Sixes
Seat 2: madmaddie92 folded before Flop (didn't bet)
Seat 3: oleg 1011 folded on the Flop
Seat 4: jcarlos.vale folded before Flop (didn't bet)
Seat 5: yazvauazva folded before Flop (didn't bet)
Seat 6: Teoriya300 folded before Flop (didn't bet)
Seat 7: Dirg Digler folded before Flop (didn't bet)
Seat 8: DartmanD1 (button) folded on the Flop
Seat 9: neris449 (small blind) showed [4d 6d] and lost with a pair of Sixes



PokerStars Hand #221332375186: Tournament #3067368972, $0.25+$0.24+$0.06 USD Hold'em No Limit - Level XIII (100/200) - 2020/12/11 21:16:23 EET [2020/12/11 14:16:23 ET]
Table '3067368972 323' 9-max Seat #9 is the button
Seat 1: SJS20382 (11410 in chips, $0.24 bounty) 
Seat 2: madmaddie92 (1627 in chips, $0.24 bounty) is sitting out
Seat 3: oleg 1011 (3552 in chips, $0.24 bounty) 
Seat 4: jcarlos.vale (16572 in chips, $0.60 bounty) 
Seat 5: yazvauazva (13748 in chips, $0.24 bounty) 
Seat 6: Teoriya300 (15700 in chips, $0.24 bounty) 
Seat 7: Dirg Digler (5932 in chips, $0.24 bounty) 
Seat 8: DartmanD1 (24959 in chips, $0.60 bounty) 
Seat 9: neris449 (30166 in chips, $0.96 bounty) 
SJS20382: posts the ante 30
madmaddie92: posts the ante 30
oleg 1011: posts the ante 30
jcarlos.vale: posts the ante 30
yazvauazva: posts the ante 30
Teoriya300: posts the ante 30
Dirg Digler: posts the ante 30
DartmanD1: posts the ante 30
neris449: posts the ante 30
SJS20382: posts small blind 100
madmaddie92: posts big blind 200
*** HOLE CARDS ***
Dealt to jcarlos.vale [Th 6h]
oleg 1011: folds 
jcarlos.vale: folds 
yazvauazva: raises 400 to 600
Teoriya300: folds 
Dirg Digler: folds 
DartmanD1: folds 
neris449: calls 600
SJS20382: calls 500
madmaddie92: folds 
*** FLOP *** [8h 9d Js]
SJS20382: checks 
yazvauazva: bets 1200
neris449: calls 1200
SJS20382: folds 
*** TURN *** [8h 9d Js] [Qc]
yazvauazva: checks 
neris449: checks 
*** RIVER *** [8h 9d Js Qc] [Qd]
yazvauazva: bets 2335
neris449: calls 2335
*** SHOW DOWN ***
yazvauazva: shows [Ac As] (two pair, Aces and Queens)
neris449: mucks handDTO
yazvauazva collected 9340 from pot
*** SUMMARY ***
Total pot 9340 | Rake 0 
Board [8h 9d Js Qc Qd]
Seat 1: SJS20382 (small blind) folded on the Flop
Seat 2: madmaddie92 (big blind) folded before Flop
Seat 3: oleg 1011 folded before Flop (didn't bet)
Seat 4: jcarlos.vale folded before Flop (didn't bet)
Seat 5: yazvauazva showed [Ac As] and won (9340) with two pair, Aces and Queens
Seat 6: Teoriya300 folded before Flop (didn't bet)
Seat 7: Dirg Digler folded before Flop (didn't bet)
Seat 8: DartmanD1 folded before Flop (didn't bet)
Seat 9: neris449 (button) mucked [Jh Kd]



PokerStars Hand #221332417131: Tournament #3067368972, $0.25+$0.24+$0.06 USD Hold'em No Limit - Level XIV (125/250) - 2020/12/11 21:17:28 EET [2020/12/11 14:17:28 ET]
Table '3067368972 323' 9-max Seat #1 is the button
Seat 1: SJS20382 (10780 in chips, $0.24 bounty) 
Seat 2: madmaddie92 (1397 in chips, $0.24 bounty) is sitting out
Seat 3: oleg 1011 (3522 in chips, $0.24 bounty) 
Seat 4: jcarlos.vale (16542 in chips, $0.60 bounty) 
Seat 5: yazvauazva (18923 in chips, $0.24 bounty) 
Seat 6: Teoriya300 (15670 in chips, $0.24 bounty) 
Seat 7: Dirg Digler (5902 in chips, $0.24 bounty) 
Seat 8: DartmanD1 (24929 in chips, $0.60 bounty) 
Seat 9: neris449 (26001 in chips, $0.96 bounty) 
SJS20382: posts the ante 38
madmaddie92: posts the ante 38
oleg 1011: posts the ante 38
jcarlos.vale: posts the ante 38
yazvauazva: posts the ante 38
Teoriya300: posts the ante 38
Dirg Digler: posts the ante 38
DartmanD1: posts the ante 38
neris449: posts the ante 38
madmaddie92: posts small blind 125
oleg 1011: posts big blind 250
*** HOLE CARDS ***
Dealt to jcarlos.vale [9h Tc]
jcarlos.vale: folds 
yazvauazva: folds 
Teoriya300: folds 
Dirg Digler: folds 
DartmanD1: folds 
neris449: calls 250
SJS20382: folds 
madmaddie92: folds 
oleg 1011: checks 
*** FLOP *** [Ad As 6c]
oleg 1011: checks 
neris449: checks 
*** TURN *** [Ad As 6c] [7s]
oleg 1011: bets 484
neris449: folds 
Uncalled bet (484) returned to oleg 1011
oleg 1011 collected 967 from pot
oleg 1011: doesn't show handDTO
*** SUMMARY ***
Total pot 967 | Rake 0 
Board [Ad As 6c 7s]
Seat 1: SJS20382 (button) folded before Flop (didn't bet)
Seat 2: madmaddie92 (small blind) folded before Flop
Seat 3: oleg 1011 (big blind) collected (967)
Seat 4: jcarlos.vale folded before Flop (didn't bet)
Seat 5: yazvauazva folded before Flop (didn't bet)
Seat 6: Teoriya300 folded before Flop (didn't bet)
Seat 7: Dirg Digler folded before Flop (didn't bet)
Seat 8: DartmanD1 folded before Flop (didn't bet)
Seat 9: neris449 folded on the Turn



PokerStars Hand #221332438379: Tournament #3067368972, $0.25+$0.24+$0.06 USD Hold'em No Limit - Level XIV (125/250) - 2020/12/11 21:18:01 EET [2020/12/11 14:18:01 ET]
Table '3067368972 323' 9-max Seat #2 is the button
Seat 1: SJS20382 (10742 in chips, $0.24 bounty) 
Seat 2: madmaddie92 (1234 in chips, $0.24 bounty) is sitting out
Seat 3: oleg 1011 (4201 in chips, $0.24 bounty) 
Seat 4: jcarlos.vale (16504 in chips, $0.60 bounty) 
Seat 5: yazvauazva (18885 in chips, $0.24 bounty) 
Seat 6: Teoriya300 (15632 in chips, $0.24 bounty) 
Seat 7: Dirg Digler (5864 in chips, $0.24 bounty) 
Seat 8: DartmanD1 (24891 in chips, $0.60 bounty) 
Seat 9: neris449 (25713 in chips, $0.96 bounty) 
SJS20382: posts the ante 38
madmaddie92: posts the ante 38
oleg 1011: posts the ante 38
jcarlos.vale: posts the ante 38
yazvauazva: posts the ante 38
Teoriya300: posts the ante 38
Dirg Digler: posts the ante 38
DartmanD1: posts the ante 38
neris449: posts the ante 38
oleg 1011: posts small blind 125
jcarlos.vale: posts big blind 250
*** HOLE CARDS ***
Dealt to jcarlos.vale [6d Ah]
yazvauazva: folds 
Teoriya300: folds 
Dirg Digler: folds 
DartmanD1: raises 500 to 750
neris449: folds 
SJS20382: folds 
madmaddie92: folds 
oleg 1011: folds 
jcarlos.vale: folds 
Uncalled bet (500) returned to DartmanD1
DartmanD1 collected 967 from pot
*** SUMMARY ***
Total pot 967 | Rake 0 
Seat 1: SJS20382 folded before Flop (didn't bet)
Seat 2: madmaddie92 (button) folded before Flop (didn't bet)
Seat 3: oleg 1011 (small blind) folded before Flop
Seat 4: jcarlos.vale (big blind) folded before Flop
Seat 5: yazvauazva folded before Flop (didn't bet)
Seat 6: Teoriya300 folded before Flop (didn't bet)
Seat 7: Dirg Digler folded before Flop (didn't bet)
Seat 8: DartmanD1 collected (967)
Seat 9: neris449 folded before Flop (didn't bet)



PokerStars Hand #221332457549: Tournament #3067368972, $0.25+$0.24+$0.06 USD Hold'em No Limit - Level XIV (125/250) - 2020/12/11 21:18:31 EET [2020/12/11 14:18:31 ET]
Table '3067368972 323' 9-max Seat #3 is the button
Seat 1: SJS20382 (10704 in chips, $0.24 bounty) 
Seat 2: madmaddie92 (1196 in chips, $0.24 bounty) is sitting out
Seat 3: oleg 1011 (4038 in chips, $0.24 bounty) 
Seat 4: jcarlos.vale (16216 in chips, $0.60 bounty) 
Seat 5: yazvauazva (18847 in chips, $0.24 bounty) 
Seat 6: Teoriya300 (15594 in chips, $0.24 bounty) 
Seat 7: Dirg Digler (5826 in chips, $0.24 bounty) 
Seat 8: DartmanD1 (25570 in chips, $0.60 bounty) 
Seat 9: neris449 (25675 in chips, $0.96 bounty) 
SJS20382: posts the ante 38
madmaddie92: posts the ante 38
oleg 1011: posts the ante 38
jcarlos.vale: posts the ante 38
yazvauazva: posts the ante 38
Teoriya300: posts the ante 38
Dirg Digler: posts the ante 38
DartmanD1: posts the ante 38
neris449: posts the ante 38
jcarlos.vale: posts small blind 125
yazvauazva: posts big blind 250
*** HOLE CARDS ***
Dealt to jcarlos.vale [8d Ad]
Teoriya300: folds 
Dirg Digler: folds 
DartmanD1: folds 
neris449: calls 250
SJS20382: folds 
madmaddie92: folds 
oleg 1011: folds 
jcarlos.vale: calls 125
yazvauazva: checks 
*** FLOP *** [2c 3h Jd]
jcarlos.vale: checks 
yazvauazva: checks 
neris449: checks 
*** TURN *** [2c 3h Jd] [4c]
jcarlos.vale: checks 
yazvauazva: checks 
neris449: checks 
*** RIVER *** [2c 3h Jd 4c] [4d]
jcarlos.vale: bets 500
yazvauazva: folds 
neris449: folds 
Uncalled bet (500) returned to jcarlos.vale
jcarlos.vale collected 1092 from pot
jcarlos.vale: doesn't show handDTO
*** SUMMARY ***
Total pot 1092 | Rake 0 
Board [2c 3h Jd 4c 4d]
Seat 1: SJS20382 folded before Flop (didn't bet)
Seat 2: madmaddie92 folded before Flop (didn't bet)
Seat 3: oleg 1011 (button) folded before Flop (didn't bet)
Seat 4: jcarlos.vale (small blind) collected (1092)
Seat 5: yazvauazva (big blind) folded on the River
Seat 6: Teoriya300 folded before Flop (didn't bet)
Seat 7: Dirg Digler folded before Flop (didn't bet)
Seat 8: DartmanD1 folded before Flop (didn't bet)
Seat 9: neris449 folded on the River



PokerStars Hand #221332496077: Tournament #3067368972, $0.25+$0.24+$0.06 USD Hold'em No Limit - Level XIV (125/250) - 2020/12/11 21:19:31 EET [2020/12/11 14:19:31 ET]
Table '3067368972 323' 9-max Seat #4 is the button
Seat 1: SJS20382 (10666 in chips, $0.24 bounty) 
Seat 2: madmaddie92 (1158 in chips, $0.24 bounty) is sitting out
Seat 3: oleg 1011 (4000 in chips, $0.24 bounty) 
Seat 4: jcarlos.vale (17020 in chips, $0.60 bounty) 
Seat 5: yazvauazva (18559 in chips, $0.24 bounty) 
Seat 6: Teoriya300 (15556 in chips, $0.24 bounty) 
Seat 7: Dirg Digler (5788 in chips, $0.24 bounty) 
Seat 8: DartmanD1 (25532 in chips, $0.60 bounty) 
Seat 9: neris449 (25387 in chips, $0.96 bounty) 
SJS20382: posts the ante 38
madmaddie92: posts the ante 38
oleg 1011: posts the ante 38
jcarlos.vale: posts the ante 38
yazvauazva: posts the ante 38
Teoriya300: posts the ante 38
Dirg Digler: posts the ante 38
DartmanD1: posts the ante 38
neris449: posts the ante 38
yazvauazva: posts small blind 125
Teoriya300: posts big blind 250
*** HOLE CARDS ***
Dealt to jcarlos.vale [Qh 2d]
Dirg Digler: raises 500 to 750
DartmanD1: folds 
neris449: calls 750
SJS20382: calls 750
madmaddie92: folds 
oleg 1011: folds 
jcarlos.vale: folds 
yazvauazva: folds 
Teoriya300: folds 
*** FLOP *** [6s Kd 2h]
Dirg Digler: checks 
neris449: checks 
SJS20382: checks 
*** TURN *** [6s Kd 2h] [Js]
Dirg Digler: checks 
neris449: bets 1484
SJS20382: folds 
Dirg Digler: folds 
Uncalled bet (1484) returned to neris449
neris449 collected 2967 from pot
neris449: doesn't show handDTO
*** SUMMARY ***
Total pot 2967 | Rake 0 
Board [6s Kd 2h Js]
Seat 1: SJS20382 folded on the Turn
Seat 2: madmaddie92 folded before Flop (didn't bet)
Seat 3: oleg 1011 folded before Flop (didn't bet)
Seat 4: jcarlos.vale (button) folded before Flop (didn't bet)
Seat 5: yazvauazva (small blind) folded before Flop
Seat 6: Teoriya300 (big blind) folded before Flop
Seat 7: Dirg Digler folded on the Turn
Seat 8: DartmanD1 folded before Flop (didn't bet)
Seat 9: neris449 collected (2967)



PokerStars Hand #221332537941: Tournament #3067368972, $0.25+$0.24+$0.06 USD Hold'em No Limit - Level XIV (125/250) - 2020/12/11 21:20:35 EET [2020/12/11 14:20:35 ET]
Table '3067368972 323' 9-max Seat #5 is the button
Seat 1: SJS20382 (9878 in chips, $0.24 bounty) 
Seat 2: madmaddie92 (1120 in chips, $0.24 bounty) is sitting out
Seat 3: oleg 1011 (3962 in chips, $0.24 bounty) 
Seat 4: jcarlos.vale (16982 in chips, $0.60 bounty) 
Seat 5: yazvauazva (18396 in chips, $0.24 bounty) 
Seat 6: Teoriya300 (15268 in chips, $0.24 bounty) 
Seat 7: Dirg Digler (5000 in chips, $0.24 bounty) 
Seat 8: DartmanD1 (25494 in chips, $0.60 bounty) 
Seat 9: neris449 (27566 in chips, $0.96 bounty) 
SJS20382: posts the ante 38
madmaddie92: posts the ante 38
oleg 1011: posts the ante 38
jcarlos.vale: posts the ante 38
yazvauazva: posts the ante 38
Teoriya300: posts the ante 38
Dirg Digler: posts the ante 38
DartmanD1: posts the ante 38
neris449: posts the ante 38
Teoriya300: posts small blind 125
Dirg Digler: posts big blind 250
*** HOLE CARDS ***
Dealt to jcarlos.vale [Kd 4c]
DartmanD1: raises 500 to 750
neris449: calls 750
SJS20382: folds 
madmaddie92: folds 
oleg 1011: folds 
jcarlos.vale: folds 
yazvauazva: folds 
Teoriya300: folds 
Dirg Digler: folds 
*** FLOP *** [Kh 2d Jd]
DartmanD1: bets 776
neris449: calls 776
*** TURN *** [Kh 2d Jd] [4d]
DartmanD1: checks 
neris449: checks 
*** RIVER *** [Kh 2d Jd 4d] [2s]
DartmanD1: bets 2000
neris449: calls 2000
*** SHOW DOWN ***
DartmanD1: shows [Ac 8h] (a pair of Deuces)
neris449: shows [Qd Jh] (two pair, Jacks and Deuces)
neris449 collected 7769 from pot
*** SUMMARY ***
Total pot 7769 | Rake 0 
Board [Kh 2d Jd 4d 2s]
Seat 1: SJS20382 folded before Flop (didn't bet)
Seat 2: madmaddie92 folded before Flop (didn't bet)
Seat 3: oleg 1011 folded before Flop (didn't bet)
Seat 4: jcarlos.vale folded before Flop (didn't bet)
Seat 5: yazvauazva (button) folded before Flop (didn't bet)
Seat 6: Teoriya300 (small blind) folded before Flop
Seat 7: Dirg Digler (big blind) folded before Flop
Seat 8: DartmanD1 showed [Ac 8h] and lost with a pair of Deuces
Seat 9: neris449 showed [Qd Jh] and won (7769) with two pair, Jacks and Deuces



PokerStars Hand #221332565316: Tournament #3067368972, $0.25+$0.24+$0.06 USD Hold'em No Limit - Level XIV (125/250) - 2020/12/11 21:21:18 EET [2020/12/11 14:21:18 ET]
Table '3067368972 323' 9-max Seat #6 is the button
Seat 1: SJS20382 (9840 in chips, $0.24 bounty) 
Seat 2: madmaddie92 (1082 in chips, $0.24 bounty) is sitting out
Seat 3: oleg 1011 (3924 in chips, $0.24 bounty) 
Seat 4: jcarlos.vale (16944 in chips, $0.60 bounty) 
Seat 5: yazvauazva (18358 in chips, $0.24 bounty) 
Seat 6: Teoriya300 (15105 in chips, $0.24 bounty) 
Seat 7: Dirg Digler (4712 in chips, $0.24 bounty) 
Seat 8: DartmanD1 (21930 in chips, $0.60 bounty) 
Seat 9: neris449 (31771 in chips, $0.96 bounty) 
SJS20382: posts the ante 38
madmaddie92: posts the ante 38
oleg 1011: posts the ante 38
jcarlos.vale: posts the ante 38
yazvauazva: posts the ante 38
Teoriya300: posts the ante 38
Dirg Digler: posts the ante 38
DartmanD1: posts the ante 38
neris449: posts the ante 38
Dirg Digler: posts small blind 125
DartmanD1: posts big blind 250
*** HOLE CARDS ***
Dealt to jcarlos.vale [Qh 9h]
neris449: calls 250
SJS20382: folds 
madmaddie92: folds 
oleg 1011: folds 
jcarlos.vale: folds 
yazvauazva: folds 
Teoriya300: folds 
Dirg Digler: calls 125
DartmanD1: checks 
*** FLOP *** [7c Jh 3c]
Dirg Digler: checks 
DartmanD1: checks 
neris449: checks 
*** TURN *** [7c Jh 3c] [4c]
Dirg Digler: bets 500
DartmanD1: calls 500
neris449: folds 
*** RIVER *** [7c Jh 3c 4c] [6c]
Dirg Digler: checks 
DartmanD1: bets 1046
Dirg Digler: calls 1046
*** SHOW DOWN ***
DartmanD1: shows [Qc 2h] (a flush, Queen high)
Dirg Digler: mucks handDTO
DartmanD1 collected 4184 from pot
*** SUMMARY ***
Total pot 4184 | Rake 0 
Board [7c Jh 3c 4c 6c]
Seat 1: SJS20382 folded before Flop (didn't bet)
Seat 2: madmaddie92 folded before Flop (didn't bet)
Seat 3: oleg 1011 folded before Flop (didn't bet)
Seat 4: jcarlos.vale folded before Flop (didn't bet)
Seat 5: yazvauazva folded before Flop (didn't bet)
Seat 6: Teoriya300 (button) folded before Flop (didn't bet)
Seat 7: Dirg Digler (small blind) mucked [Tc Th]
Seat 8: DartmanD1 (big blind) showed [Qc 2h] and won (4184) with a flush, Queen high
Seat 9: neris449 folded on the Turn



PokerStars Hand #221332608097: Tournament #3067368972, $0.25+$0.24+$0.06 USD Hold'em No Limit - Level XIV (125/250) - 2020/12/11 21:22:24 EET [2020/12/11 14:22:24 ET]
Table '3067368972 323' 9-max Seat #7 is the button
Seat 1: SJS20382 (9802 in chips, $0.24 bounty) 
Seat 2: madmaddie92 (1044 in chips, $0.24 bounty) is sitting out
Seat 3: oleg 1011 (3886 in chips, $0.24 bounty) 
Seat 4: jcarlos.vale (16906 in chips, $0.60 bounty) 
Seat 5: yazvauazva (18320 in chips, $0.24 bounty) 
Seat 6: Teoriya300 (15067 in chips, $0.24 bounty) 
Seat 7: Dirg Digler (2878 in chips, $0.24 bounty) 
Seat 8: DartmanD1 (24280 in chips, $0.60 bounty) 
Seat 9: neris449 (31483 in chips, $0.96 bounty) 
SJS20382: posts the ante 38
madmaddie92: posts the ante 38
oleg 1011: posts the ante 38
jcarlos.vale: posts the ante 38
yazvauazva: posts the ante 38
Teoriya300: posts the ante 38
Dirg Digler: posts the ante 38
DartmanD1: posts the ante 38
neris449: posts the ante 38
DartmanD1: posts small blind 125
neris449: posts big blind 250
*** HOLE CARDS ***
Dealt to jcarlos.vale [2h 8c]
SJS20382: folds 
madmaddie92: folds 
oleg 1011: folds 
jcarlos.vale: folds 
yazvauazva: folds 
Teoriya300: folds 
Dirg Digler: raises 2590 to 2840 and is all-in
DartmanD1: folds 
neris449: folds 
Uncalled bet (2590) returned to Dirg Digler
Dirg Digler collected 967 from pot
Dirg Digler: doesn't show handDTO
*** SUMMARY ***
Total pot 967 | Rake 0 
Seat 1: SJS20382 folded before Flop (didn't bet)
Seat 2: madmaddie92 folded before Flop (didn't bet)
Seat 3: oleg 1011 folded before Flop (didn't bet)
Seat 4: jcarlos.vale folded before Flop (didn't bet)
Seat 5: yazvauazva folded before Flop (didn't bet)
Seat 6: Teoriya300 folded before Flop (didn't bet)
Seat 7: Dirg Digler (button) collected (967)
Seat 8: DartmanD1 (small blind) folded before Flop
Seat 9: neris449 (big blind) folded before Flop



PokerStars Hand #221332630531: Tournament #3067368972, $0.25+$0.24+$0.06 USD Hold'em No Limit - Level XIV (125/250) - 2020/12/11 21:22:52 EET [2020/12/11 14:22:52 ET]
Table '3067368972 323' 9-max Seat #8 is the button
Seat 1: SJS20382 (9764 in chips, $0.24 bounty) 
Seat 2: madmaddie92 (1006 in chips, $0.24 bounty) is sitting out
Seat 3: oleg 1011 (3848 in chips, $0.24 bounty) 
Seat 4: jcarlos.vale (16868 in chips, $0.60 bounty) 
Seat 5: yazvauazva (18282 in chips, $0.24 bounty) 
Seat 6: Teoriya300 (15029 in chips, $0.24 bounty) 
Seat 7: Dirg Digler (3557 in chips, $0.24 bounty) 
Seat 8: DartmanD1 (24117 in chips, $0.60 bounty) 
Seat 9: neris449 (31195 in chips, $0.96 bounty) 
SJS20382: posts the ante 38
madmaddie92: posts the ante 38
oleg 1011: posts the ante 38
jcarlos.vale: posts the ante 38
yazvauazva: posts the ante 38
Teoriya300: posts the ante 38
Dirg Digler: posts the ante 38
DartmanD1: posts the ante 38
neris449: posts the ante 38
neris449: posts small blind 125
SJS20382: posts big blind 250
*** HOLE CARDS ***
Dealt to jcarlos.vale [Ad 9c]
madmaddie92: folds 
oleg 1011: folds 
jcarlos.vale: folds 
yazvauazva: folds 
Teoriya300: folds 
Dirg Digler: raises 3269 to 3519 and is all-in
DartmanD1: folds 
neris449: calls 3394
SJS20382: folds 
*** FLOP *** [7c 8c 2s]
*** TURN *** [7c 8c 2s] [Js]
*** RIVER *** [7c 8c 2s Js] [5s]
*** SHOW DOWN ***
neris449: shows [9s 8d] (a pair of Eights)
Dirg Digler: shows [Kd 9d] (high pairOfCards King)
neris449 collected 7630 from pot
neris449 wins $0.12 for eliminating Dirg Digler and their own bounty increases by $0.12 to $1.08
Dirg Digler finished the tournament
*** SUMMARY ***
Total pot 7630 | Rake 0 
Board [7c 8c 2s Js 5s]
Seat 1: SJS20382 (big blind) folded before Flop
Seat 2: madmaddie92 folded before Flop (didn't bet)
Seat 3: oleg 1011 folded before Flop (didn't bet)
Seat 4: jcarlos.vale folded before Flop (didn't bet)
Seat 5: yazvauazva folded before Flop (didn't bet)
Seat 6: Teoriya300 folded before Flop (didn't bet)
Seat 7: Dirg Digler showed [Kd 9d] and lost with high pairOfCards King
Seat 8: DartmanD1 (button) folded before Flop (didn't bet)
Seat 9: neris449 (small blind) showed [9s 8d] and won (7630) with a pair of Eights



PokerStars Hand #221332673658: Tournament #3067368972, $0.25+$0.24+$0.06 USD Hold'em No Limit - Level XV (150/300) - 2020/12/11 21:23:59 EET [2020/12/11 14:23:59 ET]
Table '3067368972 323' 9-max Seat #9 is the button
Seat 1: SJS20382 (9476 in chips, $0.24 bounty) 
Seat 2: madmaddie92 (968 in chips, $0.24 bounty) is sitting out
Seat 3: oleg 1011 (3810 in chips, $0.24 bounty) 
Seat 4: jcarlos.vale (16830 in chips, $0.60 bounty) 
Seat 5: yazvauazva (18244 in chips, $0.24 bounty) 
Seat 6: Teoriya300 (14991 in chips, $0.24 bounty) 
Seat 7: TAH0C12345 (5000 in chips, $0.24 bounty) 
Seat 8: DartmanD1 (24079 in chips, $0.60 bounty) 
Seat 9: neris449 (35268 in chips, $1.08 bounty) 
SJS20382: posts the ante 50
madmaddie92: posts the ante 50
oleg 1011: posts the ante 50
jcarlos.vale: posts the ante 50
yazvauazva: posts the ante 50
Teoriya300: posts the ante 50
TAH0C12345: posts the ante 50
DartmanD1: posts the ante 50
neris449: posts the ante 50
SJS20382: posts small blind 150
madmaddie92: posts big blind 300
*** HOLE CARDS ***
Dealt to jcarlos.vale [Jd Jc]
oleg 1011 has timed out
oleg 1011: folds 
oleg 1011 is sitting out
jcarlos.vale: raises 600 to 900
yazvauazva: folds 
Teoriya300: folds 
TAH0C12345: raises 4050 to 4950 and is all-in
DartmanD1: folds 
neris449: calls 4950
SJS20382: folds 
madmaddie92: folds 
jcarlos.vale: raises 11830 to 16780 and is all-in
oleg 1011 has returned
neris449: calls 11830
*** FLOP *** [9h 4h 2c]
*** TURN *** [9h 4h 2c] [5d]
*** RIVER *** [9h 4h 2c 5d] [5c]
*** SHOW DOWN ***
jcarlos.vale: shows [Jd Jc] (two pair, Jacks and Fives)
neris449: shows [Qh Ks] (a pair of Fives)
jcarlos.vale collected 23660 from side pot
TAH0C12345: shows [Ac 2h] (two pair, Fives and Deuces)
jcarlos.vale collected 15750 from main pot
jcarlos.vale wins $0.12 for eliminating TAH0C12345 and their own bounty increases by $0.12 to $0.72
TAH0C12345 finished the tournament
*** SUMMARY ***
Total pot 39410 Main pot 15750. Side pot 23660. | Rake 0 
Board [9h 4h 2c 5d 5c]
Seat 1: SJS20382 (small blind) folded before Flop
Seat 2: madmaddie92 (big blind) folded before Flop
Seat 3: oleg 1011 folded before Flop (didn't bet)
Seat 4: jcarlos.vale showed [Jd Jc] and won (39410) with two pair, Jacks and Fives
Seat 5: yazvauazva folded before Flop (didn't bet)
Seat 6: Teoriya300 folded before Flop (didn't bet)
Seat 7: TAH0C12345 showed [Ac 2h] and lost with two pair, Fives and Deuces
Seat 8: DartmanD1 folded before Flop (didn't bet)
Seat 9: neris449 (button) showed [Qh Ks] and lost with a pair of Fives



PokerStars Hand #221332733166: Tournament #3067368972, $0.25+$0.24+$0.06 USD Hold'em No Limit - Level XV (150/300) - 2020/12/11 21:25:32 EET [2020/12/11 14:25:32 ET]
Table '3067368972 323' 9-max Seat #1 is the button
Seat 1: SJS20382 (9276 in chips, $0.24 bounty) 
Seat 2: madmaddie92 (618 in chips, $0.24 bounty) is sitting out
Seat 3: oleg 1011 (3760 in chips, $0.24 bounty) 
Seat 4: jcarlos.vale (39410 in chips, $0.72 bounty) 
Seat 5: yazvauazva (18194 in chips, $0.24 bounty) 
Seat 6: Teoriya300 (14941 in chips, $0.24 bounty) 
Seat 8: DartmanD1 (24029 in chips, $0.60 bounty) 
Seat 9: neris449 (18438 in chips, $1.08 bounty) 
SJS20382: posts the ante 50
madmaddie92: posts the ante 50
oleg 1011: posts the ante 50
jcarlos.vale: posts the ante 50
yazvauazva: posts the ante 50
Teoriya300: posts the ante 50
DartmanD1: posts the ante 50
neris449: posts the ante 50
madmaddie92: posts small blind 150
oleg 1011: posts big blind 300
*** HOLE CARDS ***
Dealt to jcarlos.vale [As Ah]
jcarlos.vale: raises 600 to 900
yazvauazva: folds 
Teoriya300: folds 
DartmanD1: folds 
neris449: folds 
SJS20382: folds 
madmaddie92: folds 
oleg 1011: folds 
Uncalled bet (600) returned to jcarlos.vale
jcarlos.vale collected 1150 from pot
jcarlos.vale: doesn't show handDTO
*** SUMMARY ***
Total pot 1150 | Rake 0 
Seat 1: SJS20382 (button) folded before Flop (didn't bet)
Seat 2: madmaddie92 (small blind) folded before Flop
Seat 3: oleg 1011 (big blind) folded before Flop
Seat 4: jcarlos.vale collected (1150)
Seat 5: yazvauazva folded before Flop (didn't bet)
Seat 6: Teoriya300 folded before Flop (didn't bet)
Seat 8: DartmanD1 folded before Flop (didn't bet)
Seat 9: neris449 folded before Flop (didn't bet)



PokerStars Hand #221332748022: Tournament #3067368972, $0.25+$0.24+$0.06 USD Hold'em No Limit - Level XV (150/300) - 2020/12/11 21:25:55 EET [2020/12/11 14:25:55 ET]
Table '3067368972 323' 9-max Seat #2 is the button
Seat 1: SJS20382 (9226 in chips, $0.24 bounty) 
Seat 2: madmaddie92 (418 in chips, $0.24 bounty) is sitting out
Seat 3: oleg 1011 (3410 in chips, $0.24 bounty) 
Seat 4: jcarlos.vale (40210 in chips, $0.72 bounty) 
Seat 5: yazvauazva (18144 in chips, $0.24 bounty) 
Seat 6: Teoriya300 (14891 in chips, $0.24 bounty) 
Seat 7: sandoo23 (5000 in chips, $0.24 bounty) 
Seat 8: DartmanD1 (23979 in chips, $0.60 bounty) 
Seat 9: neris449 (18388 in chips, $1.08 bounty) 
SJS20382: posts the ante 50
madmaddie92: posts the ante 50
oleg 1011: posts the ante 50
jcarlos.vale: posts the ante 50
yazvauazva: posts the ante 50
Teoriya300: posts the ante 50
sandoo23: posts the ante 50
DartmanD1: posts the ante 50
neris449: posts the ante 50
oleg 1011: posts small blind 150
jcarlos.vale: posts big blind 300
*** HOLE CARDS ***
Dealt to jcarlos.vale [5d Ad]
yazvauazva: folds 
Teoriya300: folds 
sandoo23: calls 300
DartmanD1: calls 300
neris449: calls 300
SJS20382: calls 300
madmaddie92: folds 
oleg 1011: calls 150
jcarlos.vale: checks 
*** FLOP *** [8s 2d Qs]
oleg 1011: checks 
jcarlos.vale: checks 
sandoo23: checks 
DartmanD1: checks 
neris449: checks 
SJS20382: checks 
*** TURN *** [8s 2d Qs] [Kc]
oleg 1011: bets 1125
jcarlos.vale: folds 
sandoo23: calls 1125
DartmanD1: calls 1125
neris449: folds 
SJS20382: folds 
*** RIVER *** [8s 2d Qs Kc] [4h]
oleg 1011: bets 1935 and is all-in
sandoo23: calls 1935
DartmanD1: raises 2865 to 4800
sandoo23: calls 1590 and is all-in
Uncalled bet (1275) returned to DartmanD1
*** SHOW DOWN ***
DartmanD1: shows [2h 2s] (three of a kind, Deuces)
sandoo23: shows [Kd 3s] (a pair of Kings)
DartmanD1 collected 3180 from side pot
oleg 1011: shows [Kh Jd] (a pair of Kings)
DartmanD1 collected 11430 from main pot
DartmanD1 wins $0.12 for eliminating oleg 1011 and their own bounty increases by $0.12 to $0.72
DartmanD1 wins $0.12 for eliminating sandoo23 and their own bounty increases by $0.12 to $0.84
sandoo23 finished the tournament
oleg 1011 finished the tournament
*** SUMMARY ***
Total pot 14610 Main pot 11430. Side pot 3180. | Rake 0 
Board [8s 2d Qs Kc 4h]
Seat 1: SJS20382 folded on the Turn
Seat 2: madmaddie92 (button) folded before Flop (didn't bet)
Seat 3: oleg 1011 (small blind) showed [Kh Jd] and lost with a pair of Kings
Seat 4: jcarlos.vale (big blind) folded on the Turn
Seat 5: yazvauazva folded before Flop (didn't bet)
Seat 6: Teoriya300 folded before Flop (didn't bet)
Seat 7: sandoo23 showed [Kd 3s] and lost with a pair of Kings
Seat 8: DartmanD1 showed [2h 2s] and won (14610) with three of a kind, Deuces
Seat 9: neris449 folded on the Turn



PokerStars Hand #221332804957: Tournament #3067368972, $0.25+$0.24+$0.06 USD Hold'em No Limit - Level XV (150/300) - 2020/12/11 21:27:24 EET [2020/12/11 14:27:24 ET]
Table '3067368972 323' 9-max Seat #4 is the button
Seat 1: SJS20382 (8876 in chips, $0.24 bounty) 
Seat 2: madmaddie92 (368 in chips, $0.24 bounty) is sitting out
Seat 3: ventzas (5000 in chips, $0.24 bounty) 
Seat 4: jcarlos.vale (39860 in chips, $0.72 bounty) 
Seat 5: yazvauazva (18094 in chips, $0.24 bounty) 
Seat 6: Teoriya300 (14841 in chips, $0.24 bounty) 
Seat 8: DartmanD1 (33589 in chips, $0.84 bounty) 
Seat 9: neris449 (18038 in chips, $1.08 bounty) 
SJS20382: posts the ante 50
madmaddie92: posts the ante 50
ventzas: posts the ante 50
jcarlos.vale: posts the ante 50
yazvauazva: posts the ante 50
Teoriya300: posts the ante 50
DartmanD1: posts the ante 50
neris449: posts the ante 50
yazvauazva: posts small blind 150
Teoriya300: posts big blind 300
*** HOLE CARDS ***
Dealt to jcarlos.vale [Th 7c]
DartmanD1: raises 600 to 900
neris449: folds 
SJS20382: folds 
madmaddie92: folds 
ventzas: folds 
jcarlos.vale: folds 
yazvauazva: folds 
Teoriya300: raises 2400 to 3300
DartmanD1: raises 30239 to 33539 and is all-in
Teoriya300: calls 11491 and is all-in
Uncalled bet (18748) returned to DartmanD1
*** FLOP *** [Qd 5d 8h]
*** TURN *** [Qd 5d 8h] [8c]
*** RIVER *** [Qd 5d 8h 8c] [2c]
*** SHOW DOWN ***
Teoriya300: shows [Kh Kc] (two pair, Kings and Eights)
DartmanD1: shows [Jh Jc] (two pair, Jacks and Eights)
Teoriya300 collected 30132 from pot
*** SUMMARY ***
Total pot 30132 | Rake 0 
Board [Qd 5d 8h 8c 2c]
Seat 1: SJS20382 folded before Flop (didn't bet)
Seat 2: madmaddie92 folded before Flop (didn't bet)
Seat 3: ventzas folded before Flop (didn't bet)
Seat 4: jcarlos.vale (button) folded before Flop (didn't bet)
Seat 5: yazvauazva (small blind) folded before Flop
Seat 6: Teoriya300 (big blind) showed [Kh Kc] and won (30132) with two pair, Kings and Eights
Seat 8: DartmanD1 showed [Jh Jc] and lost with two pair, Jacks and Eights
Seat 9: neris449 folded before Flop (didn't bet)



PokerStars Hand #221332842854: Tournament #3067368972, $0.25+$0.24+$0.06 USD Hold'em No Limit - Level XV (150/300) - 2020/12/11 21:28:23 EET [2020/12/11 14:28:23 ET]
Table '3067368972 323' 9-max Seat #5 is the button
Seat 1: SJS20382 (8826 in chips, $0.24 bounty) 
Seat 2: madmaddie92 (318 in chips, $0.24 bounty) is sitting out
Seat 3: ventzas (4950 in chips, $0.24 bounty) 
Seat 4: jcarlos.vale (39810 in chips, $0.72 bounty) 
Seat 5: yazvauazva (17894 in chips, $0.24 bounty) 
Seat 6: Teoriya300 (30132 in chips, $0.24 bounty) 
Seat 7: higvand.182 (5000 in chips, $0.24 bounty) 
Seat 8: DartmanD1 (18748 in chips, $0.84 bounty) 
Seat 9: neris449 (17988 in chips, $1.08 bounty) 
SJS20382: posts the ante 50
madmaddie92: posts the ante 50
ventzas: posts the ante 50
jcarlos.vale: posts the ante 50
yazvauazva: posts the ante 50
Teoriya300: posts the ante 50
higvand.182: posts the ante 50
DartmanD1: posts the ante 50
neris449: posts the ante 50
Teoriya300: posts small blind 150
higvand.182: posts big blind 300
*** HOLE CARDS ***
Dealt to jcarlos.vale [Tc 8s]
DartmanD1: folds 
neris449: calls 300
SJS20382: folds 
madmaddie92: folds 
ventzas: raises 4600 to 4900 and is all-in
jcarlos.vale: folds 
yazvauazva: folds 
Teoriya300: folds 
higvand.182: raises 50 to 4950 and is all-in
neris449: folds 
Uncalled bet (50) returned to higvand.182
*** FLOP *** [4d Kd Kh]
*** TURN *** [4d Kd Kh] [Kc]
*** RIVER *** [4d Kd Kh Kc] [Qc]
*** SHOW DOWN ***
higvand.182: shows [9c Ah] (three of a kind, Kings)
ventzas: shows [Td Ts] (a full house, Kings full of Tens)
ventzas collected 10700 from pot
*** SUMMARY ***
Total pot 10700 | Rake 0 
Board [4d Kd Kh Kc Qc]
Seat 1: SJS20382 folded before Flop (didn't bet)
Seat 2: madmaddie92 folded before Flop (didn't bet)
Seat 3: ventzas showed [Td Ts] and won (10700) with a full house, Kings full of Tens
Seat 4: jcarlos.vale folded before Flop (didn't bet)
Seat 5: yazvauazva (button) folded before Flop (didn't bet)
Seat 6: Teoriya300 (small blind) folded before Flop
Seat 7: higvand.182 (big blind) showed [9c Ah] and lost with three of a kind, Kings
Seat 8: DartmanD1 folded before Flop (didn't bet)
Seat 9: neris449 folded before Flop



PokerStars Hand #221332859009: Tournament #3067368972, $0.25+$0.24+$0.06 USD Hold'em No Limit - Level XV (150/300) - 2020/12/11 21:28:48 EET [2020/12/11 14:28:48 ET]
Table '3067368972 323' 9-max Seat #6 is the button
Seat 1: SJS20382 (8776 in chips, $0.24 bounty) 
Seat 2: madmaddie92 (268 in chips, $0.24 bounty) is sitting out
Seat 3: ventzas (10700 in chips, $0.24 bounty) 
Seat 4: jcarlos.vale (39760 in chips, $0.72 bounty) 
Seat 5: yazvauazva (17844 in chips, $0.24 bounty) 
Seat 6: Teoriya300 (29932 in chips, $0.24 bounty) 
Seat 7: higvand.182 (50 in chips, $0.24 bounty) 
Seat 8: DartmanD1 (18698 in chips, $0.84 bounty) 
Seat 9: neris449 (17638 in chips, $1.08 bounty) 
SJS20382: posts the ante 50
madmaddie92: posts the ante 50
ventzas: posts the ante 50
jcarlos.vale: posts the ante 50
yazvauazva: posts the ante 50
Teoriya300: posts the ante 50
higvand.182: posts the ante 50 and is all-in
DartmanD1: posts the ante 50
neris449: posts the ante 50
DartmanD1: posts big blind 300
*** HOLE CARDS ***
Dealt to jcarlos.vale [Jd Js]
neris449: calls 300
SJS20382: folds 
madmaddie92: folds 
ventzas: calls 300
jcarlos.vale: raises 600 to 900
yazvauazva: folds 
Teoriya300: folds 
DartmanD1: folds 
neris449: calls 600
ventzas: calls 600
*** FLOP *** [Jc 3c 6h]
neris449: checks 
ventzas: checks 
jcarlos.vale: bets 2700
neris449: folds 
ventzas: folds 
Uncalled bet (2700) returned to jcarlos.vale
*** TURN *** [Jc 3c 6h] [7h]
*** RIVER *** [Jc 3c 6h 7h] [Tc]
*** SHOW DOWN ***
jcarlos.vale: shows [Jd Js] (three of a kind, Jacks)
jcarlos.vale collected 3000 from side pot
higvand.182: shows [8d 3s] (a pair of Threes)
jcarlos.vale collected 450 from main pot
jcarlos.vale wins $0.12 for eliminating higvand.182 and their own bounty increases by $0.12 to $0.84
higvand.182 finished the tournament
*** SUMMARY ***
Total pot 3450 Main pot 450. Side pot 3000. | Rake 0 
Board [Jc 3c 6h 7h Tc]
Seat 1: SJS20382 folded before Flop (didn't bet)
Seat 2: madmaddie92 folded before Flop (didn't bet)
Seat 3: ventzas folded on the Flop
Seat 4: jcarlos.vale showed [Jd Js] and won (3450) with three of a kind, Jacks
Seat 5: yazvauazva folded before Flop (didn't bet)
Seat 6: Teoriya300 (button) folded before Flop (didn't bet)
Seat 7: higvand.182 showed [8d 3s] and lost with a pair of Threes
Seat 8: DartmanD1 (big blind) folded before Flop
Seat 9: neris449 folded on the Flop



PokerStars Hand #221332886607: Tournament #3067368972, $0.25+$0.24+$0.06 USD Hold'em No Limit - Level XV (150/300) - 2020/12/11 21:29:30 EET [2020/12/11 14:29:30 ET]
Table '3067368972 323' 9-max Seat #8 is the button
Seat 1: SJS20382 (8726 in chips, $0.24 bounty) 
Seat 2: madmaddie92 (218 in chips, $0.24 bounty) is sitting out
Seat 3: ventzas (9750 in chips, $0.24 bounty) 
Seat 4: jcarlos.vale (42260 in chips, $0.84 bounty) 
Seat 5: yazvauazva (17794 in chips, $0.24 bounty) 
Seat 6: Teoriya300 (29882 in chips, $0.24 bounty) 
Seat 8: DartmanD1 (18348 in chips, $0.84 bounty) 
Seat 9: neris449 (16688 in chips, $1.08 bounty) 
SJS20382: posts the ante 50
madmaddie92: posts the ante 50
ventzas: posts the ante 50
jcarlos.vale: posts the ante 50
yazvauazva: posts the ante 50
Teoriya300: posts the ante 50
DartmanD1: posts the ante 50
neris449: posts the ante 50
neris449: posts small blind 150
SJS20382: posts big blind 300
*** HOLE CARDS ***
Dealt to jcarlos.vale [6d 3c]
madmaddie92: folds 
ventzas: raises 300 to 600
jcarlos.vale: folds 
yazvauazva: folds 
Teoriya300: folds 
DartmanD1: folds 
neris449: calls 450
SJS20382: calls 300
*** FLOP *** [8h Ah 6s]
neris449: checks 
SJS20382: bets 600
ventzas: calls 600
neris449: folds 
*** TURN *** [8h Ah 6s] [6c]
SJS20382: checks 
ventzas: checks 
*** RIVER *** [8h Ah 6s 6c] [3s]
SJS20382: checks 
ventzas: checks 
*** SHOW DOWN ***
SJS20382: shows [Th Kh] (a pair of Sixes)
ventzas: mucks handDTO
SJS20382 collected 3400 from pot
*** SUMMARY ***
Total pot 3400 | Rake 0 
Board [8h Ah 6s 6c 3s]
Seat 1: SJS20382 (big blind) showed [Th Kh] and won (3400) with a pair of Sixes
Seat 2: madmaddie92 folded before Flop (didn't bet)
Seat 3: ventzas mucked [Qh Jh]
Seat 4: jcarlos.vale folded before Flop (didn't bet)
Seat 5: yazvauazva folded before Flop (didn't bet)
Seat 6: Teoriya300 folded before Flop (didn't bet)
Seat 8: DartmanD1 (button) folded before Flop (didn't bet)
Seat 9: neris449 (small blind) folded on the Flop



PokerStars Hand #221332922204: Tournament #3067368972, $0.25+$0.24+$0.06 USD Hold'em No Limit - Level XV (150/300) - 2020/12/11 21:30:25 EET [2020/12/11 14:30:25 ET]
Table '3067368972 323' 9-max Seat #9 is the button
Seat 1: SJS20382 (10876 in chips, $0.24 bounty) 
Seat 2: madmaddie92 (168 in chips, $0.24 bounty) is sitting out
Seat 3: ventzas (8500 in chips, $0.24 bounty) 
Seat 4: jcarlos.vale (42210 in chips, $0.84 bounty) 
Seat 5: yazvauazva (17744 in chips, $0.24 bounty) 
Seat 6: Teoriya300 (29832 in chips, $0.24 bounty) 
Seat 7: marianopokerino (5000 in chips, $0.24 bounty) 
Seat 8: DartmanD1 (18298 in chips, $0.84 bounty) 
Seat 9: neris449 (16038 in chips, $1.08 bounty) 
SJS20382: posts the ante 50
madmaddie92: posts the ante 50
ventzas: posts the ante 50
jcarlos.vale: posts the ante 50
yazvauazva: posts the ante 50
Teoriya300: posts the ante 50
marianopokerino: posts the ante 50
DartmanD1: posts the ante 50
neris449: posts the ante 50
SJS20382: posts small blind 150
madmaddie92: posts big blind 118 and is all-in
*** HOLE CARDS ***
Dealt to jcarlos.vale [Ac Qd]
ventzas: raises 450 to 600
jcarlos.vale: calls 600
yazvauazva: calls 600
Teoriya300: calls 600
marianopokerino: raises 4350 to 4950 and is all-in
DartmanD1: folds 
neris449: folds 
SJS20382: folds 
madmaddie92: folds 
ventzas: folds 
jcarlos.vale: calls 4350
yazvauazva: folds 
Teoriya300: folds 
*** FLOP *** [8s As 2c]
*** TURN *** [8s As 2c] [Qh]
*** RIVER *** [8s As 2c Qh] [8d]
*** SHOW DOWN ***
jcarlos.vale: shows [Ac Qd] (two pair, Aces and Queens)
marianopokerino: shows [6h 6d] (two pair, Eights and Sixes)
jcarlos.vale collected 12418 from pot
jcarlos.vale wins $0.12 for eliminating madmaddie92 and their own bounty increases by $0.12 to $0.96
jcarlos.vale wins $0.12 for eliminating marianopokerino and their own bounty increases by $0.12 to $1.08
marianopokerino finished the tournament
madmaddie92 finished the tournament
*** SUMMARY ***
Total pot 12418 | Rake 0 
Board [8s As 2c Qh 8d]
Seat 1: SJS20382 (small blind) folded before Flop
Seat 2: madmaddie92 (big blind) folded before Flop
Seat 3: ventzas folded before Flop
Seat 4: jcarlos.vale showed [Ac Qd] and won (12418) with two pair, Aces and Queens
Seat 5: yazvauazva folded before Flop
Seat 6: Teoriya300 folded before Flop
Seat 7: marianopokerino showed [6h 6d] and lost with two pair, Eights and Sixes
Seat 8: DartmanD1 folded before Flop (didn't bet)
Seat 9: neris449 (button) folded before Flop (didn't bet)



PokerStars Hand #221332974900: Tournament #3067368972, $0.25+$0.24+$0.06 USD Hold'em No Limit - Level XVI (200/400) - 2020/12/11 21:31:45 EET [2020/12/11 14:31:45 ET]
Table '3067368972 323' 9-max Seat #1 is the button
Seat 1: SJS20382 (10676 in chips, $0.24 bounty) 
Seat 3: ventzas (7850 in chips, $0.24 bounty) 
Seat 4: jcarlos.vale (49628 in chips, $1.08 bounty) 
Seat 5: yazvauazva (17094 in chips, $0.24 bounty) 
Seat 6: Teoriya300 (29182 in chips, $0.24 bounty) 
Seat 7: DevilsAngel666 (9519 in chips, $0.24 bounty) 
Seat 8: DartmanD1 (18248 in chips, $0.84 bounty) 
Seat 9: neris449 (15988 in chips, $1.08 bounty) 
SJS20382: posts the ante 60
ventzas: posts the ante 60
jcarlos.vale: posts the ante 60
yazvauazva: posts the ante 60
Teoriya300: posts the ante 60
DevilsAngel666: posts the ante 60
DartmanD1: posts the ante 60
neris449: posts the ante 60
ventzas: posts small blind 200
jcarlos.vale: posts big blind 400
*** HOLE CARDS ***
Dealt to jcarlos.vale [Jc 2d]
yazvauazva: folds 
Teoriya300: folds 
DevilsAngel666: calls 400
DartmanD1: raises 800 to 1200
neris449: folds 
SJS20382: folds 
ventzas: folds 
jcarlos.vale: folds 
DevilsAngel666: calls 800
*** FLOP *** [Js Jh Ad]
DevilsAngel666: checks 
DartmanD1: bets 1392
DevilsAngel666: folds 
Uncalled bet (1392) returned to DartmanD1
DartmanD1 collected 3480 from pot
*** SUMMARY ***
Total pot 3480 | Rake 0 
Board [Js Jh Ad]
Seat 1: SJS20382 (button) folded before Flop (didn't bet)
Seat 3: ventzas (small blind) folded before Flop
Seat 4: jcarlos.vale (big blind) folded before Flop
Seat 5: yazvauazva folded before Flop (didn't bet)
Seat 6: Teoriya300 folded before Flop (didn't bet)
Seat 7: DevilsAngel666 folded on the Flop
Seat 8: DartmanD1 collected (3480)
Seat 9: neris449 folded before Flop (didn't bet)



PokerStars Hand #221333000148: Tournament #3067368972, $0.25+$0.24+$0.06 USD Hold'em No Limit - Level XVI (200/400) - 2020/12/11 21:32:24 EET [2020/12/11 14:32:24 ET]
Table '3067368972 323' 9-max Seat #3 is the button
Seat 1: SJS20382 (10616 in chips, $0.24 bounty) 
Seat 2: poulant1998 (5000 in chips, $0.24 bounty) 
Seat 3: ventzas (7590 in chips, $0.24 bounty) 
Seat 4: jcarlos.vale (49168 in chips, $1.08 bounty) 
Seat 5: yazvauazva (17034 in chips, $0.24 bounty) 
Seat 6: Teoriya300 (29122 in chips, $0.24 bounty) 
Seat 7: DevilsAngel666 (8259 in chips, $0.24 bounty) 
Seat 8: DartmanD1 (20468 in chips, $0.84 bounty) 
Seat 9: neris449 (15928 in chips, $1.08 bounty) 
SJS20382: posts the ante 60
poulant1998: posts the ante 60
ventzas: posts the ante 60
jcarlos.vale: posts the ante 60
yazvauazva: posts the ante 60
Teoriya300: posts the ante 60
DevilsAngel666: posts the ante 60
DartmanD1: posts the ante 60
neris449: posts the ante 60
jcarlos.vale: posts small blind 200
yazvauazva: posts big blind 400
*** HOLE CARDS ***
Dealt to jcarlos.vale [Ks 7c]
Teoriya300: folds 
DevilsAngel666: folds 
DartmanD1: folds 
neris449: calls 400
SJS20382: folds 
poulant1998: calls 400
ventzas: calls 400
jcarlos.vale: calls 200
yazvauazva: checks 
*** FLOP *** [9c 6d 5s]
jcarlos.vale: checks 
yazvauazva: checks 
neris449: bets 400
poulant1998: folds 
ventzas: calls 400
jcarlos.vale: folds 
DevilsAngel666 said, "fu"
yazvauazva: folds 
*** TURN *** [9c 6d 5s] [Kh]
neris449: checks 
ventzas: checks 
*** RIVER *** [9c 6d 5s Kh] [7s]
neris449: bets 3340
ventzas: folds 
Uncalled bet (3340) returned to neris449
neris449 collected 3340 from pot
neris449: doesn't show handDTO
*** SUMMARY ***
Total pot 3340 | Rake 0 
Board [9c 6d 5s Kh 7s]
Seat 1: SJS20382 folded before Flop (didn't bet)
Seat 2: poulant1998 folded on the Flop
Seat 3: ventzas (button) folded on the River
Seat 4: jcarlos.vale (small blind) folded on the Flop
Seat 5: yazvauazva (big blind) folded on the Flop
Seat 6: Teoriya300 folded before Flop (didn't bet)
Seat 7: DevilsAngel666 folded before Flop (didn't bet)
Seat 8: DartmanD1 folded before Flop (didn't bet)
Seat 9: neris449 collected (3340)



PokerStars Hand #221333100613: Tournament #3067368972, $0.25+$0.24+$0.06 USD Hold'em No Limit - Level XVI (200/400) - 2020/12/11 21:34:55 EET [2020/12/11 14:34:55 ET]
Table '3067368972 323' 9-max Seat #4 is the button
Seat 1: SJS20382 (10556 in chips, $0.24 bounty) 
Seat 2: poulant1998 (4540 in chips, $0.24 bounty) 
Seat 3: ventzas (6730 in chips, $0.24 bounty) 
Seat 4: jcarlos.vale (48708 in chips, $1.08 bounty) 
Seat 5: yazvauazva (16574 in chips, $0.24 bounty) 
Seat 6: Teoriya300 (29062 in chips, $0.24 bounty) 
Seat 7: DevilsAngel666 (8199 in chips, $0.24 bounty) 
Seat 8: DartmanD1 (20408 in chips, $0.84 bounty) 
Seat 9: neris449 (18408 in chips, $1.08 bounty) 
SJS20382: posts the ante 60
poulant1998: posts the ante 60
ventzas: posts the ante 60
jcarlos.vale: posts the ante 60
yazvauazva: posts the ante 60
Teoriya300: posts the ante 60
DevilsAngel666: posts the ante 60
DartmanD1: posts the ante 60
neris449: posts the ante 60
yazvauazva: posts small blind 200
Teoriya300: posts big blind 400
*** HOLE CARDS ***
Dealt to jcarlos.vale [8s Tc]
DevilsAngel666: folds 
DartmanD1: folds 
neris449: calls 400
SJS20382: folds 
poulant1998: folds 
ventzas: calls 400
jcarlos.vale: folds 
yazvauazva: folds 
Teoriya300: checks 
*** FLOP *** [Jh Kd 9h]
Teoriya300: checks 
neris449: checks 
ventzas: checks 
*** TURN *** [Jh Kd 9h] [2s]
Teoriya300: checks 
neris449: checks 
ventzas: checks 
*** RIVER *** [Jh Kd 9h 2s] [6s]
Teoriya300: bets 800
neris449: folds 
ventzas: folds 
Uncalled bet (800) returned to Teoriya300
Teoriya300 collected 1940 from pot
Teoriya300: doesn't show handDTO
*** SUMMARY ***
Total pot 1940 | Rake 0 
Board [Jh Kd 9h 2s 6s]
Seat 1: SJS20382 folded before Flop (didn't bet)
Seat 2: poulant1998 folded before Flop (didn't bet)
Seat 3: ventzas folded on the River
Seat 4: jcarlos.vale (button) folded before Flop (didn't bet)
Seat 5: yazvauazva (small blind) folded before Flop
Seat 6: Teoriya300 (big blind) collected (1940)
Seat 7: DevilsAngel666 folded before Flop (didn't bet)
Seat 8: DartmanD1 folded before Flop (didn't bet)
Seat 9: neris449 folded on the River



PokerStars Hand #221333132529: Tournament #3067368972, $0.25+$0.24+$0.06 USD Hold'em No Limit - Level XVI (200/400) - 2020/12/11 21:35:44 EET [2020/12/11 14:35:44 ET]
Table '3067368972 323' 9-max Seat #5 is the button
Seat 1: SJS20382 (10496 in chips, $0.24 bounty) 
Seat 2: poulant1998 (4480 in chips, $0.24 bounty) 
Seat 3: ventzas (6270 in chips, $0.24 bounty) 
Seat 4: jcarlos.vale (48648 in chips, $1.08 bounty) 
Seat 5: yazvauazva (16314 in chips, $0.24 bounty) 
Seat 6: Teoriya300 (30542 in chips, $0.24 bounty) 
Seat 7: DevilsAngel666 (8139 in chips, $0.24 bounty) 
Seat 8: DartmanD1 (20348 in chips, $0.84 bounty) 
Seat 9: neris449 (17948 in chips, $1.08 bounty) 
SJS20382: posts the ante 60
poulant1998: posts the ante 60
ventzas: posts the ante 60
jcarlos.vale: posts the ante 60
yazvauazva: posts the ante 60
Teoriya300: posts the ante 60
DevilsAngel666: posts the ante 60
DartmanD1: posts the ante 60
neris449: posts the ante 60
Teoriya300: posts small blind 200
DevilsAngel666: posts big blind 400
*** HOLE CARDS ***
Dealt to jcarlos.vale [Ac 3d]
DartmanD1: folds 
neris449: calls 400
SJS20382: folds 
poulant1998: folds 
ventzas: calls 400
jcarlos.vale: folds 
yazvauazva: folds 
Teoriya300: calls 200
DevilsAngel666: raises 7679 to 8079 and is all-in
neris449: folds 
ventzas: folds 
Teoriya300: folds 
Uncalled bet (7679) returned to DevilsAngel666
DevilsAngel666 collected 2140 from pot
*** SUMMARY ***
Total pot 2140 | Rake 0 
Seat 1: SJS20382 folded before Flop (didn't bet)
Seat 2: poulant1998 folded before Flop (didn't bet)
Seat 3: ventzas folded before Flop
Seat 4: jcarlos.vale folded before Flop (didn't bet)
Seat 5: yazvauazva (button) folded before Flop (didn't bet)
Seat 6: Teoriya300 (small blind) folded before Flop
Seat 7: DevilsAngel666 (big blind) collected (2140)
Seat 8: DartmanD1 folded before Flop (didn't bet)
Seat 9: neris449 folded before Flop



PokerStars Hand #221333159388: Tournament #3067368972, $0.25+$0.24+$0.06 USD Hold'em No Limit - Level XVI (200/400) - 2020/12/11 21:36:25 EET [2020/12/11 14:36:25 ET]
Table '3067368972 323' 9-max Seat #6 is the button
Seat 1: SJS20382 (10436 in chips, $0.24 bounty) 
Seat 2: poulant1998 (4420 in chips, $0.24 bounty) 
Seat 3: ventzas (5810 in chips, $0.24 bounty) 
Seat 4: jcarlos.vale (48588 in chips, $1.08 bounty) 
Seat 5: yazvauazva (16254 in chips, $0.24 bounty) 
Seat 6: Teoriya300 (30082 in chips, $0.24 bounty) 
Seat 7: DevilsAngel666 (9819 in chips, $0.24 bounty) 
Seat 8: DartmanD1 (20288 in chips, $0.84 bounty) 
Seat 9: neris449 (17488 in chips, $1.08 bounty) 
SJS20382: posts the ante 60
poulant1998: posts the ante 60
ventzas: posts the ante 60
jcarlos.vale: posts the ante 60
yazvauazva: posts the ante 60
Teoriya300: posts the ante 60
DevilsAngel666: posts the ante 60
DartmanD1: posts the ante 60
neris449: posts the ante 60
DevilsAngel666: posts small blind 200
DartmanD1: posts big blind 400
*** HOLE CARDS ***
Dealt to jcarlos.vale [3h 8d]
neris449: folds 
SJS20382: calls 400
poulant1998: folds 
ventzas: folds 
jcarlos.vale: folds 
yazvauazva: folds 
Teoriya300: folds 
DevilsAngel666: calls 200
DartmanD1: checks 
*** FLOP *** [Ks 9s 5h]
DevilsAngel666: checks 
DartmanD1: checks 
SJS20382: bets 400
DevilsAngel666: calls 400
DartmanD1: folds 
*** TURN *** [Ks 9s 5h] [7s]
DevilsAngel666: checks 
SJS20382: bets 400
DevilsAngel666: calls 400
*** RIVER *** [Ks 9s 5h 7s] [6s]
DevilsAngel666: checks 
SJS20382: bets 1200
DevilsAngel666: calls 1200
*** SHOW DOWN ***
SJS20382: shows [Qs Jh] (a flush, King high)
DevilsAngel666: mucks handDTO
SJS20382 collected 5740 from pot
*** SUMMARY ***
Total pot 5740 | Rake 0 
Board [Ks 9s 5h 7s 6s]
Seat 1: SJS20382 showed [Qs Jh] and won (5740) with a flush, King high
Seat 2: poulant1998 folded before Flop (didn't bet)
Seat 3: ventzas folded before Flop (didn't bet)
Seat 4: jcarlos.vale folded before Flop (didn't bet)
Seat 5: yazvauazva folded before Flop (didn't bet)
Seat 6: Teoriya300 (button) folded before Flop (didn't bet)
Seat 7: DevilsAngel666 (small blind) mucked [Ts Qh]
Seat 8: DartmanD1 (big blind) folded on the Flop
Seat 9: neris449 folded before Flop (didn't bet)



PokerStars Hand #221333193429: Tournament #3067368972, $0.25+$0.24+$0.06 USD Hold'em No Limit - Level XVI (200/400) - 2020/12/11 21:37:16 EET [2020/12/11 14:37:16 ET]
Table '3067368972 323' 9-max Seat #7 is the button
Seat 1: SJS20382 (13716 in chips, $0.24 bounty) 
Seat 2: poulant1998 (4360 in chips, $0.24 bounty) 
Seat 3: ventzas (5750 in chips, $0.24 bounty) 
Seat 4: jcarlos.vale (48528 in chips, $1.08 bounty) 
Seat 5: yazvauazva (16194 in chips, $0.24 bounty) 
Seat 6: Teoriya300 (30022 in chips, $0.24 bounty) 
Seat 7: DevilsAngel666 (7359 in chips, $0.24 bounty) 
Seat 8: DartmanD1 (19828 in chips, $0.84 bounty) 
Seat 9: neris449 (17428 in chips, $1.08 bounty) 
SJS20382: posts the ante 60
poulant1998: posts the ante 60
ventzas: posts the ante 60
jcarlos.vale: posts the ante 60
yazvauazva: posts the ante 60
Teoriya300: posts the ante 60
DevilsAngel666: posts the ante 60
DartmanD1: posts the ante 60
neris449: posts the ante 60
DartmanD1: posts small blind 200
neris449: posts big blind 400
*** HOLE CARDS ***
Dealt to jcarlos.vale [Ah Kd]
SJS20382: folds 
poulant1998: folds 
ventzas: folds 
jcarlos.vale: raises 640 to 1040
yazvauazva: folds 
Teoriya300: folds 
DevilsAngel666: calls 1040
DartmanD1: folds 
neris449: folds 
*** FLOP *** [5s 8d 6h]
jcarlos.vale: checks 
DevilsAngel666: checks 
*** TURN *** [5s 8d 6h] [Kh]
jcarlos.vale: bets 2415
DevilsAngel666: folds 
Uncalled bet (2415) returned to jcarlos.vale
jcarlos.vale collected 3220 from pot
jcarlos.vale: doesn't show handDTO
*** SUMMARY ***
Total pot 3220 | Rake 0 
Board [5s 8d 6h Kh]
Seat 1: SJS20382 folded before Flop (didn't bet)
Seat 2: poulant1998 folded before Flop (didn't bet)
Seat 3: ventzas folded before Flop (didn't bet)
Seat 4: jcarlos.vale collected (3220)
Seat 5: yazvauazva folded before Flop (didn't bet)
Seat 6: Teoriya300 folded before Flop (didn't bet)
Seat 7: DevilsAngel666 (button) folded on the Turn
Seat 8: DartmanD1 (small blind) folded before Flop
Seat 9: neris449 (big blind) folded before Flop



PokerStars Hand #221333215985: Tournament #3067368972, $0.25+$0.24+$0.06 USD Hold'em No Limit - Level XVI (200/400) - 2020/12/11 21:37:50 EET [2020/12/11 14:37:50 ET]
Table '3067368972 323' 9-max Seat #8 is the button
Seat 1: SJS20382 (13656 in chips, $0.24 bounty) 
Seat 2: poulant1998 (4300 in chips, $0.24 bounty) 
Seat 3: ventzas (5690 in chips, $0.24 bounty) 
Seat 4: jcarlos.vale (50648 in chips, $1.08 bounty) 
Seat 5: yazvauazva (16134 in chips, $0.24 bounty) 
Seat 6: Teoriya300 (29962 in chips, $0.24 bounty) 
Seat 7: DevilsAngel666 (6259 in chips, $0.24 bounty) 
Seat 8: DartmanD1 (19568 in chips, $0.84 bounty) 
Seat 9: neris449 (16968 in chips, $1.08 bounty) 
SJS20382: posts the ante 60
poulant1998: posts the ante 60
ventzas: posts the ante 60
jcarlos.vale: posts the ante 60
yazvauazva: posts the ante 60
Teoriya300: posts the ante 60
DevilsAngel666: posts the ante 60
DartmanD1: posts the ante 60
neris449: posts the ante 60
neris449: posts small blind 200
SJS20382: posts big blind 400
*** HOLE CARDS ***
Dealt to jcarlos.vale [Td Jc]
poulant1998: calls 400
ventzas: folds 
jcarlos.vale: folds 
yazvauazva: folds 
Teoriya300: folds 
DevilsAngel666: raises 5799 to 6199 and is all-in
DartmanD1: folds 
neris449: folds 
SJS20382: folds 
poulant1998: folds 
Uncalled bet (5799) returned to DevilsAngel666
DevilsAngel666 collected 1940 from pot
*** SUMMARY ***
Total pot 1940 | Rake 0 
Seat 1: SJS20382 (big blind) folded before Flop
Seat 2: poulant1998 folded before Flop
Seat 3: ventzas folded before Flop (didn't bet)
Seat 4: jcarlos.vale folded before Flop (didn't bet)
Seat 5: yazvauazva folded before Flop (didn't bet)
Seat 6: Teoriya300 folded before Flop (didn't bet)
Seat 7: DevilsAngel666 collected (1940)
Seat 8: DartmanD1 (button) folded before Flop (didn't bet)
Seat 9: neris449 (small blind) folded before Flop



PokerStars Hand #221333238753: Tournament #3067368972, $0.25+$0.24+$0.06 USD Hold'em No Limit - Level XVI (200/400) - 2020/12/11 21:38:25 EET [2020/12/11 14:38:25 ET]
Table '3067368972 323' 9-max Seat #9 is the button
Seat 1: SJS20382 (13196 in chips, $0.24 bounty) 
Seat 2: poulant1998 (3840 in chips, $0.24 bounty) 
Seat 3: ventzas (5630 in chips, $0.24 bounty) 
Seat 4: jcarlos.vale (50588 in chips, $1.08 bounty) 
Seat 5: yazvauazva (16074 in chips, $0.24 bounty) 
Seat 6: Teoriya300 (29902 in chips, $0.24 bounty) 
Seat 7: DevilsAngel666 (7739 in chips, $0.24 bounty) 
Seat 8: DartmanD1 (19508 in chips, $0.84 bounty) 
Seat 9: neris449 (16708 in chips, $1.08 bounty) 
SJS20382: posts the ante 60
poulant1998: posts the ante 60
ventzas: posts the ante 60
jcarlos.vale: posts the ante 60
yazvauazva: posts the ante 60
Teoriya300: posts the ante 60
DevilsAngel666: posts the ante 60
DartmanD1: posts the ante 60
neris449: posts the ante 60
SJS20382: posts small blind 200
poulant1998: posts big blind 400
*** HOLE CARDS ***
Dealt to jcarlos.vale [2h 8s]
ventzas: folds 
jcarlos.vale: folds 
yazvauazva: folds 
Teoriya300: folds 
DevilsAngel666: folds 
DartmanD1: folds 
neris449: calls 400
SJS20382: calls 200
poulant1998: raises 400 to 800
neris449: calls 400
SJS20382: calls 400
*** FLOP *** [Td Kh Js]
SJS20382: checks 
poulant1998: checks 
neris449: checks 
*** TURN *** [Td Kh Js] [6h]
SJS20382: checks 
poulant1998: bets 800
neris449: calls 800
SJS20382: calls 800
*** RIVER *** [Td Kh Js 6h] [Qh]
SJS20382: checks 
poulant1998: checks 
neris449: bets 5340
SJS20382: folds 
poulant1998: calls 2180 and is all-in
Uncalled bet (3160) returned to neris449
*** SHOW DOWN ***
neris449: shows [9c 7d] (a straight, Nine to King)
poulant1998: shows [Ah Ac] (a straight, Ten to Ace)
poulant1998 collected 9700 from pot
*** SUMMARY ***
Total pot 9700 | Rake 0 
Board [Td Kh Js 6h Qh]
Seat 1: SJS20382 (small blind) folded on the River
Seat 2: poulant1998 (big blind) showed [Ah Ac] and won (9700) with a straight, Ten to Ace
Seat 3: ventzas folded before Flop (didn't bet)
Seat 4: jcarlos.vale folded before Flop (didn't bet)
Seat 5: yazvauazva folded before Flop (didn't bet)
Seat 6: Teoriya300 folded before Flop (didn't bet)
Seat 7: DevilsAngel666 folded before Flop (didn't bet)
Seat 8: DartmanD1 folded before Flop (didn't bet)
Seat 9: neris449 (button) showed [9c 7d] and lost with a straight, Nine to King



PokerStars Hand #221333291348: Tournament #3067368972, $0.25+$0.24+$0.06 USD Hold'em No Limit - Level XVII (250/500) - 2020/12/11 21:39:44 EET [2020/12/11 14:39:44 ET]
Table '3067368972 323' 9-max Seat #1 is the button
Seat 1: SJS20382 (11536 in chips, $0.24 bounty) 
Seat 2: poulant1998 (9700 in chips, $0.24 bounty) 
Seat 3: ventzas (5570 in chips, $0.24 bounty) 
Seat 4: jcarlos.vale (50528 in chips, $1.08 bounty) 
Seat 5: yazvauazva (16014 in chips, $0.24 bounty) 
Seat 6: Teoriya300 (29842 in chips, $0.24 bounty) 
Seat 7: DevilsAngel666 (7679 in chips, $0.24 bounty) 
Seat 8: DartmanD1 (19448 in chips, $0.84 bounty) 
Seat 9: neris449 (12868 in chips, $1.08 bounty) 
SJS20382: posts the ante 80
poulant1998: posts the ante 80
ventzas: posts the ante 80
jcarlos.vale: posts the ante 80
yazvauazva: posts the ante 80
Teoriya300: posts the ante 80
DevilsAngel666: posts the ante 80
DartmanD1: posts the ante 80
neris449: posts the ante 80
poulant1998: posts small blind 250
ventzas: posts big blind 500
*** HOLE CARDS ***
Dealt to jcarlos.vale [2d 2c]
jcarlos.vale: calls 500
yazvauazva: folds 
Teoriya300: folds 
DevilsAngel666: raises 1000 to 1500
DartmanD1: calls 1500
neris449: calls 1500
SJS20382: folds 
poulant1998: folds 
ventzas: calls 1000
jcarlos.vale: calls 1000
*** FLOP *** [Jh Kh 9c]
ventzas: checks 
jcarlos.vale: checks 
DevilsAngel666: bets 6099 and is all-in
DartmanD1: calls 6099
neris449: calls 6099
ventzas: folds 
jcarlos.vale: folds 
*** TURN *** [Jh Kh 9c] [Td]
DartmanD1: checks 
neris449: checks 
*** RIVER *** [Jh Kh 9c Td] [Ad]
DartmanD1: checks 
neris449: checks 
*** SHOW DOWN ***
DevilsAngel666: shows [Qs 9s] (a straight, Ten to Ace)
DartmanD1: mucks handDTO
neris449: mucks handDTO
DevilsAngel666 collected 26767 from pot
*** SUMMARY ***
Total pot 26767 | Rake 0 
Board [Jh Kh 9c Td Ad]
Seat 1: SJS20382 (button) folded before Flop (didn't bet)
Seat 2: poulant1998 (small blind) folded before Flop
Seat 3: ventzas (big blind) folded on the Flop
Seat 4: jcarlos.vale folded on the Flop
Seat 5: yazvauazva folded before Flop (didn't bet)
Seat 6: Teoriya300 folded before Flop (didn't bet)
Seat 7: DevilsAngel666 showed [Qs 9s] and won (26767) with a straight, Ten to Ace
Seat 8: DartmanD1 mucked [Js 8s]
Seat 9: neris449 mucked [5h Kd]



PokerStars Hand #221333348381: Tournament #3067368972, $0.25+$0.24+$0.06 USD Hold'em No Limit - Level XVII (250/500) - 2020/12/11 21:41:10 EET [2020/12/11 14:41:10 ET]
Table '3067368972 323' 9-max Seat #2 is the button
Seat 1: SJS20382 (11456 in chips, $0.24 bounty) 
Seat 2: poulant1998 (9370 in chips, $0.24 bounty) 
Seat 3: ventzas (3990 in chips, $0.24 bounty) 
Seat 4: jcarlos.vale (48948 in chips, $1.08 bounty) 
Seat 5: yazvauazva (15934 in chips, $0.24 bounty) 
Seat 6: Teoriya300 (29762 in chips, $0.24 bounty) 
Seat 7: DevilsAngel666 (26767 in chips, $0.24 bounty) 
Seat 8: DartmanD1 (11769 in chips, $0.84 bounty) 
Seat 9: neris449 (5189 in chips, $1.08 bounty) 
SJS20382: posts the ante 80
poulant1998: posts the ante 80
ventzas: posts the ante 80
jcarlos.vale: posts the ante 80
yazvauazva: posts the ante 80
Teoriya300: posts the ante 80
DevilsAngel666: posts the ante 80
DartmanD1: posts the ante 80
neris449: posts the ante 80
ventzas: posts small blind 250
jcarlos.vale: posts big blind 500
*** HOLE CARDS ***
Dealt to jcarlos.vale [8s 7d]
yazvauazva: folds 
Teoriya300: folds 
DevilsAngel666: folds 
DartmanD1: folds 
neris449: raises 4609 to 5109 and is all-in
SJS20382: folds 
poulant1998: folds 
ventzas: folds 
jcarlos.vale: folds 
Uncalled bet (4609) returned to neris449
neris449 collected 1970 from pot
neris449: doesn't show handDTO
*** SUMMARY ***
Total pot 1970 | Rake 0 
Seat 1: SJS20382 folded before Flop (didn't bet)
Seat 2: poulant1998 (button) folded before Flop (didn't bet)
Seat 3: ventzas (small blind) folded before Flop
Seat 4: jcarlos.vale (big blind) folded before Flop
Seat 5: yazvauazva folded before Flop (didn't bet)
Seat 6: Teoriya300 folded before Flop (didn't bet)
Seat 7: DevilsAngel666 folded before Flop (didn't bet)
Seat 8: DartmanD1 folded before Flop (didn't bet)
Seat 9: neris449 collected (1970)



PokerStars Hand #221333374393: Tournament #3067368972, $0.25+$0.24+$0.06 USD Hold'em No Limit - Level XVII (250/500) - 2020/12/11 21:41:48 EET [2020/12/11 14:41:48 ET]
Table '3067368972 323' 9-max Seat #3 is the button
Seat 1: SJS20382 (11376 in chips, $0.24 bounty) 
Seat 2: poulant1998 (9290 in chips, $0.24 bounty) 
Seat 3: ventzas (3660 in chips, $0.24 bounty) 
Seat 4: jcarlos.vale (48368 in chips, $1.08 bounty) 
Seat 5: yazvauazva (15854 in chips, $0.24 bounty) 
Seat 6: Teoriya300 (29682 in chips, $0.24 bounty) 
Seat 7: DevilsAngel666 (26687 in chips, $0.24 bounty) 
Seat 8: DartmanD1 (11689 in chips, $0.84 bounty) 
Seat 9: neris449 (6579 in chips, $1.08 bounty) 
SJS20382: posts the ante 80
poulant1998: posts the ante 80
ventzas: posts the ante 80
jcarlos.vale: posts the ante 80
yazvauazva: posts the ante 80
Teoriya300: posts the ante 80
DevilsAngel666: posts the ante 80
DartmanD1: posts the ante 80
neris449: posts the ante 80
jcarlos.vale: posts small blind 250
yazvauazva: posts big blind 500
*** HOLE CARDS ***
Dealt to jcarlos.vale [4c 2c]
Teoriya300: folds 
DevilsAngel666: folds 
DartmanD1: folds 
neris449: calls 500
SJS20382: folds 
poulant1998: folds 
ventzas: folds 
jcarlos.vale: calls 250
yazvauazva: checks 
*** FLOP *** [Jh 8s 3d]
jcarlos.vale: checks 
yazvauazva: checks 
neris449: checks 
*** TURN *** [Jh 8s 3d] [5s]
jcarlos.vale: checks 
yazvauazva: checks 
neris449: checks 
*** RIVER *** [Jh 8s 3d 5s] [Ts]
jcarlos.vale: checks 
yazvauazva: checks 
neris449: checks 
*** SHOW DOWN ***
jcarlos.vale: shows [4c 2c] (high pairOfCards Jack)
yazvauazva: shows [4d Qs] (high pairOfCards Queen)
neris449: shows [Qh 6c] (high pairOfCards Queen - Jack+Ten+Eight+Six kicker)
neris449 collected 2220 from pot
*** SUMMARY ***
Total pot 2220 | Rake 0 
Board [Jh 8s 3d 5s Ts]
Seat 1: SJS20382 folded before Flop (didn't bet)
Seat 2: poulant1998 folded before Flop (didn't bet)
Seat 3: ventzas (button) folded before Flop (didn't bet)
Seat 4: jcarlos.vale (small blind) showed [4c 2c] and lost with high pairOfCards Jack
Seat 5: yazvauazva (big blind) showed [4d Qs] and lost with high pairOfCards Queen
Seat 6: Teoriya300 folded before Flop (didn't bet)
Seat 7: DevilsAngel666 folded before Flop (didn't bet)
Seat 8: DartmanD1 folded before Flop (didn't bet)
Seat 9: neris449 showed [Qh 6c] and won (2220) with high pairOfCards Queen



PokerStars Hand #221333421717: Tournament #3067368972, $0.25+$0.24+$0.06 USD Hold'em No Limit - Level XVII (250/500) - 2020/12/11 21:42:59 EET [2020/12/11 14:42:59 ET]
Table '3067368972 323' 9-max Seat #4 is the button
Seat 1: SJS20382 (11296 in chips, $0.24 bounty) 
Seat 2: poulant1998 (9210 in chips, $0.24 bounty) 
Seat 3: ventzas (3580 in chips, $0.24 bounty) 
Seat 4: jcarlos.vale (47788 in chips, $1.08 bounty) 
Seat 5: yazvauazva (15274 in chips, $0.24 bounty) 
Seat 6: Teoriya300 (29602 in chips, $0.24 bounty) 
Seat 7: DevilsAngel666 (26607 in chips, $0.24 bounty) 
Seat 8: DartmanD1 (11609 in chips, $0.84 bounty) 
Seat 9: neris449 (8219 in chips, $1.08 bounty) 
SJS20382: posts the ante 80
poulant1998: posts the ante 80
ventzas: posts the ante 80
jcarlos.vale: posts the ante 80
yazvauazva: posts the ante 80
Teoriya300: posts the ante 80
DevilsAngel666: posts the ante 80
DartmanD1: posts the ante 80
neris449: posts the ante 80
yazvauazva: posts small blind 250
Teoriya300: posts big blind 500
*** HOLE CARDS ***
Dealt to jcarlos.vale [Ac 7d]
DevilsAngel666: calls 500
DartmanD1: raises 1500 to 2000
neris449: folds 
SJS20382: folds 
poulant1998: folds 
ventzas: raises 1500 to 3500 and is all-in
jcarlos.vale: folds 
yazvauazva: folds 
Teoriya300: folds 
DevilsAngel666: folds 
DartmanD1: calls 1500
*** FLOP *** [7s Tc Ad]
*** TURN *** [7s Tc Ad] [Ts]
*** RIVER *** [7s Tc Ad Ts] [Qh]
*** SHOW DOWN ***
DartmanD1: shows [As Ah] (a full house, Aces full of Tens)
ventzas: shows [Jd Ks] (a straight, Ten to Ace)
DartmanD1 collected 8970 from pot
DartmanD1 wins $0.12 for eliminating ventzas and their own bounty increases by $0.12 to $0.96
ventzas finished the tournament in 1635th place
*** SUMMARY ***
Total pot 8970 | Rake 0 
Board [7s Tc Ad Ts Qh]
Seat 1: SJS20382 folded before Flop (didn't bet)
Seat 2: poulant1998 folded before Flop (didn't bet)
Seat 3: ventzas showed [Jd Ks] and lost with a straight, Ten to Ace
Seat 4: jcarlos.vale (button) folded before Flop (didn't bet)
Seat 5: yazvauazva (small blind) folded before Flop
Seat 6: Teoriya300 (big blind) folded before Flop
Seat 7: DevilsAngel666 folded before Flop
Seat 8: DartmanD1 showed [As Ah] and won (8970) with a full house, Aces full of Tens
Seat 9: neris449 folded before Flop (didn't bet)



PokerStars Hand #221333459374: Tournament #3067368972, $0.25+$0.24+$0.06 USD Hold'em No Limit - Level XVII (250/500) - 2020/12/11 21:43:42 EET [2020/12/11 14:43:42 ET]
Table '3067368972 323' 9-max Seat #5 is the button
Seat 1: SJS20382 (11216 in chips, $0.24 bounty) 
Seat 2: poulant1998 (9130 in chips, $0.24 bounty) 
Seat 4: jcarlos.vale (47708 in chips, $1.08 bounty) 
Seat 5: yazvauazva (14944 in chips, $0.24 bounty) 
Seat 6: Teoriya300 (29022 in chips, $0.24 bounty) 
Seat 7: DevilsAngel666 (26027 in chips, $0.24 bounty) 
Seat 8: DartmanD1 (16999 in chips, $0.96 bounty) 
Seat 9: neris449 (8139 in chips, $1.08 bounty) 
SJS20382: posts the ante 80
poulant1998: posts the ante 80
jcarlos.vale: posts the ante 80
yazvauazva: posts the ante 80
Teoriya300: posts the ante 80
DevilsAngel666: posts the ante 80
DartmanD1: posts the ante 80
neris449: posts the ante 80
Teoriya300: posts small blind 250
DevilsAngel666: posts big blind 500
*** HOLE CARDS ***
Dealt to jcarlos.vale [Ac Js]
DartmanD1: raises 500 to 1000
neris449: calls 1000
SJS20382: folds 
poulant1998: folds 
jcarlos.vale: calls 1000
yazvauazva: folds 
Teoriya300: calls 750
DevilsAngel666: calls 500
*** FLOP *** [6h 5s Kh]
Teoriya300: checks 
DevilsAngel666: checks 
DartmanD1: bets 1500
neris449: calls 1500
jcarlos.vale: folds 
Teoriya300: folds 
SJS20382 is disconnected 
DevilsAngel666: folds 
*** TURN *** [6h 5s Kh] [3c]
DartmanD1: bets 6480
neris449: folds 
Uncalled bet (6480) returned to DartmanD1
DartmanD1 collected 8640 from pot
*** SUMMARY ***
Total pot 8640 | Rake 0 
Board [6h 5s Kh 3c]
Seat 1: SJS20382 folded before Flop (didn't bet)
Seat 2: poulant1998 folded before Flop (didn't bet)
Seat 4: jcarlos.vale folded on the Flop
Seat 5: yazvauazva (button) folded before Flop (didn't bet)
Seat 6: Teoriya300 (small blind) folded on the Flop
Seat 7: DevilsAngel666 (big blind) folded on the Flop
Seat 8: DartmanD1 collected (8640)
Seat 9: neris449 folded on the Turn



PokerStars Hand #221333497039: Tournament #3067368972, $0.25+$0.24+$0.06 USD Hold'em No Limit - Level XVII (250/500) - 2020/12/11 21:44:38 EET [2020/12/11 14:44:38 ET]
Table '3067368972 323' 9-max Seat #6 is the button
Seat 1: SJS20382 (11136 in chips, $0.24 bounty) 
Seat 2: poulant1998 (9050 in chips, $0.24 bounty) 
Seat 3: Darken528 (24816 in chips, $0.48 bounty) 
Seat 4: jcarlos.vale (46628 in chips, $1.08 bounty) 
Seat 5: yazvauazva (14864 in chips, $0.24 bounty) 
Seat 6: Teoriya300 (27942 in chips, $0.24 bounty) 
Seat 7: DevilsAngel666 (24947 in chips, $0.24 bounty) 
Seat 8: DartmanD1 (23059 in chips, $0.96 bounty) 
Seat 9: neris449 (5559 in chips, $1.08 bounty) 
SJS20382: posts the ante 80
poulant1998: posts the ante 80
Darken528: posts the ante 80
jcarlos.vale: posts the ante 80
yazvauazva: posts the ante 80
Teoriya300: posts the ante 80
DevilsAngel666: posts the ante 80
DartmanD1: posts the ante 80
neris449: posts the ante 80
DevilsAngel666: posts small blind 250
DartmanD1: posts big blind 500
*** HOLE CARDS ***
Dealt to jcarlos.vale [Qd Jh]
neris449: folds 
SJS20382: calls 500
poulant1998: calls 500
Darken528: folds 
jcarlos.vale: raises 800 to 1300
yazvauazva: folds 
Teoriya300: folds 
DevilsAngel666: calls 1050
DartmanD1: folds 
SJS20382: calls 800
poulant1998: calls 800
*** FLOP *** [7s 8h Jc]
DevilsAngel666: checks 
SJS20382: checks 
poulant1998: checks 
jcarlos.vale: bets 4815
DevilsAngel666: folds 
SJS20382: folds 
poulant1998: folds 
Uncalled bet (4815) returned to jcarlos.vale
jcarlos.vale collected 6420 from pot
jcarlos.vale: doesn't show handDTO
*** SUMMARY ***
Total pot 6420 | Rake 0 
Board [7s 8h Jc]
Seat 1: SJS20382 folded on the Flop
Seat 2: poulant1998 folded on the Flop
Seat 3: Darken528 folded before Flop (didn't bet)
Seat 4: jcarlos.vale collected (6420)
Seat 5: yazvauazva folded before Flop (didn't bet)
Seat 6: Teoriya300 (button) folded before Flop (didn't bet)
Seat 7: DevilsAngel666 (small blind) folded on the Flop
Seat 8: DartmanD1 (big blind) folded before Flop
Seat 9: neris449 folded before Flop (didn't bet)



PokerStars Hand #221333538195: Tournament #3067368972, $0.25+$0.24+$0.06 USD Hold'em No Limit - Level XVII (250/500) - 2020/12/11 21:45:39 EET [2020/12/11 14:45:39 ET]
Table '3067368972 323' 9-max Seat #7 is the button
Seat 1: SJS20382 (9756 in chips, $0.24 bounty) 
Seat 2: poulant1998 (7670 in chips, $0.24 bounty) 
Seat 3: Darken528 (24736 in chips, $0.48 bounty) 
Seat 4: jcarlos.vale (51668 in chips, $1.08 bounty) 
Seat 5: yazvauazva (14784 in chips, $0.24 bounty) 
Seat 6: Teoriya300 (27862 in chips, $0.24 bounty) 
Seat 7: DevilsAngel666 (23567 in chips, $0.24 bounty) 
Seat 8: DartmanD1 (22479 in chips, $0.96 bounty) 
Seat 9: neris449 (5479 in chips, $1.08 bounty) 
SJS20382: posts the ante 80
poulant1998: posts the ante 80
Darken528: posts the ante 80
jcarlos.vale: posts the ante 80
yazvauazva: posts the ante 80
Teoriya300: posts the ante 80
DevilsAngel666: posts the ante 80
DartmanD1: posts the ante 80
neris449: posts the ante 80
DartmanD1: posts small blind 250
neris449: posts big blind 500
*** HOLE CARDS ***
Dealt to jcarlos.vale [4c Ks]
SJS20382: raises 1970 to 2470
poulant1998: folds 
Darken528: folds 
jcarlos.vale: folds 
yazvauazva: folds 
Teoriya300: folds 
DevilsAngel666: raises 6410 to 8880
DartmanD1: folds 
neris449: calls 4899 and is all-in
SJS20382: raises 796 to 9676 and is all-in
DevilsAngel666: calls 796
*** FLOP *** [Jh 8h Jc]
*** TURN *** [Jh 8h Jc] [3s]
*** RIVER *** [Jh 8h Jc 3s] [6c]
*** SHOW DOWN ***
SJS20382: shows [9h 9d] (two pair, Jacks and Nines)
DevilsAngel666: shows [As Ac] (two pair, Aces and Jacks)
DevilsAngel666 collected 8554 from side pot
neris449: shows [7s Ah] (a pair of Jacks)
DevilsAngel666 collected 17167 from main pot
DevilsAngel666 wins $0.12 for eliminating SJS20382 and their own bounty increases by $0.12 to $0.36
DevilsAngel666 wins $0.54 for eliminating neris449 and their own bounty increases by $0.54 to $0.90
SJS20382 finished the tournament in 1535th place
neris449 finished the tournament in 1536th place
*** SUMMARY ***
Total pot 25721 Main pot 17167. Side pot 8554. | Rake 0 
Board [Jh 8h Jc 3s 6c]
Seat 1: SJS20382 showed [9h 9d] and lost with two pair, Jacks and Nines
Seat 2: poulant1998 folded before Flop (didn't bet)
Seat 3: Darken528 folded before Flop (didn't bet)
Seat 4: jcarlos.vale folded before Flop (didn't bet)
Seat 5: yazvauazva folded before Flop (didn't bet)
Seat 6: Teoriya300 folded before Flop (didn't bet)
Seat 7: DevilsAngel666 (button) showed [As Ac] and won (25721) with two pair, Aces and Jacks
Seat 8: DartmanD1 (small blind) folded before Flop
Seat 9: neris449 (big blind) showed [7s Ah] and lost with a pair of Jacks



PokerStars Hand #221333566122: Tournament #3067368972, $0.25+$0.24+$0.06 USD Hold'em No Limit - Level XVII (250/500) - 2020/12/11 21:46:20 EET [2020/12/11 14:46:20 ET]
Table '3067368972 323' 9-max Seat #8 is the button
Seat 1: TRICOLOR13SP (9169 in chips) out of handDTO (moved from another table into small blind)
Seat 2: poulant1998 (7590 in chips, $0.24 bounty) 
Seat 3: Darken528 (24656 in chips, $0.48 bounty) 
Seat 4: jcarlos.vale (51588 in chips, $1.08 bounty) 
Seat 5: yazvauazva (14704 in chips, $0.24 bounty) 
Seat 6: Teoriya300 (27782 in chips, $0.24 bounty) 
Seat 7: DevilsAngel666 (39532 in chips, $0.90 bounty) 
Seat 8: DartmanD1 (22149 in chips, $0.96 bounty) 
TRICOLOR13SP will be allowed to play after the button
poulant1998: posts the ante 80
Darken528: posts the ante 80
jcarlos.vale: posts the ante 80
yazvauazva: posts the ante 80
Teoriya300: posts the ante 80
DevilsAngel666: posts the ante 80
DartmanD1: posts the ante 80
poulant1998: posts small blind 250
Darken528: posts big blind 500
*** HOLE CARDS ***
Dealt to jcarlos.vale [Th 9h]
jcarlos.vale: folds 
yazvauazva: folds 
Teoriya300: folds 
DevilsAngel666: folds 
DartmanD1: raises 750 to 1250
poulant1998: calls 1000
Darken528: folds 
*** FLOP *** [5d 6c 3h]
poulant1998: bets 500
DartmanD1: calls 500
*** TURN *** [5d 6c 3h] [Kd]
poulant1998: checks 
DartmanD1: checks 
*** RIVER *** [5d 6c 3h Kd] [6h]
poulant1998: bets 2000
DartmanD1: folds 
Uncalled bet (2000) returned to poulant1998
poulant1998 collected 4560 from pot
*** SUMMARY ***
Total pot 4560 | Rake 0 
Board [5d 6c 3h Kd 6h]
Seat 2: poulant1998 (small blind) collected (4560)
Seat 3: Darken528 (big blind) folded before Flop
Seat 4: jcarlos.vale folded before Flop (didn't bet)
Seat 5: yazvauazva folded before Flop (didn't bet)
Seat 6: Teoriya300 folded before Flop (didn't bet)
Seat 7: DevilsAngel666 folded before Flop (didn't bet)
Seat 8: DartmanD1 (button) folded on the River



PokerStars Hand #221333615174: Tournament #3067368972, $0.25+$0.24+$0.06 USD Hold'em No Limit - Level XVIII (300/600) - 2020/12/11 21:47:33 EET [2020/12/11 14:47:33 ET]
Table '3067368972 323' 9-max Seat #2 is the button
Seat 1: TRICOLOR13SP (9169 in chips, $0.36 bounty) 
Seat 2: poulant1998 (10320 in chips, $0.24 bounty) 
Seat 3: Darken528 (24076 in chips, $0.48 bounty) 
Seat 4: jcarlos.vale (51508 in chips, $1.08 bounty) 
Seat 5: yazvauazva (14624 in chips, $0.24 bounty) 
Seat 6: Teoriya300 (27702 in chips, $0.24 bounty) 
Seat 7: DevilsAngel666 (39452 in chips, $0.90 bounty) 
Seat 8: DartmanD1 (20319 in chips, $0.96 bounty) 
Seat 9: thespych (2961 in chips, $0.36 bounty) 
TRICOLOR13SP: posts the ante 90
poulant1998: posts the ante 90
Darken528: posts the ante 90
jcarlos.vale: posts the ante 90
yazvauazva: posts the ante 90
Teoriya300: posts the ante 90
DevilsAngel666: posts the ante 90
DartmanD1: posts the ante 90
thespych: posts the ante 90
Darken528: posts small blind 300
jcarlos.vale: posts big blind 600
*** HOLE CARDS ***
Dealt to jcarlos.vale [2d Ad]
yazvauazva: folds 
Teoriya300: raises 600 to 1200
DevilsAngel666: folds 
DartmanD1: calls 1200
thespych: folds 
TRICOLOR13SP: folds 
poulant1998: folds 
Darken528: calls 900
jcarlos.vale: calls 600
*** FLOP *** [5s 9s 3c]
Darken528: checks 
jcarlos.vale: checks 
Teoriya300: bets 3000
DartmanD1: raises 16029 to 19029 and is all-in
Darken528: folds 
jcarlos.vale: folds 
Teoriya300: calls 16029
*** TURN *** [5s 9s 3c] [Th]
*** RIVER *** [5s 9s 3c Th] [6h]
*** SHOW DOWN ***
Teoriya300: shows [Jc Js] (a pair of Jacks)
DartmanD1: shows [Ks 7s] (high pairOfCards King)
Teoriya300 collected 43668 from pot
Teoriya300 wins $0.48 for eliminating DartmanD1 and their own bounty increases by $0.48 to $0.72
DartmanD1 finished the tournament in 1450th place
*** SUMMARY ***
Total pot 43668 | Rake 0 
Board [5s 9s 3c Th 6h]
Seat 1: TRICOLOR13SP folded before Flop (didn't bet)
Seat 2: poulant1998 (button) folded before Flop (didn't bet)
Seat 3: Darken528 (small blind) folded on the Flop
Seat 4: jcarlos.vale (big blind) folded on the Flop
Seat 5: yazvauazva folded before Flop (didn't bet)
Seat 6: Teoriya300 showed [Jc Js] and won (43668) with a pair of Jacks
Seat 7: DevilsAngel666 folded before Flop (didn't bet)
Seat 8: DartmanD1 showed [Ks 7s] and lost with high pairOfCards King
Seat 9: thespych folded before Flop (didn't bet)



PokerStars Hand #221333704454: Tournament #3067368972, $0.25+$0.24+$0.06 USD Hold'em No Limit - Level XVIII (300/600) - 2020/12/11 21:49:46 EET [2020/12/11 14:49:46 ET]
Table '3067368972 51' 9-max Seat #9 is the button
Seat 1: Dapper14 (50263 in chips, $1.26 bounty) 
Seat 2: murtypoker (19562 in chips, $1.44 bounty) 
Seat 3: liverpool f1 (27552 in chips, $0.78 bounty) 
Seat 4: pafax (34372 in chips, $0.90 bounty) 
Seat 5: VMPCE (6690 in chips, $0.24 bounty) 
Seat 6: heberiver (50635 in chips, $0.72 bounty) 
Seat 7: DerGamingOpa (46245 in chips, $0.60 bounty) 
Seat 8: jcarlos.vale (50218 in chips, $1.08 bounty) 
Seat 9: Anderson9976 (14124 in chips, $0.66 bounty) 
Dapper14: posts the ante 90
murtypoker: posts the ante 90
liverpool f1: posts the ante 90
pafax: posts the ante 90
VMPCE: posts the ante 90
heberiver: posts the ante 90
DerGamingOpa: posts the ante 90
jcarlos.vale: posts the ante 90
Anderson9976: posts the ante 90
Dapper14: posts small blind 300
murtypoker: posts big blind 600
*** HOLE CARDS ***
Dealt to jcarlos.vale [Qs Js]
liverpool f1 has timed out
liverpool f1: folds 
liverpool f1 is sitting out
pafax: folds 
VMPCE: folds 
heberiver: folds 
DerGamingOpa: folds 
liverpool f1 has returned
jcarlos.vale: raises 960 to 1560
Anderson9976: folds 
Dapper14: calls 1260
murtypoker: calls 960
*** FLOP *** [2s 6d 7d]
Dapper14: checks 
murtypoker: checks 
jcarlos.vale: checks 
*** TURN *** [2s 6d 7d] [7s]
Dapper14: bets 1800
murtypoker: folds 
jcarlos.vale: folds 
Uncalled bet (1800) returned to Dapper14
Dapper14 collected 5490 from pot
Dapper14: doesn't show handDTO
*** SUMMARY ***
Total pot 5490 | Rake 0 
Board [2s 6d 7d 7s]
Seat 1: Dapper14 (small blind) collected (5490)
Seat 2: murtypoker (big blind) folded on the Turn
Seat 3: liverpool f1 folded before Flop (didn't bet)
Seat 4: pafax folded before Flop (didn't bet)
Seat 5: VMPCE folded before Flop (didn't bet)
Seat 6: heberiver folded before Flop (didn't bet)
Seat 7: DerGamingOpa folded before Flop (didn't bet)
Seat 8: jcarlos.vale folded on the Turn
Seat 9: Anderson9976 (button) folded before Flop (didn't bet)



PokerStars Hand #221333771243: Tournament #3067368972, $0.25+$0.24+$0.06 USD Hold'em No Limit - Level XVIII (300/600) - 2020/12/11 21:51:24 EET [2020/12/11 14:51:24 ET]
Table '3067368972 51' 9-max Seat #1 is the button
Seat 1: Dapper14 (54103 in chips, $1.26 bounty) 
Seat 2: murtypoker (17912 in chips, $1.44 bounty) 
Seat 3: liverpool f1 (27462 in chips, $0.78 bounty) 
Seat 4: pafax (34282 in chips, $0.90 bounty) 
Seat 5: VMPCE (6600 in chips, $0.24 bounty) 
Seat 6: heberiver (50545 in chips, $0.72 bounty) 
Seat 7: DerGamingOpa (46155 in chips, $0.60 bounty) 
Seat 8: jcarlos.vale (48568 in chips, $1.08 bounty) 
Seat 9: Anderson9976 (14034 in chips, $0.66 bounty) 
Dapper14: posts the ante 90
murtypoker: posts the ante 90
liverpool f1: posts the ante 90
pafax: posts the ante 90
VMPCE: posts the ante 90
heberiver: posts the ante 90
DerGamingOpa: posts the ante 90
jcarlos.vale: posts the ante 90
Anderson9976: posts the ante 90
murtypoker: posts small blind 300
liverpool f1: posts big blind 600
*** HOLE CARDS ***
Dealt to jcarlos.vale [4s 5d]
pafax: calls 600
VMPCE: folds 
heberiver: folds 
DerGamingOpa: folds 
jcarlos.vale: folds 
Anderson9976: folds 
Dapper14: calls 600
murtypoker: calls 300
liverpool f1: raises 3210 to 3810
pafax: folds 
Dapper14: folds 
murtypoker: folds 
Uncalled bet (3210) returned to liverpool f1
liverpool f1 collected 3210 from pot
liverpool f1: doesn't show handDTO
*** SUMMARY ***
Total pot 3210 | Rake 0 
Seat 1: Dapper14 (button) folded before Flop
Seat 2: murtypoker (small blind) folded before Flop
Seat 3: liverpool f1 (big blind) collected (3210)
Seat 4: pafax folded before Flop
Seat 5: VMPCE folded before Flop (didn't bet)
Seat 6: heberiver folded before Flop (didn't bet)
Seat 7: DerGamingOpa folded before Flop (didn't bet)
Seat 8: jcarlos.vale folded before Flop (didn't bet)
Seat 9: Anderson9976 folded before Flop (didn't bet)



PokerStars Hand #221333809872: Tournament #3067368972, $0.25+$0.24+$0.06 USD Hold'em No Limit - Level XVIII (300/600) - 2020/12/11 21:52:20 EET [2020/12/11 14:52:20 ET]
Table '3067368972 51' 9-max Seat #2 is the button
Seat 1: Dapper14 (53413 in chips, $1.26 bounty) 
Seat 2: murtypoker (17222 in chips, $1.44 bounty) 
Seat 3: liverpool f1 (29982 in chips, $0.78 bounty) 
Seat 4: pafax (33592 in chips, $0.90 bounty) 
Seat 5: VMPCE (6510 in chips, $0.24 bounty) 
Seat 6: heberiver (50455 in chips, $0.72 bounty) 
Seat 7: DerGamingOpa (46065 in chips, $0.60 bounty) 
Seat 8: jcarlos.vale (48478 in chips, $1.08 bounty) 
Seat 9: Anderson9976 (13944 in chips, $0.66 bounty) 
Dapper14: posts the ante 90
murtypoker: posts the ante 90
liverpool f1: posts the ante 90
pafax: posts the ante 90
VMPCE: posts the ante 90
heberiver: posts the ante 90
DerGamingOpa: posts the ante 90
jcarlos.vale: posts the ante 90
Anderson9976: posts the ante 90
liverpool f1: posts small blind 300
pafax: posts big blind 600
*** HOLE CARDS ***
Dealt to jcarlos.vale [2c 7h]
VMPCE: folds 
heberiver: raises 1200 to 1800
DerGamingOpa: folds 
jcarlos.vale: folds 
Anderson9976: raises 12054 to 13854 and is all-in
Dapper14: folds 
murtypoker: folds 
liverpool f1: folds 
pafax: folds 
heberiver: calls 12054
*** FLOP *** [Kc 9h 2d]
*** TURN *** [Kc 9h 2d] [8d]
*** RIVER *** [Kc 9h 2d 8d] [3c]
*** SHOW DOWN ***
heberiver: shows [Kd Ah] (a pair of Kings)
Anderson9976: shows [Ad Qh] (high pairOfCards Ace)
heberiver collected 29418 from pot
heberiver wins $0.33 for eliminating Anderson9976 and their own bounty increases by $0.33 to $1.05
Anderson9976 finished the tournament in 1314th place
*** SUMMARY ***
Total pot 29418 | Rake 0 
Board [Kc 9h 2d 8d 3c]
Seat 1: Dapper14 folded before Flop (didn't bet)
Seat 2: murtypoker (button) folded before Flop (didn't bet)
Seat 3: liverpool f1 (small blind) folded before Flop
Seat 4: pafax (big blind) folded before Flop
Seat 5: VMPCE folded before Flop (didn't bet)
Seat 6: heberiver showed [Kd Ah] and won (29418) with a pair of Kings
Seat 7: DerGamingOpa folded before Flop (didn't bet)
Seat 8: jcarlos.vale folded before Flop (didn't bet)
Seat 9: Anderson9976 showed [Ad Qh] and lost with high pairOfCards Ace



PokerStars Hand #221333839326: Tournament #3067368972, $0.25+$0.24+$0.06 USD Hold'em No Limit - Level XVIII (300/600) - 2020/12/11 21:53:03 EET [2020/12/11 14:53:03 ET]
Table '3067368972 51' 9-max Seat #3 is the button
Seat 1: Dapper14 (53323 in chips, $1.26 bounty) 
Seat 2: murtypoker (17132 in chips, $1.44 bounty) 
Seat 3: liverpool f1 (29592 in chips, $0.78 bounty) 
Seat 4: pafax (32902 in chips, $0.90 bounty) 
Seat 5: VMPCE (6420 in chips, $0.24 bounty) 
Seat 6: heberiver (65929 in chips, $1.05 bounty) 
Seat 7: DerGamingOpa (45975 in chips, $0.60 bounty) 
Seat 8: jcarlos.vale (48388 in chips, $1.08 bounty) 
Dapper14: posts the ante 90
murtypoker: posts the ante 90
liverpool f1: posts the ante 90
pafax: posts the ante 90
VMPCE: posts the ante 90
heberiver: posts the ante 90
DerGamingOpa: posts the ante 90
jcarlos.vale: posts the ante 90
pafax: posts small blind 300
VMPCE: posts big blind 600
*** HOLE CARDS ***
Dealt to jcarlos.vale [5s Qc]
heberiver has timed out
heberiver: folds 
heberiver is sitting out
DerGamingOpa: folds 
jcarlos.vale: folds 
Dapper14: folds 
murtypoker: folds 
heberiver has returned
liverpool f1: folds 
pafax: folds 
Uncalled bet (300) returned to VMPCE
VMPCE collected 1320 from pot
VMPCE: doesn't show handDTO
*** SUMMARY ***
Total pot 1320 | Rake 0 
Seat 1: Dapper14 folded before Flop (didn't bet)
Seat 2: murtypoker folded before Flop (didn't bet)
Seat 3: liverpool f1 (button) folded before Flop (didn't bet)
Seat 4: pafax (small blind) folded before Flop
Seat 5: VMPCE (big blind) collected (1320)
Seat 6: heberiver folded before Flop (didn't bet)
Seat 7: DerGamingOpa folded before Flop (didn't bet)
Seat 8: jcarlos.vale folded before Flop (didn't bet)



PokerStars Hand #221333860153: Tournament #3067368972, $0.25+$0.24+$0.06 USD Hold'em No Limit - Level XVIII (300/600) - 2020/12/11 21:53:34 EET [2020/12/11 14:53:34 ET]
Table '3067368972 51' 9-max Seat #4 is the button
Seat 1: Dapper14 (53233 in chips, $1.26 bounty) 
Seat 2: murtypoker (17042 in chips, $1.44 bounty) 
Seat 3: liverpool f1 (29502 in chips, $0.78 bounty) 
Seat 4: pafax (32512 in chips, $0.90 bounty) 
Seat 5: VMPCE (7350 in chips, $0.24 bounty) 
Seat 6: heberiver (65839 in chips, $1.05 bounty) 
Seat 7: DerGamingOpa (45885 in chips, $0.60 bounty) 
Seat 8: jcarlos.vale (48298 in chips, $1.08 bounty) 
Seat 9: Olly559 (17224 in chips, $0.36 bounty) 
Dapper14: posts the ante 90
murtypoker: posts the ante 90
liverpool f1: posts the ante 90
pafax: posts the ante 90
VMPCE: posts the ante 90
heberiver: posts the ante 90
DerGamingOpa: posts the ante 90
jcarlos.vale: posts the ante 90
Olly559: posts the ante 90
VMPCE: posts small blind 300
heberiver: posts big blind 600
*** HOLE CARDS ***
Dealt to jcarlos.vale [3s Jd]
DerGamingOpa: raises 600 to 1200
jcarlos.vale: folds 
Olly559: folds 
Dapper14: calls 1200
murtypoker: folds 
liverpool f1: folds 
pafax: folds 
VMPCE: folds 
heberiver: folds 
*** FLOP *** [9d Ts 6s]
DerGamingOpa: checks 
Dapper14: bets 1455
DerGamingOpa: calls 1455
*** TURN *** [9d Ts 6s] [9c]
DerGamingOpa: checks 
Dapper14: bets 2910
DerGamingOpa: calls 2910
*** RIVER *** [9d Ts 6s 9c] [4d]
DerGamingOpa: checks 
Dapper14: checks 
*** SHOW DOWN ***
DerGamingOpa: shows [Qh Jh] (a pair of Nines)
Dapper14: mucks handDTO
DerGamingOpa collected 12840 from pot
*** SUMMARY ***
Total pot 12840 | Rake 0 
Board [9d Ts 6s 9c 4d]
Seat 1: Dapper14 mucked [3d 2d]
Seat 2: murtypoker folded before Flop (didn't bet)
Seat 3: liverpool f1 folded before Flop (didn't bet)
Seat 4: pafax (button) folded before Flop (didn't bet)
Seat 5: VMPCE (small blind) folded before Flop
Seat 6: heberiver (big blind) folded before Flop
Seat 7: DerGamingOpa showed [Qh Jh] and won (12840) with a pair of Nines
Seat 8: jcarlos.vale folded before Flop (didn't bet)
Seat 9: Olly559 folded before Flop (didn't bet)



PokerStars Hand #221333902629: Tournament #3067368972, $0.25+$0.24+$0.06 USD Hold'em No Limit - Level XVIII (300/600) - 2020/12/11 21:54:37 EET [2020/12/11 14:54:37 ET]
Table '3067368972 51' 9-max Seat #5 is the button
Seat 1: Dapper14 (47578 in chips, $1.26 bounty) 
Seat 2: murtypoker (16952 in chips, $1.44 bounty) 
Seat 3: liverpool f1 (29412 in chips, $0.78 bounty) 
Seat 4: pafax (32422 in chips, $0.90 bounty) 
Seat 5: VMPCE (6960 in chips, $0.24 bounty) 
Seat 6: heberiver (65149 in chips, $1.05 bounty) 
Seat 7: DerGamingOpa (53070 in chips, $0.60 bounty) 
Seat 8: jcarlos.vale (48208 in chips, $1.08 bounty) 
Seat 9: Olly559 (17134 in chips, $0.36 bounty) 
Dapper14: posts the ante 90
murtypoker: posts the ante 90
liverpool f1: posts the ante 90
pafax: posts the ante 90
VMPCE: posts the ante 90
heberiver: posts the ante 90
DerGamingOpa: posts the ante 90
jcarlos.vale: posts the ante 90
Olly559: posts the ante 90
heberiver: posts small blind 300
DerGamingOpa: posts big blind 600
*** HOLE CARDS ***
Dealt to jcarlos.vale [3c 2c]
jcarlos.vale: folds 
Olly559: folds 
Dapper14: folds 
murtypoker: calls 600
liverpool f1: raises 28722 to 29322 and is all-in
pafax: folds 
VMPCE: folds 
heberiver: folds 
DerGamingOpa: folds 
murtypoker: folds 
Uncalled bet (28722) returned to liverpool f1
liverpool f1 collected 2910 from pot
liverpool f1: doesn't show handDTO
*** SUMMARY ***
Total pot 2910 | Rake 0 
Seat 1: Dapper14 folded before Flop (didn't bet)
Seat 2: murtypoker folded before Flop
Seat 3: liverpool f1 collected (2910)
Seat 4: pafax folded before Flop (didn't bet)
Seat 5: VMPCE (button) folded before Flop (didn't bet)
Seat 6: heberiver (small blind) folded before Flop
Seat 7: DerGamingOpa (big blind) folded before Flop
Seat 8: jcarlos.vale folded before Flop (didn't bet)
Seat 9: Olly559 folded before Flop (didn't bet)



PokerStars Hand #221334160196: Tournament #3067368972, $0.25+$0.24+$0.06 USD Hold'em No Limit - Level XIX (350/700) - 2020/12/11 22:02:30 EET [2020/12/11 15:02:30 ET]
Table '3067368972 51' 9-max Seat #6 is the button
Seat 1: Dapper14 (47488 in chips, $1.26 bounty) 
Seat 2: murtypoker (16262 in chips, $1.44 bounty) 
Seat 3: liverpool f1 (31632 in chips, $0.78 bounty) 
Seat 4: pafax (32332 in chips, $0.90 bounty) 
Seat 5: VMPCE (6870 in chips, $0.24 bounty) 
Seat 6: heberiver (64759 in chips, $1.05 bounty) 
Seat 7: DerGamingOpa (52380 in chips, $0.60 bounty) 
Seat 8: jcarlos.vale (48118 in chips, $1.08 bounty) 
Seat 9: Olly559 (17044 in chips, $0.36 bounty) 
Dapper14: posts the ante 110
murtypoker: posts the ante 110
liverpool f1: posts the ante 110
pafax: posts the ante 110
VMPCE: posts the ante 110
heberiver: posts the ante 110
DerGamingOpa: posts the ante 110
jcarlos.vale: posts the ante 110
Olly559: posts the ante 110
DerGamingOpa: posts small blind 350
jcarlos.vale: posts big blind 700
*** HOLE CARDS ***
Dealt to jcarlos.vale [Qc 4h]
Olly559 has timed out
Olly559: folds 
Olly559 is sitting out
Dapper14: folds 
murtypoker: folds 
liverpool f1 is disconnected 
liverpool f1 has timed out while being disconnected
liverpool f1: folds 
liverpool f1 is sitting out
pafax: folds 
VMPCE: raises 5600 to 6300
liverpool f1 is disconnected 
liverpool f1 has returned
heberiver has timed out while disconnected
heberiver: folds 
heberiver is sitting out
DerGamingOpa: folds 
jcarlos.vale: folds 
Uncalled bet (5600) returned to VMPCE
VMPCE collected 2740 from pot
VMPCE: doesn't show handDTO
*** SUMMARY ***
Total pot 2740 | Rake 0 
Seat 1: Dapper14 folded before Flop (didn't bet)
Seat 2: murtypoker folded before Flop (didn't bet)
Seat 3: liverpool f1 folded before Flop (didn't bet)
Seat 4: pafax folded before Flop (didn't bet)
Seat 5: VMPCE collected (2740)
Seat 6: heberiver (button) folded before Flop (didn't bet)
Seat 7: DerGamingOpa (small blind) folded before Flop
Seat 8: jcarlos.vale (big blind) folded before Flop
Seat 9: Olly559 folded before Flop (didn't bet)



PokerStars Hand #221334209920: Tournament #3067368972, $0.25+$0.24+$0.06 USD Hold'em No Limit - Level XIX (350/700) - 2020/12/11 22:03:44 EET [2020/12/11 15:03:44 ET]
Table '3067368972 51' 9-max Seat #7 is the button
Seat 1: Dapper14 (47378 in chips, $1.26 bounty) 
Seat 2: murtypoker (16152 in chips, $1.44 bounty) 
Seat 3: liverpool f1 (31522 in chips, $0.78 bounty) 
Seat 4: pafax (32222 in chips, $0.90 bounty) 
Seat 5: VMPCE (8800 in chips, $0.24 bounty) 
Seat 6: heberiver (64649 in chips, $1.05 bounty) is sitting out
Seat 7: DerGamingOpa (51920 in chips, $0.60 bounty) 
Seat 8: jcarlos.vale (47308 in chips, $1.08 bounty) 
Seat 9: Olly559 (16934 in chips, $0.36 bounty) is sitting out
Dapper14: posts the ante 110
murtypoker: posts the ante 110
liverpool f1: posts the ante 110
pafax: posts the ante 110
VMPCE: posts the ante 110
heberiver: posts the ante 110
DerGamingOpa: posts the ante 110
jcarlos.vale: posts the ante 110
Olly559: posts the ante 110
jcarlos.vale: posts small blind 350
Olly559: posts big blind 700
*** HOLE CARDS ***
Dealt to jcarlos.vale [2c 8h]
Dapper14: folds 
murtypoker: folds 
liverpool f1: folds 
pafax: folds 
VMPCE: folds 
heberiver: folds 
DerGamingOpa: folds 
jcarlos.vale: raises 700 to 1400
Olly559: folds 
Uncalled bet (700) returned to jcarlos.vale
jcarlos.vale collected 2390 from pot
jcarlos.vale: doesn't show handDTO
*** SUMMARY ***
Total pot 2390 | Rake 0 
Seat 1: Dapper14 folded before Flop (didn't bet)
Seat 2: murtypoker folded before Flop (didn't bet)
Seat 3: liverpool f1 folded before Flop (didn't bet)
Seat 4: pafax folded before Flop (didn't bet)
Seat 5: VMPCE folded before Flop (didn't bet)
Seat 6: heberiver folded before Flop (didn't bet)
Seat 7: DerGamingOpa (button) folded before Flop (didn't bet)
Seat 8: jcarlos.vale (small blind) collected (2390)
Seat 9: Olly559 (big blind) folded before Flop



PokerStars Hand #221334226126: Tournament #3067368972, $0.25+$0.24+$0.06 USD Hold'em No Limit - Level XIX (350/700) - 2020/12/11 22:04:07 EET [2020/12/11 15:04:07 ET]
Table '3067368972 51' 9-max Seat #8 is the button
Seat 1: Dapper14 (47268 in chips, $1.26 bounty) 
Seat 2: murtypoker (16042 in chips, $1.44 bounty) 
Seat 3: liverpool f1 (31412 in chips, $0.78 bounty) 
Seat 4: pafax (32112 in chips, $0.90 bounty) 
Seat 5: VMPCE (8690 in chips, $0.24 bounty) 
Seat 6: heberiver (64539 in chips, $1.05 bounty) is sitting out
Seat 7: DerGamingOpa (51810 in chips, $0.60 bounty) 
Seat 8: jcarlos.vale (48888 in chips, $1.08 bounty) 
Seat 9: Olly559 (16124 in chips, $0.36 bounty) is sitting out
Dapper14: posts the ante 110
murtypoker: posts the ante 110
liverpool f1: posts the ante 110
pafax: posts the ante 110
VMPCE: posts the ante 110
heberiver: posts the ante 110
DerGamingOpa: posts the ante 110
jcarlos.vale: posts the ante 110
Olly559: posts the ante 110
Olly559: posts small blind 350
Dapper14: posts big blind 700
*** HOLE CARDS ***
Dealt to jcarlos.vale [3h 6s]
murtypoker: raises 700 to 1400
liverpool f1: folds 
pafax: folds 
Olly559 has returned
VMPCE: raises 7180 to 8580 and is all-in
heberiver: folds 
DerGamingOpa: folds 
jcarlos.vale: folds 
Olly559: folds 
Dapper14: raises 38578 to 47158 and is all-in
murtypoker: calls 14532 and is all-in
Uncalled bet (31226) returned to Dapper14
*** FLOP *** [Qd Ks 9d]
*** TURN *** [Qd Ks 9d] [Ac]
*** RIVER *** [Qd Ks 9d Ac] [Tc]
*** SHOW DOWN ***
Dapper14: shows [As Kc] (two pair, Aces and Kings)
murtypoker: shows [Ah Ad] (three of a kind, Aces)
murtypoker collected 14704 from side pot
VMPCE: shows [Qc Qh] (three of a kind, Queens)
murtypoker collected 27080 from main pot
murtypoker wins $0.12 for eliminating VMPCE and their own bounty increases by $0.12 to $1.56
VMPCE finished the tournament in 1197th place
*** SUMMARY ***
Total pot 41784 Main pot 27080. Side pot 14704. | Rake 0 
Board [Qd Ks 9d Ac Tc]
Seat 1: Dapper14 (big blind) showed [As Kc] and lost with two pair, Aces and Kings
Seat 2: murtypoker showed [Ah Ad] and won (41784) with three of a kind, Aces
Seat 3: liverpool f1 folded before Flop (didn't bet)
Seat 4: pafax folded before Flop (didn't bet)
Seat 5: VMPCE showed [Qc Qh] and lost with three of a kind, Queens
Seat 6: heberiver folded before Flop (didn't bet)
Seat 7: DerGamingOpa folded before Flop (didn't bet)
Seat 8: jcarlos.vale (button) folded before Flop (didn't bet)
Seat 9: Olly559 (small blind) folded before Flop



PokerStars Hand #221334271906: Tournament #3067368972, $0.25+$0.24+$0.06 USD Hold'em No Limit - Level XIX (350/700) - 2020/12/11 22:05:13 EET [2020/12/11 15:05:13 ET]
Table '3067368972 51' 9-max Seat #9 is the button
Seat 1: Dapper14 (31226 in chips, $1.26 bounty) 
Seat 2: murtypoker (41784 in chips, $1.56 bounty) 
Seat 3: liverpool f1 (31302 in chips, $0.78 bounty) 
Seat 4: pafax (32002 in chips, $0.90 bounty) 
Seat 6: heberiver (64429 in chips, $1.05 bounty) is sitting out
Seat 7: DerGamingOpa (51700 in chips, $0.60 bounty) 
Seat 8: jcarlos.vale (48778 in chips, $1.08 bounty) 
Seat 9: Olly559 (15664 in chips, $0.36 bounty) 
Dapper14: posts the ante 110
murtypoker: posts the ante 110
liverpool f1: posts the ante 110
pafax: posts the ante 110
heberiver: posts the ante 110
DerGamingOpa: posts the ante 110
jcarlos.vale: posts the ante 110
Olly559: posts the ante 110
Dapper14: posts small blind 350
murtypoker: posts big blind 700
*** HOLE CARDS ***
Dealt to jcarlos.vale [Ts 4c]
liverpool f1: calls 700
pafax: folds 
heberiver: folds 
DerGamingOpa: folds 
jcarlos.vale: folds 
Olly559: folds 
Dapper14: calls 350
murtypoker: checks 
*** FLOP *** [8c 3d Kh]
Dapper14: checks 
murtypoker: checks 
liverpool f1: checks 
*** TURN *** [8c 3d Kh] [2s]
Dapper14: checks 
murtypoker: bets 1490
liverpool f1: folds 
Dapper14: calls 1490
*** RIVER *** [8c 3d Kh 2s] [4h]
Dapper14: checks 
murtypoker: bets 2100
Dapper14: folds 
Uncalled bet (2100) returned to murtypoker
murtypoker collected 5960 from pot
*** SUMMARY ***
Total pot 5960 | Rake 0 
Board [8c 3d Kh 2s 4h]
Seat 1: Dapper14 (small blind) folded on the River
Seat 2: murtypoker (big blind) collected (5960)
Seat 3: liverpool f1 folded on the Turn
Seat 4: pafax folded before Flop (didn't bet)
Seat 6: heberiver folded before Flop (didn't bet)
Seat 7: DerGamingOpa folded before Flop (didn't bet)
Seat 8: jcarlos.vale folded before Flop (didn't bet)
Seat 9: Olly559 (button) folded before Flop (didn't bet)



PokerStars Hand #221334323468: Tournament #3067368972, $0.25+$0.24+$0.06 USD Hold'em No Limit - Level XIX (350/700) - 2020/12/11 22:06:26 EET [2020/12/11 15:06:26 ET]
Table '3067368972 51' 9-max Seat #1 is the button
Seat 1: Dapper14 (28926 in chips, $1.26 bounty) 
Seat 2: murtypoker (45444 in chips, $1.56 bounty) 
Seat 3: liverpool f1 (30492 in chips, $0.78 bounty) 
Seat 4: pafax (31892 in chips, $0.90 bounty) 
Seat 5: piratrau (29142 in chips, $0.57 bounty) 
Seat 6: heberiver (64319 in chips, $1.05 bounty) is sitting out
Seat 7: DerGamingOpa (51590 in chips, $0.60 bounty) 
Seat 8: jcarlos.vale (48668 in chips, $1.08 bounty) 
Seat 9: Olly559 (15554 in chips, $0.36 bounty) 
Dapper14: posts the ante 110
murtypoker: posts the ante 110
liverpool f1: posts the ante 110
pafax: posts the ante 110
piratrau: posts the ante 110
heberiver: posts the ante 110
DerGamingOpa: posts the ante 110
jcarlos.vale: posts the ante 110
Olly559: posts the ante 110
murtypoker: posts small blind 350
liverpool f1: posts big blind 700
*** HOLE CARDS ***
Dealt to jcarlos.vale [2c 8c]
pafax: folds 
piratrau: folds 
heberiver: folds 
DerGamingOpa: folds 
jcarlos.vale: folds 
Olly559: folds 
Dapper14: calls 700
murtypoker: calls 350
liverpool f1: checks 
*** FLOP *** [Th Js 4c]
murtypoker: bets 1545
liverpool f1: calls 1545
Dapper14: calls 1545
*** TURN *** [Th Js 4c] [Qh]
murtypoker: checks 
liverpool f1: checks 
Dapper14: checks 
*** RIVER *** [Th Js 4c Qh] [2h]
murtypoker: checks 
liverpool f1: bets 2100
Dapper14: folds 
murtypoker: calls 2100
*** SHOW DOWN ***
liverpool f1: shows [Qc 9h] (a pair of Queens)
murtypoker: mucks handDTO
liverpool f1 collected 11925 from pot
*** SUMMARY ***
Total pot 11925 | Rake 0 
Board [Th Js 4c Qh 2h]
Seat 1: Dapper14 (button) folded on the River
Seat 2: murtypoker (small blind) mucked [Jc Kh]
Seat 3: liverpool f1 (big blind) showed [Qc 9h] and won (11925) with a pair of Queens
Seat 4: pafax folded before Flop (didn't bet)
Seat 5: piratrau folded before Flop (didn't bet)
Seat 6: heberiver folded before Flop (didn't bet)
Seat 7: DerGamingOpa folded before Flop (didn't bet)
Seat 8: jcarlos.vale folded before Flop (didn't bet)
Seat 9: Olly559 folded before Flop (didn't bet)



PokerStars Hand #221334374610: Tournament #3067368972, $0.25+$0.24+$0.06 USD Hold'em No Limit - Level XIX (350/700) - 2020/12/11 22:07:38 EET [2020/12/11 15:07:38 ET]
Table '3067368972 51' 9-max Seat #2 is the button
Seat 1: Dapper14 (26571 in chips, $1.26 bounty) 
Seat 2: murtypoker (40989 in chips, $1.56 bounty) 
Seat 3: liverpool f1 (37962 in chips, $0.78 bounty) 
Seat 4: pafax (31782 in chips, $0.90 bounty) 
Seat 5: piratrau (29032 in chips, $0.57 bounty) 
Seat 6: heberiver (64209 in chips, $1.05 bounty) is sitting out
Seat 7: DerGamingOpa (51480 in chips, $0.60 bounty) 
Seat 8: jcarlos.vale (48558 in chips, $1.08 bounty) 
Seat 9: Olly559 (15444 in chips, $0.36 bounty) 
Dapper14: posts the ante 110
murtypoker: posts the ante 110
liverpool f1: posts the ante 110
pafax: posts the ante 110
piratrau: posts the ante 110
heberiver: posts the ante 110
DerGamingOpa: posts the ante 110
jcarlos.vale: posts the ante 110
Olly559: posts the ante 110
liverpool f1: posts small blind 350
pafax: posts big blind 700
*** HOLE CARDS ***
Dealt to jcarlos.vale [Kc 4c]
piratrau: folds 
heberiver: folds 
DerGamingOpa: folds 
jcarlos.vale: folds 
Olly559: calls 700
Dapper14: folds 
murtypoker: folds 
liverpool f1: calls 350
pafax: checks 
*** FLOP *** [6d 2c 2d]
liverpool f1: bets 700
pafax: calls 700
Olly559: folds 
*** TURN *** [6d 2c 2d] [Kd]
liverpool f1: bets 700
pafax: folds 
Uncalled bet (700) returned to liverpool f1
liverpool f1 collected 4490 from pot
liverpool f1: doesn't show handDTO
*** SUMMARY ***
Total pot 4490 | Rake 0 
Board [6d 2c 2d Kd]
Seat 1: Dapper14 folded before Flop (didn't bet)
Seat 2: murtypoker (button) folded before Flop (didn't bet)
Seat 3: liverpool f1 (small blind) collected (4490)
Seat 4: pafax (big blind) folded on the Turn
Seat 5: piratrau folded before Flop (didn't bet)
Seat 6: heberiver folded before Flop (didn't bet)
Seat 7: DerGamingOpa folded before Flop (didn't bet)
Seat 8: jcarlos.vale folded before Flop (didn't bet)
Seat 9: Olly559 folded on the Flop



PokerStars Hand #221334408699: Tournament #3067368972, $0.25+$0.24+$0.06 USD Hold'em No Limit - Level XIX (350/700) - 2020/12/11 22:08:26 EET [2020/12/11 15:08:26 ET]
Table '3067368972 51' 9-max Seat #3 is the button
Seat 1: Dapper14 (26461 in chips, $1.26 bounty) 
Seat 2: murtypoker (40879 in chips, $1.56 bounty) 
Seat 3: liverpool f1 (40942 in chips, $0.78 bounty) 
Seat 4: pafax (30272 in chips, $0.90 bounty) 
Seat 5: piratrau (28922 in chips, $0.57 bounty) 
Seat 6: heberiver (64099 in chips, $1.05 bounty) is sitting out
Seat 7: DerGamingOpa (51370 in chips, $0.60 bounty) 
Seat 8: jcarlos.vale (48448 in chips, $1.08 bounty) 
Seat 9: Olly559 (14634 in chips, $0.36 bounty) 
Dapper14: posts the ante 110
murtypoker: posts the ante 110
liverpool f1: posts the ante 110
pafax: posts the ante 110
piratrau: posts the ante 110
heberiver: posts the ante 110
DerGamingOpa: posts the ante 110
jcarlos.vale: posts the ante 110
Olly559: posts the ante 110
pafax: posts small blind 350
piratrau: posts big blind 700
*** HOLE CARDS ***
Dealt to jcarlos.vale [7c 4c]
heberiver: folds 
DerGamingOpa: folds 
jcarlos.vale: folds 
Olly559: folds 
Dapper14: raises 1340 to 2040
murtypoker: folds 
liverpool f1: folds 
pafax: folds 
piratrau: calls 1340
*** FLOP *** [3s 8h 7h]
piratrau: checks 
Dapper14: bets 2010
piratrau: folds 
Uncalled bet (2010) returned to Dapper14
Dapper14 collected 5420 from pot
Dapper14: doesn't show handDTO
*** SUMMARY ***
Total pot 5420 | Rake 0 
Board [3s 8h 7h]
Seat 1: Dapper14 collected (5420)
Seat 2: murtypoker folded before Flop (didn't bet)
Seat 3: liverpool f1 (button) folded before Flop (didn't bet)
Seat 4: pafax (small blind) folded before Flop
Seat 5: piratrau (big blind) folded on the Flop
Seat 6: heberiver folded before Flop (didn't bet)
Seat 7: DerGamingOpa folded before Flop (didn't bet)
Seat 8: jcarlos.vale folded before Flop (didn't bet)
Seat 9: Olly559 folded before Flop (didn't bet)



PokerStars Hand #221334442873: Tournament #3067368972, $0.25+$0.24+$0.06 USD Hold'em No Limit - Level XIX (350/700) - 2020/12/11 22:09:13 EET [2020/12/11 15:09:13 ET]
Table '3067368972 51' 9-max Seat #4 is the button
Seat 1: Dapper14 (29731 in chips, $1.26 bounty) 
Seat 2: murtypoker (40769 in chips, $1.56 bounty) 
Seat 3: liverpool f1 (40832 in chips, $0.78 bounty) 
Seat 4: pafax (29812 in chips, $0.90 bounty) 
Seat 5: piratrau (26772 in chips, $0.57 bounty) 
Seat 6: heberiver (63989 in chips, $1.05 bounty) is sitting out
Seat 7: DerGamingOpa (51260 in chips, $0.60 bounty) 
Seat 8: jcarlos.vale (48338 in chips, $1.08 bounty) 
Seat 9: Olly559 (14524 in chips, $0.36 bounty) 
Dapper14: posts the ante 110
murtypoker: posts the ante 110
liverpool f1: posts the ante 110
pafax: posts the ante 110
piratrau: posts the ante 110
heberiver: posts the ante 110
DerGamingOpa: posts the ante 110
jcarlos.vale: posts the ante 110
Olly559: posts the ante 110
piratrau: posts small blind 350
heberiver: posts big blind 700
*** HOLE CARDS ***
Dealt to jcarlos.vale [6h 7d]
DerGamingOpa: folds 
jcarlos.vale: folds 
Olly559: calls 700
Dapper14: calls 700
murtypoker: folds 
liverpool f1: calls 700
pafax: folds 
piratrau: folds 
heberiver: folds 
*** FLOP *** [Ts Ah Qc]
Olly559: bets 700
Dapper14: calls 700
liverpool f1: calls 700
*** TURN *** [Ts Ah Qc] [6d]
Olly559: bets 3120
Dapper14: folds 
liverpool f1: folds 
Uncalled bet (3120) returned to Olly559
Olly559 collected 6240 from pot
Olly559: doesn't show handDTO
*** SUMMARY ***
Total pot 6240 | Rake 0 
Board [Ts Ah Qc 6d]
Seat 1: Dapper14 folded on the Turn
Seat 2: murtypoker folded before Flop (didn't bet)
Seat 3: liverpool f1 folded on the Turn
Seat 4: pafax (button) folded before Flop (didn't bet)
Seat 5: piratrau (small blind) folded before Flop
Seat 6: heberiver (big blind) folded before Flop
Seat 7: DerGamingOpa folded before Flop (didn't bet)
Seat 8: jcarlos.vale folded before Flop (didn't bet)
Seat 9: Olly559 collected (6240)



PokerStars Hand #221334465477: Tournament #3067368972, $0.25+$0.24+$0.06 USD Hold'em No Limit - Level XIX (350/700) - 2020/12/11 22:09:45 EET [2020/12/11 15:09:45 ET]
Table '3067368972 51' 9-max Seat #5 is the button
Seat 1: Dapper14 (28221 in chips, $1.26 bounty) 
Seat 2: murtypoker (40659 in chips, $1.56 bounty) 
Seat 3: liverpool f1 (39322 in chips, $0.78 bounty) 
Seat 4: pafax (29702 in chips, $0.90 bounty) 
Seat 5: piratrau (26312 in chips, $0.57 bounty) 
Seat 6: heberiver (63179 in chips, $1.05 bounty) is sitting out
Seat 7: DerGamingOpa (51150 in chips, $0.60 bounty) 
Seat 8: jcarlos.vale (48228 in chips, $1.08 bounty) 
Seat 9: Olly559 (19254 in chips, $0.36 bounty) 
Dapper14: posts the ante 110
murtypoker: posts the ante 110
liverpool f1: posts the ante 110
pafax: posts the ante 110
piratrau: posts the ante 110
heberiver: posts the ante 110
DerGamingOpa: posts the ante 110
jcarlos.vale: posts the ante 110
Olly559: posts the ante 110
heberiver: posts small blind 350
DerGamingOpa: posts big blind 700
*** HOLE CARDS ***
Dealt to jcarlos.vale [6c 3h]
jcarlos.vale: folds 
Olly559: calls 700
Dapper14: calls 700
murtypoker: folds 
liverpool f1: calls 700
pafax: folds 
piratrau: folds 
heberiver: folds 
DerGamingOpa: checks 
*** FLOP *** [8h Ks Td]
DerGamingOpa: checks 
Olly559: checks 
Dapper14: bets 2070
liverpool f1: folds 
DerGamingOpa: folds 
Olly559: folds 
Uncalled bet (2070) returned to Dapper14
Dapper14 collected 4140 from pot
Dapper14: doesn't show handDTO
*** SUMMARY ***
Total pot 4140 | Rake 0 
Board [8h Ks Td]
Seat 1: Dapper14 collected (4140)
Seat 2: murtypoker folded before Flop (didn't bet)
Seat 3: liverpool f1 folded on the Flop
Seat 4: pafax folded before Flop (didn't bet)
Seat 5: piratrau (button) folded before Flop (didn't bet)
Seat 6: heberiver (small blind) folded before Flop
Seat 7: DerGamingOpa (big blind) folded on the Flop
Seat 8: jcarlos.vale folded before Flop (didn't bet)
Seat 9: Olly559 folded on the Flop



PokerStars Hand #221334505218: Tournament #3067368972, $0.25+$0.24+$0.06 USD Hold'em No Limit - Level XX (400/800) - 2020/12/11 22:10:41 EET [2020/12/11 15:10:41 ET]
Table '3067368972 51' 9-max Seat #6 is the button
Seat 1: Dapper14 (31551 in chips, $1.26 bounty) 
Seat 2: murtypoker (40549 in chips, $1.56 bounty) 
Seat 3: liverpool f1 (38512 in chips, $0.78 bounty) 
Seat 4: pafax (29592 in chips, $0.90 bounty) 
Seat 5: piratrau (26202 in chips, $0.57 bounty) 
Seat 6: heberiver (62719 in chips, $1.05 bounty) is sitting out
Seat 7: DerGamingOpa (50340 in chips, $0.60 bounty) 
Seat 8: jcarlos.vale (48118 in chips, $1.08 bounty) 
Seat 9: Olly559 (18444 in chips, $0.36 bounty) 
Dapper14: posts the ante 120
murtypoker: posts the ante 120
liverpool f1: posts the ante 120
pafax: posts the ante 120
piratrau: posts the ante 120
heberiver: posts the ante 120
DerGamingOpa: posts the ante 120
jcarlos.vale: posts the ante 120
Olly559: posts the ante 120
DerGamingOpa: posts small blind 400
jcarlos.vale: posts big blind 800
*** HOLE CARDS ***
Dealt to jcarlos.vale [3s Jh]
Olly559: folds 
Dapper14: folds 
murtypoker: folds 
liverpool f1: folds 
pafax: folds 
piratrau: calls 800
heberiver: folds 
DerGamingOpa: raises 49420 to 50220 and is all-in
jcarlos.vale: folds 
piratrau: folds 
Uncalled bet (49420) returned to DerGamingOpa
DerGamingOpa collected 3480 from pot
DerGamingOpa: doesn't show handDTO
*** SUMMARY ***
Total pot 3480 | Rake 0 
Seat 1: Dapper14 folded before Flop (didn't bet)
Seat 2: murtypoker folded before Flop (didn't bet)
Seat 3: liverpool f1 folded before Flop (didn't bet)
Seat 4: pafax folded before Flop (didn't bet)
Seat 5: piratrau folded before Flop
Seat 6: heberiver (button) folded before Flop (didn't bet)
Seat 7: DerGamingOpa (small blind) collected (3480)
Seat 8: jcarlos.vale (big blind) folded before Flop
Seat 9: Olly559 folded before Flop (didn't bet)



PokerStars Hand #221334531335: Tournament #3067368972, $0.25+$0.24+$0.06 USD Hold'em No Limit - Level XX (400/800) - 2020/12/11 22:11:17 EET [2020/12/11 15:11:17 ET]
Table '3067368972 51' 9-max Seat #7 is the button
Seat 1: Dapper14 (31431 in chips, $1.26 bounty) 
Seat 2: murtypoker (40429 in chips, $1.56 bounty) 
Seat 3: liverpool f1 (38392 in chips, $0.78 bounty) 
Seat 4: pafax (29472 in chips, $0.90 bounty) 
Seat 5: piratrau (25282 in chips, $0.57 bounty) 
Seat 6: heberiver (62599 in chips, $1.05 bounty) is sitting out
Seat 7: DerGamingOpa (52900 in chips, $0.60 bounty) 
Seat 8: jcarlos.vale (47198 in chips, $1.08 bounty) 
Seat 9: Olly559 (18324 in chips, $0.36 bounty) 
Dapper14: posts the ante 120
murtypoker: posts the ante 120
liverpool f1: posts the ante 120
pafax: posts the ante 120
piratrau: posts the ante 120
heberiver: posts the ante 120
DerGamingOpa: posts the ante 120
jcarlos.vale: posts the ante 120
Olly559: posts the ante 120
jcarlos.vale: posts small blind 400
Olly559: posts big blind 800
*** HOLE CARDS ***
Dealt to jcarlos.vale [8d 5c]
Dapper14: folds 
murtypoker: folds 
liverpool f1: calls 800
pafax: folds 
piratrau: raises 3880 to 4680
heberiver: folds 
DerGamingOpa: folds 
jcarlos.vale: folds 
Olly559: folds 
liverpool f1: folds 
Uncalled bet (3880) returned to piratrau
piratrau collected 3880 from pot
*** SUMMARY ***
Total pot 3880 | Rake 0 
Seat 1: Dapper14 folded before Flop (didn't bet)
Seat 2: murtypoker folded before Flop (didn't bet)
Seat 3: liverpool f1 folded before Flop
Seat 4: pafax folded before Flop (didn't bet)
Seat 5: piratrau collected (3880)
Seat 6: heberiver folded before Flop (didn't bet)
Seat 7: DerGamingOpa (button) folded before Flop (didn't bet)
Seat 8: jcarlos.vale (small blind) folded before Flop
Seat 9: Olly559 (big blind) folded before Flop



PokerStars Hand #221334564895: Tournament #3067368972, $0.25+$0.24+$0.06 USD Hold'em No Limit - Level XX (400/800) - 2020/12/11 22:12:04 EET [2020/12/11 15:12:04 ET]
Table '3067368972 51' 9-max Seat #8 is the button
Seat 1: Dapper14 (31311 in chips, $1.26 bounty) 
Seat 2: murtypoker (40309 in chips, $1.56 bounty) 
Seat 3: liverpool f1 (37472 in chips, $0.78 bounty) 
Seat 4: pafax (29352 in chips, $0.90 bounty) 
Seat 5: piratrau (28242 in chips, $0.57 bounty) 
Seat 6: heberiver (62479 in chips, $1.05 bounty) is sitting out
Seat 7: DerGamingOpa (52780 in chips, $0.60 bounty) 
Seat 8: jcarlos.vale (46678 in chips, $1.08 bounty) 
Seat 9: Olly559 (17404 in chips, $0.36 bounty) 
Dapper14: posts the ante 120
murtypoker: posts the ante 120
liverpool f1: posts the ante 120
pafax: posts the ante 120
piratrau: posts the ante 120
heberiver: posts the ante 120
DerGamingOpa: posts the ante 120
jcarlos.vale: posts the ante 120
Olly559: posts the ante 120
Olly559: posts small blind 400
Dapper14: posts big blind 800
*** HOLE CARDS ***
Dealt to jcarlos.vale [4h As]
murtypoker: calls 800
liverpool f1: folds 
pafax: folds 
piratrau: folds 
heberiver: folds 
DerGamingOpa: calls 800
jcarlos.vale: folds 
Olly559: calls 400
Dapper14: checks 
*** FLOP *** [Ac Jh Qs]
Olly559: checks 
Dapper14: checks 
murtypoker: bets 1111
DerGamingOpa: calls 1111
Olly559: calls 1111
Dapper14: calls 1111
*** TURN *** [Ac Jh Qs] [2h]
Olly559: checks 
Dapper14: checks 
murtypoker: bets 4444
DerGamingOpa: calls 4444
Olly559: folds 
Dapper14: calls 4444
*** RIVER *** [Ac Jh Qs 2h] [7c]
Dapper14: checks 
murtypoker: bets 2222
DerGamingOpa: raises 44083 to 46305 and is all-in
Dapper14: calls 24836 and is all-in
murtypoker: calls 31612 and is all-in
Uncalled bet (12471) returned to DerGamingOpa
*** SHOW DOWN ***
DerGamingOpa: shows [Th Kd] (a straight, Ten to Ace)
murtypoker: shows [Ks Ad] (a pair of Aces)
DerGamingOpa collected 17996 from side pot
Dapper14: shows [2d 2c] (three of a kind, Deuces)
DerGamingOpa collected 96564 from main pot
DerGamingOpa wins $0.63 for eliminating Dapper14 and their own bounty increases by $0.63 to $1.23
DerGamingOpa wins $0.78 for eliminating murtypoker and their own bounty increases by $0.78 to $2.01
*** SUMMARY ***
Total pot 114560 Main pot 96564. Side pot 17996. | Rake 0 
Board [Ac Jh Qs 2h 7c]
Seat 1: Dapper14 (big blind) showed [2d 2c] and lost with three of a kind, Deuces
Seat 2: murtypoker showed [Ks Ad] and lost with a pair of Aces
Seat 3: liverpool f1 folded before Flop (didn't bet)
Seat 4: pafax folded before Flop (didn't bet)
Seat 5: piratrau folded before Flop (didn't bet)
Seat 6: heberiver folded before Flop (didn't bet)
Seat 7: DerGamingOpa showed [Th Kd] and won (114560) with a straight, Ten to Ace
Seat 8: jcarlos.vale (button) folded before Flop (didn't bet)
Seat 9: Olly559 (small blind) folded on the Turn



PokerStars Hand #221334670865: Tournament #3067368972, $0.25+$0.24+$0.06 USD Hold'em No Limit - Level XX (400/800) - 2020/12/11 22:14:32 EET [2020/12/11 15:14:32 ET]
Table '3067368972 51' 9-max Seat #9 is the button
Seat 2: lis@nderr (20467 in chips) out of handDTO (moved from another table into small blind)
Seat 3: liverpool f1 (37352 in chips, $0.78 bounty) 
Seat 4: pafax (29232 in chips, $0.90 bounty) 
Seat 5: piratrau (28122 in chips, $0.57 bounty) 
Seat 6: heberiver (62359 in chips, $1.05 bounty) is sitting out
Seat 7: DerGamingOpa (127031 in chips, $2.01 bounty) 
Seat 8: jcarlos.vale (46558 in chips, $1.08 bounty) 
Seat 9: Olly559 (15373 in chips, $0.36 bounty) 
lis@nderr will be allowed to play after the button
liverpool f1: posts the ante 120
pafax: posts the ante 120
piratrau: posts the ante 120
heberiver: posts the ante 120
DerGamingOpa: posts the ante 120
jcarlos.vale: posts the ante 120
Olly559: posts the ante 120
liverpool f1: posts small blind 400
pafax: posts big blind 800
*** HOLE CARDS ***
Dealt to jcarlos.vale [4s Qc]
piratrau: folds 
heberiver: folds 
DerGamingOpa: folds 
jcarlos.vale: folds 
Olly559: calls 800
liverpool f1: calls 400
pafax: checks 
*** FLOP *** [Ah Tc 7d]
liverpool f1: checks 
pafax: bets 800
Olly559: calls 800
liverpool f1: folds 
*** TURN *** [Ah Tc 7d] [2s]
heberiver has returned
pafax: bets 2904
Olly559: calls 2904
*** RIVER *** [Ah Tc 7d 2s] [Td]
pafax: bets 12000
Olly559: folds 
Uncalled bet (12000) returned to pafax
pafax collected 10648 from pot
pafax: doesn't show handDTO
*** SUMMARY ***
Total pot 10648 | Rake 0 
Board [Ah Tc 7d 2s Td]
Seat 3: liverpool f1 (small blind) folded on the Flop
Seat 4: pafax (big blind) collected (10648)
Seat 5: piratrau folded before Flop (didn't bet)
Seat 6: heberiver folded before Flop (didn't bet)
Seat 7: DerGamingOpa folded before Flop (didn't bet)
Seat 8: jcarlos.vale folded before Flop (didn't bet)
Seat 9: Olly559 (button) folded on the River



PokerStars Hand #221334729986: Tournament #3067368972, $0.25+$0.24+$0.06 USD Hold'em No Limit - Level XX (400/800) - 2020/12/11 22:15:54 EET [2020/12/11 15:15:54 ET]
Table '3067368972 51' 9-max Seat #3 is the button
Seat 1: amassi13 (64947 in chips, $1.17 bounty) 
Seat 2: lis@nderr (20467 in chips, $0.78 bounty) 
Seat 3: liverpool f1 (36432 in chips, $0.78 bounty) 
Seat 4: pafax (35256 in chips, $0.90 bounty) 
Seat 5: piratrau (28002 in chips, $0.57 bounty) 
Seat 6: heberiver (62239 in chips, $1.05 bounty) 
Seat 7: DerGamingOpa (126911 in chips, $2.01 bounty) 
Seat 8: jcarlos.vale (46438 in chips, $1.08 bounty) 
Seat 9: Olly559 (10749 in chips, $0.36 bounty) 
amassi13: posts the ante 120
lis@nderr: posts the ante 120
liverpool f1: posts the ante 120
pafax: posts the ante 120
piratrau: posts the ante 120
heberiver: posts the ante 120
DerGamingOpa: posts the ante 120
jcarlos.vale: posts the ante 120
Olly559: posts the ante 120
pafax: posts small blind 400
piratrau: posts big blind 800
*** HOLE CARDS ***
Dealt to jcarlos.vale [Tc 7c]
heberiver: folds 
DerGamingOpa: folds 
jcarlos.vale: folds 
Olly559: folds 
amassi13: folds 
lis@nderr: raises 800 to 1600
liverpool f1: folds 
pafax: folds 
piratrau: folds 
Uncalled bet (800) returned to lis@nderr
lis@nderr collected 3080 from pot
lis@nderr: doesn't show handDTO
*** SUMMARY ***
Total pot 3080 | Rake 0 
Seat 1: amassi13 folded before Flop (didn't bet)
Seat 2: lis@nderr collected (3080)
Seat 3: liverpool f1 (button) folded before Flop (didn't bet)
Seat 4: pafax (small blind) folded before Flop
Seat 5: piratrau (big blind) folded before Flop
Seat 6: heberiver folded before Flop (didn't bet)
Seat 7: DerGamingOpa folded before Flop (didn't bet)
Seat 8: jcarlos.vale folded before Flop (didn't bet)
Seat 9: Olly559 folded before Flop (didn't bet)



PokerStars Hand #221334765557: Tournament #3067368972, $0.25+$0.24+$0.06 USD Hold'em No Limit - Level XX (400/800) - 2020/12/11 22:16:44 EET [2020/12/11 15:16:44 ET]
Table '3067368972 51' 9-max Seat #4 is the button
Seat 1: amassi13 (64827 in chips, $1.17 bounty) 
Seat 2: lis@nderr (22627 in chips, $0.78 bounty) 
Seat 3: liverpool f1 (36312 in chips, $0.78 bounty) 
Seat 4: pafax (34736 in chips, $0.90 bounty) 
Seat 5: piratrau (27082 in chips, $0.57 bounty) 
Seat 6: heberiver (62119 in chips, $1.05 bounty) 
Seat 7: DerGamingOpa (126791 in chips, $2.01 bounty) 
Seat 8: jcarlos.vale (46318 in chips, $1.08 bounty) 
Seat 9: Olly559 (10629 in chips, $0.36 bounty) 
amassi13: posts the ante 120
lis@nderr: posts the ante 120
liverpool f1: posts the ante 120
pafax: posts the ante 120
piratrau: posts the ante 120
heberiver: posts the ante 120
DerGamingOpa: posts the ante 120
jcarlos.vale: posts the ante 120
Olly559: posts the ante 120
piratrau: posts small blind 400
heberiver: posts big blind 800
*** HOLE CARDS ***
Dealt to jcarlos.vale [Kc 7d]
DerGamingOpa: folds 
jcarlos.vale: folds 
Olly559: calls 800
amassi13: folds 
lis@nderr: folds 
liverpool f1: folds 
pafax: folds 
piratrau: folds 
heberiver: checks 
*** FLOP *** [4c Js Qc]
heberiver: bets 800
Olly559: calls 800
*** TURN *** [4c Js Qc] [Qs]
heberiver: bets 2340
Olly559: folds 
Uncalled bet (2340) returned to heberiver
heberiver collected 4680 from pot
heberiver: doesn't show handDTO
*** SUMMARY ***
Total pot 4680 | Rake 0 
Board [4c Js Qc Qs]
Seat 1: amassi13 folded before Flop (didn't bet)
Seat 2: lis@nderr folded before Flop (didn't bet)
Seat 3: liverpool f1 folded before Flop (didn't bet)
Seat 4: pafax (button) folded before Flop (didn't bet)
Seat 5: piratrau (small blind) folded before Flop
Seat 6: heberiver (big blind) collected (4680)
Seat 7: DerGamingOpa folded before Flop (didn't bet)
Seat 8: jcarlos.vale folded before Flop (didn't bet)
Seat 9: Olly559 folded on the Turn



PokerStars Hand #221334797402: Tournament #3067368972, $0.25+$0.24+$0.06 USD Hold'em No Limit - Level XX (400/800) - 2020/12/11 22:17:28 EET [2020/12/11 15:17:28 ET]
Table '3067368972 51' 9-max Seat #5 is the button
Seat 1: amassi13 (64707 in chips, $1.17 bounty) 
Seat 2: lis@nderr (22507 in chips, $0.78 bounty) 
Seat 3: liverpool f1 (36192 in chips, $0.78 bounty) 
Seat 4: pafax (34616 in chips, $0.90 bounty) 
Seat 5: piratrau (26562 in chips, $0.57 bounty) 
Seat 6: heberiver (65079 in chips, $1.05 bounty) 
Seat 7: DerGamingOpa (126671 in chips, $2.01 bounty) 
Seat 8: jcarlos.vale (46198 in chips, $1.08 bounty) 
Seat 9: Olly559 (8909 in chips, $0.36 bounty) 
amassi13: posts the ante 120
lis@nderr: posts the ante 120
liverpool f1: posts the ante 120
pafax: posts the ante 120
piratrau: posts the ante 120
heberiver: posts the ante 120
DerGamingOpa: posts the ante 120
jcarlos.vale: posts the ante 120
Olly559: posts the ante 120
heberiver: posts small blind 400
DerGamingOpa: posts big blind 800
*** HOLE CARDS ***
Dealt to jcarlos.vale [6h 5c]
jcarlos.vale: folds 
Olly559: folds 
amassi13: folds 
lis@nderr: folds 
liverpool f1: calls 800
pafax: calls 800
piratrau: calls 800
heberiver: calls 400
DerGamingOpa: checks 
*** FLOP *** [6c 2c Ts]
heberiver: checks 
DerGamingOpa: bets 3556
liverpool f1: folds 
pafax: folds 
piratrau: folds 
heberiver: folds 
Uncalled bet (3556) returned to DerGamingOpa
DerGamingOpa collected 5080 from pot
DerGamingOpa: doesn't show handDTO
*** SUMMARY ***
Total pot 5080 | Rake 0 
Board [6c 2c Ts]
Seat 1: amassi13 folded before Flop (didn't bet)
Seat 2: lis@nderr folded before Flop (didn't bet)
Seat 3: liverpool f1 folded on the Flop
Seat 4: pafax folded on the Flop
Seat 5: piratrau (button) folded on the Flop
Seat 6: heberiver (small blind) folded on the Flop
Seat 7: DerGamingOpa (big blind) collected (5080)
Seat 8: jcarlos.vale folded before Flop (didn't bet)
Seat 9: Olly559 folded before Flop (didn't bet)



PokerStars Hand #221334842833: Tournament #3067368972, $0.25+$0.24+$0.06 USD Hold'em No Limit - Level XXI (450/900) - 2020/12/11 22:18:25 EET [2020/12/11 15:18:25 ET]
Table '3067368972 51' 9-max Seat #6 is the button
Seat 1: amassi13 (64587 in chips, $1.17 bounty) 
Seat 2: lis@nderr (22387 in chips, $0.78 bounty) 
Seat 3: liverpool f1 (35272 in chips, $0.78 bounty) 
Seat 4: pafax (33696 in chips, $0.90 bounty) 
Seat 5: piratrau (25642 in chips, $0.57 bounty) 
Seat 6: heberiver (64159 in chips, $1.05 bounty) 
Seat 7: DerGamingOpa (130831 in chips, $2.01 bounty) 
Seat 8: jcarlos.vale (46078 in chips, $1.08 bounty) 
Seat 9: Olly559 (8789 in chips, $0.36 bounty) 
amassi13: posts the ante 140
lis@nderr: posts the ante 140
liverpool f1: posts the ante 140
pafax: posts the ante 140
piratrau: posts the ante 140
heberiver: posts the ante 140
DerGamingOpa: posts the ante 140
jcarlos.vale: posts the ante 140
Olly559: posts the ante 140
DerGamingOpa: posts small blind 450
jcarlos.vale: posts big blind 900
*** HOLE CARDS ***
Dealt to jcarlos.vale [2h 2s]
Olly559: folds 
amassi13: raises 900 to 1800
lis@nderr: calls 1800
liverpool f1: folds 
pafax: calls 1800
piratrau: folds 
heberiver: folds 
DerGamingOpa: calls 1350
jcarlos.vale: calls 900
*** FLOP *** [Tc 9c 8c]
DerGamingOpa: checks 
jcarlos.vale: checks 
amassi13: checks 
lis@nderr: bets 3386
pafax: calls 3386
DerGamingOpa: folds 
jcarlos.vale: folds 
amassi13: folds 
*** TURN *** [Tc 9c 8c] [Qs]
lis@nderr: bets 17061 and is all-in
pafax: folds 
Uncalled bet (17061) returned to lis@nderr
lis@nderr collected 17032 from pot
lis@nderr: doesn't show handDTO
*** SUMMARY ***
Total pot 17032 | Rake 0 
Board [Tc 9c 8c Qs]
Seat 1: amassi13 folded on the Flop
Seat 2: lis@nderr collected (17032)
Seat 3: liverpool f1 folded before Flop (didn't bet)
Seat 4: pafax folded on the Turn
Seat 5: piratrau folded before Flop (didn't bet)
Seat 6: heberiver (button) folded before Flop (didn't bet)
Seat 7: DerGamingOpa (small blind) folded on the Flop
Seat 8: jcarlos.vale (big blind) folded on the Flop
Seat 9: Olly559 folded before Flop (didn't bet)



PokerStars Hand #221334903373: Tournament #3067368972, $0.25+$0.24+$0.06 USD Hold'em No Limit - Level XXI (450/900) - 2020/12/11 22:19:50 EET [2020/12/11 15:19:50 ET]
Table '3067368972 51' 9-max Seat #7 is the button
Seat 1: amassi13 (62647 in chips, $1.17 bounty) 
Seat 2: lis@nderr (34093 in chips, $0.78 bounty) 
Seat 3: liverpool f1 (35132 in chips, $0.78 bounty) 
Seat 4: pafax (28370 in chips, $0.90 bounty) 
Seat 5: piratrau (25502 in chips, $0.57 bounty) 
Seat 6: heberiver (64019 in chips, $1.05 bounty) 
Seat 7: DerGamingOpa (128891 in chips, $2.01 bounty) 
Seat 8: jcarlos.vale (44138 in chips, $1.08 bounty) 
Seat 9: Olly559 (8649 in chips, $0.36 bounty) 
amassi13: posts the ante 140
lis@nderr: posts the ante 140
liverpool f1: posts the ante 140
pafax: posts the ante 140
piratrau: posts the ante 140
heberiver: posts the ante 140
DerGamingOpa: posts the ante 140
jcarlos.vale: posts the ante 140
Olly559: posts the ante 140
jcarlos.vale: posts small blind 450
Olly559: posts big blind 900
*** HOLE CARDS ***
Dealt to jcarlos.vale [Kc 4d]
amassi13: folds 
lis@nderr: folds 
liverpool f1: folds 
pafax: folds 
piratrau: folds 
heberiver: folds 
DerGamingOpa: raises 900 to 1800
jcarlos.vale: folds 
Olly559: calls 900
*** FLOP *** [Ks As 6d]
Olly559: checks 
DerGamingOpa: bets 900
Olly559: calls 900
*** TURN *** [Ks As 6d] [2h]
Olly559: checks 
DerGamingOpa: bets 6300
Olly559: folds 
Uncalled bet (6300) returned to DerGamingOpa
DerGamingOpa collected 7110 from pot
DerGamingOpa: doesn't show handDTO
*** SUMMARY ***
Total pot 7110 | Rake 0 
Board [Ks As 6d 2h]
Seat 1: amassi13 folded before Flop (didn't bet)
Seat 2: lis@nderr folded before Flop (didn't bet)
Seat 3: liverpool f1 folded before Flop (didn't bet)
Seat 4: pafax folded before Flop (didn't bet)
Seat 5: piratrau folded before Flop (didn't bet)
Seat 6: heberiver folded before Flop (didn't bet)
Seat 7: DerGamingOpa (button) collected (7110)
Seat 8: jcarlos.vale (small blind) folded before Flop
Seat 9: Olly559 (big blind) folded on the Turn



PokerStars Hand #221334933764: Tournament #3067368972, $0.25+$0.24+$0.06 USD Hold'em No Limit - Level XXI (450/900) - 2020/12/11 22:20:32 EET [2020/12/11 15:20:32 ET]
Table '3067368972 51' 9-max Seat #8 is the button
Seat 1: amassi13 (62507 in chips, $1.17 bounty) 
Seat 2: lis@nderr (33953 in chips, $0.78 bounty) 
Seat 3: liverpool f1 (34992 in chips, $0.78 bounty) 
Seat 4: pafax (28230 in chips, $0.90 bounty) 
Seat 5: piratrau (25362 in chips, $0.57 bounty) 
Seat 6: heberiver (63879 in chips, $1.05 bounty) 
Seat 7: DerGamingOpa (133161 in chips, $2.01 bounty) 
Seat 8: jcarlos.vale (43548 in chips, $1.08 bounty) 
Seat 9: Olly559 (5809 in chips, $0.36 bounty) 
amassi13: posts the ante 140
lis@nderr: posts the ante 140
liverpool f1: posts the ante 140
pafax: posts the ante 140
piratrau: posts the ante 140
heberiver: posts the ante 140
DerGamingOpa: posts the ante 140
jcarlos.vale: posts the ante 140
Olly559: posts the ante 140
Olly559: posts small blind 450
amassi13: posts big blind 900
*** HOLE CARDS ***
Dealt to jcarlos.vale [2s 7h]
lis@nderr: folds 
liverpool f1: calls 900
pafax: folds 
piratrau: calls 900
heberiver: folds 
DerGamingOpa: folds 
jcarlos.vale: folds 
Olly559: calls 450
amassi13: checks 
*** FLOP *** [6s 9s 7s]
Olly559: checks 
amassi13: checks 
liverpool f1: checks 
piratrau: checks 
*** TURN *** [6s 9s 7s] [4d]
Olly559: checks 
amassi13: checks 
liverpool f1: checks 
piratrau: checks 
*** RIVER *** [6s 9s 7s 4d] [8d]
Olly559: bets 900
amassi13: calls 900
liverpool f1: raises 2700 to 3600
piratrau: folds 
Olly559: raises 1169 to 4769 and is all-in
amassi13: calls 3869
liverpool f1: calls 1169
*** SHOW DOWN ***
Olly559: shows [Td 6c] (a straight, Six to Ten)
amassi13: shows [4c Tc] (a straight, Six to Ten)
liverpool f1: shows [As 4s] (a flush, Ace high)
liverpool f1 collected 19167 from pot
liverpool f1 wins $0.18 for eliminating Olly559 and their own bounty increases by $0.18 to $0.96
Olly559 finished the tournament in 921st place and received $0.48.
*** SUMMARY ***
Total pot 19167 | Rake 0 
Board [6s 9s 7s 4d 8d]
Seat 1: amassi13 (big blind) showed [4c Tc] and lost with a straight, Six to Ten
Seat 2: lis@nderr folded before Flop (didn't bet)
Seat 3: liverpool f1 showed [As 4s] and won (19167) with a flush, Ace high
Seat 4: pafax folded before Flop (didn't bet)
Seat 5: piratrau folded on the River
Seat 6: heberiver folded before Flop (didn't bet)
Seat 7: DerGamingOpa folded before Flop (didn't bet)
Seat 8: jcarlos.vale (button) folded before Flop (didn't bet)
Seat 9: Olly559 (small blind) showed [Td 6c] and lost with a straight, Six to Ten



PokerStars Hand #221334991317: Tournament #3067368972, $0.25+$0.24+$0.06 USD Hold'em No Limit - Level XXI (450/900) - 2020/12/11 22:21:52 EET [2020/12/11 15:21:52 ET]
Table '3067368972 51' 9-max Seat #1 is the button
Seat 1: amassi13 (56698 in chips, $1.17 bounty) 
Seat 2: lis@nderr (33813 in chips, $0.78 bounty) 
Seat 3: liverpool f1 (48350 in chips, $0.96 bounty) 
Seat 4: pafax (28090 in chips, $0.90 bounty) 
Seat 5: piratrau (24322 in chips, $0.57 bounty) 
Seat 6: heberiver (63739 in chips, $1.05 bounty) 
Seat 7: DerGamingOpa (133021 in chips, $2.01 bounty) 
Seat 8: jcarlos.vale (43408 in chips, $1.08 bounty) 
amassi13: posts the ante 140
lis@nderr: posts the ante 140
liverpool f1: posts the ante 140
pafax: posts the ante 140
piratrau: posts the ante 140
heberiver: posts the ante 140
DerGamingOpa: posts the ante 140
jcarlos.vale: posts the ante 140
lis@nderr: posts small blind 450
liverpool f1: posts big blind 900
*** HOLE CARDS ***
Dealt to jcarlos.vale [4h Jh]
pafax: folds 
piratrau: folds 
heberiver: folds 
DerGamingOpa: folds 
jcarlos.vale: folds 
amassi13: calls 900
lis@nderr: calls 450
liverpool f1: checks 
*** FLOP *** [6h 5c 6d]
lis@nderr: checks 
liverpool f1: bets 900
amassi13: folds 
lis@nderr: calls 900
*** TURN *** [6h 5c 6d] [3c]
lis@nderr: checks 
liverpool f1: bets 1800
lis@nderr: raises 30073 to 31873 and is all-in
liverpool f1: folds 
Uncalled bet (30073) returned to lis@nderr
lis@nderr collected 9220 from pot
lis@nderr: doesn't show handDTO
*** SUMMARY ***
Total pot 9220 | Rake 0 
Board [6h 5c 6d 3c]
Seat 1: amassi13 (button) folded on the Flop
Seat 2: lis@nderr (small blind) collected (9220)
Seat 3: liverpool f1 (big blind) folded on the Turn
Seat 4: pafax folded before Flop (didn't bet)
Seat 5: piratrau folded before Flop (didn't bet)
Seat 6: heberiver folded before Flop (didn't bet)
Seat 7: DerGamingOpa folded before Flop (didn't bet)
Seat 8: jcarlos.vale folded before Flop (didn't bet)



PokerStars Hand #221335053801: Tournament #3067368972, $0.25+$0.24+$0.06 USD Hold'em No Limit - Level XXI (450/900) - 2020/12/11 22:23:18 EET [2020/12/11 15:23:18 ET]
Table '3067368972 51' 9-max Seat #2 is the button
Seat 2: lis@nderr (39293 in chips, $0.78 bounty) 
Seat 3: liverpool f1 (44610 in chips, $0.96 bounty) 
Seat 4: pafax (27950 in chips, $0.90 bounty) 
Seat 5: piratrau (24182 in chips, $0.57 bounty) 
Seat 6: heberiver (63599 in chips, $1.05 bounty) 
Seat 7: DerGamingOpa (132881 in chips, $2.01 bounty) 
Seat 8: jcarlos.vale (43268 in chips, $1.08 bounty) 
Seat 9: Madchester11 (34335 in chips, $1.20 bounty) 
lis@nderr: posts the ante 140
liverpool f1: posts the ante 140
pafax: posts the ante 140
piratrau: posts the ante 140
heberiver: posts the ante 140
DerGamingOpa: posts the ante 140
jcarlos.vale: posts the ante 140
Madchester11: posts the ante 140
liverpool f1: posts small blind 450
pafax: posts big blind 900
*** HOLE CARDS ***
Dealt to jcarlos.vale [Qc 2d]
piratrau: folds 
heberiver: raises 900 to 1800
DerGamingOpa: calls 1800
jcarlos.vale: folds 
Madchester11: folds 
lis@nderr: folds 
liverpool f1: folds 
pafax: folds 
*** FLOP *** [4h 6c Ad]
heberiver: bets 1800
DerGamingOpa: calls 1800
*** TURN *** [4h 6c Ad] [Ah]
heberiver: checks 
DerGamingOpa: checks 
*** RIVER *** [4h 6c Ad Ah] [Kh]
heberiver: bets 9670
DerGamingOpa: folds 
Uncalled bet (9670) returned to heberiver
heberiver collected 9670 from pot
heberiver: doesn't show handDTO
*** SUMMARY ***
Total pot 9670 | Rake 0 
Board [4h 6c Ad Ah Kh]
Seat 2: lis@nderr (button) folded before Flop (didn't bet)
Seat 3: liverpool f1 (small blind) folded before Flop
Seat 4: pafax (big blind) folded before Flop
Seat 5: piratrau folded before Flop (didn't bet)
Seat 6: heberiver collected (9670)
Seat 7: DerGamingOpa folded on the River
Seat 8: jcarlos.vale folded before Flop (didn't bet)
Seat 9: Madchester11 folded before Flop (didn't bet)



PokerStars Hand #221335085124: Tournament #3067368972, $0.25+$0.24+$0.06 USD Hold'em No Limit - Level XXI (450/900) - 2020/12/11 22:24:02 EET [2020/12/11 15:24:02 ET]
Table '3067368972 51' 9-max Seat #3 is the button
Seat 1: informoney00 (38498 in chips, $1.53 bounty) 
Seat 2: lis@nderr (39153 in chips, $0.78 bounty) 
Seat 3: liverpool f1 (44020 in chips, $0.96 bounty) 
Seat 4: pafax (26910 in chips, $0.90 bounty) 
Seat 5: piratrau (24042 in chips, $0.57 bounty) 
Seat 6: heberiver (69529 in chips, $1.05 bounty) 
Seat 7: DerGamingOpa (129141 in chips, $2.01 bounty) 
Seat 8: jcarlos.vale (43128 in chips, $1.08 bounty) 
Seat 9: Madchester11 (34195 in chips, $1.20 bounty) 
informoney00: posts the ante 140
lis@nderr: posts the ante 140
liverpool f1: posts the ante 140
pafax: posts the ante 140
piratrau: posts the ante 140
heberiver: posts the ante 140
DerGamingOpa: posts the ante 140
jcarlos.vale: posts the ante 140
Madchester11: posts the ante 140
pafax: posts small blind 450
piratrau: posts big blind 900
*** HOLE CARDS ***
Dealt to jcarlos.vale [9h Th]
heberiver: raises 900 to 1800
DerGamingOpa: folds 
jcarlos.vale: folds 
Madchester11: folds 
informoney00: folds 
lis@nderr: folds 
liverpool f1: folds 
pafax: folds 
piratrau: folds 
Uncalled bet (900) returned to heberiver
heberiver collected 3510 from pot
heberiver: doesn't show handDTO
*** SUMMARY ***
Total pot 3510 | Rake 0 
Seat 1: informoney00 folded before Flop (didn't bet)
Seat 2: lis@nderr folded before Flop (didn't bet)
Seat 3: liverpool f1 (button) folded before Flop (didn't bet)
Seat 4: pafax (small blind) folded before Flop
Seat 5: piratrau (big blind) folded before Flop
Seat 6: heberiver collected (3510)
Seat 7: DerGamingOpa folded before Flop (didn't bet)
Seat 8: jcarlos.vale folded before Flop (didn't bet)
Seat 9: Madchester11 folded before Flop (didn't bet)



PokerStars Hand #221335098699: Tournament #3067368972, $0.25+$0.24+$0.06 USD Hold'em No Limit - Level XXI (450/900) - 2020/12/11 22:24:20 EET [2020/12/11 15:24:20 ET]
Table '3067368972 51' 9-max Seat #4 is the button
Seat 1: informoney00 (38358 in chips, $1.53 bounty) 
Seat 2: lis@nderr (39013 in chips, $0.78 bounty) 
Seat 3: liverpool f1 (43880 in chips, $0.96 bounty) 
Seat 4: pafax (26320 in chips, $0.90 bounty) 
Seat 5: piratrau (23002 in chips, $0.57 bounty) 
Seat 6: heberiver (71999 in chips, $1.05 bounty) 
Seat 7: DerGamingOpa (129001 in chips, $2.01 bounty) 
Seat 8: jcarlos.vale (42988 in chips, $1.08 bounty) 
Seat 9: Madchester11 (34055 in chips, $1.20 bounty) 
informoney00: posts the ante 140
lis@nderr: posts the ante 140
liverpool f1: posts the ante 140
pafax: posts the ante 140
piratrau: posts the ante 140
heberiver: posts the ante 140
DerGamingOpa: posts the ante 140
jcarlos.vale: posts the ante 140
Madchester11: posts the ante 140
piratrau: posts small blind 450
heberiver: posts big blind 900
*** HOLE CARDS ***
Dealt to jcarlos.vale [6h 2d]
DerGamingOpa: folds 
jcarlos.vale: folds 
Madchester11: calls 900
informoney00: raises 4410 to 5310
lis@nderr: folds 
liverpool f1: folds 
pafax: folds 
piratrau: calls 4860
heberiver: folds 
Madchester11: folds 
*** FLOP *** [Js 5c 3c]
piratrau: checks 
informoney00: bets 13680
piratrau: calls 13680
*** TURN *** [Js 5c 3c] [Kd]
piratrau: checks 
informoney00: bets 19228 and is all-in
piratrau: calls 3872 and is all-in
Uncalled bet (15356) returned to informoney00
*** RIVER *** [Js 5c 3c Kd] [Qh]
*** SHOW DOWN ***
piratrau: shows [Td Jc] (a pair of Jacks)
informoney00: shows [As Tc] (a straight, Ten to Ace)
informoney00 collected 48784 from pot
informoney00 wins $0.29 for eliminating piratrau and their own bounty increases by $0.28 to $1.81
piratrau finished the tournament in 856th place and received $0.48.
*** SUMMARY ***
Total pot 48784 | Rake 0 
Board [Js 5c 3c Kd Qh]
Seat 1: informoney00 showed [As Tc] and won (48784) with a straight, Ten to Ace
Seat 2: lis@nderr folded before Flop (didn't bet)
Seat 3: liverpool f1 folded before Flop (didn't bet)
Seat 4: pafax (button) folded before Flop (didn't bet)
Seat 5: piratrau (small blind) showed [Td Jc] and lost with a pair of Jacks
Seat 6: heberiver (big blind) folded before Flop
Seat 7: DerGamingOpa folded before Flop (didn't bet)
Seat 8: jcarlos.vale folded before Flop (didn't bet)
Seat 9: Madchester11 folded before Flop



PokerStars Hand #221335149737: Tournament #3067368972, $0.25+$0.24+$0.06 USD Hold'em No Limit - Level XXI (450/900) - 2020/12/11 22:25:32 EET [2020/12/11 15:25:32 ET]
Table '3067368972 258' 9-max Seat #7 is the button
Seat 1: Titanik00077 (15798 in chips, $0.24 bounty) 
Seat 2: abarros007 (22660 in chips, $0.36 bounty) 
Seat 3: SyPlums (7021 in chips, $0.60 bounty) 
Seat 4: ripbon (12245 in chips, $0.72 bounty) 
Seat 5: Sergant777111 (62632 in chips, $1.20 bounty) 
Seat 6: stolleken161 (75642 in chips, $0.78 bounty) 
Seat 7: Tuco_atc (7327 in chips, $0.24 bounty) 
Seat 8: DeeGee60 (41670 in chips, $0.94 bounty) 
Seat 9: jcarlos.vale (42848 in chips, $1.08 bounty) 
Titanik00077: posts the ante 140
abarros007: posts the ante 140
SyPlums: posts the ante 140
ripbon: posts the ante 140
Sergant777111: posts the ante 140
stolleken161: posts the ante 140
Tuco_atc: posts the ante 140
DeeGee60: posts the ante 140
jcarlos.vale: posts the ante 140
DeeGee60: posts small blind 450
jcarlos.vale: posts big blind 900
*** HOLE CARDS ***
Dealt to jcarlos.vale [Js 6c]
Titanik00077: folds 
abarros007: folds 
SyPlums: folds 
ripbon: folds 
Sergant777111: folds 
stolleken161: calls 900
Tuco_atc: folds 
DeeGee60: calls 450
jcarlos.vale: checks 
*** FLOP *** [Kh 4c 7d]
DeeGee60: checks 
jcarlos.vale: checks 
stolleken161: checks 
*** TURN *** [Kh 4c 7d] [7h]
DeeGee60: checks 
jcarlos.vale: bets 1800
stolleken161: calls 1800
DeeGee60: folds 
*** RIVER *** [Kh 4c 7d 7h] [5h]
jcarlos.vale: bets 2700
stolleken161: raises 42768 to 45468
jcarlos.vale: folds 
Uncalled bet (42768) returned to stolleken161
stolleken161 collected 12960 from pot
stolleken161: doesn't show handDTO
*** SUMMARY ***
Total pot 12960 | Rake 0 
Board [Kh 4c 7d 7h 5h]
Seat 1: Titanik00077 folded before Flop (didn't bet)
Seat 2: abarros007 folded before Flop (didn't bet)
Seat 3: SyPlums folded before Flop (didn't bet)
Seat 4: ripbon folded before Flop (didn't bet)
Seat 5: Sergant777111 folded before Flop (didn't bet)
Seat 6: stolleken161 collected (12960)
Seat 7: Tuco_atc (button) folded before Flop (didn't bet)
Seat 8: DeeGee60 (small blind) folded on the Turn
Seat 9: jcarlos.vale (big blind) folded on the River



PokerStars Hand #221335211903: Tournament #3067368972, $0.25+$0.24+$0.06 USD Hold'em No Limit - Level XXII (500/1000) - 2020/12/11 22:26:44 EET [2020/12/11 15:26:44 ET]
Table '3067368972 258' 9-max Seat #8 is the button
Seat 1: Titanik00077 (15658 in chips, $0.24 bounty) 
Seat 2: abarros007 (22520 in chips, $0.36 bounty) 
Seat 3: SyPlums (6881 in chips, $0.60 bounty) 
Seat 4: ripbon (12105 in chips, $0.72 bounty) 
Seat 5: Sergant777111 (62492 in chips, $1.20 bounty) 
Seat 6: stolleken161 (83062 in chips, $0.78 bounty) 
Seat 7: Tuco_atc (7187 in chips, $0.24 bounty) 
Seat 8: DeeGee60 (40630 in chips, $0.94 bounty) 
Seat 9: jcarlos.vale (37308 in chips, $1.08 bounty) 
Titanik00077: posts the ante 150
abarros007: posts the ante 150
SyPlums: posts the ante 150
ripbon: posts the ante 150
Sergant777111: posts the ante 150
stolleken161: posts the ante 150
Tuco_atc: posts the ante 150
DeeGee60: posts the ante 150
jcarlos.vale: posts the ante 150
jcarlos.vale: posts small blind 500
Titanik00077: posts big blind 1000
*** HOLE CARDS ***
Dealt to jcarlos.vale [8d Ts]
abarros007: folds 
SyPlums: folds 
ripbon: raises 10955 to 11955 and is all-in
Sergant777111: folds 
stolleken161: folds 
Tuco_atc: folds 
DeeGee60: folds 
jcarlos.vale: folds 
Titanik00077: folds 
Uncalled bet (10955) returned to ripbon
ripbon collected 3850 from pot
ripbon: doesn't show handDTO
*** SUMMARY ***
Total pot 3850 | Rake 0 
Seat 1: Titanik00077 (big blind) folded before Flop
Seat 2: abarros007 folded before Flop (didn't bet)
Seat 3: SyPlums folded before Flop (didn't bet)
Seat 4: ripbon collected (3850)
Seat 5: Sergant777111 folded before Flop (didn't bet)
Seat 6: stolleken161 folded before Flop (didn't bet)
Seat 7: Tuco_atc folded before Flop (didn't bet)
Seat 8: DeeGee60 (button) folded before Flop (didn't bet)
Seat 9: jcarlos.vale (small blind) folded before Flop



PokerStars Hand #221335242969: Tournament #3067368972, $0.25+$0.24+$0.06 USD Hold'em No Limit - Level XXII (500/1000) - 2020/12/11 22:27:27 EET [2020/12/11 15:27:27 ET]
Table '3067368972 258' 9-max Seat #9 is the button
Seat 1: Titanik00077 (14508 in chips, $0.24 bounty) 
Seat 2: abarros007 (22370 in chips, $0.36 bounty) 
Seat 3: SyPlums (6731 in chips, $0.60 bounty) 
Seat 4: ripbon (14805 in chips, $0.72 bounty) 
Seat 5: Sergant777111 (62342 in chips, $1.20 bounty) 
Seat 6: stolleken161 (82912 in chips, $0.78 bounty) 
Seat 7: Tuco_atc (7037 in chips, $0.24 bounty) 
Seat 8: DeeGee60 (40480 in chips, $0.94 bounty) 
Seat 9: jcarlos.vale (36658 in chips, $1.08 bounty) 
Titanik00077: posts the ante 150
abarros007: posts the ante 150
SyPlums: posts the ante 150
ripbon: posts the ante 150
Sergant777111: posts the ante 150
stolleken161: posts the ante 150
Tuco_atc: posts the ante 150
DeeGee60: posts the ante 150
jcarlos.vale: posts the ante 150
Titanik00077: posts small blind 500
abarros007: posts big blind 1000
*** HOLE CARDS ***
Dealt to jcarlos.vale [Th 9s]
SyPlums has timed out
SyPlums: folds 
SyPlums is sitting out
ripbon: folds 
Sergant777111: folds 
stolleken161: calls 1000
SyPlums has returned
Tuco_atc: folds 
DeeGee60: folds 
jcarlos.vale: folds 
Titanik00077: folds 
abarros007: checks 
*** FLOP *** [4d 3c 8s]
abarros007: checks 
stolleken161: bets 1000
abarros007: raises 2500 to 3500
stolleken161: calls 2500
*** TURN *** [4d 3c 8s] [Kd]
abarros007: bets 6000
stolleken161: calls 6000
*** RIVER *** [4d 3c 8s Kd] [8c]
abarros007: checks 
stolleken161: bets 4742
abarros007: folds 
Uncalled bet (4742) returned to stolleken161
stolleken161 collected 22850 from pot
stolleken161: doesn't show handDTO
*** SUMMARY ***
Total pot 22850 | Rake 0 
Board [4d 3c 8s Kd 8c]
Seat 1: Titanik00077 (small blind) folded before Flop
Seat 2: abarros007 (big blind) folded on the River
Seat 3: SyPlums folded before Flop (didn't bet)
Seat 4: ripbon folded before Flop (didn't bet)
Seat 5: Sergant777111 folded before Flop (didn't bet)
Seat 6: stolleken161 collected (22850)
Seat 7: Tuco_atc folded before Flop (didn't bet)
Seat 8: DeeGee60 folded before Flop (didn't bet)
Seat 9: jcarlos.vale (button) folded before Flop (didn't bet)



PokerStars Hand #221335303522: Tournament #3067368972, $0.25+$0.24+$0.06 USD Hold'em No Limit - Level XXII (500/1000) - 2020/12/11 22:28:52 EET [2020/12/11 15:28:52 ET]
Table '3067368972 258' 9-max Seat #1 is the button
Seat 1: Titanik00077 (13858 in chips, $0.24 bounty) 
Seat 2: abarros007 (11720 in chips, $0.36 bounty) 
Seat 3: SyPlums (6581 in chips, $0.60 bounty) 
Seat 4: ripbon (14655 in chips, $0.72 bounty) 
Seat 5: Sergant777111 (62192 in chips, $1.20 bounty) 
Seat 6: stolleken161 (95112 in chips, $0.78 bounty) 
Seat 7: Tuco_atc (6887 in chips, $0.24 bounty) 
Seat 8: DeeGee60 (40330 in chips, $0.94 bounty) 
Seat 9: jcarlos.vale (36508 in chips, $1.08 bounty) 
Titanik00077: posts the ante 150
abarros007: posts the ante 150
SyPlums: posts the ante 150
ripbon: posts the ante 150
Sergant777111: posts the ante 150
stolleken161: posts the ante 150
Tuco_atc: posts the ante 150
DeeGee60: posts the ante 150
jcarlos.vale: posts the ante 150
abarros007: posts small blind 500
SyPlums: posts big blind 1000
*** HOLE CARDS ***
Dealt to jcarlos.vale [6h 3c]
ripbon: raises 13505 to 14505 and is all-in
Sergant777111: folds 
stolleken161: folds 
Tuco_atc: folds 
DeeGee60: folds 
jcarlos.vale: folds 
Titanik00077: calls 13708 and is all-in
abarros007: folds 
SyPlums: folds 
Uncalled bet (797) returned to ripbon
*** FLOP *** [9c Th Jh]
*** TURN *** [9c Th Jh] [7c]
*** RIVER *** [9c Th Jh 7c] [2s]
*** SHOW DOWN ***
ripbon: shows [Ah Qc] (high pairOfCards Ace)
Titanik00077: shows [Ac Qh] (high pairOfCards Ace)
ripbon collected 15133 from pot
Titanik00077 collected 15133 from pot
*** SUMMARY ***
Total pot 30266 | Rake 0 
Board [9c Th Jh 7c 2s]
Seat 1: Titanik00077 (button) showed [Ac Qh] and won (15133) with high pairOfCards Ace
Seat 2: abarros007 (small blind) folded before Flop
Seat 3: SyPlums (big blind) folded before Flop
Seat 4: ripbon showed [Ah Qc] and won (15133) with high pairOfCards Ace
Seat 5: Sergant777111 folded before Flop (didn't bet)
Seat 6: stolleken161 folded before Flop (didn't bet)
Seat 7: Tuco_atc folded before Flop (didn't bet)
Seat 8: DeeGee60 folded before Flop (didn't bet)
Seat 9: jcarlos.vale folded before Flop (didn't bet)



PokerStars Hand #221335334195: Tournament #3067368972, $0.25+$0.24+$0.06 USD Hold'em No Limit - Level XXII (500/1000) - 2020/12/11 22:29:35 EET [2020/12/11 15:29:35 ET]
Table '3067368972 258' 9-max Seat #2 is the button
Seat 1: Titanik00077 (15133 in chips, $0.24 bounty) 
Seat 2: abarros007 (11070 in chips, $0.36 bounty) 
Seat 3: SyPlums (5431 in chips, $0.60 bounty) 
Seat 4: ripbon (15930 in chips, $0.72 bounty) 
Seat 5: Sergant777111 (62042 in chips, $1.20 bounty) 
Seat 6: stolleken161 (94962 in chips, $0.78 bounty) 
Seat 7: Tuco_atc (6737 in chips, $0.24 bounty) 
Seat 8: DeeGee60 (40180 in chips, $0.94 bounty) 
Seat 9: jcarlos.vale (36358 in chips, $1.08 bounty) 
Titanik00077: posts the ante 150
abarros007: posts the ante 150
SyPlums: posts the ante 150
ripbon: posts the ante 150
Sergant777111: posts the ante 150
stolleken161: posts the ante 150
Tuco_atc: posts the ante 150
DeeGee60: posts the ante 150
jcarlos.vale: posts the ante 150
SyPlums: posts small blind 500
ripbon: posts big blind 1000
*** HOLE CARDS ***
Dealt to jcarlos.vale [5c 9d]
Sergant777111: calls 1000
stolleken161: folds 
Tuco_atc: folds 
DeeGee60: raises 1000 to 2000
jcarlos.vale: folds 
Titanik00077: folds 
abarros007: folds 
SyPlums: folds 
ripbon: folds 
Sergant777111: calls 1000
*** FLOP *** [3h Jd 2h]
Sergant777111: bets 1500
DeeGee60: calls 1500
*** TURN *** [3h Jd 2h] [Ah]
Sergant777111: bets 2000
DeeGee60: raises 13850 to 15850
Sergant777111: folds 
Uncalled bet (13850) returned to DeeGee60
DeeGee60 collected 13850 from pot
DeeGee60: doesn't show handDTO
*** SUMMARY ***
Total pot 13850 | Rake 0 
Board [3h Jd 2h Ah]
Seat 1: Titanik00077 folded before Flop (didn't bet)
Seat 2: abarros007 (button) folded before Flop (didn't bet)
Seat 3: SyPlums (small blind) folded before Flop
Seat 4: ripbon (big blind) folded before Flop
Seat 5: Sergant777111 folded on the Turn
Seat 6: stolleken161 folded before Flop (didn't bet)
Seat 7: Tuco_atc folded before Flop (didn't bet)
Seat 8: DeeGee60 collected (13850)
Seat 9: jcarlos.vale folded before Flop (didn't bet)



PokerStars Hand #221335378592: Tournament #3067368972, $0.25+$0.24+$0.06 USD Hold'em No Limit - Level XXII (500/1000) - 2020/12/11 22:30:37 EET [2020/12/11 15:30:37 ET]
Table '3067368972 258' 9-max Seat #3 is the button
Seat 1: Titanik00077 (14983 in chips, $0.24 bounty) 
Seat 2: abarros007 (10920 in chips, $0.36 bounty) 
Seat 3: SyPlums (4781 in chips, $0.60 bounty) 
Seat 4: ripbon (14780 in chips, $0.72 bounty) 
Seat 5: Sergant777111 (56392 in chips, $1.20 bounty) 
Seat 7: Tuco_atc (6587 in chips, $0.24 bounty) 
Seat 8: DeeGee60 (48380 in chips, $0.94 bounty) 
Seat 9: jcarlos.vale (36208 in chips, $1.08 bounty) 
Titanik00077: posts the ante 150
abarros007: posts the ante 150
SyPlums: posts the ante 150
ripbon: posts the ante 150
Sergant777111: posts the ante 150
Tuco_atc: posts the ante 150
DeeGee60: posts the ante 150
jcarlos.vale: posts the ante 150
ripbon: posts small blind 500
Sergant777111: posts big blind 1000
*** HOLE CARDS ***
Dealt to jcarlos.vale [Qh Ac]
Tuco_atc: folds 
DeeGee60: folds 
jcarlos.vale: raises 1600 to 2600
Titanik00077: folds 
abarros007: folds 
SyPlums: folds 
ripbon: folds 
Sergant777111: calls 1600
*** FLOP *** [8h 7c Tc]
Sergant777111: checks 
jcarlos.vale: checks 
*** TURN *** [8h 7c Tc] [9h]
Sergant777111: checks 
jcarlos.vale: checks 
*** RIVER *** [8h 7c Tc 9h] [5s]
Sergant777111: checks 
jcarlos.vale: checks 
*** SHOW DOWN ***
Sergant777111: shows [Ad 8d] (a pair of Eights)
jcarlos.vale: mucks handDTO
Sergant777111 collected 6900 from pot
*** SUMMARY ***
Total pot 6900 | Rake 0 
Board [8h 7c Tc 9h 5s]
Seat 1: Titanik00077 folded before Flop (didn't bet)
Seat 2: abarros007 folded before Flop (didn't bet)
Seat 3: SyPlums (button) folded before Flop (didn't bet)
Seat 4: ripbon (small blind) folded before Flop
Seat 5: Sergant777111 (big blind) showed [Ad 8d] and won (6900) with a pair of Eights
Seat 7: Tuco_atc folded before Flop (didn't bet)
Seat 8: DeeGee60 folded before Flop (didn't bet)
Seat 9: jcarlos.vale mucked [Qh Ac]



PokerStars Hand #221335414221: Tournament #3067368972, $0.25+$0.24+$0.06 USD Hold'em No Limit - Level XXII (500/1000) - 2020/12/11 22:31:27 EET [2020/12/11 15:31:27 ET]
Table '3067368972 258' 9-max Seat #4 is the button
Seat 1: Titanik00077 (14833 in chips, $0.24 bounty) 
Seat 2: abarros007 (10770 in chips, $0.36 bounty) 
Seat 3: SyPlums (4631 in chips, $0.60 bounty) 
Seat 4: ripbon (14130 in chips, $0.72 bounty) 
Seat 5: Sergant777111 (60542 in chips, $1.20 bounty) 
Seat 6: @rnold93 (41633 in chips, $0.75 bounty) 
Seat 7: Tuco_atc (6437 in chips, $0.24 bounty) 
Seat 8: DeeGee60 (48230 in chips, $0.94 bounty) 
Seat 9: jcarlos.vale (33458 in chips, $1.08 bounty) 
Titanik00077: posts the ante 150
abarros007: posts the ante 150
SyPlums: posts the ante 150
ripbon: posts the ante 150
Sergant777111: posts the ante 150
@rnold93: posts the ante 150
Tuco_atc: posts the ante 150
DeeGee60: posts the ante 150
jcarlos.vale: posts the ante 150
Sergant777111: posts small blind 500
@rnold93: posts big blind 1000
*** HOLE CARDS ***
Dealt to jcarlos.vale [7s Kh]
Tuco_atc: raises 5287 to 6287 and is all-in
DeeGee60: folds 
jcarlos.vale: folds 
Titanik00077: folds 
abarros007: folds 
SyPlums: folds 
ripbon: folds 
Sergant777111: folds 
@rnold93: calls 5287
*** FLOP *** [9s Ah 6c]
*** TURN *** [9s Ah 6c] [5c]
*** RIVER *** [9s Ah 6c 5c] [2s]
*** SHOW DOWN ***
@rnold93: shows [Qc Ts] (high pairOfCards Ace)
Tuco_atc: shows [As Qd] (a pair of Aces)
Tuco_atc collected 14424 from pot
*** SUMMARY ***
Total pot 14424 | Rake 0 
Board [9s Ah 6c 5c 2s]
Seat 1: Titanik00077 folded before Flop (didn't bet)
Seat 2: abarros007 folded before Flop (didn't bet)
Seat 3: SyPlums folded before Flop (didn't bet)
Seat 4: ripbon (button) folded before Flop (didn't bet)
Seat 5: Sergant777111 (small blind) folded before Flop
Seat 6: @rnold93 (big blind) showed [Qc Ts] and lost with high pairOfCards Ace
Seat 7: Tuco_atc showed [As Qd] and won (14424) with a pair of Aces
Seat 8: DeeGee60 folded before Flop (didn't bet)
Seat 9: jcarlos.vale folded before Flop (didn't bet)



PokerStars Hand #221335450337: Tournament #3067368972, $0.25+$0.24+$0.06 USD Hold'em No Limit - Level XXII (500/1000) - 2020/12/11 22:32:17 EET [2020/12/11 15:32:17 ET]
Table '3067368972 258' 9-max Seat #5 is the button
Seat 1: Titanik00077 (14683 in chips, $0.24 bounty) 
Seat 2: abarros007 (10620 in chips, $0.36 bounty) 
Seat 3: SyPlums (4481 in chips, $0.60 bounty) 
Seat 4: ripbon (13980 in chips, $0.72 bounty) 
Seat 5: Sergant777111 (59892 in chips, $1.20 bounty) 
Seat 6: @rnold93 (35196 in chips, $0.75 bounty) 
Seat 7: Tuco_atc (14424 in chips, $0.24 bounty) 
Seat 8: DeeGee60 (48080 in chips, $0.94 bounty) 
Seat 9: jcarlos.vale (33308 in chips, $1.08 bounty) 
Titanik00077: posts the ante 150
abarros007: posts the ante 150
SyPlums: posts the ante 150
ripbon: posts the ante 150
Sergant777111: posts the ante 150
@rnold93: posts the ante 150
Tuco_atc: posts the ante 150
DeeGee60: posts the ante 150
jcarlos.vale: posts the ante 150
@rnold93: posts small blind 500
Tuco_atc: posts big blind 1000
*** HOLE CARDS ***
Dealt to jcarlos.vale [5c 3s]
DeeGee60: folds 
jcarlos.vale: folds 
Titanik00077: folds 
abarros007: folds 
SyPlums: folds 
ripbon: folds 
Sergant777111: folds 
@rnold93: calls 500
Tuco_atc: checks 
*** FLOP *** [9d 8c 3h]
@rnold93: bets 3350
Tuco_atc: calls 3350
*** TURN *** [9d 8c 3h] [9s]
@rnold93: checks 
Tuco_atc: checks 
*** RIVER *** [9d 8c 3h 9s] [Kd]
@rnold93: bets 10050
Tuco_atc: folds 
Uncalled bet (10050) returned to @rnold93
@rnold93 collected 10050 from pot
@rnold93: doesn't show handDTO
*** SUMMARY ***
Total pot 10050 | Rake 0 
Board [9d 8c 3h 9s Kd]
Seat 1: Titanik00077 folded before Flop (didn't bet)
Seat 2: abarros007 folded before Flop (didn't bet)
Seat 3: SyPlums folded before Flop (didn't bet)
Seat 4: ripbon folded before Flop (didn't bet)
Seat 5: Sergant777111 (button) folded before Flop (didn't bet)
Seat 6: @rnold93 (small blind) collected (10050)
Seat 7: Tuco_atc (big blind) folded on the River
Seat 8: DeeGee60 folded before Flop (didn't bet)
Seat 9: jcarlos.vale folded before Flop (didn't bet)



PokerStars Hand #221335489540: Tournament #3067368972, $0.25+$0.24+$0.06 USD Hold'em No Limit - Level XXII (500/1000) - 2020/12/11 22:33:11 EET [2020/12/11 15:33:11 ET]
Table '3067368972 258' 9-max Seat #6 is the button
Seat 1: Titanik00077 (14533 in chips, $0.24 bounty) 
Seat 2: abarros007 (10470 in chips, $0.36 bounty) 
Seat 3: SyPlums (4331 in chips, $0.60 bounty) 
Seat 4: ripbon (13830 in chips, $0.72 bounty) 
Seat 5: Sergant777111 (59742 in chips, $1.20 bounty) 
Seat 6: @rnold93 (40746 in chips, $0.75 bounty) 
Seat 7: Tuco_atc (9924 in chips, $0.24 bounty) 
Seat 8: DeeGee60 (47930 in chips, $0.94 bounty) 
Seat 9: jcarlos.vale (33158 in chips, $1.08 bounty) 
Titanik00077: posts the ante 150
abarros007: posts the ante 150
SyPlums: posts the ante 150
ripbon: posts the ante 150
Sergant777111: posts the ante 150
@rnold93: posts the ante 150
Tuco_atc: posts the ante 150
DeeGee60: posts the ante 150
jcarlos.vale: posts the ante 150
Tuco_atc: posts small blind 500
DeeGee60: posts big blind 1000
*** HOLE CARDS ***
Dealt to jcarlos.vale [5h 8h]
jcarlos.vale: folds 
Titanik00077 is disconnected 
Titanik00077 has timed out while being disconnected
Titanik00077: folds 
Titanik00077 is sitting out
abarros007: folds 
SyPlums: raises 3181 to 4181 and is all-in
ripbon: folds 
Sergant777111: folds 
@rnold93: folds 
Tuco_atc: raises 5593 to 9774 and is all-in
DeeGee60: calls 8774
*** FLOP *** [4c 4h 8d]
*** TURN *** [4c 4h 8d] [Js]
*** RIVER *** [4c 4h 8d Js] [Kh]
*** SHOW DOWN ***
Tuco_atc: shows [Jh 9s] (two pair, Jacks and Fours)
DeeGee60: shows [Qh Qd] (two pair, Queens and Fours)
DeeGee60 collected 11186 from side pot
SyPlums: shows [Ah 7d] (a pair of Fours)
DeeGee60 collected 13893 from main pot
DeeGee60 wins $0.30 for eliminating SyPlums and their own bounty increases by $0.30 to $1.24
DeeGee60 wins $0.12 for eliminating Tuco_atc and their own bounty increases by $0.12 to $1.36
Tuco_atc finished the tournament in 717th place and received $0.51.
SyPlums finished the tournament in 718th place and received $0.51.
*** SUMMARY ***
Total pot 25079 Main pot 13893. Side pot 11186. | Rake 0 
Board [4c 4h 8d Js Kh]
Seat 1: Titanik00077 folded before Flop (didn't bet)
Seat 2: abarros007 folded before Flop (didn't bet)
Seat 3: SyPlums showed [Ah 7d] and lost with a pair of Fours
Seat 4: ripbon folded before Flop (didn't bet)
Seat 5: Sergant777111 folded before Flop (didn't bet)
Seat 6: @rnold93 (button) folded before Flop (didn't bet)
Seat 7: Tuco_atc (small blind) showed [Jh 9s] and lost with two pair, Jacks and Fours
Seat 8: DeeGee60 (big blind) showed [Qh Qd] and won (25079) with two pair, Queens and Fours
Seat 9: jcarlos.vale folded before Flop (didn't bet)



PokerStars Hand #221335542912: Tournament #3067368972, $0.25+$0.24+$0.06 USD Hold'em No Limit - Level XXIII (600/1200) - 2020/12/11 22:34:25 EET [2020/12/11 15:34:25 ET]
Table '3067368972 258' 9-max Seat #8 is the button
Seat 1: Titanik00077 (14383 in chips, $0.24 bounty) is sitting out
Seat 2: abarros007 (10320 in chips, $0.36 bounty) 
Seat 4: ripbon (13680 in chips, $0.72 bounty) 
Seat 5: Sergant777111 (59592 in chips, $1.20 bounty) 
Seat 6: @rnold93 (40596 in chips, $0.75 bounty) 
Seat 7: DannoYVR (17702 in chips, $0.81 bounty) 
Seat 8: DeeGee60 (63085 in chips, $1.36 bounty) 
Seat 9: jcarlos.vale (33008 in chips, $1.08 bounty) 
Titanik00077: posts the ante 180
abarros007: posts the ante 180
ripbon: posts the ante 180
Sergant777111: posts the ante 180
@rnold93: posts the ante 180
DannoYVR: posts the ante 180
DeeGee60: posts the ante 180
jcarlos.vale: posts the ante 180
jcarlos.vale: posts small blind 600
Titanik00077: posts big blind 1200
*** HOLE CARDS ***
Dealt to jcarlos.vale [8c 7d]
Titanik00077 has returned
abarros007: folds 
ripbon: folds 
Sergant777111: folds 
@rnold93: folds 
DannoYVR: folds 
DeeGee60: raises 1200 to 2400
jcarlos.vale: folds 
Titanik00077: folds 
Uncalled bet (1200) returned to DeeGee60
DeeGee60 collected 4440 from pot
DeeGee60: doesn't show handDTO
*** SUMMARY ***
Total pot 4440 | Rake 0 
Seat 1: Titanik00077 (big blind) folded before Flop
Seat 2: abarros007 folded before Flop (didn't bet)
Seat 4: ripbon folded before Flop (didn't bet)
Seat 5: Sergant777111 folded before Flop (didn't bet)
Seat 6: @rnold93 folded before Flop (didn't bet)
Seat 7: DannoYVR folded before Flop (didn't bet)
Seat 8: DeeGee60 (button) collected (4440)
Seat 9: jcarlos.vale (small blind) folded before Flop



PokerStars Hand #221335576743: Tournament #3067368972, $0.25+$0.24+$0.06 USD Hold'em No Limit - Level XXIII (600/1200) - 2020/12/11 22:35:05 EET [2020/12/11 15:35:05 ET]
Table '3067368972 258' 9-max Seat #9 is the button
Seat 1: Titanik00077 (13003 in chips, $0.24 bounty) 
Seat 2: abarros007 (10140 in chips, $0.36 bounty) 
Seat 3: W. of Poker (55542 in chips, $2.14 bounty) 
Seat 4: ripbon (13500 in chips, $0.72 bounty) 
Seat 5: Sergant777111 (59412 in chips, $1.20 bounty) 
Seat 6: @rnold93 (40416 in chips, $0.75 bounty) 
Seat 7: DannoYVR (17522 in chips, $0.81 bounty) 
Seat 8: DeeGee60 (66145 in chips, $1.36 bounty) 
Seat 9: jcarlos.vale (32228 in chips, $1.08 bounty) 
Titanik00077: posts the ante 180
abarros007: posts the ante 180
W. of Poker: posts the ante 180
ripbon: posts the ante 180
Sergant777111: posts the ante 180
@rnold93: posts the ante 180
DannoYVR: posts the ante 180
DeeGee60: posts the ante 180
jcarlos.vale: posts the ante 180
Titanik00077: posts small blind 600
abarros007: posts big blind 1200
*** HOLE CARDS ***
Dealt to jcarlos.vale [2d 3h]
W. of Poker: folds 
ripbon: folds 
Sergant777111: folds 
@rnold93: folds 
DannoYVR: folds 
DeeGee60: raises 1200 to 2400
jcarlos.vale: folds 
Titanik00077: calls 1800
abarros007: calls 1200
*** FLOP *** [3c Ad 5h]
Titanik00077: checks 
abarros007: checks 
DeeGee60: bets 8820
Titanik00077: folds 
abarros007: folds 
Uncalled bet (8820) returned to DeeGee60
DeeGee60 collected 8820 from pot
DeeGee60: doesn't show handDTO
*** SUMMARY ***
Total pot 8820 | Rake 0 
Board [3c Ad 5h]
Seat 1: Titanik00077 (small blind) folded on the Flop
Seat 2: abarros007 (big blind) folded on the Flop
Seat 3: W. of Poker folded before Flop (didn't bet)
Seat 4: ripbon folded before Flop (didn't bet)
Seat 5: Sergant777111 folded before Flop (didn't bet)
Seat 6: @rnold93 folded before Flop (didn't bet)
Seat 7: DannoYVR folded before Flop (didn't bet)
Seat 8: DeeGee60 collected (8820)
Seat 9: jcarlos.vale (button) folded before Flop (didn't bet)



PokerStars Hand #221335608854: Tournament #3067368972, $0.25+$0.24+$0.06 USD Hold'em No Limit - Level XXIII (600/1200) - 2020/12/11 22:35:50 EET [2020/12/11 15:35:50 ET]
Table '3067368972 258' 9-max Seat #1 is the button
Seat 1: Titanik00077 (10423 in chips, $0.24 bounty) 
Seat 2: abarros007 (7560 in chips, $0.36 bounty) 
Seat 3: W. of Poker (55362 in chips, $2.14 bounty) 
Seat 4: ripbon (13320 in chips, $0.72 bounty) 
Seat 5: Sergant777111 (59232 in chips, $1.20 bounty) 
Seat 6: @rnold93 (40236 in chips, $0.75 bounty) 
Seat 7: DannoYVR (17342 in chips, $0.81 bounty) 
Seat 8: DeeGee60 (72385 in chips, $1.36 bounty) 
Seat 9: jcarlos.vale (32048 in chips, $1.08 bounty) 
Titanik00077: posts the ante 180
abarros007: posts the ante 180
W. of Poker: posts the ante 180
ripbon: posts the ante 180
Sergant777111: posts the ante 180
@rnold93: posts the ante 180
DannoYVR: posts the ante 180
DeeGee60: posts the ante 180
jcarlos.vale: posts the ante 180
abarros007: posts small blind 600
W. of Poker: posts big blind 1200
*** HOLE CARDS ***
Dealt to jcarlos.vale [4h Th]
ripbon: raises 11940 to 13140 and is all-in
Sergant777111: folds 
@rnold93: folds 
DannoYVR: folds 
DeeGee60: folds 
jcarlos.vale: folds 
Titanik00077: folds 
abarros007: folds 
W. of Poker: calls 11940
*** FLOP *** [7d 9d 8c]
*** TURN *** [7d 9d 8c] [2h]
*** RIVER *** [7d 9d 8c 2h] [Jc]
*** SHOW DOWN ***
W. of Poker: shows [Kc Ad] (high pairOfCards Ace)
ripbon: shows [Ac Kd] (high pairOfCards Ace)
W. of Poker collected 14250 from pot
ripbon collected 14250 from pot
*** SUMMARY ***
Total pot 28500 | Rake 0 
Board [7d 9d 8c 2h Jc]
Seat 1: Titanik00077 (button) folded before Flop (didn't bet)
Seat 2: abarros007 (small blind) folded before Flop
Seat 3: W. of Poker (big blind) showed [Kc Ad] and won (14250) with high pairOfCards Ace
Seat 4: ripbon showed [Ac Kd] and won (14250) with high pairOfCards Ace
Seat 5: Sergant777111 folded before Flop (didn't bet)
Seat 6: @rnold93 folded before Flop (didn't bet)
Seat 7: DannoYVR folded before Flop (didn't bet)
Seat 8: DeeGee60 folded before Flop (didn't bet)
Seat 9: jcarlos.vale folded before Flop (didn't bet)



PokerStars Hand #221335640799: Tournament #3067368972, $0.25+$0.24+$0.06 USD Hold'em No Limit - Level XXIII (600/1200) - 2020/12/11 22:36:34 EET [2020/12/11 15:36:34 ET]
Table '3067368972 258' 9-max Seat #2 is the button
Seat 1: Titanik00077 (10243 in chips, $0.24 bounty) 
Seat 2: abarros007 (6780 in chips, $0.36 bounty) 
Seat 3: W. of Poker (56292 in chips, $2.14 bounty) 
Seat 4: ripbon (14250 in chips, $0.72 bounty) 
Seat 5: Sergant777111 (59052 in chips, $1.20 bounty) 
Seat 6: @rnold93 (40056 in chips, $0.75 bounty) 
Seat 7: DannoYVR (17162 in chips, $0.81 bounty) 
Seat 8: DeeGee60 (72205 in chips, $1.36 bounty) 
Seat 9: jcarlos.vale (31868 in chips, $1.08 bounty) 
Titanik00077: posts the ante 180
abarros007: posts the ante 180
W. of Poker: posts the ante 180
ripbon: posts the ante 180
Sergant777111: posts the ante 180
@rnold93: posts the ante 180
DannoYVR: posts the ante 180
DeeGee60: posts the ante 180
jcarlos.vale: posts the ante 180
W. of Poker: posts small blind 600
ripbon: posts big blind 1200
*** HOLE CARDS ***
Dealt to jcarlos.vale [2c 4h]
Sergant777111: folds 
@rnold93: folds 
DannoYVR: folds 
DeeGee60: folds 
jcarlos.vale: folds 
Titanik00077: folds 
abarros007: raises 5400 to 6600 and is all-in
W. of Poker: calls 6000
ripbon: folds 
*** FLOP *** [Tc Th 5h]
*** TURN *** [Tc Th 5h] [Td]
*** RIVER *** [Tc Th 5h Td] [8c]
*** SHOW DOWN ***
W. of Poker: shows [Qs 8s] (a full house, Tens full of Eights)
abarros007: shows [9s 7s] (three of a kind, Tens)
W. of Poker collected 16020 from pot
W. of Poker wins $0.18 for eliminating abarros007 and their own bounty increases by $0.18 to $2.32
abarros007 finished the tournament in 684th place and received $0.51.
*** SUMMARY ***
Total pot 16020 | Rake 0 
Board [Tc Th 5h Td 8c]
Seat 1: Titanik00077 folded before Flop (didn't bet)
Seat 2: abarros007 (button) showed [9s 7s] and lost with three of a kind, Tens
Seat 3: W. of Poker (small blind) showed [Qs 8s] and won (16020) with a full house, Tens full of Eights
Seat 4: ripbon (big blind) folded before Flop
Seat 5: Sergant777111 folded before Flop (didn't bet)
Seat 6: @rnold93 folded before Flop (didn't bet)
Seat 7: DannoYVR folded before Flop (didn't bet)
Seat 8: DeeGee60 folded before Flop (didn't bet)
Seat 9: jcarlos.vale folded before Flop (didn't bet)



PokerStars Hand #221335674765: Tournament #3067368972, $0.25+$0.24+$0.06 USD Hold'em No Limit - Level XXIII (600/1200) - 2020/12/11 22:37:22 EET [2020/12/11 15:37:22 ET]
Table '3067368972 258' 9-max Seat #3 is the button
Seat 1: Titanik00077 (10063 in chips, $0.24 bounty) 
Seat 3: W. of Poker (65532 in chips, $2.32 bounty) 
Seat 4: ripbon (12870 in chips, $0.72 bounty) 
Seat 5: Sergant777111 (58872 in chips, $1.20 bounty) 
Seat 6: @rnold93 (39876 in chips, $0.75 bounty) 
Seat 7: DannoYVR (16982 in chips, $0.81 bounty) 
Seat 8: DeeGee60 (72025 in chips, $1.36 bounty) 
Seat 9: jcarlos.vale (31688 in chips, $1.08 bounty) 
Titanik00077: posts the ante 180
W. of Poker: posts the ante 180
ripbon: posts the ante 180
Sergant777111: posts the ante 180
@rnold93: posts the ante 180
DannoYVR: posts the ante 180
DeeGee60: posts the ante 180
jcarlos.vale: posts the ante 180
ripbon: posts small blind 600
Sergant777111: posts big blind 1200
*** HOLE CARDS ***
Dealt to jcarlos.vale [Qh Qc]
@rnold93: folds 
DannoYVR: folds 
DeeGee60: folds 
jcarlos.vale: raises 1920 to 3120
Titanik00077: folds 
W. of Poker: calls 3120
ripbon: folds 
Sergant777111: folds 
*** FLOP *** [4s 3c 7h]
jcarlos.vale: bets 7110
W. of Poker: calls 7110
*** TURN *** [4s 3c 7h] [6h]
jcarlos.vale: bets 17775
W. of Poker: raises 17775 to 35550
jcarlos.vale: calls 3503 and is all-in
Uncalled bet (14272) returned to W. of Poker
*** RIVER *** [4s 3c 7h 6h] [4h]
*** SHOW DOWN ***
jcarlos.vale: shows [Qh Qc] (two pair, Queens and Fours)
W. of Poker: shows [4d 4c] (four of a kind, Fours)
W. of Poker collected 66256 from pot
W. of Poker wins $0.54 for eliminating jcarlos.vale and their own bounty increases by $0.54 to $2.86
jcarlos.vale finished the tournament in 668th place and received $0.51.
*** SUMMARY ***
Total pot 66256 | Rake 0 
Board [4s 3c 7h 6h 4h]
Seat 1: Titanik00077 folded before Flop (didn't bet)
Seat 3: W. of Poker (button) showed [4d 4c] and won (66256) with four of a kind, Fours
Seat 4: ripbon (small blind) folded before Flop
Seat 5: Sergant777111 (big blind) folded before Flop
Seat 6: @rnold93 folded before Flop (didn't bet)
Seat 7: DannoYVR folded before Flop (didn't bet)
Seat 8: DeeGee60 folded before Flop (didn't bet)
Seat 9: jcarlos.vale showed [Qh Qc] and lost with two pair, Queens and Fours



