PokerStars Hand #221589545122: Tournament #3079328305, $0.91+$0.09 USD Hold'em No Limit - Level I (10/20) - 2020/12/19 1:12:31 EET [2020/12/18 18:12:31 ET]
Table '3079328305 5' 9-max Seat #1 is the button
Seat 1: Asti.wp (1500 in chips) 
Seat 2: jcarlos.vale (1500 in chips) 
Seat 3: dady09 (1500 in chips) 
Seat 4: Nogarottoo (1500 in chips) 
Seat 5: Petrillo717 (1500 in chips) 
Seat 6: baalder (1500 in chips) 
Seat 7: PorNoSloniKK (1500 in chips) 
Seat 8: totyajohnny (1500 in chips) 
Seat 9: camcf63 (1500 in chips) 
Asti.wp: posts the ante 3
jcarlos.vale: posts the ante 3
dady09: posts the ante 3
Nogarottoo: posts the ante 3
Petrillo717: posts the ante 3
baalder: posts the ante 3
PorNoSloniKK: posts the ante 3
totyajohnny: posts the ante 3
camcf63: posts the ante 3
jcarlos.vale: posts small blind 10
dady09: posts big blind 20
*** HOLE CARDS ***
Dealt to jcarlos.vale [8c 2h]
Nogarottoo: raises 20 to 40
Petrillo717: calls 40
baalder: folds 
PorNoSloniKK: folds 
totyajohnny: calls 40
camcf63: raises 50 to 90
Asti.wp: folds 
jcarlos.vale: folds 
dady09: folds 
Nogarottoo: calls 50
Petrillo717: calls 50
totyajohnny: calls 50
*** FLOP *** [8d Kc 4d]
Nogarottoo: checks 
Petrillo717: checks 
totyajohnny: bets 209
camcf63: raises 376 to 585
Nogarottoo: folds 
Petrillo717: folds 
totyajohnny: folds 
Uncalled bet (376) returned to camcf63
camcf63 collected 835 from pot
*** SUMMARY ***
Total pot 835 | Rake 0 
Board [8d Kc 4d]
Seat 1: Asti.wp (button) folded before Flop (didn't bet)
Seat 2: jcarlos.vale (small blind) folded before Flop
Seat 3: dady09 (big blind) folded before Flop
Seat 4: Nogarottoo folded on the Flop
Seat 5: Petrillo717 folded on the Flop
Seat 6: baalder folded before Flop (didn't bet)
Seat 7: PorNoSloniKK folded before Flop (didn't bet)
Seat 8: totyajohnny folded on the Flop
Seat 9: camcf63 collected (835)



PokerStars Hand #221589598173: Tournament #3079328305, $0.91+$0.09 USD Hold'em No Limit - Level I (10/20) - 2020/12/19 1:13:55 EET [2020/12/18 18:13:55 ET]
Table '3079328305 5' 9-max Seat #2 is the button
Seat 1: Asti.wp (1497 in chips) 
Seat 2: jcarlos.vale (1487 in chips) 
Seat 3: dady09 (1477 in chips) 
Seat 4: Nogarottoo (1407 in chips) 
Seat 5: Petrillo717 (1407 in chips) 
Seat 6: baalder (1497 in chips) 
Seat 7: PorNoSloniKK (1497 in chips) 
Seat 8: totyajohnny (1198 in chips) 
Seat 9: camcf63 (2033 in chips) 
Asti.wp: posts the ante 3
jcarlos.vale: posts the ante 3
dady09: posts the ante 3
Nogarottoo: posts the ante 3
Petrillo717: posts the ante 3
baalder: posts the ante 3
PorNoSloniKK: posts the ante 3
totyajohnny: posts the ante 3
camcf63: posts the ante 3
dady09: posts small blind 10
Nogarottoo: posts big blind 20
*** HOLE CARDS ***
Dealt to jcarlos.vale [7s 7d]
Petrillo717: raises 20 to 40
baalder: folds 
PorNoSloniKK: folds 
totyajohnny: raises 137 to 177
camcf63: folds 
Asti.wp: folds 
jcarlos.vale: folds 
dady09: calls 167
Nogarottoo: folds 
Petrillo717: calls 137
*** FLOP *** [Td Qh 6d]
dady09: checks 
Petrillo717: checks 
totyajohnny: bets 578
dady09: folds 
Petrillo717: folds 
Uncalled bet (578) returned to totyajohnny
totyajohnny collected 578 from pot
totyajohnny: doesn't show handDTO
*** SUMMARY ***
Total pot 578 | Rake 0 
Board [Td Qh 6d]
Seat 1: Asti.wp folded before Flop (didn't bet)
Seat 2: jcarlos.vale (button) folded before Flop (didn't bet)
Seat 3: dady09 (small blind) folded on the Flop
Seat 4: Nogarottoo (big blind) folded before Flop
Seat 5: Petrillo717 folded on the Flop
Seat 6: baalder folded before Flop (didn't bet)
Seat 7: PorNoSloniKK folded before Flop (didn't bet)
Seat 8: totyajohnny collected (578)
Seat 9: camcf63 folded before Flop (didn't bet)



PokerStars Hand #221589646474: Tournament #3079328305, $0.91+$0.09 USD Hold'em No Limit - Level I (10/20) - 2020/12/19 1:15:11 EET [2020/12/18 18:15:11 ET]
Table '3079328305 5' 9-max Seat #3 is the button
Seat 1: Asti.wp (1494 in chips) 
Seat 2: jcarlos.vale (1484 in chips) 
Seat 3: dady09 (1297 in chips) 
Seat 4: Nogarottoo (1384 in chips) 
Seat 5: Petrillo717 (1227 in chips) 
Seat 6: baalder (1494 in chips) 
Seat 7: PorNoSloniKK (1494 in chips) 
Seat 8: totyajohnny (1596 in chips) 
Seat 9: camcf63 (2030 in chips) 
Asti.wp: posts the ante 3
jcarlos.vale: posts the ante 3
dady09: posts the ante 3
Nogarottoo: posts the ante 3
Petrillo717: posts the ante 3
baalder: posts the ante 3
PorNoSloniKK: posts the ante 3
totyajohnny: posts the ante 3
camcf63: posts the ante 3
Nogarottoo: posts small blind 10
Petrillo717: posts big blind 20
*** HOLE CARDS ***
Dealt to jcarlos.vale [8h Qd]
baalder: folds 
PorNoSloniKK: folds 
totyajohnny: calls 20
camcf63: folds 
Asti.wp: raises 50 to 70
jcarlos.vale: folds 
dady09: calls 70
Nogarottoo: folds 
Petrillo717: calls 50
totyajohnny: calls 50
*** FLOP *** [4h 2h As]
Petrillo717: checks 
totyajohnny: bets 20
Asti.wp: folds 
dady09: raises 179 to 199
Petrillo717: folds 
totyajohnny: calls 179
*** TURN *** [4h 2h As] [9d]
totyajohnny: checks 
dady09: bets 358
totyajohnny: raises 966 to 1324 and is all-in
dady09: calls 667 and is all-in
Uncalled bet (299) returned to totyajohnny
*** RIVER *** [4h 2h As 9d] [Js]
*** SHOW DOWN ***
totyajohnny: shows [3d 6d] (high pairOfCards Ace)
dady09: shows [4d 4c] (three of a kind, Fours)
dady09 collected 2765 from pot
*** SUMMARY ***
Total pot 2765 | Rake 0 
Board [4h 2h As 9d Js]
Seat 1: Asti.wp folded on the Flop
Seat 2: jcarlos.vale folded before Flop (didn't bet)
Seat 3: dady09 (button) showed [4d 4c] and won (2765) with three of a kind, Fours
Seat 4: Nogarottoo (small blind) folded before Flop
Seat 5: Petrillo717 (big blind) folded on the Flop
Seat 6: baalder folded before Flop (didn't bet)
Seat 7: PorNoSloniKK folded before Flop (didn't bet)
Seat 8: totyajohnny showed [3d 6d] and lost with high pairOfCards Ace
Seat 9: camcf63 folded before Flop (didn't bet)



PokerStars Hand #221589718348: Tournament #3079328305, $0.91+$0.09 USD Hold'em No Limit - Level I (10/20) - 2020/12/19 1:17:06 EET [2020/12/18 18:17:06 ET]
Table '3079328305 5' 9-max Seat #4 is the button
Seat 1: Asti.wp (1421 in chips) 
Seat 2: jcarlos.vale (1481 in chips) 
Seat 3: dady09 (2765 in chips) 
Seat 4: Nogarottoo (1371 in chips) 
Seat 5: Petrillo717 (1154 in chips) 
Seat 6: baalder (1491 in chips) 
Seat 7: PorNoSloniKK (1491 in chips) 
Seat 8: totyajohnny (299 in chips) 
Seat 9: camcf63 (2027 in chips) 
Asti.wp: posts the ante 3
jcarlos.vale: posts the ante 3
dady09: posts the ante 3
Nogarottoo: posts the ante 3
Petrillo717: posts the ante 3
baalder: posts the ante 3
PorNoSloniKK: posts the ante 3
totyajohnny: posts the ante 3
camcf63: posts the ante 3
Petrillo717: posts small blind 10
baalder: posts big blind 20
*** HOLE CARDS ***
Dealt to jcarlos.vale [6c 9c]
PorNoSloniKK: folds 
totyajohnny: raises 276 to 296 and is all-in
camcf63: folds 
Asti.wp: folds 
jcarlos.vale: folds 
dady09: folds 
Nogarottoo: folds 
Petrillo717: folds 
baalder: folds 
Uncalled bet (276) returned to totyajohnny
totyajohnny collected 77 from pot
totyajohnny: doesn't show handDTO
*** SUMMARY ***
Total pot 77 | Rake 0 
Seat 1: Asti.wp folded before Flop (didn't bet)
Seat 2: jcarlos.vale folded before Flop (didn't bet)
Seat 3: dady09 folded before Flop (didn't bet)
Seat 4: Nogarottoo (button) folded before Flop (didn't bet)
Seat 5: Petrillo717 (small blind) folded before Flop
Seat 6: baalder (big blind) folded before Flop
Seat 7: PorNoSloniKK folded before Flop (didn't bet)
Seat 8: totyajohnny collected (77)
Seat 9: camcf63 folded before Flop (didn't bet)



PokerStars Hand #221589738823: Tournament #3079328305, $0.91+$0.09 USD Hold'em No Limit - Level I (10/20) - 2020/12/19 1:17:38 EET [2020/12/18 18:17:38 ET]
Table '3079328305 5' 9-max Seat #5 is the button
Seat 1: Asti.wp (1418 in chips) 
Seat 2: jcarlos.vale (1478 in chips) 
Seat 3: dady09 (2762 in chips) 
Seat 4: Nogarottoo (1368 in chips) 
Seat 5: Petrillo717 (1141 in chips) 
Seat 6: baalder (1468 in chips) 
Seat 7: PorNoSloniKK (1488 in chips) 
Seat 8: totyajohnny (353 in chips) 
Seat 9: camcf63 (2024 in chips) 
Asti.wp: posts the ante 3
jcarlos.vale: posts the ante 3
dady09: posts the ante 3
Nogarottoo: posts the ante 3
Petrillo717: posts the ante 3
baalder: posts the ante 3
PorNoSloniKK: posts the ante 3
totyajohnny: posts the ante 3
camcf63: posts the ante 3
baalder: posts small blind 10
PorNoSloniKK: posts big blind 20
*** HOLE CARDS ***
Dealt to jcarlos.vale [As 7c]
totyajohnny: calls 20
camcf63: folds 
Asti.wp: folds 
jcarlos.vale: folds 
dady09: folds 
Nogarottoo: folds 
Petrillo717: folds 
baalder: folds 
PorNoSloniKK: checks 
*** FLOP *** [6d Ad 3c]
PorNoSloniKK: checks 
totyajohnny: bets 330 and is all-in
PorNoSloniKK: folds 
Uncalled bet (330) returned to totyajohnny
totyajohnny collected 77 from pot
totyajohnny: doesn't show handDTO
*** SUMMARY ***
Total pot 77 | Rake 0 
Board [6d Ad 3c]
Seat 1: Asti.wp folded before Flop (didn't bet)
Seat 2: jcarlos.vale folded before Flop (didn't bet)
Seat 3: dady09 folded before Flop (didn't bet)
Seat 4: Nogarottoo folded before Flop (didn't bet)
Seat 5: Petrillo717 (button) folded before Flop (didn't bet)
Seat 6: baalder (small blind) folded before Flop
Seat 7: PorNoSloniKK (big blind) folded on the Flop
Seat 8: totyajohnny collected (77)
Seat 9: camcf63 folded before Flop (didn't bet)



PokerStars Hand #221589769178: Tournament #3079328305, $0.91+$0.09 USD Hold'em No Limit - Level I (10/20) - 2020/12/19 1:18:27 EET [2020/12/18 18:18:27 ET]
Table '3079328305 5' 9-max Seat #6 is the button
Seat 1: Asti.wp (1415 in chips) 
Seat 2: jcarlos.vale (1475 in chips) 
Seat 3: dady09 (2759 in chips) 
Seat 4: Nogarottoo (1365 in chips) 
Seat 5: Petrillo717 (1138 in chips) 
Seat 6: baalder (1455 in chips) 
Seat 7: PorNoSloniKK (1465 in chips) 
Seat 8: totyajohnny (407 in chips) 
Seat 9: camcf63 (2021 in chips) 
Asti.wp: posts the ante 3
jcarlos.vale: posts the ante 3
dady09: posts the ante 3
Nogarottoo: posts the ante 3
Petrillo717: posts the ante 3
baalder: posts the ante 3
PorNoSloniKK: posts the ante 3
totyajohnny: posts the ante 3
camcf63: posts the ante 3
PorNoSloniKK: posts small blind 10
totyajohnny: posts big blind 20
*** HOLE CARDS ***
Dealt to jcarlos.vale [7s Jh]
camcf63: calls 20
Asti.wp: folds 
jcarlos.vale: folds 
dady09: folds 
Nogarottoo: folds 
Petrillo717: folds 
baalder: folds 
PorNoSloniKK: folds 
totyajohnny: checks 
*** FLOP *** [4d 2s Ac]
totyajohnny: bets 20
camcf63: calls 20
*** TURN *** [4d 2s Ac] [Kh]
totyajohnny: bets 20
camcf63: raises 71 to 91
totyajohnny: folds 
Uncalled bet (71) returned to camcf63
camcf63 collected 157 from pot
*** SUMMARY ***
Total pot 157 | Rake 0 
Board [4d 2s Ac Kh]
Seat 1: Asti.wp folded before Flop (didn't bet)
Seat 2: jcarlos.vale folded before Flop (didn't bet)
Seat 3: dady09 folded before Flop (didn't bet)
Seat 4: Nogarottoo folded before Flop (didn't bet)
Seat 5: Petrillo717 folded before Flop (didn't bet)
Seat 6: baalder (button) folded before Flop (didn't bet)
Seat 7: PorNoSloniKK (small blind) folded before Flop
Seat 8: totyajohnny (big blind) folded on the Turn
Seat 9: camcf63 collected (157)



PokerStars Hand #221589805658: Tournament #3079328305, $0.91+$0.09 USD Hold'em No Limit - Level I (10/20) - 2020/12/19 1:19:26 EET [2020/12/18 18:19:26 ET]
Table '3079328305 5' 9-max Seat #7 is the button
Seat 1: Asti.wp (1412 in chips) 
Seat 2: jcarlos.vale (1472 in chips) 
Seat 3: dady09 (2756 in chips) 
Seat 4: Nogarottoo (1362 in chips) 
Seat 5: Petrillo717 (1135 in chips) 
Seat 6: baalder (1452 in chips) 
Seat 7: PorNoSloniKK (1452 in chips) 
Seat 8: totyajohnny (344 in chips) 
Seat 9: camcf63 (2115 in chips) 
Asti.wp: posts the ante 3
jcarlos.vale: posts the ante 3
dady09: posts the ante 3
Nogarottoo: posts the ante 3
Petrillo717: posts the ante 3
baalder: posts the ante 3
PorNoSloniKK: posts the ante 3
totyajohnny: posts the ante 3
camcf63: posts the ante 3
totyajohnny: posts small blind 10
camcf63: posts big blind 20
*** HOLE CARDS ***
Dealt to jcarlos.vale [8h 9h]
Asti.wp: folds 
jcarlos.vale: folds 
dady09: folds 
Nogarottoo: raises 20 to 40
Petrillo717: folds 
baalder: calls 40
PorNoSloniKK: folds 
totyajohnny: folds 
camcf63: calls 20
*** FLOP *** [7c 3h 4c]
camcf63: bets 47
Nogarottoo: calls 47
baalder: calls 47
*** TURN *** [7c 3h 4c] [9s]
camcf63: bets 89
Nogarottoo: calls 89
baalder: calls 89
*** RIVER *** [7c 3h 4c 9s] [5c]
camcf63: checks 
Nogarottoo: checks 
baalder: bets 565
camcf63: raises 1371 to 1936 and is all-in
Nogarottoo: folds 
baalder: folds 
Uncalled bet (1371) returned to camcf63
camcf63 collected 1695 from pot
*** SUMMARY ***
Total pot 1695 | Rake 0 
Board [7c 3h 4c 9s 5c]
Seat 1: Asti.wp folded before Flop (didn't bet)
Seat 2: jcarlos.vale folded before Flop (didn't bet)
Seat 3: dady09 folded before Flop (didn't bet)
Seat 4: Nogarottoo folded on the River
Seat 5: Petrillo717 folded before Flop (didn't bet)
Seat 6: baalder folded on the River
Seat 7: PorNoSloniKK (button) folded before Flop (didn't bet)
Seat 8: totyajohnny (small blind) folded before Flop
Seat 9: camcf63 (big blind) collected (1695)



PokerStars Hand #221589877814: Tournament #3079328305, $0.91+$0.09 USD Hold'em No Limit - Level I (10/20) - 2020/12/19 1:21:22 EET [2020/12/18 18:21:22 ET]
Table '3079328305 5' 9-max Seat #8 is the button
Seat 1: Asti.wp (1409 in chips) 
Seat 2: jcarlos.vale (1469 in chips) 
Seat 3: dady09 (2753 in chips) 
Seat 4: Nogarottoo (1183 in chips) 
Seat 5: Petrillo717 (1132 in chips) 
Seat 6: baalder (708 in chips) 
Seat 7: PorNoSloniKK (1449 in chips) 
Seat 8: totyajohnny (331 in chips) 
Seat 9: camcf63 (3066 in chips) 
Asti.wp: posts the ante 3
jcarlos.vale: posts the ante 3
dady09: posts the ante 3
Nogarottoo: posts the ante 3
Petrillo717: posts the ante 3
baalder: posts the ante 3
PorNoSloniKK: posts the ante 3
totyajohnny: posts the ante 3
camcf63: posts the ante 3
camcf63: posts small blind 10
Asti.wp: posts big blind 20
*** HOLE CARDS ***
Dealt to jcarlos.vale [2c Qd]
jcarlos.vale: folds 
dady09: folds 
Nogarottoo: folds 
Petrillo717: raises 20 to 40
baalder: calls 40
PorNoSloniKK: folds 
totyajohnny: raises 288 to 328 and is all-in
camcf63: folds 
Asti.wp: folds 
Petrillo717: folds 
baalder: calls 288
*** FLOP *** [5d Qs 6s]
*** TURN *** [5d Qs 6s] [Ac]
*** RIVER *** [5d Qs 6s Ac] [9h]
*** SHOW DOWN ***
baalder: shows [3h 3d] (a pair of Threes)
totyajohnny: shows [4h 6c] (a pair of Sixes)
totyajohnny collected 753 from pot
*** SUMMARY ***
Total pot 753 | Rake 0 
Board [5d Qs 6s Ac 9h]
Seat 1: Asti.wp (big blind) folded before Flop
Seat 2: jcarlos.vale folded before Flop (didn't bet)
Seat 3: dady09 folded before Flop (didn't bet)
Seat 4: Nogarottoo folded before Flop (didn't bet)
Seat 5: Petrillo717 folded before Flop
Seat 6: baalder showed [3h 3d] and lost with a pair of Threes
Seat 7: PorNoSloniKK folded before Flop (didn't bet)
Seat 8: totyajohnny (button) showed [4h 6c] and won (753) with a pair of Sixes
Seat 9: camcf63 (small blind) folded before Flop



PokerStars Hand #221589914778: Tournament #3079328305, $0.91+$0.09 USD Hold'em No Limit - Level I (10/20) - 2020/12/19 1:22:22 EET [2020/12/18 18:22:22 ET]
Table '3079328305 5' 9-max Seat #9 is the button
Seat 1: Asti.wp (1386 in chips) 
Seat 2: jcarlos.vale (1466 in chips) 
Seat 3: dady09 (2750 in chips) 
Seat 4: Nogarottoo (1180 in chips) 
Seat 5: Petrillo717 (1089 in chips) 
Seat 6: baalder (377 in chips) 
Seat 7: PorNoSloniKK (1446 in chips) 
Seat 8: totyajohnny (753 in chips) 
Seat 9: camcf63 (3053 in chips) 
Asti.wp: posts the ante 3
jcarlos.vale: posts the ante 3
dady09: posts the ante 3
Nogarottoo: posts the ante 3
Petrillo717: posts the ante 3
baalder: posts the ante 3
PorNoSloniKK: posts the ante 3
totyajohnny: posts the ante 3
camcf63: posts the ante 3
Asti.wp: posts small blind 10
jcarlos.vale: posts big blind 20
*** HOLE CARDS ***
Dealt to jcarlos.vale [4d Ad]
dady09: folds 
Nogarottoo: folds 
Petrillo717: raises 20 to 40
baalder: folds 
PorNoSloniKK: folds 
totyajohnny: folds 
camcf63: folds 
Asti.wp: folds 
jcarlos.vale: folds 
Uncalled bet (20) returned to Petrillo717
Petrillo717 collected 77 from pot
Petrillo717: doesn't show handDTO
*** SUMMARY ***
Total pot 77 | Rake 0 
Seat 1: Asti.wp (small blind) folded before Flop
Seat 2: jcarlos.vale (big blind) folded before Flop
Seat 3: dady09 folded before Flop (didn't bet)
Seat 4: Nogarottoo folded before Flop (didn't bet)
Seat 5: Petrillo717 collected (77)
Seat 6: baalder folded before Flop (didn't bet)
Seat 7: PorNoSloniKK folded before Flop (didn't bet)
Seat 8: totyajohnny folded before Flop (didn't bet)
Seat 9: camcf63 (button) folded before Flop (didn't bet)



PokerStars Hand #221589930745: Tournament #3079328305, $0.91+$0.09 USD Hold'em No Limit - Level II (15/30) - 2020/12/19 1:22:48 EET [2020/12/18 18:22:48 ET]
Table '3079328305 5' 9-max Seat #1 is the button
Seat 1: Asti.wp (1373 in chips) 
Seat 2: jcarlos.vale (1443 in chips) 
Seat 3: dady09 (2747 in chips) 
Seat 4: Nogarottoo (1177 in chips) 
Seat 5: Petrillo717 (1143 in chips) 
Seat 6: baalder (374 in chips) 
Seat 7: PorNoSloniKK (1443 in chips) 
Seat 8: totyajohnny (750 in chips) 
Seat 9: camcf63 (3050 in chips) 
Asti.wp: posts the ante 4
jcarlos.vale: posts the ante 4
dady09: posts the ante 4
Nogarottoo: posts the ante 4
Petrillo717: posts the ante 4
baalder: posts the ante 4
PorNoSloniKK: posts the ante 4
totyajohnny: posts the ante 4
camcf63: posts the ante 4
jcarlos.vale: posts small blind 15
dady09: posts big blind 30
*** HOLE CARDS ***
Dealt to jcarlos.vale [Td Ks]
Nogarottoo: folds 
Petrillo717: raises 30 to 60
baalder: raises 30 to 90
PorNoSloniKK: folds 
totyajohnny: raises 30 to 120
camcf63: folds 
Asti.wp: folds 
jcarlos.vale: folds 
dady09: folds 
Petrillo717: calls 60
baalder: raises 250 to 370 and is all-in
totyajohnny: raises 376 to 746 and is all-in
Petrillo717: folds 
Uncalled bet (376) returned to totyajohnny
*** FLOP *** [Qc Ac Tc]
*** TURN *** [Qc Ac Tc] [9h]
*** RIVER *** [Qc Ac Tc 9h] [Jc]
*** SHOW DOWN ***
baalder: shows [9s 6s] (a pair of Nines)
totyajohnny: shows [8d Jd] (a straight, Eight to Queen)
totyajohnny collected 941 from pot
baalder finished the tournament in 42nd place
*** SUMMARY ***
Total pot 941 | Rake 0 
Board [Qc Ac Tc 9h Jc]
Seat 1: Asti.wp (button) folded before Flop (didn't bet)
Seat 2: jcarlos.vale (small blind) folded before Flop
Seat 3: dady09 (big blind) folded before Flop
Seat 4: Nogarottoo folded before Flop (didn't bet)
Seat 5: Petrillo717 folded before Flop
Seat 6: baalder showed [9s 6s] and lost with a pair of Nines
Seat 7: PorNoSloniKK folded before Flop (didn't bet)
Seat 8: totyajohnny showed [8d Jd] and won (941) with a straight, Eight to Queen
Seat 9: camcf63 folded before Flop (didn't bet)



PokerStars Hand #221589967413: Tournament #3079328305, $0.91+$0.09 USD Hold'em No Limit - Level II (15/30) - 2020/12/19 1:23:48 EET [2020/12/18 18:23:48 ET]
Table '3079328305 5' 9-max Seat #2 is the button
Seat 1: Asti.wp (1369 in chips) 
Seat 2: jcarlos.vale (1424 in chips) 
Seat 3: dady09 (2713 in chips) 
Seat 4: Nogarottoo (1173 in chips) 
Seat 5: Petrillo717 (1019 in chips) 
Seat 7: PorNoSloniKK (1439 in chips) 
Seat 8: totyajohnny (1317 in chips) 
Seat 9: camcf63 (3046 in chips) 
Asti.wp: posts the ante 4
jcarlos.vale: posts the ante 4
dady09: posts the ante 4
Nogarottoo: posts the ante 4
Petrillo717: posts the ante 4
PorNoSloniKK: posts the ante 4
totyajohnny: posts the ante 4
camcf63: posts the ante 4
dady09: posts small blind 15
Nogarottoo: posts big blind 30
*** HOLE CARDS ***
Dealt to jcarlos.vale [Kh 6c]
Petrillo717: raises 30 to 60
PorNoSloniKK: folds 
totyajohnny: calls 60
camcf63: calls 60
Asti.wp: folds 
jcarlos.vale: folds 
dady09: calls 45
Nogarottoo: calls 30
*** FLOP *** [8d Qh As]
dady09: checks 
Nogarottoo: checks 
Petrillo717: checks 
totyajohnny: bets 332
camcf63: folds 
dady09: folds 
Nogarottoo: folds 
Petrillo717: folds 
Uncalled bet (332) returned to totyajohnny
totyajohnny collected 332 from pot
totyajohnny: doesn't show handDTO
*** SUMMARY ***
Total pot 332 | Rake 0 
Board [8d Qh As]
Seat 1: Asti.wp folded before Flop (didn't bet)
Seat 2: jcarlos.vale (button) folded before Flop (didn't bet)
Seat 3: dady09 (small blind) folded on the Flop
Seat 4: Nogarottoo (big blind) folded on the Flop
Seat 5: Petrillo717 folded on the Flop
Seat 7: PorNoSloniKK folded before Flop (didn't bet)
Seat 8: totyajohnny collected (332)
Seat 9: camcf63 folded on the Flop



PokerStars Hand #221590010912: Tournament #3079328305, $0.91+$0.09 USD Hold'em No Limit - Level II (15/30) - 2020/12/19 1:24:59 EET [2020/12/18 18:24:59 ET]
Table '3079328305 5' 9-max Seat #3 is the button
Seat 1: Asti.wp (1365 in chips) 
Seat 2: jcarlos.vale (1420 in chips) 
Seat 3: dady09 (2649 in chips) 
Seat 4: Nogarottoo (1109 in chips) 
Seat 5: Petrillo717 (955 in chips) 
Seat 7: PorNoSloniKK (1435 in chips) 
Seat 8: totyajohnny (1585 in chips) 
Seat 9: camcf63 (2982 in chips) 
Asti.wp: posts the ante 4
jcarlos.vale: posts the ante 4
dady09: posts the ante 4
Nogarottoo: posts the ante 4
Petrillo717: posts the ante 4
PorNoSloniKK: posts the ante 4
totyajohnny: posts the ante 4
camcf63: posts the ante 4
Nogarottoo: posts small blind 15
Petrillo717: posts big blind 30
*** HOLE CARDS ***
Dealt to jcarlos.vale [Ts Tc]
PorNoSloniKK: folds 
totyajohnny: folds 
camcf63: raises 30 to 60
Asti.wp: folds 
jcarlos.vale: raises 56 to 116
dady09: folds 
Nogarottoo: folds 
Petrillo717: calls 86
camcf63: calls 56
*** FLOP *** [3d 8d 3s]
Petrillo717: checks 
camcf63: bets 178
jcarlos.vale: calls 178
Petrillo717: calls 178
*** TURN *** [3d 8d 3s] [7h]
Petrillo717: checks 
camcf63: bets 2684 and is all-in
jcarlos.vale: calls 1122 and is all-in
Petrillo717: folds 
Uncalled bet (1562) returned to camcf63
*** RIVER *** [3d 8d 3s 7h] [9d]
*** SHOW DOWN ***
camcf63: shows [8s 9h] (two pair, Nines and Eights)
jcarlos.vale: shows [Ts Tc] (two pair, Tens and Threes)
jcarlos.vale collected 3173 from pot
*** SUMMARY ***
Total pot 3173 | Rake 0 
Board [3d 8d 3s 7h 9d]
Seat 1: Asti.wp folded before Flop (didn't bet)
Seat 2: jcarlos.vale showed [Ts Tc] and won (3173) with two pair, Tens and Threes
Seat 3: dady09 (button) folded before Flop (didn't bet)
Seat 4: Nogarottoo (small blind) folded before Flop
Seat 5: Petrillo717 (big blind) folded on the Turn
Seat 7: PorNoSloniKK folded before Flop (didn't bet)
Seat 8: totyajohnny folded before Flop (didn't bet)
Seat 9: camcf63 showed [8s 9h] and lost with two pair, Nines and Eights



PokerStars Hand #221590076916: Tournament #3079328305, $0.91+$0.09 USD Hold'em No Limit - Level II (15/30) - 2020/12/19 1:26:35 EET [2020/12/18 18:26:35 ET]
Table '3079328305 5' 9-max Seat #4 is the button
Seat 1: Asti.wp (1361 in chips) 
Seat 2: jcarlos.vale (3173 in chips) 
Seat 3: dady09 (2645 in chips) 
Seat 4: Nogarottoo (1090 in chips) 
Seat 5: Petrillo717 (657 in chips) 
Seat 7: PorNoSloniKK (1431 in chips) 
Seat 8: totyajohnny (1581 in chips) 
Seat 9: camcf63 (1562 in chips) 
Asti.wp: posts the ante 4
jcarlos.vale: posts the ante 4
dady09: posts the ante 4
Nogarottoo: posts the ante 4
Petrillo717: posts the ante 4
PorNoSloniKK: posts the ante 4
totyajohnny: posts the ante 4
camcf63: posts the ante 4
Petrillo717: posts small blind 15
PorNoSloniKK: posts big blind 30
*** HOLE CARDS ***
Dealt to jcarlos.vale [7c 9s]
totyajohnny: folds 
camcf63: folds 
Asti.wp: folds 
jcarlos.vale: folds 
dady09: folds 
Nogarottoo: raises 60 to 90
Petrillo717: raises 563 to 653 and is all-in
PorNoSloniKK: raises 774 to 1427 and is all-in
Nogarottoo: calls 996 and is all-in
Uncalled bet (341) returned to PorNoSloniKK
*** FLOP *** [Ts 6s 3s]
*** TURN *** [Ts 6s 3s] [6d]
*** RIVER *** [Ts 6s 3s 6d] [9h]
*** SHOW DOWN ***
PorNoSloniKK: shows [As Jd] (a pair of Sixes)
Nogarottoo: shows [Ks Ac] (a pair of Sixes - Ace+King kicker)
Nogarottoo collected 866 from side pot
Petrillo717: shows [Ah Js] (a pair of Sixes - lower kicker)
Nogarottoo collected 1991 from main pot
Petrillo717 finished the tournament in 40th place
*** SUMMARY ***
Total pot 2857 Main pot 1991. Side pot 866. | Rake 0 
Board [Ts 6s 3s 6d 9h]
Seat 1: Asti.wp folded before Flop (didn't bet)
Seat 2: jcarlos.vale folded before Flop (didn't bet)
Seat 3: dady09 folded before Flop (didn't bet)
Seat 4: Nogarottoo (button) showed [Ks Ac] and won (2857) with a pair of Sixes
Seat 5: Petrillo717 (small blind) showed [Ah Js] and lost with a pair of Sixes
Seat 7: PorNoSloniKK (big blind) showed [As Jd] and lost with a pair of Sixes
Seat 8: totyajohnny folded before Flop (didn't bet)
Seat 9: camcf63 folded before Flop (didn't bet)



PokerStars Hand #221590127716: Tournament #3079328305, $0.91+$0.09 USD Hold'em No Limit - Level II (15/30) - 2020/12/19 1:27:58 EET [2020/12/18 18:27:58 ET]
Table '3079328305 5' 9-max Seat #7 is the button
Seat 1: Asti.wp (1357 in chips) 
Seat 2: jcarlos.vale (3169 in chips) 
Seat 3: dady09 (2641 in chips) 
Seat 4: Nogarottoo (2857 in chips) 
Seat 7: PorNoSloniKK (341 in chips) 
Seat 8: totyajohnny (1577 in chips) 
Seat 9: camcf63 (1558 in chips) 
Asti.wp: posts the ante 4
jcarlos.vale: posts the ante 4
dady09: posts the ante 4
Nogarottoo: posts the ante 4
PorNoSloniKK: posts the ante 4
totyajohnny: posts the ante 4
camcf63: posts the ante 4
totyajohnny: posts small blind 15
camcf63: posts big blind 30
*** HOLE CARDS ***
Dealt to jcarlos.vale [9d 8s]
Asti.wp: folds 
jcarlos.vale: folds 
dady09: folds 
Nogarottoo: raises 30 to 60
PorNoSloniKK: folds 
totyajohnny: folds 
camcf63: calls 30
*** FLOP *** [5h 4c Ac]
camcf63: checks 
Nogarottoo: bets 82
camcf63: folds 
Uncalled bet (82) returned to Nogarottoo
Nogarottoo collected 163 from pot
Nogarottoo: doesn't show handDTO
*** SUMMARY ***
Total pot 163 | Rake 0 
Board [5h 4c Ac]
Seat 1: Asti.wp folded before Flop (didn't bet)
Seat 2: jcarlos.vale folded before Flop (didn't bet)
Seat 3: dady09 folded before Flop (didn't bet)
Seat 4: Nogarottoo collected (163)
Seat 7: PorNoSloniKK (button) folded before Flop (didn't bet)
Seat 8: totyajohnny (small blind) folded before Flop
Seat 9: camcf63 (big blind) folded on the Flop



PokerStars Hand #221590148222: Tournament #3079328305, $0.91+$0.09 USD Hold'em No Limit - Level II (15/30) - 2020/12/19 1:28:32 EET [2020/12/18 18:28:32 ET]
Table '3079328305 5' 9-max Seat #8 is the button
Seat 1: Asti.wp (1353 in chips) 
Seat 2: jcarlos.vale (3165 in chips) 
Seat 3: dady09 (2637 in chips) 
Seat 4: Nogarottoo (2956 in chips) 
Seat 7: PorNoSloniKK (337 in chips) 
Seat 8: totyajohnny (1558 in chips) 
Seat 9: camcf63 (1494 in chips) 
Asti.wp: posts the ante 4
jcarlos.vale: posts the ante 4
dady09: posts the ante 4
Nogarottoo: posts the ante 4
PorNoSloniKK: posts the ante 4
totyajohnny: posts the ante 4
camcf63: posts the ante 4
camcf63: posts small blind 15
Asti.wp: posts big blind 30
*** HOLE CARDS ***
Dealt to jcarlos.vale [2d Th]
jcarlos.vale: folds 
dady09: folds 
Nogarottoo: folds 
PorNoSloniKK: folds 
totyajohnny: raises 30 to 60
camcf63: folds 
Asti.wp: calls 30
*** FLOP *** [As Qh Ac]
Asti.wp: checks 
totyajohnny: bets 82
Asti.wp: calls 82
*** TURN *** [As Qh Ac] [4c]
Asti.wp: checks 
totyajohnny: checks 
*** RIVER *** [As Qh Ac 4c] [4s]
Asti.wp: bets 92
totyajohnny: raises 511 to 603
Asti.wp: raises 604 to 1207 and is all-in
totyajohnny: folds 
Uncalled bet (604) returned to Asti.wp
Asti.wp collected 1533 from pot
Asti.wp: doesn't show handDTO
*** SUMMARY ***
Total pot 1533 | Rake 0 
Board [As Qh Ac 4c 4s]
Seat 1: Asti.wp (big blind) collected (1533)
Seat 2: jcarlos.vale folded before Flop (didn't bet)
Seat 3: dady09 folded before Flop (didn't bet)
Seat 4: Nogarottoo folded before Flop (didn't bet)
Seat 7: PorNoSloniKK folded before Flop (didn't bet)
Seat 8: totyajohnny (button) folded on the River
Seat 9: camcf63 (small blind) folded before Flop



PokerStars Hand #221590203071: Tournament #3079328305, $0.91+$0.09 USD Hold'em No Limit - Level II (15/30) - 2020/12/19 1:30:04 EET [2020/12/18 18:30:04 ET]
Table '3079328305 5' 9-max Seat #9 is the button
Seat 1: Asti.wp (2137 in chips) 
Seat 2: jcarlos.vale (3161 in chips) 
Seat 3: dady09 (2633 in chips) 
Seat 4: Nogarottoo (2952 in chips) 
Seat 7: PorNoSloniKK (333 in chips) 
Seat 8: totyajohnny (809 in chips) 
Seat 9: camcf63 (1475 in chips) 
Asti.wp: posts the ante 4
jcarlos.vale: posts the ante 4
dady09: posts the ante 4
Nogarottoo: posts the ante 4
PorNoSloniKK: posts the ante 4
totyajohnny: posts the ante 4
camcf63: posts the ante 4
Asti.wp: posts small blind 15
jcarlos.vale: posts big blind 30
*** HOLE CARDS ***
Dealt to jcarlos.vale [2d 7d]
dady09: folds 
Nogarottoo: raises 30 to 60
PorNoSloniKK: folds 
totyajohnny: raises 193 to 253
camcf63: folds 
Asti.wp: folds 
jcarlos.vale: folds 
Nogarottoo: calls 193
*** FLOP *** [3c Jd 3h]
Nogarottoo: checks 
totyajohnny: bets 552 and is all-in
Nogarottoo: folds 
Uncalled bet (552) returned to totyajohnny
totyajohnny collected 579 from pot
totyajohnny: doesn't show handDTO
*** SUMMARY ***
Total pot 579 | Rake 0 
Board [3c Jd 3h]
Seat 1: Asti.wp (small blind) folded before Flop
Seat 2: jcarlos.vale (big blind) folded before Flop
Seat 3: dady09 folded before Flop (didn't bet)
Seat 4: Nogarottoo folded on the Flop
Seat 7: PorNoSloniKK folded before Flop (didn't bet)
Seat 8: totyajohnny collected (579)
Seat 9: camcf63 (button) folded before Flop (didn't bet)



PokerStars Hand #221590258171: Tournament #3079328305, $0.91+$0.09 USD Hold'em No Limit - Level II (15/30) - 2020/12/19 1:31:23 EET [2020/12/18 18:31:23 ET]
Table '3079328305 5' 9-max Seat #1 is the button
Seat 1: Asti.wp (2118 in chips) 
Seat 2: jcarlos.vale (3127 in chips) 
Seat 3: dady09 (2629 in chips) 
Seat 4: Nogarottoo (2695 in chips) 
Seat 7: PorNoSloniKK (329 in chips) 
Seat 8: totyajohnny (1131 in chips) 
Seat 9: camcf63 (1471 in chips) 
Asti.wp: posts the ante 4
jcarlos.vale: posts the ante 4
dady09: posts the ante 4
Nogarottoo: posts the ante 4
PorNoSloniKK: posts the ante 4
totyajohnny: posts the ante 4
camcf63: posts the ante 4
jcarlos.vale: posts small blind 15
dady09: posts big blind 30
*** HOLE CARDS ***
Dealt to jcarlos.vale [Qc 5h]
Nogarottoo: folds 
PorNoSloniKK: folds 
totyajohnny: folds 
camcf63: raises 30 to 60
Asti.wp: raises 135 to 195
jcarlos.vale: folds 
dady09: folds 
camcf63: folds 
Uncalled bet (135) returned to Asti.wp
Asti.wp collected 193 from pot
Asti.wp: doesn't show handDTO
*** SUMMARY ***
Total pot 193 | Rake 0 
Seat 1: Asti.wp (button) collected (193)
Seat 2: jcarlos.vale (small blind) folded before Flop
Seat 3: dady09 (big blind) folded before Flop
Seat 4: Nogarottoo folded before Flop (didn't bet)
Seat 7: PorNoSloniKK folded before Flop (didn't bet)
Seat 8: totyajohnny folded before Flop (didn't bet)
Seat 9: camcf63 folded before Flop



PokerStars Hand #221590282277: Tournament #3079328305, $0.91+$0.09 USD Hold'em No Limit - Level II (15/30) - 2020/12/19 1:32:03 EET [2020/12/18 18:32:03 ET]
Table '3079328305 5' 9-max Seat #2 is the button
Seat 1: Asti.wp (2247 in chips) 
Seat 2: jcarlos.vale (3108 in chips) 
Seat 3: dady09 (2595 in chips) 
Seat 4: Nogarottoo (2691 in chips) 
Seat 7: PorNoSloniKK (325 in chips) 
Seat 8: totyajohnny (1127 in chips) 
Seat 9: camcf63 (1407 in chips) 
Asti.wp: posts the ante 4
jcarlos.vale: posts the ante 4
dady09: posts the ante 4
Nogarottoo: posts the ante 4
PorNoSloniKK: posts the ante 4
totyajohnny: posts the ante 4
camcf63: posts the ante 4
dady09: posts small blind 15
Nogarottoo: posts big blind 30
*** HOLE CARDS ***
Dealt to jcarlos.vale [Ad 7h]
PorNoSloniKK: folds 
totyajohnny: calls 30
camcf63: folds 
Asti.wp: folds 
jcarlos.vale: raises 60 to 90
dady09: calls 75
Nogarottoo: calls 60
totyajohnny: calls 60
*** FLOP *** [Th 8s 6h]
dady09: bets 194
Nogarottoo: folds 
totyajohnny: raises 388 to 582
jcarlos.vale: folds 
dady09: folds 
Uncalled bet (388) returned to totyajohnny
totyajohnny collected 776 from pot
totyajohnny: doesn't show handDTO
*** SUMMARY ***
Total pot 776 | Rake 0 
Board [Th 8s 6h]
Seat 1: Asti.wp folded before Flop (didn't bet)
Seat 2: jcarlos.vale (button) folded on the Flop
Seat 3: dady09 (small blind) folded on the Flop
Seat 4: Nogarottoo (big blind) folded on the Flop
Seat 7: PorNoSloniKK folded before Flop (didn't bet)
Seat 8: totyajohnny collected (776)
Seat 9: camcf63 folded before Flop (didn't bet)



PokerStars Hand #221590314288: Tournament #3079328305, $0.91+$0.09 USD Hold'em No Limit - Level III (25/50) - 2020/12/19 1:32:56 EET [2020/12/18 18:32:56 ET]
Table '3079328305 5' 9-max Seat #3 is the button
Seat 1: Asti.wp (2243 in chips) 
Seat 2: jcarlos.vale (3014 in chips) 
Seat 3: dady09 (2307 in chips) 
Seat 4: Nogarottoo (2597 in chips) 
Seat 7: PorNoSloniKK (321 in chips) 
Seat 8: totyajohnny (1615 in chips) 
Seat 9: camcf63 (1403 in chips) 
Asti.wp: posts the ante 6
jcarlos.vale: posts the ante 6
dady09: posts the ante 6
Nogarottoo: posts the ante 6
PorNoSloniKK: posts the ante 6
totyajohnny: posts the ante 6
camcf63: posts the ante 6
Nogarottoo: posts small blind 25
PorNoSloniKK: posts big blind 50
*** HOLE CARDS ***
Dealt to jcarlos.vale [2s 2d]
totyajohnny: folds 
camcf63: folds 
Asti.wp: folds 
jcarlos.vale: raises 80 to 130
dady09: folds 
Nogarottoo: folds 
PorNoSloniKK: folds 
Uncalled bet (80) returned to jcarlos.vale
jcarlos.vale collected 167 from pot
jcarlos.vale: doesn't show handDTO
*** SUMMARY ***
Total pot 167 | Rake 0 
Seat 1: Asti.wp folded before Flop (didn't bet)
Seat 2: jcarlos.vale collected (167)
Seat 3: dady09 (button) folded before Flop (didn't bet)
Seat 4: Nogarottoo (small blind) folded before Flop
Seat 7: PorNoSloniKK (big blind) folded before Flop
Seat 8: totyajohnny folded before Flop (didn't bet)
Seat 9: camcf63 folded before Flop (didn't bet)



PokerStars Hand #221590332817: Tournament #3079328305, $0.91+$0.09 USD Hold'em No Limit - Level III (25/50) - 2020/12/19 1:33:26 EET [2020/12/18 18:33:26 ET]
Table '3079328305 5' 9-max Seat #4 is the button
Seat 1: Asti.wp (2237 in chips) 
Seat 2: jcarlos.vale (3125 in chips) 
Seat 3: dady09 (2301 in chips) 
Seat 4: Nogarottoo (2566 in chips) 
Seat 7: PorNoSloniKK (265 in chips) 
Seat 8: totyajohnny (1609 in chips) 
Seat 9: camcf63 (1397 in chips) 
Asti.wp: posts the ante 6
jcarlos.vale: posts the ante 6
dady09: posts the ante 6
Nogarottoo: posts the ante 6
PorNoSloniKK: posts the ante 6
totyajohnny: posts the ante 6
camcf63: posts the ante 6
PorNoSloniKK: posts small blind 25
totyajohnny: posts big blind 50
*** HOLE CARDS ***
Dealt to jcarlos.vale [3c 6h]
camcf63: folds 
Asti.wp: folds 
jcarlos.vale: folds 
dady09: folds 
Nogarottoo: raises 100 to 150
PorNoSloniKK: folds 
totyajohnny: raises 100 to 250
Nogarottoo: raises 2310 to 2560 and is all-in
totyajohnny: calls 1353 and is all-in
Uncalled bet (957) returned to Nogarottoo
*** FLOP *** [Tc Kc 8c]
*** TURN *** [Tc Kc 8c] [Kd]
*** RIVER *** [Tc Kc 8c Kd] [Qd]
*** SHOW DOWN ***
totyajohnny: shows [4c Ac] (a flush, Ace high)
Nogarottoo: shows [Ks Ah] (three of a kind, Kings)
totyajohnny collected 3273 from pot
*** SUMMARY ***
Total pot 3273 | Rake 0 
Board [Tc Kc 8c Kd Qd]
Seat 1: Asti.wp folded before Flop (didn't bet)
Seat 2: jcarlos.vale folded before Flop (didn't bet)
Seat 3: dady09 folded before Flop (didn't bet)
Seat 4: Nogarottoo (button) showed [Ks Ah] and lost with three of a kind, Kings
Seat 7: PorNoSloniKK (small blind) folded before Flop
Seat 8: totyajohnny (big blind) showed [4c Ac] and won (3273) with a flush, Ace high
Seat 9: camcf63 folded before Flop (didn't bet)



PokerStars Hand #221590365283: Tournament #3079328305, $0.91+$0.09 USD Hold'em No Limit - Level III (25/50) - 2020/12/19 1:34:20 EET [2020/12/18 18:34:20 ET]
Table '3079328305 5' 9-max Seat #7 is the button
Seat 1: Asti.wp (2231 in chips) 
Seat 2: jcarlos.vale (3119 in chips) 
Seat 3: dady09 (2295 in chips) 
Seat 4: Nogarottoo (957 in chips) 
Seat 7: PorNoSloniKK (234 in chips) 
Seat 8: totyajohnny (3273 in chips) 
Seat 9: camcf63 (1391 in chips) 
Asti.wp: posts the ante 6
jcarlos.vale: posts the ante 6
dady09: posts the ante 6
Nogarottoo: posts the ante 6
PorNoSloniKK: posts the ante 6
totyajohnny: posts the ante 6
camcf63: posts the ante 6
totyajohnny: posts small blind 25
camcf63: posts big blind 50
*** HOLE CARDS ***
Dealt to jcarlos.vale [Ah Qd]
Asti.wp: folds 
jcarlos.vale: raises 80 to 130
dady09: raises 80 to 210
Nogarottoo: folds 
PorNoSloniKK: folds 
totyajohnny: calls 185
camcf63: raises 1175 to 1385 and is all-in
jcarlos.vale: folds 
dady09: calls 1175
totyajohnny: raises 1882 to 3267 and is all-in
dady09: calls 904 and is all-in
Uncalled bet (978) returned to totyajohnny
*** FLOP *** [9d 9c 7s]
*** TURN *** [9d 9c 7s] [2s]
*** RIVER *** [9d 9c 7s 2s] [Jd]
*** SHOW DOWN ***
totyajohnny: shows [Ks Ad] (a pair of Nines)
dady09: shows [Kh Ac] (a pair of Nines)
totyajohnny collected 904 from side pot
dady09 collected 904 from side pot
camcf63: shows [4c 4h] (two pair, Nines and Fours)
camcf63 collected 4327 from main pot
*** SUMMARY ***
Total pot 6135 Main pot 4327. Side pot 1808. | Rake 0 
Board [9d 9c 7s 2s Jd]
Seat 1: Asti.wp folded before Flop (didn't bet)
Seat 2: jcarlos.vale folded before Flop
Seat 3: dady09 showed [Kh Ac] and won (904) with a pair of Nines
Seat 4: Nogarottoo folded before Flop (didn't bet)
Seat 7: PorNoSloniKK (button) folded before Flop (didn't bet)
Seat 8: totyajohnny (small blind) showed [Ks Ad] and won (904) with a pair of Nines
Seat 9: camcf63 (big blind) showed [4c 4h] and won (4327) with two pair, Nines and Fours



PokerStars Hand #221590406140: Tournament #3079328305, $0.91+$0.09 USD Hold'em No Limit - Level III (25/50) - 2020/12/19 1:35:28 EET [2020/12/18 18:35:28 ET]
Table '3079328305 5' 9-max Seat #8 is the button
Seat 1: Asti.wp (2225 in chips) 
Seat 2: jcarlos.vale (2983 in chips) 
Seat 3: dady09 (904 in chips) 
Seat 4: Nogarottoo (951 in chips) 
Seat 5: Fisering123 (2448 in chips) 
Seat 6: PassaTempo77 (2069 in chips) 
Seat 7: PorNoSloniKK (228 in chips) 
Seat 8: totyajohnny (1882 in chips) 
Seat 9: camcf63 (4327 in chips) 
Asti.wp: posts the ante 6
jcarlos.vale: posts the ante 6
dady09: posts the ante 6
Nogarottoo: posts the ante 6
Fisering123: posts the ante 6
PassaTempo77: posts the ante 6
PorNoSloniKK: posts the ante 6
totyajohnny: posts the ante 6
camcf63: posts the ante 6
camcf63: posts small blind 25
Asti.wp: posts big blind 50
*** HOLE CARDS ***
Dealt to jcarlos.vale [4h Jh]
jcarlos.vale: folds 
dady09: folds 
Nogarottoo: folds 
Fisering123: raises 100 to 150
PassaTempo77: folds 
PorNoSloniKK: folds 
totyajohnny: calls 150
camcf63: folds 
Asti.wp: calls 100
*** FLOP *** [5c Kc Th]
Asti.wp: checks 
Fisering123: bets 265
totyajohnny: raises 265 to 530
Asti.wp: folds 
Fisering123: folds 
Uncalled bet (265) returned to totyajohnny
totyajohnny collected 1059 from pot
totyajohnny: doesn't show handDTO
*** SUMMARY ***
Total pot 1059 | Rake 0 
Board [5c Kc Th]
Seat 1: Asti.wp (big blind) folded on the Flop
Seat 2: jcarlos.vale folded before Flop (didn't bet)
Seat 3: dady09 folded before Flop (didn't bet)
Seat 4: Nogarottoo folded before Flop (didn't bet)
Seat 5: Fisering123 folded on the Flop
Seat 6: PassaTempo77 folded before Flop (didn't bet)
Seat 7: PorNoSloniKK folded before Flop (didn't bet)
Seat 8: totyajohnny (button) collected (1059)
Seat 9: camcf63 (small blind) folded before Flop



PokerStars Hand #221590429446: Tournament #3079328305, $0.91+$0.09 USD Hold'em No Limit - Level III (25/50) - 2020/12/19 1:36:07 EET [2020/12/18 18:36:07 ET]
Table '3079328305 5' 9-max Seat #9 is the button
Seat 1: Asti.wp (2069 in chips) 
Seat 2: jcarlos.vale (2977 in chips) 
Seat 3: dady09 (898 in chips) 
Seat 4: Nogarottoo (945 in chips) 
Seat 5: Fisering123 (2027 in chips) 
Seat 6: PassaTempo77 (2063 in chips) 
Seat 7: PorNoSloniKK (222 in chips) 
Seat 8: totyajohnny (2520 in chips) 
Seat 9: camcf63 (4296 in chips) 
Asti.wp: posts the ante 6
jcarlos.vale: posts the ante 6
dady09: posts the ante 6
Nogarottoo: posts the ante 6
Fisering123: posts the ante 6
PassaTempo77: posts the ante 6
PorNoSloniKK: posts the ante 6
totyajohnny: posts the ante 6
camcf63: posts the ante 6
Asti.wp: posts small blind 25
jcarlos.vale: posts big blind 50
*** HOLE CARDS ***
Dealt to jcarlos.vale [9s Ks]
dady09: raises 100 to 150
Nogarottoo: folds 
Fisering123: folds 
PassaTempo77: folds 
PorNoSloniKK: folds 
totyajohnny: folds 
camcf63: folds 
Asti.wp: folds 
jcarlos.vale: calls 100
*** FLOP *** [2c 8s 8d]
jcarlos.vale: checks 
dady09: bets 190
jcarlos.vale: folds 
Uncalled bet (190) returned to dady09
dady09 collected 379 from pot
dady09: doesn't show handDTO
*** SUMMARY ***
Total pot 379 | Rake 0 
Board [2c 8s 8d]
Seat 1: Asti.wp (small blind) folded before Flop
Seat 2: jcarlos.vale (big blind) folded on the Flop
Seat 3: dady09 collected (379)
Seat 4: Nogarottoo folded before Flop (didn't bet)
Seat 5: Fisering123 folded before Flop (didn't bet)
Seat 6: PassaTempo77 folded before Flop (didn't bet)
Seat 7: PorNoSloniKK folded before Flop (didn't bet)
Seat 8: totyajohnny folded before Flop (didn't bet)
Seat 9: camcf63 (button) folded before Flop (didn't bet)



PokerStars Hand #221590454660: Tournament #3079328305, $0.91+$0.09 USD Hold'em No Limit - Level III (25/50) - 2020/12/19 1:36:49 EET [2020/12/18 18:36:49 ET]
Table '3079328305 5' 9-max Seat #1 is the button
Seat 1: Asti.wp (2038 in chips) 
Seat 2: jcarlos.vale (2821 in chips) 
Seat 3: dady09 (1121 in chips) 
Seat 4: Nogarottoo (939 in chips) 
Seat 5: Fisering123 (2021 in chips) 
Seat 6: PassaTempo77 (2057 in chips) 
Seat 7: PorNoSloniKK (216 in chips) 
Seat 8: totyajohnny (2514 in chips) 
Seat 9: camcf63 (4290 in chips) 
Asti.wp: posts the ante 6
jcarlos.vale: posts the ante 6
dady09: posts the ante 6
Nogarottoo: posts the ante 6
Fisering123: posts the ante 6
PassaTempo77: posts the ante 6
PorNoSloniKK: posts the ante 6
totyajohnny: posts the ante 6
camcf63: posts the ante 6
jcarlos.vale: posts small blind 25
dady09: posts big blind 50
*** HOLE CARDS ***
Dealt to jcarlos.vale [8h As]
Nogarottoo: folds 
Fisering123: folds 
PassaTempo77: folds 
PorNoSloniKK: folds 
totyajohnny: calls 50
camcf63: folds 
Asti.wp: calls 50
jcarlos.vale: calls 25
dady09: raises 100 to 150
totyajohnny: calls 100
Asti.wp: calls 100
jcarlos.vale: folds 
*** FLOP *** [Kc 6s 4s]
dady09: bets 277
totyajohnny: folds 
Asti.wp: folds 
Uncalled bet (277) returned to dady09
dady09 collected 554 from pot
dady09: doesn't show handDTO
*** SUMMARY ***
Total pot 554 | Rake 0 
Board [Kc 6s 4s]
Seat 1: Asti.wp (button) folded on the Flop
Seat 2: jcarlos.vale (small blind) folded before Flop
Seat 3: dady09 (big blind) collected (554)
Seat 4: Nogarottoo folded before Flop (didn't bet)
Seat 5: Fisering123 folded before Flop (didn't bet)
Seat 6: PassaTempo77 folded before Flop (didn't bet)
Seat 7: PorNoSloniKK folded before Flop (didn't bet)
Seat 8: totyajohnny folded on the Flop
Seat 9: camcf63 folded before Flop (didn't bet)



PokerStars Hand #221590495419: Tournament #3079328305, $0.91+$0.09 USD Hold'em No Limit - Level III (25/50) - 2020/12/19 1:37:58 EET [2020/12/18 18:37:58 ET]
Table '3079328305 5' 9-max Seat #2 is the button
Seat 1: Asti.wp (1882 in chips) 
Seat 2: jcarlos.vale (2765 in chips) 
Seat 3: dady09 (1519 in chips) 
Seat 4: Nogarottoo (933 in chips) 
Seat 5: Fisering123 (2015 in chips) 
Seat 6: PassaTempo77 (2051 in chips) 
Seat 7: PorNoSloniKK (210 in chips) 
Seat 8: totyajohnny (2358 in chips) 
Seat 9: camcf63 (4284 in chips) 
Asti.wp: posts the ante 6
jcarlos.vale: posts the ante 6
dady09: posts the ante 6
Nogarottoo: posts the ante 6
Fisering123: posts the ante 6
PassaTempo77: posts the ante 6
PorNoSloniKK: posts the ante 6
totyajohnny: posts the ante 6
camcf63: posts the ante 6
dady09: posts small blind 25
Nogarottoo: posts big blind 50
*** HOLE CARDS ***
Dealt to jcarlos.vale [Qs 3c]
Fisering123: raises 100 to 150
PassaTempo77: folds 
PorNoSloniKK: folds 
totyajohnny: folds 
camcf63: folds 
Asti.wp: folds 
jcarlos.vale: folds 
dady09: folds 
Nogarottoo: calls 100
*** FLOP *** [Kh 4h 4c]
Nogarottoo: checks 
Fisering123: bets 1859 and is all-in
Nogarottoo: folds 
Uncalled bet (1859) returned to Fisering123
Fisering123 collected 379 from pot
Fisering123: doesn't show handDTO
*** SUMMARY ***
Total pot 379 | Rake 0 
Board [Kh 4h 4c]
Seat 1: Asti.wp folded before Flop (didn't bet)
Seat 2: jcarlos.vale (button) folded before Flop (didn't bet)
Seat 3: dady09 (small blind) folded before Flop
Seat 4: Nogarottoo (big blind) folded on the Flop
Seat 5: Fisering123 collected (379)
Seat 6: PassaTempo77 folded before Flop (didn't bet)
Seat 7: PorNoSloniKK folded before Flop (didn't bet)
Seat 8: totyajohnny folded before Flop (didn't bet)
Seat 9: camcf63 folded before Flop (didn't bet)



PokerStars Hand #221590524553: Tournament #3079328305, $0.91+$0.09 USD Hold'em No Limit - Level III (25/50) - 2020/12/19 1:38:47 EET [2020/12/18 18:38:47 ET]
Table '3079328305 5' 9-max Seat #3 is the button
Seat 1: Asti.wp (1876 in chips) 
Seat 2: jcarlos.vale (2759 in chips) 
Seat 3: dady09 (1488 in chips) 
Seat 4: Nogarottoo (777 in chips) 
Seat 5: Fisering123 (2238 in chips) 
Seat 6: PassaTempo77 (2045 in chips) 
Seat 7: PorNoSloniKK (204 in chips) 
Seat 8: totyajohnny (2352 in chips) 
Seat 9: camcf63 (4278 in chips) 
Asti.wp: posts the ante 6
jcarlos.vale: posts the ante 6
dady09: posts the ante 6
Nogarottoo: posts the ante 6
Fisering123: posts the ante 6
PassaTempo77: posts the ante 6
PorNoSloniKK: posts the ante 6
totyajohnny: posts the ante 6
camcf63: posts the ante 6
Nogarottoo: posts small blind 25
Fisering123: posts big blind 50
*** HOLE CARDS ***
Dealt to jcarlos.vale [7s 8s]
PassaTempo77: folds 
PorNoSloniKK: folds 
totyajohnny: raises 50 to 100
camcf63: folds 
Asti.wp: folds 
jcarlos.vale: calls 100
dady09: calls 100
Nogarottoo: calls 75
Fisering123: calls 50
*** FLOP *** [Qs Ts 7h]
Nogarottoo: checks 
Fisering123: checks 
totyajohnny: bets 100
jcarlos.vale: calls 100
dady09: calls 100
Nogarottoo: raises 571 to 671 and is all-in
Fisering123: folds 
totyajohnny: folds 
jcarlos.vale: calls 571
dady09: folds 
*** TURN *** [Qs Ts 7h] [As]
*** RIVER *** [Qs Ts 7h As] [Kd]
*** SHOW DOWN ***
Nogarottoo: shows [Td 8c] (a pair of Tens)
jcarlos.vale: shows [7s 8s] (a flush, Ace high)
jcarlos.vale collected 2096 from pot
Nogarottoo finished the tournament in 36th place
*** SUMMARY ***
Total pot 2096 | Rake 0 
Board [Qs Ts 7h As Kd]
Seat 1: Asti.wp folded before Flop (didn't bet)
Seat 2: jcarlos.vale showed [7s 8s] and won (2096) with a flush, Ace high
Seat 3: dady09 (button) folded on the Flop
Seat 4: Nogarottoo (small blind) showed [Td 8c] and lost with a pair of Tens
Seat 5: Fisering123 (big blind) folded on the Flop
Seat 6: PassaTempo77 folded before Flop (didn't bet)
Seat 7: PorNoSloniKK folded before Flop (didn't bet)
Seat 8: totyajohnny folded on the Flop
Seat 9: camcf63 folded before Flop (didn't bet)



PokerStars Hand #221590578374: Tournament #3079328305, $0.91+$0.09 USD Hold'em No Limit - Level III (25/50) - 2020/12/19 1:40:19 EET [2020/12/18 18:40:19 ET]
Table '3079328305 5' 9-max Seat #5 is the button
Seat 1: Asti.wp (1870 in chips) 
Seat 2: jcarlos.vale (4078 in chips) 
Seat 3: dady09 (1282 in chips) 
Seat 5: Fisering123 (2132 in chips) 
Seat 6: PassaTempo77 (2039 in chips) 
Seat 7: PorNoSloniKK (198 in chips) 
Seat 8: totyajohnny (2146 in chips) 
Seat 9: camcf63 (4272 in chips) 
Asti.wp: posts the ante 6
jcarlos.vale: posts the ante 6
dady09: posts the ante 6
Fisering123: posts the ante 6
PassaTempo77: posts the ante 6
PorNoSloniKK: posts the ante 6
totyajohnny: posts the ante 6
camcf63: posts the ante 6
PassaTempo77: posts small blind 25
PorNoSloniKK: posts big blind 50
*** HOLE CARDS ***
Dealt to jcarlos.vale [6d 2s]
totyajohnny: folds 
camcf63: calls 50
Asti.wp: raises 125 to 175
jcarlos.vale: folds 
dady09: folds 
Fisering123: folds 
PassaTempo77: calls 150
PorNoSloniKK: folds 
camcf63: calls 125
*** FLOP *** [4d Ts 7c]
PassaTempo77: checks 
camcf63: bets 280
Asti.wp: folds 
PassaTempo77: folds 
Uncalled bet (280) returned to camcf63
camcf63 collected 623 from pot
*** SUMMARY ***
Total pot 623 | Rake 0 
Board [4d Ts 7c]
Seat 1: Asti.wp folded on the Flop
Seat 2: jcarlos.vale folded before Flop (didn't bet)
Seat 3: dady09 folded before Flop (didn't bet)
Seat 5: Fisering123 (button) folded before Flop (didn't bet)
Seat 6: PassaTempo77 (small blind) folded on the Flop
Seat 7: PorNoSloniKK (big blind) folded before Flop
Seat 8: totyajohnny folded before Flop (didn't bet)
Seat 9: camcf63 collected (623)



PokerStars Hand #221590617411: Tournament #3079328305, $0.91+$0.09 USD Hold'em No Limit - Level III (25/50) - 2020/12/19 1:41:26 EET [2020/12/18 18:41:26 ET]
Table '3079328305 5' 9-max Seat #6 is the button
Seat 1: Asti.wp (1689 in chips) 
Seat 2: jcarlos.vale (4072 in chips) 
Seat 3: dady09 (1276 in chips) 
Seat 5: Fisering123 (2126 in chips) 
Seat 6: PassaTempo77 (1858 in chips) 
Seat 7: PorNoSloniKK (142 in chips) 
Seat 8: totyajohnny (2140 in chips) 
Seat 9: camcf63 (4714 in chips) 
Asti.wp: posts the ante 6
jcarlos.vale: posts the ante 6
dady09: posts the ante 6
Fisering123: posts the ante 6
PassaTempo77: posts the ante 6
PorNoSloniKK: posts the ante 6
totyajohnny: posts the ante 6
camcf63: posts the ante 6
PorNoSloniKK: posts small blind 25
totyajohnny: posts big blind 50
*** HOLE CARDS ***
Dealt to jcarlos.vale [4s 9d]
camcf63: folds 
Asti.wp: folds 
jcarlos.vale: folds 
dady09: raises 100 to 150
Fisering123: raises 423 to 573
PassaTempo77: folds 
PorNoSloniKK: folds 
totyajohnny: folds 
dady09: calls 423
*** FLOP *** [4c 7s 9s]
dady09: checks 
Fisering123: bets 1547 and is all-in
dady09: folds 
Uncalled bet (1547) returned to Fisering123
Fisering123 collected 1269 from pot
Fisering123: doesn't show handDTO
*** SUMMARY ***
Total pot 1269 | Rake 0 
Board [4c 7s 9s]
Seat 1: Asti.wp folded before Flop (didn't bet)
Seat 2: jcarlos.vale folded before Flop (didn't bet)
Seat 3: dady09 folded on the Flop
Seat 5: Fisering123 collected (1269)
Seat 6: PassaTempo77 (button) folded before Flop (didn't bet)
Seat 7: PorNoSloniKK (small blind) folded before Flop
Seat 8: totyajohnny (big blind) folded before Flop
Seat 9: camcf63 folded before Flop (didn't bet)



PokerStars Hand #221590645380: Tournament #3079328305, $0.91+$0.09 USD Hold'em No Limit - Level III (25/50) - 2020/12/19 1:42:13 EET [2020/12/18 18:42:13 ET]
Table '3079328305 5' 9-max Seat #7 is the button
Seat 1: Asti.wp (1683 in chips) 
Seat 2: jcarlos.vale (4066 in chips) 
Seat 3: dady09 (697 in chips) 
Seat 5: Fisering123 (2816 in chips) 
Seat 6: PassaTempo77 (1852 in chips) 
Seat 7: PorNoSloniKK (111 in chips) 
Seat 8: totyajohnny (2084 in chips) 
Seat 9: camcf63 (4708 in chips) 
Asti.wp: posts the ante 6
jcarlos.vale: posts the ante 6
dady09: posts the ante 6
Fisering123: posts the ante 6
PassaTempo77: posts the ante 6
PorNoSloniKK: posts the ante 6
totyajohnny: posts the ante 6
camcf63: posts the ante 6
totyajohnny: posts small blind 25
camcf63: posts big blind 50
*** HOLE CARDS ***
Dealt to jcarlos.vale [Jh 7s]
Asti.wp: folds 
jcarlos.vale: folds 
dady09: raises 100 to 150
Fisering123: folds 
PassaTempo77: raises 1696 to 1846 and is all-in
PorNoSloniKK: calls 105 and is all-in
totyajohnny: folds 
camcf63: folds 
dady09: calls 541 and is all-in
Uncalled bet (1155) returned to PassaTempo77
*** FLOP *** [2s 4c Ts]
*** TURN *** [2s 4c Ts] [4d]
*** RIVER *** [2s 4c Ts 4d] [6d]
*** SHOW DOWN ***
dady09: shows [2d 2c] (a full house, Deuces full of Fours)
PassaTempo77: shows [Kc Ah] (a pair of Fours)
dady09 collected 1172 from side pot
PorNoSloniKK: shows [Ad 3s] (a pair of Fours)
dady09 collected 438 from main pot
PorNoSloniKK finished the tournament in 33rd place
*** SUMMARY ***
Total pot 1610 Main pot 438. Side pot 1172. | Rake 0 
Board [2s 4c Ts 4d 6d]
Seat 1: Asti.wp folded before Flop (didn't bet)
Seat 2: jcarlos.vale folded before Flop (didn't bet)
Seat 3: dady09 showed [2d 2c] and won (1610) with a full house, Deuces full of Fours
Seat 5: Fisering123 folded before Flop (didn't bet)
Seat 6: PassaTempo77 showed [Kc Ah] and lost with a pair of Fours
Seat 7: PorNoSloniKK (button) showed [Ad 3s] and lost with a pair of Fours
Seat 8: totyajohnny (small blind) folded before Flop
Seat 9: camcf63 (big blind) folded before Flop



PokerStars Hand #221590688958: Tournament #3079328305, $0.91+$0.09 USD Hold'em No Limit - Level IV (40/80) - 2020/12/19 1:43:17 EET [2020/12/18 18:43:17 ET]
Table '3079328305 5' 9-max Seat #8 is the button
Seat 1: Asti.wp (1677 in chips) 
Seat 2: jcarlos.vale (4060 in chips) 
Seat 3: dady09 (1610 in chips) 
Seat 5: Fisering123 (2810 in chips) 
Seat 6: PassaTempo77 (1155 in chips) 
Seat 8: totyajohnny (2053 in chips) 
Seat 9: camcf63 (4652 in chips) 
Asti.wp: posts the ante 10
jcarlos.vale: posts the ante 10
dady09: posts the ante 10
Fisering123: posts the ante 10
PassaTempo77: posts the ante 10
totyajohnny: posts the ante 10
camcf63: posts the ante 10
camcf63: posts small blind 40
Asti.wp: posts big blind 80
*** HOLE CARDS ***
Dealt to jcarlos.vale [7c 6d]
jcarlos.vale: folds 
dady09: raises 160 to 240
Fisering123: folds 
PassaTempo77: folds 
totyajohnny: raises 670 to 910
camcf63: folds 
Asti.wp: folds 
dady09: folds 
Uncalled bet (670) returned to totyajohnny
totyajohnny collected 670 from pot
totyajohnny: doesn't show handDTO
*** SUMMARY ***
Total pot 670 | Rake 0 
Seat 1: Asti.wp (big blind) folded before Flop
Seat 2: jcarlos.vale folded before Flop (didn't bet)
Seat 3: dady09 folded before Flop
Seat 5: Fisering123 folded before Flop (didn't bet)
Seat 6: PassaTempo77 folded before Flop (didn't bet)
Seat 8: totyajohnny (button) collected (670)
Seat 9: camcf63 (small blind) folded before Flop



PokerStars Hand #221590710967: Tournament #3079328305, $0.91+$0.09 USD Hold'em No Limit - Level IV (40/80) - 2020/12/19 1:43:55 EET [2020/12/18 18:43:55 ET]
Table '3079328305 5' 9-max Seat #9 is the button
Seat 1: Asti.wp (1587 in chips) 
Seat 2: jcarlos.vale (4050 in chips) 
Seat 3: dady09 (1360 in chips) 
Seat 5: Fisering123 (2800 in chips) 
Seat 6: PassaTempo77 (1145 in chips) 
Seat 8: totyajohnny (2473 in chips) 
Seat 9: camcf63 (4602 in chips) 
Asti.wp: posts the ante 10
jcarlos.vale: posts the ante 10
dady09: posts the ante 10
Fisering123: posts the ante 10
PassaTempo77: posts the ante 10
totyajohnny: posts the ante 10
camcf63: posts the ante 10
Asti.wp: posts small blind 40
jcarlos.vale: posts big blind 80
*** HOLE CARDS ***
Dealt to jcarlos.vale [3d 3h]
dady09: folds 
Fisering123: raises 160 to 240
PassaTempo77: folds 
totyajohnny: folds 
camcf63: folds 
Asti.wp: folds 
jcarlos.vale: folds 
Uncalled bet (160) returned to Fisering123
Fisering123 collected 270 from pot
Fisering123: doesn't show handDTO
*** SUMMARY ***
Total pot 270 | Rake 0 
Seat 1: Asti.wp (small blind) folded before Flop
Seat 2: jcarlos.vale (big blind) folded before Flop
Seat 3: dady09 folded before Flop (didn't bet)
Seat 5: Fisering123 collected (270)
Seat 6: PassaTempo77 folded before Flop (didn't bet)
Seat 8: totyajohnny folded before Flop (didn't bet)
Seat 9: camcf63 (button) folded before Flop (didn't bet)



PokerStars Hand #221590732748: Tournament #3079328305, $0.91+$0.09 USD Hold'em No Limit - Level IV (40/80) - 2020/12/19 1:44:33 EET [2020/12/18 18:44:33 ET]
Table '3079328305 5' 9-max Seat #1 is the button
Seat 1: Asti.wp (1537 in chips) 
Seat 2: jcarlos.vale (3960 in chips) 
Seat 3: dady09 (1350 in chips) 
Seat 5: Fisering123 (2980 in chips) 
Seat 6: PassaTempo77 (1135 in chips) 
Seat 8: totyajohnny (2463 in chips) 
Seat 9: camcf63 (4592 in chips) 
Asti.wp: posts the ante 10
jcarlos.vale: posts the ante 10
dady09: posts the ante 10
Fisering123: posts the ante 10
PassaTempo77: posts the ante 10
totyajohnny: posts the ante 10
camcf63: posts the ante 10
jcarlos.vale: posts small blind 40
dady09: posts big blind 80
*** HOLE CARDS ***
Dealt to jcarlos.vale [Td 8h]
Fisering123: folds 
PassaTempo77: folds 
totyajohnny: raises 80 to 160
camcf63: folds 
Asti.wp: folds 
jcarlos.vale: folds 
dady09: calls 80
*** FLOP *** [3d 9s 7h]
dady09: checks 
totyajohnny: bets 430
dady09: calls 430
*** TURN *** [3d 9s 7h] [5s]
dady09: checks 
totyajohnny: bets 645
dady09: folds 
Uncalled bet (645) returned to totyajohnny
totyajohnny collected 1290 from pot
totyajohnny: doesn't show handDTO
*** SUMMARY ***
Total pot 1290 | Rake 0 
Board [3d 9s 7h 5s]
Seat 1: Asti.wp (button) folded before Flop (didn't bet)
Seat 2: jcarlos.vale (small blind) folded before Flop
Seat 3: dady09 (big blind) folded on the Turn
Seat 5: Fisering123 folded before Flop (didn't bet)
Seat 6: PassaTempo77 folded before Flop (didn't bet)
Seat 8: totyajohnny collected (1290)
Seat 9: camcf63 folded before Flop (didn't bet)



PokerStars Hand #221590775729: Tournament #3079328305, $0.91+$0.09 USD Hold'em No Limit - Level IV (40/80) - 2020/12/19 1:45:47 EET [2020/12/18 18:45:47 ET]
Table '3079328305 5' 9-max Seat #2 is the button
Seat 1: Asti.wp (1527 in chips) 
Seat 2: jcarlos.vale (3910 in chips) 
Seat 3: dady09 (750 in chips) 
Seat 5: Fisering123 (2970 in chips) 
Seat 6: PassaTempo77 (1125 in chips) 
Seat 8: totyajohnny (3153 in chips) 
Seat 9: camcf63 (4582 in chips) 
Asti.wp: posts the ante 10
jcarlos.vale: posts the ante 10
dady09: posts the ante 10
Fisering123: posts the ante 10
PassaTempo77: posts the ante 10
totyajohnny: posts the ante 10
camcf63: posts the ante 10
dady09: posts small blind 40
Fisering123: posts big blind 80
*** HOLE CARDS ***
Dealt to jcarlos.vale [Kd 5d]
PassaTempo77: folds 
totyajohnny: raises 80 to 160
camcf63: calls 160
Asti.wp: folds 
jcarlos.vale: folds 
dady09: calls 120
Fisering123: calls 80
*** FLOP *** [Jc 2s Th]
dady09: bets 580 and is all-in
Fisering123: folds 
totyajohnny: calls 580
camcf63: folds 
*** TURN *** [Jc 2s Th] [Kc]
*** RIVER *** [Jc 2s Th Kc] [Ac]
*** SHOW DOWN ***
dady09: shows [Jh Ks] (two pair, Kings and Jacks)
totyajohnny: shows [9d Ah] (a pair of Aces)
dady09 collected 1870 from pot
*** SUMMARY ***
Total pot 1870 | Rake 0 
Board [Jc 2s Th Kc Ac]
Seat 1: Asti.wp folded before Flop (didn't bet)
Seat 2: jcarlos.vale (button) folded before Flop (didn't bet)
Seat 3: dady09 (small blind) showed [Jh Ks] and won (1870) with two pair, Kings and Jacks
Seat 5: Fisering123 (big blind) folded on the Flop
Seat 6: PassaTempo77 folded before Flop (didn't bet)
Seat 8: totyajohnny showed [9d Ah] and lost with a pair of Aces
Seat 9: camcf63 folded on the Flop



PokerStars Hand #221590804573: Tournament #3079328305, $0.91+$0.09 USD Hold'em No Limit - Level IV (40/80) - 2020/12/19 1:46:37 EET [2020/12/18 18:46:37 ET]
Table '3079328305 5' 9-max Seat #3 is the button
Seat 1: Asti.wp (1517 in chips) 
Seat 2: jcarlos.vale (3900 in chips) 
Seat 3: dady09 (1870 in chips) 
Seat 5: Fisering123 (2800 in chips) 
Seat 6: PassaTempo77 (1115 in chips) 
Seat 8: totyajohnny (2403 in chips) 
Seat 9: camcf63 (4412 in chips) 
Asti.wp: posts the ante 10
jcarlos.vale: posts the ante 10
dady09: posts the ante 10
Fisering123: posts the ante 10
PassaTempo77: posts the ante 10
totyajohnny: posts the ante 10
camcf63: posts the ante 10
Fisering123: posts small blind 40
PassaTempo77: posts big blind 80
*** HOLE CARDS ***
Dealt to jcarlos.vale [4c 7c]
totyajohnny: raises 80 to 160
camcf63: folds 
Asti.wp: folds 
jcarlos.vale: folds 
dady09: raises 80 to 240
Fisering123: folds 
PassaTempo77: folds 
totyajohnny: calls 80
*** FLOP *** [As 9c Qc]
totyajohnny: bets 670
dady09: calls 670
*** TURN *** [As 9c Qc] [6d]
totyajohnny: bets 1483 and is all-in
dady09: calls 950 and is all-in
Uncalled bet (533) returned to totyajohnny
*** RIVER *** [As 9c Qc 6d] [9h]
*** SHOW DOWN ***
totyajohnny: shows [7s Ac] (two pair, Aces and Nines)
dady09: shows [Kc Ks] (two pair, Kings and Nines)
totyajohnny collected 3910 from pot
dady09 finished the tournament in 30th place
*** SUMMARY ***
Total pot 3910 | Rake 0 
Board [As 9c Qc 6d 9h]
Seat 1: Asti.wp folded before Flop (didn't bet)
Seat 2: jcarlos.vale folded before Flop (didn't bet)
Seat 3: dady09 (button) showed [Kc Ks] and lost with two pair, Kings and Nines
Seat 5: Fisering123 (small blind) folded before Flop
Seat 6: PassaTempo77 (big blind) folded before Flop
Seat 8: totyajohnny showed [7s Ac] and won (3910) with two pair, Aces and Nines
Seat 9: camcf63 folded before Flop (didn't bet)



PokerStars Hand #221590837238: Tournament #3079328305, $0.91+$0.09 USD Hold'em No Limit - Level IV (40/80) - 2020/12/19 1:47:34 EET [2020/12/18 18:47:34 ET]
Table '3079328305 5' 9-max Seat #5 is the button
Seat 1: Asti.wp (1507 in chips) 
Seat 2: jcarlos.vale (3890 in chips) 
Seat 5: Fisering123 (2750 in chips) 
Seat 6: PassaTempo77 (1025 in chips) 
Seat 8: totyajohnny (4443 in chips) 
Seat 9: camcf63 (4402 in chips) 
Asti.wp: posts the ante 10
jcarlos.vale: posts the ante 10
Fisering123: posts the ante 10
PassaTempo77: posts the ante 10
totyajohnny: posts the ante 10
camcf63: posts the ante 10
PassaTempo77: posts small blind 40
totyajohnny: posts big blind 80
*** HOLE CARDS ***
Dealt to jcarlos.vale [3s Qs]
camcf63: folds 
Asti.wp: folds 
jcarlos.vale: folds 
Fisering123: raises 160 to 240
PassaTempo77: folds 
totyajohnny: calls 160
*** FLOP *** [9s Js As]
totyajohnny: bets 580
Fisering123: raises 1920 to 2500 and is all-in
totyajohnny: calls 1920
*** TURN *** [9s Js As] [3d]
*** RIVER *** [9s Js As 3d] [Ah]
*** SHOW DOWN ***
totyajohnny: shows [4s 7s] (a flush, Ace high)
Fisering123: shows [Th 5s] (a pair of Aces)
totyajohnny collected 5580 from pot
Fisering123 finished the tournament in 29th place
*** SUMMARY ***
Total pot 5580 | Rake 0 
Board [9s Js As 3d Ah]
Seat 1: Asti.wp folded before Flop (didn't bet)
Seat 2: jcarlos.vale folded before Flop (didn't bet)
Seat 5: Fisering123 (button) showed [Th 5s] and lost with a pair of Aces
Seat 6: PassaTempo77 (small blind) folded before Flop
Seat 8: totyajohnny (big blind) showed [4s 7s] and won (5580) with a flush, Ace high
Seat 9: camcf63 folded before Flop (didn't bet)



PokerStars Hand #221590861296: Tournament #3079328305, $0.91+$0.09 USD Hold'em No Limit - Level IV (40/80) - 2020/12/19 1:48:17 EET [2020/12/18 18:48:17 ET]
Table '3079328305 5' 9-max Seat #6 is the button
Seat 1: Asti.wp (1497 in chips) 
Seat 2: jcarlos.vale (3880 in chips) 
Seat 3: adabrakadabra (1934 in chips) 
Seat 4: iceblast56 (701 in chips) 
Seat 6: PassaTempo77 (975 in chips) 
Seat 8: totyajohnny (7273 in chips) 
Seat 9: camcf63 (4392 in chips) 
Asti.wp: posts the ante 10
jcarlos.vale: posts the ante 10
adabrakadabra: posts the ante 10
iceblast56: posts the ante 10
PassaTempo77: posts the ante 10
totyajohnny: posts the ante 10
camcf63: posts the ante 10
totyajohnny: posts small blind 40
camcf63: posts big blind 80
*** HOLE CARDS ***
Dealt to jcarlos.vale [9c 4d]
Asti.wp: folds 
jcarlos.vale: folds 
adabrakadabra: folds 
iceblast56: folds 
PassaTempo77: folds 
totyajohnny: calls 40
camcf63: checks 
*** FLOP *** [Qc 5d Js]
totyajohnny: bets 115
camcf63: folds 
Uncalled bet (115) returned to totyajohnny
totyajohnny collected 230 from pot
totyajohnny: doesn't show handDTO
*** SUMMARY ***
Total pot 230 | Rake 0 
Board [Qc 5d Js]
Seat 1: Asti.wp folded before Flop (didn't bet)
Seat 2: jcarlos.vale folded before Flop (didn't bet)
Seat 3: adabrakadabra folded before Flop (didn't bet)
Seat 4: iceblast56 folded before Flop (didn't bet)
Seat 6: PassaTempo77 (button) folded before Flop (didn't bet)
Seat 8: totyajohnny (small blind) collected (230)
Seat 9: camcf63 (big blind) folded on the Flop



PokerStars Hand #221590888298: Tournament #3079328305, $0.91+$0.09 USD Hold'em No Limit - Level IV (40/80) - 2020/12/19 1:49:04 EET [2020/12/18 18:49:04 ET]
Table '3079328305 5' 9-max Seat #8 is the button
Seat 1: Asti.wp (1487 in chips) 
Seat 2: jcarlos.vale (3870 in chips) 
Seat 3: adabrakadabra (1924 in chips) 
Seat 4: iceblast56 (691 in chips) 
Seat 6: PassaTempo77 (965 in chips) 
Seat 8: totyajohnny (7413 in chips) 
Seat 9: camcf63 (4302 in chips) 
Asti.wp: posts the ante 10
jcarlos.vale: posts the ante 10
adabrakadabra: posts the ante 10
iceblast56: posts the ante 10
PassaTempo77: posts the ante 10
totyajohnny: posts the ante 10
camcf63: posts the ante 10
camcf63: posts small blind 40
Asti.wp: posts big blind 80
*** HOLE CARDS ***
Dealt to jcarlos.vale [Tc Qh]
jcarlos.vale: folds 
adabrakadabra: folds 
iceblast56: folds 
PassaTempo77: folds 
totyajohnny: calls 80
camcf63: calls 40
Asti.wp: checks 
*** FLOP *** [2d 4h Ks]
camcf63: checks 
Asti.wp: checks 
totyajohnny: bets 155
camcf63: calls 155
Asti.wp: folds 
*** TURN *** [2d 4h Ks] [Ts]
camcf63: checks 
totyajohnny: bets 620
camcf63: folds 
Uncalled bet (620) returned to totyajohnny
totyajohnny collected 620 from pot
totyajohnny: doesn't show handDTO
*** SUMMARY ***
Total pot 620 | Rake 0 
Board [2d 4h Ks Ts]
Seat 1: Asti.wp (big blind) folded on the Flop
Seat 2: jcarlos.vale folded before Flop (didn't bet)
Seat 3: adabrakadabra folded before Flop (didn't bet)
Seat 4: iceblast56 folded before Flop (didn't bet)
Seat 6: PassaTempo77 folded before Flop (didn't bet)
Seat 8: totyajohnny (button) collected (620)
Seat 9: camcf63 (small blind) folded on the Turn



PokerStars Hand #221590928006: Tournament #3079328305, $0.91+$0.09 USD Hold'em No Limit - Level IV (40/80) - 2020/12/19 1:50:14 EET [2020/12/18 18:50:14 ET]
Table '3079328305 5' 9-max Seat #9 is the button
Seat 1: Asti.wp (1397 in chips) 
Seat 2: jcarlos.vale (3860 in chips) 
Seat 3: adabrakadabra (1914 in chips) 
Seat 4: iceblast56 (681 in chips) 
Seat 6: PassaTempo77 (955 in chips) 
Seat 8: totyajohnny (7788 in chips) 
Seat 9: camcf63 (4057 in chips) 
Asti.wp: posts the ante 10
jcarlos.vale: posts the ante 10
adabrakadabra: posts the ante 10
iceblast56: posts the ante 10
PassaTempo77: posts the ante 10
totyajohnny: posts the ante 10
camcf63: posts the ante 10
Asti.wp: posts small blind 40
jcarlos.vale: posts big blind 80
*** HOLE CARDS ***
Dealt to jcarlos.vale [8c Td]
adabrakadabra: folds 
iceblast56: folds 
PassaTempo77: raises 865 to 945 and is all-in
totyajohnny: folds 
camcf63: folds 
Asti.wp: raises 442 to 1387 and is all-in
jcarlos.vale: folds 
Uncalled bet (442) returned to Asti.wp
*** FLOP *** [Ah 3h 3d]
*** TURN *** [Ah 3h 3d] [4h]
*** RIVER *** [Ah 3h 3d 4h] [Js]
*** SHOW DOWN ***
Asti.wp: shows [Qs Qh] (two pair, Queens and Threes)
PassaTempo77: shows [7h Ac] (two pair, Aces and Threes)
PassaTempo77 collected 2040 from pot
*** SUMMARY ***
Total pot 2040 | Rake 0 
Board [Ah 3h 3d 4h Js]
Seat 1: Asti.wp (small blind) showed [Qs Qh] and lost with two pair, Queens and Threes
Seat 2: jcarlos.vale (big blind) folded before Flop
Seat 3: adabrakadabra folded before Flop (didn't bet)
Seat 4: iceblast56 folded before Flop (didn't bet)
Seat 6: PassaTempo77 showed [7h Ac] and won (2040) with two pair, Aces and Threes
Seat 8: totyajohnny folded before Flop (didn't bet)
Seat 9: camcf63 (button) folded before Flop (didn't bet)



PokerStars Hand #221590950684: Tournament #3079328305, $0.91+$0.09 USD Hold'em No Limit - Level IV (40/80) - 2020/12/19 1:50:54 EET [2020/12/18 18:50:54 ET]
Table '3079328305 5' 9-max Seat #1 is the button
Seat 1: Asti.wp (442 in chips) 
Seat 2: jcarlos.vale (3770 in chips) 
Seat 3: adabrakadabra (1904 in chips) 
Seat 4: iceblast56 (671 in chips) 
Seat 6: PassaTempo77 (2040 in chips) 
Seat 8: totyajohnny (7778 in chips) 
Seat 9: camcf63 (4047 in chips) 
Asti.wp: posts the ante 10
jcarlos.vale: posts the ante 10
adabrakadabra: posts the ante 10
iceblast56: posts the ante 10
PassaTempo77: posts the ante 10
totyajohnny: posts the ante 10
camcf63: posts the ante 10
jcarlos.vale: posts small blind 40
adabrakadabra: posts big blind 80
*** HOLE CARDS ***
Dealt to jcarlos.vale [Th 7s]
iceblast56: folds 
PassaTempo77: folds 
totyajohnny: folds 
camcf63: raises 80 to 160
Asti.wp: folds 
jcarlos.vale: folds 
adabrakadabra: folds 
Uncalled bet (80) returned to camcf63
camcf63 collected 270 from pot
*** SUMMARY ***
Total pot 270 | Rake 0 
Seat 1: Asti.wp (button) folded before Flop (didn't bet)
Seat 2: jcarlos.vale (small blind) folded before Flop
Seat 3: adabrakadabra (big blind) folded before Flop
Seat 4: iceblast56 folded before Flop (didn't bet)
Seat 6: PassaTempo77 folded before Flop (didn't bet)
Seat 8: totyajohnny folded before Flop (didn't bet)
Seat 9: camcf63 collected (270)



PokerStars Hand #221590963989: Tournament #3079328305, $0.91+$0.09 USD Hold'em No Limit - Level IV (40/80) - 2020/12/19 1:51:17 EET [2020/12/18 18:51:17 ET]
Table '3079328305 5' 9-max Seat #2 is the button
Seat 1: Asti.wp (432 in chips) 
Seat 2: jcarlos.vale (3720 in chips) 
Seat 3: adabrakadabra (1814 in chips) 
Seat 4: iceblast56 (661 in chips) 
Seat 6: PassaTempo77 (2030 in chips) 
Seat 8: totyajohnny (7768 in chips) 
Seat 9: camcf63 (4227 in chips) 
Asti.wp: posts the ante 10
jcarlos.vale: posts the ante 10
adabrakadabra: posts the ante 10
iceblast56: posts the ante 10
PassaTempo77: posts the ante 10
totyajohnny: posts the ante 10
camcf63: posts the ante 10
adabrakadabra: posts small blind 40
iceblast56: posts big blind 80
*** HOLE CARDS ***
Dealt to jcarlos.vale [5c Qc]
PassaTempo77: folds 
totyajohnny: raises 80 to 160
camcf63: calls 160
Asti.wp: folds 
jcarlos.vale: folds 
adabrakadabra: folds 
iceblast56: folds 
*** FLOP *** [7d 2h Kc]
totyajohnny: bets 510
camcf63: folds 
Uncalled bet (510) returned to totyajohnny
totyajohnny collected 510 from pot
totyajohnny: doesn't show handDTO
*** SUMMARY ***
Total pot 510 | Rake 0 
Board [7d 2h Kc]
Seat 1: Asti.wp folded before Flop (didn't bet)
Seat 2: jcarlos.vale (button) folded before Flop (didn't bet)
Seat 3: adabrakadabra (small blind) folded before Flop
Seat 4: iceblast56 (big blind) folded before Flop
Seat 6: PassaTempo77 folded before Flop (didn't bet)
Seat 8: totyajohnny collected (510)
Seat 9: camcf63 folded on the Flop



PokerStars Hand #221591005847: Tournament #3079328305, $0.91+$0.09 USD Hold'em No Limit - Level IV (40/80) - 2020/12/19 1:52:32 EET [2020/12/18 18:52:32 ET]
Table '3079328305 5' 9-max Seat #3 is the button
Seat 1: Asti.wp (422 in chips) 
Seat 2: jcarlos.vale (3710 in chips) 
Seat 3: adabrakadabra (1764 in chips) 
Seat 4: iceblast56 (571 in chips) 
Seat 5: welton max (2109 in chips) 
Seat 6: PassaTempo77 (2020 in chips) 
Seat 7: Richard_KONO (1432 in chips) 
Seat 8: totyajohnny (8108 in chips) 
Seat 9: camcf63 (4057 in chips) 
Asti.wp: posts the ante 10
jcarlos.vale: posts the ante 10
adabrakadabra: posts the ante 10
iceblast56: posts the ante 10
welton max: posts the ante 10
PassaTempo77: posts the ante 10
Richard_KONO: posts the ante 10
totyajohnny: posts the ante 10
camcf63: posts the ante 10
iceblast56: posts small blind 40
welton max: posts big blind 80
*** HOLE CARDS ***
Dealt to jcarlos.vale [3s Jd]
PassaTempo77: raises 88 to 168
Richard_KONO: folds 
totyajohnny: raises 88 to 256
camcf63: folds 
Asti.wp: folds 
jcarlos.vale: folds 
adabrakadabra: folds 
iceblast56: folds 
welton max: folds 
PassaTempo77: calls 88
*** FLOP *** [Jh Jc 6h]
PassaTempo77: checks 
totyajohnny: bets 722
PassaTempo77: folds 
Uncalled bet (722) returned to totyajohnny
totyajohnny collected 722 from pot
totyajohnny: doesn't show handDTO
*** SUMMARY ***
Total pot 722 | Rake 0 
Board [Jh Jc 6h]
Seat 1: Asti.wp folded before Flop (didn't bet)
Seat 2: jcarlos.vale folded before Flop (didn't bet)
Seat 3: adabrakadabra (button) folded before Flop (didn't bet)
Seat 4: iceblast56 (small blind) folded before Flop
Seat 5: welton max (big blind) folded before Flop
Seat 6: PassaTempo77 folded on the Flop
Seat 7: Richard_KONO folded before Flop (didn't bet)
Seat 8: totyajohnny collected (722)
Seat 9: camcf63 folded before Flop (didn't bet)



PokerStars Hand #221591053464: Tournament #3079328305, $0.91+$0.09 USD Hold'em No Limit - Level V (60/120) - 2020/12/19 1:53:57 EET [2020/12/18 18:53:57 ET]
Table '3079328305 5' 9-max Seat #4 is the button
Seat 1: Asti.wp (412 in chips) 
Seat 2: jcarlos.vale (3700 in chips) 
Seat 3: adabrakadabra (1754 in chips) 
Seat 4: iceblast56 (521 in chips) 
Seat 5: welton max (2019 in chips) 
Seat 6: PassaTempo77 (1754 in chips) 
Seat 7: Richard_KONO (1422 in chips) 
Seat 8: totyajohnny (8564 in chips) 
Seat 9: camcf63 (4047 in chips) 
Asti.wp: posts the ante 15
jcarlos.vale: posts the ante 15
adabrakadabra: posts the ante 15
iceblast56: posts the ante 15
welton max: posts the ante 15
PassaTempo77: posts the ante 15
Richard_KONO: posts the ante 15
totyajohnny: posts the ante 15
camcf63: posts the ante 15
welton max: posts small blind 60
PassaTempo77: posts big blind 120
*** HOLE CARDS ***
Dealt to jcarlos.vale [4s 5s]
Richard_KONO: folds 
totyajohnny: calls 120
camcf63: folds 
Asti.wp: folds 
jcarlos.vale: folds 
adabrakadabra: folds 
iceblast56: folds 
welton max: calls 60
PassaTempo77: checks 
*** FLOP *** [Ks 3s Jd]
welton max: checks 
PassaTempo77: checks 
totyajohnny: bets 120
welton max: calls 120
PassaTempo77: folds 
*** TURN *** [Ks 3s Jd] [Qs]
welton max: checks 
totyajohnny: bets 368
welton max: calls 368
*** RIVER *** [Ks 3s Jd Qs] [2d]
welton max: checks 
totyajohnny: checks 
*** SHOW DOWN ***
welton max: shows [Qh Tc] (a pair of Queens)
totyajohnny: mucks handDTO
welton max collected 1471 from pot
*** SUMMARY ***
Total pot 1471 | Rake 0 
Board [Ks 3s Jd Qs 2d]
Seat 1: Asti.wp folded before Flop (didn't bet)
Seat 2: jcarlos.vale folded before Flop (didn't bet)
Seat 3: adabrakadabra folded before Flop (didn't bet)
Seat 4: iceblast56 (button) folded before Flop (didn't bet)
Seat 5: welton max (small blind) showed [Qh Tc] and won (1471) with a pair of Queens
Seat 6: PassaTempo77 (big blind) folded on the Flop
Seat 7: Richard_KONO folded before Flop (didn't bet)
Seat 8: totyajohnny mucked [8c As]
Seat 9: camcf63 folded before Flop (didn't bet)



PokerStars Hand #221591236793: Tournament #3079328305, $0.91+$0.09 USD Hold'em No Limit - Level V (60/120) - 2020/12/19 2:00:23 EET [2020/12/18 19:00:23 ET]
Table '3079328305 5' 9-max Seat #5 is the button
Seat 1: Asti.wp (397 in chips) 
Seat 2: jcarlos.vale (3685 in chips) 
Seat 3: adabrakadabra (1739 in chips) 
Seat 4: iceblast56 (506 in chips) 
Seat 5: welton max (2867 in chips) 
Seat 6: PassaTempo77 (1619 in chips) 
Seat 7: Richard_KONO (1407 in chips) 
Seat 8: totyajohnny (7941 in chips) 
Seat 9: camcf63 (4032 in chips) 
Asti.wp: posts the ante 15
jcarlos.vale: posts the ante 15
adabrakadabra: posts the ante 15
iceblast56: posts the ante 15
welton max: posts the ante 15
PassaTempo77: posts the ante 15
Richard_KONO: posts the ante 15
totyajohnny: posts the ante 15
camcf63: posts the ante 15
PassaTempo77: posts small blind 60
Richard_KONO: posts big blind 120
*** HOLE CARDS ***
Dealt to jcarlos.vale [5h Td]
totyajohnny: folds 
camcf63: folds 
Asti.wp: folds 
jcarlos.vale: folds 
adabrakadabra: folds 
iceblast56: raises 300 to 420
welton max: calls 420
PassaTempo77: folds 
Richard_KONO: folds 
*** FLOP *** [3h Jc 7c]
iceblast56: bets 71 and is all-in
welton max: calls 71
*** TURN *** [3h Jc 7c] [8d]
*** RIVER *** [3h Jc 7c 8d] [Kd]
*** SHOW DOWN ***
iceblast56: shows [Ad 2s] (high pairOfCards Ace)
welton max: shows [Qh Kc] (a pair of Kings)
welton max collected 1297 from pot
iceblast56 finished the tournament in 27th place
*** SUMMARY ***
Total pot 1297 | Rake 0 
Board [3h Jc 7c 8d Kd]
Seat 1: Asti.wp folded before Flop (didn't bet)
Seat 2: jcarlos.vale folded before Flop (didn't bet)
Seat 3: adabrakadabra folded before Flop (didn't bet)
Seat 4: iceblast56 showed [Ad 2s] and lost with high pairOfCards Ace
Seat 5: welton max (button) showed [Qh Kc] and won (1297) with a pair of Kings
Seat 6: PassaTempo77 (small blind) folded before Flop
Seat 7: Richard_KONO (big blind) folded before Flop
Seat 8: totyajohnny folded before Flop (didn't bet)
Seat 9: camcf63 folded before Flop (didn't bet)



PokerStars Hand #221591274035: Tournament #3079328305, $0.91+$0.09 USD Hold'em No Limit - Level V (60/120) - 2020/12/19 2:01:38 EET [2020/12/18 19:01:38 ET]
Table '3079328305 5' 9-max Seat #6 is the button
Seat 1: Asti.wp (382 in chips) 
Seat 2: jcarlos.vale (3670 in chips) 
Seat 3: adabrakadabra (1724 in chips) 
Seat 5: welton max (3658 in chips) 
Seat 6: PassaTempo77 (1544 in chips) 
Seat 7: Richard_KONO (1272 in chips) 
Seat 8: totyajohnny (7926 in chips) 
Seat 9: camcf63 (4017 in chips) 
Asti.wp: posts the ante 15
jcarlos.vale: posts the ante 15
adabrakadabra: posts the ante 15
welton max: posts the ante 15
PassaTempo77: posts the ante 15
Richard_KONO: posts the ante 15
totyajohnny: posts the ante 15
camcf63: posts the ante 15
Richard_KONO: posts small blind 60
totyajohnny: posts big blind 120
*** HOLE CARDS ***
Dealt to jcarlos.vale [Ad Jd]
camcf63: folds 
Asti.wp: folds 
jcarlos.vale: raises 192 to 312
adabrakadabra: folds 
welton max: folds 
PassaTempo77: folds 
Richard_KONO: folds 
totyajohnny: folds 
Uncalled bet (192) returned to jcarlos.vale
jcarlos.vale collected 420 from pot
jcarlos.vale: doesn't show handDTO
*** SUMMARY ***
Total pot 420 | Rake 0 
Seat 1: Asti.wp folded before Flop (didn't bet)
Seat 2: jcarlos.vale collected (420)
Seat 3: adabrakadabra folded before Flop (didn't bet)
Seat 5: welton max folded before Flop (didn't bet)
Seat 6: PassaTempo77 (button) folded before Flop (didn't bet)
Seat 7: Richard_KONO (small blind) folded before Flop
Seat 8: totyajohnny (big blind) folded before Flop
Seat 9: camcf63 folded before Flop (didn't bet)



PokerStars Hand #221591290865: Tournament #3079328305, $0.91+$0.09 USD Hold'em No Limit - Level V (60/120) - 2020/12/19 2:02:10 EET [2020/12/18 19:02:10 ET]
Table '3079328305 5' 9-max Seat #7 is the button
Seat 1: Asti.wp (367 in chips) 
Seat 2: jcarlos.vale (3955 in chips) 
Seat 3: adabrakadabra (1709 in chips) 
Seat 5: welton max (3643 in chips) 
Seat 6: PassaTempo77 (1529 in chips) 
Seat 7: Richard_KONO (1197 in chips) 
Seat 8: totyajohnny (7791 in chips) 
Seat 9: camcf63 (4002 in chips) 
Asti.wp: posts the ante 15
jcarlos.vale: posts the ante 15
adabrakadabra: posts the ante 15
welton max: posts the ante 15
PassaTempo77: posts the ante 15
Richard_KONO: posts the ante 15
totyajohnny: posts the ante 15
camcf63: posts the ante 15
totyajohnny: posts small blind 60
camcf63: posts big blind 120
*** HOLE CARDS ***
Dealt to jcarlos.vale [9h Qs]
Asti.wp: folds 
jcarlos.vale: folds 
adabrakadabra: folds 
welton max: folds 
PassaTempo77: folds 
Richard_KONO: raises 1062 to 1182 and is all-in
totyajohnny: folds 
camcf63: folds 
Uncalled bet (1062) returned to Richard_KONO
Richard_KONO collected 420 from pot
Richard_KONO: doesn't show handDTO
*** SUMMARY ***
Total pot 420 | Rake 0 
Seat 1: Asti.wp folded before Flop (didn't bet)
Seat 2: jcarlos.vale folded before Flop (didn't bet)
Seat 3: adabrakadabra folded before Flop (didn't bet)
Seat 5: welton max folded before Flop (didn't bet)
Seat 6: PassaTempo77 folded before Flop (didn't bet)
Seat 7: Richard_KONO (button) collected (420)
Seat 8: totyajohnny (small blind) folded before Flop
Seat 9: camcf63 (big blind) folded before Flop



PokerStars Hand #221591309611: Tournament #3079328305, $0.91+$0.09 USD Hold'em No Limit - Level V (60/120) - 2020/12/19 2:02:44 EET [2020/12/18 19:02:44 ET]
Table '3079328305 5' 9-max Seat #8 is the button
Seat 1: Asti.wp (352 in chips) 
Seat 2: jcarlos.vale (3940 in chips) 
Seat 3: adabrakadabra (1694 in chips) 
Seat 5: welton max (3628 in chips) 
Seat 6: PassaTempo77 (1514 in chips) 
Seat 7: Richard_KONO (1482 in chips) 
Seat 8: totyajohnny (7716 in chips) 
Seat 9: camcf63 (3867 in chips) 
Asti.wp: posts the ante 15
jcarlos.vale: posts the ante 15
adabrakadabra: posts the ante 15
welton max: posts the ante 15
PassaTempo77: posts the ante 15
Richard_KONO: posts the ante 15
totyajohnny: posts the ante 15
camcf63: posts the ante 15
camcf63: posts small blind 60
Asti.wp: posts big blind 120
*** HOLE CARDS ***
Dealt to jcarlos.vale [9h 2d]
jcarlos.vale: folds 
adabrakadabra: raises 1559 to 1679 and is all-in
welton max: folds 
PassaTempo77: folds 
Richard_KONO: folds 
totyajohnny: folds 
camcf63: folds 
Asti.wp: calls 217 and is all-in
Uncalled bet (1342) returned to adabrakadabra
*** FLOP *** [9c 4s 8d]
*** TURN *** [9c 4s 8d] [Qc]
*** RIVER *** [9c 4s 8d Qc] [7d]
*** SHOW DOWN ***
Asti.wp: shows [3c 3d] (a pair of Threes)
adabrakadabra: shows [Qs Ad] (a pair of Queens)
adabrakadabra collected 854 from pot
Asti.wp finished the tournament in 26th place
*** SUMMARY ***
Total pot 854 | Rake 0 
Board [9c 4s 8d Qc 7d]
Seat 1: Asti.wp (big blind) showed [3c 3d] and lost with a pair of Threes
Seat 2: jcarlos.vale folded before Flop (didn't bet)
Seat 3: adabrakadabra showed [Qs Ad] and won (854) with a pair of Queens
Seat 5: welton max folded before Flop (didn't bet)
Seat 6: PassaTempo77 folded before Flop (didn't bet)
Seat 7: Richard_KONO folded before Flop (didn't bet)
Seat 8: totyajohnny (button) folded before Flop (didn't bet)
Seat 9: camcf63 (small blind) folded before Flop



PokerStars Hand #221591334742: Tournament #3079328305, $0.91+$0.09 USD Hold'em No Limit - Level V (60/120) - 2020/12/19 2:03:30 EET [2020/12/18 19:03:30 ET]
Table '3079328305 5' 9-max Seat #9 is the button
Seat 2: jcarlos.vale (3925 in chips) 
Seat 3: adabrakadabra (2196 in chips) 
Seat 5: welton max (3613 in chips) 
Seat 6: PassaTempo77 (1499 in chips) 
Seat 7: Richard_KONO (1467 in chips) 
Seat 8: totyajohnny (7701 in chips) 
Seat 9: camcf63 (3792 in chips) 
jcarlos.vale: posts the ante 15
adabrakadabra: posts the ante 15
welton max: posts the ante 15
PassaTempo77: posts the ante 15
Richard_KONO: posts the ante 15
totyajohnny: posts the ante 15
camcf63: posts the ante 15
jcarlos.vale: posts small blind 60
adabrakadabra: posts big blind 120
*** HOLE CARDS ***
Dealt to jcarlos.vale [4c 6h]
welton max: raises 144 to 264
PassaTempo77: folds 
Richard_KONO: folds 
totyajohnny: calls 264
camcf63: folds 
jcarlos.vale: folds 
adabrakadabra: folds 
*** FLOP *** [7h Qc 5h]
welton max: bets 360
totyajohnny: calls 360
*** TURN *** [7h Qc 5h] [2c]
welton max: bets 840
totyajohnny: calls 840
*** RIVER *** [7h Qc 5h 2c] [5s]
welton max: checks 
totyajohnny: checks 
*** SHOW DOWN ***
welton max: shows [Ac Td] (a pair of Fives)
totyajohnny: mucks handDTO
welton max collected 3213 from pot
*** SUMMARY ***
Total pot 3213 | Rake 0 
Board [7h Qc 5h 2c 5s]
Seat 2: jcarlos.vale (small blind) folded before Flop
Seat 3: adabrakadabra (big blind) folded before Flop
Seat 5: welton max showed [Ac Td] and won (3213) with a pair of Fives
Seat 6: PassaTempo77 folded before Flop (didn't bet)
Seat 7: Richard_KONO folded before Flop (didn't bet)
Seat 8: totyajohnny mucked [Jc Kc]
Seat 9: camcf63 (button) folded before Flop (didn't bet)



PokerStars Hand #221591390602: Tournament #3079328305, $0.91+$0.09 USD Hold'em No Limit - Level V (60/120) - 2020/12/19 2:05:14 EET [2020/12/18 19:05:14 ET]
Table '3079328305 5' 9-max Seat #2 is the button
Seat 2: jcarlos.vale (3850 in chips) 
Seat 3: adabrakadabra (2061 in chips) 
Seat 4: billyjoe9999 (2832 in chips) 
Seat 5: welton max (5347 in chips) 
Seat 6: PassaTempo77 (1484 in chips) 
Seat 7: Richard_KONO (1452 in chips) 
Seat 8: totyajohnny (6222 in chips) 
Seat 9: camcf63 (3777 in chips) 
jcarlos.vale: posts the ante 15
adabrakadabra: posts the ante 15
billyjoe9999: posts the ante 15
welton max: posts the ante 15
PassaTempo77: posts the ante 15
Richard_KONO: posts the ante 15
totyajohnny: posts the ante 15
camcf63: posts the ante 15
adabrakadabra: posts small blind 60
billyjoe9999: posts big blind 120
*** HOLE CARDS ***
Dealt to jcarlos.vale [Kd 3h]
welton max has timed out
welton max: folds 
welton max is sitting out
PassaTempo77: folds 
Richard_KONO: folds 
totyajohnny: raises 120 to 240
camcf63: raises 300 to 540
jcarlos.vale: folds 
adabrakadabra: folds 
welton max has returned
billyjoe9999: folds 
totyajohnny: calls 300
*** FLOP *** [5s Ac 3s]
totyajohnny: bets 690
camcf63: folds 
Uncalled bet (690) returned to totyajohnny
totyajohnny collected 1380 from pot
totyajohnny: doesn't show handDTO
*** SUMMARY ***
Total pot 1380 | Rake 0 
Board [5s Ac 3s]
Seat 2: jcarlos.vale (button) folded before Flop (didn't bet)
Seat 3: adabrakadabra (small blind) folded before Flop
Seat 4: billyjoe9999 (big blind) folded before Flop
Seat 5: welton max folded before Flop (didn't bet)
Seat 6: PassaTempo77 folded before Flop (didn't bet)
Seat 7: Richard_KONO folded before Flop (didn't bet)
Seat 8: totyajohnny collected (1380)
Seat 9: camcf63 folded on the Flop



PokerStars Hand #221591424133: Tournament #3079328305, $0.91+$0.09 USD Hold'em No Limit - Level V (60/120) - 2020/12/19 2:06:16 EET [2020/12/18 19:06:16 ET]
Table '3079328305 5' 9-max Seat #3 is the button
Seat 2: jcarlos.vale (3835 in chips) 
Seat 3: adabrakadabra (1986 in chips) 
Seat 4: billyjoe9999 (2697 in chips) 
Seat 5: welton max (5332 in chips) 
Seat 6: PassaTempo77 (1469 in chips) 
Seat 7: Richard_KONO (1437 in chips) 
Seat 9: camcf63 (3222 in chips) 
jcarlos.vale: posts the ante 15
adabrakadabra: posts the ante 15
billyjoe9999: posts the ante 15
welton max: posts the ante 15
PassaTempo77: posts the ante 15
Richard_KONO: posts the ante 15
camcf63: posts the ante 15
billyjoe9999: posts small blind 60
welton max: posts big blind 120
*** HOLE CARDS ***
Dealt to jcarlos.vale [3h Ac]
PassaTempo77: folds 
Richard_KONO: folds 
camcf63: raises 120 to 240
jcarlos.vale: folds 
adabrakadabra: folds 
billyjoe9999: folds 
welton max: calls 120
*** FLOP *** [2s Ts 9d]
welton max: checks 
camcf63: checks 
*** TURN *** [2s Ts 9d] [3c]
welton max: bets 240
camcf63: calls 240
*** RIVER *** [2s Ts 9d 3c] [6c]
welton max: checks 
camcf63: checks 
*** SHOW DOWN ***
welton max: shows [Ks 4h] (high pairOfCards King)
camcf63: shows [Kd Jd] (high pairOfCards King - Jack kicker)
camcf63 collected 1125 from pot
*** SUMMARY ***
Total pot 1125 | Rake 0 
Board [2s Ts 9d 3c 6c]
Seat 2: jcarlos.vale folded before Flop (didn't bet)
Seat 3: adabrakadabra (button) folded before Flop (didn't bet)
Seat 4: billyjoe9999 (small blind) folded before Flop
Seat 5: welton max (big blind) showed [Ks 4h] and lost with high pairOfCards King
Seat 6: PassaTempo77 folded before Flop (didn't bet)
Seat 7: Richard_KONO folded before Flop (didn't bet)
Seat 9: camcf63 showed [Kd Jd] and won (1125) with high pairOfCards King



PokerStars Hand #221591453636: Tournament #3079328305, $0.91+$0.09 USD Hold'em No Limit - Level V (60/120) - 2020/12/19 2:07:12 EET [2020/12/18 19:07:12 ET]
Table '3079328305 5' 9-max Seat #4 is the button
Seat 2: jcarlos.vale (3820 in chips) 
Seat 3: adabrakadabra (1971 in chips) 
Seat 4: billyjoe9999 (2622 in chips) 
Seat 5: welton max (4837 in chips) 
Seat 6: PassaTempo77 (1454 in chips) 
Seat 7: Richard_KONO (1422 in chips) 
Seat 9: camcf63 (3852 in chips) 
jcarlos.vale: posts the ante 15
adabrakadabra: posts the ante 15
billyjoe9999: posts the ante 15
welton max: posts the ante 15
PassaTempo77: posts the ante 15
Richard_KONO: posts the ante 15
camcf63: posts the ante 15
welton max: posts small blind 60
PassaTempo77: posts big blind 120
*** HOLE CARDS ***
Dealt to jcarlos.vale [4c Jd]
Richard_KONO: folds 
camcf63: raises 120 to 240
jcarlos.vale: folds 
adabrakadabra: raises 480 to 720
billyjoe9999: folds 
welton max: raises 4102 to 4822 and is all-in
PassaTempo77: calls 1319 and is all-in
camcf63: folds 
adabrakadabra: calls 1236 and is all-in
Uncalled bet (2866) returned to welton max
*** FLOP *** [Tc 6s 9c]
*** TURN *** [Tc 6s 9c] [4d]
*** RIVER *** [Tc 6s 9c 4d] [Kc]
*** SHOW DOWN ***
welton max: shows [Js Jc] (a pair of Jacks)
adabrakadabra: shows [Ks Kd] (three of a kind, Kings)
adabrakadabra collected 1034 from side pot
PassaTempo77: shows [As Kh] (a pair of Kings)
adabrakadabra collected 4662 from main pot
PassaTempo77 finished the tournament in 20th place
*** SUMMARY ***
Total pot 5696 Main pot 4662. Side pot 1034. | Rake 0 
Board [Tc 6s 9c 4d Kc]
Seat 2: jcarlos.vale folded before Flop (didn't bet)
Seat 3: adabrakadabra showed [Ks Kd] and won (5696) with three of a kind, Kings
Seat 4: billyjoe9999 (button) folded before Flop (didn't bet)
Seat 5: welton max (small blind) showed [Js Jc] and lost with a pair of Jacks
Seat 6: PassaTempo77 (big blind) showed [As Kh] and lost with a pair of Kings
Seat 7: Richard_KONO folded before Flop (didn't bet)
Seat 9: camcf63 folded before Flop



PokerStars Hand #221591478726: Tournament #3079328305, $0.91+$0.09 USD Hold'em No Limit - Level VI (80/160) - 2020/12/19 2:07:59 EET [2020/12/18 19:07:59 ET]
Table '3079328305 5' 9-max Seat #5 is the button
Seat 2: jcarlos.vale (3805 in chips) 
Seat 3: adabrakadabra (5696 in chips) 
Seat 4: billyjoe9999 (2607 in chips) 
Seat 5: welton max (2866 in chips) 
Seat 7: Richard_KONO (1407 in chips) 
Seat 9: camcf63 (3597 in chips) 
jcarlos.vale: posts the ante 20
adabrakadabra: posts the ante 20
billyjoe9999: posts the ante 20
welton max: posts the ante 20
Richard_KONO: posts the ante 20
camcf63: posts the ante 20
Richard_KONO: posts small blind 80
camcf63: posts big blind 160
*** HOLE CARDS ***
Dealt to jcarlos.vale [Ts Kh]
jcarlos.vale: folds 
adabrakadabra: folds 
billyjoe9999: folds 
welton max: raises 160 to 320
Richard_KONO: folds 
camcf63: raises 3257 to 3577 and is all-in
welton max: calls 2526 and is all-in
Uncalled bet (731) returned to camcf63
*** FLOP *** [6s Jd 7h]
*** TURN *** [6s Jd 7h] [Jh]
*** RIVER *** [6s Jd 7h Jh] [Ks]
*** SHOW DOWN ***
camcf63: shows [Ac Qs] (a pair of Jacks)
welton max: shows [Ad 2d] (a pair of Jacks - lower kicker)
camcf63 collected 5892 from pot
welton max finished the tournament in 18th place
*** SUMMARY ***
Total pot 5892 | Rake 0 
Board [6s Jd 7h Jh Ks]
Seat 2: jcarlos.vale folded before Flop (didn't bet)
Seat 3: adabrakadabra folded before Flop (didn't bet)
Seat 4: billyjoe9999 folded before Flop (didn't bet)
Seat 5: welton max (button) showed [Ad 2d] and lost with a pair of Jacks
Seat 7: Richard_KONO (small blind) folded before Flop
Seat 9: camcf63 (big blind) showed [Ac Qs] and won (5892) with a pair of Jacks



PokerStars Hand #221591497568: Tournament #3079328305, $0.91+$0.09 USD Hold'em No Limit - Level VI (80/160) - 2020/12/19 2:08:34 EET [2020/12/18 19:08:34 ET]
Table '3079328305 5' 9-max Seat #7 is the button
Seat 1: m55uu (3117 in chips) 
Seat 2: jcarlos.vale (3785 in chips) 
Seat 3: adabrakadabra (5676 in chips) 
Seat 4: billyjoe9999 (2587 in chips) 
Seat 6: whiskey732 (6049 in chips) 
Seat 7: Richard_KONO (1307 in chips) 
Seat 8: Lucie686979 (628 in chips) out of handDTO (moved from another table into small blind)
Seat 9: camcf63 (6623 in chips) 
Lucie686979 will be allowed to play after the button
m55uu: posts the ante 20
jcarlos.vale: posts the ante 20
adabrakadabra: posts the ante 20
billyjoe9999: posts the ante 20
whiskey732: posts the ante 20
Richard_KONO: posts the ante 20
camcf63: posts the ante 20
camcf63: posts small blind 80
m55uu: posts big blind 160
*** HOLE CARDS ***
Dealt to jcarlos.vale [3c Kd]
jcarlos.vale: folds 
adabrakadabra: folds 
billyjoe9999: calls 160
whiskey732: folds 
Richard_KONO: folds 
camcf63: raises 160 to 320
m55uu: folds 
billyjoe9999: calls 160
*** FLOP *** [6d Qh 5d]
camcf63: bets 423
billyjoe9999: folds 
Uncalled bet (423) returned to camcf63
camcf63 collected 940 from pot
*** SUMMARY ***
Total pot 940 | Rake 0 
Board [6d Qh 5d]
Seat 1: m55uu (big blind) folded before Flop
Seat 2: jcarlos.vale folded before Flop (didn't bet)
Seat 3: adabrakadabra folded before Flop (didn't bet)
Seat 4: billyjoe9999 folded on the Flop
Seat 6: whiskey732 folded before Flop (didn't bet)
Seat 7: Richard_KONO (button) folded before Flop (didn't bet)
Seat 9: camcf63 (small blind) collected (940)



PokerStars Hand #221591543009: Tournament #3079328305, $0.91+$0.09 USD Hold'em No Limit - Level VI (80/160) - 2020/12/19 2:10:01 EET [2020/12/18 19:10:01 ET]
Table '3079328305 5' 9-max Seat #9 is the button
Seat 1: m55uu (2937 in chips) 
Seat 2: jcarlos.vale (3765 in chips) 
Seat 3: adabrakadabra (5656 in chips) 
Seat 4: billyjoe9999 (2247 in chips) 
Seat 6: whiskey732 (6029 in chips) 
Seat 7: Richard_KONO (1287 in chips) 
Seat 8: Lucie686979 (628 in chips) is sitting out
Seat 9: camcf63 (7223 in chips) 
m55uu: posts the ante 20
jcarlos.vale: posts the ante 20
adabrakadabra: posts the ante 20
billyjoe9999: posts the ante 20
whiskey732: posts the ante 20
Richard_KONO: posts the ante 20
Lucie686979: posts the ante 20
camcf63: posts the ante 20
m55uu: posts small blind 80
jcarlos.vale: posts big blind 160
*** HOLE CARDS ***
Dealt to jcarlos.vale [Ad Kc]
adabrakadabra: folds 
billyjoe9999: folds 
whiskey732: folds 
Richard_KONO: folds 
Lucie686979: folds 
camcf63: folds 
m55uu: raises 248 to 408
jcarlos.vale: raises 3337 to 3745 and is all-in
m55uu: folds 
Uncalled bet (3337) returned to jcarlos.vale
jcarlos.vale collected 976 from pot
jcarlos.vale: doesn't show handDTO
*** SUMMARY ***
Total pot 976 | Rake 0 
Seat 1: m55uu (small blind) folded before Flop
Seat 2: jcarlos.vale (big blind) collected (976)
Seat 3: adabrakadabra folded before Flop (didn't bet)
Seat 4: billyjoe9999 folded before Flop (didn't bet)
Seat 6: whiskey732 folded before Flop (didn't bet)
Seat 7: Richard_KONO folded before Flop (didn't bet)
Seat 8: Lucie686979 folded before Flop (didn't bet)
Seat 9: camcf63 (button) folded before Flop (didn't bet)



PokerStars Hand #221591571227: Tournament #3079328305, $0.91+$0.09 USD Hold'em No Limit - Level VI (80/160) - 2020/12/19 2:10:54 EET [2020/12/18 19:10:54 ET]
Table '3079328305 5' 9-max Seat #1 is the button
Seat 1: m55uu (2509 in chips) 
Seat 2: jcarlos.vale (4313 in chips) 
Seat 3: adabrakadabra (5636 in chips) 
Seat 4: billyjoe9999 (2227 in chips) 
Seat 6: whiskey732 (6009 in chips) 
Seat 7: Richard_KONO (1267 in chips) 
Seat 8: Lucie686979 (608 in chips) is sitting out
Seat 9: camcf63 (7203 in chips) 
m55uu: posts the ante 20
jcarlos.vale: posts the ante 20
adabrakadabra: posts the ante 20
billyjoe9999: posts the ante 20
whiskey732: posts the ante 20
Richard_KONO: posts the ante 20
Lucie686979: posts the ante 20
camcf63: posts the ante 20
jcarlos.vale: posts small blind 80
adabrakadabra: posts big blind 160
*** HOLE CARDS ***
Dealt to jcarlos.vale [3s Ad]
billyjoe9999: calls 160
whiskey732: folds 
Richard_KONO: folds 
Lucie686979: folds 
camcf63: folds 
m55uu: folds 
jcarlos.vale: calls 80
adabrakadabra: checks 
*** FLOP *** [8d Jc 5s]
jcarlos.vale: checks 
adabrakadabra: checks 
billyjoe9999: checks 
*** TURN *** [8d Jc 5s] [Qs]
jcarlos.vale: checks 
adabrakadabra: checks 
billyjoe9999: bets 160
jcarlos.vale: folds 
adabrakadabra: folds 
Uncalled bet (160) returned to billyjoe9999
billyjoe9999 collected 640 from pot
billyjoe9999: doesn't show handDTO
*** SUMMARY ***
Total pot 640 | Rake 0 
Board [8d Jc 5s Qs]
Seat 1: m55uu (button) folded before Flop (didn't bet)
Seat 2: jcarlos.vale (small blind) folded on the Turn
Seat 3: adabrakadabra (big blind) folded on the Turn
Seat 4: billyjoe9999 collected (640)
Seat 6: whiskey732 folded before Flop (didn't bet)
Seat 7: Richard_KONO folded before Flop (didn't bet)
Seat 8: Lucie686979 folded before Flop (didn't bet)
Seat 9: camcf63 folded before Flop (didn't bet)



PokerStars Hand #221591612256: Tournament #3079328305, $0.91+$0.09 USD Hold'em No Limit - Level VI (80/160) - 2020/12/19 2:12:09 EET [2020/12/18 19:12:09 ET]
Table '3079328305 5' 9-max Seat #2 is the button
Seat 1: m55uu (2489 in chips) 
Seat 2: jcarlos.vale (4133 in chips) 
Seat 3: adabrakadabra (5456 in chips) 
Seat 4: billyjoe9999 (2687 in chips) 
Seat 6: whiskey732 (5989 in chips) 
Seat 7: Richard_KONO (1247 in chips) 
Seat 8: Lucie686979 (588 in chips) is sitting out
Seat 9: camcf63 (7183 in chips) 
m55uu: posts the ante 20
jcarlos.vale: posts the ante 20
adabrakadabra: posts the ante 20
billyjoe9999: posts the ante 20
whiskey732: posts the ante 20
Richard_KONO: posts the ante 20
Lucie686979: posts the ante 20
camcf63: posts the ante 20
adabrakadabra: posts small blind 80
billyjoe9999: posts big blind 160
*** HOLE CARDS ***
Dealt to jcarlos.vale [8h 2s]
whiskey732: folds 
Richard_KONO: folds 
Lucie686979: folds 
camcf63: raises 400 to 560
m55uu: folds 
jcarlos.vale: folds 
adabrakadabra: folds 
billyjoe9999: folds 
Uncalled bet (400) returned to camcf63
camcf63 collected 560 from pot
*** SUMMARY ***
Total pot 560 | Rake 0 
Seat 1: m55uu folded before Flop (didn't bet)
Seat 2: jcarlos.vale (button) folded before Flop (didn't bet)
Seat 3: adabrakadabra (small blind) folded before Flop
Seat 4: billyjoe9999 (big blind) folded before Flop
Seat 6: whiskey732 folded before Flop (didn't bet)
Seat 7: Richard_KONO folded before Flop (didn't bet)
Seat 8: Lucie686979 folded before Flop (didn't bet)
Seat 9: camcf63 collected (560)



PokerStars Hand #221591627016: Tournament #3079328305, $0.91+$0.09 USD Hold'em No Limit - Level VI (80/160) - 2020/12/19 2:12:37 EET [2020/12/18 19:12:37 ET]
Table '3079328305 5' 9-max Seat #3 is the button
Seat 1: m55uu (2469 in chips) 
Seat 2: jcarlos.vale (4113 in chips) 
Seat 3: adabrakadabra (5356 in chips) 
Seat 4: billyjoe9999 (2507 in chips) 
Seat 6: whiskey732 (5969 in chips) 
Seat 7: Richard_KONO (1227 in chips) 
Seat 8: Lucie686979 (568 in chips) is sitting out
Seat 9: camcf63 (7563 in chips) 
m55uu: posts the ante 20
jcarlos.vale: posts the ante 20
adabrakadabra: posts the ante 20
billyjoe9999: posts the ante 20
whiskey732: posts the ante 20
Richard_KONO: posts the ante 20
Lucie686979: posts the ante 20
camcf63: posts the ante 20
billyjoe9999: posts small blind 80
whiskey732: posts big blind 160
*** HOLE CARDS ***
Dealt to jcarlos.vale [Kc Ad]
Richard_KONO: folds 
Lucie686979: folds 
camcf63: folds 
m55uu: folds 
jcarlos.vale: raises 320 to 480
adabrakadabra: folds 
billyjoe9999: folds 
whiskey732: folds 
Uncalled bet (320) returned to jcarlos.vale
jcarlos.vale collected 560 from pot
jcarlos.vale: doesn't show handDTO
*** SUMMARY ***
Total pot 560 | Rake 0 
Seat 1: m55uu folded before Flop (didn't bet)
Seat 2: jcarlos.vale collected (560)
Seat 3: adabrakadabra (button) folded before Flop (didn't bet)
Seat 4: billyjoe9999 (small blind) folded before Flop
Seat 6: whiskey732 (big blind) folded before Flop
Seat 7: Richard_KONO folded before Flop (didn't bet)
Seat 8: Lucie686979 folded before Flop (didn't bet)
Seat 9: camcf63 folded before Flop (didn't bet)



PokerStars Hand #221591641157: Tournament #3079328305, $0.91+$0.09 USD Hold'em No Limit - Level VI (80/160) - 2020/12/19 2:13:04 EET [2020/12/18 19:13:04 ET]
Table '3079328305 5' 9-max Seat #4 is the button
Seat 1: m55uu (2449 in chips) 
Seat 2: jcarlos.vale (4493 in chips) 
Seat 3: adabrakadabra (5336 in chips) 
Seat 4: billyjoe9999 (2407 in chips) 
Seat 6: whiskey732 (5789 in chips) 
Seat 7: Richard_KONO (1207 in chips) 
Seat 8: Lucie686979 (548 in chips) is sitting out
Seat 9: camcf63 (7543 in chips) 
m55uu: posts the ante 20
jcarlos.vale: posts the ante 20
adabrakadabra: posts the ante 20
billyjoe9999: posts the ante 20
whiskey732: posts the ante 20
Richard_KONO: posts the ante 20
Lucie686979: posts the ante 20
camcf63: posts the ante 20
whiskey732: posts small blind 80
Richard_KONO: posts big blind 160
*** HOLE CARDS ***
Dealt to jcarlos.vale [6d Ah]
Lucie686979: folds 
camcf63: folds 
m55uu: folds 
jcarlos.vale: folds 
adabrakadabra: folds 
billyjoe9999: folds 
whiskey732: folds 
Uncalled bet (80) returned to Richard_KONO
Richard_KONO collected 320 from pot
Richard_KONO: doesn't show handDTO
*** SUMMARY ***
Total pot 320 | Rake 0 
Seat 1: m55uu folded before Flop (didn't bet)
Seat 2: jcarlos.vale folded before Flop (didn't bet)
Seat 3: adabrakadabra folded before Flop (didn't bet)
Seat 4: billyjoe9999 (button) folded before Flop (didn't bet)
Seat 6: whiskey732 (small blind) folded before Flop
Seat 7: Richard_KONO (big blind) collected (320)
Seat 8: Lucie686979 folded before Flop (didn't bet)
Seat 9: camcf63 folded before Flop (didn't bet)



PokerStars Hand #221591663482: Tournament #3079328305, $0.91+$0.09 USD Hold'em No Limit - Level VI (80/160) - 2020/12/19 2:13:47 EET [2020/12/18 19:13:47 ET]
Table '3079328305 5' 9-max Seat #6 is the button
Seat 1: m55uu (2429 in chips) 
Seat 2: jcarlos.vale (4473 in chips) 
Seat 3: adabrakadabra (5316 in chips) 
Seat 4: billyjoe9999 (2387 in chips) 
Seat 6: whiskey732 (5689 in chips) 
Seat 7: Richard_KONO (1427 in chips) 
Seat 8: Lucie686979 (528 in chips) is sitting out
Seat 9: camcf63 (7523 in chips) 
m55uu: posts the ante 20
jcarlos.vale: posts the ante 20
adabrakadabra: posts the ante 20
billyjoe9999: posts the ante 20
whiskey732: posts the ante 20
Richard_KONO: posts the ante 20
Lucie686979: posts the ante 20
camcf63: posts the ante 20
Richard_KONO: posts small blind 80
Lucie686979: posts big blind 160
*** HOLE CARDS ***
Dealt to jcarlos.vale [3h 3d]
camcf63: folds 
m55uu: folds 
jcarlos.vale: calls 160
adabrakadabra: folds 
billyjoe9999: folds 
whiskey732: folds 
Richard_KONO: calls 80
Lucie686979: folds 
*** FLOP *** [5s 4d Qd]
Richard_KONO: checks 
jcarlos.vale: bets 320
Richard_KONO: raises 927 to 1247 and is all-in
jcarlos.vale: folds 
Uncalled bet (927) returned to Richard_KONO
Richard_KONO collected 1280 from pot
Richard_KONO: doesn't show handDTO
*** SUMMARY ***
Total pot 1280 | Rake 0 
Board [5s 4d Qd]
Seat 1: m55uu folded before Flop (didn't bet)
Seat 2: jcarlos.vale folded on the Flop
Seat 3: adabrakadabra folded before Flop (didn't bet)
Seat 4: billyjoe9999 folded before Flop (didn't bet)
Seat 6: whiskey732 (button) folded before Flop (didn't bet)
Seat 7: Richard_KONO (small blind) collected (1280)
Seat 8: Lucie686979 (big blind) folded before Flop
Seat 9: camcf63 folded before Flop (didn't bet)



PokerStars Hand #221591684063: Tournament #3079328305, $0.91+$0.09 USD Hold'em No Limit - Level VI (80/160) - 2020/12/19 2:14:26 EET [2020/12/18 19:14:26 ET]
Table '3079328305 5' 9-max Seat #7 is the button
Seat 1: m55uu (2409 in chips) 
Seat 2: jcarlos.vale (3973 in chips) 
Seat 3: adabrakadabra (5296 in chips) 
Seat 4: billyjoe9999 (2367 in chips) 
Seat 6: whiskey732 (5669 in chips) 
Seat 7: Richard_KONO (2207 in chips) 
Seat 8: Lucie686979 (348 in chips) is sitting out
Seat 9: camcf63 (7503 in chips) 
m55uu: posts the ante 20
jcarlos.vale: posts the ante 20
adabrakadabra: posts the ante 20
billyjoe9999: posts the ante 20
whiskey732: posts the ante 20
Richard_KONO: posts the ante 20
Lucie686979: posts the ante 20
camcf63: posts the ante 20
Lucie686979: posts small blind 80
camcf63: posts big blind 160
*** HOLE CARDS ***
Dealt to jcarlos.vale [8d 5s]
m55uu: folds 
jcarlos.vale: folds 
adabrakadabra: folds 
billyjoe9999: folds 
whiskey732: folds 
Richard_KONO: folds 
Lucie686979: folds 
Uncalled bet (80) returned to camcf63
camcf63 collected 320 from pot
*** SUMMARY ***
Total pot 320 | Rake 0 
Seat 1: m55uu folded before Flop (didn't bet)
Seat 2: jcarlos.vale folded before Flop (didn't bet)
Seat 3: adabrakadabra folded before Flop (didn't bet)
Seat 4: billyjoe9999 folded before Flop (didn't bet)
Seat 6: whiskey732 folded before Flop (didn't bet)
Seat 7: Richard_KONO (button) folded before Flop (didn't bet)
Seat 8: Lucie686979 (small blind) folded before Flop
Seat 9: camcf63 (big blind) collected (320)



PokerStars Hand #221591696451: Tournament #3079328305, $0.91+$0.09 USD Hold'em No Limit - Level VI (80/160) - 2020/12/19 2:14:50 EET [2020/12/18 19:14:50 ET]
Table '3079328305 5' 9-max Seat #8 is the button
Seat 1: m55uu (2389 in chips) 
Seat 2: jcarlos.vale (3953 in chips) 
Seat 3: adabrakadabra (5276 in chips) 
Seat 4: billyjoe9999 (2347 in chips) 
Seat 6: whiskey732 (5649 in chips) 
Seat 7: Richard_KONO (2187 in chips) 
Seat 8: Lucie686979 (248 in chips) is sitting out
Seat 9: camcf63 (7723 in chips) 
m55uu: posts the ante 20
jcarlos.vale: posts the ante 20
adabrakadabra: posts the ante 20
billyjoe9999: posts the ante 20
whiskey732: posts the ante 20
Richard_KONO: posts the ante 20
Lucie686979: posts the ante 20
camcf63: posts the ante 20
camcf63: posts small blind 80
m55uu: posts big blind 160
*** HOLE CARDS ***
Dealt to jcarlos.vale [Jc Tc]
jcarlos.vale: raises 256 to 416
adabrakadabra: folds 
billyjoe9999: folds 
whiskey732: folds 
Richard_KONO: folds 
Lucie686979: folds 
camcf63: raises 256 to 672
m55uu: folds 
jcarlos.vale: calls 256
*** FLOP *** [2c Qh Qc]
camcf63: bets 499
jcarlos.vale: raises 2762 to 3261 and is all-in
camcf63: folds 
Uncalled bet (2762) returned to jcarlos.vale
jcarlos.vale collected 2662 from pot
jcarlos.vale: doesn't show handDTO
*** SUMMARY ***
Total pot 2662 | Rake 0 
Board [2c Qh Qc]
Seat 1: m55uu (big blind) folded before Flop
Seat 2: jcarlos.vale collected (2662)
Seat 3: adabrakadabra folded before Flop (didn't bet)
Seat 4: billyjoe9999 folded before Flop (didn't bet)
Seat 6: whiskey732 folded before Flop (didn't bet)
Seat 7: Richard_KONO folded before Flop (didn't bet)
Seat 8: Lucie686979 (button) folded before Flop (didn't bet)
Seat 9: camcf63 (small blind) folded on the Flop



PokerStars Hand #221591734065: Tournament #3079328305, $0.91+$0.09 USD Hold'em No Limit - Level VI (80/160) - 2020/12/19 2:16:03 EET [2020/12/18 19:16:03 ET]
Table '3079328305 5' 9-max Seat #9 is the button
Seat 1: m55uu (2209 in chips) 
Seat 2: jcarlos.vale (5424 in chips) 
Seat 3: adabrakadabra (5256 in chips) 
Seat 4: billyjoe9999 (2327 in chips) 
Seat 6: whiskey732 (5629 in chips) 
Seat 7: Richard_KONO (2167 in chips) 
Seat 8: Lucie686979 (228 in chips) is sitting out
Seat 9: camcf63 (6532 in chips) 
m55uu: posts the ante 20
jcarlos.vale: posts the ante 20
adabrakadabra: posts the ante 20
billyjoe9999: posts the ante 20
whiskey732: posts the ante 20
Richard_KONO: posts the ante 20
Lucie686979: posts the ante 20
camcf63: posts the ante 20
m55uu: posts small blind 80
jcarlos.vale: posts big blind 160
*** HOLE CARDS ***
Dealt to jcarlos.vale [8s 4d]
adabrakadabra: folds 
billyjoe9999: folds 
whiskey732: folds 
Richard_KONO: folds 
Lucie686979: folds 
camcf63: raises 160 to 320
m55uu: folds 
jcarlos.vale: folds 
Uncalled bet (160) returned to camcf63
camcf63 collected 560 from pot
*** SUMMARY ***
Total pot 560 | Rake 0 
Seat 1: m55uu (small blind) folded before Flop
Seat 2: jcarlos.vale (big blind) folded before Flop
Seat 3: adabrakadabra folded before Flop (didn't bet)
Seat 4: billyjoe9999 folded before Flop (didn't bet)
Seat 6: whiskey732 folded before Flop (didn't bet)
Seat 7: Richard_KONO folded before Flop (didn't bet)
Seat 8: Lucie686979 folded before Flop (didn't bet)
Seat 9: camcf63 (button) collected (560)



PokerStars Hand #221591757982: Tournament #3079328305, $0.91+$0.09 USD Hold'em No Limit - Level VI (80/160) - 2020/12/19 2:16:30 EET [2020/12/18 19:16:30 ET]
Table '3079328305 5' 9-max Seat #1 is the button
Seat 1: m55uu (2109 in chips) 
Seat 2: jcarlos.vale (5244 in chips) 
Seat 3: adabrakadabra (5236 in chips) 
Seat 4: billyjoe9999 (2307 in chips) 
Seat 6: whiskey732 (5609 in chips) 
Seat 7: Richard_KONO (2147 in chips) 
Seat 8: Lucie686979 (208 in chips) is sitting out
Seat 9: camcf63 (6912 in chips) 
m55uu: posts the ante 20
jcarlos.vale: posts the ante 20
adabrakadabra: posts the ante 20
billyjoe9999: posts the ante 20
whiskey732: posts the ante 20
Richard_KONO: posts the ante 20
Lucie686979: posts the ante 20
camcf63: posts the ante 20
jcarlos.vale: posts small blind 80
adabrakadabra: posts big blind 160
*** HOLE CARDS ***
Dealt to jcarlos.vale [Th 3c]
billyjoe9999: folds 
whiskey732: folds 
Richard_KONO: folds 
Lucie686979: folds 
camcf63: folds 
m55uu: raises 1929 to 2089 and is all-in
jcarlos.vale: folds 
adabrakadabra: folds 
Uncalled bet (1929) returned to m55uu
m55uu collected 560 from pot
*** SUMMARY ***
Total pot 560 | Rake 0 
Seat 1: m55uu (button) collected (560)
Seat 2: jcarlos.vale (small blind) folded before Flop
Seat 3: adabrakadabra (big blind) folded before Flop
Seat 4: billyjoe9999 folded before Flop (didn't bet)
Seat 6: whiskey732 folded before Flop (didn't bet)
Seat 7: Richard_KONO folded before Flop (didn't bet)
Seat 8: Lucie686979 folded before Flop (didn't bet)
Seat 9: camcf63 folded before Flop (didn't bet)



PokerStars Hand #221591772097: Tournament #3079328305, $0.91+$0.09 USD Hold'em No Limit - Level VI (80/160) - 2020/12/19 2:16:57 EET [2020/12/18 19:16:57 ET]
Table '3079328305 5' 9-max Seat #2 is the button
Seat 1: m55uu (2489 in chips) 
Seat 2: jcarlos.vale (5144 in chips) 
Seat 3: adabrakadabra (5056 in chips) 
Seat 4: billyjoe9999 (2287 in chips) 
Seat 6: whiskey732 (5589 in chips) 
Seat 7: Richard_KONO (2127 in chips) 
Seat 8: Lucie686979 (188 in chips) is sitting out
Seat 9: camcf63 (6892 in chips) 
m55uu: posts the ante 20
jcarlos.vale: posts the ante 20
adabrakadabra: posts the ante 20
billyjoe9999: posts the ante 20
whiskey732: posts the ante 20
Richard_KONO: posts the ante 20
Lucie686979: posts the ante 20
camcf63: posts the ante 20
adabrakadabra: posts small blind 80
billyjoe9999: posts big blind 160
*** HOLE CARDS ***
Dealt to jcarlos.vale [Jc 4c]
whiskey732: folds 
Richard_KONO: folds 
Lucie686979: folds 
camcf63: folds 
m55uu: folds 
jcarlos.vale: folds 
adabrakadabra: raises 4876 to 5036 and is all-in
billyjoe9999: folds 
Uncalled bet (4876) returned to adabrakadabra
adabrakadabra collected 480 from pot
*** SUMMARY ***
Total pot 480 | Rake 0 
Seat 1: m55uu folded before Flop (didn't bet)
Seat 2: jcarlos.vale (button) folded before Flop (didn't bet)
Seat 3: adabrakadabra (small blind) collected (480)
Seat 4: billyjoe9999 (big blind) folded before Flop
Seat 6: whiskey732 folded before Flop (didn't bet)
Seat 7: Richard_KONO folded before Flop (didn't bet)
Seat 8: Lucie686979 folded before Flop (didn't bet)
Seat 9: camcf63 folded before Flop (didn't bet)



PokerStars Hand #221591793296: Tournament #3079328305, $0.91+$0.09 USD Hold'em No Limit - Level VI (80/160) - 2020/12/19 2:17:24 EET [2020/12/18 19:17:24 ET]
Table '3079328305 5' 9-max Seat #3 is the button
Seat 1: m55uu (2469 in chips) 
Seat 2: jcarlos.vale (5124 in chips) 
Seat 3: adabrakadabra (5356 in chips) 
Seat 4: billyjoe9999 (2107 in chips) 
Seat 6: whiskey732 (5569 in chips) 
Seat 7: Richard_KONO (2107 in chips) 
Seat 8: Lucie686979 (168 in chips) is sitting out
Seat 9: camcf63 (6872 in chips) 
m55uu: posts the ante 20
jcarlos.vale: posts the ante 20
adabrakadabra: posts the ante 20
billyjoe9999: posts the ante 20
whiskey732: posts the ante 20
Richard_KONO: posts the ante 20
Lucie686979: posts the ante 20
camcf63: posts the ante 20
billyjoe9999: posts small blind 80
whiskey732: posts big blind 160
*** HOLE CARDS ***
Dealt to jcarlos.vale [5d 5s]
Richard_KONO: folds 
Lucie686979: folds 
camcf63: folds 
m55uu: folds 
jcarlos.vale: raises 256 to 416
adabrakadabra: folds 
billyjoe9999: calls 336
whiskey732: folds 
*** FLOP *** [Kh 9s Kd]
billyjoe9999: bets 160
jcarlos.vale: calls 160
*** TURN *** [Kh 9s Kd] [2s]
billyjoe9999: bets 160
jcarlos.vale: calls 160
*** RIVER *** [Kh 9s Kd 2s] [Td]
billyjoe9999: checks 
jcarlos.vale: checks 
*** SHOW DOWN ***
billyjoe9999: shows [Ts Js] (two pair, Kings and Tens)
jcarlos.vale: mucks handDTO
billyjoe9999 collected 1792 from pot
*** SUMMARY ***
Total pot 1792 | Rake 0 
Board [Kh 9s Kd 2s Td]
Seat 1: m55uu folded before Flop (didn't bet)
Seat 2: jcarlos.vale mucked [5d 5s]
Seat 3: adabrakadabra (button) folded before Flop (didn't bet)
Seat 4: billyjoe9999 (small blind) showed [Ts Js] and won (1792) with two pair, Kings and Tens
Seat 6: whiskey732 (big blind) folded before Flop
Seat 7: Richard_KONO folded before Flop (didn't bet)
Seat 8: Lucie686979 folded before Flop (didn't bet)
Seat 9: camcf63 folded before Flop (didn't bet)



PokerStars Hand #221591823587: Tournament #3079328305, $0.91+$0.09 USD Hold'em No Limit - Level VII (100/200) - 2020/12/19 2:18:22 EET [2020/12/18 19:18:22 ET]
Table '3079328305 5' 9-max Seat #4 is the button
Seat 1: m55uu (2449 in chips) 
Seat 2: jcarlos.vale (4368 in chips) 
Seat 3: adabrakadabra (5336 in chips) 
Seat 4: billyjoe9999 (3143 in chips) 
Seat 6: whiskey732 (5389 in chips) 
Seat 7: Richard_KONO (2087 in chips) 
Seat 8: Lucie686979 (148 in chips) is sitting out
Seat 9: camcf63 (6852 in chips) 
m55uu: posts the ante 25
jcarlos.vale: posts the ante 25
adabrakadabra: posts the ante 25
billyjoe9999: posts the ante 25
whiskey732: posts the ante 25
Richard_KONO: posts the ante 25
Lucie686979: posts the ante 25
camcf63: posts the ante 25
whiskey732: posts small blind 100
Richard_KONO: posts big blind 200
*** HOLE CARDS ***
Dealt to jcarlos.vale [2s 2c]
Lucie686979: folds 
camcf63: folds 
m55uu: folds 
jcarlos.vale: folds 
adabrakadabra: folds 
billyjoe9999: folds 
whiskey732: folds 
Uncalled bet (100) returned to Richard_KONO
Richard_KONO collected 400 from pot
Richard_KONO: doesn't show handDTO
*** SUMMARY ***
Total pot 400 | Rake 0 
Seat 1: m55uu folded before Flop (didn't bet)
Seat 2: jcarlos.vale folded before Flop (didn't bet)
Seat 3: adabrakadabra folded before Flop (didn't bet)
Seat 4: billyjoe9999 (button) folded before Flop (didn't bet)
Seat 6: whiskey732 (small blind) folded before Flop
Seat 7: Richard_KONO (big blind) collected (400)
Seat 8: Lucie686979 folded before Flop (didn't bet)
Seat 9: camcf63 folded before Flop (didn't bet)



PokerStars Hand #221591835738: Tournament #3079328305, $0.91+$0.09 USD Hold'em No Limit - Level VII (100/200) - 2020/12/19 2:18:46 EET [2020/12/18 19:18:46 ET]
Table '3079328305 5' 9-max Seat #6 is the button
Seat 1: m55uu (2424 in chips) 
Seat 2: jcarlos.vale (4343 in chips) 
Seat 3: adabrakadabra (5311 in chips) 
Seat 4: billyjoe9999 (3118 in chips) 
Seat 6: whiskey732 (5264 in chips) 
Seat 7: Richard_KONO (2362 in chips) 
Seat 8: Lucie686979 (123 in chips) is sitting out
Seat 9: camcf63 (6827 in chips) 
m55uu: posts the ante 25
jcarlos.vale: posts the ante 25
adabrakadabra: posts the ante 25
billyjoe9999: posts the ante 25
whiskey732: posts the ante 25
Richard_KONO: posts the ante 25
Lucie686979: posts the ante 25
camcf63: posts the ante 25
Richard_KONO: posts small blind 100
Lucie686979: posts big blind 98 and is all-in
*** HOLE CARDS ***
Dealt to jcarlos.vale [6h 2s]
camcf63: folds 
m55uu: folds 
jcarlos.vale: folds 
adabrakadabra: folds 
billyjoe9999: folds 
whiskey732: calls 200
Richard_KONO: raises 2137 to 2337 and is all-in
Lucie686979: folds 
whiskey732: folds 
Uncalled bet (2137) returned to Richard_KONO
Richard_KONO collected 698 from pot
Lucie686979 finished the tournament in 16th place
Richard_KONO: doesn't show handDTO
*** SUMMARY ***
Total pot 698 | Rake 0 
Seat 1: m55uu folded before Flop (didn't bet)
Seat 2: jcarlos.vale folded before Flop (didn't bet)
Seat 3: adabrakadabra folded before Flop (didn't bet)
Seat 4: billyjoe9999 folded before Flop (didn't bet)
Seat 6: whiskey732 (button) folded before Flop
Seat 7: Richard_KONO (small blind) collected (698)
Seat 8: Lucie686979 (big blind) folded before Flop
Seat 9: camcf63 folded before Flop (didn't bet)



PokerStars Hand #221591855785: Tournament #3079328305, $0.91+$0.09 USD Hold'em No Limit - Level VII (100/200) - 2020/12/19 2:19:24 EET [2020/12/18 19:19:24 ET]
Table '3079328305 5' 9-max Seat #7 is the button
Seat 1: m55uu (2399 in chips) 
Seat 2: jcarlos.vale (4318 in chips) 
Seat 3: adabrakadabra (5286 in chips) 
Seat 4: billyjoe9999 (3093 in chips) 
Seat 6: whiskey732 (5039 in chips) 
Seat 7: Richard_KONO (2835 in chips) 
Seat 9: camcf63 (6802 in chips) 
m55uu: posts the ante 25
jcarlos.vale: posts the ante 25
adabrakadabra: posts the ante 25
billyjoe9999: posts the ante 25
whiskey732: posts the ante 25
Richard_KONO: posts the ante 25
camcf63: posts the ante 25
camcf63: posts small blind 100
m55uu: posts big blind 200
*** HOLE CARDS ***
Dealt to jcarlos.vale [9h Kd]
jcarlos.vale: folds 
adabrakadabra: folds 
billyjoe9999: folds 
whiskey732: folds 
Richard_KONO: folds 
camcf63: raises 200 to 400
m55uu: calls 200
*** FLOP *** [4d 2s Ac]
camcf63: bets 439
m55uu: folds 
Uncalled bet (439) returned to camcf63
camcf63 collected 975 from pot
*** SUMMARY ***
Total pot 975 | Rake 0 
Board [4d 2s Ac]
Seat 1: m55uu (big blind) folded on the Flop
Seat 2: jcarlos.vale folded before Flop (didn't bet)
Seat 3: adabrakadabra folded before Flop (didn't bet)
Seat 4: billyjoe9999 folded before Flop (didn't bet)
Seat 6: whiskey732 folded before Flop (didn't bet)
Seat 7: Richard_KONO (button) folded before Flop (didn't bet)
Seat 9: camcf63 (small blind) collected (975)



PokerStars Hand #221591877687: Tournament #3079328305, $0.91+$0.09 USD Hold'em No Limit - Level VII (100/200) - 2020/12/19 2:20:07 EET [2020/12/18 19:20:07 ET]
Table '3079328305 5' 9-max Seat #9 is the button
Seat 1: m55uu (1974 in chips) 
Seat 2: jcarlos.vale (4293 in chips) 
Seat 3: adabrakadabra (5261 in chips) 
Seat 4: billyjoe9999 (3068 in chips) 
Seat 6: whiskey732 (5014 in chips) 
Seat 7: Richard_KONO (2810 in chips) 
Seat 9: camcf63 (7352 in chips) 
m55uu: posts the ante 25
jcarlos.vale: posts the ante 25
adabrakadabra: posts the ante 25
billyjoe9999: posts the ante 25
whiskey732: posts the ante 25
Richard_KONO: posts the ante 25
camcf63: posts the ante 25
m55uu: posts small blind 100
jcarlos.vale: posts big blind 200
*** HOLE CARDS ***
Dealt to jcarlos.vale [Jd 7c]
adabrakadabra: folds 
billyjoe9999: folds 
whiskey732: calls 200
Richard_KONO: folds 
camcf63: folds 
m55uu: raises 1749 to 1949 and is all-in
jcarlos.vale: folds 
whiskey732: calls 1749
*** FLOP *** [8d Tc 4c]
*** TURN *** [8d Tc 4c] [Qc]
*** RIVER *** [8d Tc 4c Qc] [7h]
*** SHOW DOWN ***
m55uu: shows [Qs Ah] (a pair of Queens)
whiskey732: shows [Kc Jc] (a flush, King high)
whiskey732 collected 4273 from pot
m55uu finished the tournament in 15th place
*** SUMMARY ***
Total pot 4273 | Rake 0 
Board [8d Tc 4c Qc 7h]
Seat 1: m55uu (small blind) showed [Qs Ah] and lost with a pair of Queens
Seat 2: jcarlos.vale (big blind) folded before Flop
Seat 3: adabrakadabra folded before Flop (didn't bet)
Seat 4: billyjoe9999 folded before Flop (didn't bet)
Seat 6: whiskey732 showed [Kc Jc] and won (4273) with a flush, King high
Seat 7: Richard_KONO folded before Flop (didn't bet)
Seat 9: camcf63 (button) folded before Flop (didn't bet)



PokerStars Hand #221591901245: Tournament #3079328305, $0.91+$0.09 USD Hold'em No Limit - Level VII (100/200) - 2020/12/19 2:20:53 EET [2020/12/18 19:20:53 ET]
Table '3079328305 5' 9-max Seat #2 is the button
Seat 2: jcarlos.vale (4068 in chips) 
Seat 3: adabrakadabra (5236 in chips) 
Seat 4: billyjoe9999 (3043 in chips) 
Seat 6: whiskey732 (7313 in chips) 
Seat 7: Richard_KONO (2785 in chips) 
Seat 9: camcf63 (7327 in chips) 
jcarlos.vale: posts the ante 25
adabrakadabra: posts the ante 25
billyjoe9999: posts the ante 25
whiskey732: posts the ante 25
Richard_KONO: posts the ante 25
camcf63: posts the ante 25
adabrakadabra: posts small blind 100
billyjoe9999: posts big blind 200
*** HOLE CARDS ***
Dealt to jcarlos.vale [9d 2h]
whiskey732: raises 650 to 850
Richard_KONO: folds 
camcf63: folds 
jcarlos.vale: folds 
adabrakadabra: folds 
billyjoe9999: folds 
Uncalled bet (650) returned to whiskey732
whiskey732 collected 650 from pot
*** SUMMARY ***
Total pot 650 | Rake 0 
Seat 2: jcarlos.vale (button) folded before Flop (didn't bet)
Seat 3: adabrakadabra (small blind) folded before Flop
Seat 4: billyjoe9999 (big blind) folded before Flop
Seat 6: whiskey732 collected (650)
Seat 7: Richard_KONO folded before Flop (didn't bet)
Seat 9: camcf63 folded before Flop (didn't bet)



PokerStars Hand #221591912862: Tournament #3079328305, $0.91+$0.09 USD Hold'em No Limit - Level VII (100/200) - 2020/12/19 2:21:16 EET [2020/12/18 19:21:16 ET]
Table '3079328305 5' 9-max Seat #3 is the button
Seat 2: jcarlos.vale (4043 in chips) 
Seat 3: adabrakadabra (5111 in chips) 
Seat 4: billyjoe9999 (2818 in chips) 
Seat 6: whiskey732 (7738 in chips) 
Seat 7: Richard_KONO (2760 in chips) 
Seat 9: camcf63 (7302 in chips) 
jcarlos.vale: posts the ante 25
adabrakadabra: posts the ante 25
billyjoe9999: posts the ante 25
whiskey732: posts the ante 25
Richard_KONO: posts the ante 25
camcf63: posts the ante 25
billyjoe9999: posts small blind 100
whiskey732: posts big blind 200
*** HOLE CARDS ***
Dealt to jcarlos.vale [9h 6s]
Richard_KONO: folds 
camcf63: folds 
jcarlos.vale: folds 
adabrakadabra: folds 
billyjoe9999: folds 
Uncalled bet (100) returned to whiskey732
whiskey732 collected 350 from pot
*** SUMMARY ***
Total pot 350 | Rake 0 
Seat 2: jcarlos.vale folded before Flop (didn't bet)
Seat 3: adabrakadabra (button) folded before Flop (didn't bet)
Seat 4: billyjoe9999 (small blind) folded before Flop
Seat 6: whiskey732 (big blind) collected (350)
Seat 7: Richard_KONO folded before Flop (didn't bet)
Seat 9: camcf63 folded before Flop (didn't bet)



PokerStars Hand #221591921921: Tournament #3079328305, $0.91+$0.09 USD Hold'em No Limit - Level VII (100/200) - 2020/12/19 2:21:34 EET [2020/12/18 19:21:34 ET]
Table '3079328305 5' 9-max Seat #4 is the button
Seat 2: jcarlos.vale (4018 in chips) 
Seat 3: adabrakadabra (5086 in chips) 
Seat 4: billyjoe9999 (2693 in chips) 
Seat 6: whiskey732 (7963 in chips) 
Seat 7: Richard_KONO (2735 in chips) 
Seat 9: camcf63 (7277 in chips) 
jcarlos.vale: posts the ante 25
adabrakadabra: posts the ante 25
billyjoe9999: posts the ante 25
whiskey732: posts the ante 25
Richard_KONO: posts the ante 25
camcf63: posts the ante 25
whiskey732: posts small blind 100
Richard_KONO: posts big blind 200
*** HOLE CARDS ***
Dealt to jcarlos.vale [Qh As]
camcf63: raises 200 to 400
jcarlos.vale: raises 3593 to 3993 and is all-in
adabrakadabra: folds 
billyjoe9999: folds 
whiskey732: folds 
Richard_KONO: folds 
camcf63: folds 
Uncalled bet (3593) returned to jcarlos.vale
jcarlos.vale collected 1250 from pot
jcarlos.vale: doesn't show handDTO
*** SUMMARY ***
Total pot 1250 | Rake 0 
Seat 2: jcarlos.vale collected (1250)
Seat 3: adabrakadabra folded before Flop (didn't bet)
Seat 4: billyjoe9999 (button) folded before Flop (didn't bet)
Seat 6: whiskey732 (small blind) folded before Flop
Seat 7: Richard_KONO (big blind) folded before Flop
Seat 9: camcf63 folded before Flop



PokerStars Hand #221591932089: Tournament #3079328305, $0.91+$0.09 USD Hold'em No Limit - Level VII (100/200) - 2020/12/19 2:21:54 EET [2020/12/18 19:21:54 ET]
Table '3079328305 5' 9-max Seat #6 is the button
Seat 2: jcarlos.vale (4843 in chips) 
Seat 3: adabrakadabra (5061 in chips) 
Seat 4: billyjoe9999 (2668 in chips) 
Seat 6: whiskey732 (7838 in chips) 
Seat 7: Richard_KONO (2510 in chips) 
Seat 9: camcf63 (6852 in chips) 
jcarlos.vale: posts the ante 25
adabrakadabra: posts the ante 25
billyjoe9999: posts the ante 25
whiskey732: posts the ante 25
Richard_KONO: posts the ante 25
camcf63: posts the ante 25
Richard_KONO: posts small blind 100
camcf63: posts big blind 200
*** HOLE CARDS ***
Dealt to jcarlos.vale [3d 4h]
jcarlos.vale: folds 
adabrakadabra: folds 
billyjoe9999: folds 
whiskey732: folds 
Richard_KONO: raises 2285 to 2485 and is all-in
camcf63: folds 
Uncalled bet (2285) returned to Richard_KONO
Richard_KONO collected 550 from pot
Richard_KONO: doesn't show handDTO
*** SUMMARY ***
Total pot 550 | Rake 0 
Seat 2: jcarlos.vale folded before Flop (didn't bet)
Seat 3: adabrakadabra folded before Flop (didn't bet)
Seat 4: billyjoe9999 folded before Flop (didn't bet)
Seat 6: whiskey732 (button) folded before Flop (didn't bet)
Seat 7: Richard_KONO (small blind) collected (550)
Seat 9: camcf63 (big blind) folded before Flop



PokerStars Hand #221591943763: Tournament #3079328305, $0.91+$0.09 USD Hold'em No Limit - Level VII (100/200) - 2020/12/19 2:22:17 EET [2020/12/18 19:22:17 ET]
Table '3079328305 5' 9-max Seat #7 is the button
Seat 2: jcarlos.vale (4818 in chips) 
Seat 3: adabrakadabra (5036 in chips) 
Seat 4: billyjoe9999 (2643 in chips) 
Seat 6: whiskey732 (7813 in chips) 
Seat 7: Richard_KONO (2835 in chips) 
Seat 9: camcf63 (6627 in chips) 
jcarlos.vale: posts the ante 25
adabrakadabra: posts the ante 25
billyjoe9999: posts the ante 25
whiskey732: posts the ante 25
Richard_KONO: posts the ante 25
camcf63: posts the ante 25
camcf63: posts small blind 100
jcarlos.vale: posts big blind 200
*** HOLE CARDS ***
Dealt to jcarlos.vale [Qh Qd]
adabrakadabra: folds 
billyjoe9999: calls 200
whiskey732: folds 
Richard_KONO: folds 
camcf63: calls 100
jcarlos.vale: raises 320 to 520
billyjoe9999: calls 320
camcf63: folds 
*** FLOP *** [3c 7s Td]
jcarlos.vale: bets 1043
billyjoe9999: raises 1043 to 2086
jcarlos.vale: raises 2187 to 4273 and is all-in
billyjoe9999: calls 12 and is all-in
Uncalled bet (2175) returned to jcarlos.vale
*** TURN *** [3c 7s Td] [9h]
*** RIVER *** [3c 7s Td 9h] [8s]
*** SHOW DOWN ***
jcarlos.vale: shows [Qh Qd] (a pair of Queens)
billyjoe9999: shows [Ad 3d] (a pair of Threes)
jcarlos.vale collected 5586 from pot
billyjoe9999 finished the tournament in 12th place
*** SUMMARY ***
Total pot 5586 | Rake 0 
Board [3c 7s Td 9h 8s]
Seat 2: jcarlos.vale (big blind) showed [Qh Qd] and won (5586) with a pair of Queens
Seat 3: adabrakadabra folded before Flop (didn't bet)
Seat 4: billyjoe9999 showed [Ad 3d] and lost with a pair of Threes
Seat 6: whiskey732 folded before Flop (didn't bet)
Seat 7: Richard_KONO (button) folded before Flop (didn't bet)
Seat 9: camcf63 (small blind) folded before Flop



PokerStars Hand #221591975800: Tournament #3079328305, $0.91+$0.09 USD Hold'em No Limit - Level VII (100/200) - 2020/12/19 2:23:20 EET [2020/12/18 19:23:20 ET]
Table '3079328305 5' 9-max Seat #9 is the button
Seat 2: jcarlos.vale (7761 in chips) 
Seat 3: adabrakadabra (5011 in chips) 
Seat 6: whiskey732 (7788 in chips) 
Seat 7: Richard_KONO (2810 in chips) 
Seat 9: camcf63 (6402 in chips) 
jcarlos.vale: posts the ante 25
adabrakadabra: posts the ante 25
whiskey732: posts the ante 25
Richard_KONO: posts the ante 25
camcf63: posts the ante 25
jcarlos.vale: posts small blind 100
adabrakadabra: posts big blind 200
*** HOLE CARDS ***
Dealt to jcarlos.vale [8c 4c]
whiskey732: folds 
Richard_KONO: folds 
camcf63: folds 
jcarlos.vale: folds 
Uncalled bet (100) returned to adabrakadabra
adabrakadabra collected 325 from pot
*** SUMMARY ***
Total pot 325 | Rake 0 
Seat 2: jcarlos.vale (small blind) folded before Flop
Seat 3: adabrakadabra (big blind) collected (325)
Seat 6: whiskey732 folded before Flop (didn't bet)
Seat 7: Richard_KONO folded before Flop (didn't bet)
Seat 9: camcf63 (button) folded before Flop (didn't bet)



PokerStars Hand #221591989537: Tournament #3079328305, $0.91+$0.09 USD Hold'em No Limit - Level VII (100/200) - 2020/12/19 2:23:48 EET [2020/12/18 19:23:48 ET]
Table '3079328305 5' 9-max Seat #2 is the button
Seat 2: jcarlos.vale (7636 in chips) 
Seat 3: adabrakadabra (5211 in chips) 
Seat 6: whiskey732 (7763 in chips) 
Seat 7: Richard_KONO (2785 in chips) 
Seat 9: camcf63 (6377 in chips) 
jcarlos.vale: posts the ante 25
adabrakadabra: posts the ante 25
whiskey732: posts the ante 25
Richard_KONO: posts the ante 25
camcf63: posts the ante 25
adabrakadabra: posts small blind 100
whiskey732: posts big blind 200
*** HOLE CARDS ***
Dealt to jcarlos.vale [Qs 5d]
Richard_KONO: raises 2560 to 2760 and is all-in
camcf63: folds 
jcarlos.vale: folds 
adabrakadabra: folds 
whiskey732: folds 
Uncalled bet (2560) returned to Richard_KONO
Richard_KONO collected 625 from pot
Richard_KONO: doesn't show handDTO
*** SUMMARY ***
Total pot 625 | Rake 0 
Seat 2: jcarlos.vale (button) folded before Flop (didn't bet)
Seat 3: adabrakadabra (small blind) folded before Flop
Seat 6: whiskey732 (big blind) folded before Flop
Seat 7: Richard_KONO collected (625)
Seat 9: camcf63 folded before Flop (didn't bet)



PokerStars Hand #221592003147: Tournament #3079328305, $0.91+$0.09 USD Hold'em No Limit - Level VII (100/200) - 2020/12/19 2:24:15 EET [2020/12/18 19:24:15 ET]
Table '3079328305 5' 9-max Seat #3 is the button
Seat 2: jcarlos.vale (7611 in chips) 
Seat 3: adabrakadabra (5086 in chips) 
Seat 6: whiskey732 (7538 in chips) 
Seat 7: Richard_KONO (3185 in chips) 
Seat 9: camcf63 (6352 in chips) 
jcarlos.vale: posts the ante 25
adabrakadabra: posts the ante 25
whiskey732: posts the ante 25
Richard_KONO: posts the ante 25
camcf63: posts the ante 25
whiskey732: posts small blind 100
Richard_KONO: posts big blind 200
*** HOLE CARDS ***
Dealt to jcarlos.vale [6s 3h]
camcf63: folds 
jcarlos.vale: folds 
adabrakadabra: folds 
whiskey732: folds 
Uncalled bet (100) returned to Richard_KONO
Richard_KONO collected 325 from pot
Richard_KONO: doesn't show handDTO
*** SUMMARY ***
Total pot 325 | Rake 0 
Seat 2: jcarlos.vale folded before Flop (didn't bet)
Seat 3: adabrakadabra (button) folded before Flop (didn't bet)
Seat 6: whiskey732 (small blind) folded before Flop
Seat 7: Richard_KONO (big blind) collected (325)
Seat 9: camcf63 folded before Flop (didn't bet)



PokerStars Hand #221592026515: Tournament #3079328305, $0.91+$0.09 USD Hold'em No Limit - Level VII (100/200) - 2020/12/19 2:25:02 EET [2020/12/18 19:25:02 ET]
Table '3079328305 5' 9-max Seat #6 is the button
Seat 2: jcarlos.vale (7586 in chips) 
Seat 3: adabrakadabra (5061 in chips) 
Seat 6: whiskey732 (7413 in chips) 
Seat 7: Richard_KONO (3385 in chips) 
Seat 9: camcf63 (6327 in chips) 
jcarlos.vale: posts the ante 25
adabrakadabra: posts the ante 25
whiskey732: posts the ante 25
Richard_KONO: posts the ante 25
camcf63: posts the ante 25
Richard_KONO: posts small blind 100
camcf63: posts big blind 200
*** HOLE CARDS ***
Dealt to jcarlos.vale [9h 4s]
jcarlos.vale: folds 
adabrakadabra: folds 
whiskey732: folds 
Richard_KONO: calls 100
camcf63: raises 6102 to 6302 and is all-in
Richard_KONO: folds 
Uncalled bet (6102) returned to camcf63
camcf63 collected 525 from pot
*** SUMMARY ***
Total pot 525 | Rake 0 
Seat 2: jcarlos.vale folded before Flop (didn't bet)
Seat 3: adabrakadabra folded before Flop (didn't bet)
Seat 6: whiskey732 (button) folded before Flop (didn't bet)
Seat 7: Richard_KONO (small blind) folded before Flop
Seat 9: camcf63 (big blind) collected (525)



PokerStars Hand #221592043459: Tournament #3079328305, $0.91+$0.09 USD Hold'em No Limit - Level VII (100/200) - 2020/12/19 2:25:36 EET [2020/12/18 19:25:36 ET]
Table '3079328305 5' 9-max Seat #7 is the button
Seat 2: jcarlos.vale (7561 in chips) 
Seat 3: adabrakadabra (5036 in chips) 
Seat 6: whiskey732 (7388 in chips) 
Seat 7: Richard_KONO (3160 in chips) 
Seat 9: camcf63 (6627 in chips) 
jcarlos.vale: posts the ante 25
adabrakadabra: posts the ante 25
whiskey732: posts the ante 25
Richard_KONO: posts the ante 25
camcf63: posts the ante 25
camcf63: posts small blind 100
jcarlos.vale: posts big blind 200
*** HOLE CARDS ***
Dealt to jcarlos.vale [8c Jh]
adabrakadabra: folds 
whiskey732: folds 
Richard_KONO: folds 
camcf63: folds 
Uncalled bet (100) returned to jcarlos.vale
jcarlos.vale collected 325 from pot
jcarlos.vale: doesn't show handDTO
*** SUMMARY ***
Total pot 325 | Rake 0 
Seat 2: jcarlos.vale (big blind) collected (325)
Seat 3: adabrakadabra folded before Flop (didn't bet)
Seat 6: whiskey732 folded before Flop (didn't bet)
Seat 7: Richard_KONO (button) folded before Flop (didn't bet)
Seat 9: camcf63 (small blind) folded before Flop



PokerStars Hand #221592052445: Tournament #3079328305, $0.91+$0.09 USD Hold'em No Limit - Level VII (100/200) - 2020/12/19 2:25:54 EET [2020/12/18 19:25:54 ET]
Table '3079328305 5' 9-max Seat #9 is the button
Seat 2: jcarlos.vale (7761 in chips) 
Seat 3: adabrakadabra (5011 in chips) 
Seat 6: whiskey732 (7363 in chips) 
Seat 7: Richard_KONO (3135 in chips) 
Seat 9: camcf63 (6502 in chips) 
jcarlos.vale: posts the ante 25
adabrakadabra: posts the ante 25
whiskey732: posts the ante 25
Richard_KONO: posts the ante 25
camcf63: posts the ante 25
jcarlos.vale: posts small blind 100
adabrakadabra: posts big blind 200
*** HOLE CARDS ***
Dealt to jcarlos.vale [2s Ks]
whiskey732: folds 
Richard_KONO: folds 
camcf63: raises 200 to 400
jcarlos.vale: folds 
adabrakadabra: folds 
Uncalled bet (200) returned to camcf63
camcf63 collected 625 from pot
*** SUMMARY ***
Total pot 625 | Rake 0 
Seat 2: jcarlos.vale (small blind) folded before Flop
Seat 3: adabrakadabra (big blind) folded before Flop
Seat 6: whiskey732 folded before Flop (didn't bet)
Seat 7: Richard_KONO folded before Flop (didn't bet)
Seat 9: camcf63 (button) collected (625)



PokerStars Hand #221592061800: Tournament #3079328305, $0.91+$0.09 USD Hold'em No Limit - Level VII (100/200) - 2020/12/19 2:26:13 EET [2020/12/18 19:26:13 ET]
Table '3079328305 5' 9-max Seat #2 is the button
Seat 2: jcarlos.vale (7636 in chips) 
Seat 3: adabrakadabra (4786 in chips) 
Seat 6: whiskey732 (7338 in chips) 
Seat 7: Richard_KONO (3110 in chips) 
Seat 9: camcf63 (6902 in chips) 
jcarlos.vale: posts the ante 25
adabrakadabra: posts the ante 25
whiskey732: posts the ante 25
Richard_KONO: posts the ante 25
camcf63: posts the ante 25
adabrakadabra: posts small blind 100
whiskey732: posts big blind 200
*** HOLE CARDS ***
Dealt to jcarlos.vale [Jd Jh]
Richard_KONO: folds 
camcf63: raises 200 to 400
jcarlos.vale: raises 7211 to 7611 and is all-in
adabrakadabra: folds 
whiskey732: folds 
camcf63: calls 6477 and is all-in
Uncalled bet (734) returned to jcarlos.vale
*** FLOP *** [9d 7h 4h]
*** TURN *** [9d 7h 4h] [9c]
*** RIVER *** [9d 7h 4h 9c] [Jc]
*** SHOW DOWN ***
camcf63: shows [Kd Ad] (a pair of Nines)
jcarlos.vale: shows [Jd Jh] (a full house, Jacks full of Nines)
jcarlos.vale collected 14179 from pot
camcf63 finished the tournament in 10th place
*** SUMMARY ***
Total pot 14179 | Rake 0 
Board [9d 7h 4h 9c Jc]
Seat 2: jcarlos.vale (button) showed [Jd Jh] and won (14179) with a full house, Jacks full of Nines
Seat 3: adabrakadabra (small blind) folded before Flop
Seat 6: whiskey732 (big blind) folded before Flop
Seat 7: Richard_KONO folded before Flop (didn't bet)
Seat 9: camcf63 showed [Kd Ad] and lost with a pair of Nines



PokerStars Hand #221592108032: Tournament #3079328305, $0.91+$0.09 USD Hold'em No Limit - Level VII (100/200) - 2020/12/19 2:27:47 EET [2020/12/18 19:27:47 ET]
Table '3079328305 4' 9-max Seat #1 is the button
Seat 1: SenhorFredo (2768 in chips) 
Seat 2: pro100zoom777 (20903 in chips) 
Seat 3: Richard_KONO (3085 in chips) 
Seat 4: LoletsPadre (6504 in chips) 
Seat 5: whiskey732 (7113 in chips) 
Seat 6: adabrakadabra (4661 in chips) 
Seat 7: jcarlos.vale (14913 in chips) 
Seat 8: I`m Parasite (3566 in chips) 
Seat 9: wikem (3987 in chips) 
SenhorFredo: posts the ante 25
pro100zoom777: posts the ante 25
Richard_KONO: posts the ante 25
LoletsPadre: posts the ante 25
whiskey732: posts the ante 25
adabrakadabra: posts the ante 25
jcarlos.vale: posts the ante 25
I`m Parasite: posts the ante 25
wikem: posts the ante 25
pro100zoom777: posts small blind 100
Richard_KONO: posts big blind 200
*** HOLE CARDS ***
Dealt to jcarlos.vale [2h Th]
LoletsPadre: folds 
whiskey732: folds 
adabrakadabra: folds 
jcarlos.vale: folds 
I`m Parasite: folds 
wikem: folds 
SenhorFredo: folds 
pro100zoom777: raises 20678 to 20878 and is all-in
Richard_KONO: folds 
Uncalled bet (20678) returned to pro100zoom777
pro100zoom777 collected 625 from pot
*** SUMMARY ***
Total pot 625 | Rake 0 
Seat 1: SenhorFredo (button) folded before Flop (didn't bet)
Seat 2: pro100zoom777 (small blind) collected (625)
Seat 3: Richard_KONO (big blind) folded before Flop
Seat 4: LoletsPadre folded before Flop (didn't bet)
Seat 5: whiskey732 folded before Flop (didn't bet)
Seat 6: adabrakadabra folded before Flop (didn't bet)
Seat 7: jcarlos.vale folded before Flop (didn't bet)
Seat 8: I`m Parasite folded before Flop (didn't bet)
Seat 9: wikem folded before Flop (didn't bet)



PokerStars Hand #221592138018: Tournament #3079328305, $0.91+$0.09 USD Hold'em No Limit - Level VIII (150/300) - 2020/12/19 2:28:48 EET [2020/12/18 19:28:48 ET]
Table '3079328305 4' 9-max Seat #2 is the button
Seat 1: SenhorFredo (2743 in chips) 
Seat 2: pro100zoom777 (21303 in chips) 
Seat 3: Richard_KONO (2860 in chips) 
Seat 4: LoletsPadre (6479 in chips) 
Seat 5: whiskey732 (7088 in chips) 
Seat 6: adabrakadabra (4636 in chips) 
Seat 7: jcarlos.vale (14888 in chips) 
Seat 8: I`m Parasite (3541 in chips) 
Seat 9: wikem (3962 in chips) 
SenhorFredo: posts the ante 25
pro100zoom777: posts the ante 25
Richard_KONO: posts the ante 25
LoletsPadre: posts the ante 25
whiskey732: posts the ante 25
adabrakadabra: posts the ante 25
jcarlos.vale: posts the ante 25
I`m Parasite: posts the ante 25
wikem: posts the ante 25
Richard_KONO: posts small blind 150
LoletsPadre: posts big blind 300
*** HOLE CARDS ***
Dealt to jcarlos.vale [Ac 4d]
whiskey732: folds 
adabrakadabra: folds 
jcarlos.vale: folds 
I`m Parasite: folds 
wikem: folds 
SenhorFredo: folds 
pro100zoom777: raises 330 to 630
Richard_KONO: folds 
LoletsPadre: calls 330
*** FLOP *** [Jd Tc 9c]
LoletsPadre: checks 
pro100zoom777: bets 474
LoletsPadre: calls 474
*** TURN *** [Jd Tc 9c] [Th]
LoletsPadre: checks 
pro100zoom777: bets 749
LoletsPadre: calls 749
*** RIVER *** [Jd Tc 9c Th] [2h]
LoletsPadre: checks 
pro100zoom777: checks 
*** SHOW DOWN ***
LoletsPadre: shows [Js Qd] (two pair, Jacks and Tens)
pro100zoom777: mucks handDTO
LoletsPadre collected 4081 from pot
*** SUMMARY ***
Total pot 4081 | Rake 0 
Board [Jd Tc 9c Th 2h]
Seat 1: SenhorFredo folded before Flop (didn't bet)
Seat 2: pro100zoom777 (button) mucked [6h 5c]
Seat 3: Richard_KONO (small blind) folded before Flop
Seat 4: LoletsPadre (big blind) showed [Js Qd] and won (4081) with two pair, Jacks and Tens
Seat 5: whiskey732 folded before Flop (didn't bet)
Seat 6: adabrakadabra folded before Flop (didn't bet)
Seat 7: jcarlos.vale folded before Flop (didn't bet)
Seat 8: I`m Parasite folded before Flop (didn't bet)
Seat 9: wikem folded before Flop (didn't bet)



PokerStars Hand #221592167082: Tournament #3079328305, $0.91+$0.09 USD Hold'em No Limit - Level VIII (150/300) - 2020/12/19 2:29:47 EET [2020/12/18 19:29:47 ET]
Table '3079328305 4' 9-max Seat #3 is the button
Seat 1: SenhorFredo (2718 in chips) 
Seat 2: pro100zoom777 (19425 in chips) 
Seat 3: Richard_KONO (2685 in chips) 
Seat 4: LoletsPadre (8682 in chips) 
Seat 5: whiskey732 (7063 in chips) 
Seat 6: adabrakadabra (4611 in chips) 
Seat 7: jcarlos.vale (14863 in chips) 
Seat 8: I`m Parasite (3516 in chips) 
Seat 9: wikem (3937 in chips) 
SenhorFredo: posts the ante 25
pro100zoom777: posts the ante 25
Richard_KONO: posts the ante 25
LoletsPadre: posts the ante 25
whiskey732: posts the ante 25
adabrakadabra: posts the ante 25
jcarlos.vale: posts the ante 25
I`m Parasite: posts the ante 25
wikem: posts the ante 25
LoletsPadre: posts small blind 150
whiskey732: posts big blind 300
*** HOLE CARDS ***
Dealt to jcarlos.vale [Jd 3h]
adabrakadabra: folds 
jcarlos.vale: folds 
I`m Parasite: folds 
wikem: folds 
SenhorFredo: raises 2393 to 2693 and is all-in
pro100zoom777: folds 
Richard_KONO: folds 
LoletsPadre: folds 
whiskey732: folds 
Uncalled bet (2393) returned to SenhorFredo
SenhorFredo collected 975 from pot
*** SUMMARY ***
Total pot 975 | Rake 0 
Seat 1: SenhorFredo collected (975)
Seat 2: pro100zoom777 folded before Flop (didn't bet)
Seat 3: Richard_KONO (button) folded before Flop (didn't bet)
Seat 4: LoletsPadre (small blind) folded before Flop
Seat 5: whiskey732 (big blind) folded before Flop
Seat 6: adabrakadabra folded before Flop (didn't bet)
Seat 7: jcarlos.vale folded before Flop (didn't bet)
Seat 8: I`m Parasite folded before Flop (didn't bet)
Seat 9: wikem folded before Flop (didn't bet)



PokerStars Hand #221592184958: Tournament #3079328305, $0.91+$0.09 USD Hold'em No Limit - Level VIII (150/300) - 2020/12/19 2:30:23 EET [2020/12/18 19:30:23 ET]
Table '3079328305 4' 9-max Seat #4 is the button
Seat 1: SenhorFredo (3368 in chips) 
Seat 2: pro100zoom777 (19400 in chips) 
Seat 3: Richard_KONO (2660 in chips) 
Seat 4: LoletsPadre (8507 in chips) 
Seat 5: whiskey732 (6738 in chips) 
Seat 6: adabrakadabra (4586 in chips) 
Seat 7: jcarlos.vale (14838 in chips) 
Seat 8: I`m Parasite (3491 in chips) 
Seat 9: wikem (3912 in chips) 
SenhorFredo: posts the ante 25
pro100zoom777: posts the ante 25
Richard_KONO: posts the ante 25
LoletsPadre: posts the ante 25
whiskey732: posts the ante 25
adabrakadabra: posts the ante 25
jcarlos.vale: posts the ante 25
I`m Parasite: posts the ante 25
wikem: posts the ante 25
whiskey732: posts small blind 150
adabrakadabra: posts big blind 300
*** HOLE CARDS ***
Dealt to jcarlos.vale [Kc 9h]
jcarlos.vale: folds 
I`m Parasite: folds 
wikem: calls 300
SenhorFredo: folds 
pro100zoom777: folds 
Richard_KONO: folds 
LoletsPadre: raises 1040 to 1340
whiskey732: folds 
adabrakadabra: folds 
wikem: raises 2547 to 3887 and is all-in
LoletsPadre: calls 2547
*** FLOP *** [Jd 3d 3s]
*** TURN *** [Jd 3d 3s] [6d]
*** RIVER *** [Jd 3d 3s 6d] [9d]
*** SHOW DOWN ***
wikem: shows [3h Kh] (three of a kind, Threes)
LoletsPadre: shows [Jh Js] (a full house, Jacks full of Threes)
LoletsPadre collected 8449 from pot
wikem finished the tournament in 9th place
*** SUMMARY ***
Total pot 8449 | Rake 0 
Board [Jd 3d 3s 6d 9d]
Seat 1: SenhorFredo folded before Flop (didn't bet)
Seat 2: pro100zoom777 folded before Flop (didn't bet)
Seat 3: Richard_KONO folded before Flop (didn't bet)
Seat 4: LoletsPadre (button) showed [Jh Js] and won (8449) with a full house, Jacks full of Threes
Seat 5: whiskey732 (small blind) folded before Flop
Seat 6: adabrakadabra (big blind) folded before Flop
Seat 7: jcarlos.vale folded before Flop (didn't bet)
Seat 8: I`m Parasite folded before Flop (didn't bet)
Seat 9: wikem showed [3h Kh] and lost with three of a kind, Threes



PokerStars Hand #221592214572: Tournament #3079328305, $0.91+$0.09 USD Hold'em No Limit - Level VIII (150/300) - 2020/12/19 2:31:24 EET [2020/12/18 19:31:24 ET]
Table '3079328305 4' 9-max Seat #5 is the button
Seat 1: SenhorFredo (3343 in chips) 
Seat 2: pro100zoom777 (19375 in chips) 
Seat 3: Richard_KONO (2635 in chips) 
Seat 4: LoletsPadre (13044 in chips) 
Seat 5: whiskey732 (6563 in chips) 
Seat 6: adabrakadabra (4261 in chips) 
Seat 7: jcarlos.vale (14813 in chips) 
Seat 8: I`m Parasite (3466 in chips) 
SenhorFredo: posts the ante 25
pro100zoom777: posts the ante 25
Richard_KONO: posts the ante 25
LoletsPadre: posts the ante 25
whiskey732: posts the ante 25
adabrakadabra: posts the ante 25
jcarlos.vale: posts the ante 25
I`m Parasite: posts the ante 25
adabrakadabra: posts small blind 150
jcarlos.vale: posts big blind 300
*** HOLE CARDS ***
Dealt to jcarlos.vale [Kc Jc]
I`m Parasite: folds 
SenhorFredo: folds 
pro100zoom777: raises 300 to 600
Richard_KONO: folds 
LoletsPadre: folds 
whiskey732: folds 
adabrakadabra: folds 
jcarlos.vale: calls 300
*** FLOP *** [4c 6d 7s]
jcarlos.vale: checks 
pro100zoom777: bets 450
jcarlos.vale: folds 
Uncalled bet (450) returned to pro100zoom777
pro100zoom777 collected 1550 from pot
pro100zoom777: shows [Ah As] (a pair of Aces)
*** SUMMARY ***
Total pot 1550 | Rake 0 
Board [4c 6d 7s]
Seat 1: SenhorFredo folded before Flop (didn't bet)
Seat 2: pro100zoom777 collected (1550)
Seat 3: Richard_KONO folded before Flop (didn't bet)
Seat 4: LoletsPadre folded before Flop (didn't bet)
Seat 5: whiskey732 (button) folded before Flop (didn't bet)
Seat 6: adabrakadabra (small blind) folded before Flop
Seat 7: jcarlos.vale (big blind) folded on the Flop
Seat 8: I`m Parasite folded before Flop (didn't bet)



PokerStars Hand #221592240538: Tournament #3079328305, $0.91+$0.09 USD Hold'em No Limit - Level VIII (150/300) - 2020/12/19 2:32:17 EET [2020/12/18 19:32:17 ET]
Table '3079328305 4' 9-max Seat #6 is the button
Seat 1: SenhorFredo (3318 in chips) 
Seat 2: pro100zoom777 (20300 in chips) 
Seat 3: Richard_KONO (2610 in chips) 
Seat 4: LoletsPadre (13019 in chips) 
Seat 5: whiskey732 (6538 in chips) 
Seat 6: adabrakadabra (4086 in chips) 
Seat 7: jcarlos.vale (14188 in chips) 
Seat 8: I`m Parasite (3441 in chips) 
SenhorFredo: posts the ante 25
pro100zoom777: posts the ante 25
Richard_KONO: posts the ante 25
LoletsPadre: posts the ante 25
whiskey732: posts the ante 25
adabrakadabra: posts the ante 25
jcarlos.vale: posts the ante 25
I`m Parasite: posts the ante 25
jcarlos.vale: posts small blind 150
I`m Parasite: posts big blind 300
*** HOLE CARDS ***
Dealt to jcarlos.vale [9d Jd]
SenhorFredo: folds 
pro100zoom777: folds 
Richard_KONO: raises 2285 to 2585 and is all-in
LoletsPadre: folds 
whiskey732: raises 3928 to 6513 and is all-in
adabrakadabra: folds 
jcarlos.vale: folds 
I`m Parasite: folds 
Uncalled bet (3928) returned to whiskey732
*** FLOP *** [2s Qd Jh]
*** TURN *** [2s Qd Jh] [Ac]
*** RIVER *** [2s Qd Jh Ac] [Kd]
*** SHOW DOWN ***
Richard_KONO: shows [Kh Ad] (two pair, Aces and Kings)
whiskey732: shows [As Qc] (two pair, Aces and Queens)
Richard_KONO collected 5820 from pot
Richard_KONO said, "uff"
*** SUMMARY ***
Total pot 5820 | Rake 0 
Board [2s Qd Jh Ac Kd]
Seat 1: SenhorFredo folded before Flop (didn't bet)
Seat 2: pro100zoom777 folded before Flop (didn't bet)
Seat 3: Richard_KONO showed [Kh Ad] and won (5820) with two pair, Aces and Kings
Seat 4: LoletsPadre folded before Flop (didn't bet)
Seat 5: whiskey732 showed [As Qc] and lost with two pair, Aces and Queens
Seat 6: adabrakadabra (button) folded before Flop (didn't bet)
Seat 7: jcarlos.vale (small blind) folded before Flop
Seat 8: I`m Parasite (big blind) folded before Flop



PokerStars Hand #221592262473: Tournament #3079328305, $0.91+$0.09 USD Hold'em No Limit - Level VIII (150/300) - 2020/12/19 2:33:02 EET [2020/12/18 19:33:02 ET]
Table '3079328305 4' 9-max Seat #7 is the button
Seat 1: SenhorFredo (3293 in chips) 
Seat 2: pro100zoom777 (20275 in chips) 
Seat 3: Richard_KONO (5820 in chips) 
Seat 4: LoletsPadre (12994 in chips) 
Seat 5: whiskey732 (3928 in chips) 
Seat 6: adabrakadabra (4061 in chips) 
Seat 7: jcarlos.vale (14013 in chips) 
Seat 8: I`m Parasite (3116 in chips) 
SenhorFredo: posts the ante 25
pro100zoom777: posts the ante 25
Richard_KONO: posts the ante 25
LoletsPadre: posts the ante 25
whiskey732: posts the ante 25
adabrakadabra: posts the ante 25
jcarlos.vale: posts the ante 25
I`m Parasite: posts the ante 25
I`m Parasite: posts small blind 150
SenhorFredo: posts big blind 300
*** HOLE CARDS ***
Dealt to jcarlos.vale [9c Js]
pro100zoom777: folds 
Richard_KONO: folds 
LoletsPadre: folds 
whiskey732: raises 950 to 1250
adabrakadabra: folds 
jcarlos.vale: folds 
I`m Parasite: folds 
SenhorFredo: folds 
Uncalled bet (950) returned to whiskey732
whiskey732 collected 950 from pot
*** SUMMARY ***
Total pot 950 | Rake 0 
Seat 1: SenhorFredo (big blind) folded before Flop
Seat 2: pro100zoom777 folded before Flop (didn't bet)
Seat 3: Richard_KONO folded before Flop (didn't bet)
Seat 4: LoletsPadre folded before Flop (didn't bet)
Seat 5: whiskey732 collected (950)
Seat 6: adabrakadabra folded before Flop (didn't bet)
Seat 7: jcarlos.vale (button) folded before Flop (didn't bet)
Seat 8: I`m Parasite (small blind) folded before Flop



PokerStars Hand #221592275880: Tournament #3079328305, $0.91+$0.09 USD Hold'em No Limit - Level VIII (150/300) - 2020/12/19 2:33:30 EET [2020/12/18 19:33:30 ET]
Table '3079328305 4' 9-max Seat #8 is the button
Seat 1: SenhorFredo (2968 in chips) 
Seat 2: pro100zoom777 (20250 in chips) 
Seat 3: Richard_KONO (5795 in chips) 
Seat 4: LoletsPadre (12969 in chips) 
Seat 5: whiskey732 (4553 in chips) 
Seat 6: adabrakadabra (4036 in chips) 
Seat 7: jcarlos.vale (13988 in chips) 
Seat 8: I`m Parasite (2941 in chips) 
SenhorFredo: posts the ante 25
pro100zoom777: posts the ante 25
Richard_KONO: posts the ante 25
LoletsPadre: posts the ante 25
whiskey732: posts the ante 25
adabrakadabra: posts the ante 25
jcarlos.vale: posts the ante 25
I`m Parasite: posts the ante 25
SenhorFredo: posts small blind 150
pro100zoom777: posts big blind 300
*** HOLE CARDS ***
Dealt to jcarlos.vale [3d 7h]
Richard_KONO: folds 
LoletsPadre: folds 
whiskey732: raises 950 to 1250
adabrakadabra: folds 
jcarlos.vale: folds 
I`m Parasite: folds 
SenhorFredo: folds 
pro100zoom777: calls 950
*** FLOP *** [2s Ks 5h]
pro100zoom777: checks 
whiskey732: bets 2850
pro100zoom777: raises 2850 to 5700
whiskey732: calls 428 and is all-in
Uncalled bet (2422) returned to pro100zoom777
*** TURN *** [2s Ks 5h] [Ts]
*** RIVER *** [2s Ks 5h Ts] [2h]
*** SHOW DOWN ***
pro100zoom777: shows [Qs Kc] (two pair, Kings and Deuces)
whiskey732: shows [As Js] (a flush, Ace high)
whiskey732 collected 9406 from pot
*** SUMMARY ***
Total pot 9406 | Rake 0 
Board [2s Ks 5h Ts 2h]
Seat 1: SenhorFredo (small blind) folded before Flop
Seat 2: pro100zoom777 (big blind) showed [Qs Kc] and lost with two pair, Kings and Deuces
Seat 3: Richard_KONO folded before Flop (didn't bet)
Seat 4: LoletsPadre folded before Flop (didn't bet)
Seat 5: whiskey732 showed [As Js] and won (9406) with a flush, Ace high
Seat 6: adabrakadabra folded before Flop (didn't bet)
Seat 7: jcarlos.vale folded before Flop (didn't bet)
Seat 8: I`m Parasite (button) folded before Flop (didn't bet)



PokerStars Hand #221592304318: Tournament #3079328305, $0.91+$0.09 USD Hold'em No Limit - Level VIII (150/300) - 2020/12/19 2:34:29 EET [2020/12/18 19:34:29 ET]
Table '3079328305 4' 9-max Seat #1 is the button
Seat 1: SenhorFredo (2793 in chips) 
Seat 2: pro100zoom777 (15697 in chips) 
Seat 3: Richard_KONO (5770 in chips) 
Seat 4: LoletsPadre (12944 in chips) 
Seat 5: whiskey732 (9406 in chips) 
Seat 6: adabrakadabra (4011 in chips) 
Seat 7: jcarlos.vale (13963 in chips) 
Seat 8: I`m Parasite (2916 in chips) 
SenhorFredo: posts the ante 25
pro100zoom777: posts the ante 25
Richard_KONO: posts the ante 25
LoletsPadre: posts the ante 25
whiskey732: posts the ante 25
adabrakadabra: posts the ante 25
jcarlos.vale: posts the ante 25
I`m Parasite: posts the ante 25
pro100zoom777: posts small blind 150
Richard_KONO: posts big blind 300
*** HOLE CARDS ***
Dealt to jcarlos.vale [Kh Ad]
LoletsPadre: folds 
whiskey732: folds 
adabrakadabra: folds 
jcarlos.vale: raises 480 to 780
I`m Parasite: folds 
SenhorFredo: folds 
pro100zoom777: folds 
Richard_KONO: folds 
Uncalled bet (480) returned to jcarlos.vale
jcarlos.vale collected 950 from pot
jcarlos.vale: doesn't show handDTO
*** SUMMARY ***
Total pot 950 | Rake 0 
Seat 1: SenhorFredo (button) folded before Flop (didn't bet)
Seat 2: pro100zoom777 (small blind) folded before Flop
Seat 3: Richard_KONO (big blind) folded before Flop
Seat 4: LoletsPadre folded before Flop (didn't bet)
Seat 5: whiskey732 folded before Flop (didn't bet)
Seat 6: adabrakadabra folded before Flop (didn't bet)
Seat 7: jcarlos.vale collected (950)
Seat 8: I`m Parasite folded before Flop (didn't bet)



PokerStars Hand #221592330032: Tournament #3079328305, $0.91+$0.09 USD Hold'em No Limit - Level VIII (150/300) - 2020/12/19 2:35:05 EET [2020/12/18 19:35:05 ET]
Table '3079328305 4' 9-max Seat #2 is the button
Seat 1: SenhorFredo (2768 in chips) 
Seat 2: pro100zoom777 (15522 in chips) 
Seat 3: Richard_KONO (5445 in chips) 
Seat 4: LoletsPadre (12919 in chips) 
Seat 5: whiskey732 (9381 in chips) 
Seat 6: adabrakadabra (3986 in chips) 
Seat 7: jcarlos.vale (14588 in chips) 
Seat 8: I`m Parasite (2891 in chips) 
SenhorFredo: posts the ante 25
pro100zoom777: posts the ante 25
Richard_KONO: posts the ante 25
LoletsPadre: posts the ante 25
whiskey732: posts the ante 25
adabrakadabra: posts the ante 25
jcarlos.vale: posts the ante 25
I`m Parasite: posts the ante 25
Richard_KONO: posts small blind 150
LoletsPadre: posts big blind 300
*** HOLE CARDS ***
Dealt to jcarlos.vale [5h 6s]
whiskey732: calls 300
adabrakadabra: folds 
jcarlos.vale: folds 
I`m Parasite: folds 
SenhorFredo: folds 
pro100zoom777: folds 
Richard_KONO: folds 
LoletsPadre: checks 
*** FLOP *** [4s Js 4d]
LoletsPadre: checks 
whiskey732: bets 950
LoletsPadre: folds 
Uncalled bet (950) returned to whiskey732
whiskey732 collected 950 from pot
*** SUMMARY ***
Total pot 950 | Rake 0 
Board [4s Js 4d]
Seat 1: SenhorFredo folded before Flop (didn't bet)
Seat 2: pro100zoom777 (button) folded before Flop (didn't bet)
Seat 3: Richard_KONO (small blind) folded before Flop
Seat 4: LoletsPadre (big blind) folded on the Flop
Seat 5: whiskey732 collected (950)
Seat 6: adabrakadabra folded before Flop (didn't bet)
Seat 7: jcarlos.vale folded before Flop (didn't bet)
Seat 8: I`m Parasite folded before Flop (didn't bet)



PokerStars Hand #221592348697: Tournament #3079328305, $0.91+$0.09 USD Hold'em No Limit - Level VIII (150/300) - 2020/12/19 2:35:44 EET [2020/12/18 19:35:44 ET]
Table '3079328305 4' 9-max Seat #3 is the button
Seat 1: SenhorFredo (2743 in chips) 
Seat 2: pro100zoom777 (15497 in chips) 
Seat 3: Richard_KONO (5270 in chips) 
Seat 4: LoletsPadre (12594 in chips) 
Seat 5: whiskey732 (10006 in chips) 
Seat 6: adabrakadabra (3961 in chips) 
Seat 7: jcarlos.vale (14563 in chips) 
Seat 8: I`m Parasite (2866 in chips) 
SenhorFredo: posts the ante 25
pro100zoom777: posts the ante 25
Richard_KONO: posts the ante 25
LoletsPadre: posts the ante 25
whiskey732: posts the ante 25
adabrakadabra: posts the ante 25
jcarlos.vale: posts the ante 25
I`m Parasite: posts the ante 25
LoletsPadre: posts small blind 150
whiskey732: posts big blind 300
*** HOLE CARDS ***
Dealt to jcarlos.vale [5h 3s]
adabrakadabra: folds 
jcarlos.vale: folds 
I`m Parasite: raises 2541 to 2841 and is all-in
SenhorFredo: folds 
pro100zoom777: folds 
Richard_KONO: folds 
LoletsPadre: folds 
whiskey732: folds 
Uncalled bet (2541) returned to I`m Parasite
I`m Parasite collected 950 from pot
I`m Parasite: doesn't show handDTO
*** SUMMARY ***
Total pot 950 | Rake 0 
Seat 1: SenhorFredo folded before Flop (didn't bet)
Seat 2: pro100zoom777 folded before Flop (didn't bet)
Seat 3: Richard_KONO (button) folded before Flop (didn't bet)
Seat 4: LoletsPadre (small blind) folded before Flop
Seat 5: whiskey732 (big blind) folded before Flop
Seat 6: adabrakadabra folded before Flop (didn't bet)
Seat 7: jcarlos.vale folded before Flop (didn't bet)
Seat 8: I`m Parasite collected (950)



PokerStars Hand #221592374791: Tournament #3079328305, $0.91+$0.09 USD Hold'em No Limit - Level VIII (150/300) - 2020/12/19 2:36:38 EET [2020/12/18 19:36:38 ET]
Table '3079328305 4' 9-max Seat #4 is the button
Seat 1: SenhorFredo (2718 in chips) 
Seat 2: pro100zoom777 (15472 in chips) 
Seat 3: Richard_KONO (5245 in chips) 
Seat 4: LoletsPadre (12419 in chips) 
Seat 5: whiskey732 (9681 in chips) 
Seat 6: adabrakadabra (3936 in chips) 
Seat 7: jcarlos.vale (14538 in chips) 
Seat 8: I`m Parasite (3491 in chips) 
SenhorFredo: posts the ante 25
pro100zoom777: posts the ante 25
Richard_KONO: posts the ante 25
LoletsPadre: posts the ante 25
whiskey732: posts the ante 25
adabrakadabra: posts the ante 25
jcarlos.vale: posts the ante 25
I`m Parasite: posts the ante 25
whiskey732: posts small blind 150
adabrakadabra: posts big blind 300
*** HOLE CARDS ***
Dealt to jcarlos.vale [4c 6h]
jcarlos.vale: folds 
I`m Parasite: folds 
SenhorFredo: folds 
pro100zoom777: raises 330 to 630
Richard_KONO: folds 
LoletsPadre: folds 
whiskey732: folds 
adabrakadabra: folds 
Uncalled bet (330) returned to pro100zoom777
pro100zoom777 collected 950 from pot
*** SUMMARY ***
Total pot 950 | Rake 0 
Seat 1: SenhorFredo folded before Flop (didn't bet)
Seat 2: pro100zoom777 collected (950)
Seat 3: Richard_KONO folded before Flop (didn't bet)
Seat 4: LoletsPadre (button) folded before Flop (didn't bet)
Seat 5: whiskey732 (small blind) folded before Flop
Seat 6: adabrakadabra (big blind) folded before Flop
Seat 7: jcarlos.vale folded before Flop (didn't bet)
Seat 8: I`m Parasite folded before Flop (didn't bet)



PokerStars Hand #221592392272: Tournament #3079328305, $0.91+$0.09 USD Hold'em No Limit - Level VIII (150/300) - 2020/12/19 2:37:14 EET [2020/12/18 19:37:14 ET]
Table '3079328305 4' 9-max Seat #5 is the button
Seat 1: SenhorFredo (2693 in chips) 
Seat 2: pro100zoom777 (16097 in chips) 
Seat 3: Richard_KONO (5220 in chips) 
Seat 4: LoletsPadre (12394 in chips) 
Seat 5: whiskey732 (9506 in chips) 
Seat 6: adabrakadabra (3611 in chips) 
Seat 7: jcarlos.vale (14513 in chips) 
Seat 8: I`m Parasite (3466 in chips) 
SenhorFredo: posts the ante 25
pro100zoom777: posts the ante 25
Richard_KONO: posts the ante 25
LoletsPadre: posts the ante 25
whiskey732: posts the ante 25
adabrakadabra: posts the ante 25
jcarlos.vale: posts the ante 25
I`m Parasite: posts the ante 25
adabrakadabra: posts small blind 150
jcarlos.vale: posts big blind 300
*** HOLE CARDS ***
Dealt to jcarlos.vale [Ac 4c]
I`m Parasite: folds 
SenhorFredo: raises 300 to 600
pro100zoom777: folds 
Richard_KONO: folds 
LoletsPadre: folds 
whiskey732: folds 
adabrakadabra: folds 
jcarlos.vale: folds 
Uncalled bet (300) returned to SenhorFredo
SenhorFredo collected 950 from pot
*** SUMMARY ***
Total pot 950 | Rake 0 
Seat 1: SenhorFredo collected (950)
Seat 2: pro100zoom777 folded before Flop (didn't bet)
Seat 3: Richard_KONO folded before Flop (didn't bet)
Seat 4: LoletsPadre folded before Flop (didn't bet)
Seat 5: whiskey732 (button) folded before Flop (didn't bet)
Seat 6: adabrakadabra (small blind) folded before Flop
Seat 7: jcarlos.vale (big blind) folded before Flop
Seat 8: I`m Parasite folded before Flop (didn't bet)



PokerStars Hand #221592404954: Tournament #3079328305, $0.91+$0.09 USD Hold'em No Limit - Level VIII (150/300) - 2020/12/19 2:37:41 EET [2020/12/18 19:37:41 ET]
Table '3079328305 4' 9-max Seat #6 is the button
Seat 1: SenhorFredo (3318 in chips) 
Seat 2: pro100zoom777 (16072 in chips) 
Seat 3: Richard_KONO (5195 in chips) 
Seat 4: LoletsPadre (12369 in chips) 
Seat 5: whiskey732 (9481 in chips) 
Seat 6: adabrakadabra (3436 in chips) 
Seat 7: jcarlos.vale (14188 in chips) 
Seat 8: I`m Parasite (3441 in chips) 
SenhorFredo: posts the ante 25
pro100zoom777: posts the ante 25
Richard_KONO: posts the ante 25
LoletsPadre: posts the ante 25
whiskey732: posts the ante 25
adabrakadabra: posts the ante 25
jcarlos.vale: posts the ante 25
I`m Parasite: posts the ante 25
jcarlos.vale: posts small blind 150
I`m Parasite: posts big blind 300
*** HOLE CARDS ***
Dealt to jcarlos.vale [5c 2s]
SenhorFredo: folds 
pro100zoom777: folds 
Richard_KONO: folds 
LoletsPadre: raises 370 to 670
whiskey732: folds 
adabrakadabra: folds 
jcarlos.vale: folds 
I`m Parasite: folds 
Uncalled bet (370) returned to LoletsPadre
LoletsPadre collected 950 from pot
LoletsPadre: doesn't show handDTO
*** SUMMARY ***
Total pot 950 | Rake 0 
Seat 1: SenhorFredo folded before Flop (didn't bet)
Seat 2: pro100zoom777 folded before Flop (didn't bet)
Seat 3: Richard_KONO folded before Flop (didn't bet)
Seat 4: LoletsPadre collected (950)
Seat 5: whiskey732 folded before Flop (didn't bet)
Seat 6: adabrakadabra (button) folded before Flop (didn't bet)
Seat 7: jcarlos.vale (small blind) folded before Flop
Seat 8: I`m Parasite (big blind) folded before Flop



PokerStars Hand #221592422590: Tournament #3079328305, $0.91+$0.09 USD Hold'em No Limit - Level IX (200/400) - 2020/12/19 2:38:18 EET [2020/12/18 19:38:18 ET]
Table '3079328305 4' 9-max Seat #7 is the button
Seat 1: SenhorFredo (3293 in chips) 
Seat 2: pro100zoom777 (16047 in chips) 
Seat 3: Richard_KONO (5170 in chips) 
Seat 4: LoletsPadre (12994 in chips) 
Seat 5: whiskey732 (9456 in chips) 
Seat 6: adabrakadabra (3411 in chips) 
Seat 7: jcarlos.vale (14013 in chips) 
Seat 8: I`m Parasite (3116 in chips) 
SenhorFredo: posts the ante 25
pro100zoom777: posts the ante 25
Richard_KONO: posts the ante 25
LoletsPadre: posts the ante 25
whiskey732: posts the ante 25
adabrakadabra: posts the ante 25
jcarlos.vale: posts the ante 25
I`m Parasite: posts the ante 25
I`m Parasite: posts small blind 200
SenhorFredo: posts big blind 400
*** HOLE CARDS ***
Dealt to jcarlos.vale [Tc Qs]
pro100zoom777: folds 
Richard_KONO: folds 
LoletsPadre: folds 
whiskey732: folds 
adabrakadabra: folds 
jcarlos.vale: folds 
I`m Parasite: raises 2691 to 3091 and is all-in
SenhorFredo: folds 
Uncalled bet (2691) returned to I`m Parasite
I`m Parasite collected 1000 from pot
I`m Parasite: doesn't show handDTO
*** SUMMARY ***
Total pot 1000 | Rake 0 
Seat 1: SenhorFredo (big blind) folded before Flop
Seat 2: pro100zoom777 folded before Flop (didn't bet)
Seat 3: Richard_KONO folded before Flop (didn't bet)
Seat 4: LoletsPadre folded before Flop (didn't bet)
Seat 5: whiskey732 folded before Flop (didn't bet)
Seat 6: adabrakadabra folded before Flop (didn't bet)
Seat 7: jcarlos.vale (button) folded before Flop (didn't bet)
Seat 8: I`m Parasite (small blind) collected (1000)



PokerStars Hand #221592437757: Tournament #3079328305, $0.91+$0.09 USD Hold'em No Limit - Level IX (200/400) - 2020/12/19 2:38:50 EET [2020/12/18 19:38:50 ET]
Table '3079328305 4' 9-max Seat #8 is the button
Seat 1: SenhorFredo (2868 in chips) 
Seat 2: pro100zoom777 (16022 in chips) 
Seat 3: Richard_KONO (5145 in chips) 
Seat 4: LoletsPadre (12969 in chips) 
Seat 5: whiskey732 (9431 in chips) 
Seat 6: adabrakadabra (3386 in chips) 
Seat 7: jcarlos.vale (13988 in chips) 
Seat 8: I`m Parasite (3691 in chips) 
SenhorFredo: posts the ante 25
pro100zoom777: posts the ante 25
Richard_KONO: posts the ante 25
LoletsPadre: posts the ante 25
whiskey732: posts the ante 25
adabrakadabra: posts the ante 25
jcarlos.vale: posts the ante 25
I`m Parasite: posts the ante 25
SenhorFredo: posts small blind 200
pro100zoom777: posts big blind 400
*** HOLE CARDS ***
Dealt to jcarlos.vale [Kd Qc]
Richard_KONO: folds 
LoletsPadre: folds 
whiskey732: folds 
adabrakadabra: folds 
jcarlos.vale: raises 640 to 1040
I`m Parasite: folds 
SenhorFredo: folds 
pro100zoom777: folds 
Uncalled bet (640) returned to jcarlos.vale
jcarlos.vale collected 1200 from pot
jcarlos.vale: doesn't show handDTO
*** SUMMARY ***
Total pot 1200 | Rake 0 
Seat 1: SenhorFredo (small blind) folded before Flop
Seat 2: pro100zoom777 (big blind) folded before Flop
Seat 3: Richard_KONO folded before Flop (didn't bet)
Seat 4: LoletsPadre folded before Flop (didn't bet)
Seat 5: whiskey732 folded before Flop (didn't bet)
Seat 6: adabrakadabra folded before Flop (didn't bet)
Seat 7: jcarlos.vale collected (1200)
Seat 8: I`m Parasite (button) folded before Flop (didn't bet)



PokerStars Hand #221592457435: Tournament #3079328305, $0.91+$0.09 USD Hold'em No Limit - Level IX (200/400) - 2020/12/19 2:39:31 EET [2020/12/18 19:39:31 ET]
Table '3079328305 4' 9-max Seat #1 is the button
Seat 1: SenhorFredo (2643 in chips) 
Seat 2: pro100zoom777 (15597 in chips) 
Seat 3: Richard_KONO (5120 in chips) 
Seat 4: LoletsPadre (12944 in chips) 
Seat 5: whiskey732 (9406 in chips) 
Seat 6: adabrakadabra (3361 in chips) 
Seat 7: jcarlos.vale (14763 in chips) 
Seat 8: I`m Parasite (3666 in chips) 
SenhorFredo: posts the ante 25
pro100zoom777: posts the ante 25
Richard_KONO: posts the ante 25
LoletsPadre: posts the ante 25
whiskey732: posts the ante 25
adabrakadabra: posts the ante 25
jcarlos.vale: posts the ante 25
I`m Parasite: posts the ante 25
pro100zoom777: posts small blind 200
Richard_KONO: posts big blind 400
*** HOLE CARDS ***
Dealt to jcarlos.vale [4d 3c]
LoletsPadre: folds 
whiskey732: folds 
adabrakadabra: folds 
jcarlos.vale: folds 
I`m Parasite: folds 
SenhorFredo: raises 2218 to 2618 and is all-in
pro100zoom777: calls 2418
Richard_KONO: folds 
*** FLOP *** [4c 8d 6h]
*** TURN *** [4c 8d 6h] [9c]
*** RIVER *** [4c 8d 6h 9c] [Tc]
*** SHOW DOWN ***
pro100zoom777: shows [Ah Ks] (high pairOfCards Ace)
SenhorFredo: shows [5h Kh] (high pairOfCards King)
pro100zoom777 collected 5836 from pot
SenhorFredo is sitting out
SenhorFredo finished the tournament in 8th place
*** SUMMARY ***
Total pot 5836 | Rake 0 
Board [4c 8d 6h 9c Tc]
Seat 1: SenhorFredo (button) showed [5h Kh] and lost with high pairOfCards King
Seat 2: pro100zoom777 (small blind) showed [Ah Ks] and won (5836) with high pairOfCards Ace
Seat 3: Richard_KONO (big blind) folded before Flop
Seat 4: LoletsPadre folded before Flop (didn't bet)
Seat 5: whiskey732 folded before Flop (didn't bet)
Seat 6: adabrakadabra folded before Flop (didn't bet)
Seat 7: jcarlos.vale folded before Flop (didn't bet)
Seat 8: I`m Parasite folded before Flop (didn't bet)



PokerStars Hand #221592472008: Tournament #3079328305, $0.91+$0.09 USD Hold'em No Limit - Level IX (200/400) - 2020/12/19 2:40:01 EET [2020/12/18 19:40:01 ET]
Table '3079328305 4' 9-max Seat #2 is the button
Seat 2: pro100zoom777 (18790 in chips) 
Seat 3: Richard_KONO (4695 in chips) 
Seat 4: LoletsPadre (12919 in chips) 
Seat 5: whiskey732 (9381 in chips) 
Seat 6: adabrakadabra (3336 in chips) 
Seat 7: jcarlos.vale (14738 in chips) 
Seat 8: I`m Parasite (3641 in chips) 
pro100zoom777: posts the ante 25
Richard_KONO: posts the ante 25
LoletsPadre: posts the ante 25
whiskey732: posts the ante 25
adabrakadabra: posts the ante 25
jcarlos.vale: posts the ante 25
I`m Parasite: posts the ante 25
Richard_KONO: posts small blind 200
LoletsPadre: posts big blind 400
*** HOLE CARDS ***
Dealt to jcarlos.vale [Ah 2h]
whiskey732: folds 
adabrakadabra: folds 
jcarlos.vale: folds 
I`m Parasite: folds 
pro100zoom777: folds 
Richard_KONO: folds 
Uncalled bet (200) returned to LoletsPadre
LoletsPadre collected 575 from pot
LoletsPadre: doesn't show handDTO
*** SUMMARY ***
Total pot 575 | Rake 0 
Seat 2: pro100zoom777 (button) folded before Flop (didn't bet)
Seat 3: Richard_KONO (small blind) folded before Flop
Seat 4: LoletsPadre (big blind) collected (575)
Seat 5: whiskey732 folded before Flop (didn't bet)
Seat 6: adabrakadabra folded before Flop (didn't bet)
Seat 7: jcarlos.vale folded before Flop (didn't bet)
Seat 8: I`m Parasite folded before Flop (didn't bet)



PokerStars Hand #221592479669: Tournament #3079328305, $0.91+$0.09 USD Hold'em No Limit - Level IX (200/400) - 2020/12/19 2:40:18 EET [2020/12/18 19:40:18 ET]
Table '3079328305 4' 9-max Seat #3 is the button
Seat 2: pro100zoom777 (18765 in chips) 
Seat 3: Richard_KONO (4470 in chips) 
Seat 4: LoletsPadre (13269 in chips) 
Seat 5: whiskey732 (9356 in chips) 
Seat 6: adabrakadabra (3311 in chips) 
Seat 7: jcarlos.vale (14713 in chips) 
Seat 8: I`m Parasite (3616 in chips) 
pro100zoom777: posts the ante 25
Richard_KONO: posts the ante 25
LoletsPadre: posts the ante 25
whiskey732: posts the ante 25
adabrakadabra: posts the ante 25
jcarlos.vale: posts the ante 25
I`m Parasite: posts the ante 25
LoletsPadre: posts small blind 200
whiskey732: posts big blind 400
*** HOLE CARDS ***
Dealt to jcarlos.vale [Qc 6h]
adabrakadabra: folds 
jcarlos.vale: folds 
I`m Parasite: raises 3191 to 3591 and is all-in
pro100zoom777: folds 
Richard_KONO: folds 
LoletsPadre: folds 
whiskey732: folds 
Uncalled bet (3191) returned to I`m Parasite
I`m Parasite collected 1175 from pot
I`m Parasite: doesn't show handDTO
*** SUMMARY ***
Total pot 1175 | Rake 0 
Seat 2: pro100zoom777 folded before Flop (didn't bet)
Seat 3: Richard_KONO (button) folded before Flop (didn't bet)
Seat 4: LoletsPadre (small blind) folded before Flop
Seat 5: whiskey732 (big blind) folded before Flop
Seat 6: adabrakadabra folded before Flop (didn't bet)
Seat 7: jcarlos.vale folded before Flop (didn't bet)
Seat 8: I`m Parasite collected (1175)



PokerStars Hand #221592493559: Tournament #3079328305, $0.91+$0.09 USD Hold'em No Limit - Level IX (200/400) - 2020/12/19 2:40:47 EET [2020/12/18 19:40:47 ET]
Table '3079328305 4' 9-max Seat #4 is the button
Seat 2: pro100zoom777 (18740 in chips) 
Seat 3: Richard_KONO (4445 in chips) 
Seat 4: LoletsPadre (13044 in chips) 
Seat 5: whiskey732 (8931 in chips) 
Seat 6: adabrakadabra (3286 in chips) 
Seat 7: jcarlos.vale (14688 in chips) 
Seat 8: I`m Parasite (4366 in chips) 
pro100zoom777: posts the ante 25
Richard_KONO: posts the ante 25
LoletsPadre: posts the ante 25
whiskey732: posts the ante 25
adabrakadabra: posts the ante 25
jcarlos.vale: posts the ante 25
I`m Parasite: posts the ante 25
whiskey732: posts small blind 200
adabrakadabra: posts big blind 400
*** HOLE CARDS ***
Dealt to jcarlos.vale [Kc 2h]
jcarlos.vale: folds 
I`m Parasite: folds 
pro100zoom777: folds 
Richard_KONO: folds 
LoletsPadre: folds 
whiskey732: folds 
Uncalled bet (200) returned to adabrakadabra
adabrakadabra collected 575 from pot
*** SUMMARY ***
Total pot 575 | Rake 0 
Seat 2: pro100zoom777 folded before Flop (didn't bet)
Seat 3: Richard_KONO folded before Flop (didn't bet)
Seat 4: LoletsPadre (button) folded before Flop (didn't bet)
Seat 5: whiskey732 (small blind) folded before Flop
Seat 6: adabrakadabra (big blind) collected (575)
Seat 7: jcarlos.vale folded before Flop (didn't bet)
Seat 8: I`m Parasite folded before Flop (didn't bet)



PokerStars Hand #221592503859: Tournament #3079328305, $0.91+$0.09 USD Hold'em No Limit - Level IX (200/400) - 2020/12/19 2:41:09 EET [2020/12/18 19:41:09 ET]
Table '3079328305 4' 9-max Seat #5 is the button
Seat 2: pro100zoom777 (18715 in chips) 
Seat 3: Richard_KONO (4420 in chips) 
Seat 4: LoletsPadre (13019 in chips) 
Seat 5: whiskey732 (8706 in chips) 
Seat 6: adabrakadabra (3636 in chips) 
Seat 7: jcarlos.vale (14663 in chips) 
Seat 8: I`m Parasite (4341 in chips) 
pro100zoom777: posts the ante 25
Richard_KONO: posts the ante 25
LoletsPadre: posts the ante 25
whiskey732: posts the ante 25
adabrakadabra: posts the ante 25
jcarlos.vale: posts the ante 25
I`m Parasite: posts the ante 25
adabrakadabra: posts small blind 200
jcarlos.vale: posts big blind 400
*** HOLE CARDS ***
Dealt to jcarlos.vale [7s 6s]
I`m Parasite: folds 
pro100zoom777: raises 400 to 800
Richard_KONO: folds 
LoletsPadre: folds 
whiskey732: folds 
adabrakadabra: folds 
jcarlos.vale: calls 400
*** FLOP *** [Th 6c 4c]
jcarlos.vale: checks 
pro100zoom777 is disconnected 
pro100zoom777 is connected 
pro100zoom777: bets 573
jcarlos.vale: folds 
Uncalled bet (573) returned to pro100zoom777
pro100zoom777 collected 1975 from pot
*** SUMMARY ***
Total pot 1975 | Rake 0 
Board [Th 6c 4c]
Seat 2: pro100zoom777 collected (1975)
Seat 3: Richard_KONO folded before Flop (didn't bet)
Seat 4: LoletsPadre folded before Flop (didn't bet)
Seat 5: whiskey732 (button) folded before Flop (didn't bet)
Seat 6: adabrakadabra (small blind) folded before Flop
Seat 7: jcarlos.vale (big blind) folded on the Flop
Seat 8: I`m Parasite folded before Flop (didn't bet)



PokerStars Hand #221592538477: Tournament #3079328305, $0.91+$0.09 USD Hold'em No Limit - Level IX (200/400) - 2020/12/19 2:42:22 EET [2020/12/18 19:42:22 ET]
Table '3079328305 4' 9-max Seat #6 is the button
Seat 2: pro100zoom777 (19865 in chips) 
Seat 3: Richard_KONO (4395 in chips) 
Seat 4: LoletsPadre (12994 in chips) 
Seat 5: whiskey732 (8681 in chips) 
Seat 6: adabrakadabra (3411 in chips) 
Seat 7: jcarlos.vale (13838 in chips) 
Seat 8: I`m Parasite (4316 in chips) 
pro100zoom777: posts the ante 25
Richard_KONO: posts the ante 25
LoletsPadre: posts the ante 25
whiskey732: posts the ante 25
adabrakadabra: posts the ante 25
jcarlos.vale: posts the ante 25
I`m Parasite: posts the ante 25
jcarlos.vale: posts small blind 200
I`m Parasite: posts big blind 400
*** HOLE CARDS ***
Dealt to jcarlos.vale [8s 6c]
pro100zoom777: folds 
Richard_KONO: folds 
LoletsPadre: folds 
whiskey732: folds 
adabrakadabra: raises 2986 to 3386 and is all-in
jcarlos.vale: folds 
I`m Parasite: folds 
Uncalled bet (2986) returned to adabrakadabra
adabrakadabra collected 1175 from pot
*** SUMMARY ***
Total pot 1175 | Rake 0 
Seat 2: pro100zoom777 folded before Flop (didn't bet)
Seat 3: Richard_KONO folded before Flop (didn't bet)
Seat 4: LoletsPadre folded before Flop (didn't bet)
Seat 5: whiskey732 folded before Flop (didn't bet)
Seat 6: adabrakadabra (button) collected (1175)
Seat 7: jcarlos.vale (small blind) folded before Flop
Seat 8: I`m Parasite (big blind) folded before Flop



PokerStars Hand #221592549786: Tournament #3079328305, $0.91+$0.09 USD Hold'em No Limit - Level IX (200/400) - 2020/12/19 2:42:47 EET [2020/12/18 19:42:47 ET]
Table '3079328305 4' 9-max Seat #7 is the button
Seat 2: pro100zoom777 (19840 in chips) 
Seat 3: Richard_KONO (4370 in chips) 
Seat 4: LoletsPadre (12969 in chips) 
Seat 5: whiskey732 (8656 in chips) 
Seat 6: adabrakadabra (4161 in chips) 
Seat 7: jcarlos.vale (13613 in chips) 
Seat 8: I`m Parasite (3891 in chips) 
pro100zoom777: posts the ante 25
Richard_KONO: posts the ante 25
LoletsPadre: posts the ante 25
whiskey732: posts the ante 25
adabrakadabra: posts the ante 25
jcarlos.vale: posts the ante 25
I`m Parasite: posts the ante 25
I`m Parasite: posts small blind 200
pro100zoom777: posts big blind 400
*** HOLE CARDS ***
Dealt to jcarlos.vale [Ts 2c]
Richard_KONO: folds 
LoletsPadre: folds 
whiskey732: folds 
adabrakadabra: folds 
jcarlos.vale: folds 
I`m Parasite: raises 3466 to 3866 and is all-in
pro100zoom777: folds 
Uncalled bet (3466) returned to I`m Parasite
I`m Parasite collected 975 from pot
I`m Parasite: doesn't show handDTO
*** SUMMARY ***
Total pot 975 | Rake 0 
Seat 2: pro100zoom777 (big blind) folded before Flop
Seat 3: Richard_KONO folded before Flop (didn't bet)
Seat 4: LoletsPadre folded before Flop (didn't bet)
Seat 5: whiskey732 folded before Flop (didn't bet)
Seat 6: adabrakadabra folded before Flop (didn't bet)
Seat 7: jcarlos.vale (button) folded before Flop (didn't bet)
Seat 8: I`m Parasite (small blind) collected (975)



PokerStars Hand #221592563788: Tournament #3079328305, $0.91+$0.09 USD Hold'em No Limit - Level IX (200/400) - 2020/12/19 2:43:17 EET [2020/12/18 19:43:17 ET]
Table '3079328305 4' 9-max Seat #8 is the button
Seat 2: pro100zoom777 (19415 in chips) 
Seat 3: Richard_KONO (4345 in chips) 
Seat 4: LoletsPadre (12944 in chips) 
Seat 5: whiskey732 (8631 in chips) 
Seat 6: adabrakadabra (4136 in chips) 
Seat 7: jcarlos.vale (13588 in chips) 
Seat 8: I`m Parasite (4441 in chips) 
pro100zoom777: posts the ante 25
Richard_KONO: posts the ante 25
LoletsPadre: posts the ante 25
whiskey732: posts the ante 25
adabrakadabra: posts the ante 25
jcarlos.vale: posts the ante 25
I`m Parasite: posts the ante 25
pro100zoom777: posts small blind 200
Richard_KONO: posts big blind 400
*** HOLE CARDS ***
Dealt to jcarlos.vale [7d Qs]
LoletsPadre: folds 
whiskey732: folds 
adabrakadabra: raises 3711 to 4111 and is all-in
jcarlos.vale: folds 
I`m Parasite: folds 
pro100zoom777: folds 
Richard_KONO: folds 
Uncalled bet (3711) returned to adabrakadabra
adabrakadabra collected 1175 from pot
*** SUMMARY ***
Total pot 1175 | Rake 0 
Seat 2: pro100zoom777 (small blind) folded before Flop
Seat 3: Richard_KONO (big blind) folded before Flop
Seat 4: LoletsPadre folded before Flop (didn't bet)
Seat 5: whiskey732 folded before Flop (didn't bet)
Seat 6: adabrakadabra collected (1175)
Seat 7: jcarlos.vale folded before Flop (didn't bet)
Seat 8: I`m Parasite (button) folded before Flop (didn't bet)



PokerStars Hand #221592574024: Tournament #3079328305, $0.91+$0.09 USD Hold'em No Limit - Level IX (200/400) - 2020/12/19 2:43:39 EET [2020/12/18 19:43:39 ET]
Table '3079328305 4' 9-max Seat #2 is the button
Seat 2: pro100zoom777 (19190 in chips) 
Seat 3: Richard_KONO (3920 in chips) 
Seat 4: LoletsPadre (12919 in chips) 
Seat 5: whiskey732 (8606 in chips) 
Seat 6: adabrakadabra (4886 in chips) 
Seat 7: jcarlos.vale (13563 in chips) 
Seat 8: I`m Parasite (4416 in chips) 
pro100zoom777: posts the ante 25
Richard_KONO: posts the ante 25
LoletsPadre: posts the ante 25
whiskey732: posts the ante 25
adabrakadabra: posts the ante 25
jcarlos.vale: posts the ante 25
I`m Parasite: posts the ante 25
Richard_KONO: posts small blind 200
LoletsPadre: posts big blind 400
*** HOLE CARDS ***
Dealt to jcarlos.vale [Qh 9c]
whiskey732: folds 
adabrakadabra: folds 
jcarlos.vale: folds 
I`m Parasite: folds 
pro100zoom777: folds 
Richard_KONO: folds 
Uncalled bet (200) returned to LoletsPadre
LoletsPadre collected 575 from pot
LoletsPadre: doesn't show handDTO
*** SUMMARY ***
Total pot 575 | Rake 0 
Seat 2: pro100zoom777 (button) folded before Flop (didn't bet)
Seat 3: Richard_KONO (small blind) folded before Flop
Seat 4: LoletsPadre (big blind) collected (575)
Seat 5: whiskey732 folded before Flop (didn't bet)
Seat 6: adabrakadabra folded before Flop (didn't bet)
Seat 7: jcarlos.vale folded before Flop (didn't bet)
Seat 8: I`m Parasite folded before Flop (didn't bet)



PokerStars Hand #221592581390: Tournament #3079328305, $0.91+$0.09 USD Hold'em No Limit - Level IX (200/400) - 2020/12/19 2:43:54 EET [2020/12/18 19:43:54 ET]
Table '3079328305 4' 9-max Seat #3 is the button
Seat 2: pro100zoom777 (19165 in chips) 
Seat 3: Richard_KONO (3695 in chips) 
Seat 4: LoletsPadre (13269 in chips) 
Seat 5: whiskey732 (8581 in chips) 
Seat 6: adabrakadabra (4861 in chips) 
Seat 7: jcarlos.vale (13538 in chips) 
Seat 8: I`m Parasite (4391 in chips) 
pro100zoom777: posts the ante 25
Richard_KONO: posts the ante 25
LoletsPadre: posts the ante 25
whiskey732: posts the ante 25
adabrakadabra: posts the ante 25
jcarlos.vale: posts the ante 25
I`m Parasite: posts the ante 25
LoletsPadre: posts small blind 200
whiskey732: posts big blind 400
*** HOLE CARDS ***
Dealt to jcarlos.vale [3s 8c]
adabrakadabra: folds 
jcarlos.vale: folds 
I`m Parasite: folds 
pro100zoom777: raises 400 to 800
Richard_KONO: folds 
LoletsPadre: folds 
whiskey732: folds 
Uncalled bet (400) returned to pro100zoom777
pro100zoom777 collected 1175 from pot
*** SUMMARY ***
Total pot 1175 | Rake 0 
Seat 2: pro100zoom777 collected (1175)
Seat 3: Richard_KONO (button) folded before Flop (didn't bet)
Seat 4: LoletsPadre (small blind) folded before Flop
Seat 5: whiskey732 (big blind) folded before Flop
Seat 6: adabrakadabra folded before Flop (didn't bet)
Seat 7: jcarlos.vale folded before Flop (didn't bet)
Seat 8: I`m Parasite folded before Flop (didn't bet)



PokerStars Hand #221592592011: Tournament #3079328305, $0.91+$0.09 USD Hold'em No Limit - Level IX (200/400) - 2020/12/19 2:44:17 EET [2020/12/18 19:44:17 ET]
Table '3079328305 4' 9-max Seat #4 is the button
Seat 2: pro100zoom777 (19915 in chips) 
Seat 3: Richard_KONO (3670 in chips) 
Seat 4: LoletsPadre (13044 in chips) 
Seat 5: whiskey732 (8156 in chips) 
Seat 6: adabrakadabra (4836 in chips) 
Seat 7: jcarlos.vale (13513 in chips) 
Seat 8: I`m Parasite (4366 in chips) 
pro100zoom777: posts the ante 25
Richard_KONO: posts the ante 25
LoletsPadre: posts the ante 25
whiskey732: posts the ante 25
adabrakadabra: posts the ante 25
jcarlos.vale: posts the ante 25
I`m Parasite: posts the ante 25
whiskey732: posts small blind 200
adabrakadabra: posts big blind 400
*** HOLE CARDS ***
Dealt to jcarlos.vale [Kc Jd]
jcarlos.vale: raises 640 to 1040
I`m Parasite: folds 
pro100zoom777: folds 
Richard_KONO: folds 
LoletsPadre: folds 
whiskey732: folds 
adabrakadabra: folds 
Uncalled bet (640) returned to jcarlos.vale
jcarlos.vale collected 1175 from pot
jcarlos.vale: doesn't show handDTO
*** SUMMARY ***
Total pot 1175 | Rake 0 
Seat 2: pro100zoom777 folded before Flop (didn't bet)
Seat 3: Richard_KONO folded before Flop (didn't bet)
Seat 4: LoletsPadre (button) folded before Flop (didn't bet)
Seat 5: whiskey732 (small blind) folded before Flop
Seat 6: adabrakadabra (big blind) folded before Flop
Seat 7: jcarlos.vale collected (1175)
Seat 8: I`m Parasite folded before Flop (didn't bet)



PokerStars Hand #221592601047: Tournament #3079328305, $0.91+$0.09 USD Hold'em No Limit - Level IX (200/400) - 2020/12/19 2:44:36 EET [2020/12/18 19:44:36 ET]
Table '3079328305 4' 9-max Seat #5 is the button
Seat 2: pro100zoom777 (19890 in chips) 
Seat 3: Richard_KONO (3645 in chips) 
Seat 4: LoletsPadre (13019 in chips) 
Seat 5: whiskey732 (7931 in chips) 
Seat 6: adabrakadabra (4411 in chips) 
Seat 7: jcarlos.vale (14263 in chips) 
Seat 8: I`m Parasite (4341 in chips) 
pro100zoom777: posts the ante 25
Richard_KONO: posts the ante 25
LoletsPadre: posts the ante 25
whiskey732: posts the ante 25
adabrakadabra: posts the ante 25
jcarlos.vale: posts the ante 25
I`m Parasite: posts the ante 25
adabrakadabra: posts small blind 200
jcarlos.vale: posts big blind 400
*** HOLE CARDS ***
Dealt to jcarlos.vale [Ah Kh]
I`m Parasite: raises 3916 to 4316 and is all-in
pro100zoom777: folds 
Richard_KONO: folds 
LoletsPadre: folds 
whiskey732: raises 3590 to 7906 and is all-in
adabrakadabra: folds 
jcarlos.vale: calls 7506
*** FLOP *** [8d Qh Qs]
*** TURN *** [8d Qh Qs] [8h]
*** RIVER *** [8d Qh Qs 8h] [2s]
*** SHOW DOWN ***
jcarlos.vale: shows [Ah Kh] (two pair, Queens and Eights)
whiskey732: shows [As Jc] (two pair, Queens and Eights)
jcarlos.vale collected 3590 from side pot
whiskey732 collected 3590 from side pot
I`m Parasite: shows [Ac Qc] (a full house, Queens full of Eights)
I`m Parasite collected 13323 from main pot
*** SUMMARY ***
Total pot 20503 Main pot 13323. Side pot 7180. | Rake 0 
Board [8d Qh Qs 8h 2s]
Seat 2: pro100zoom777 folded before Flop (didn't bet)
Seat 3: Richard_KONO folded before Flop (didn't bet)
Seat 4: LoletsPadre folded before Flop (didn't bet)
Seat 5: whiskey732 (button) showed [As Jc] and won (3590) with two pair, Queens and Eights
Seat 6: adabrakadabra (small blind) folded before Flop
Seat 7: jcarlos.vale (big blind) showed [Ah Kh] and won (3590) with two pair, Queens and Eights
Seat 8: I`m Parasite showed [Ac Qc] and won (13323) with a full house, Queens full of Eights



PokerStars Hand #221592620573: Tournament #3079328305, $0.91+$0.09 USD Hold'em No Limit - Level IX (200/400) - 2020/12/19 2:45:19 EET [2020/12/18 19:45:19 ET]
Table '3079328305 4' 9-max Seat #6 is the button
Seat 2: pro100zoom777 (19865 in chips) 
Seat 3: Richard_KONO (3620 in chips) 
Seat 4: LoletsPadre (12994 in chips) 
Seat 5: whiskey732 (3590 in chips) 
Seat 6: adabrakadabra (4186 in chips) 
Seat 7: jcarlos.vale (9922 in chips) 
Seat 8: I`m Parasite (13323 in chips) 
pro100zoom777: posts the ante 25
Richard_KONO: posts the ante 25
LoletsPadre: posts the ante 25
whiskey732: posts the ante 25
adabrakadabra: posts the ante 25
jcarlos.vale: posts the ante 25
I`m Parasite: posts the ante 25
jcarlos.vale: posts small blind 200
I`m Parasite: posts big blind 400
*** HOLE CARDS ***
Dealt to jcarlos.vale [3c 2s]
pro100zoom777: folds 
Richard_KONO: folds 
LoletsPadre: folds 
whiskey732: folds 
adabrakadabra: folds 
jcarlos.vale: folds 
Uncalled bet (200) returned to I`m Parasite
I`m Parasite collected 575 from pot
I`m Parasite: doesn't show handDTO
*** SUMMARY ***
Total pot 575 | Rake 0 
Seat 2: pro100zoom777 folded before Flop (didn't bet)
Seat 3: Richard_KONO folded before Flop (didn't bet)
Seat 4: LoletsPadre folded before Flop (didn't bet)
Seat 5: whiskey732 folded before Flop (didn't bet)
Seat 6: adabrakadabra (button) folded before Flop (didn't bet)
Seat 7: jcarlos.vale (small blind) folded before Flop
Seat 8: I`m Parasite (big blind) collected (575)



PokerStars Hand #221592633443: Tournament #3079328305, $0.91+$0.09 USD Hold'em No Limit - Level IX (200/400) - 2020/12/19 2:45:46 EET [2020/12/18 19:45:46 ET]
Table '3079328305 4' 9-max Seat #7 is the button
Seat 2: pro100zoom777 (19840 in chips) 
Seat 3: Richard_KONO (3595 in chips) 
Seat 4: LoletsPadre (12969 in chips) 
Seat 5: whiskey732 (3565 in chips) 
Seat 6: adabrakadabra (4161 in chips) 
Seat 7: jcarlos.vale (9697 in chips) 
Seat 8: I`m Parasite (13673 in chips) 
pro100zoom777: posts the ante 25
Richard_KONO: posts the ante 25
LoletsPadre: posts the ante 25
whiskey732: posts the ante 25
adabrakadabra: posts the ante 25
jcarlos.vale: posts the ante 25
I`m Parasite: posts the ante 25
I`m Parasite: posts small blind 200
pro100zoom777: posts big blind 400
*** HOLE CARDS ***
Dealt to jcarlos.vale [2d 6h]
Richard_KONO: folds 
LoletsPadre: folds 
whiskey732: folds 
adabrakadabra: folds 
jcarlos.vale: folds 
I`m Parasite: raises 400 to 800
pro100zoom777: raises 1600 to 2400
I`m Parasite: folds 
Uncalled bet (1600) returned to pro100zoom777
pro100zoom777 collected 1775 from pot
*** SUMMARY ***
Total pot 1775 | Rake 0 
Seat 2: pro100zoom777 (big blind) collected (1775)
Seat 3: Richard_KONO folded before Flop (didn't bet)
Seat 4: LoletsPadre folded before Flop (didn't bet)
Seat 5: whiskey732 folded before Flop (didn't bet)
Seat 6: adabrakadabra folded before Flop (didn't bet)
Seat 7: jcarlos.vale (button) folded before Flop (didn't bet)
Seat 8: I`m Parasite (small blind) folded before Flop



PokerStars Hand #221592649179: Tournament #3079328305, $0.91+$0.09 USD Hold'em No Limit - Level IX (200/400) - 2020/12/19 2:46:20 EET [2020/12/18 19:46:20 ET]
Table '3079328305 4' 9-max Seat #8 is the button
Seat 2: pro100zoom777 (20790 in chips) 
Seat 3: Richard_KONO (3570 in chips) 
Seat 4: LoletsPadre (12944 in chips) 
Seat 5: whiskey732 (3540 in chips) 
Seat 6: adabrakadabra (4136 in chips) 
Seat 7: jcarlos.vale (9672 in chips) 
Seat 8: I`m Parasite (12848 in chips) 
pro100zoom777: posts the ante 25
Richard_KONO: posts the ante 25
LoletsPadre: posts the ante 25
whiskey732: posts the ante 25
adabrakadabra: posts the ante 25
jcarlos.vale: posts the ante 25
I`m Parasite: posts the ante 25
pro100zoom777: posts small blind 200
Richard_KONO: posts big blind 400
*** HOLE CARDS ***
Dealt to jcarlos.vale [8h Kh]
LoletsPadre: folds 
whiskey732: folds 
adabrakadabra: folds 
jcarlos.vale: folds 
I`m Parasite: folds 
pro100zoom777: raises 1200 to 1600
Richard_KONO: folds 
Uncalled bet (1200) returned to pro100zoom777
pro100zoom777 collected 975 from pot
*** SUMMARY ***
Total pot 975 | Rake 0 
Seat 2: pro100zoom777 (small blind) collected (975)
Seat 3: Richard_KONO (big blind) folded before Flop
Seat 4: LoletsPadre folded before Flop (didn't bet)
Seat 5: whiskey732 folded before Flop (didn't bet)
Seat 6: adabrakadabra folded before Flop (didn't bet)
Seat 7: jcarlos.vale folded before Flop (didn't bet)
Seat 8: I`m Parasite (button) folded before Flop (didn't bet)



PokerStars Hand #221592662749: Tournament #3079328305, $0.91+$0.09 USD Hold'em No Limit - Level IX (200/400) - 2020/12/19 2:46:49 EET [2020/12/18 19:46:49 ET]
Table '3079328305 4' 9-max Seat #2 is the button
Seat 2: pro100zoom777 (21340 in chips) 
Seat 3: Richard_KONO (3145 in chips) 
Seat 4: LoletsPadre (12919 in chips) 
Seat 5: whiskey732 (3515 in chips) 
Seat 6: adabrakadabra (4111 in chips) 
Seat 7: jcarlos.vale (9647 in chips) 
Seat 8: I`m Parasite (12823 in chips) 
pro100zoom777: posts the ante 25
Richard_KONO: posts the ante 25
LoletsPadre: posts the ante 25
whiskey732: posts the ante 25
adabrakadabra: posts the ante 25
jcarlos.vale: posts the ante 25
I`m Parasite: posts the ante 25
Richard_KONO: posts small blind 200
LoletsPadre: posts big blind 400
*** HOLE CARDS ***
Dealt to jcarlos.vale [Js 8c]
whiskey732: raises 3090 to 3490 and is all-in
adabrakadabra: folds 
jcarlos.vale: folds 
I`m Parasite: folds 
pro100zoom777: calls 3490
Richard_KONO: folds 
LoletsPadre: folds 
*** FLOP *** [2s 9d 5c]
*** TURN *** [2s 9d 5c] [2c]
*** RIVER *** [2s 9d 5c 2c] [Jc]
*** SHOW DOWN ***
whiskey732: shows [Ad Kh] (a pair of Deuces)
pro100zoom777: shows [Ks Kc] (two pair, Kings and Deuces)
pro100zoom777 collected 7755 from pot
whiskey732 finished the tournament in 7th place and received $1.43.
*** SUMMARY ***
Total pot 7755 | Rake 0 
Board [2s 9d 5c 2c Jc]
Seat 2: pro100zoom777 (button) showed [Ks Kc] and won (7755) with two pair, Kings and Deuces
Seat 3: Richard_KONO (small blind) folded before Flop
Seat 4: LoletsPadre (big blind) folded before Flop
Seat 5: whiskey732 showed [Ad Kh] and lost with a pair of Deuces
Seat 6: adabrakadabra folded before Flop (didn't bet)
Seat 7: jcarlos.vale folded before Flop (didn't bet)
Seat 8: I`m Parasite folded before Flop (didn't bet)



PokerStars Hand #221592682449: Tournament #3079328305, $0.91+$0.09 USD Hold'em No Limit - Level IX (200/400) - 2020/12/19 2:47:31 EET [2020/12/18 19:47:31 ET]
Table '3079328305 4' 9-max Seat #3 is the button
Seat 2: pro100zoom777 (25580 in chips) 
Seat 3: Richard_KONO (2920 in chips) 
Seat 4: LoletsPadre (12494 in chips) 
Seat 6: adabrakadabra (4086 in chips) 
Seat 7: jcarlos.vale (9622 in chips) 
Seat 8: I`m Parasite (12798 in chips) 
pro100zoom777: posts the ante 25
Richard_KONO: posts the ante 25
LoletsPadre: posts the ante 25
adabrakadabra: posts the ante 25
jcarlos.vale: posts the ante 25
I`m Parasite: posts the ante 25
LoletsPadre: posts small blind 200
adabrakadabra: posts big blind 400
*** HOLE CARDS ***
Dealt to jcarlos.vale [Ac Jh]
jcarlos.vale: raises 9197 to 9597 and is all-in
I`m Parasite: folds 
pro100zoom777: folds 
Richard_KONO: folds 
LoletsPadre: folds 
adabrakadabra: folds 
Uncalled bet (9197) returned to jcarlos.vale
jcarlos.vale collected 1150 from pot
jcarlos.vale: doesn't show handDTO
*** SUMMARY ***
Total pot 1150 | Rake 0 
Seat 2: pro100zoom777 folded before Flop (didn't bet)
Seat 3: Richard_KONO (button) folded before Flop (didn't bet)
Seat 4: LoletsPadre (small blind) folded before Flop
Seat 6: adabrakadabra (big blind) folded before Flop
Seat 7: jcarlos.vale collected (1150)
Seat 8: I`m Parasite folded before Flop (didn't bet)



PokerStars Hand #221592692968: Tournament #3079328305, $0.91+$0.09 USD Hold'em No Limit - Level IX (200/400) - 2020/12/19 2:47:54 EET [2020/12/18 19:47:54 ET]
Table '3079328305 4' 9-max Seat #4 is the button
Seat 2: pro100zoom777 (25555 in chips) 
Seat 3: Richard_KONO (2895 in chips) 
Seat 4: LoletsPadre (12269 in chips) 
Seat 6: adabrakadabra (3661 in chips) 
Seat 7: jcarlos.vale (10347 in chips) 
Seat 8: I`m Parasite (12773 in chips) 
pro100zoom777: posts the ante 25
Richard_KONO: posts the ante 25
LoletsPadre: posts the ante 25
adabrakadabra: posts the ante 25
jcarlos.vale: posts the ante 25
I`m Parasite: posts the ante 25
adabrakadabra: posts small blind 200
jcarlos.vale: posts big blind 400
*** HOLE CARDS ***
Dealt to jcarlos.vale [7h 8h]
I`m Parasite: folds 
pro100zoom777: raises 440 to 840
Richard_KONO: folds 
LoletsPadre: folds 
adabrakadabra: folds 
jcarlos.vale: calls 440
*** FLOP *** [5h Qs 5c]
jcarlos.vale: checks 
pro100zoom777: bets 589
jcarlos.vale: folds 
Uncalled bet (589) returned to pro100zoom777
pro100zoom777 collected 2030 from pot
*** SUMMARY ***
Total pot 2030 | Rake 0 
Board [5h Qs 5c]
Seat 2: pro100zoom777 collected (2030)
Seat 3: Richard_KONO folded before Flop (didn't bet)
Seat 4: LoletsPadre (button) folded before Flop (didn't bet)
Seat 6: adabrakadabra (small blind) folded before Flop
Seat 7: jcarlos.vale (big blind) folded on the Flop
Seat 8: I`m Parasite folded before Flop (didn't bet)



PokerStars Hand #221592702609: Tournament #3079328305, $0.91+$0.09 USD Hold'em No Limit - Level X (300/600) - 2020/12/19 2:48:15 EET [2020/12/18 19:48:15 ET]
Table '3079328305 4' 9-max Seat #6 is the button
Seat 2: pro100zoom777 (26720 in chips) 
Seat 3: Richard_KONO (2870 in chips) 
Seat 4: LoletsPadre (12244 in chips) 
Seat 6: adabrakadabra (3436 in chips) 
Seat 7: jcarlos.vale (9482 in chips) 
Seat 8: I`m Parasite (12748 in chips) 
pro100zoom777: posts the ante 50
Richard_KONO: posts the ante 50
LoletsPadre: posts the ante 50
adabrakadabra: posts the ante 50
jcarlos.vale: posts the ante 50
I`m Parasite: posts the ante 50
jcarlos.vale: posts small blind 300
I`m Parasite: posts big blind 600
*** HOLE CARDS ***
Dealt to jcarlos.vale [4h Jc]
pro100zoom777: folds 
Richard_KONO: folds 
LoletsPadre: folds 
adabrakadabra: folds 
jcarlos.vale: folds 
Uncalled bet (300) returned to I`m Parasite
I`m Parasite collected 900 from pot
I`m Parasite: doesn't show handDTO
*** SUMMARY ***
Total pot 900 | Rake 0 
Seat 2: pro100zoom777 folded before Flop (didn't bet)
Seat 3: Richard_KONO folded before Flop (didn't bet)
Seat 4: LoletsPadre folded before Flop (didn't bet)
Seat 6: adabrakadabra (button) folded before Flop (didn't bet)
Seat 7: jcarlos.vale (small blind) folded before Flop
Seat 8: I`m Parasite (big blind) collected (900)



PokerStars Hand #221592712991: Tournament #3079328305, $0.91+$0.09 USD Hold'em No Limit - Level X (300/600) - 2020/12/19 2:48:38 EET [2020/12/18 19:48:38 ET]
Table '3079328305 4' 9-max Seat #7 is the button
Seat 2: pro100zoom777 (26670 in chips) 
Seat 3: Richard_KONO (2820 in chips) 
Seat 4: LoletsPadre (12194 in chips) 
Seat 6: adabrakadabra (3386 in chips) 
Seat 7: jcarlos.vale (9132 in chips) 
Seat 8: I`m Parasite (13298 in chips) 
pro100zoom777: posts the ante 50
Richard_KONO: posts the ante 50
LoletsPadre: posts the ante 50
adabrakadabra: posts the ante 50
jcarlos.vale: posts the ante 50
I`m Parasite: posts the ante 50
I`m Parasite: posts small blind 300
pro100zoom777: posts big blind 600
*** HOLE CARDS ***
Dealt to jcarlos.vale [5h Tc]
Richard_KONO: folds 
LoletsPadre: folds 
adabrakadabra: folds 
jcarlos.vale: folds 
I`m Parasite: folds 
Uncalled bet (300) returned to pro100zoom777
pro100zoom777 collected 900 from pot
*** SUMMARY ***
Total pot 900 | Rake 0 
Seat 2: pro100zoom777 (big blind) collected (900)
Seat 3: Richard_KONO folded before Flop (didn't bet)
Seat 4: LoletsPadre folded before Flop (didn't bet)
Seat 6: adabrakadabra folded before Flop (didn't bet)
Seat 7: jcarlos.vale (button) folded before Flop (didn't bet)
Seat 8: I`m Parasite (small blind) folded before Flop



PokerStars Hand #221592722183: Tournament #3079328305, $0.91+$0.09 USD Hold'em No Limit - Level X (300/600) - 2020/12/19 2:48:58 EET [2020/12/18 19:48:58 ET]
Table '3079328305 4' 9-max Seat #8 is the button
Seat 2: pro100zoom777 (27220 in chips) 
Seat 3: Richard_KONO (2770 in chips) 
Seat 4: LoletsPadre (12144 in chips) 
Seat 6: adabrakadabra (3336 in chips) 
Seat 7: jcarlos.vale (9082 in chips) 
Seat 8: I`m Parasite (12948 in chips) 
pro100zoom777: posts the ante 50
Richard_KONO: posts the ante 50
LoletsPadre: posts the ante 50
adabrakadabra: posts the ante 50
jcarlos.vale: posts the ante 50
I`m Parasite: posts the ante 50
pro100zoom777: posts small blind 300
Richard_KONO: posts big blind 600
*** HOLE CARDS ***
Dealt to jcarlos.vale [Jh 4h]
LoletsPadre: folds 
adabrakadabra: folds 
jcarlos.vale: folds 
I`m Parasite: raises 600 to 1200
pro100zoom777: folds 
Richard_KONO: folds 
Uncalled bet (600) returned to I`m Parasite
I`m Parasite collected 1800 from pot
I`m Parasite: doesn't show handDTO
*** SUMMARY ***
Total pot 1800 | Rake 0 
Seat 2: pro100zoom777 (small blind) folded before Flop
Seat 3: Richard_KONO (big blind) folded before Flop
Seat 4: LoletsPadre folded before Flop (didn't bet)
Seat 6: adabrakadabra folded before Flop (didn't bet)
Seat 7: jcarlos.vale folded before Flop (didn't bet)
Seat 8: I`m Parasite (button) collected (1800)



PokerStars Hand #221592731706: Tournament #3079328305, $0.91+$0.09 USD Hold'em No Limit - Level X (300/600) - 2020/12/19 2:49:18 EET [2020/12/18 19:49:18 ET]
Table '3079328305 4' 9-max Seat #2 is the button
Seat 2: pro100zoom777 (26870 in chips) 
Seat 3: Richard_KONO (2120 in chips) 
Seat 4: LoletsPadre (12094 in chips) 
Seat 6: adabrakadabra (3286 in chips) 
Seat 7: jcarlos.vale (9032 in chips) 
Seat 8: I`m Parasite (14098 in chips) 
pro100zoom777: posts the ante 50
Richard_KONO: posts the ante 50
LoletsPadre: posts the ante 50
adabrakadabra: posts the ante 50
jcarlos.vale: posts the ante 50
I`m Parasite: posts the ante 50
Richard_KONO: posts small blind 300
LoletsPadre: posts big blind 600
*** HOLE CARDS ***
Dealt to jcarlos.vale [6c Ts]
adabrakadabra: folds 
jcarlos.vale: folds 
I`m Parasite: folds 
pro100zoom777: folds 
Richard_KONO: folds 
Uncalled bet (300) returned to LoletsPadre
LoletsPadre collected 900 from pot
LoletsPadre: doesn't show handDTO
*** SUMMARY ***
Total pot 900 | Rake 0 
Seat 2: pro100zoom777 (button) folded before Flop (didn't bet)
Seat 3: Richard_KONO (small blind) folded before Flop
Seat 4: LoletsPadre (big blind) collected (900)
Seat 6: adabrakadabra folded before Flop (didn't bet)
Seat 7: jcarlos.vale folded before Flop (didn't bet)
Seat 8: I`m Parasite folded before Flop (didn't bet)



PokerStars Hand #221592749403: Tournament #3079328305, $0.91+$0.09 USD Hold'em No Limit - Level X (300/600) - 2020/12/19 2:49:44 EET [2020/12/18 19:49:44 ET]
Table '3079328305 4' 9-max Seat #3 is the button
Seat 2: pro100zoom777 (26820 in chips) 
Seat 3: Richard_KONO (1770 in chips) 
Seat 4: LoletsPadre (12644 in chips) 
Seat 6: adabrakadabra (3236 in chips) 
Seat 7: jcarlos.vale (8982 in chips) 
Seat 8: I`m Parasite (14048 in chips) 
pro100zoom777: posts the ante 50
Richard_KONO: posts the ante 50
LoletsPadre: posts the ante 50
adabrakadabra: posts the ante 50
jcarlos.vale: posts the ante 50
I`m Parasite: posts the ante 50
LoletsPadre: posts small blind 300
adabrakadabra: posts big blind 600
*** HOLE CARDS ***
Dealt to jcarlos.vale [5d 5h]
jcarlos.vale: raises 8332 to 8932 and is all-in
I`m Parasite: folds 
pro100zoom777: folds 
Richard_KONO: folds 
LoletsPadre: folds 
adabrakadabra: folds 
Uncalled bet (8332) returned to jcarlos.vale
jcarlos.vale collected 1800 from pot
jcarlos.vale: doesn't show handDTO
*** SUMMARY ***
Total pot 1800 | Rake 0 
Seat 2: pro100zoom777 folded before Flop (didn't bet)
Seat 3: Richard_KONO (button) folded before Flop (didn't bet)
Seat 4: LoletsPadre (small blind) folded before Flop
Seat 6: adabrakadabra (big blind) folded before Flop
Seat 7: jcarlos.vale collected (1800)
Seat 8: I`m Parasite folded before Flop (didn't bet)



PokerStars Hand #221592767806: Tournament #3079328305, $0.91+$0.09 USD Hold'em No Limit - Level X (300/600) - 2020/12/19 2:50:25 EET [2020/12/18 19:50:25 ET]
Table '3079328305 4' 9-max Seat #4 is the button
Seat 2: pro100zoom777 (26770 in chips) 
Seat 3: Richard_KONO (1720 in chips) 
Seat 4: LoletsPadre (12294 in chips) 
Seat 6: adabrakadabra (2586 in chips) 
Seat 7: jcarlos.vale (10132 in chips) 
Seat 8: I`m Parasite (13998 in chips) 
pro100zoom777: posts the ante 50
Richard_KONO: posts the ante 50
LoletsPadre: posts the ante 50
adabrakadabra: posts the ante 50
jcarlos.vale: posts the ante 50
I`m Parasite: posts the ante 50
adabrakadabra: posts small blind 300
jcarlos.vale: posts big blind 600
*** HOLE CARDS ***
Dealt to jcarlos.vale [As 5s]
I`m Parasite: folds 
pro100zoom777: folds 
Richard_KONO: folds 
LoletsPadre: folds 
adabrakadabra: folds 
Uncalled bet (300) returned to jcarlos.vale
jcarlos.vale collected 900 from pot
jcarlos.vale: doesn't show handDTO
*** SUMMARY ***
Total pot 900 | Rake 0 
Seat 2: pro100zoom777 folded before Flop (didn't bet)
Seat 3: Richard_KONO folded before Flop (didn't bet)
Seat 4: LoletsPadre (button) folded before Flop (didn't bet)
Seat 6: adabrakadabra (small blind) folded before Flop
Seat 7: jcarlos.vale (big blind) collected (900)
Seat 8: I`m Parasite folded before Flop (didn't bet)



PokerStars Hand #221592778036: Tournament #3079328305, $0.91+$0.09 USD Hold'em No Limit - Level X (300/600) - 2020/12/19 2:50:47 EET [2020/12/18 19:50:47 ET]
Table '3079328305 4' 9-max Seat #6 is the button
Seat 2: pro100zoom777 (26720 in chips) 
Seat 3: Richard_KONO (1670 in chips) 
Seat 4: LoletsPadre (12244 in chips) 
Seat 6: adabrakadabra (2236 in chips) 
Seat 7: jcarlos.vale (10682 in chips) 
Seat 8: I`m Parasite (13948 in chips) 
pro100zoom777: posts the ante 50
Richard_KONO: posts the ante 50
LoletsPadre: posts the ante 50
adabrakadabra: posts the ante 50
jcarlos.vale: posts the ante 50
I`m Parasite: posts the ante 50
jcarlos.vale: posts small blind 300
I`m Parasite: posts big blind 600
*** HOLE CARDS ***
Dealt to jcarlos.vale [2s Qc]
pro100zoom777: folds 
Richard_KONO: folds 
LoletsPadre: folds 
adabrakadabra: folds 
jcarlos.vale: folds 
Uncalled bet (300) returned to I`m Parasite
I`m Parasite collected 900 from pot
I`m Parasite: doesn't show handDTO
*** SUMMARY ***
Total pot 900 | Rake 0 
Seat 2: pro100zoom777 folded before Flop (didn't bet)
Seat 3: Richard_KONO folded before Flop (didn't bet)
Seat 4: LoletsPadre folded before Flop (didn't bet)
Seat 6: adabrakadabra (button) folded before Flop (didn't bet)
Seat 7: jcarlos.vale (small blind) folded before Flop
Seat 8: I`m Parasite (big blind) collected (900)



PokerStars Hand #221592785766: Tournament #3079328305, $0.91+$0.09 USD Hold'em No Limit - Level X (300/600) - 2020/12/19 2:51:05 EET [2020/12/18 19:51:05 ET]
Table '3079328305 4' 9-max Seat #7 is the button
Seat 2: pro100zoom777 (26670 in chips) 
Seat 3: Richard_KONO (1620 in chips) 
Seat 4: LoletsPadre (12194 in chips) 
Seat 6: adabrakadabra (2186 in chips) 
Seat 7: jcarlos.vale (10332 in chips) 
Seat 8: I`m Parasite (14498 in chips) 
pro100zoom777: posts the ante 50
Richard_KONO: posts the ante 50
LoletsPadre: posts the ante 50
adabrakadabra: posts the ante 50
jcarlos.vale: posts the ante 50
I`m Parasite: posts the ante 50
I`m Parasite: posts small blind 300
pro100zoom777: posts big blind 600
*** HOLE CARDS ***
Dealt to jcarlos.vale [2s 7c]
Richard_KONO: folds 
LoletsPadre: folds 
adabrakadabra: folds 
jcarlos.vale: folds 
I`m Parasite: folds 
Uncalled bet (300) returned to pro100zoom777
pro100zoom777 collected 900 from pot
*** SUMMARY ***
Total pot 900 | Rake 0 
Seat 2: pro100zoom777 (big blind) collected (900)
Seat 3: Richard_KONO folded before Flop (didn't bet)
Seat 4: LoletsPadre folded before Flop (didn't bet)
Seat 6: adabrakadabra folded before Flop (didn't bet)
Seat 7: jcarlos.vale (button) folded before Flop (didn't bet)
Seat 8: I`m Parasite (small blind) folded before Flop



PokerStars Hand #221592796863: Tournament #3079328305, $0.91+$0.09 USD Hold'em No Limit - Level X (300/600) - 2020/12/19 2:51:29 EET [2020/12/18 19:51:29 ET]
Table '3079328305 4' 9-max Seat #8 is the button
Seat 2: pro100zoom777 (27220 in chips) 
Seat 3: Richard_KONO (1570 in chips) 
Seat 4: LoletsPadre (12144 in chips) 
Seat 6: adabrakadabra (2136 in chips) 
Seat 7: jcarlos.vale (10282 in chips) 
Seat 8: I`m Parasite (14148 in chips) 
pro100zoom777: posts the ante 50
Richard_KONO: posts the ante 50
LoletsPadre: posts the ante 50
adabrakadabra: posts the ante 50
jcarlos.vale: posts the ante 50
I`m Parasite: posts the ante 50
pro100zoom777: posts small blind 300
Richard_KONO: posts big blind 600
*** HOLE CARDS ***
Dealt to jcarlos.vale [6d 8s]
LoletsPadre: raises 600 to 1200
adabrakadabra: raises 886 to 2086 and is all-in
jcarlos.vale: folds 
I`m Parasite: folds 
pro100zoom777: folds 
Richard_KONO: folds 
LoletsPadre: calls 886
*** FLOP *** [Js 5d 2c]
*** TURN *** [Js 5d 2c] [Kc]
*** RIVER *** [Js 5d 2c Kc] [5c]
*** SHOW DOWN ***
LoletsPadre: shows [8h Ah] (a pair of Fives)
adabrakadabra: shows [Ac Ad] (two pair, Aces and Fives)
adabrakadabra collected 5372 from pot
*** SUMMARY ***
Total pot 5372 | Rake 0 
Board [Js 5d 2c Kc 5c]
Seat 2: pro100zoom777 (small blind) folded before Flop
Seat 3: Richard_KONO (big blind) folded before Flop
Seat 4: LoletsPadre showed [8h Ah] and lost with a pair of Fives
Seat 6: adabrakadabra showed [Ac Ad] and won (5372) with two pair, Aces and Fives
Seat 7: jcarlos.vale folded before Flop (didn't bet)
Seat 8: I`m Parasite (button) folded before Flop (didn't bet)



PokerStars Hand #221592812541: Tournament #3079328305, $0.91+$0.09 USD Hold'em No Limit - Level X (300/600) - 2020/12/19 2:52:04 EET [2020/12/18 19:52:04 ET]
Table '3079328305 4' 9-max Seat #2 is the button
Seat 2: pro100zoom777 (26870 in chips) 
Seat 3: Richard_KONO (920 in chips) 
Seat 4: LoletsPadre (10008 in chips) 
Seat 6: adabrakadabra (5372 in chips) 
Seat 7: jcarlos.vale (10232 in chips) 
Seat 8: I`m Parasite (14098 in chips) 
pro100zoom777: posts the ante 50
Richard_KONO: posts the ante 50
LoletsPadre: posts the ante 50
adabrakadabra: posts the ante 50
jcarlos.vale: posts the ante 50
I`m Parasite: posts the ante 50
Richard_KONO: posts small blind 300
LoletsPadre: posts big blind 600
*** HOLE CARDS ***
Dealt to jcarlos.vale [Jd 9s]
adabrakadabra: folds 
jcarlos.vale: folds 
I`m Parasite: folds 
pro100zoom777: folds 
Richard_KONO: folds 
Uncalled bet (300) returned to LoletsPadre
LoletsPadre collected 900 from pot
LoletsPadre: doesn't show handDTO
*** SUMMARY ***
Total pot 900 | Rake 0 
Seat 2: pro100zoom777 (button) folded before Flop (didn't bet)
Seat 3: Richard_KONO (small blind) folded before Flop
Seat 4: LoletsPadre (big blind) collected (900)
Seat 6: adabrakadabra folded before Flop (didn't bet)
Seat 7: jcarlos.vale folded before Flop (didn't bet)
Seat 8: I`m Parasite folded before Flop (didn't bet)



PokerStars Hand #221592822279: Tournament #3079328305, $0.91+$0.09 USD Hold'em No Limit - Level X (300/600) - 2020/12/19 2:52:26 EET [2020/12/18 19:52:26 ET]
Table '3079328305 4' 9-max Seat #3 is the button
Seat 2: pro100zoom777 (26820 in chips) 
Seat 3: Richard_KONO (570 in chips) 
Seat 4: LoletsPadre (10558 in chips) 
Seat 6: adabrakadabra (5322 in chips) 
Seat 7: jcarlos.vale (10182 in chips) 
Seat 8: I`m Parasite (14048 in chips) 
pro100zoom777: posts the ante 50
Richard_KONO: posts the ante 50
LoletsPadre: posts the ante 50
adabrakadabra: posts the ante 50
jcarlos.vale: posts the ante 50
I`m Parasite: posts the ante 50
LoletsPadre: posts small blind 300
adabrakadabra: posts big blind 600
*** HOLE CARDS ***
Dealt to jcarlos.vale [Qc 6h]
jcarlos.vale: folds 
I`m Parasite: folds 
pro100zoom777: folds 
Richard_KONO: calls 520 and is all-in
LoletsPadre: folds 
Uncalled bet (80) returned to adabrakadabra
*** FLOP *** [Ad 5h 3c]
*** TURN *** [Ad 5h 3c] [Tc]
*** RIVER *** [Ad 5h 3c Tc] [8c]
*** SHOW DOWN ***
adabrakadabra: shows [As 6s] (a pair of Aces)
Richard_KONO: shows [6d Qd] (high pairOfCards Ace)
adabrakadabra collected 1640 from pot
Richard_KONO is sitting out
Richard_KONO finished the tournament in 6th place and received $2.45.
*** SUMMARY ***
Total pot 1640 | Rake 0 
Board [Ad 5h 3c Tc 8c]
Seat 2: pro100zoom777 folded before Flop (didn't bet)
Seat 3: Richard_KONO (button) showed [6d Qd] and lost with high pairOfCards Ace
Seat 4: LoletsPadre (small blind) folded before Flop
Seat 6: adabrakadabra (big blind) showed [As 6s] and won (1640) with a pair of Aces
Seat 7: jcarlos.vale folded before Flop (didn't bet)
Seat 8: I`m Parasite folded before Flop (didn't bet)



PokerStars Hand #221592834942: Tournament #3079328305, $0.91+$0.09 USD Hold'em No Limit - Level X (300/600) - 2020/12/19 2:52:55 EET [2020/12/18 19:52:55 ET]
Table '3079328305 4' 9-max Seat #4 is the button
Seat 2: pro100zoom777 (26770 in chips) 
Seat 4: LoletsPadre (10208 in chips) 
Seat 6: adabrakadabra (6392 in chips) 
Seat 7: jcarlos.vale (10132 in chips) 
Seat 8: I`m Parasite (13998 in chips) 
pro100zoom777: posts the ante 50
LoletsPadre: posts the ante 50
adabrakadabra: posts the ante 50
jcarlos.vale: posts the ante 50
I`m Parasite: posts the ante 50
adabrakadabra: posts small blind 300
jcarlos.vale: posts big blind 600
*** HOLE CARDS ***
Dealt to jcarlos.vale [3s Qh]
I`m Parasite: folds 
pro100zoom777: folds 
LoletsPadre: raises 1000 to 1600
adabrakadabra: folds 
jcarlos.vale: folds 
Uncalled bet (1000) returned to LoletsPadre
LoletsPadre collected 1750 from pot
LoletsPadre: doesn't show handDTO
*** SUMMARY ***
Total pot 1750 | Rake 0 
Seat 2: pro100zoom777 folded before Flop (didn't bet)
Seat 4: LoletsPadre (button) collected (1750)
Seat 6: adabrakadabra (small blind) folded before Flop
Seat 7: jcarlos.vale (big blind) folded before Flop
Seat 8: I`m Parasite folded before Flop (didn't bet)



PokerStars Hand #221592843318: Tournament #3079328305, $0.91+$0.09 USD Hold'em No Limit - Level X (300/600) - 2020/12/19 2:53:14 EET [2020/12/18 19:53:14 ET]
Table '3079328305 4' 9-max Seat #6 is the button
Seat 2: pro100zoom777 (26720 in chips) 
Seat 4: LoletsPadre (11308 in chips) 
Seat 6: adabrakadabra (6042 in chips) 
Seat 7: jcarlos.vale (9482 in chips) 
Seat 8: I`m Parasite (13948 in chips) 
pro100zoom777: posts the ante 50
LoletsPadre: posts the ante 50
adabrakadabra: posts the ante 50
jcarlos.vale: posts the ante 50
I`m Parasite: posts the ante 50
jcarlos.vale: posts small blind 300
I`m Parasite: posts big blind 600
*** HOLE CARDS ***
Dealt to jcarlos.vale [Qc 4c]
pro100zoom777: raises 600 to 1200
LoletsPadre: folds 
adabrakadabra: folds 
jcarlos.vale: folds 
I`m Parasite: folds 
Uncalled bet (600) returned to pro100zoom777
pro100zoom777 collected 1750 from pot
*** SUMMARY ***
Total pot 1750 | Rake 0 
Seat 2: pro100zoom777 collected (1750)
Seat 4: LoletsPadre folded before Flop (didn't bet)
Seat 6: adabrakadabra (button) folded before Flop (didn't bet)
Seat 7: jcarlos.vale (small blind) folded before Flop
Seat 8: I`m Parasite (big blind) folded before Flop



PokerStars Hand #221592850452: Tournament #3079328305, $0.91+$0.09 USD Hold'em No Limit - Level X (300/600) - 2020/12/19 2:53:30 EET [2020/12/18 19:53:30 ET]
Table '3079328305 4' 9-max Seat #7 is the button
Seat 2: pro100zoom777 (27820 in chips) 
Seat 4: LoletsPadre (11258 in chips) 
Seat 6: adabrakadabra (5992 in chips) 
Seat 7: jcarlos.vale (9132 in chips) 
Seat 8: I`m Parasite (13298 in chips) 
pro100zoom777: posts the ante 50
LoletsPadre: posts the ante 50
adabrakadabra: posts the ante 50
jcarlos.vale: posts the ante 50
I`m Parasite: posts the ante 50
I`m Parasite: posts small blind 300
pro100zoom777: posts big blind 600
*** HOLE CARDS ***
Dealt to jcarlos.vale [4d 4c]
LoletsPadre: folds 
adabrakadabra: folds 
jcarlos.vale: raises 8482 to 9082 and is all-in
I`m Parasite: folds 
pro100zoom777: folds 
Uncalled bet (8482) returned to jcarlos.vale
jcarlos.vale collected 1750 from pot
jcarlos.vale: doesn't show handDTO
*** SUMMARY ***
Total pot 1750 | Rake 0 
Seat 2: pro100zoom777 (big blind) folded before Flop
Seat 4: LoletsPadre folded before Flop (didn't bet)
Seat 6: adabrakadabra folded before Flop (didn't bet)
Seat 7: jcarlos.vale (button) collected (1750)
Seat 8: I`m Parasite (small blind) folded before Flop



PokerStars Hand #221592861042: Tournament #3079328305, $0.91+$0.09 USD Hold'em No Limit - Level X (300/600) - 2020/12/19 2:53:53 EET [2020/12/18 19:53:53 ET]
Table '3079328305 4' 9-max Seat #8 is the button
Seat 2: pro100zoom777 (27170 in chips) 
Seat 4: LoletsPadre (11208 in chips) 
Seat 6: adabrakadabra (5942 in chips) 
Seat 7: jcarlos.vale (10232 in chips) 
Seat 8: I`m Parasite (12948 in chips) 
pro100zoom777: posts the ante 50
LoletsPadre: posts the ante 50
adabrakadabra: posts the ante 50
jcarlos.vale: posts the ante 50
I`m Parasite: posts the ante 50
pro100zoom777: posts small blind 300
LoletsPadre: posts big blind 600
*** HOLE CARDS ***
Dealt to jcarlos.vale [7d 9s]
adabrakadabra: folds 
jcarlos.vale: folds 
I`m Parasite: folds 
pro100zoom777: raises 1500 to 2100
LoletsPadre: folds 
Uncalled bet (1500) returned to pro100zoom777
pro100zoom777 collected 1450 from pot
*** SUMMARY ***
Total pot 1450 | Rake 0 
Seat 2: pro100zoom777 (small blind) collected (1450)
Seat 4: LoletsPadre (big blind) folded before Flop
Seat 6: adabrakadabra folded before Flop (didn't bet)
Seat 7: jcarlos.vale folded before Flop (didn't bet)
Seat 8: I`m Parasite (button) folded before Flop (didn't bet)



PokerStars Hand #221592870350: Tournament #3079328305, $0.91+$0.09 USD Hold'em No Limit - Level X (300/600) - 2020/12/19 2:54:14 EET [2020/12/18 19:54:14 ET]
Table '3079328305 4' 9-max Seat #2 is the button
Seat 2: pro100zoom777 (27970 in chips) 
Seat 4: LoletsPadre (10558 in chips) 
Seat 6: adabrakadabra (5892 in chips) 
Seat 7: jcarlos.vale (10182 in chips) 
Seat 8: I`m Parasite (12898 in chips) 
pro100zoom777: posts the ante 50
LoletsPadre: posts the ante 50
adabrakadabra: posts the ante 50
jcarlos.vale: posts the ante 50
I`m Parasite: posts the ante 50
LoletsPadre: posts small blind 300
adabrakadabra: posts big blind 600
*** HOLE CARDS ***
Dealt to jcarlos.vale [Kc 4d]
jcarlos.vale: folds 
I`m Parasite: raises 600 to 1200
pro100zoom777: folds 
LoletsPadre: folds 
adabrakadabra: folds 
Uncalled bet (600) returned to I`m Parasite
I`m Parasite collected 1750 from pot
I`m Parasite: doesn't show handDTO
*** SUMMARY ***
Total pot 1750 | Rake 0 
Seat 2: pro100zoom777 (button) folded before Flop (didn't bet)
Seat 4: LoletsPadre (small blind) folded before Flop
Seat 6: adabrakadabra (big blind) folded before Flop
Seat 7: jcarlos.vale folded before Flop (didn't bet)
Seat 8: I`m Parasite collected (1750)



PokerStars Hand #221592880076: Tournament #3079328305, $0.91+$0.09 USD Hold'em No Limit - Level X (300/600) - 2020/12/19 2:54:36 EET [2020/12/18 19:54:36 ET]
Table '3079328305 4' 9-max Seat #4 is the button
Seat 2: pro100zoom777 (27920 in chips) 
Seat 4: LoletsPadre (10208 in chips) 
Seat 6: adabrakadabra (5242 in chips) 
Seat 7: jcarlos.vale (10132 in chips) 
Seat 8: I`m Parasite (13998 in chips) 
pro100zoom777: posts the ante 50
LoletsPadre: posts the ante 50
adabrakadabra: posts the ante 50
jcarlos.vale: posts the ante 50
I`m Parasite: posts the ante 50
adabrakadabra: posts small blind 300
jcarlos.vale: posts big blind 600
*** HOLE CARDS ***
Dealt to jcarlos.vale [Kc 5s]
I`m Parasite: folds 
pro100zoom777: folds 
LoletsPadre: raises 800 to 1400
adabrakadabra: folds 
jcarlos.vale: folds 
Uncalled bet (800) returned to LoletsPadre
LoletsPadre collected 1750 from pot
*** SUMMARY ***
Total pot 1750 | Rake 0 
Seat 2: pro100zoom777 folded before Flop (didn't bet)
Seat 4: LoletsPadre (button) collected (1750)
Seat 6: adabrakadabra (small blind) folded before Flop
Seat 7: jcarlos.vale (big blind) folded before Flop
Seat 8: I`m Parasite folded before Flop (didn't bet)



PokerStars Hand #221593003162: Tournament #3079328305, $0.91+$0.09 USD Hold'em No Limit - Level X (300/600) - 2020/12/19 3:00:12 EET [2020/12/18 20:00:12 ET]
Table '3079328305 4' 9-max Seat #6 is the button
Seat 2: pro100zoom777 (27870 in chips) 
Seat 4: LoletsPadre (11308 in chips) 
Seat 6: adabrakadabra (4892 in chips) 
Seat 7: jcarlos.vale (9482 in chips) 
Seat 8: I`m Parasite (13948 in chips) 
pro100zoom777: posts the ante 50
LoletsPadre: posts the ante 50
adabrakadabra: posts the ante 50
jcarlos.vale: posts the ante 50
I`m Parasite: posts the ante 50
jcarlos.vale: posts small blind 300
I`m Parasite: posts big blind 600
*** HOLE CARDS ***
Dealt to jcarlos.vale [6d 6c]
pro100zoom777: folds 
LoletsPadre: folds 
adabrakadabra: folds 
jcarlos.vale: raises 8832 to 9432 and is all-in
I`m Parasite: folds 
Uncalled bet (8832) returned to jcarlos.vale
jcarlos.vale collected 1450 from pot
jcarlos.vale: doesn't show handDTO
*** SUMMARY ***
Total pot 1450 | Rake 0 
Seat 2: pro100zoom777 folded before Flop (didn't bet)
Seat 4: LoletsPadre folded before Flop (didn't bet)
Seat 6: adabrakadabra (button) folded before Flop (didn't bet)
Seat 7: jcarlos.vale (small blind) collected (1450)
Seat 8: I`m Parasite (big blind) folded before Flop



PokerStars Hand #221593015564: Tournament #3079328305, $0.91+$0.09 USD Hold'em No Limit - Level X (300/600) - 2020/12/19 3:00:43 EET [2020/12/18 20:00:43 ET]
Table '3079328305 4' 9-max Seat #7 is the button
Seat 2: pro100zoom777 (27820 in chips) 
Seat 4: LoletsPadre (11258 in chips) 
Seat 6: adabrakadabra (4842 in chips) 
Seat 7: jcarlos.vale (10282 in chips) 
Seat 8: I`m Parasite (13298 in chips) 
pro100zoom777: posts the ante 50
LoletsPadre: posts the ante 50
adabrakadabra: posts the ante 50
jcarlos.vale: posts the ante 50
I`m Parasite: posts the ante 50
I`m Parasite: posts small blind 300
pro100zoom777: posts big blind 600
*** HOLE CARDS ***
Dealt to jcarlos.vale [Td 8d]
LoletsPadre: folds 
adabrakadabra: folds 
jcarlos.vale: folds 
I`m Parasite: raises 600 to 1200
pro100zoom777: raises 1800 to 3000
I`m Parasite: folds 
Uncalled bet (1800) returned to pro100zoom777
pro100zoom777 collected 2650 from pot
*** SUMMARY ***
Total pot 2650 | Rake 0 
Seat 2: pro100zoom777 (big blind) collected (2650)
Seat 4: LoletsPadre folded before Flop (didn't bet)
Seat 6: adabrakadabra folded before Flop (didn't bet)
Seat 7: jcarlos.vale (button) folded before Flop (didn't bet)
Seat 8: I`m Parasite (small blind) folded before Flop



PokerStars Hand #221593023594: Tournament #3079328305, $0.91+$0.09 USD Hold'em No Limit - Level X (300/600) - 2020/12/19 3:01:03 EET [2020/12/18 20:01:03 ET]
Table '3079328305 4' 9-max Seat #8 is the button
Seat 2: pro100zoom777 (29220 in chips) 
Seat 4: LoletsPadre (11208 in chips) 
Seat 6: adabrakadabra (4792 in chips) 
Seat 7: jcarlos.vale (10232 in chips) 
Seat 8: I`m Parasite (12048 in chips) 
pro100zoom777: posts the ante 50
LoletsPadre: posts the ante 50
adabrakadabra: posts the ante 50
jcarlos.vale: posts the ante 50
I`m Parasite: posts the ante 50
pro100zoom777: posts small blind 300
LoletsPadre: posts big blind 600
*** HOLE CARDS ***
Dealt to jcarlos.vale [As 8s]
adabrakadabra: folds 
jcarlos.vale: raises 9582 to 10182 and is all-in
I`m Parasite: folds 
pro100zoom777: calls 9882
LoletsPadre: folds 
*** FLOP *** [9c 7d 6s]
*** TURN *** [9c 7d 6s] [9h]
*** RIVER *** [9c 7d 6s 9h] [5s]
*** SHOW DOWN ***
pro100zoom777: shows [Td Tc] (two pair, Tens and Nines)
jcarlos.vale: shows [As 8s] (a straight, Five to Nine)
jcarlos.vale collected 21214 from pot
*** SUMMARY ***
Total pot 21214 | Rake 0 
Board [9c 7d 6s 9h 5s]
Seat 2: pro100zoom777 (small blind) showed [Td Tc] and lost with two pair, Tens and Nines
Seat 4: LoletsPadre (big blind) folded before Flop
Seat 6: adabrakadabra folded before Flop (didn't bet)
Seat 7: jcarlos.vale showed [As 8s] and won (21214) with a straight, Five to Nine
Seat 8: I`m Parasite (button) folded before Flop (didn't bet)



PokerStars Hand #221593050687: Tournament #3079328305, $0.91+$0.09 USD Hold'em No Limit - Level X (300/600) - 2020/12/19 3:01:32 EET [2020/12/18 20:01:32 ET]
Table '3079328305 4' 9-max Seat #2 is the button
Seat 2: pro100zoom777 (18988 in chips) 
Seat 4: LoletsPadre (10558 in chips) 
Seat 6: adabrakadabra (4742 in chips) 
Seat 7: jcarlos.vale (21214 in chips) 
Seat 8: I`m Parasite (11998 in chips) 
pro100zoom777: posts the ante 50
LoletsPadre: posts the ante 50
adabrakadabra: posts the ante 50
jcarlos.vale: posts the ante 50
I`m Parasite: posts the ante 50
LoletsPadre: posts small blind 300
adabrakadabra: posts big blind 600
*** HOLE CARDS ***
Dealt to jcarlos.vale [4h 6d]
jcarlos.vale: folds 
I`m Parasite: folds 
pro100zoom777: raises 660 to 1260
LoletsPadre: folds 
adabrakadabra: raises 3432 to 4692 and is all-in
pro100zoom777: calls 3432
*** FLOP *** [9s 7d 2d]
*** TURN *** [9s 7d 2d] [Qc]
*** RIVER *** [9s 7d 2d Qc] [5s]
*** SHOW DOWN ***
adabrakadabra: shows [Kh Kc] (a pair of Kings)
pro100zoom777: shows [Ad Qs] (a pair of Queens)
adabrakadabra collected 9934 from pot
*** SUMMARY ***
Total pot 9934 | Rake 0 
Board [9s 7d 2d Qc 5s]
Seat 2: pro100zoom777 (button) showed [Ad Qs] and lost with a pair of Queens
Seat 4: LoletsPadre (small blind) folded before Flop
Seat 6: adabrakadabra (big blind) showed [Kh Kc] and won (9934) with a pair of Kings
Seat 7: jcarlos.vale folded before Flop (didn't bet)
Seat 8: I`m Parasite folded before Flop (didn't bet)



PokerStars Hand #221593067214: Tournament #3079328305, $0.91+$0.09 USD Hold'em No Limit - Level X (300/600) - 2020/12/19 3:02:10 EET [2020/12/18 20:02:10 ET]
Table '3079328305 4' 9-max Seat #4 is the button
Seat 2: pro100zoom777 (14246 in chips) 
Seat 4: LoletsPadre (10208 in chips) 
Seat 6: adabrakadabra (9934 in chips) 
Seat 7: jcarlos.vale (21164 in chips) 
Seat 8: I`m Parasite (11948 in chips) 
pro100zoom777: posts the ante 50
LoletsPadre: posts the ante 50
adabrakadabra: posts the ante 50
jcarlos.vale: posts the ante 50
I`m Parasite: posts the ante 50
adabrakadabra: posts small blind 300
jcarlos.vale: posts big blind 600
*** HOLE CARDS ***
Dealt to jcarlos.vale [2c Qc]
I`m Parasite: raises 600 to 1200
pro100zoom777: folds 
LoletsPadre: folds 
adabrakadabra: folds 
jcarlos.vale: folds 
Uncalled bet (600) returned to I`m Parasite
I`m Parasite collected 1750 from pot
I`m Parasite: doesn't show handDTO
*** SUMMARY ***
Total pot 1750 | Rake 0 
Seat 2: pro100zoom777 folded before Flop (didn't bet)
Seat 4: LoletsPadre (button) folded before Flop (didn't bet)
Seat 6: adabrakadabra (small blind) folded before Flop
Seat 7: jcarlos.vale (big blind) folded before Flop
Seat 8: I`m Parasite collected (1750)



PokerStars Hand #221593074594: Tournament #3079328305, $0.91+$0.09 USD Hold'em No Limit - Level X (300/600) - 2020/12/19 3:02:27 EET [2020/12/18 20:02:27 ET]
Table '3079328305 4' 9-max Seat #6 is the button
Seat 2: pro100zoom777 (14196 in chips) 
Seat 4: LoletsPadre (10158 in chips) 
Seat 6: adabrakadabra (9584 in chips) 
Seat 7: jcarlos.vale (20514 in chips) 
Seat 8: I`m Parasite (13048 in chips) 
pro100zoom777: posts the ante 50
LoletsPadre: posts the ante 50
adabrakadabra: posts the ante 50
jcarlos.vale: posts the ante 50
I`m Parasite: posts the ante 50
jcarlos.vale: posts small blind 300
I`m Parasite: posts big blind 600
*** HOLE CARDS ***
Dealt to jcarlos.vale [4c 9s]
pro100zoom777: folds 
LoletsPadre: folds 
adabrakadabra: raises 600 to 1200
jcarlos.vale: folds 
I`m Parasite: calls 600
*** FLOP *** [Qd 2d 3s]
I`m Parasite: checks 
adabrakadabra: checks 
*** TURN *** [Qd 2d 3s] [Js]
I`m Parasite: checks 
adabrakadabra: checks 
*** RIVER *** [Qd 2d 3s Js] [5d]
I`m Parasite: checks 
adabrakadabra: checks 
*** SHOW DOWN ***
I`m Parasite: shows [8c Jh] (a pair of Jacks)
adabrakadabra: mucks handDTO
I`m Parasite collected 2950 from pot
*** SUMMARY ***
Total pot 2950 | Rake 0 
Board [Qd 2d 3s Js 5d]
Seat 2: pro100zoom777 folded before Flop (didn't bet)
Seat 4: LoletsPadre folded before Flop (didn't bet)
Seat 6: adabrakadabra (button) mucked [Ts Ac]
Seat 7: jcarlos.vale (small blind) folded before Flop
Seat 8: I`m Parasite (big blind) showed [8c Jh] and won (2950) with a pair of Jacks



PokerStars Hand #221593095894: Tournament #3079328305, $0.91+$0.09 USD Hold'em No Limit - Level XI (400/800) - 2020/12/19 3:03:16 EET [2020/12/18 20:03:16 ET]
Table '3079328305 4' 9-max Seat #7 is the button
Seat 2: pro100zoom777 (14146 in chips) 
Seat 4: LoletsPadre (10108 in chips) 
Seat 6: adabrakadabra (8334 in chips) 
Seat 7: jcarlos.vale (20164 in chips) 
Seat 8: I`m Parasite (14748 in chips) 
pro100zoom777: posts the ante 50
LoletsPadre: posts the ante 50
adabrakadabra: posts the ante 50
jcarlos.vale: posts the ante 50
I`m Parasite: posts the ante 50
I`m Parasite: posts small blind 400
pro100zoom777: posts big blind 800
*** HOLE CARDS ***
Dealt to jcarlos.vale [3d 8s]
LoletsPadre: raises 9258 to 10058 and is all-in
adabrakadabra: calls 8284 and is all-in
jcarlos.vale: folds 
I`m Parasite: folds 
pro100zoom777: folds 
Uncalled bet (1774) returned to LoletsPadre
*** FLOP *** [2d 7c Tc]
*** TURN *** [2d 7c Tc] [4h]
*** RIVER *** [2d 7c Tc 4h] [Ks]
*** SHOW DOWN ***
LoletsPadre: shows [As 6h] (high pairOfCards Ace)
adabrakadabra: shows [Ah Ad] (a pair of Aces)
adabrakadabra collected 18018 from pot
*** SUMMARY ***
Total pot 18018 | Rake 0 
Board [2d 7c Tc 4h Ks]
Seat 2: pro100zoom777 (big blind) folded before Flop
Seat 4: LoletsPadre showed [As 6h] and lost with high pairOfCards Ace
Seat 6: adabrakadabra showed [Ah Ad] and won (18018) with a pair of Aces
Seat 7: jcarlos.vale (button) folded before Flop (didn't bet)
Seat 8: I`m Parasite (small blind) folded before Flop



PokerStars Hand #221593113333: Tournament #3079328305, $0.91+$0.09 USD Hold'em No Limit - Level XI (400/800) - 2020/12/19 3:03:55 EET [2020/12/18 20:03:55 ET]
Table '3079328305 4' 9-max Seat #8 is the button
Seat 2: pro100zoom777 (13296 in chips) 
Seat 4: LoletsPadre (1774 in chips) 
Seat 6: adabrakadabra (18018 in chips) 
Seat 7: jcarlos.vale (20114 in chips) 
Seat 8: I`m Parasite (14298 in chips) 
pro100zoom777: posts the ante 50
LoletsPadre: posts the ante 50
adabrakadabra: posts the ante 50
jcarlos.vale: posts the ante 50
I`m Parasite: posts the ante 50
pro100zoom777: posts small blind 400
LoletsPadre: posts big blind 800
*** HOLE CARDS ***
Dealt to jcarlos.vale [2c 5d]
adabrakadabra: folds 
jcarlos.vale: folds 
I`m Parasite: raises 800 to 1600
pro100zoom777: folds 
LoletsPadre: raises 124 to 1724 and is all-in
I`m Parasite: calls 124
*** FLOP *** [2s 4s 8d]
*** TURN *** [2s 4s 8d] [7c]
*** RIVER *** [2s 4s 8d 7c] [6d]
*** SHOW DOWN ***
LoletsPadre: shows [7s 4d] (two pair, Sevens and Fours)
I`m Parasite: shows [9d Kh] (high pairOfCards King)
LoletsPadre collected 4098 from pot
*** SUMMARY ***
Total pot 4098 | Rake 0 
Board [2s 4s 8d 7c 6d]
Seat 2: pro100zoom777 (small blind) folded before Flop
Seat 4: LoletsPadre (big blind) showed [7s 4d] and won (4098) with two pair, Sevens and Fours
Seat 6: adabrakadabra folded before Flop (didn't bet)
Seat 7: jcarlos.vale folded before Flop (didn't bet)
Seat 8: I`m Parasite (button) showed [9d Kh] and lost with high pairOfCards King



PokerStars Hand #221593134254: Tournament #3079328305, $0.91+$0.09 USD Hold'em No Limit - Level XI (400/800) - 2020/12/19 3:04:43 EET [2020/12/18 20:04:43 ET]
Table '3079328305 4' 9-max Seat #2 is the button
Seat 2: pro100zoom777 (12846 in chips) 
Seat 4: LoletsPadre (4098 in chips) 
Seat 6: adabrakadabra (17968 in chips) 
Seat 7: jcarlos.vale (20064 in chips) 
Seat 8: I`m Parasite (12524 in chips) 
pro100zoom777: posts the ante 50
LoletsPadre: posts the ante 50
adabrakadabra: posts the ante 50
jcarlos.vale: posts the ante 50
I`m Parasite: posts the ante 50
LoletsPadre: posts small blind 400
adabrakadabra: posts big blind 800
*** HOLE CARDS ***
Dealt to jcarlos.vale [2c Qs]
jcarlos.vale: folds 
I`m Parasite: folds 
pro100zoom777: raises 800 to 1600
LoletsPadre: folds 
adabrakadabra: folds 
Uncalled bet (800) returned to pro100zoom777
pro100zoom777 collected 2250 from pot
*** SUMMARY ***
Total pot 2250 | Rake 0 
Seat 2: pro100zoom777 (button) collected (2250)
Seat 4: LoletsPadre (small blind) folded before Flop
Seat 6: adabrakadabra (big blind) folded before Flop
Seat 7: jcarlos.vale folded before Flop (didn't bet)
Seat 8: I`m Parasite folded before Flop (didn't bet)



PokerStars Hand #221593142405: Tournament #3079328305, $0.91+$0.09 USD Hold'em No Limit - Level XI (400/800) - 2020/12/19 3:05:02 EET [2020/12/18 20:05:02 ET]
Table '3079328305 4' 9-max Seat #4 is the button
Seat 2: pro100zoom777 (14246 in chips) 
Seat 4: LoletsPadre (3648 in chips) 
Seat 6: adabrakadabra (17118 in chips) 
Seat 7: jcarlos.vale (20014 in chips) 
Seat 8: I`m Parasite (12474 in chips) 
pro100zoom777: posts the ante 50
LoletsPadre: posts the ante 50
adabrakadabra: posts the ante 50
jcarlos.vale: posts the ante 50
I`m Parasite: posts the ante 50
adabrakadabra: posts small blind 400
jcarlos.vale: posts big blind 800
*** HOLE CARDS ***
Dealt to jcarlos.vale [2c 5d]
I`m Parasite: raises 800 to 1600
pro100zoom777: folds 
LoletsPadre: raises 1998 to 3598 and is all-in
adabrakadabra: folds 
jcarlos.vale: folds 
I`m Parasite: calls 1998
*** FLOP *** [9h 4c Ts]
*** TURN *** [9h 4c Ts] [4h]
*** RIVER *** [9h 4c Ts 4h] [Td]
*** SHOW DOWN ***
I`m Parasite: shows [3c Ac] (two pair, Tens and Fours)
LoletsPadre: shows [3d Ad] (two pair, Tens and Fours)
I`m Parasite collected 4323 from pot
LoletsPadre collected 4323 from pot
*** SUMMARY ***
Total pot 8646 | Rake 0 
Board [9h 4c Ts 4h Td]
Seat 2: pro100zoom777 folded before Flop (didn't bet)
Seat 4: LoletsPadre (button) showed [3d Ad] and won (4323) with two pair, Tens and Fours
Seat 6: adabrakadabra (small blind) folded before Flop
Seat 7: jcarlos.vale (big blind) folded before Flop
Seat 8: I`m Parasite showed [3c Ac] and won (4323) with two pair, Tens and Fours



PokerStars Hand #221593155597: Tournament #3079328305, $0.91+$0.09 USD Hold'em No Limit - Level XI (400/800) - 2020/12/19 3:05:31 EET [2020/12/18 20:05:31 ET]
Table '3079328305 4' 9-max Seat #6 is the button
Seat 2: pro100zoom777 (14196 in chips) 
Seat 4: LoletsPadre (4323 in chips) 
Seat 6: adabrakadabra (16668 in chips) 
Seat 7: jcarlos.vale (19164 in chips) 
Seat 8: I`m Parasite (13149 in chips) 
pro100zoom777: posts the ante 50
LoletsPadre: posts the ante 50
adabrakadabra: posts the ante 50
jcarlos.vale: posts the ante 50
I`m Parasite: posts the ante 50
jcarlos.vale: posts small blind 400
I`m Parasite: posts big blind 800
*** HOLE CARDS ***
Dealt to jcarlos.vale [5h 7d]
pro100zoom777: raises 880 to 1680
LoletsPadre: folds 
adabrakadabra: folds 
jcarlos.vale: folds 
I`m Parasite: calls 880
*** FLOP *** [2h 4s 3d]
I`m Parasite: checks 
pro100zoom777: bets 1163
I`m Parasite: calls 1163
*** TURN *** [2h 4s 3d] [Jc]
I`m Parasite: checks 
pro100zoom777: bets 1837
I`m Parasite: folds 
Uncalled bet (1837) returned to pro100zoom777
pro100zoom777 collected 6336 from pot
*** SUMMARY ***
Total pot 6336 | Rake 0 
Board [2h 4s 3d Jc]
Seat 2: pro100zoom777 collected (6336)
Seat 4: LoletsPadre folded before Flop (didn't bet)
Seat 6: adabrakadabra (button) folded before Flop (didn't bet)
Seat 7: jcarlos.vale (small blind) folded before Flop
Seat 8: I`m Parasite (big blind) folded on the Turn



PokerStars Hand #221593172418: Tournament #3079328305, $0.91+$0.09 USD Hold'em No Limit - Level XI (400/800) - 2020/12/19 3:06:10 EET [2020/12/18 20:06:10 ET]
Table '3079328305 4' 9-max Seat #7 is the button
Seat 2: pro100zoom777 (17639 in chips) 
Seat 4: LoletsPadre (4273 in chips) 
Seat 6: adabrakadabra (16618 in chips) 
Seat 7: jcarlos.vale (18714 in chips) 
Seat 8: I`m Parasite (10256 in chips) 
pro100zoom777: posts the ante 50
LoletsPadre: posts the ante 50
adabrakadabra: posts the ante 50
jcarlos.vale: posts the ante 50
I`m Parasite: posts the ante 50
I`m Parasite: posts small blind 400
pro100zoom777: posts big blind 800
*** HOLE CARDS ***
Dealt to jcarlos.vale [4d As]
LoletsPadre: raises 3423 to 4223 and is all-in
adabrakadabra: folds 
jcarlos.vale: folds 
I`m Parasite: folds 
pro100zoom777: folds 
Uncalled bet (3423) returned to LoletsPadre
LoletsPadre collected 2250 from pot
LoletsPadre: doesn't show handDTO
*** SUMMARY ***
Total pot 2250 | Rake 0 
Seat 2: pro100zoom777 (big blind) folded before Flop
Seat 4: LoletsPadre collected (2250)
Seat 6: adabrakadabra folded before Flop (didn't bet)
Seat 7: jcarlos.vale (button) folded before Flop (didn't bet)
Seat 8: I`m Parasite (small blind) folded before Flop



PokerStars Hand #221593179707: Tournament #3079328305, $0.91+$0.09 USD Hold'em No Limit - Level XI (400/800) - 2020/12/19 3:06:27 EET [2020/12/18 20:06:27 ET]
Table '3079328305 4' 9-max Seat #8 is the button
Seat 2: pro100zoom777 (16789 in chips) 
Seat 4: LoletsPadre (5673 in chips) 
Seat 6: adabrakadabra (16568 in chips) 
Seat 7: jcarlos.vale (18664 in chips) 
Seat 8: I`m Parasite (9806 in chips) 
pro100zoom777: posts the ante 50
LoletsPadre: posts the ante 50
adabrakadabra: posts the ante 50
jcarlos.vale: posts the ante 50
I`m Parasite: posts the ante 50
pro100zoom777: posts small blind 400
LoletsPadre: posts big blind 800
*** HOLE CARDS ***
Dealt to jcarlos.vale [8h 7s]
adabrakadabra: folds 
jcarlos.vale: folds 
I`m Parasite: folds 
pro100zoom777: folds 
Uncalled bet (400) returned to LoletsPadre
LoletsPadre collected 1050 from pot
LoletsPadre: doesn't show handDTO
*** SUMMARY ***
Total pot 1050 | Rake 0 
Seat 2: pro100zoom777 (small blind) folded before Flop
Seat 4: LoletsPadre (big blind) collected (1050)
Seat 6: adabrakadabra folded before Flop (didn't bet)
Seat 7: jcarlos.vale folded before Flop (didn't bet)
Seat 8: I`m Parasite (button) folded before Flop (didn't bet)



PokerStars Hand #221593184549: Tournament #3079328305, $0.91+$0.09 USD Hold'em No Limit - Level XI (400/800) - 2020/12/19 3:06:38 EET [2020/12/18 20:06:38 ET]
Table '3079328305 4' 9-max Seat #2 is the button
Seat 2: pro100zoom777 (16339 in chips) 
Seat 4: LoletsPadre (6273 in chips) 
Seat 6: adabrakadabra (16518 in chips) 
Seat 7: jcarlos.vale (18614 in chips) 
Seat 8: I`m Parasite (9756 in chips) 
pro100zoom777: posts the ante 50
LoletsPadre: posts the ante 50
adabrakadabra: posts the ante 50
jcarlos.vale: posts the ante 50
I`m Parasite: posts the ante 50
LoletsPadre: posts small blind 400
adabrakadabra: posts big blind 800
*** HOLE CARDS ***
Dealt to jcarlos.vale [As 5s]
jcarlos.vale: raises 1280 to 2080
I`m Parasite: folds 
pro100zoom777: folds 
LoletsPadre: folds 
adabrakadabra: folds 
Uncalled bet (1280) returned to jcarlos.vale
jcarlos.vale collected 2250 from pot
jcarlos.vale: doesn't show handDTO
*** SUMMARY ***
Total pot 2250 | Rake 0 
Seat 2: pro100zoom777 (button) folded before Flop (didn't bet)
Seat 4: LoletsPadre (small blind) folded before Flop
Seat 6: adabrakadabra (big blind) folded before Flop
Seat 7: jcarlos.vale collected (2250)
Seat 8: I`m Parasite folded before Flop (didn't bet)



PokerStars Hand #221593190906: Tournament #3079328305, $0.91+$0.09 USD Hold'em No Limit - Level XI (400/800) - 2020/12/19 3:06:53 EET [2020/12/18 20:06:53 ET]
Table '3079328305 4' 9-max Seat #4 is the button
Seat 2: pro100zoom777 (16289 in chips) 
Seat 4: LoletsPadre (5823 in chips) 
Seat 6: adabrakadabra (15668 in chips) 
Seat 7: jcarlos.vale (20014 in chips) 
Seat 8: I`m Parasite (9706 in chips) 
pro100zoom777: posts the ante 50
LoletsPadre: posts the ante 50
adabrakadabra: posts the ante 50
jcarlos.vale: posts the ante 50
I`m Parasite: posts the ante 50
adabrakadabra: posts small blind 400
jcarlos.vale: posts big blind 800
*** HOLE CARDS ***
Dealt to jcarlos.vale [3s 9d]
I`m Parasite: folds 
pro100zoom777: folds 
LoletsPadre: folds 
adabrakadabra: folds 
Uncalled bet (400) returned to jcarlos.vale
jcarlos.vale collected 1050 from pot
jcarlos.vale: doesn't show handDTO
*** SUMMARY ***
Total pot 1050 | Rake 0 
Seat 2: pro100zoom777 folded before Flop (didn't bet)
Seat 4: LoletsPadre (button) folded before Flop (didn't bet)
Seat 6: adabrakadabra (small blind) folded before Flop
Seat 7: jcarlos.vale (big blind) collected (1050)
Seat 8: I`m Parasite folded before Flop (didn't bet)



PokerStars Hand #221593196876: Tournament #3079328305, $0.91+$0.09 USD Hold'em No Limit - Level XI (400/800) - 2020/12/19 3:07:05 EET [2020/12/18 20:07:05 ET]
Table '3079328305 4' 9-max Seat #6 is the button
Seat 2: pro100zoom777 (16239 in chips) 
Seat 4: LoletsPadre (5773 in chips) 
Seat 6: adabrakadabra (15218 in chips) 
Seat 7: jcarlos.vale (20614 in chips) 
Seat 8: I`m Parasite (9656 in chips) 
pro100zoom777: posts the ante 50
LoletsPadre: posts the ante 50
adabrakadabra: posts the ante 50
jcarlos.vale: posts the ante 50
I`m Parasite: posts the ante 50
jcarlos.vale: posts small blind 400
I`m Parasite: posts big blind 800
*** HOLE CARDS ***
Dealt to jcarlos.vale [4c Jc]
pro100zoom777: folds 
LoletsPadre: folds 
adabrakadabra: folds 
jcarlos.vale: folds 
Uncalled bet (400) returned to I`m Parasite
I`m Parasite collected 1050 from pot
I`m Parasite: doesn't show handDTO
*** SUMMARY ***
Total pot 1050 | Rake 0 
Seat 2: pro100zoom777 folded before Flop (didn't bet)
Seat 4: LoletsPadre folded before Flop (didn't bet)
Seat 6: adabrakadabra (button) folded before Flop (didn't bet)
Seat 7: jcarlos.vale (small blind) folded before Flop
Seat 8: I`m Parasite (big blind) collected (1050)



PokerStars Hand #221593203732: Tournament #3079328305, $0.91+$0.09 USD Hold'em No Limit - Level XI (400/800) - 2020/12/19 3:07:21 EET [2020/12/18 20:07:21 ET]
Table '3079328305 4' 9-max Seat #7 is the button
Seat 2: pro100zoom777 (16189 in chips) 
Seat 4: LoletsPadre (5723 in chips) 
Seat 6: adabrakadabra (15168 in chips) 
Seat 7: jcarlos.vale (20164 in chips) 
Seat 8: I`m Parasite (10256 in chips) 
pro100zoom777: posts the ante 50
LoletsPadre: posts the ante 50
adabrakadabra: posts the ante 50
jcarlos.vale: posts the ante 50
I`m Parasite: posts the ante 50
I`m Parasite: posts small blind 400
pro100zoom777: posts big blind 800
*** HOLE CARDS ***
Dealt to jcarlos.vale [As 3d]
LoletsPadre: folds 
adabrakadabra: folds 
jcarlos.vale: folds 
I`m Parasite: folds 
Uncalled bet (400) returned to pro100zoom777
pro100zoom777 collected 1050 from pot
*** SUMMARY ***
Total pot 1050 | Rake 0 
Seat 2: pro100zoom777 (big blind) collected (1050)
Seat 4: LoletsPadre folded before Flop (didn't bet)
Seat 6: adabrakadabra folded before Flop (didn't bet)
Seat 7: jcarlos.vale (button) folded before Flop (didn't bet)
Seat 8: I`m Parasite (small blind) folded before Flop



PokerStars Hand #221593209770: Tournament #3079328305, $0.91+$0.09 USD Hold'em No Limit - Level XI (400/800) - 2020/12/19 3:07:35 EET [2020/12/18 20:07:35 ET]
Table '3079328305 4' 9-max Seat #8 is the button
Seat 2: pro100zoom777 (16789 in chips) 
Seat 4: LoletsPadre (5673 in chips) 
Seat 6: adabrakadabra (15118 in chips) 
Seat 7: jcarlos.vale (20114 in chips) 
Seat 8: I`m Parasite (9806 in chips) 
pro100zoom777: posts the ante 50
LoletsPadre: posts the ante 50
adabrakadabra: posts the ante 50
jcarlos.vale: posts the ante 50
I`m Parasite: posts the ante 50
pro100zoom777: posts small blind 400
LoletsPadre: posts big blind 800
*** HOLE CARDS ***
Dealt to jcarlos.vale [3s 4c]
adabrakadabra: raises 14268 to 15068 and is all-in
jcarlos.vale: folds 
I`m Parasite: folds 
pro100zoom777: folds 
LoletsPadre: calls 4823 and is all-in
Uncalled bet (9445) returned to adabrakadabra
*** FLOP *** [5h 9d 5c]
*** TURN *** [5h 9d 5c] [2d]
*** RIVER *** [5h 9d 5c 2d] [9h]
*** SHOW DOWN ***
LoletsPadre: shows [Jh As] (two pair, Nines and Fives)
adabrakadabra: shows [Ad Kd] (two pair, Nines and Fives)
LoletsPadre collected 5948 from pot
adabrakadabra collected 5948 from pot
*** SUMMARY ***
Total pot 11896 | Rake 0 
Board [5h 9d 5c 2d 9h]
Seat 2: pro100zoom777 (small blind) folded before Flop
Seat 4: LoletsPadre (big blind) showed [Jh As] and won (5948) with two pair, Nines and Fives
Seat 6: adabrakadabra showed [Ad Kd] and won (5948) with two pair, Nines and Fives
Seat 7: jcarlos.vale folded before Flop (didn't bet)
Seat 8: I`m Parasite (button) folded before Flop (didn't bet)



PokerStars Hand #221593228181: Tournament #3079328305, $0.91+$0.09 USD Hold'em No Limit - Level XI (400/800) - 2020/12/19 3:08:17 EET [2020/12/18 20:08:17 ET]
Table '3079328305 4' 9-max Seat #2 is the button
Seat 2: pro100zoom777 (16339 in chips) 
Seat 4: LoletsPadre (5948 in chips) 
Seat 6: adabrakadabra (15393 in chips) 
Seat 7: jcarlos.vale (20064 in chips) 
Seat 8: I`m Parasite (9756 in chips) 
pro100zoom777: posts the ante 50
LoletsPadre: posts the ante 50
adabrakadabra: posts the ante 50
jcarlos.vale: posts the ante 50
I`m Parasite: posts the ante 50
LoletsPadre: posts small blind 400
adabrakadabra: posts big blind 800
*** HOLE CARDS ***
Dealt to jcarlos.vale [8s 2c]
jcarlos.vale: folds 
I`m Parasite: raises 8906 to 9706 and is all-in
pro100zoom777: folds 
LoletsPadre: folds 
adabrakadabra: folds 
Uncalled bet (8906) returned to I`m Parasite
I`m Parasite collected 2250 from pot
I`m Parasite: doesn't show handDTO
*** SUMMARY ***
Total pot 2250 | Rake 0 
Seat 2: pro100zoom777 (button) folded before Flop (didn't bet)
Seat 4: LoletsPadre (small blind) folded before Flop
Seat 6: adabrakadabra (big blind) folded before Flop
Seat 7: jcarlos.vale folded before Flop (didn't bet)
Seat 8: I`m Parasite collected (2250)



PokerStars Hand #221593246561: Tournament #3079328305, $0.91+$0.09 USD Hold'em No Limit - Level XI (400/800) - 2020/12/19 3:08:59 EET [2020/12/18 20:08:59 ET]
Table '3079328305 4' 9-max Seat #4 is the button
Seat 2: pro100zoom777 (16289 in chips) 
Seat 4: LoletsPadre (5498 in chips) 
Seat 6: adabrakadabra (14543 in chips) 
Seat 7: jcarlos.vale (20014 in chips) 
Seat 8: I`m Parasite (11156 in chips) 
pro100zoom777: posts the ante 50
LoletsPadre: posts the ante 50
adabrakadabra: posts the ante 50
jcarlos.vale: posts the ante 50
I`m Parasite: posts the ante 50
adabrakadabra: posts small blind 400
jcarlos.vale: posts big blind 800
*** HOLE CARDS ***
Dealt to jcarlos.vale [6d Ts]
I`m Parasite: folds 
pro100zoom777: raises 800 to 1600
LoletsPadre: folds 
adabrakadabra: folds 
jcarlos.vale: folds 
Uncalled bet (800) returned to pro100zoom777
pro100zoom777 collected 2250 from pot
*** SUMMARY ***
Total pot 2250 | Rake 0 
Seat 2: pro100zoom777 collected (2250)
Seat 4: LoletsPadre (button) folded before Flop (didn't bet)
Seat 6: adabrakadabra (small blind) folded before Flop
Seat 7: jcarlos.vale (big blind) folded before Flop
Seat 8: I`m Parasite folded before Flop (didn't bet)



PokerStars Hand #221593252484: Tournament #3079328305, $0.91+$0.09 USD Hold'em No Limit - Level XI (400/800) - 2020/12/19 3:09:12 EET [2020/12/18 20:09:12 ET]
Table '3079328305 4' 9-max Seat #6 is the button
Seat 2: pro100zoom777 (17689 in chips) 
Seat 4: LoletsPadre (5448 in chips) 
Seat 6: adabrakadabra (14093 in chips) 
Seat 7: jcarlos.vale (19164 in chips) 
Seat 8: I`m Parasite (11106 in chips) 
pro100zoom777: posts the ante 50
LoletsPadre: posts the ante 50
adabrakadabra: posts the ante 50
jcarlos.vale: posts the ante 50
I`m Parasite: posts the ante 50
jcarlos.vale: posts small blind 400
I`m Parasite: posts big blind 800
*** HOLE CARDS ***
Dealt to jcarlos.vale [5s Th]
pro100zoom777: folds 
LoletsPadre: raises 4598 to 5398 and is all-in
adabrakadabra: folds 
jcarlos.vale: folds 
I`m Parasite: folds 
Uncalled bet (4598) returned to LoletsPadre
LoletsPadre collected 2250 from pot
LoletsPadre: doesn't show handDTO
*** SUMMARY ***
Total pot 2250 | Rake 0 
Seat 2: pro100zoom777 folded before Flop (didn't bet)
Seat 4: LoletsPadre collected (2250)
Seat 6: adabrakadabra (button) folded before Flop (didn't bet)
Seat 7: jcarlos.vale (small blind) folded before Flop
Seat 8: I`m Parasite (big blind) folded before Flop



PokerStars Hand #221593258557: Tournament #3079328305, $0.91+$0.09 USD Hold'em No Limit - Level XI (400/800) - 2020/12/19 3:09:26 EET [2020/12/18 20:09:26 ET]
Table '3079328305 4' 9-max Seat #7 is the button
Seat 2: pro100zoom777 (17639 in chips) 
Seat 4: LoletsPadre (6848 in chips) 
Seat 6: adabrakadabra (14043 in chips) 
Seat 7: jcarlos.vale (18714 in chips) 
Seat 8: I`m Parasite (10256 in chips) 
pro100zoom777: posts the ante 50
LoletsPadre: posts the ante 50
adabrakadabra: posts the ante 50
jcarlos.vale: posts the ante 50
I`m Parasite: posts the ante 50
I`m Parasite: posts small blind 400
pro100zoom777: posts big blind 800
*** HOLE CARDS ***
Dealt to jcarlos.vale [Jc 9s]
LoletsPadre: raises 5998 to 6798 and is all-in
adabrakadabra: folds 
jcarlos.vale: folds 
I`m Parasite: folds 
pro100zoom777: folds 
Uncalled bet (5998) returned to LoletsPadre
LoletsPadre collected 2250 from pot
LoletsPadre: doesn't show handDTO
*** SUMMARY ***
Total pot 2250 | Rake 0 
Seat 2: pro100zoom777 (big blind) folded before Flop
Seat 4: LoletsPadre collected (2250)
Seat 6: adabrakadabra folded before Flop (didn't bet)
Seat 7: jcarlos.vale (button) folded before Flop (didn't bet)
Seat 8: I`m Parasite (small blind) folded before Flop



PokerStars Hand #221593265148: Tournament #3079328305, $0.91+$0.09 USD Hold'em No Limit - Level XI (400/800) - 2020/12/19 3:09:41 EET [2020/12/18 20:09:41 ET]
Table '3079328305 4' 9-max Seat #8 is the button
Seat 2: pro100zoom777 (16789 in chips) 
Seat 4: LoletsPadre (8248 in chips) 
Seat 6: adabrakadabra (13993 in chips) 
Seat 7: jcarlos.vale (18664 in chips) 
Seat 8: I`m Parasite (9806 in chips) 
pro100zoom777: posts the ante 50
LoletsPadre: posts the ante 50
adabrakadabra: posts the ante 50
jcarlos.vale: posts the ante 50
I`m Parasite: posts the ante 50
pro100zoom777: posts small blind 400
LoletsPadre: posts big blind 800
*** HOLE CARDS ***
Dealt to jcarlos.vale [6d 7d]
adabrakadabra: folds 
jcarlos.vale: raises 1280 to 2080
I`m Parasite: folds 
pro100zoom777: folds 
LoletsPadre: folds 
Uncalled bet (1280) returned to jcarlos.vale
jcarlos.vale collected 2250 from pot
jcarlos.vale: doesn't show handDTO
*** SUMMARY ***
Total pot 2250 | Rake 0 
Seat 2: pro100zoom777 (small blind) folded before Flop
Seat 4: LoletsPadre (big blind) folded before Flop
Seat 6: adabrakadabra folded before Flop (didn't bet)
Seat 7: jcarlos.vale collected (2250)
Seat 8: I`m Parasite (button) folded before Flop (didn't bet)



PokerStars Hand #221593271223: Tournament #3079328305, $0.91+$0.09 USD Hold'em No Limit - Level XI (400/800) - 2020/12/19 3:09:55 EET [2020/12/18 20:09:55 ET]
Table '3079328305 4' 9-max Seat #2 is the button
Seat 2: pro100zoom777 (16339 in chips) 
Seat 4: LoletsPadre (7398 in chips) 
Seat 6: adabrakadabra (13943 in chips) 
Seat 7: jcarlos.vale (20064 in chips) 
Seat 8: I`m Parasite (9756 in chips) 
pro100zoom777: posts the ante 50
LoletsPadre: posts the ante 50
adabrakadabra: posts the ante 50
jcarlos.vale: posts the ante 50
I`m Parasite: posts the ante 50
LoletsPadre: posts small blind 400
adabrakadabra: posts big blind 800
*** HOLE CARDS ***
Dealt to jcarlos.vale [Qc Td]
jcarlos.vale: folds 
I`m Parasite: folds 
pro100zoom777: raises 800 to 1600
LoletsPadre: folds 
adabrakadabra: folds 
Uncalled bet (800) returned to pro100zoom777
pro100zoom777 collected 2250 from pot
*** SUMMARY ***
Total pot 2250 | Rake 0 
Seat 2: pro100zoom777 (button) collected (2250)
Seat 4: LoletsPadre (small blind) folded before Flop
Seat 6: adabrakadabra (big blind) folded before Flop
Seat 7: jcarlos.vale folded before Flop (didn't bet)
Seat 8: I`m Parasite folded before Flop (didn't bet)



PokerStars Hand #221593277212: Tournament #3079328305, $0.91+$0.09 USD Hold'em No Limit - Level XI (400/800) - 2020/12/19 3:10:08 EET [2020/12/18 20:10:08 ET]
Table '3079328305 4' 9-max Seat #4 is the button
Seat 2: pro100zoom777 (17739 in chips) 
Seat 4: LoletsPadre (6948 in chips) 
Seat 6: adabrakadabra (13093 in chips) 
Seat 7: jcarlos.vale (20014 in chips) 
Seat 8: I`m Parasite (9706 in chips) 
pro100zoom777: posts the ante 50
LoletsPadre: posts the ante 50
adabrakadabra: posts the ante 50
jcarlos.vale: posts the ante 50
I`m Parasite: posts the ante 50
adabrakadabra: posts small blind 400
jcarlos.vale: posts big blind 800
*** HOLE CARDS ***
Dealt to jcarlos.vale [3h 5h]
I`m Parasite: folds 
pro100zoom777: raises 800 to 1600
LoletsPadre: folds 
adabrakadabra: folds 
jcarlos.vale: folds 
Uncalled bet (800) returned to pro100zoom777
pro100zoom777 collected 2250 from pot
*** SUMMARY ***
Total pot 2250 | Rake 0 
Seat 2: pro100zoom777 collected (2250)
Seat 4: LoletsPadre (button) folded before Flop (didn't bet)
Seat 6: adabrakadabra (small blind) folded before Flop
Seat 7: jcarlos.vale (big blind) folded before Flop
Seat 8: I`m Parasite folded before Flop (didn't bet)



PokerStars Hand #221593283319: Tournament #3079328305, $0.91+$0.09 USD Hold'em No Limit - Level XI (400/800) - 2020/12/19 3:10:22 EET [2020/12/18 20:10:22 ET]
Table '3079328305 4' 9-max Seat #6 is the button
Seat 2: pro100zoom777 (19139 in chips) 
Seat 4: LoletsPadre (6898 in chips) 
Seat 6: adabrakadabra (12643 in chips) 
Seat 7: jcarlos.vale (19164 in chips) 
Seat 8: I`m Parasite (9656 in chips) 
pro100zoom777: posts the ante 50
LoletsPadre: posts the ante 50
adabrakadabra: posts the ante 50
jcarlos.vale: posts the ante 50
I`m Parasite: posts the ante 50
jcarlos.vale: posts small blind 400
I`m Parasite: posts big blind 800
*** HOLE CARDS ***
Dealt to jcarlos.vale [Js Qh]
pro100zoom777: raises 800 to 1600
LoletsPadre: folds 
adabrakadabra: folds 
jcarlos.vale: calls 1200
I`m Parasite: calls 800
*** FLOP *** [Kd 4h 3c]
jcarlos.vale: checks 
I`m Parasite: checks 
pro100zoom777: bets 1465
jcarlos.vale: folds 
I`m Parasite: folds 
Uncalled bet (1465) returned to pro100zoom777
pro100zoom777 collected 5050 from pot
pro100zoom777: shows [Kh]
*** SUMMARY ***
Total pot 5050 | Rake 0 
Board [Kd 4h 3c]
Seat 2: pro100zoom777 collected (5050)
Seat 4: LoletsPadre folded before Flop (didn't bet)
Seat 6: adabrakadabra (button) folded before Flop (didn't bet)
Seat 7: jcarlos.vale (small blind) folded on the Flop
Seat 8: I`m Parasite (big blind) folded on the Flop



PokerStars Hand #221593295589: Tournament #3079328305, $0.91+$0.09 USD Hold'em No Limit - Level XI (400/800) - 2020/12/19 3:10:50 EET [2020/12/18 20:10:50 ET]
Table '3079328305 4' 9-max Seat #7 is the button
Seat 2: pro100zoom777 (22539 in chips) 
Seat 4: LoletsPadre (6848 in chips) 
Seat 6: adabrakadabra (12593 in chips) 
Seat 7: jcarlos.vale (17514 in chips) 
Seat 8: I`m Parasite (8006 in chips) 
pro100zoom777: posts the ante 50
LoletsPadre: posts the ante 50
adabrakadabra: posts the ante 50
jcarlos.vale: posts the ante 50
I`m Parasite: posts the ante 50
I`m Parasite: posts small blind 400
pro100zoom777: posts big blind 800
*** HOLE CARDS ***
Dealt to jcarlos.vale [Th 8d]
LoletsPadre: raises 5998 to 6798 and is all-in
adabrakadabra: folds 
jcarlos.vale: folds 
I`m Parasite: folds 
pro100zoom777: folds 
Uncalled bet (5998) returned to LoletsPadre
LoletsPadre collected 2250 from pot
LoletsPadre: doesn't show handDTO
*** SUMMARY ***
Total pot 2250 | Rake 0 
Seat 2: pro100zoom777 (big blind) folded before Flop
Seat 4: LoletsPadre collected (2250)
Seat 6: adabrakadabra folded before Flop (didn't bet)
Seat 7: jcarlos.vale (button) folded before Flop (didn't bet)
Seat 8: I`m Parasite (small blind) folded before Flop



PokerStars Hand #221593303228: Tournament #3079328305, $0.91+$0.09 USD Hold'em No Limit - Level XI (400/800) - 2020/12/19 3:11:08 EET [2020/12/18 20:11:08 ET]
Table '3079328305 4' 9-max Seat #8 is the button
Seat 2: pro100zoom777 (21689 in chips) 
Seat 4: LoletsPadre (8248 in chips) 
Seat 6: adabrakadabra (12543 in chips) 
Seat 7: jcarlos.vale (17464 in chips) 
Seat 8: I`m Parasite (7556 in chips) 
pro100zoom777: posts the ante 50
LoletsPadre: posts the ante 50
adabrakadabra: posts the ante 50
jcarlos.vale: posts the ante 50
I`m Parasite: posts the ante 50
pro100zoom777: posts small blind 400
LoletsPadre: posts big blind 800
*** HOLE CARDS ***
Dealt to jcarlos.vale [6d 7h]
adabrakadabra: folds 
jcarlos.vale: folds 
I`m Parasite: raises 6706 to 7506 and is all-in
pro100zoom777: folds 
LoletsPadre: calls 6706
*** FLOP *** [8d 6h As]
*** TURN *** [8d 6h As] [5h]
*** RIVER *** [8d 6h As 5h] [7s]
*** SHOW DOWN ***
LoletsPadre: shows [Qc Qd] (a pair of Queens)
I`m Parasite: shows [4h Ac] (a straight, Four to Eight)
I`m Parasite collected 15662 from pot
*** SUMMARY ***
Total pot 15662 | Rake 0 
Board [8d 6h As 5h 7s]
Seat 2: pro100zoom777 (small blind) folded before Flop
Seat 4: LoletsPadre (big blind) showed [Qc Qd] and lost with a pair of Queens
Seat 6: adabrakadabra folded before Flop (didn't bet)
Seat 7: jcarlos.vale folded before Flop (didn't bet)
Seat 8: I`m Parasite (button) showed [4h Ac] and won (15662) with a straight, Four to Eight



PokerStars Hand #221593314733: Tournament #3079328305, $0.91+$0.09 USD Hold'em No Limit - Level XI (400/800) - 2020/12/19 3:11:34 EET [2020/12/18 20:11:34 ET]
Table '3079328305 4' 9-max Seat #2 is the button
Seat 2: pro100zoom777 (21239 in chips) 
Seat 4: LoletsPadre (692 in chips) 
Seat 6: adabrakadabra (12493 in chips) 
Seat 7: jcarlos.vale (17414 in chips) 
Seat 8: I`m Parasite (15662 in chips) 
pro100zoom777: posts the ante 50
LoletsPadre: posts the ante 50
adabrakadabra: posts the ante 50
jcarlos.vale: posts the ante 50
I`m Parasite: posts the ante 50
LoletsPadre: posts small blind 400
adabrakadabra: posts big blind 800
*** HOLE CARDS ***
Dealt to jcarlos.vale [8d 6d]
jcarlos.vale: calls 800
I`m Parasite: folds 
pro100zoom777: folds 
LoletsPadre: calls 242 and is all-in
adabrakadabra: checks 
*** FLOP *** [Ah Qs Qd]
adabrakadabra: checks 
jcarlos.vale: checks 
*** TURN *** [Ah Qs Qd] [4d]
adabrakadabra: bets 800
jcarlos.vale: folds 
Uncalled bet (800) returned to adabrakadabra
*** RIVER *** [Ah Qs Qd 4d] [Qh]
*** SHOW DOWN ***
adabrakadabra: shows [3s Qc] (four of a kind, Queens)
adabrakadabra collected 316 from side pot
LoletsPadre: shows [8c 6c] (three of a kind, Queens)
adabrakadabra collected 2176 from main pot
LoletsPadre finished the tournament in 5th place and received $3.68.
*** SUMMARY ***
Total pot 2492 Main pot 2176. Side pot 316. | Rake 0 
Board [Ah Qs Qd 4d Qh]
Seat 2: pro100zoom777 (button) folded before Flop (didn't bet)
Seat 4: LoletsPadre (small blind) showed [8c 6c] and lost with three of a kind, Queens
Seat 6: adabrakadabra (big blind) showed [3s Qc] and won (2492) with four of a kind, Queens
Seat 7: jcarlos.vale folded on the Turn
Seat 8: I`m Parasite folded before Flop (didn't bet)



PokerStars Hand #221593329249: Tournament #3079328305, $0.91+$0.09 USD Hold'em No Limit - Level XI (400/800) - 2020/12/19 3:12:07 EET [2020/12/18 20:12:07 ET]
Table '3079328305 4' 9-max Seat #6 is the button
Seat 2: pro100zoom777 (21189 in chips) 
Seat 6: adabrakadabra (14135 in chips) 
Seat 7: jcarlos.vale (16564 in chips) 
Seat 8: I`m Parasite (15612 in chips) 
pro100zoom777: posts the ante 50
adabrakadabra: posts the ante 50
jcarlos.vale: posts the ante 50
I`m Parasite: posts the ante 50
jcarlos.vale: posts small blind 400
I`m Parasite: posts big blind 800
*** HOLE CARDS ***
Dealt to jcarlos.vale [Kc Ts]
pro100zoom777: raises 800 to 1600
adabrakadabra: folds 
jcarlos.vale: raises 14914 to 16514 and is all-in
I`m Parasite: folds 
pro100zoom777: folds 
Uncalled bet (14914) returned to jcarlos.vale
jcarlos.vale collected 4200 from pot
jcarlos.vale: doesn't show handDTO
*** SUMMARY ***
Total pot 4200 | Rake 0 
Seat 2: pro100zoom777 folded before Flop
Seat 6: adabrakadabra (button) folded before Flop (didn't bet)
Seat 7: jcarlos.vale (small blind) collected (4200)
Seat 8: I`m Parasite (big blind) folded before Flop



PokerStars Hand #221593336342: Tournament #3079328305, $0.91+$0.09 USD Hold'em No Limit - Level XI (400/800) - 2020/12/19 3:12:24 EET [2020/12/18 20:12:24 ET]
Table '3079328305 4' 9-max Seat #7 is the button
Seat 2: pro100zoom777 (19539 in chips) 
Seat 6: adabrakadabra (14085 in chips) 
Seat 7: jcarlos.vale (19114 in chips) 
Seat 8: I`m Parasite (14762 in chips) 
pro100zoom777: posts the ante 50
adabrakadabra: posts the ante 50
jcarlos.vale: posts the ante 50
I`m Parasite: posts the ante 50
I`m Parasite: posts small blind 400
pro100zoom777: posts big blind 800
*** HOLE CARDS ***
Dealt to jcarlos.vale [Ad Ts]
adabrakadabra: raises 13235 to 14035 and is all-in
jcarlos.vale: folds 
I`m Parasite: folds 
pro100zoom777: folds 
Uncalled bet (13235) returned to adabrakadabra
adabrakadabra collected 2200 from pot
*** SUMMARY ***
Total pot 2200 | Rake 0 
Seat 2: pro100zoom777 (big blind) folded before Flop
Seat 6: adabrakadabra collected (2200)
Seat 7: jcarlos.vale (button) folded before Flop (didn't bet)
Seat 8: I`m Parasite (small blind) folded before Flop



PokerStars Hand #221593352401: Tournament #3079328305, $0.91+$0.09 USD Hold'em No Limit - Level XI (400/800) - 2020/12/19 3:13:01 EET [2020/12/18 20:13:01 ET]
Table '3079328305 4' 9-max Seat #8 is the button
Seat 2: pro100zoom777 (18689 in chips) 
Seat 6: adabrakadabra (15435 in chips) 
Seat 7: jcarlos.vale (19064 in chips) 
Seat 8: I`m Parasite (14312 in chips) 
pro100zoom777: posts the ante 50
adabrakadabra: posts the ante 50
jcarlos.vale: posts the ante 50
I`m Parasite: posts the ante 50
pro100zoom777: posts small blind 400
adabrakadabra: posts big blind 800
*** HOLE CARDS ***
Dealt to jcarlos.vale [Td 4c]
jcarlos.vale: folds 
I`m Parasite: folds 
pro100zoom777: raises 2000 to 2800
adabrakadabra: folds 
Uncalled bet (2000) returned to pro100zoom777
pro100zoom777 collected 1800 from pot
*** SUMMARY ***
Total pot 1800 | Rake 0 
Seat 2: pro100zoom777 (small blind) collected (1800)
Seat 6: adabrakadabra (big blind) folded before Flop
Seat 7: jcarlos.vale folded before Flop (didn't bet)
Seat 8: I`m Parasite (button) folded before Flop (didn't bet)



PokerStars Hand #221593360233: Tournament #3079328305, $0.91+$0.09 USD Hold'em No Limit - Level XII (500/1000) - 2020/12/19 3:13:19 EET [2020/12/18 20:13:19 ET]
Table '3079328305 4' 9-max Seat #2 is the button
Seat 2: pro100zoom777 (19639 in chips) 
Seat 6: adabrakadabra (14585 in chips) 
Seat 7: jcarlos.vale (19014 in chips) 
Seat 8: I`m Parasite (14262 in chips) 
pro100zoom777: posts the ante 60
adabrakadabra: posts the ante 60
jcarlos.vale: posts the ante 60
I`m Parasite: posts the ante 60
adabrakadabra: posts small blind 500
jcarlos.vale: posts big blind 1000
*** HOLE CARDS ***
Dealt to jcarlos.vale [Td 3c]
I`m Parasite: folds 
pro100zoom777: folds 
adabrakadabra: folds 
Uncalled bet (500) returned to jcarlos.vale
jcarlos.vale collected 1240 from pot
jcarlos.vale: doesn't show handDTO
*** SUMMARY ***
Total pot 1240 | Rake 0 
Seat 2: pro100zoom777 (button) folded before Flop (didn't bet)
Seat 6: adabrakadabra (small blind) folded before Flop
Seat 7: jcarlos.vale (big blind) collected (1240)
Seat 8: I`m Parasite folded before Flop (didn't bet)



PokerStars Hand #221593366328: Tournament #3079328305, $0.91+$0.09 USD Hold'em No Limit - Level XII (500/1000) - 2020/12/19 3:13:33 EET [2020/12/18 20:13:33 ET]
Table '3079328305 4' 9-max Seat #6 is the button
Seat 2: pro100zoom777 (19579 in chips) 
Seat 6: adabrakadabra (14025 in chips) 
Seat 7: jcarlos.vale (19694 in chips) 
Seat 8: I`m Parasite (14202 in chips) 
pro100zoom777: posts the ante 60
adabrakadabra: posts the ante 60
jcarlos.vale: posts the ante 60
I`m Parasite: posts the ante 60
jcarlos.vale: posts small blind 500
I`m Parasite: posts big blind 1000
*** HOLE CARDS ***
Dealt to jcarlos.vale [8s 2d]
pro100zoom777: folds 
adabrakadabra: folds 
jcarlos.vale: folds 
Uncalled bet (500) returned to I`m Parasite
I`m Parasite collected 1240 from pot
I`m Parasite: doesn't show handDTO
*** SUMMARY ***
Total pot 1240 | Rake 0 
Seat 2: pro100zoom777 folded before Flop (didn't bet)
Seat 6: adabrakadabra (button) folded before Flop (didn't bet)
Seat 7: jcarlos.vale (small blind) folded before Flop
Seat 8: I`m Parasite (big blind) collected (1240)



PokerStars Hand #221593373749: Tournament #3079328305, $0.91+$0.09 USD Hold'em No Limit - Level XII (500/1000) - 2020/12/19 3:13:51 EET [2020/12/18 20:13:51 ET]
Table '3079328305 4' 9-max Seat #7 is the button
Seat 2: pro100zoom777 (19519 in chips) 
Seat 6: adabrakadabra (13965 in chips) 
Seat 7: jcarlos.vale (19134 in chips) 
Seat 8: I`m Parasite (14882 in chips) 
pro100zoom777: posts the ante 60
adabrakadabra: posts the ante 60
jcarlos.vale: posts the ante 60
I`m Parasite: posts the ante 60
I`m Parasite: posts small blind 500
pro100zoom777: posts big blind 1000
*** HOLE CARDS ***
Dealt to jcarlos.vale [Js Kc]
adabrakadabra: folds 
jcarlos.vale: raises 18074 to 19074 and is all-in
I`m Parasite: folds 
pro100zoom777: calls 18074
*** FLOP *** [Jc Qh As]
*** TURN *** [Jc Qh As] [4c]
*** RIVER *** [Jc Qh As 4c] [4s]
*** SHOW DOWN ***
pro100zoom777: shows [Td Tc] (two pair, Tens and Fours)
jcarlos.vale: shows [Js Kc] (two pair, Jacks and Fours)
jcarlos.vale collected 38888 from pot
*** SUMMARY ***
Total pot 38888 | Rake 0 
Board [Jc Qh As 4c 4s]
Seat 2: pro100zoom777 (big blind) showed [Td Tc] and lost with two pair, Tens and Fours
Seat 6: adabrakadabra folded before Flop (didn't bet)
Seat 7: jcarlos.vale (button) showed [Js Kc] and won (38888) with two pair, Jacks and Fours
Seat 8: I`m Parasite (small blind) folded before Flop



PokerStars Hand #221593384714: Tournament #3079328305, $0.91+$0.09 USD Hold'em No Limit - Level XII (500/1000) - 2020/12/19 3:14:16 EET [2020/12/18 20:14:16 ET]
Table '3079328305 4' 9-max Seat #8 is the button
Seat 2: pro100zoom777 (385 in chips) 
Seat 6: adabrakadabra (13905 in chips) 
Seat 7: jcarlos.vale (38888 in chips) 
Seat 8: I`m Parasite (14322 in chips) 
pro100zoom777: posts the ante 60
adabrakadabra: posts the ante 60
jcarlos.vale: posts the ante 60
I`m Parasite: posts the ante 60
pro100zoom777: posts small blind 325 and is all-in
adabrakadabra: posts big blind 1000
*** HOLE CARDS ***
Dealt to jcarlos.vale [Js Ad]
jcarlos.vale: raises 37828 to 38828 and is all-in
I`m Parasite: folds 
adabrakadabra: folds 
Uncalled bet (37828) returned to jcarlos.vale
*** FLOP *** [6c 4h Ts]
*** TURN *** [6c 4h Ts] [Jh]
*** RIVER *** [6c 4h Ts Jh] [Jd]
*** SHOW DOWN ***
jcarlos.vale: shows [Js Ad] (three of a kind, Jacks)
jcarlos.vale collected 1350 from side pot
pro100zoom777: shows [Tc As] (two pair, Jacks and Tens)
jcarlos.vale collected 1215 from main pot
pro100zoom777 finished the tournament in 4th place and received $5.11.
*** SUMMARY ***
Total pot 2565 Main pot 1215. Side pot 1350. | Rake 0 
Board [6c 4h Ts Jh Jd]
Seat 2: pro100zoom777 (small blind) showed [Tc As] and lost with two pair, Jacks and Tens
Seat 6: adabrakadabra (big blind) folded before Flop
Seat 7: jcarlos.vale showed [Js Ad] and won (2565) with three of a kind, Jacks
Seat 8: I`m Parasite (button) folded before Flop (didn't bet)



PokerStars Hand #221593395955: Tournament #3079328305, $0.91+$0.09 USD Hold'em No Limit - Level XII (500/1000) - 2020/12/19 3:14:41 EET [2020/12/18 20:14:41 ET]
Table '3079328305 4' 9-max Seat #6 is the button
Seat 6: adabrakadabra (12845 in chips) 
Seat 7: jcarlos.vale (40393 in chips) 
Seat 8: I`m Parasite (14262 in chips) 
adabrakadabra: posts the ante 60
jcarlos.vale: posts the ante 60
I`m Parasite: posts the ante 60
jcarlos.vale: posts small blind 500
I`m Parasite: posts big blind 1000
*** HOLE CARDS ***
Dealt to jcarlos.vale [7c Ks]
adabrakadabra: folds 
jcarlos.vale: raises 1600 to 2600
I`m Parasite: folds 
Uncalled bet (1600) returned to jcarlos.vale
jcarlos.vale collected 2180 from pot
jcarlos.vale: doesn't show handDTO
*** SUMMARY ***
Total pot 2180 | Rake 0 
Seat 6: adabrakadabra (button) folded before Flop (didn't bet)
Seat 7: jcarlos.vale (small blind) collected (2180)
Seat 8: I`m Parasite (big blind) folded before Flop



PokerStars Hand #221593402585: Tournament #3079328305, $0.91+$0.09 USD Hold'em No Limit - Level XII (500/1000) - 2020/12/19 3:14:57 EET [2020/12/18 20:14:57 ET]
Table '3079328305 4' 9-max Seat #7 is the button
Seat 6: adabrakadabra (12785 in chips) 
Seat 7: jcarlos.vale (41513 in chips) 
Seat 8: I`m Parasite (13202 in chips) 
adabrakadabra: posts the ante 60
jcarlos.vale: posts the ante 60
I`m Parasite: posts the ante 60
I`m Parasite: posts small blind 500
adabrakadabra: posts big blind 1000
*** HOLE CARDS ***
Dealt to jcarlos.vale [Kd Qd]
jcarlos.vale: raises 1600 to 2600
I`m Parasite: folds 
adabrakadabra: raises 10125 to 12725 and is all-in
jcarlos.vale: calls 10125
*** FLOP *** [Ac 2s 8s]
*** TURN *** [Ac 2s 8s] [9d]
*** RIVER *** [Ac 2s 8s 9d] [Ts]
*** SHOW DOWN ***
adabrakadabra: shows [Js Ad] (a pair of Aces)
jcarlos.vale: shows [Kd Qd] (high pairOfCards Ace)
adabrakadabra collected 26130 from pot
*** SUMMARY ***
Total pot 26130 | Rake 0 
Board [Ac 2s 8s 9d Ts]
Seat 6: adabrakadabra (big blind) showed [Js Ad] and won (26130) with a pair of Aces
Seat 7: jcarlos.vale (button) showed [Kd Qd] and lost with high pairOfCards Ace
Seat 8: I`m Parasite (small blind) folded before Flop



PokerStars Hand #221593413701: Tournament #3079328305, $0.91+$0.09 USD Hold'em No Limit - Level XII (500/1000) - 2020/12/19 3:15:22 EET [2020/12/18 20:15:22 ET]
Table '3079328305 4' 9-max Seat #8 is the button
Seat 6: adabrakadabra (26130 in chips) 
Seat 7: jcarlos.vale (28728 in chips) 
Seat 8: I`m Parasite (12642 in chips) 
adabrakadabra: posts the ante 60
jcarlos.vale: posts the ante 60
I`m Parasite: posts the ante 60
adabrakadabra: posts small blind 500
jcarlos.vale: posts big blind 1000
*** HOLE CARDS ***
Dealt to jcarlos.vale [Qc 7h]
I`m Parasite: raises 1000 to 2000
adabrakadabra: folds 
jcarlos.vale: folds 
Uncalled bet (1000) returned to I`m Parasite
I`m Parasite collected 2680 from pot
I`m Parasite: doesn't show handDTO
*** SUMMARY ***
Total pot 2680 | Rake 0 
Seat 6: adabrakadabra (small blind) folded before Flop
Seat 7: jcarlos.vale (big blind) folded before Flop
Seat 8: I`m Parasite (button) collected (2680)



PokerStars Hand #221593420971: Tournament #3079328305, $0.91+$0.09 USD Hold'em No Limit - Level XII (500/1000) - 2020/12/19 3:15:39 EET [2020/12/18 20:15:39 ET]
Table '3079328305 4' 9-max Seat #6 is the button
Seat 6: adabrakadabra (25570 in chips) 
Seat 7: jcarlos.vale (27668 in chips) 
Seat 8: I`m Parasite (14262 in chips) 
adabrakadabra: posts the ante 60
jcarlos.vale: posts the ante 60
I`m Parasite: posts the ante 60
jcarlos.vale: posts small blind 500
I`m Parasite: posts big blind 1000
*** HOLE CARDS ***
Dealt to jcarlos.vale [Td Qd]
adabrakadabra: folds 
jcarlos.vale: raises 26608 to 27608 and is all-in
I`m Parasite: calls 13202 and is all-in
Uncalled bet (13406) returned to jcarlos.vale
*** FLOP *** [5d 2d Ac]
*** TURN *** [5d 2d Ac] [Ad]
*** RIVER *** [5d 2d Ac Ad] [8d]
*** SHOW DOWN ***
jcarlos.vale: shows [Td Qd] (a flush, Ace high)
I`m Parasite: shows [4s Ah] (three of a kind, Aces)
jcarlos.vale collected 28584 from pot
I`m Parasite finished the tournament in 3rd place and received $6.75.
*** SUMMARY ***
Total pot 28584 | Rake 0 
Board [5d 2d Ac Ad 8d]
Seat 6: adabrakadabra (button) folded before Flop (didn't bet)
Seat 7: jcarlos.vale (small blind) showed [Td Qd] and won (28584) with a flush, Ace high
Seat 8: I`m Parasite (big blind) showed [4s Ah] and lost with three of a kind, Aces



PokerStars Hand #221593430856: Tournament #3079328305, $0.91+$0.09 USD Hold'em No Limit - Level XII (500/1000) - 2020/12/19 3:16:02 EET [2020/12/18 20:16:02 ET]
Table '3079328305 4' 9-max Seat #7 is the button
Seat 6: adabrakadabra (25510 in chips) 
Seat 7: jcarlos.vale (41990 in chips) 
adabrakadabra: posts the ante 60
jcarlos.vale: posts the ante 60
jcarlos.vale: posts small blind 500
adabrakadabra: posts big blind 1000
*** HOLE CARDS ***
Dealt to jcarlos.vale [Jh Ks]
jcarlos.vale: raises 1600 to 2600
adabrakadabra: folds 
Uncalled bet (1600) returned to jcarlos.vale
jcarlos.vale collected 2120 from pot
jcarlos.vale: doesn't show handDTO
*** SUMMARY ***
Total pot 2120 | Rake 0 
Seat 6: adabrakadabra (big blind) folded before Flop
Seat 7: jcarlos.vale (button) (small blind) collected (2120)



PokerStars Hand #221593442328: Tournament #3079328305, $0.91+$0.09 USD Hold'em No Limit - Level XII (500/1000) - 2020/12/19 3:16:17 EET [2020/12/18 20:16:17 ET]
Table '3079328305 4' 9-max Seat #6 is the button
Seat 6: adabrakadabra (24450 in chips) 
Seat 7: jcarlos.vale (43050 in chips) 
adabrakadabra: posts the ante 60
jcarlos.vale: posts the ante 60
adabrakadabra: posts small blind 500
jcarlos.vale: posts big blind 1000
*** HOLE CARDS ***
Dealt to jcarlos.vale [Ad 4c]
adabrakadabra: raises 23390 to 24390 and is all-in
jcarlos.vale: folds 
Uncalled bet (23390) returned to adabrakadabra
adabrakadabra collected 2120 from pot
*** SUMMARY ***
Total pot 2120 | Rake 0 
Seat 6: adabrakadabra (button) (small blind) collected (2120)
Seat 7: jcarlos.vale (big blind) folded before Flop



PokerStars Hand #221593448667: Tournament #3079328305, $0.91+$0.09 USD Hold'em No Limit - Level XII (500/1000) - 2020/12/19 3:16:31 EET [2020/12/18 20:16:31 ET]
Table '3079328305 4' 9-max Seat #7 is the button
Seat 6: adabrakadabra (25510 in chips) 
Seat 7: jcarlos.vale (41990 in chips) 
adabrakadabra: posts the ante 60
jcarlos.vale: posts the ante 60
jcarlos.vale: posts small blind 500
adabrakadabra: posts big blind 1000
*** HOLE CARDS ***
Dealt to jcarlos.vale [6h 9h]
jcarlos.vale: raises 1600 to 2600
adabrakadabra: raises 22850 to 25450 and is all-in
jcarlos.vale: folds 
Uncalled bet (22850) returned to adabrakadabra
adabrakadabra collected 5320 from pot
*** SUMMARY ***
Total pot 5320 | Rake 0 
Seat 6: adabrakadabra (big blind) collected (5320)
Seat 7: jcarlos.vale (button) (small blind) folded before Flop



PokerStars Hand #221593455160: Tournament #3079328305, $0.91+$0.09 USD Hold'em No Limit - Level XII (500/1000) - 2020/12/19 3:16:47 EET [2020/12/18 20:16:47 ET]
Table '3079328305 4' 9-max Seat #6 is the button
Seat 6: adabrakadabra (28170 in chips) 
Seat 7: jcarlos.vale (39330 in chips) 
adabrakadabra: posts the ante 60
jcarlos.vale: posts the ante 60
adabrakadabra: posts small blind 500
jcarlos.vale: posts big blind 1000
*** HOLE CARDS ***
Dealt to jcarlos.vale [8h 7h]
adabrakadabra: folds 
Uncalled bet (500) returned to jcarlos.vale
jcarlos.vale collected 1120 from pot
jcarlos.vale: doesn't show handDTO
*** SUMMARY ***
Total pot 1120 | Rake 0 
Seat 6: adabrakadabra (button) (small blind) folded before Flop
Seat 7: jcarlos.vale (big blind) collected (1120)



PokerStars Hand #221593459719: Tournament #3079328305, $0.91+$0.09 USD Hold'em No Limit - Level XII (500/1000) - 2020/12/19 3:16:57 EET [2020/12/18 20:16:57 ET]
Table '3079328305 4' 9-max Seat #7 is the button
Seat 6: adabrakadabra (27610 in chips) 
Seat 7: jcarlos.vale (39890 in chips) 
adabrakadabra: posts the ante 60
jcarlos.vale: posts the ante 60
jcarlos.vale: posts small blind 500
adabrakadabra: posts big blind 1000
*** HOLE CARDS ***
Dealt to jcarlos.vale [Ks Kc]
jcarlos.vale: raises 1600 to 2600
adabrakadabra: folds 
Uncalled bet (1600) returned to jcarlos.vale
jcarlos.vale collected 2120 from pot
jcarlos.vale: doesn't show handDTO
*** SUMMARY ***
Total pot 2120 | Rake 0 
Seat 6: adabrakadabra (big blind) folded before Flop
Seat 7: jcarlos.vale (button) (small blind) collected (2120)



PokerStars Hand #221593465297: Tournament #3079328305, $0.91+$0.09 USD Hold'em No Limit - Level XII (500/1000) - 2020/12/19 3:17:10 EET [2020/12/18 20:17:10 ET]
Table '3079328305 4' 9-max Seat #6 is the button
Seat 6: adabrakadabra (26550 in chips) 
Seat 7: jcarlos.vale (40950 in chips) 
adabrakadabra: posts the ante 60
jcarlos.vale: posts the ante 60
adabrakadabra: posts small blind 500
jcarlos.vale: posts big blind 1000
*** HOLE CARDS ***
Dealt to jcarlos.vale [6h Jd]
adabrakadabra: folds 
Uncalled bet (500) returned to jcarlos.vale
jcarlos.vale collected 1120 from pot
jcarlos.vale: doesn't show handDTO
*** SUMMARY ***
Total pot 1120 | Rake 0 
Seat 6: adabrakadabra (button) (small blind) folded before Flop
Seat 7: jcarlos.vale (big blind) collected (1120)



PokerStars Hand #221593469676: Tournament #3079328305, $0.91+$0.09 USD Hold'em No Limit - Level XII (500/1000) - 2020/12/19 3:17:20 EET [2020/12/18 20:17:20 ET]
Table '3079328305 4' 9-max Seat #7 is the button
Seat 6: adabrakadabra (25990 in chips) 
Seat 7: jcarlos.vale (41510 in chips) 
adabrakadabra: posts the ante 60
jcarlos.vale: posts the ante 60
jcarlos.vale: posts small blind 500
adabrakadabra: posts big blind 1000
*** HOLE CARDS ***
Dealt to jcarlos.vale [Td 9c]
jcarlos.vale: folds 
Uncalled bet (500) returned to adabrakadabra
adabrakadabra collected 1120 from pot
*** SUMMARY ***
Total pot 1120 | Rake 0 
Seat 6: adabrakadabra (big blind) collected (1120)
Seat 7: jcarlos.vale (button) (small blind) folded before Flop



PokerStars Hand #221593474271: Tournament #3079328305, $0.91+$0.09 USD Hold'em No Limit - Level XII (500/1000) - 2020/12/19 3:17:31 EET [2020/12/18 20:17:31 ET]
Table '3079328305 4' 9-max Seat #6 is the button
Seat 6: adabrakadabra (26550 in chips) 
Seat 7: jcarlos.vale (40950 in chips) 
adabrakadabra: posts the ante 60
jcarlos.vale: posts the ante 60
adabrakadabra: posts small blind 500
jcarlos.vale: posts big blind 1000
*** HOLE CARDS ***
Dealt to jcarlos.vale [3s Kd]
adabrakadabra: raises 1000 to 2000
jcarlos.vale: calls 1000
*** FLOP *** [4d 5d 8d]
jcarlos.vale: bets 2060
adabrakadabra: folds 
Uncalled bet (2060) returned to jcarlos.vale
jcarlos.vale collected 4120 from pot
jcarlos.vale: doesn't show handDTO
*** SUMMARY ***
Total pot 4120 | Rake 0 
Board [4d 5d 8d]
Seat 6: adabrakadabra (button) (small blind) folded on the Flop
Seat 7: jcarlos.vale (big blind) collected (4120)



PokerStars Hand #221593484599: Tournament #3079328305, $0.91+$0.09 USD Hold'em No Limit - Level XII (500/1000) - 2020/12/19 3:17:55 EET [2020/12/18 20:17:55 ET]
Table '3079328305 4' 9-max Seat #7 is the button
Seat 6: adabrakadabra (24490 in chips) 
Seat 7: jcarlos.vale (43010 in chips) 
adabrakadabra: posts the ante 60
jcarlos.vale: posts the ante 60
jcarlos.vale: posts small blind 500
adabrakadabra: posts big blind 1000
*** HOLE CARDS ***
Dealt to jcarlos.vale [Kd 4c]
jcarlos.vale: raises 1600 to 2600
adabrakadabra: calls 1600
*** FLOP *** [8h 7c 7s]
adabrakadabra: bets 3990
jcarlos.vale: folds 
Uncalled bet (3990) returned to adabrakadabra
adabrakadabra collected 5320 from pot
*** SUMMARY ***
Total pot 5320 | Rake 0 
Board [8h 7c 7s]
Seat 6: adabrakadabra (big blind) collected (5320)
Seat 7: jcarlos.vale (button) (small blind) folded on the Flop



PokerStars Hand #221593494772: Tournament #3079328305, $0.91+$0.09 USD Hold'em No Limit - Level XII (500/1000) - 2020/12/19 3:18:18 EET [2020/12/18 20:18:18 ET]
Table '3079328305 4' 9-max Seat #6 is the button
Seat 6: adabrakadabra (27150 in chips) 
Seat 7: jcarlos.vale (40350 in chips) 
adabrakadabra: posts the ante 60
jcarlos.vale: posts the ante 60
adabrakadabra: posts small blind 500
jcarlos.vale: posts big blind 1000
*** HOLE CARDS ***
Dealt to jcarlos.vale [9c Jc]
adabrakadabra: folds 
Uncalled bet (500) returned to jcarlos.vale
jcarlos.vale collected 1120 from pot
jcarlos.vale: doesn't show handDTO
*** SUMMARY ***
Total pot 1120 | Rake 0 
Seat 6: adabrakadabra (button) (small blind) folded before Flop
Seat 7: jcarlos.vale (big blind) collected (1120)



PokerStars Hand #221593499141: Tournament #3079328305, $0.91+$0.09 USD Hold'em No Limit - Level XII (500/1000) - 2020/12/19 3:18:28 EET [2020/12/18 20:18:28 ET]
Table '3079328305 4' 9-max Seat #7 is the button
Seat 6: adabrakadabra (26590 in chips) 
Seat 7: jcarlos.vale (40910 in chips) 
adabrakadabra: posts the ante 60
jcarlos.vale: posts the ante 60
jcarlos.vale: posts small blind 500
adabrakadabra: posts big blind 1000
*** HOLE CARDS ***
Dealt to jcarlos.vale [Td 8c]
jcarlos.vale: folds 
Uncalled bet (500) returned to adabrakadabra
adabrakadabra collected 1120 from pot
*** SUMMARY ***
Total pot 1120 | Rake 0 
Seat 6: adabrakadabra (big blind) collected (1120)
Seat 7: jcarlos.vale (button) (small blind) folded before Flop



PokerStars Hand #221593503881: Tournament #3079328305, $0.91+$0.09 USD Hold'em No Limit - Level XII (500/1000) - 2020/12/19 3:18:39 EET [2020/12/18 20:18:39 ET]
Table '3079328305 4' 9-max Seat #6 is the button
Seat 6: adabrakadabra (27150 in chips) 
Seat 7: jcarlos.vale (40350 in chips) 
adabrakadabra: posts the ante 60
jcarlos.vale: posts the ante 60
adabrakadabra: posts small blind 500
jcarlos.vale: posts big blind 1000
*** HOLE CARDS ***
Dealt to jcarlos.vale [7c 2c]
adabrakadabra: raises 1000 to 2000
jcarlos.vale: calls 1000
*** FLOP *** [Ad Kd 2d]
jcarlos.vale: bets 2000
adabrakadabra: raises 4000 to 6000
jcarlos.vale: folds 
Uncalled bet (4000) returned to adabrakadabra
adabrakadabra collected 8120 from pot
*** SUMMARY ***
Total pot 8120 | Rake 0 
Board [Ad Kd 2d]
Seat 6: adabrakadabra (button) (small blind) collected (8120)
Seat 7: jcarlos.vale (big blind) folded on the Flop



PokerStars Hand #221593512993: Tournament #3079328305, $0.91+$0.09 USD Hold'em No Limit - Level XII (500/1000) - 2020/12/19 3:19:00 EET [2020/12/18 20:19:00 ET]
Table '3079328305 4' 9-max Seat #7 is the button
Seat 6: adabrakadabra (31210 in chips) 
Seat 7: jcarlos.vale (36290 in chips) 
adabrakadabra: posts the ante 60
jcarlos.vale: posts the ante 60
jcarlos.vale: posts small blind 500
adabrakadabra: posts big blind 1000
*** HOLE CARDS ***
Dealt to jcarlos.vale [8c Th]
jcarlos.vale: folds 
Uncalled bet (500) returned to adabrakadabra
adabrakadabra collected 1120 from pot
*** SUMMARY ***
Total pot 1120 | Rake 0 
Seat 6: adabrakadabra (big blind) collected (1120)
Seat 7: jcarlos.vale (button) (small blind) folded before Flop



PokerStars Hand #221593518265: Tournament #3079328305, $0.91+$0.09 USD Hold'em No Limit - Level XII (500/1000) - 2020/12/19 3:19:13 EET [2020/12/18 20:19:13 ET]
Table '3079328305 4' 9-max Seat #6 is the button
Seat 6: adabrakadabra (31770 in chips) 
Seat 7: jcarlos.vale (35730 in chips) 
adabrakadabra: posts the ante 60
jcarlos.vale: posts the ante 60
adabrakadabra: posts small blind 500
jcarlos.vale: posts big blind 1000
*** HOLE CARDS ***
Dealt to jcarlos.vale [As Qh]
adabrakadabra: raises 2000 to 3000
jcarlos.vale: raises 32670 to 35670 and is all-in
adabrakadabra: folds 
Uncalled bet (32670) returned to jcarlos.vale
jcarlos.vale collected 6120 from pot
jcarlos.vale: doesn't show handDTO
*** SUMMARY ***
Total pot 6120 | Rake 0 
Seat 6: adabrakadabra (button) (small blind) folded before Flop
Seat 7: jcarlos.vale (big blind) collected (6120)



PokerStars Hand #221593526613: Tournament #3079328305, $0.91+$0.09 USD Hold'em No Limit - Level XII (500/1000) - 2020/12/19 3:19:32 EET [2020/12/18 20:19:32 ET]
Table '3079328305 4' 9-max Seat #7 is the button
Seat 6: adabrakadabra (28710 in chips) 
Seat 7: jcarlos.vale (38790 in chips) 
adabrakadabra: posts the ante 60
jcarlos.vale: posts the ante 60
jcarlos.vale: posts small blind 500
adabrakadabra: posts big blind 1000
*** HOLE CARDS ***
Dealt to jcarlos.vale [2d 9d]
jcarlos.vale: folds 
Uncalled bet (500) returned to adabrakadabra
adabrakadabra collected 1120 from pot
*** SUMMARY ***
Total pot 1120 | Rake 0 
Seat 6: adabrakadabra (big blind) collected (1120)
Seat 7: jcarlos.vale (button) (small blind) folded before Flop



PokerStars Hand #221593531111: Tournament #3079328305, $0.91+$0.09 USD Hold'em No Limit - Level XII (500/1000) - 2020/12/19 3:19:43 EET [2020/12/18 20:19:43 ET]
Table '3079328305 4' 9-max Seat #6 is the button
Seat 6: adabrakadabra (29270 in chips) 
Seat 7: jcarlos.vale (38230 in chips) 
adabrakadabra: posts the ante 60
jcarlos.vale: posts the ante 60
adabrakadabra: posts small blind 500
jcarlos.vale: posts big blind 1000
*** HOLE CARDS ***
Dealt to jcarlos.vale [2d 6s]
adabrakadabra: folds 
Uncalled bet (500) returned to jcarlos.vale
jcarlos.vale collected 1120 from pot
jcarlos.vale: doesn't show handDTO
*** SUMMARY ***
Total pot 1120 | Rake 0 
Seat 6: adabrakadabra (button) (small blind) folded before Flop
Seat 7: jcarlos.vale (big blind) collected (1120)



PokerStars Hand #221593535367: Tournament #3079328305, $0.91+$0.09 USD Hold'em No Limit - Level XII (500/1000) - 2020/12/19 3:19:53 EET [2020/12/18 20:19:53 ET]
Table '3079328305 4' 9-max Seat #7 is the button
Seat 6: adabrakadabra (28710 in chips) 
Seat 7: jcarlos.vale (38790 in chips) 
adabrakadabra: posts the ante 60
jcarlos.vale: posts the ante 60
jcarlos.vale: posts small blind 500
adabrakadabra: posts big blind 1000
*** HOLE CARDS ***
Dealt to jcarlos.vale [Tc Kc]
jcarlos.vale: raises 1600 to 2600
adabrakadabra: calls 1600
*** FLOP *** [3s Kd 7s]
adabrakadabra: checks 
jcarlos.vale: bets 3990
adabrakadabra: folds 
Uncalled bet (3990) returned to jcarlos.vale
jcarlos.vale collected 5320 from pot
jcarlos.vale: doesn't show handDTO
*** SUMMARY ***
Total pot 5320 | Rake 0 
Board [3s Kd 7s]
Seat 6: adabrakadabra (big blind) folded on the Flop
Seat 7: jcarlos.vale (button) (small blind) collected (5320)



PokerStars Hand #221593545216: Tournament #3079328305, $0.91+$0.09 USD Hold'em No Limit - Level XII (500/1000) - 2020/12/19 3:20:16 EET [2020/12/18 20:20:16 ET]
Table '3079328305 4' 9-max Seat #6 is the button
Seat 6: adabrakadabra (26050 in chips) 
Seat 7: jcarlos.vale (41450 in chips) 
adabrakadabra: posts the ante 60
jcarlos.vale: posts the ante 60
adabrakadabra: posts small blind 500
jcarlos.vale: posts big blind 1000
*** HOLE CARDS ***
Dealt to jcarlos.vale [4h Qc]
adabrakadabra: raises 1000 to 2000
jcarlos.vale: folds 
Uncalled bet (1000) returned to adabrakadabra
adabrakadabra collected 2120 from pot
*** SUMMARY ***
Total pot 2120 | Rake 0 
Seat 6: adabrakadabra (button) (small blind) collected (2120)
Seat 7: jcarlos.vale (big blind) folded before Flop



PokerStars Hand #221593550916: Tournament #3079328305, $0.91+$0.09 USD Hold'em No Limit - Level XII (500/1000) - 2020/12/19 3:20:29 EET [2020/12/18 20:20:29 ET]
Table '3079328305 4' 9-max Seat #7 is the button
Seat 6: adabrakadabra (27110 in chips) 
Seat 7: jcarlos.vale (40390 in chips) 
adabrakadabra: posts the ante 60
jcarlos.vale: posts the ante 60
jcarlos.vale: posts small blind 500
adabrakadabra: posts big blind 1000
*** HOLE CARDS ***
Dealt to jcarlos.vale [3d Jd]
jcarlos.vale: raises 1000 to 2000
adabrakadabra: folds 
Uncalled bet (1000) returned to jcarlos.vale
jcarlos.vale collected 2120 from pot
jcarlos.vale: doesn't show handDTO
*** SUMMARY ***
Total pot 2120 | Rake 0 
Seat 6: adabrakadabra (big blind) folded before Flop
Seat 7: jcarlos.vale (button) (small blind) collected (2120)



PokerStars Hand #221593556354: Tournament #3079328305, $0.91+$0.09 USD Hold'em No Limit - Level XII (500/1000) - 2020/12/19 3:20:41 EET [2020/12/18 20:20:41 ET]
Table '3079328305 4' 9-max Seat #6 is the button
Seat 6: adabrakadabra (26050 in chips) 
Seat 7: jcarlos.vale (41450 in chips) 
adabrakadabra: posts the ante 60
jcarlos.vale: posts the ante 60
adabrakadabra: posts small blind 500
jcarlos.vale: posts big blind 1000
*** HOLE CARDS ***
Dealt to jcarlos.vale [Qc Ah]
adabrakadabra: folds 
Uncalled bet (500) returned to jcarlos.vale
jcarlos.vale collected 1120 from pot
jcarlos.vale: doesn't show handDTO
*** SUMMARY ***
Total pot 1120 | Rake 0 
Seat 6: adabrakadabra (button) (small blind) folded before Flop
Seat 7: jcarlos.vale (big blind) collected (1120)



PokerStars Hand #221593562438: Tournament #3079328305, $0.91+$0.09 USD Hold'em No Limit - Level XII (500/1000) - 2020/12/19 3:20:56 EET [2020/12/18 20:20:56 ET]
Table '3079328305 4' 9-max Seat #7 is the button
Seat 6: adabrakadabra (25490 in chips) 
Seat 7: jcarlos.vale (42010 in chips) 
adabrakadabra: posts the ante 60
jcarlos.vale: posts the ante 60
jcarlos.vale: posts small blind 500
adabrakadabra: posts big blind 1000
*** HOLE CARDS ***
Dealt to jcarlos.vale [Qs 2h]
jcarlos.vale: folds 
Uncalled bet (500) returned to adabrakadabra
adabrakadabra collected 1120 from pot
*** SUMMARY ***
Total pot 1120 | Rake 0 
Seat 6: adabrakadabra (big blind) collected (1120)
Seat 7: jcarlos.vale (button) (small blind) folded before Flop



PokerStars Hand #221593566795: Tournament #3079328305, $0.91+$0.09 USD Hold'em No Limit - Level XII (500/1000) - 2020/12/19 3:21:06 EET [2020/12/18 20:21:06 ET]
Table '3079328305 4' 9-max Seat #6 is the button
Seat 6: adabrakadabra (26050 in chips) 
Seat 7: jcarlos.vale (41450 in chips) 
adabrakadabra: posts the ante 60
jcarlos.vale: posts the ante 60
adabrakadabra: posts small blind 500
jcarlos.vale: posts big blind 1000
*** HOLE CARDS ***
Dealt to jcarlos.vale [9h 6s]
adabrakadabra: calls 500
jcarlos.vale: checks 
*** FLOP *** [2h 7c 2d]
jcarlos.vale: checks 
adabrakadabra: checks 
*** TURN *** [2h 7c 2d] [Js]
jcarlos.vale: bets 1060
adabrakadabra: folds 
Uncalled bet (1060) returned to jcarlos.vale
jcarlos.vale collected 2120 from pot
jcarlos.vale: doesn't show handDTO
*** SUMMARY ***
Total pot 2120 | Rake 0 
Board [2h 7c 2d Js]
Seat 6: adabrakadabra (button) (small blind) folded on the Turn
Seat 7: jcarlos.vale (big blind) collected (2120)



PokerStars Hand #221593576864: Tournament #3079328305, $0.91+$0.09 USD Hold'em No Limit - Level XII (500/1000) - 2020/12/19 3:21:29 EET [2020/12/18 20:21:29 ET]
Table '3079328305 4' 9-max Seat #7 is the button
Seat 6: adabrakadabra (24990 in chips) 
Seat 7: jcarlos.vale (42510 in chips) 
adabrakadabra: posts the ante 60
jcarlos.vale: posts the ante 60
jcarlos.vale: posts small blind 500
adabrakadabra: posts big blind 1000
*** HOLE CARDS ***
Dealt to jcarlos.vale [6d 4d]
jcarlos.vale: raises 1600 to 2600
adabrakadabra: folds 
Uncalled bet (1600) returned to jcarlos.vale
jcarlos.vale collected 2120 from pot
jcarlos.vale: doesn't show handDTO
*** SUMMARY ***
Total pot 2120 | Rake 0 
Seat 6: adabrakadabra (big blind) folded before Flop
Seat 7: jcarlos.vale (button) (small blind) collected (2120)



PokerStars Hand #221593581565: Tournament #3079328305, $0.91+$0.09 USD Hold'em No Limit - Level XII (500/1000) - 2020/12/19 3:21:40 EET [2020/12/18 20:21:40 ET]
Table '3079328305 4' 9-max Seat #6 is the button
Seat 6: adabrakadabra (23930 in chips) 
Seat 7: jcarlos.vale (43570 in chips) 
adabrakadabra: posts the ante 60
jcarlos.vale: posts the ante 60
adabrakadabra: posts small blind 500
jcarlos.vale: posts big blind 1000
*** HOLE CARDS ***
Dealt to jcarlos.vale [7d 6d]
adabrakadabra: folds 
Uncalled bet (500) returned to jcarlos.vale
jcarlos.vale collected 1120 from pot
jcarlos.vale: doesn't show handDTO
*** SUMMARY ***
Total pot 1120 | Rake 0 
Seat 6: adabrakadabra (button) (small blind) folded before Flop
Seat 7: jcarlos.vale (big blind) collected (1120)



PokerStars Hand #221593588722: Tournament #3079328305, $0.91+$0.09 USD Hold'em No Limit - Level XII (500/1000) - 2020/12/19 3:21:57 EET [2020/12/18 20:21:57 ET]
Table '3079328305 4' 9-max Seat #7 is the button
Seat 6: adabrakadabra (23370 in chips) 
Seat 7: jcarlos.vale (44130 in chips) 
adabrakadabra: posts the ante 60
jcarlos.vale: posts the ante 60
jcarlos.vale: posts small blind 500
adabrakadabra: posts big blind 1000
*** HOLE CARDS ***
Dealt to jcarlos.vale [9d 5h]
jcarlos.vale: folds 
Uncalled bet (500) returned to adabrakadabra
adabrakadabra collected 1120 from pot
*** SUMMARY ***
Total pot 1120 | Rake 0 
Seat 6: adabrakadabra (big blind) collected (1120)
Seat 7: jcarlos.vale (button) (small blind) folded before Flop



PokerStars Hand #221593596119: Tournament #3079328305, $0.91+$0.09 USD Hold'em No Limit - Level XII (500/1000) - 2020/12/19 3:22:14 EET [2020/12/18 20:22:14 ET]
Table '3079328305 4' 9-max Seat #6 is the button
Seat 6: adabrakadabra (23930 in chips) 
Seat 7: jcarlos.vale (43570 in chips) 
adabrakadabra: posts the ante 60
jcarlos.vale: posts the ante 60
adabrakadabra: posts small blind 500
jcarlos.vale: posts big blind 1000
*** HOLE CARDS ***
Dealt to jcarlos.vale [Ac 4h]
adabrakadabra: calls 500
jcarlos.vale: checks 
*** FLOP *** [Kc 6s 6c]
jcarlos.vale: checks 
adabrakadabra: checks 
*** TURN *** [Kc 6s 6c] [3d]
jcarlos.vale: bets 2000
adabrakadabra: folds 
Uncalled bet (2000) returned to jcarlos.vale
jcarlos.vale collected 2120 from pot
jcarlos.vale: doesn't show handDTO
*** SUMMARY ***
Total pot 2120 | Rake 0 
Board [Kc 6s 6c 3d]
Seat 6: adabrakadabra (button) (small blind) folded on the Turn
Seat 7: jcarlos.vale (big blind) collected (2120)



PokerStars Hand #221593609032: Tournament #3079328305, $0.91+$0.09 USD Hold'em No Limit - Level XII (500/1000) - 2020/12/19 3:22:44 EET [2020/12/18 20:22:44 ET]
Table '3079328305 4' 9-max Seat #7 is the button
Seat 6: adabrakadabra (22870 in chips) 
Seat 7: jcarlos.vale (44630 in chips) 
adabrakadabra: posts the ante 60
jcarlos.vale: posts the ante 60
jcarlos.vale: posts small blind 500
adabrakadabra: posts big blind 1000
*** HOLE CARDS ***
Dealt to jcarlos.vale [7h Ac]
jcarlos.vale: raises 1600 to 2600
adabrakadabra: folds 
Uncalled bet (1600) returned to jcarlos.vale
jcarlos.vale collected 2120 from pot
jcarlos.vale: doesn't show handDTO
*** SUMMARY ***
Total pot 2120 | Rake 0 
Seat 6: adabrakadabra (big blind) folded before Flop
Seat 7: jcarlos.vale (button) (small blind) collected (2120)



PokerStars Hand #221593615293: Tournament #3079328305, $0.91+$0.09 USD Hold'em No Limit - Level XII (500/1000) - 2020/12/19 3:22:59 EET [2020/12/18 20:22:59 ET]
Table '3079328305 4' 9-max Seat #6 is the button
Seat 6: adabrakadabra (21810 in chips) 
Seat 7: jcarlos.vale (45690 in chips) 
adabrakadabra: posts the ante 60
jcarlos.vale: posts the ante 60
adabrakadabra: posts small blind 500
jcarlos.vale: posts big blind 1000
*** HOLE CARDS ***
Dealt to jcarlos.vale [8h Qh]
adabrakadabra: folds 
Uncalled bet (500) returned to jcarlos.vale
jcarlos.vale collected 1120 from pot
jcarlos.vale: doesn't show handDTO
*** SUMMARY ***
Total pot 1120 | Rake 0 
Seat 6: adabrakadabra (button) (small blind) folded before Flop
Seat 7: jcarlos.vale (big blind) collected (1120)



PokerStars Hand #221593621505: Tournament #3079328305, $0.91+$0.09 USD Hold'em No Limit - Level XIII (600/1200) - 2020/12/19 3:23:14 EET [2020/12/18 20:23:14 ET]
Table '3079328305 4' 9-max Seat #7 is the button
Seat 6: adabrakadabra (21250 in chips) 
Seat 7: jcarlos.vale (46250 in chips) 
adabrakadabra: posts the ante 75
jcarlos.vale: posts the ante 75
jcarlos.vale: posts small blind 600
adabrakadabra: posts big blind 1200
*** HOLE CARDS ***
Dealt to jcarlos.vale [Ks Kc]
jcarlos.vale: raises 1920 to 3120
adabrakadabra: folds 
Uncalled bet (1920) returned to jcarlos.vale
jcarlos.vale collected 2550 from pot
jcarlos.vale: doesn't show handDTO
*** SUMMARY ***
Total pot 2550 | Rake 0 
Seat 6: adabrakadabra (big blind) folded before Flop
Seat 7: jcarlos.vale (button) (small blind) collected (2550)



PokerStars Hand #221593627568: Tournament #3079328305, $0.91+$0.09 USD Hold'em No Limit - Level XIII (600/1200) - 2020/12/19 3:23:28 EET [2020/12/18 20:23:28 ET]
Table '3079328305 4' 9-max Seat #6 is the button
Seat 6: adabrakadabra (19975 in chips) 
Seat 7: jcarlos.vale (47525 in chips) 
adabrakadabra: posts the ante 75
jcarlos.vale: posts the ante 75
adabrakadabra: posts small blind 600
jcarlos.vale: posts big blind 1200
*** HOLE CARDS ***
Dealt to jcarlos.vale [8h 6c]
adabrakadabra: folds 
Uncalled bet (600) returned to jcarlos.vale
jcarlos.vale collected 1350 from pot
jcarlos.vale: doesn't show handDTO
*** SUMMARY ***
Total pot 1350 | Rake 0 
Seat 6: adabrakadabra (button) (small blind) folded before Flop
Seat 7: jcarlos.vale (big blind) collected (1350)



PokerStars Hand #221593634227: Tournament #3079328305, $0.91+$0.09 USD Hold'em No Limit - Level XIII (600/1200) - 2020/12/19 3:23:43 EET [2020/12/18 20:23:43 ET]
Table '3079328305 4' 9-max Seat #7 is the button
Seat 6: adabrakadabra (19300 in chips) 
Seat 7: jcarlos.vale (48200 in chips) 
adabrakadabra: posts the ante 75
jcarlos.vale: posts the ante 75
jcarlos.vale: posts small blind 600
adabrakadabra: posts big blind 1200
*** HOLE CARDS ***
Dealt to jcarlos.vale [3s 5d]
jcarlos.vale: folds 
Uncalled bet (600) returned to adabrakadabra
adabrakadabra collected 1350 from pot
*** SUMMARY ***
Total pot 1350 | Rake 0 
Seat 6: adabrakadabra (big blind) collected (1350)
Seat 7: jcarlos.vale (button) (small blind) folded before Flop



PokerStars Hand #221593639202: Tournament #3079328305, $0.91+$0.09 USD Hold'em No Limit - Level XIII (600/1200) - 2020/12/19 3:23:55 EET [2020/12/18 20:23:55 ET]
Table '3079328305 4' 9-max Seat #6 is the button
Seat 6: adabrakadabra (19975 in chips) 
Seat 7: jcarlos.vale (47525 in chips) 
adabrakadabra: posts the ante 75
jcarlos.vale: posts the ante 75
adabrakadabra: posts small blind 600
jcarlos.vale: posts big blind 1200
*** HOLE CARDS ***
Dealt to jcarlos.vale [2d 4h]
adabrakadabra: calls 600
jcarlos.vale: checks 
*** FLOP *** [9c 5s 3d]
jcarlos.vale: bets 1275
adabrakadabra: folds 
Uncalled bet (1275) returned to jcarlos.vale
jcarlos.vale collected 2550 from pot
jcarlos.vale: doesn't show handDTO
*** SUMMARY ***
Total pot 2550 | Rake 0 
Board [9c 5s 3d]
Seat 6: adabrakadabra (button) (small blind) folded on the Flop
Seat 7: jcarlos.vale (big blind) collected (2550)



PokerStars Hand #221593647868: Tournament #3079328305, $0.91+$0.09 USD Hold'em No Limit - Level XIII (600/1200) - 2020/12/19 3:24:15 EET [2020/12/18 20:24:15 ET]
Table '3079328305 4' 9-max Seat #7 is the button
Seat 6: adabrakadabra (18700 in chips) 
Seat 7: jcarlos.vale (48800 in chips) 
adabrakadabra: posts the ante 75
jcarlos.vale: posts the ante 75
jcarlos.vale: posts small blind 600
adabrakadabra: posts big blind 1200
*** HOLE CARDS ***
Dealt to jcarlos.vale [3h Kc]
jcarlos.vale: folds 
Uncalled bet (600) returned to adabrakadabra
adabrakadabra collected 1350 from pot
*** SUMMARY ***
Total pot 1350 | Rake 0 
Seat 6: adabrakadabra (big blind) collected (1350)
Seat 7: jcarlos.vale (button) (small blind) folded before Flop



PokerStars Hand #221593652407: Tournament #3079328305, $0.91+$0.09 USD Hold'em No Limit - Level XIII (600/1200) - 2020/12/19 3:24:25 EET [2020/12/18 20:24:25 ET]
Table '3079328305 4' 9-max Seat #6 is the button
Seat 6: adabrakadabra (19375 in chips) 
Seat 7: jcarlos.vale (48125 in chips) 
adabrakadabra: posts the ante 75
jcarlos.vale: posts the ante 75
adabrakadabra: posts small blind 600
jcarlos.vale: posts big blind 1200
*** HOLE CARDS ***
Dealt to jcarlos.vale [4d Qc]
adabrakadabra: raises 2400 to 3600
jcarlos.vale: folds 
Uncalled bet (2400) returned to adabrakadabra
adabrakadabra collected 2550 from pot
*** SUMMARY ***
Total pot 2550 | Rake 0 
Seat 6: adabrakadabra (button) (small blind) collected (2550)
Seat 7: jcarlos.vale (big blind) folded before Flop



PokerStars Hand #221593666434: Tournament #3079328305, $0.91+$0.09 USD Hold'em No Limit - Level XIII (600/1200) - 2020/12/19 3:24:41 EET [2020/12/18 20:24:41 ET]
Table '3079328305 4' 9-max Seat #7 is the button
Seat 6: adabrakadabra (20650 in chips) 
Seat 7: jcarlos.vale (46850 in chips) 
adabrakadabra: posts the ante 75
jcarlos.vale: posts the ante 75
jcarlos.vale: posts small blind 600
adabrakadabra: posts big blind 1200
*** HOLE CARDS ***
Dealt to jcarlos.vale [3d Kc]
jcarlos.vale: calls 600
adabrakadabra: checks 
*** FLOP *** [Kh 8d Qs]
adabrakadabra: checks 
jcarlos.vale: bets 1275
adabrakadabra: folds 
Uncalled bet (1275) returned to jcarlos.vale
jcarlos.vale collected 2550 from pot
jcarlos.vale: doesn't show handDTO
*** SUMMARY ***
Total pot 2550 | Rake 0 
Board [Kh 8d Qs]
Seat 6: adabrakadabra (big blind) folded on the Flop
Seat 7: jcarlos.vale (button) (small blind) collected (2550)



PokerStars Hand #221593675412: Tournament #3079328305, $0.91+$0.09 USD Hold'em No Limit - Level XIII (600/1200) - 2020/12/19 3:25:02 EET [2020/12/18 20:25:02 ET]
Table '3079328305 4' 9-max Seat #6 is the button
Seat 6: adabrakadabra (19375 in chips) 
Seat 7: jcarlos.vale (48125 in chips) 
adabrakadabra: posts the ante 75
jcarlos.vale: posts the ante 75
adabrakadabra: posts small blind 600
jcarlos.vale: posts big blind 1200
*** HOLE CARDS ***
Dealt to jcarlos.vale [Kc Ts]
adabrakadabra: folds 
Uncalled bet (600) returned to jcarlos.vale
jcarlos.vale collected 1350 from pot
jcarlos.vale: doesn't show handDTO
*** SUMMARY ***
Total pot 1350 | Rake 0 
Seat 6: adabrakadabra (button) (small blind) folded before Flop
Seat 7: jcarlos.vale (big blind) collected (1350)



PokerStars Hand #221593680193: Tournament #3079328305, $0.91+$0.09 USD Hold'em No Limit - Level XIII (600/1200) - 2020/12/19 3:25:14 EET [2020/12/18 20:25:14 ET]
Table '3079328305 4' 9-max Seat #7 is the button
Seat 6: adabrakadabra (18700 in chips) 
Seat 7: jcarlos.vale (48800 in chips) 
adabrakadabra: posts the ante 75
jcarlos.vale: posts the ante 75
jcarlos.vale: posts small blind 600
adabrakadabra: posts big blind 1200
*** HOLE CARDS ***
Dealt to jcarlos.vale [4c 8h]
jcarlos.vale: folds 
Uncalled bet (600) returned to adabrakadabra
adabrakadabra collected 1350 from pot
*** SUMMARY ***
Total pot 1350 | Rake 0 
Seat 6: adabrakadabra (big blind) collected (1350)
Seat 7: jcarlos.vale (button) (small blind) folded before Flop



PokerStars Hand #221593684885: Tournament #3079328305, $0.91+$0.09 USD Hold'em No Limit - Level XIII (600/1200) - 2020/12/19 3:25:25 EET [2020/12/18 20:25:25 ET]
Table '3079328305 4' 9-max Seat #6 is the button
Seat 6: adabrakadabra (19375 in chips) 
Seat 7: jcarlos.vale (48125 in chips) 
adabrakadabra: posts the ante 75
jcarlos.vale: posts the ante 75
adabrakadabra: posts small blind 600
jcarlos.vale: posts big blind 1200
*** HOLE CARDS ***
Dealt to jcarlos.vale [4h 5c]
adabrakadabra: raises 2400 to 3600
jcarlos.vale: folds 
Uncalled bet (2400) returned to adabrakadabra
adabrakadabra collected 2550 from pot
*** SUMMARY ***
Total pot 2550 | Rake 0 
Seat 6: adabrakadabra (button) (small blind) collected (2550)
Seat 7: jcarlos.vale (big blind) folded before Flop



PokerStars Hand #221593690988: Tournament #3079328305, $0.91+$0.09 USD Hold'em No Limit - Level XIII (600/1200) - 2020/12/19 3:25:39 EET [2020/12/18 20:25:39 ET]
Table '3079328305 4' 9-max Seat #7 is the button
Seat 6: adabrakadabra (20650 in chips) 
Seat 7: jcarlos.vale (46850 in chips) 
adabrakadabra: posts the ante 75
jcarlos.vale: posts the ante 75
jcarlos.vale: posts small blind 600
adabrakadabra: posts big blind 1200
*** HOLE CARDS ***
Dealt to jcarlos.vale [Kh 5c]
jcarlos.vale: raises 1920 to 3120
adabrakadabra: folds 
Uncalled bet (1920) returned to jcarlos.vale
jcarlos.vale collected 2550 from pot
jcarlos.vale: doesn't show handDTO
*** SUMMARY ***
Total pot 2550 | Rake 0 
Seat 6: adabrakadabra (big blind) folded before Flop
Seat 7: jcarlos.vale (button) (small blind) collected (2550)



PokerStars Hand #221593698118: Tournament #3079328305, $0.91+$0.09 USD Hold'em No Limit - Level XIII (600/1200) - 2020/12/19 3:25:56 EET [2020/12/18 20:25:56 ET]
Table '3079328305 4' 9-max Seat #6 is the button
Seat 6: adabrakadabra (19375 in chips) 
Seat 7: jcarlos.vale (48125 in chips) 
adabrakadabra: posts the ante 75
jcarlos.vale: posts the ante 75
adabrakadabra: posts small blind 600
jcarlos.vale: posts big blind 1200
*** HOLE CARDS ***
Dealt to jcarlos.vale [Ah 2d]
adabrakadabra: folds 
Uncalled bet (600) returned to jcarlos.vale
jcarlos.vale collected 1350 from pot
jcarlos.vale: doesn't show handDTO
*** SUMMARY ***
Total pot 1350 | Rake 0 
Seat 6: adabrakadabra (button) (small blind) folded before Flop
Seat 7: jcarlos.vale (big blind) collected (1350)



PokerStars Hand #221593702302: Tournament #3079328305, $0.91+$0.09 USD Hold'em No Limit - Level XIII (600/1200) - 2020/12/19 3:26:06 EET [2020/12/18 20:26:06 ET]
Table '3079328305 4' 9-max Seat #7 is the button
Seat 6: adabrakadabra (18700 in chips) 
Seat 7: jcarlos.vale (48800 in chips) 
adabrakadabra: posts the ante 75
jcarlos.vale: posts the ante 75
jcarlos.vale: posts small blind 600
adabrakadabra: posts big blind 1200
*** HOLE CARDS ***
Dealt to jcarlos.vale [5s 4d]
jcarlos.vale: raises 1920 to 3120
adabrakadabra: folds 
Uncalled bet (1920) returned to jcarlos.vale
jcarlos.vale collected 2550 from pot
jcarlos.vale: doesn't show handDTO
*** SUMMARY ***
Total pot 2550 | Rake 0 
Seat 6: adabrakadabra (big blind) folded before Flop
Seat 7: jcarlos.vale (button) (small blind) collected (2550)



PokerStars Hand #221593707331: Tournament #3079328305, $0.91+$0.09 USD Hold'em No Limit - Level XIII (600/1200) - 2020/12/19 3:26:18 EET [2020/12/18 20:26:18 ET]
Table '3079328305 4' 9-max Seat #6 is the button
Seat 6: adabrakadabra (17425 in chips) 
Seat 7: jcarlos.vale (50075 in chips) 
adabrakadabra: posts the ante 75
jcarlos.vale: posts the ante 75
adabrakadabra: posts small blind 600
jcarlos.vale: posts big blind 1200
*** HOLE CARDS ***
Dealt to jcarlos.vale [Ad 7h]
adabrakadabra: calls 600
jcarlos.vale: checks 
*** FLOP *** [Qd 3s Kd]
jcarlos.vale: checks 
adabrakadabra: checks 
*** TURN *** [Qd 3s Kd] [Td]
jcarlos.vale: checks 
adabrakadabra: bets 1913
jcarlos.vale: calls 1913
*** RIVER *** [Qd 3s Kd Td] [Ac]
jcarlos.vale: bets 3188
adabrakadabra: raises 11049 to 14237 and is all-in
jcarlos.vale: calls 11049
*** SHOW DOWN ***
adabrakadabra: shows [7d Jh] (a straight, Ten to Ace)
jcarlos.vale: shows [Ad 7h] (a pair of Aces)
adabrakadabra collected 34850 from pot
*** SUMMARY ***
Total pot 34850 | Rake 0 
Board [Qd 3s Kd Td Ac]
Seat 6: adabrakadabra (button) (small blind) showed [7d Jh] and won (34850) with a straight, Ten to Ace
Seat 7: jcarlos.vale (big blind) showed [Ad 7h] and lost with a pair of Aces



PokerStars Hand #221593723809: Tournament #3079328305, $0.91+$0.09 USD Hold'em No Limit - Level XIII (600/1200) - 2020/12/19 3:26:57 EET [2020/12/18 20:26:57 ET]
Table '3079328305 4' 9-max Seat #7 is the button
Seat 6: adabrakadabra (34850 in chips) 
Seat 7: jcarlos.vale (32650 in chips) 
adabrakadabra: posts the ante 75
jcarlos.vale: posts the ante 75
jcarlos.vale: posts small blind 600
adabrakadabra: posts big blind 1200
*** HOLE CARDS ***
Dealt to jcarlos.vale [7h 5c]
jcarlos.vale: calls 600
adabrakadabra: checks 
*** FLOP *** [Kd Qh 5d]
adabrakadabra: checks 
jcarlos.vale: bets 1275
adabrakadabra: folds 
Uncalled bet (1275) returned to jcarlos.vale
jcarlos.vale collected 2550 from pot
jcarlos.vale: doesn't show handDTO
*** SUMMARY ***
Total pot 2550 | Rake 0 
Board [Kd Qh 5d]
Seat 6: adabrakadabra (big blind) folded on the Flop
Seat 7: jcarlos.vale (button) (small blind) collected (2550)



PokerStars Hand #221593732105: Tournament #3079328305, $0.91+$0.09 USD Hold'em No Limit - Level XIII (600/1200) - 2020/12/19 3:27:16 EET [2020/12/18 20:27:16 ET]
Table '3079328305 4' 9-max Seat #6 is the button
Seat 6: adabrakadabra (33575 in chips) 
Seat 7: jcarlos.vale (33925 in chips) 
adabrakadabra: posts the ante 75
jcarlos.vale: posts the ante 75
adabrakadabra: posts small blind 600
jcarlos.vale: posts big blind 1200
*** HOLE CARDS ***
Dealt to jcarlos.vale [8d 5d]
adabrakadabra: raises 2400 to 3600
jcarlos.vale: calls 2400
*** FLOP *** [8c 2c 3s]
jcarlos.vale: bets 5513
adabrakadabra: folds 
Uncalled bet (5513) returned to jcarlos.vale
jcarlos.vale collected 7350 from pot
jcarlos.vale: doesn't show handDTO
*** SUMMARY ***
Total pot 7350 | Rake 0 
Board [8c 2c 3s]
Seat 6: adabrakadabra (button) (small blind) folded on the Flop
Seat 7: jcarlos.vale (big blind) collected (7350)



PokerStars Hand #221593742410: Tournament #3079328305, $0.91+$0.09 USD Hold'em No Limit - Level XIII (600/1200) - 2020/12/19 3:27:41 EET [2020/12/18 20:27:41 ET]
Table '3079328305 4' 9-max Seat #7 is the button
Seat 6: adabrakadabra (29900 in chips) 
Seat 7: jcarlos.vale (37600 in chips) 
adabrakadabra: posts the ante 75
jcarlos.vale: posts the ante 75
jcarlos.vale: posts small blind 600
adabrakadabra: posts big blind 1200
*** HOLE CARDS ***
Dealt to jcarlos.vale [8h 2h]
jcarlos.vale: folds 
Uncalled bet (600) returned to adabrakadabra
adabrakadabra collected 1350 from pot
*** SUMMARY ***
Total pot 1350 | Rake 0 
Seat 6: adabrakadabra (big blind) collected (1350)
Seat 7: jcarlos.vale (button) (small blind) folded before Flop



PokerStars Hand #221593746871: Tournament #3079328305, $0.91+$0.09 USD Hold'em No Limit - Level XIII (600/1200) - 2020/12/19 3:27:51 EET [2020/12/18 20:27:51 ET]
Table '3079328305 4' 9-max Seat #6 is the button
Seat 6: adabrakadabra (30575 in chips) 
Seat 7: jcarlos.vale (36925 in chips) 
adabrakadabra: posts the ante 75
jcarlos.vale: posts the ante 75
adabrakadabra: posts small blind 600
jcarlos.vale: posts big blind 1200
*** HOLE CARDS ***
Dealt to jcarlos.vale [8s 9s]
adabrakadabra: folds 
Uncalled bet (600) returned to jcarlos.vale
jcarlos.vale collected 1350 from pot
jcarlos.vale: doesn't show handDTO
*** SUMMARY ***
Total pot 1350 | Rake 0 
Seat 6: adabrakadabra (button) (small blind) folded before Flop
Seat 7: jcarlos.vale (big blind) collected (1350)



PokerStars Hand #221593753546: Tournament #3079328305, $0.91+$0.09 USD Hold'em No Limit - Level XIII (600/1200) - 2020/12/19 3:28:07 EET [2020/12/18 20:28:07 ET]
Table '3079328305 4' 9-max Seat #7 is the button
Seat 6: adabrakadabra (29900 in chips) 
Seat 7: jcarlos.vale (37600 in chips) 
adabrakadabra: posts the ante 75
jcarlos.vale: posts the ante 75
jcarlos.vale: posts small blind 600
adabrakadabra: posts big blind 1200
*** HOLE CARDS ***
Dealt to jcarlos.vale [7s 6c]
jcarlos.vale: raises 1920 to 3120
adabrakadabra: folds 
Uncalled bet (1920) returned to jcarlos.vale
jcarlos.vale collected 2550 from pot
jcarlos.vale: doesn't show handDTO
*** SUMMARY ***
Total pot 2550 | Rake 0 
Seat 6: adabrakadabra (big blind) folded before Flop
Seat 7: jcarlos.vale (button) (small blind) collected (2550)



PokerStars Hand #221593761643: Tournament #3079328305, $0.91+$0.09 USD Hold'em No Limit - Level XIII (600/1200) - 2020/12/19 3:28:26 EET [2020/12/18 20:28:26 ET]
Table '3079328305 4' 9-max Seat #6 is the button
Seat 6: adabrakadabra (28625 in chips) 
Seat 7: jcarlos.vale (38875 in chips) 
adabrakadabra: posts the ante 75
jcarlos.vale: posts the ante 75
adabrakadabra: posts small blind 600
jcarlos.vale: posts big blind 1200
*** HOLE CARDS ***
Dealt to jcarlos.vale [Qd 2h]
adabrakadabra: raises 1200 to 2400
jcarlos.vale: folds 
Uncalled bet (1200) returned to adabrakadabra
adabrakadabra collected 2550 from pot
*** SUMMARY ***
Total pot 2550 | Rake 0 
Seat 6: adabrakadabra (button) (small blind) collected (2550)
Seat 7: jcarlos.vale (big blind) folded before Flop



PokerStars Hand #221593769132: Tournament #3079328305, $0.91+$0.09 USD Hold'em No Limit - Level XIII (600/1200) - 2020/12/19 3:28:44 EET [2020/12/18 20:28:44 ET]
Table '3079328305 4' 9-max Seat #7 is the button
Seat 6: adabrakadabra (29900 in chips) 
Seat 7: jcarlos.vale (37600 in chips) 
adabrakadabra: posts the ante 75
jcarlos.vale: posts the ante 75
jcarlos.vale: posts small blind 600
adabrakadabra: posts big blind 1200
*** HOLE CARDS ***
Dealt to jcarlos.vale [Kd Ac]
jcarlos.vale: raises 1920 to 3120
adabrakadabra: folds 
Uncalled bet (1920) returned to jcarlos.vale
jcarlos.vale collected 2550 from pot
jcarlos.vale: doesn't show handDTO
*** SUMMARY ***
Total pot 2550 | Rake 0 
Seat 6: adabrakadabra (big blind) folded before Flop
Seat 7: jcarlos.vale (button) (small blind) collected (2550)



PokerStars Hand #221593774463: Tournament #3079328305, $0.91+$0.09 USD Hold'em No Limit - Level XIII (600/1200) - 2020/12/19 3:28:57 EET [2020/12/18 20:28:57 ET]
Table '3079328305 4' 9-max Seat #6 is the button
Seat 6: adabrakadabra (28625 in chips) 
Seat 7: jcarlos.vale (38875 in chips) 
adabrakadabra: posts the ante 75
jcarlos.vale: posts the ante 75
adabrakadabra: posts small blind 600
jcarlos.vale: posts big blind 1200
*** HOLE CARDS ***
Dealt to jcarlos.vale [9s Qs]
adabrakadabra: raises 1200 to 2400
jcarlos.vale: calls 1200
*** FLOP *** [Js 7d 2c]
jcarlos.vale: checks 
adabrakadabra: bets 3713
jcarlos.vale: folds 
Uncalled bet (3713) returned to adabrakadabra
adabrakadabra collected 4950 from pot
*** SUMMARY ***
Total pot 4950 | Rake 0 
Board [Js 7d 2c]
Seat 6: adabrakadabra (button) (small blind) collected (4950)
Seat 7: jcarlos.vale (big blind) folded on the Flop



PokerStars Hand #221593784151: Tournament #3079328305, $0.91+$0.09 USD Hold'em No Limit - Level XIII (600/1200) - 2020/12/19 3:29:20 EET [2020/12/18 20:29:20 ET]
Table '3079328305 4' 9-max Seat #7 is the button
Seat 6: adabrakadabra (31100 in chips) 
Seat 7: jcarlos.vale (36400 in chips) 
adabrakadabra: posts the ante 75
jcarlos.vale: posts the ante 75
jcarlos.vale: posts small blind 600
adabrakadabra: posts big blind 1200
*** HOLE CARDS ***
Dealt to jcarlos.vale [Qc Jd]
jcarlos.vale: raises 1920 to 3120
adabrakadabra: folds 
Uncalled bet (1920) returned to jcarlos.vale
jcarlos.vale collected 2550 from pot
jcarlos.vale: doesn't show handDTO
*** SUMMARY ***
Total pot 2550 | Rake 0 
Seat 6: adabrakadabra (big blind) folded before Flop
Seat 7: jcarlos.vale (button) (small blind) collected (2550)



PokerStars Hand #221593790665: Tournament #3079328305, $0.91+$0.09 USD Hold'em No Limit - Level XIII (600/1200) - 2020/12/19 3:29:35 EET [2020/12/18 20:29:35 ET]
Table '3079328305 4' 9-max Seat #6 is the button
Seat 6: adabrakadabra (29825 in chips) 
Seat 7: jcarlos.vale (37675 in chips) 
adabrakadabra: posts the ante 75
jcarlos.vale: posts the ante 75
adabrakadabra: posts small blind 600
jcarlos.vale: posts big blind 1200
*** HOLE CARDS ***
Dealt to jcarlos.vale [4d Jd]
adabrakadabra: folds 
Uncalled bet (600) returned to jcarlos.vale
jcarlos.vale collected 1350 from pot
jcarlos.vale: doesn't show handDTO
*** SUMMARY ***
Total pot 1350 | Rake 0 
Seat 6: adabrakadabra (button) (small blind) folded before Flop
Seat 7: jcarlos.vale (big blind) collected (1350)



PokerStars Hand #221593794976: Tournament #3079328305, $0.91+$0.09 USD Hold'em No Limit - Level XIII (600/1200) - 2020/12/19 3:29:46 EET [2020/12/18 20:29:46 ET]
Table '3079328305 4' 9-max Seat #7 is the button
Seat 6: adabrakadabra (29150 in chips) 
Seat 7: jcarlos.vale (38350 in chips) 
adabrakadabra: posts the ante 75
jcarlos.vale: posts the ante 75
jcarlos.vale: posts small blind 600
adabrakadabra: posts big blind 1200
*** HOLE CARDS ***
Dealt to jcarlos.vale [Js 3h]
jcarlos.vale: folds 
Uncalled bet (600) returned to adabrakadabra
adabrakadabra collected 1350 from pot
*** SUMMARY ***
Total pot 1350 | Rake 0 
Seat 6: adabrakadabra (big blind) collected (1350)
Seat 7: jcarlos.vale (button) (small blind) folded before Flop



PokerStars Hand #221593799987: Tournament #3079328305, $0.91+$0.09 USD Hold'em No Limit - Level XIII (600/1200) - 2020/12/19 3:29:58 EET [2020/12/18 20:29:58 ET]
Table '3079328305 4' 9-max Seat #6 is the button
Seat 6: adabrakadabra (29825 in chips) 
Seat 7: jcarlos.vale (37675 in chips) 
adabrakadabra: posts the ante 75
jcarlos.vale: posts the ante 75
adabrakadabra: posts small blind 600
jcarlos.vale: posts big blind 1200
*** HOLE CARDS ***
Dealt to jcarlos.vale [9h 6d]
adabrakadabra: folds 
Uncalled bet (600) returned to jcarlos.vale
jcarlos.vale collected 1350 from pot
jcarlos.vale: doesn't show handDTO
*** SUMMARY ***
Total pot 1350 | Rake 0 
Seat 6: adabrakadabra (button) (small blind) folded before Flop
Seat 7: jcarlos.vale (big blind) collected (1350)



PokerStars Hand #221593805414: Tournament #3079328305, $0.91+$0.09 USD Hold'em No Limit - Level XIII (600/1200) - 2020/12/19 3:30:10 EET [2020/12/18 20:30:10 ET]
Table '3079328305 4' 9-max Seat #7 is the button
Seat 6: adabrakadabra (29150 in chips) 
Seat 7: jcarlos.vale (38350 in chips) 
adabrakadabra: posts the ante 75
jcarlos.vale: posts the ante 75
jcarlos.vale: posts small blind 600
adabrakadabra: posts big blind 1200
*** HOLE CARDS ***
Dealt to jcarlos.vale [Js Qd]
jcarlos.vale: raises 1920 to 3120
adabrakadabra: folds 
Uncalled bet (1920) returned to jcarlos.vale
jcarlos.vale collected 2550 from pot
jcarlos.vale: doesn't show handDTO
*** SUMMARY ***
Total pot 2550 | Rake 0 
Seat 6: adabrakadabra (big blind) folded before Flop
Seat 7: jcarlos.vale (button) (small blind) collected (2550)



PokerStars Hand #221593810983: Tournament #3079328305, $0.91+$0.09 USD Hold'em No Limit - Level XIII (600/1200) - 2020/12/19 3:30:23 EET [2020/12/18 20:30:23 ET]
Table '3079328305 4' 9-max Seat #6 is the button
Seat 6: adabrakadabra (27875 in chips) 
Seat 7: jcarlos.vale (39625 in chips) 
adabrakadabra: posts the ante 75
jcarlos.vale: posts the ante 75
adabrakadabra: posts small blind 600
jcarlos.vale: posts big blind 1200
*** HOLE CARDS ***
Dealt to jcarlos.vale [2c 5d]
adabrakadabra: raises 1800 to 3000
jcarlos.vale: folds 
Uncalled bet (1800) returned to adabrakadabra
adabrakadabra collected 2550 from pot
*** SUMMARY ***
Total pot 2550 | Rake 0 
Seat 6: adabrakadabra (button) (small blind) collected (2550)
Seat 7: jcarlos.vale (big blind) folded before Flop



PokerStars Hand #221593818955: Tournament #3079328305, $0.91+$0.09 USD Hold'em No Limit - Level XIII (600/1200) - 2020/12/19 3:30:42 EET [2020/12/18 20:30:42 ET]
Table '3079328305 4' 9-max Seat #7 is the button
Seat 6: adabrakadabra (29150 in chips) 
Seat 7: jcarlos.vale (38350 in chips) 
adabrakadabra: posts the ante 75
jcarlos.vale: posts the ante 75
jcarlos.vale: posts small blind 600
adabrakadabra: posts big blind 1200
*** HOLE CARDS ***
Dealt to jcarlos.vale [Ac 2c]
jcarlos.vale: calls 600
adabrakadabra: raises 2400 to 3600
jcarlos.vale: folds 
Uncalled bet (2400) returned to adabrakadabra
adabrakadabra collected 2550 from pot
*** SUMMARY ***
Total pot 2550 | Rake 0 
Seat 6: adabrakadabra (big blind) collected (2550)
Seat 7: jcarlos.vale (button) (small blind) folded before Flop



PokerStars Hand #221593837759: Tournament #3079328305, $0.91+$0.09 USD Hold'em No Limit - Level XIII (600/1200) - 2020/12/19 3:31:27 EET [2020/12/18 20:31:27 ET]
Table '3079328305 4' 9-max Seat #6 is the button
Seat 6: adabrakadabra (30425 in chips) 
Seat 7: jcarlos.vale (37075 in chips) 
adabrakadabra: posts the ante 75
jcarlos.vale: posts the ante 75
adabrakadabra: posts small blind 600
jcarlos.vale: posts big blind 1200
*** HOLE CARDS ***
Dealt to jcarlos.vale [6c 8c]
adabrakadabra: raises 1200 to 2400
jcarlos.vale: calls 1200
*** FLOP *** [Ts As Kd]
jcarlos.vale: bets 2475
adabrakadabra: calls 2475
*** TURN *** [Ts As Kd] [7c]
jcarlos.vale: checks 
adabrakadabra: bets 1881
jcarlos.vale: folds 
Uncalled bet (1881) returned to adabrakadabra
adabrakadabra collected 9900 from pot
*** SUMMARY ***
Total pot 9900 | Rake 0 
Board [Ts As Kd 7c]
Seat 6: adabrakadabra (button) (small blind) collected (9900)
Seat 7: jcarlos.vale (big blind) folded on the Turn



PokerStars Hand #221593858703: Tournament #3079328305, $0.91+$0.09 USD Hold'em No Limit - Level XIII (600/1200) - 2020/12/19 3:31:58 EET [2020/12/18 20:31:58 ET]
Table '3079328305 4' 9-max Seat #7 is the button
Seat 6: adabrakadabra (35375 in chips) 
Seat 7: jcarlos.vale (32125 in chips) 
adabrakadabra: posts the ante 75
jcarlos.vale: posts the ante 75
jcarlos.vale: posts small blind 600
adabrakadabra: posts big blind 1200
*** HOLE CARDS ***
Dealt to jcarlos.vale [5s 4d]
jcarlos.vale: folds 
Uncalled bet (600) returned to adabrakadabra
adabrakadabra collected 1350 from pot
*** SUMMARY ***
Total pot 1350 | Rake 0 
Seat 6: adabrakadabra (big blind) collected (1350)
Seat 7: jcarlos.vale (button) (small blind) folded before Flop



PokerStars Hand #221593862892: Tournament #3079328305, $0.91+$0.09 USD Hold'em No Limit - Level XIII (600/1200) - 2020/12/19 3:32:08 EET [2020/12/18 20:32:08 ET]
Table '3079328305 4' 9-max Seat #6 is the button
Seat 6: adabrakadabra (36050 in chips) 
Seat 7: jcarlos.vale (31450 in chips) 
adabrakadabra: posts the ante 75
jcarlos.vale: posts the ante 75
adabrakadabra: posts small blind 600
jcarlos.vale: posts big blind 1200
*** HOLE CARDS ***
Dealt to jcarlos.vale [As Th]
adabrakadabra: folds 
Uncalled bet (600) returned to jcarlos.vale
jcarlos.vale collected 1350 from pot
jcarlos.vale: doesn't show handDTO
*** SUMMARY ***
Total pot 1350 | Rake 0 
Seat 6: adabrakadabra (button) (small blind) folded before Flop
Seat 7: jcarlos.vale (big blind) collected (1350)



PokerStars Hand #221593867289: Tournament #3079328305, $0.91+$0.09 USD Hold'em No Limit - Level XIII (600/1200) - 2020/12/19 3:32:19 EET [2020/12/18 20:32:19 ET]
Table '3079328305 4' 9-max Seat #7 is the button
Seat 6: adabrakadabra (35375 in chips) 
Seat 7: jcarlos.vale (32125 in chips) 
adabrakadabra: posts the ante 75
jcarlos.vale: posts the ante 75
jcarlos.vale: posts small blind 600
adabrakadabra: posts big blind 1200
*** HOLE CARDS ***
Dealt to jcarlos.vale [6c 8c]
jcarlos.vale: raises 30850 to 32050 and is all-in
adabrakadabra: folds 
Uncalled bet (30850) returned to jcarlos.vale
jcarlos.vale collected 2550 from pot
jcarlos.vale: doesn't show handDTO
*** SUMMARY ***
Total pot 2550 | Rake 0 
Seat 6: adabrakadabra (big blind) folded before Flop
Seat 7: jcarlos.vale (button) (small blind) collected (2550)



PokerStars Hand #221593873063: Tournament #3079328305, $0.91+$0.09 USD Hold'em No Limit - Level XIII (600/1200) - 2020/12/19 3:32:33 EET [2020/12/18 20:32:33 ET]
Table '3079328305 4' 9-max Seat #6 is the button
Seat 6: adabrakadabra (34100 in chips) 
Seat 7: jcarlos.vale (33400 in chips) 
adabrakadabra: posts the ante 75
jcarlos.vale: posts the ante 75
adabrakadabra: posts small blind 600
jcarlos.vale: posts big blind 1200
*** HOLE CARDS ***
Dealt to jcarlos.vale [Jd As]
adabrakadabra: folds 
Uncalled bet (600) returned to jcarlos.vale
jcarlos.vale collected 1350 from pot
jcarlos.vale: doesn't show handDTO
*** SUMMARY ***
Total pot 1350 | Rake 0 
Seat 6: adabrakadabra (button) (small blind) folded before Flop
Seat 7: jcarlos.vale (big blind) collected (1350)



PokerStars Hand #221593878003: Tournament #3079328305, $0.91+$0.09 USD Hold'em No Limit - Level XIII (600/1200) - 2020/12/19 3:32:45 EET [2020/12/18 20:32:45 ET]
Table '3079328305 4' 9-max Seat #7 is the button
Seat 6: adabrakadabra (33425 in chips) 
Seat 7: jcarlos.vale (34075 in chips) 
adabrakadabra: posts the ante 75
jcarlos.vale: posts the ante 75
jcarlos.vale: posts small blind 600
adabrakadabra: posts big blind 1200
*** HOLE CARDS ***
Dealt to jcarlos.vale [Kd Qs]
jcarlos.vale: raises 32800 to 34000 and is all-in
adabrakadabra: folds 
Uncalled bet (32800) returned to jcarlos.vale
jcarlos.vale collected 2550 from pot
jcarlos.vale: doesn't show handDTO
*** SUMMARY ***
Total pot 2550 | Rake 0 
Seat 6: adabrakadabra (big blind) folded before Flop
Seat 7: jcarlos.vale (button) (small blind) collected (2550)



PokerStars Hand #221593882938: Tournament #3079328305, $0.91+$0.09 USD Hold'em No Limit - Level XIII (600/1200) - 2020/12/19 3:32:57 EET [2020/12/18 20:32:57 ET]
Table '3079328305 4' 9-max Seat #6 is the button
Seat 6: adabrakadabra (32150 in chips) 
Seat 7: jcarlos.vale (35350 in chips) 
adabrakadabra: posts the ante 75
jcarlos.vale: posts the ante 75
adabrakadabra: posts small blind 600
jcarlos.vale: posts big blind 1200
*** HOLE CARDS ***
Dealt to jcarlos.vale [4c 9c]
adabrakadabra: calls 600
jcarlos.vale: checks 
*** FLOP *** [7h Qh 4h]
jcarlos.vale: bets 2400
adabrakadabra: folds 
Uncalled bet (2400) returned to jcarlos.vale
jcarlos.vale collected 2550 from pot
jcarlos.vale: doesn't show handDTO
*** SUMMARY ***
Total pot 2550 | Rake 0 
Board [7h Qh 4h]
Seat 6: adabrakadabra (button) (small blind) folded on the Flop
Seat 7: jcarlos.vale (big blind) collected (2550)



PokerStars Hand #221593904727: Tournament #3079328305, $0.91+$0.09 USD Hold'em No Limit - Level XIV (800/1600) - 2020/12/19 3:33:50 EET [2020/12/18 20:33:50 ET]
Table '3079328305 4' 9-max Seat #7 is the button
Seat 6: adabrakadabra (30875 in chips) 
Seat 7: jcarlos.vale (36625 in chips) 
adabrakadabra: posts the ante 75
jcarlos.vale: posts the ante 75
jcarlos.vale: posts small blind 800
adabrakadabra: posts big blind 1600
*** HOLE CARDS ***
Dealt to jcarlos.vale [Th 5h]
jcarlos.vale: folds 
Uncalled bet (800) returned to adabrakadabra
adabrakadabra collected 1750 from pot
*** SUMMARY ***
Total pot 1750 | Rake 0 
Seat 6: adabrakadabra (big blind) collected (1750)
Seat 7: jcarlos.vale (button) (small blind) folded before Flop



PokerStars Hand #221593909350: Tournament #3079328305, $0.91+$0.09 USD Hold'em No Limit - Level XIV (800/1600) - 2020/12/19 3:34:02 EET [2020/12/18 20:34:02 ET]
Table '3079328305 4' 9-max Seat #6 is the button
Seat 6: adabrakadabra (31750 in chips) 
Seat 7: jcarlos.vale (35750 in chips) 
adabrakadabra: posts the ante 75
jcarlos.vale: posts the ante 75
adabrakadabra: posts small blind 800
jcarlos.vale: posts big blind 1600
*** HOLE CARDS ***
Dealt to jcarlos.vale [5s 2c]
adabrakadabra: raises 1600 to 3200
jcarlos.vale: folds 
Uncalled bet (1600) returned to adabrakadabra
adabrakadabra collected 3350 from pot
*** SUMMARY ***
Total pot 3350 | Rake 0 
Seat 6: adabrakadabra (button) (small blind) collected (3350)
Seat 7: jcarlos.vale (big blind) folded before Flop



PokerStars Hand #221593915915: Tournament #3079328305, $0.91+$0.09 USD Hold'em No Limit - Level XIV (800/1600) - 2020/12/19 3:34:18 EET [2020/12/18 20:34:18 ET]
Table '3079328305 4' 9-max Seat #7 is the button
Seat 6: adabrakadabra (33425 in chips) 
Seat 7: jcarlos.vale (34075 in chips) 
adabrakadabra: posts the ante 75
jcarlos.vale: posts the ante 75
jcarlos.vale: posts small blind 800
adabrakadabra: posts big blind 1600
*** HOLE CARDS ***
Dealt to jcarlos.vale [8s 8h]
jcarlos.vale: raises 2560 to 4160
adabrakadabra: folds 
Uncalled bet (2560) returned to jcarlos.vale
jcarlos.vale collected 3350 from pot
jcarlos.vale: doesn't show handDTO
*** SUMMARY ***
Total pot 3350 | Rake 0 
Seat 6: adabrakadabra (big blind) folded before Flop
Seat 7: jcarlos.vale (button) (small blind) collected (3350)



PokerStars Hand #221593922056: Tournament #3079328305, $0.91+$0.09 USD Hold'em No Limit - Level XIV (800/1600) - 2020/12/19 3:34:33 EET [2020/12/18 20:34:33 ET]
Table '3079328305 4' 9-max Seat #6 is the button
Seat 6: adabrakadabra (31750 in chips) 
Seat 7: jcarlos.vale (35750 in chips) 
adabrakadabra: posts the ante 75
jcarlos.vale: posts the ante 75
adabrakadabra: posts small blind 800
jcarlos.vale: posts big blind 1600
*** HOLE CARDS ***
Dealt to jcarlos.vale [8c 5h]
adabrakadabra: calls 800
jcarlos.vale: checks 
*** FLOP *** [9c Kd 7d]
jcarlos.vale: checks 
adabrakadabra: bets 1600
jcarlos.vale: folds 
Uncalled bet (1600) returned to adabrakadabra
adabrakadabra collected 3350 from pot
*** SUMMARY ***
Total pot 3350 | Rake 0 
Board [9c Kd 7d]
Seat 6: adabrakadabra (button) (small blind) collected (3350)
Seat 7: jcarlos.vale (big blind) folded on the Flop



PokerStars Hand #221593930232: Tournament #3079328305, $0.91+$0.09 USD Hold'em No Limit - Level XIV (800/1600) - 2020/12/19 3:34:53 EET [2020/12/18 20:34:53 ET]
Table '3079328305 4' 9-max Seat #7 is the button
Seat 6: adabrakadabra (33425 in chips) 
Seat 7: jcarlos.vale (34075 in chips) 
adabrakadabra: posts the ante 75
jcarlos.vale: posts the ante 75
jcarlos.vale: posts small blind 800
adabrakadabra: posts big blind 1600
*** HOLE CARDS ***
Dealt to jcarlos.vale [Qc Tc]
jcarlos.vale: raises 2560 to 4160
adabrakadabra: folds 
Uncalled bet (2560) returned to jcarlos.vale
jcarlos.vale collected 3350 from pot
jcarlos.vale: doesn't show handDTO
*** SUMMARY ***
Total pot 3350 | Rake 0 
Seat 6: adabrakadabra (big blind) folded before Flop
Seat 7: jcarlos.vale (button) (small blind) collected (3350)



PokerStars Hand #221593940571: Tournament #3079328305, $0.91+$0.09 USD Hold'em No Limit - Level XIV (800/1600) - 2020/12/19 3:35:15 EET [2020/12/18 20:35:15 ET]
Table '3079328305 4' 9-max Seat #6 is the button
Seat 6: adabrakadabra (31750 in chips) 
Seat 7: jcarlos.vale (35750 in chips) 
adabrakadabra: posts the ante 75
jcarlos.vale: posts the ante 75
adabrakadabra: posts small blind 800
jcarlos.vale: posts big blind 1600
*** HOLE CARDS ***
Dealt to jcarlos.vale [Jd 3s]
adabrakadabra: folds 
Uncalled bet (800) returned to jcarlos.vale
jcarlos.vale collected 1750 from pot
jcarlos.vale: doesn't show handDTO
*** SUMMARY ***
Total pot 1750 | Rake 0 
Seat 6: adabrakadabra (button) (small blind) folded before Flop
Seat 7: jcarlos.vale (big blind) collected (1750)



PokerStars Hand #221593945564: Tournament #3079328305, $0.91+$0.09 USD Hold'em No Limit - Level XIV (800/1600) - 2020/12/19 3:35:27 EET [2020/12/18 20:35:27 ET]
Table '3079328305 4' 9-max Seat #7 is the button
Seat 6: adabrakadabra (30875 in chips) 
Seat 7: jcarlos.vale (36625 in chips) 
adabrakadabra: posts the ante 75
jcarlos.vale: posts the ante 75
jcarlos.vale: posts small blind 800
adabrakadabra: posts big blind 1600
*** HOLE CARDS ***
Dealt to jcarlos.vale [3c 7h]
jcarlos.vale: folds 
Uncalled bet (800) returned to adabrakadabra
adabrakadabra collected 1750 from pot
*** SUMMARY ***
Total pot 1750 | Rake 0 
Seat 6: adabrakadabra (big blind) collected (1750)
Seat 7: jcarlos.vale (button) (small blind) folded before Flop



PokerStars Hand #221593949757: Tournament #3079328305, $0.91+$0.09 USD Hold'em No Limit - Level XIV (800/1600) - 2020/12/19 3:35:38 EET [2020/12/18 20:35:38 ET]
Table '3079328305 4' 9-max Seat #6 is the button
Seat 6: adabrakadabra (31750 in chips) 
Seat 7: jcarlos.vale (35750 in chips) 
adabrakadabra: posts the ante 75
jcarlos.vale: posts the ante 75
adabrakadabra: posts small blind 800
jcarlos.vale: posts big blind 1600
*** HOLE CARDS ***
Dealt to jcarlos.vale [6s 2h]
adabrakadabra: folds 
Uncalled bet (800) returned to jcarlos.vale
jcarlos.vale collected 1750 from pot
jcarlos.vale: doesn't show handDTO
*** SUMMARY ***
Total pot 1750 | Rake 0 
Seat 6: adabrakadabra (button) (small blind) folded before Flop
Seat 7: jcarlos.vale (big blind) collected (1750)



PokerStars Hand #221593954829: Tournament #3079328305, $0.91+$0.09 USD Hold'em No Limit - Level XIV (800/1600) - 2020/12/19 3:35:50 EET [2020/12/18 20:35:50 ET]
Table '3079328305 4' 9-max Seat #7 is the button
Seat 6: adabrakadabra (30875 in chips) 
Seat 7: jcarlos.vale (36625 in chips) 
adabrakadabra: posts the ante 75
jcarlos.vale: posts the ante 75
jcarlos.vale: posts small blind 800
adabrakadabra: posts big blind 1600
*** HOLE CARDS ***
Dealt to jcarlos.vale [9c Jd]
jcarlos.vale: raises 2560 to 4160
adabrakadabra: folds 
Uncalled bet (2560) returned to jcarlos.vale
jcarlos.vale collected 3350 from pot
jcarlos.vale: doesn't show handDTO
*** SUMMARY ***
Total pot 3350 | Rake 0 
Seat 6: adabrakadabra (big blind) folded before Flop
Seat 7: jcarlos.vale (button) (small blind) collected (3350)



PokerStars Hand #221593961577: Tournament #3079328305, $0.91+$0.09 USD Hold'em No Limit - Level XIV (800/1600) - 2020/12/19 3:36:07 EET [2020/12/18 20:36:07 ET]
Table '3079328305 4' 9-max Seat #6 is the button
Seat 6: adabrakadabra (29200 in chips) 
Seat 7: jcarlos.vale (38300 in chips) 
adabrakadabra: posts the ante 75
jcarlos.vale: posts the ante 75
adabrakadabra: posts small blind 800
jcarlos.vale: posts big blind 1600
*** HOLE CARDS ***
Dealt to jcarlos.vale [9h Kc]
adabrakadabra: raises 1600 to 3200
jcarlos.vale: calls 1600
*** FLOP *** [2s Th Kd]
jcarlos.vale: checks 
adabrakadabra: checks 
*** TURN *** [2s Th Kd] [Jh]
jcarlos.vale: bets 3275
adabrakadabra: calls 3275
*** RIVER *** [2s Th Kd Jh] [Kh]
jcarlos.vale: bets 6550
adabrakadabra: folds 
Uncalled bet (6550) returned to jcarlos.vale
jcarlos.vale collected 13100 from pot
jcarlos.vale: doesn't show handDTO
*** SUMMARY ***
Total pot 13100 | Rake 0 
Board [2s Th Kd Jh Kh]
Seat 6: adabrakadabra (button) (small blind) folded on the River
Seat 7: jcarlos.vale (big blind) collected (13100)



PokerStars Hand #221593977703: Tournament #3079328305, $0.91+$0.09 USD Hold'em No Limit - Level XIV (800/1600) - 2020/12/19 3:36:46 EET [2020/12/18 20:36:46 ET]
Table '3079328305 4' 9-max Seat #7 is the button
Seat 6: adabrakadabra (22650 in chips) 
Seat 7: jcarlos.vale (44850 in chips) 
adabrakadabra: posts the ante 75
jcarlos.vale: posts the ante 75
jcarlos.vale: posts small blind 800
adabrakadabra: posts big blind 1600
*** HOLE CARDS ***
Dealt to jcarlos.vale [4c 7s]
jcarlos.vale: folds 
Uncalled bet (800) returned to adabrakadabra
adabrakadabra collected 1750 from pot
*** SUMMARY ***
Total pot 1750 | Rake 0 
Seat 6: adabrakadabra (big blind) collected (1750)
Seat 7: jcarlos.vale (button) (small blind) folded before Flop



PokerStars Hand #221593983241: Tournament #3079328305, $0.91+$0.09 USD Hold'em No Limit - Level XIV (800/1600) - 2020/12/19 3:36:56 EET [2020/12/18 20:36:56 ET]
Table '3079328305 4' 9-max Seat #6 is the button
Seat 6: adabrakadabra (23525 in chips) 
Seat 7: jcarlos.vale (43975 in chips) 
adabrakadabra: posts the ante 75
jcarlos.vale: posts the ante 75
adabrakadabra: posts small blind 800
jcarlos.vale: posts big blind 1600
*** HOLE CARDS ***
Dealt to jcarlos.vale [8h 8s]
adabrakadabra: folds 
Uncalled bet (800) returned to jcarlos.vale
jcarlos.vale collected 1750 from pot
jcarlos.vale: doesn't show handDTO
*** SUMMARY ***
Total pot 1750 | Rake 0 
Seat 6: adabrakadabra (button) (small blind) folded before Flop
Seat 7: jcarlos.vale (big blind) collected (1750)



PokerStars Hand #221593987336: Tournament #3079328305, $0.91+$0.09 USD Hold'em No Limit - Level XIV (800/1600) - 2020/12/19 3:37:06 EET [2020/12/18 20:37:06 ET]
Table '3079328305 4' 9-max Seat #7 is the button
Seat 6: adabrakadabra (22650 in chips) 
Seat 7: jcarlos.vale (44850 in chips) 
adabrakadabra: posts the ante 75
jcarlos.vale: posts the ante 75
jcarlos.vale: posts small blind 800
adabrakadabra: posts big blind 1600
*** HOLE CARDS ***
Dealt to jcarlos.vale [7d Ts]
jcarlos.vale: folds 
Uncalled bet (800) returned to adabrakadabra
adabrakadabra collected 1750 from pot
*** SUMMARY ***
Total pot 1750 | Rake 0 
Seat 6: adabrakadabra (big blind) collected (1750)
Seat 7: jcarlos.vale (button) (small blind) folded before Flop



PokerStars Hand #221593991921: Tournament #3079328305, $0.91+$0.09 USD Hold'em No Limit - Level XIV (800/1600) - 2020/12/19 3:37:17 EET [2020/12/18 20:37:17 ET]
Table '3079328305 4' 9-max Seat #6 is the button
Seat 6: adabrakadabra (23525 in chips) 
Seat 7: jcarlos.vale (43975 in chips) 
adabrakadabra: posts the ante 75
jcarlos.vale: posts the ante 75
adabrakadabra: posts small blind 800
jcarlos.vale: posts big blind 1600
*** HOLE CARDS ***
Dealt to jcarlos.vale [Kc 4s]
adabrakadabra: folds 
Uncalled bet (800) returned to jcarlos.vale
jcarlos.vale collected 1750 from pot
jcarlos.vale: doesn't show handDTO
*** SUMMARY ***
Total pot 1750 | Rake 0 
Seat 6: adabrakadabra (button) (small blind) folded before Flop
Seat 7: jcarlos.vale (big blind) collected (1750)



PokerStars Hand #221593996009: Tournament #3079328305, $0.91+$0.09 USD Hold'em No Limit - Level XIV (800/1600) - 2020/12/19 3:37:27 EET [2020/12/18 20:37:27 ET]
Table '3079328305 4' 9-max Seat #7 is the button
Seat 6: adabrakadabra (22650 in chips) 
Seat 7: jcarlos.vale (44850 in chips) 
adabrakadabra: posts the ante 75
jcarlos.vale: posts the ante 75
jcarlos.vale: posts small blind 800
adabrakadabra: posts big blind 1600
*** HOLE CARDS ***
Dealt to jcarlos.vale [Qh 3h]
jcarlos.vale: folds 
Uncalled bet (800) returned to adabrakadabra
adabrakadabra collected 1750 from pot
*** SUMMARY ***
Total pot 1750 | Rake 0 
Seat 6: adabrakadabra (big blind) collected (1750)
Seat 7: jcarlos.vale (button) (small blind) folded before Flop



PokerStars Hand #221594000216: Tournament #3079328305, $0.91+$0.09 USD Hold'em No Limit - Level XIV (800/1600) - 2020/12/19 3:37:38 EET [2020/12/18 20:37:38 ET]
Table '3079328305 4' 9-max Seat #6 is the button
Seat 6: adabrakadabra (23525 in chips) 
Seat 7: jcarlos.vale (43975 in chips) 
adabrakadabra: posts the ante 75
jcarlos.vale: posts the ante 75
adabrakadabra: posts small blind 800
jcarlos.vale: posts big blind 1600
*** HOLE CARDS ***
Dealt to jcarlos.vale [Ac 6d]
adabrakadabra: raises 4000 to 5600
jcarlos.vale: folds 
Uncalled bet (4000) returned to adabrakadabra
adabrakadabra collected 3350 from pot
*** SUMMARY ***
Total pot 3350 | Rake 0 
Seat 6: adabrakadabra (button) (small blind) collected (3350)
Seat 7: jcarlos.vale (big blind) folded before Flop



PokerStars Hand #221594007721: Tournament #3079328305, $0.91+$0.09 USD Hold'em No Limit - Level XIV (800/1600) - 2020/12/19 3:37:56 EET [2020/12/18 20:37:56 ET]
Table '3079328305 4' 9-max Seat #7 is the button
Seat 6: adabrakadabra (25200 in chips) 
Seat 7: jcarlos.vale (42300 in chips) 
adabrakadabra: posts the ante 75
jcarlos.vale: posts the ante 75
jcarlos.vale: posts small blind 800
adabrakadabra: posts big blind 1600
*** HOLE CARDS ***
Dealt to jcarlos.vale [8c Th]
jcarlos.vale: calls 800
adabrakadabra: checks 
*** FLOP *** [8d Qd Ts]
adabrakadabra: checks 
jcarlos.vale: bets 2513
adabrakadabra: calls 2513
*** TURN *** [8d Qd Ts] [Qs]
adabrakadabra: checks 
jcarlos.vale: bets 4188
adabrakadabra: calls 4188
*** RIVER *** [8d Qd Ts Qs] [4s]
adabrakadabra: checks 
jcarlos.vale: checks 
*** SHOW DOWN ***
adabrakadabra: shows [6s Td] (two pair, Queens and Tens)
jcarlos.vale: shows [8c Th] (two pair, Queens and Tens)
adabrakadabra collected 8376 from pot
jcarlos.vale collected 8376 from pot
*** SUMMARY ***
Total pot 16752 | Rake 0 
Board [8d Qd Ts Qs 4s]
Seat 6: adabrakadabra (big blind) showed [6s Td] and won (8376) with two pair, Queens and Tens
Seat 7: jcarlos.vale (button) (small blind) showed [8c Th] and won (8376) with two pair, Queens and Tens



PokerStars Hand #221594020229: Tournament #3079328305, $0.91+$0.09 USD Hold'em No Limit - Level XIV (800/1600) - 2020/12/19 3:38:27 EET [2020/12/18 20:38:27 ET]
Table '3079328305 4' 9-max Seat #6 is the button
Seat 6: adabrakadabra (25200 in chips) 
Seat 7: jcarlos.vale (42300 in chips) 
adabrakadabra: posts the ante 75
jcarlos.vale: posts the ante 75
adabrakadabra: posts small blind 800
jcarlos.vale: posts big blind 1600
*** HOLE CARDS ***
Dealt to jcarlos.vale [6c 5d]
adabrakadabra: folds 
Uncalled bet (800) returned to jcarlos.vale
jcarlos.vale collected 1750 from pot
jcarlos.vale: doesn't show handDTO
*** SUMMARY ***
Total pot 1750 | Rake 0 
Seat 6: adabrakadabra (button) (small blind) folded before Flop
Seat 7: jcarlos.vale (big blind) collected (1750)



PokerStars Hand #221594024291: Tournament #3079328305, $0.91+$0.09 USD Hold'em No Limit - Level XIV (800/1600) - 2020/12/19 3:38:37 EET [2020/12/18 20:38:37 ET]
Table '3079328305 4' 9-max Seat #7 is the button
Seat 6: adabrakadabra (24325 in chips) 
Seat 7: jcarlos.vale (43175 in chips) 
adabrakadabra: posts the ante 75
jcarlos.vale: posts the ante 75
jcarlos.vale: posts small blind 800
adabrakadabra: posts big blind 1600
*** HOLE CARDS ***
Dealt to jcarlos.vale [8d 9h]
jcarlos.vale: raises 2560 to 4160
adabrakadabra: folds 
Uncalled bet (2560) returned to jcarlos.vale
jcarlos.vale collected 3350 from pot
jcarlos.vale: doesn't show handDTO
*** SUMMARY ***
Total pot 3350 | Rake 0 
Seat 6: adabrakadabra (big blind) folded before Flop
Seat 7: jcarlos.vale (button) (small blind) collected (3350)



PokerStars Hand #221594034035: Tournament #3079328305, $0.91+$0.09 USD Hold'em No Limit - Level XIV (800/1600) - 2020/12/19 3:38:52 EET [2020/12/18 20:38:52 ET]
Table '3079328305 4' 9-max Seat #6 is the button
Seat 6: adabrakadabra (22650 in chips) 
Seat 7: jcarlos.vale (44850 in chips) 
adabrakadabra: posts the ante 75
jcarlos.vale: posts the ante 75
adabrakadabra: posts small blind 800
jcarlos.vale: posts big blind 1600
*** HOLE CARDS ***
Dealt to jcarlos.vale [Ts 6s]
adabrakadabra: calls 800
jcarlos.vale: checks 
*** FLOP *** [Qd 9c 9s]
jcarlos.vale: checks 
adabrakadabra: checks 
*** TURN *** [Qd 9c 9s] [Th]
jcarlos.vale: checks 
adabrakadabra: checks 
*** RIVER *** [Qd 9c 9s Th] [Td]
jcarlos.vale: bets 1675
adabrakadabra: calls 1675
*** SHOW DOWN ***
jcarlos.vale: shows [Ts 6s] (a full house, Tens full of Nines)
adabrakadabra: mucks handDTO
jcarlos.vale collected 6700 from pot
*** SUMMARY ***
Total pot 6700 | Rake 0 
Board [Qd 9c 9s Th Td]
Seat 6: adabrakadabra (button) (small blind) mucked [Ac 5s]
Seat 7: jcarlos.vale (big blind) showed [Ts 6s] and won (6700) with a full house, Tens full of Nines



PokerStars Hand #221594044913: Tournament #3079328305, $0.91+$0.09 USD Hold'em No Limit - Level XIV (800/1600) - 2020/12/19 3:39:19 EET [2020/12/18 20:39:19 ET]
Table '3079328305 4' 9-max Seat #7 is the button
Seat 6: adabrakadabra (19300 in chips) 
Seat 7: jcarlos.vale (48200 in chips) 
adabrakadabra: posts the ante 75
jcarlos.vale: posts the ante 75
jcarlos.vale: posts small blind 800
adabrakadabra: posts big blind 1600
*** HOLE CARDS ***
Dealt to jcarlos.vale [5h 7s]
jcarlos.vale: folds 
Uncalled bet (800) returned to adabrakadabra
adabrakadabra collected 1750 from pot
*** SUMMARY ***
Total pot 1750 | Rake 0 
Seat 6: adabrakadabra (big blind) collected (1750)
Seat 7: jcarlos.vale (button) (small blind) folded before Flop



PokerStars Hand #221594049197: Tournament #3079328305, $0.91+$0.09 USD Hold'em No Limit - Level XIV (800/1600) - 2020/12/19 3:39:30 EET [2020/12/18 20:39:30 ET]
Table '3079328305 4' 9-max Seat #6 is the button
Seat 6: adabrakadabra (20175 in chips) 
Seat 7: jcarlos.vale (47325 in chips) 
adabrakadabra: posts the ante 75
jcarlos.vale: posts the ante 75
adabrakadabra: posts small blind 800
jcarlos.vale: posts big blind 1600
*** HOLE CARDS ***
Dealt to jcarlos.vale [Ks 3c]
adabrakadabra: folds 
Uncalled bet (800) returned to jcarlos.vale
jcarlos.vale collected 1750 from pot
jcarlos.vale: doesn't show handDTO
*** SUMMARY ***
Total pot 1750 | Rake 0 
Seat 6: adabrakadabra (button) (small blind) folded before Flop
Seat 7: jcarlos.vale (big blind) collected (1750)



PokerStars Hand #221594053359: Tournament #3079328305, $0.91+$0.09 USD Hold'em No Limit - Level XIV (800/1600) - 2020/12/19 3:39:40 EET [2020/12/18 20:39:40 ET]
Table '3079328305 4' 9-max Seat #7 is the button
Seat 6: adabrakadabra (19300 in chips) 
Seat 7: jcarlos.vale (48200 in chips) 
adabrakadabra: posts the ante 75
jcarlos.vale: posts the ante 75
jcarlos.vale: posts small blind 800
adabrakadabra: posts big blind 1600
*** HOLE CARDS ***
Dealt to jcarlos.vale [4h 8c]
jcarlos.vale: folds 
Uncalled bet (800) returned to adabrakadabra
adabrakadabra collected 1750 from pot
*** SUMMARY ***
Total pot 1750 | Rake 0 
Seat 6: adabrakadabra (big blind) collected (1750)
Seat 7: jcarlos.vale (button) (small blind) folded before Flop



PokerStars Hand #221594057764: Tournament #3079328305, $0.91+$0.09 USD Hold'em No Limit - Level XIV (800/1600) - 2020/12/19 3:39:51 EET [2020/12/18 20:39:51 ET]
Table '3079328305 4' 9-max Seat #6 is the button
Seat 6: adabrakadabra (20175 in chips) 
Seat 7: jcarlos.vale (47325 in chips) 
adabrakadabra: posts the ante 75
jcarlos.vale: posts the ante 75
adabrakadabra: posts small blind 800
jcarlos.vale: posts big blind 1600
*** HOLE CARDS ***
Dealt to jcarlos.vale [4h Ah]
adabrakadabra: calls 800
jcarlos.vale: checks 
*** FLOP *** [6c 7s Js]
jcarlos.vale: checks 
adabrakadabra: checks 
*** TURN *** [6c 7s Js] [2h]
jcarlos.vale: checks 
adabrakadabra: checks 
*** RIVER *** [6c 7s Js 2h] [7h]
jcarlos.vale: checks 
adabrakadabra: checks 
*** SHOW DOWN ***
jcarlos.vale: shows [4h Ah] (a pair of Sevens)
adabrakadabra: mucks handDTO
jcarlos.vale collected 3350 from pot
*** SUMMARY ***
Total pot 3350 | Rake 0 
Board [6c 7s Js 2h 7h]
Seat 6: adabrakadabra (button) (small blind) mucked [Qh 8h]
Seat 7: jcarlos.vale (big blind) showed [4h Ah] and won (3350) with a pair of Sevens



PokerStars Hand #221594067980: Tournament #3079328305, $0.91+$0.09 USD Hold'em No Limit - Level XIV (800/1600) - 2020/12/19 3:40:16 EET [2020/12/18 20:40:16 ET]
Table '3079328305 4' 9-max Seat #7 is the button
Seat 6: adabrakadabra (18500 in chips) 
Seat 7: jcarlos.vale (49000 in chips) 
adabrakadabra: posts the ante 75
jcarlos.vale: posts the ante 75
jcarlos.vale: posts small blind 800
adabrakadabra: posts big blind 1600
*** HOLE CARDS ***
Dealt to jcarlos.vale [9s 2h]
jcarlos.vale: folds 
Uncalled bet (800) returned to adabrakadabra
adabrakadabra collected 1750 from pot
*** SUMMARY ***
Total pot 1750 | Rake 0 
Seat 6: adabrakadabra (big blind) collected (1750)
Seat 7: jcarlos.vale (button) (small blind) folded before Flop



PokerStars Hand #221594072351: Tournament #3079328305, $0.91+$0.09 USD Hold'em No Limit - Level XIV (800/1600) - 2020/12/19 3:40:27 EET [2020/12/18 20:40:27 ET]
Table '3079328305 4' 9-max Seat #6 is the button
Seat 6: adabrakadabra (19375 in chips) 
Seat 7: jcarlos.vale (48125 in chips) 
adabrakadabra: posts the ante 75
jcarlos.vale: posts the ante 75
adabrakadabra: posts small blind 800
jcarlos.vale: posts big blind 1600
*** HOLE CARDS ***
Dealt to jcarlos.vale [4d 7s]
adabrakadabra: raises 2400 to 4000
jcarlos.vale: folds 
Uncalled bet (2400) returned to adabrakadabra
adabrakadabra collected 3350 from pot
*** SUMMARY ***
Total pot 3350 | Rake 0 
Seat 6: adabrakadabra (button) (small blind) collected (3350)
Seat 7: jcarlos.vale (big blind) folded before Flop



PokerStars Hand #221594077700: Tournament #3079328305, $0.91+$0.09 USD Hold'em No Limit - Level XIV (800/1600) - 2020/12/19 3:40:40 EET [2020/12/18 20:40:40 ET]
Table '3079328305 4' 9-max Seat #7 is the button
Seat 6: adabrakadabra (21050 in chips) 
Seat 7: jcarlos.vale (46450 in chips) 
adabrakadabra: posts the ante 75
jcarlos.vale: posts the ante 75
jcarlos.vale: posts small blind 800
adabrakadabra: posts big blind 1600
*** HOLE CARDS ***
Dealt to jcarlos.vale [9c Jd]
jcarlos.vale: raises 2560 to 4160
adabrakadabra: folds 
Uncalled bet (2560) returned to jcarlos.vale
jcarlos.vale collected 3350 from pot
jcarlos.vale: doesn't show handDTO
*** SUMMARY ***
Total pot 3350 | Rake 0 
Seat 6: adabrakadabra (big blind) folded before Flop
Seat 7: jcarlos.vale (button) (small blind) collected (3350)



PokerStars Hand #221594082796: Tournament #3079328305, $0.91+$0.09 USD Hold'em No Limit - Level XIV (800/1600) - 2020/12/19 3:40:53 EET [2020/12/18 20:40:53 ET]
Table '3079328305 4' 9-max Seat #6 is the button
Seat 6: adabrakadabra (19375 in chips) 
Seat 7: jcarlos.vale (48125 in chips) 
adabrakadabra: posts the ante 75
jcarlos.vale: posts the ante 75
adabrakadabra: posts small blind 800
jcarlos.vale: posts big blind 1600
*** HOLE CARDS ***
Dealt to jcarlos.vale [Jc 5h]
adabrakadabra: calls 800
jcarlos.vale: checks 
*** FLOP *** [Kh 7s 3s]
jcarlos.vale: checks 
adabrakadabra: checks 
*** TURN *** [Kh 7s 3s] [Qs]
jcarlos.vale: checks 
adabrakadabra: bets 2513
jcarlos.vale: folds 
Uncalled bet (2513) returned to adabrakadabra
adabrakadabra collected 3350 from pot
*** SUMMARY ***
Total pot 3350 | Rake 0 
Board [Kh 7s 3s Qs]
Seat 6: adabrakadabra (button) (small blind) collected (3350)
Seat 7: jcarlos.vale (big blind) folded on the Turn



PokerStars Hand #221594095402: Tournament #3079328305, $0.91+$0.09 USD Hold'em No Limit - Level XIV (800/1600) - 2020/12/19 3:41:24 EET [2020/12/18 20:41:24 ET]
Table '3079328305 4' 9-max Seat #7 is the button
Seat 6: adabrakadabra (21050 in chips) 
Seat 7: jcarlos.vale (46450 in chips) 
adabrakadabra: posts the ante 75
jcarlos.vale: posts the ante 75
jcarlos.vale: posts small blind 800
adabrakadabra: posts big blind 1600
*** HOLE CARDS ***
Dealt to jcarlos.vale [6s 8c]
jcarlos.vale: folds 
Uncalled bet (800) returned to adabrakadabra
adabrakadabra collected 1750 from pot
*** SUMMARY ***
Total pot 1750 | Rake 0 
Seat 6: adabrakadabra (big blind) collected (1750)
Seat 7: jcarlos.vale (button) (small blind) folded before Flop



PokerStars Hand #221594099771: Tournament #3079328305, $0.91+$0.09 USD Hold'em No Limit - Level XIV (800/1600) - 2020/12/19 3:41:35 EET [2020/12/18 20:41:35 ET]
Table '3079328305 4' 9-max Seat #6 is the button
Seat 6: adabrakadabra (21925 in chips) 
Seat 7: jcarlos.vale (45575 in chips) 
adabrakadabra: posts the ante 75
jcarlos.vale: posts the ante 75
adabrakadabra: posts small blind 800
jcarlos.vale: posts big blind 1600
*** HOLE CARDS ***
Dealt to jcarlos.vale [Ks 2d]
adabrakadabra: folds 
Uncalled bet (800) returned to jcarlos.vale
jcarlos.vale collected 1750 from pot
jcarlos.vale: doesn't show handDTO
*** SUMMARY ***
Total pot 1750 | Rake 0 
Seat 6: adabrakadabra (button) (small blind) folded before Flop
Seat 7: jcarlos.vale (big blind) collected (1750)



PokerStars Hand #221594104331: Tournament #3079328305, $0.91+$0.09 USD Hold'em No Limit - Level XIV (800/1600) - 2020/12/19 3:41:46 EET [2020/12/18 20:41:46 ET]
Table '3079328305 4' 9-max Seat #7 is the button
Seat 6: adabrakadabra (21050 in chips) 
Seat 7: jcarlos.vale (46450 in chips) 
adabrakadabra: posts the ante 75
jcarlos.vale: posts the ante 75
jcarlos.vale: posts small blind 800
adabrakadabra: posts big blind 1600
*** HOLE CARDS ***
Dealt to jcarlos.vale [2c As]
jcarlos.vale: raises 2560 to 4160
adabrakadabra: folds 
Uncalled bet (2560) returned to jcarlos.vale
jcarlos.vale collected 3350 from pot
jcarlos.vale: doesn't show handDTO
*** SUMMARY ***
Total pot 3350 | Rake 0 
Seat 6: adabrakadabra (big blind) folded before Flop
Seat 7: jcarlos.vale (button) (small blind) collected (3350)



PokerStars Hand #221594109878: Tournament #3079328305, $0.91+$0.09 USD Hold'em No Limit - Level XIV (800/1600) - 2020/12/19 3:42:00 EET [2020/12/18 20:42:00 ET]
Table '3079328305 4' 9-max Seat #6 is the button
Seat 6: adabrakadabra (19375 in chips) 
Seat 7: jcarlos.vale (48125 in chips) 
adabrakadabra: posts the ante 75
jcarlos.vale: posts the ante 75
adabrakadabra: posts small blind 800
jcarlos.vale: posts big blind 1600
*** HOLE CARDS ***
Dealt to jcarlos.vale [6s Td]
adabrakadabra: folds 
Uncalled bet (800) returned to jcarlos.vale
jcarlos.vale collected 1750 from pot
jcarlos.vale: doesn't show handDTO
*** SUMMARY ***
Total pot 1750 | Rake 0 
Seat 6: adabrakadabra (button) (small blind) folded before Flop
Seat 7: jcarlos.vale (big blind) collected (1750)



PokerStars Hand #221594114451: Tournament #3079328305, $0.91+$0.09 USD Hold'em No Limit - Level XIV (800/1600) - 2020/12/19 3:42:12 EET [2020/12/18 20:42:12 ET]
Table '3079328305 4' 9-max Seat #7 is the button
Seat 6: adabrakadabra (18500 in chips) 
Seat 7: jcarlos.vale (49000 in chips) 
adabrakadabra: posts the ante 75
jcarlos.vale: posts the ante 75
jcarlos.vale: posts small blind 800
adabrakadabra: posts big blind 1600
*** HOLE CARDS ***
Dealt to jcarlos.vale [3d 8h]
jcarlos.vale: folds 
Uncalled bet (800) returned to adabrakadabra
adabrakadabra collected 1750 from pot
*** SUMMARY ***
Total pot 1750 | Rake 0 
Seat 6: adabrakadabra (big blind) collected (1750)
Seat 7: jcarlos.vale (button) (small blind) folded before Flop



PokerStars Hand #221594118751: Tournament #3079328305, $0.91+$0.09 USD Hold'em No Limit - Level XIV (800/1600) - 2020/12/19 3:42:22 EET [2020/12/18 20:42:22 ET]
Table '3079328305 4' 9-max Seat #6 is the button
Seat 6: adabrakadabra (19375 in chips) 
Seat 7: jcarlos.vale (48125 in chips) 
adabrakadabra: posts the ante 75
jcarlos.vale: posts the ante 75
adabrakadabra: posts small blind 800
jcarlos.vale: posts big blind 1600
*** HOLE CARDS ***
Dealt to jcarlos.vale [Ac 8d]
adabrakadabra: folds 
Uncalled bet (800) returned to jcarlos.vale
jcarlos.vale collected 1750 from pot
jcarlos.vale: doesn't show handDTO
*** SUMMARY ***
Total pot 1750 | Rake 0 
Seat 6: adabrakadabra (button) (small blind) folded before Flop
Seat 7: jcarlos.vale (big blind) collected (1750)



PokerStars Hand #221594123374: Tournament #3079328305, $0.91+$0.09 USD Hold'em No Limit - Level XIV (800/1600) - 2020/12/19 3:42:34 EET [2020/12/18 20:42:34 ET]
Table '3079328305 4' 9-max Seat #7 is the button
Seat 6: adabrakadabra (18500 in chips) 
Seat 7: jcarlos.vale (49000 in chips) 
adabrakadabra: posts the ante 75
jcarlos.vale: posts the ante 75
jcarlos.vale: posts small blind 800
adabrakadabra: posts big blind 1600
*** HOLE CARDS ***
Dealt to jcarlos.vale [Jd Td]
jcarlos.vale: raises 2560 to 4160
adabrakadabra: folds 
Uncalled bet (2560) returned to jcarlos.vale
jcarlos.vale collected 3350 from pot
jcarlos.vale: doesn't show handDTO
*** SUMMARY ***
Total pot 3350 | Rake 0 
Seat 6: adabrakadabra (big blind) folded before Flop
Seat 7: jcarlos.vale (button) (small blind) collected (3350)



PokerStars Hand #221594128852: Tournament #3079328305, $0.91+$0.09 USD Hold'em No Limit - Level XIV (800/1600) - 2020/12/19 3:42:47 EET [2020/12/18 20:42:47 ET]
Table '3079328305 4' 9-max Seat #6 is the button
Seat 6: adabrakadabra (16825 in chips) 
Seat 7: jcarlos.vale (50675 in chips) 
adabrakadabra: posts the ante 75
jcarlos.vale: posts the ante 75
adabrakadabra: posts small blind 800
jcarlos.vale: posts big blind 1600
*** HOLE CARDS ***
Dealt to jcarlos.vale [2c 3c]
adabrakadabra: raises 2400 to 4000
jcarlos.vale: calls 2400
*** FLOP *** [9c 5c 6c]
jcarlos.vale: bets 46600 and is all-in
adabrakadabra: folds 
Uncalled bet (46600) returned to jcarlos.vale
jcarlos.vale collected 8150 from pot
jcarlos.vale: doesn't show handDTO
*** SUMMARY ***
Total pot 8150 | Rake 0 
Board [9c 5c 6c]
Seat 6: adabrakadabra (button) (small blind) folded on the Flop
Seat 7: jcarlos.vale (big blind) collected (8150)



PokerStars Hand #221594137586: Tournament #3079328305, $0.91+$0.09 USD Hold'em No Limit - Level XV (1000/2000) - 2020/12/19 3:43:09 EET [2020/12/18 20:43:09 ET]
Table '3079328305 4' 9-max Seat #7 is the button
Seat 6: adabrakadabra (12750 in chips) 
Seat 7: jcarlos.vale (54750 in chips) 
adabrakadabra: posts the ante 100
jcarlos.vale: posts the ante 100
jcarlos.vale: posts small blind 1000
adabrakadabra: posts big blind 2000
*** HOLE CARDS ***
Dealt to jcarlos.vale [6d Qd]
jcarlos.vale: folds 
Uncalled bet (1000) returned to adabrakadabra
adabrakadabra collected 2200 from pot
*** SUMMARY ***
Total pot 2200 | Rake 0 
Seat 6: adabrakadabra (big blind) collected (2200)
Seat 7: jcarlos.vale (button) (small blind) folded before Flop



PokerStars Hand #221594141950: Tournament #3079328305, $0.91+$0.09 USD Hold'em No Limit - Level XV (1000/2000) - 2020/12/19 3:43:20 EET [2020/12/18 20:43:20 ET]
Table '3079328305 4' 9-max Seat #6 is the button
Seat 6: adabrakadabra (13850 in chips) 
Seat 7: jcarlos.vale (53650 in chips) 
adabrakadabra: posts the ante 100
jcarlos.vale: posts the ante 100
adabrakadabra: posts small blind 1000
jcarlos.vale: posts big blind 2000
*** HOLE CARDS ***
Dealt to jcarlos.vale [Ts Js]
adabrakadabra: raises 11750 to 13750 and is all-in
jcarlos.vale: folds 
Uncalled bet (11750) returned to adabrakadabra
adabrakadabra collected 4200 from pot
*** SUMMARY ***
Total pot 4200 | Rake 0 
Seat 6: adabrakadabra (button) (small blind) collected (4200)
Seat 7: jcarlos.vale (big blind) folded before Flop



PokerStars Hand #221594149034: Tournament #3079328305, $0.91+$0.09 USD Hold'em No Limit - Level XV (1000/2000) - 2020/12/19 3:43:38 EET [2020/12/18 20:43:38 ET]
Table '3079328305 4' 9-max Seat #7 is the button
Seat 6: adabrakadabra (15950 in chips) 
Seat 7: jcarlos.vale (51550 in chips) 
adabrakadabra: posts the ante 100
jcarlos.vale: posts the ante 100
jcarlos.vale: posts small blind 1000
adabrakadabra: posts big blind 2000
*** HOLE CARDS ***
Dealt to jcarlos.vale [5d Jc]
jcarlos.vale: folds 
Uncalled bet (1000) returned to adabrakadabra
adabrakadabra collected 2200 from pot
*** SUMMARY ***
Total pot 2200 | Rake 0 
Seat 6: adabrakadabra (big blind) collected (2200)
Seat 7: jcarlos.vale (button) (small blind) folded before Flop



PokerStars Hand #221594153183: Tournament #3079328305, $0.91+$0.09 USD Hold'em No Limit - Level XV (1000/2000) - 2020/12/19 3:43:48 EET [2020/12/18 20:43:48 ET]
Table '3079328305 4' 9-max Seat #6 is the button
Seat 6: adabrakadabra (17050 in chips) 
Seat 7: jcarlos.vale (50450 in chips) 
adabrakadabra: posts the ante 100
jcarlos.vale: posts the ante 100
adabrakadabra: posts small blind 1000
jcarlos.vale: posts big blind 2000
*** HOLE CARDS ***
Dealt to jcarlos.vale [Tc 3c]
adabrakadabra: raises 14950 to 16950 and is all-in
jcarlos.vale: folds 
Uncalled bet (14950) returned to adabrakadabra
adabrakadabra collected 4200 from pot
*** SUMMARY ***
Total pot 4200 | Rake 0 
Seat 6: adabrakadabra (button) (small blind) collected (4200)
Seat 7: jcarlos.vale (big blind) folded before Flop



PokerStars Hand #221594159133: Tournament #3079328305, $0.91+$0.09 USD Hold'em No Limit - Level XV (1000/2000) - 2020/12/19 3:44:03 EET [2020/12/18 20:44:03 ET]
Table '3079328305 4' 9-max Seat #7 is the button
Seat 6: adabrakadabra (19150 in chips) 
Seat 7: jcarlos.vale (48350 in chips) 
adabrakadabra: posts the ante 100
jcarlos.vale: posts the ante 100
jcarlos.vale: posts small blind 1000
adabrakadabra: posts big blind 2000
*** HOLE CARDS ***
Dealt to jcarlos.vale [7s 6d]
jcarlos.vale: folds 
Uncalled bet (1000) returned to adabrakadabra
adabrakadabra collected 2200 from pot
*** SUMMARY ***
Total pot 2200 | Rake 0 
Seat 6: adabrakadabra (big blind) collected (2200)
Seat 7: jcarlos.vale (button) (small blind) folded before Flop



PokerStars Hand #221594163685: Tournament #3079328305, $0.91+$0.09 USD Hold'em No Limit - Level XV (1000/2000) - 2020/12/19 3:44:14 EET [2020/12/18 20:44:14 ET]
Table '3079328305 4' 9-max Seat #6 is the button
Seat 6: adabrakadabra (20250 in chips) 
Seat 7: jcarlos.vale (47250 in chips) 
adabrakadabra: posts the ante 100
jcarlos.vale: posts the ante 100
adabrakadabra: posts small blind 1000
jcarlos.vale: posts big blind 2000
*** HOLE CARDS ***
Dealt to jcarlos.vale [Ah 8h]
adabrakadabra: folds 
Uncalled bet (1000) returned to jcarlos.vale
jcarlos.vale collected 2200 from pot
jcarlos.vale: doesn't show handDTO
*** SUMMARY ***
Total pot 2200 | Rake 0 
Seat 6: adabrakadabra (button) (small blind) folded before Flop
Seat 7: jcarlos.vale (big blind) collected (2200)



PokerStars Hand #221594169179: Tournament #3079328305, $0.91+$0.09 USD Hold'em No Limit - Level XV (1000/2000) - 2020/12/19 3:44:28 EET [2020/12/18 20:44:28 ET]
Table '3079328305 4' 9-max Seat #7 is the button
Seat 6: adabrakadabra (19150 in chips) 
Seat 7: jcarlos.vale (48350 in chips) 
adabrakadabra: posts the ante 100
jcarlos.vale: posts the ante 100
jcarlos.vale: posts small blind 1000
adabrakadabra: posts big blind 2000
*** HOLE CARDS ***
Dealt to jcarlos.vale [8s 2d]
jcarlos.vale: folds 
Uncalled bet (1000) returned to adabrakadabra
adabrakadabra collected 2200 from pot
*** SUMMARY ***
Total pot 2200 | Rake 0 
Seat 6: adabrakadabra (big blind) collected (2200)
Seat 7: jcarlos.vale (button) (small blind) folded before Flop



PokerStars Hand #221594173298: Tournament #3079328305, $0.91+$0.09 USD Hold'em No Limit - Level XV (1000/2000) - 2020/12/19 3:44:38 EET [2020/12/18 20:44:38 ET]
Table '3079328305 4' 9-max Seat #6 is the button
Seat 6: adabrakadabra (20250 in chips) 
Seat 7: jcarlos.vale (47250 in chips) 
adabrakadabra: posts the ante 100
jcarlos.vale: posts the ante 100
adabrakadabra: posts small blind 1000
jcarlos.vale: posts big blind 2000
*** HOLE CARDS ***
Dealt to jcarlos.vale [3d 5c]
adabrakadabra: folds 
Uncalled bet (1000) returned to jcarlos.vale
jcarlos.vale collected 2200 from pot
jcarlos.vale: doesn't show handDTO
*** SUMMARY ***
Total pot 2200 | Rake 0 
Seat 6: adabrakadabra (button) (small blind) folded before Flop
Seat 7: jcarlos.vale (big blind) collected (2200)



PokerStars Hand #221594177130: Tournament #3079328305, $0.91+$0.09 USD Hold'em No Limit - Level XV (1000/2000) - 2020/12/19 3:44:48 EET [2020/12/18 20:44:48 ET]
Table '3079328305 4' 9-max Seat #7 is the button
Seat 6: adabrakadabra (19150 in chips) 
Seat 7: jcarlos.vale (48350 in chips) 
adabrakadabra: posts the ante 100
jcarlos.vale: posts the ante 100
jcarlos.vale: posts small blind 1000
adabrakadabra: posts big blind 2000
*** HOLE CARDS ***
Dealt to jcarlos.vale [Th 9h]
jcarlos.vale: raises 3200 to 5200
adabrakadabra: folds 
Uncalled bet (3200) returned to jcarlos.vale
jcarlos.vale collected 4200 from pot
jcarlos.vale: doesn't show handDTO
*** SUMMARY ***
Total pot 4200 | Rake 0 
Seat 6: adabrakadabra (big blind) folded before Flop
Seat 7: jcarlos.vale (button) (small blind) collected (4200)



PokerStars Hand #221594185064: Tournament #3079328305, $0.91+$0.09 USD Hold'em No Limit - Level XV (1000/2000) - 2020/12/19 3:45:02 EET [2020/12/18 20:45:02 ET]
Table '3079328305 4' 9-max Seat #6 is the button
Seat 6: adabrakadabra (17050 in chips) 
Seat 7: jcarlos.vale (50450 in chips) 
adabrakadabra: posts the ante 100
jcarlos.vale: posts the ante 100
adabrakadabra: posts small blind 1000
jcarlos.vale: posts big blind 2000
*** HOLE CARDS ***
Dealt to jcarlos.vale [8h Th]
adabrakadabra: raises 14950 to 16950 and is all-in
jcarlos.vale: folds 
Uncalled bet (14950) returned to adabrakadabra
adabrakadabra collected 4200 from pot
*** SUMMARY ***
Total pot 4200 | Rake 0 
Seat 6: adabrakadabra (button) (small blind) collected (4200)
Seat 7: jcarlos.vale (big blind) folded before Flop



PokerStars Hand #221594191532: Tournament #3079328305, $0.91+$0.09 USD Hold'em No Limit - Level XV (1000/2000) - 2020/12/19 3:45:18 EET [2020/12/18 20:45:18 ET]
Table '3079328305 4' 9-max Seat #7 is the button
Seat 6: adabrakadabra (19150 in chips) 
Seat 7: jcarlos.vale (48350 in chips) 
adabrakadabra: posts the ante 100
jcarlos.vale: posts the ante 100
jcarlos.vale: posts small blind 1000
adabrakadabra: posts big blind 2000
*** HOLE CARDS ***
Dealt to jcarlos.vale [3h Kh]
jcarlos.vale: folds 
Uncalled bet (1000) returned to adabrakadabra
adabrakadabra collected 2200 from pot
*** SUMMARY ***
Total pot 2200 | Rake 0 
Seat 6: adabrakadabra (big blind) collected (2200)
Seat 7: jcarlos.vale (button) (small blind) folded before Flop



PokerStars Hand #221594195829: Tournament #3079328305, $0.91+$0.09 USD Hold'em No Limit - Level XV (1000/2000) - 2020/12/19 3:45:29 EET [2020/12/18 20:45:29 ET]
Table '3079328305 4' 9-max Seat #6 is the button
Seat 6: adabrakadabra (20250 in chips) 
Seat 7: jcarlos.vale (47250 in chips) 
adabrakadabra: posts the ante 100
jcarlos.vale: posts the ante 100
adabrakadabra: posts small blind 1000
jcarlos.vale: posts big blind 2000
*** HOLE CARDS ***
Dealt to jcarlos.vale [8h Kd]
adabrakadabra: raises 4000 to 6000
jcarlos.vale: folds 
Uncalled bet (4000) returned to adabrakadabra
adabrakadabra collected 4200 from pot
*** SUMMARY ***
Total pot 4200 | Rake 0 
Seat 6: adabrakadabra (button) (small blind) collected (4200)
Seat 7: jcarlos.vale (big blind) folded before Flop



PokerStars Hand #221594204135: Tournament #3079328305, $0.91+$0.09 USD Hold'em No Limit - Level XV (1000/2000) - 2020/12/19 3:45:51 EET [2020/12/18 20:45:51 ET]
Table '3079328305 4' 9-max Seat #7 is the button
Seat 6: adabrakadabra (22350 in chips) 
Seat 7: jcarlos.vale (45150 in chips) 
adabrakadabra: posts the ante 100
jcarlos.vale: posts the ante 100
jcarlos.vale: posts small blind 1000
adabrakadabra: posts big blind 2000
*** HOLE CARDS ***
Dealt to jcarlos.vale [3s 4d]
jcarlos.vale: folds 
Uncalled bet (1000) returned to adabrakadabra
adabrakadabra collected 2200 from pot
*** SUMMARY ***
Total pot 2200 | Rake 0 
Seat 6: adabrakadabra (big blind) collected (2200)
Seat 7: jcarlos.vale (button) (small blind) folded before Flop



PokerStars Hand #221594208490: Tournament #3079328305, $0.91+$0.09 USD Hold'em No Limit - Level XV (1000/2000) - 2020/12/19 3:46:01 EET [2020/12/18 20:46:01 ET]
Table '3079328305 4' 9-max Seat #6 is the button
Seat 6: adabrakadabra (23450 in chips) 
Seat 7: jcarlos.vale (44050 in chips) 
adabrakadabra: posts the ante 100
jcarlos.vale: posts the ante 100
adabrakadabra: posts small blind 1000
jcarlos.vale: posts big blind 2000
*** HOLE CARDS ***
Dealt to jcarlos.vale [Js 9s]
adabrakadabra: folds 
Uncalled bet (1000) returned to jcarlos.vale
jcarlos.vale collected 2200 from pot
jcarlos.vale: doesn't show handDTO
*** SUMMARY ***
Total pot 2200 | Rake 0 
Seat 6: adabrakadabra (button) (small blind) folded before Flop
Seat 7: jcarlos.vale (big blind) collected (2200)



PokerStars Hand #221594212481: Tournament #3079328305, $0.91+$0.09 USD Hold'em No Limit - Level XV (1000/2000) - 2020/12/19 3:46:11 EET [2020/12/18 20:46:11 ET]
Table '3079328305 4' 9-max Seat #7 is the button
Seat 6: adabrakadabra (22350 in chips) 
Seat 7: jcarlos.vale (45150 in chips) 
adabrakadabra: posts the ante 100
jcarlos.vale: posts the ante 100
jcarlos.vale: posts small blind 1000
adabrakadabra: posts big blind 2000
*** HOLE CARDS ***
Dealt to jcarlos.vale [Js 8s]
jcarlos.vale: raises 3200 to 5200
adabrakadabra: folds 
Uncalled bet (3200) returned to jcarlos.vale
jcarlos.vale collected 4200 from pot
jcarlos.vale: doesn't show handDTO
*** SUMMARY ***
Total pot 4200 | Rake 0 
Seat 6: adabrakadabra (big blind) folded before Flop
Seat 7: jcarlos.vale (button) (small blind) collected (4200)



PokerStars Hand #221594217326: Tournament #3079328305, $0.91+$0.09 USD Hold'em No Limit - Level XV (1000/2000) - 2020/12/19 3:46:24 EET [2020/12/18 20:46:24 ET]
Table '3079328305 4' 9-max Seat #6 is the button
Seat 6: adabrakadabra (20250 in chips) 
Seat 7: jcarlos.vale (47250 in chips) 
adabrakadabra: posts the ante 100
jcarlos.vale: posts the ante 100
adabrakadabra: posts small blind 1000
jcarlos.vale: posts big blind 2000
*** HOLE CARDS ***
Dealt to jcarlos.vale [5s 2s]
adabrakadabra: raises 4000 to 6000
jcarlos.vale: folds 
Uncalled bet (4000) returned to adabrakadabra
adabrakadabra collected 4200 from pot
*** SUMMARY ***
Total pot 4200 | Rake 0 
Seat 6: adabrakadabra (button) (small blind) collected (4200)
Seat 7: jcarlos.vale (big blind) folded before Flop



PokerStars Hand #221594223443: Tournament #3079328305, $0.91+$0.09 USD Hold'em No Limit - Level XV (1000/2000) - 2020/12/19 3:46:40 EET [2020/12/18 20:46:40 ET]
Table '3079328305 4' 9-max Seat #7 is the button
Seat 6: adabrakadabra (22350 in chips) 
Seat 7: jcarlos.vale (45150 in chips) 
adabrakadabra: posts the ante 100
jcarlos.vale: posts the ante 100
jcarlos.vale: posts small blind 1000
adabrakadabra: posts big blind 2000
*** HOLE CARDS ***
Dealt to jcarlos.vale [4d As]
jcarlos.vale: raises 3200 to 5200
adabrakadabra: folds 
Uncalled bet (3200) returned to jcarlos.vale
jcarlos.vale collected 4200 from pot
jcarlos.vale: doesn't show handDTO
*** SUMMARY ***
Total pot 4200 | Rake 0 
Seat 6: adabrakadabra (big blind) folded before Flop
Seat 7: jcarlos.vale (button) (small blind) collected (4200)



PokerStars Hand #221594228261: Tournament #3079328305, $0.91+$0.09 USD Hold'em No Limit - Level XV (1000/2000) - 2020/12/19 3:46:52 EET [2020/12/18 20:46:52 ET]
Table '3079328305 4' 9-max Seat #6 is the button
Seat 6: adabrakadabra (20250 in chips) 
Seat 7: jcarlos.vale (47250 in chips) 
adabrakadabra: posts the ante 100
jcarlos.vale: posts the ante 100
adabrakadabra: posts small blind 1000
jcarlos.vale: posts big blind 2000
*** HOLE CARDS ***
Dealt to jcarlos.vale [7c 4h]
adabrakadabra: folds 
Uncalled bet (1000) returned to jcarlos.vale
jcarlos.vale collected 2200 from pot
jcarlos.vale: doesn't show handDTO
*** SUMMARY ***
Total pot 2200 | Rake 0 
Seat 6: adabrakadabra (button) (small blind) folded before Flop
Seat 7: jcarlos.vale (big blind) collected (2200)



PokerStars Hand #221594236485: Tournament #3079328305, $0.91+$0.09 USD Hold'em No Limit - Level XV (1000/2000) - 2020/12/19 3:47:13 EET [2020/12/18 20:47:13 ET]
Table '3079328305 4' 9-max Seat #7 is the button
Seat 6: adabrakadabra (19150 in chips) 
Seat 7: jcarlos.vale (48350 in chips) 
adabrakadabra: posts the ante 100
jcarlos.vale: posts the ante 100
jcarlos.vale: posts small blind 1000
adabrakadabra: posts big blind 2000
*** HOLE CARDS ***
Dealt to jcarlos.vale [Js Td]
jcarlos.vale: raises 3200 to 5200
adabrakadabra: folds 
Uncalled bet (3200) returned to jcarlos.vale
jcarlos.vale collected 4200 from pot
jcarlos.vale: doesn't show handDTO
*** SUMMARY ***
Total pot 4200 | Rake 0 
Seat 6: adabrakadabra (big blind) folded before Flop
Seat 7: jcarlos.vale (button) (small blind) collected (4200)



PokerStars Hand #221594242478: Tournament #3079328305, $0.91+$0.09 USD Hold'em No Limit - Level XV (1000/2000) - 2020/12/19 3:47:28 EET [2020/12/18 20:47:28 ET]
Table '3079328305 4' 9-max Seat #6 is the button
Seat 6: adabrakadabra (17050 in chips) 
Seat 7: jcarlos.vale (50450 in chips) 
adabrakadabra: posts the ante 100
jcarlos.vale: posts the ante 100
adabrakadabra: posts small blind 1000
jcarlos.vale: posts big blind 2000
*** HOLE CARDS ***
Dealt to jcarlos.vale [5s 8c]
adabrakadabra: folds 
Uncalled bet (1000) returned to jcarlos.vale
jcarlos.vale collected 2200 from pot
jcarlos.vale: doesn't show handDTO
*** SUMMARY ***
Total pot 2200 | Rake 0 
Seat 6: adabrakadabra (button) (small blind) folded before Flop
Seat 7: jcarlos.vale (big blind) collected (2200)



PokerStars Hand #221594247297: Tournament #3079328305, $0.91+$0.09 USD Hold'em No Limit - Level XV (1000/2000) - 2020/12/19 3:47:40 EET [2020/12/18 20:47:40 ET]
Table '3079328305 4' 9-max Seat #7 is the button
Seat 6: adabrakadabra (15950 in chips) 
Seat 7: jcarlos.vale (51550 in chips) 
adabrakadabra: posts the ante 100
jcarlos.vale: posts the ante 100
jcarlos.vale: posts small blind 1000
adabrakadabra: posts big blind 2000
*** HOLE CARDS ***
Dealt to jcarlos.vale [4d Kh]
jcarlos.vale: folds 
Uncalled bet (1000) returned to adabrakadabra
adabrakadabra collected 2200 from pot
*** SUMMARY ***
Total pot 2200 | Rake 0 
Seat 6: adabrakadabra (big blind) collected (2200)
Seat 7: jcarlos.vale (button) (small blind) folded before Flop



PokerStars Hand #221594252167: Tournament #3079328305, $0.91+$0.09 USD Hold'em No Limit - Level XV (1000/2000) - 2020/12/19 3:47:52 EET [2020/12/18 20:47:52 ET]
Table '3079328305 4' 9-max Seat #6 is the button
Seat 6: adabrakadabra (17050 in chips) 
Seat 7: jcarlos.vale (50450 in chips) 
adabrakadabra: posts the ante 100
jcarlos.vale: posts the ante 100
adabrakadabra: posts small blind 1000
jcarlos.vale: posts big blind 2000
*** HOLE CARDS ***
Dealt to jcarlos.vale [As Jc]
adabrakadabra: folds 
Uncalled bet (1000) returned to jcarlos.vale
jcarlos.vale collected 2200 from pot
jcarlos.vale: doesn't show handDTO
*** SUMMARY ***
Total pot 2200 | Rake 0 
Seat 6: adabrakadabra (button) (small blind) folded before Flop
Seat 7: jcarlos.vale (big blind) collected (2200)



PokerStars Hand #221594256144: Tournament #3079328305, $0.91+$0.09 USD Hold'em No Limit - Level XV (1000/2000) - 2020/12/19 3:48:02 EET [2020/12/18 20:48:02 ET]
Table '3079328305 4' 9-max Seat #7 is the button
Seat 6: adabrakadabra (15950 in chips) 
Seat 7: jcarlos.vale (51550 in chips) 
adabrakadabra: posts the ante 100
jcarlos.vale: posts the ante 100
jcarlos.vale: posts small blind 1000
adabrakadabra: posts big blind 2000
*** HOLE CARDS ***
Dealt to jcarlos.vale [9c Qd]
jcarlos.vale: calls 1000
adabrakadabra: checks 
*** FLOP *** [Jd 5s 5c]
adabrakadabra: checks 
jcarlos.vale: checks 
*** TURN *** [Jd 5s 5c] [6h]
adabrakadabra: checks 
jcarlos.vale: checks 
*** RIVER *** [Jd 5s 5c 6h] [Kh]
adabrakadabra: bets 3150
jcarlos.vale: folds 
Uncalled bet (3150) returned to adabrakadabra
adabrakadabra collected 4200 from pot
*** SUMMARY ***
Total pot 4200 | Rake 0 
Board [Jd 5s 5c 6h Kh]
Seat 6: adabrakadabra (big blind) collected (4200)
Seat 7: jcarlos.vale (button) (small blind) folded on the River



PokerStars Hand #221594279893: Tournament #3079328305, $0.91+$0.09 USD Hold'em No Limit - Level XV (1000/2000) - 2020/12/19 3:48:41 EET [2020/12/18 20:48:41 ET]
Table '3079328305 4' 9-max Seat #6 is the button
Seat 6: adabrakadabra (18050 in chips) 
Seat 7: jcarlos.vale (49450 in chips) 
adabrakadabra: posts the ante 100
jcarlos.vale: posts the ante 100
adabrakadabra: posts small blind 1000
jcarlos.vale: posts big blind 2000
*** HOLE CARDS ***
Dealt to jcarlos.vale [7s Td]
adabrakadabra: folds 
Uncalled bet (1000) returned to jcarlos.vale
jcarlos.vale collected 2200 from pot
jcarlos.vale: doesn't show handDTO
*** SUMMARY ***
Total pot 2200 | Rake 0 
Seat 6: adabrakadabra (button) (small blind) folded before Flop
Seat 7: jcarlos.vale (big blind) collected (2200)



PokerStars Hand #221594285056: Tournament #3079328305, $0.91+$0.09 USD Hold'em No Limit - Level XV (1000/2000) - 2020/12/19 3:48:54 EET [2020/12/18 20:48:54 ET]
Table '3079328305 4' 9-max Seat #7 is the button
Seat 6: adabrakadabra (16950 in chips) 
Seat 7: jcarlos.vale (50550 in chips) 
adabrakadabra: posts the ante 100
jcarlos.vale: posts the ante 100
jcarlos.vale: posts small blind 1000
adabrakadabra: posts big blind 2000
*** HOLE CARDS ***
Dealt to jcarlos.vale [4s 7d]
jcarlos.vale: folds 
Uncalled bet (1000) returned to adabrakadabra
adabrakadabra collected 2200 from pot
*** SUMMARY ***
Total pot 2200 | Rake 0 
Seat 6: adabrakadabra (big blind) collected (2200)
Seat 7: jcarlos.vale (button) (small blind) folded before Flop



PokerStars Hand #221594289421: Tournament #3079328305, $0.91+$0.09 USD Hold'em No Limit - Level XV (1000/2000) - 2020/12/19 3:49:05 EET [2020/12/18 20:49:05 ET]
Table '3079328305 4' 9-max Seat #6 is the button
Seat 6: adabrakadabra (18050 in chips) 
Seat 7: jcarlos.vale (49450 in chips) 
adabrakadabra: posts the ante 100
jcarlos.vale: posts the ante 100
adabrakadabra: posts small blind 1000
jcarlos.vale: posts big blind 2000
*** HOLE CARDS ***
Dealt to jcarlos.vale [6c Ac]
adabrakadabra: folds 
Uncalled bet (1000) returned to jcarlos.vale
jcarlos.vale collected 2200 from pot
jcarlos.vale: doesn't show handDTO
*** SUMMARY ***
Total pot 2200 | Rake 0 
Seat 6: adabrakadabra (button) (small blind) folded before Flop
Seat 7: jcarlos.vale (big blind) collected (2200)



PokerStars Hand #221594293625: Tournament #3079328305, $0.91+$0.09 USD Hold'em No Limit - Level XV (1000/2000) - 2020/12/19 3:49:15 EET [2020/12/18 20:49:15 ET]
Table '3079328305 4' 9-max Seat #7 is the button
Seat 6: adabrakadabra (16950 in chips) 
Seat 7: jcarlos.vale (50550 in chips) 
adabrakadabra: posts the ante 100
jcarlos.vale: posts the ante 100
jcarlos.vale: posts small blind 1000
adabrakadabra: posts big blind 2000
*** HOLE CARDS ***
Dealt to jcarlos.vale [As 4c]
jcarlos.vale: raises 3200 to 5200
adabrakadabra: raises 11650 to 16850 and is all-in
jcarlos.vale: folds 
Uncalled bet (11650) returned to adabrakadabra
adabrakadabra collected 10600 from pot
*** SUMMARY ***
Total pot 10600 | Rake 0 
Seat 6: adabrakadabra (big blind) collected (10600)
Seat 7: jcarlos.vale (button) (small blind) folded before Flop



PokerStars Hand #221594305804: Tournament #3079328305, $0.91+$0.09 USD Hold'em No Limit - Level XV (1000/2000) - 2020/12/19 3:49:46 EET [2020/12/18 20:49:46 ET]
Table '3079328305 4' 9-max Seat #6 is the button
Seat 6: adabrakadabra (22250 in chips) 
Seat 7: jcarlos.vale (45250 in chips) 
adabrakadabra: posts the ante 100
jcarlos.vale: posts the ante 100
adabrakadabra: posts small blind 1000
jcarlos.vale: posts big blind 2000
*** HOLE CARDS ***
Dealt to jcarlos.vale [7h 8h]
adabrakadabra: folds 
Uncalled bet (1000) returned to jcarlos.vale
jcarlos.vale collected 2200 from pot
jcarlos.vale: doesn't show handDTO
*** SUMMARY ***
Total pot 2200 | Rake 0 
Seat 6: adabrakadabra (button) (small blind) folded before Flop
Seat 7: jcarlos.vale (big blind) collected (2200)



PokerStars Hand #221594312984: Tournament #3079328305, $0.91+$0.09 USD Hold'em No Limit - Level XV (1000/2000) - 2020/12/19 3:50:05 EET [2020/12/18 20:50:05 ET]
Table '3079328305 4' 9-max Seat #7 is the button
Seat 6: adabrakadabra (21150 in chips) 
Seat 7: jcarlos.vale (46350 in chips) 
adabrakadabra: posts the ante 100
jcarlos.vale: posts the ante 100
jcarlos.vale: posts small blind 1000
adabrakadabra: posts big blind 2000
*** HOLE CARDS ***
Dealt to jcarlos.vale [Ad 3s]
jcarlos.vale: raises 3200 to 5200
adabrakadabra: folds 
Uncalled bet (3200) returned to jcarlos.vale
jcarlos.vale collected 4200 from pot
jcarlos.vale: doesn't show handDTO
*** SUMMARY ***
Total pot 4200 | Rake 0 
Seat 6: adabrakadabra (big blind) folded before Flop
Seat 7: jcarlos.vale (button) (small blind) collected (4200)



PokerStars Hand #221594319700: Tournament #3079328305, $0.91+$0.09 USD Hold'em No Limit - Level XV (1000/2000) - 2020/12/19 3:50:22 EET [2020/12/18 20:50:22 ET]
Table '3079328305 4' 9-max Seat #6 is the button
Seat 6: adabrakadabra (19050 in chips) 
Seat 7: jcarlos.vale (48450 in chips) 
adabrakadabra: posts the ante 100
jcarlos.vale: posts the ante 100
adabrakadabra: posts small blind 1000
jcarlos.vale: posts big blind 2000
*** HOLE CARDS ***
Dealt to jcarlos.vale [2d 3s]
adabrakadabra: folds 
Uncalled bet (1000) returned to jcarlos.vale
jcarlos.vale collected 2200 from pot
jcarlos.vale: doesn't show handDTO
*** SUMMARY ***
Total pot 2200 | Rake 0 
Seat 6: adabrakadabra (button) (small blind) folded before Flop
Seat 7: jcarlos.vale (big blind) collected (2200)



PokerStars Hand #221594323980: Tournament #3079328305, $0.91+$0.09 USD Hold'em No Limit - Level XV (1000/2000) - 2020/12/19 3:50:33 EET [2020/12/18 20:50:33 ET]
Table '3079328305 4' 9-max Seat #7 is the button
Seat 6: adabrakadabra (17950 in chips) 
Seat 7: jcarlos.vale (49550 in chips) 
adabrakadabra: posts the ante 100
jcarlos.vale: posts the ante 100
jcarlos.vale: posts small blind 1000
adabrakadabra: posts big blind 2000
*** HOLE CARDS ***
Dealt to jcarlos.vale [Ks 4s]
jcarlos.vale: calls 1000
adabrakadabra: checks 
*** FLOP *** [Qd 5h Tc]
adabrakadabra: checks 
jcarlos.vale: checks 
*** TURN *** [Qd 5h Tc] [8c]
adabrakadabra: bets 2000
jcarlos.vale: folds 
Uncalled bet (2000) returned to adabrakadabra
adabrakadabra collected 4200 from pot
*** SUMMARY ***
Total pot 4200 | Rake 0 
Board [Qd 5h Tc 8c]
Seat 6: adabrakadabra (big blind) collected (4200)
Seat 7: jcarlos.vale (button) (small blind) folded on the Turn



PokerStars Hand #221594337996: Tournament #3079328305, $0.91+$0.09 USD Hold'em No Limit - Level XV (1000/2000) - 2020/12/19 3:51:09 EET [2020/12/18 20:51:09 ET]
Table '3079328305 4' 9-max Seat #6 is the button
Seat 6: adabrakadabra (20050 in chips) 
Seat 7: jcarlos.vale (47450 in chips) 
adabrakadabra: posts the ante 100
jcarlos.vale: posts the ante 100
adabrakadabra: posts small blind 1000
jcarlos.vale: posts big blind 2000
*** HOLE CARDS ***
Dealt to jcarlos.vale [4h 3h]
adabrakadabra: raises 17950 to 19950 and is all-in
jcarlos.vale: folds 
Uncalled bet (17950) returned to adabrakadabra
adabrakadabra collected 4200 from pot
*** SUMMARY ***
Total pot 4200 | Rake 0 
Seat 6: adabrakadabra (button) (small blind) collected (4200)
Seat 7: jcarlos.vale (big blind) folded before Flop



PokerStars Hand #221594345301: Tournament #3079328305, $0.91+$0.09 USD Hold'em No Limit - Level XV (1000/2000) - 2020/12/19 3:51:28 EET [2020/12/18 20:51:28 ET]
Table '3079328305 4' 9-max Seat #7 is the button
Seat 6: adabrakadabra (22150 in chips) 
Seat 7: jcarlos.vale (45350 in chips) 
adabrakadabra: posts the ante 100
jcarlos.vale: posts the ante 100
jcarlos.vale: posts small blind 1000
adabrakadabra: posts big blind 2000
*** HOLE CARDS ***
Dealt to jcarlos.vale [Ks 8h]
jcarlos.vale: raises 3200 to 5200
adabrakadabra: folds 
Uncalled bet (3200) returned to jcarlos.vale
jcarlos.vale collected 4200 from pot
jcarlos.vale: doesn't show handDTO
*** SUMMARY ***
Total pot 4200 | Rake 0 
Seat 6: adabrakadabra (big blind) folded before Flop
Seat 7: jcarlos.vale (button) (small blind) collected (4200)



PokerStars Hand #221594351339: Tournament #3079328305, $0.91+$0.09 USD Hold'em No Limit - Level XV (1000/2000) - 2020/12/19 3:51:44 EET [2020/12/18 20:51:44 ET]
Table '3079328305 4' 9-max Seat #6 is the button
Seat 6: adabrakadabra (20050 in chips) 
Seat 7: jcarlos.vale (47450 in chips) 
adabrakadabra: posts the ante 100
jcarlos.vale: posts the ante 100
adabrakadabra: posts small blind 1000
jcarlos.vale: posts big blind 2000
*** HOLE CARDS ***
Dealt to jcarlos.vale [3d Ks]
adabrakadabra: folds 
Uncalled bet (1000) returned to jcarlos.vale
jcarlos.vale collected 2200 from pot
jcarlos.vale: doesn't show handDTO
*** SUMMARY ***
Total pot 2200 | Rake 0 
Seat 6: adabrakadabra (button) (small blind) folded before Flop
Seat 7: jcarlos.vale (big blind) collected (2200)



PokerStars Hand #221594356878: Tournament #3079328305, $0.91+$0.09 USD Hold'em No Limit - Level XV (1000/2000) - 2020/12/19 3:51:58 EET [2020/12/18 20:51:58 ET]
Table '3079328305 4' 9-max Seat #7 is the button
Seat 6: adabrakadabra (18950 in chips) 
Seat 7: jcarlos.vale (48550 in chips) 
adabrakadabra: posts the ante 100
jcarlos.vale: posts the ante 100
jcarlos.vale: posts small blind 1000
adabrakadabra: posts big blind 2000
*** HOLE CARDS ***
Dealt to jcarlos.vale [3d Qd]
jcarlos.vale: calls 1000
adabrakadabra: raises 16850 to 18850 and is all-in
jcarlos.vale: folds 
Uncalled bet (16850) returned to adabrakadabra
adabrakadabra collected 4200 from pot
*** SUMMARY ***
Total pot 4200 | Rake 0 
Seat 6: adabrakadabra (big blind) collected (4200)
Seat 7: jcarlos.vale (button) (small blind) folded before Flop



PokerStars Hand #221594367292: Tournament #3079328305, $0.91+$0.09 USD Hold'em No Limit - Level XV (1000/2000) - 2020/12/19 3:52:25 EET [2020/12/18 20:52:25 ET]
Table '3079328305 4' 9-max Seat #6 is the button
Seat 6: adabrakadabra (21050 in chips) 
Seat 7: jcarlos.vale (46450 in chips) 
adabrakadabra: posts the ante 100
jcarlos.vale: posts the ante 100
adabrakadabra: posts small blind 1000
jcarlos.vale: posts big blind 2000
*** HOLE CARDS ***
Dealt to jcarlos.vale [Th 7s]
adabrakadabra: folds 
Uncalled bet (1000) returned to jcarlos.vale
jcarlos.vale collected 2200 from pot
jcarlos.vale: doesn't show handDTO
*** SUMMARY ***
Total pot 2200 | Rake 0 
Seat 6: adabrakadabra (button) (small blind) folded before Flop
Seat 7: jcarlos.vale (big blind) collected (2200)



PokerStars Hand #221594372906: Tournament #3079328305, $0.91+$0.09 USD Hold'em No Limit - Level XV (1000/2000) - 2020/12/19 3:52:39 EET [2020/12/18 20:52:39 ET]
Table '3079328305 4' 9-max Seat #7 is the button
Seat 6: adabrakadabra (19950 in chips) 
Seat 7: jcarlos.vale (47550 in chips) 
adabrakadabra: posts the ante 100
jcarlos.vale: posts the ante 100
jcarlos.vale: posts small blind 1000
adabrakadabra: posts big blind 2000
*** HOLE CARDS ***
Dealt to jcarlos.vale [3c 9s]
jcarlos.vale: folds 
Uncalled bet (1000) returned to adabrakadabra
adabrakadabra collected 2200 from pot
*** SUMMARY ***
Total pot 2200 | Rake 0 
Seat 6: adabrakadabra (big blind) collected (2200)
Seat 7: jcarlos.vale (button) (small blind) folded before Flop



PokerStars Hand #221594377586: Tournament #3079328305, $0.91+$0.09 USD Hold'em No Limit - Level XV (1000/2000) - 2020/12/19 3:52:52 EET [2020/12/18 20:52:52 ET]
Table '3079328305 4' 9-max Seat #6 is the button
Seat 6: adabrakadabra (21050 in chips) 
Seat 7: jcarlos.vale (46450 in chips) 
adabrakadabra: posts the ante 100
jcarlos.vale: posts the ante 100
adabrakadabra: posts small blind 1000
jcarlos.vale: posts big blind 2000
*** HOLE CARDS ***
Dealt to jcarlos.vale [As 6s]
adabrakadabra: raises 18950 to 20950 and is all-in
jcarlos.vale: calls 18950
*** FLOP *** [5d 6h Tc]
*** TURN *** [5d 6h Tc] [Kd]
*** RIVER *** [5d 6h Tc Kd] [3s]
*** SHOW DOWN ***
jcarlos.vale: shows [As 6s] (a pair of Sixes)
adabrakadabra: shows [9d 9s] (a pair of Nines)
adabrakadabra collected 42100 from pot
*** SUMMARY ***
Total pot 42100 | Rake 0 
Board [5d 6h Tc Kd 3s]
Seat 6: adabrakadabra (button) (small blind) showed [9d 9s] and won (42100) with a pair of Nines
Seat 7: jcarlos.vale (big blind) showed [As 6s] and lost with a pair of Sixes



PokerStars Hand #221594387873: Tournament #3079328305, $0.91+$0.09 USD Hold'em No Limit - Level XVI (1500/3000) - 2020/12/19 3:53:18 EET [2020/12/18 20:53:18 ET]
Table '3079328305 4' 9-max Seat #7 is the button
Seat 6: adabrakadabra (42100 in chips) 
Seat 7: jcarlos.vale (25400 in chips) 
adabrakadabra: posts the ante 150
jcarlos.vale: posts the ante 150
jcarlos.vale: posts small blind 1500
adabrakadabra: posts big blind 3000
*** HOLE CARDS ***
Dealt to jcarlos.vale [7d Kc]
jcarlos.vale: raises 22250 to 25250 and is all-in
adabrakadabra: folds 
Uncalled bet (22250) returned to jcarlos.vale
jcarlos.vale collected 6300 from pot
jcarlos.vale: doesn't show handDTO
*** SUMMARY ***
Total pot 6300 | Rake 0 
Seat 6: adabrakadabra (big blind) folded before Flop
Seat 7: jcarlos.vale (button) (small blind) collected (6300)



PokerStars Hand #221594394291: Tournament #3079328305, $0.91+$0.09 USD Hold'em No Limit - Level XVI (1500/3000) - 2020/12/19 3:53:35 EET [2020/12/18 20:53:35 ET]
Table '3079328305 4' 9-max Seat #6 is the button
Seat 6: adabrakadabra (38950 in chips) 
Seat 7: jcarlos.vale (28550 in chips) 
adabrakadabra: posts the ante 150
jcarlos.vale: posts the ante 150
adabrakadabra: posts small blind 1500
jcarlos.vale: posts big blind 3000
*** HOLE CARDS ***
Dealt to jcarlos.vale [4s 6d]
adabrakadabra: folds 
Uncalled bet (1500) returned to jcarlos.vale
jcarlos.vale collected 3300 from pot
jcarlos.vale: doesn't show handDTO
*** SUMMARY ***
Total pot 3300 | Rake 0 
Seat 6: adabrakadabra (button) (small blind) folded before Flop
Seat 7: jcarlos.vale (big blind) collected (3300)



PokerStars Hand #221594398449: Tournament #3079328305, $0.91+$0.09 USD Hold'em No Limit - Level XVI (1500/3000) - 2020/12/19 3:53:46 EET [2020/12/18 20:53:46 ET]
Table '3079328305 4' 9-max Seat #7 is the button
Seat 6: adabrakadabra (37300 in chips) 
Seat 7: jcarlos.vale (30200 in chips) 
adabrakadabra: posts the ante 150
jcarlos.vale: posts the ante 150
jcarlos.vale: posts small blind 1500
adabrakadabra: posts big blind 3000
*** HOLE CARDS ***
Dealt to jcarlos.vale [Jh 3h]
jcarlos.vale: folds 
Uncalled bet (1500) returned to adabrakadabra
adabrakadabra collected 3300 from pot
*** SUMMARY ***
Total pot 3300 | Rake 0 
Seat 6: adabrakadabra (big blind) collected (3300)
Seat 7: jcarlos.vale (button) (small blind) folded before Flop



PokerStars Hand #221594402576: Tournament #3079328305, $0.91+$0.09 USD Hold'em No Limit - Level XVI (1500/3000) - 2020/12/19 3:53:56 EET [2020/12/18 20:53:56 ET]
Table '3079328305 4' 9-max Seat #6 is the button
Seat 6: adabrakadabra (38950 in chips) 
Seat 7: jcarlos.vale (28550 in chips) 
adabrakadabra: posts the ante 150
jcarlos.vale: posts the ante 150
adabrakadabra: posts small blind 1500
jcarlos.vale: posts big blind 3000
*** HOLE CARDS ***
Dealt to jcarlos.vale [5h 3s]
adabrakadabra: folds 
Uncalled bet (1500) returned to jcarlos.vale
jcarlos.vale collected 3300 from pot
jcarlos.vale: doesn't show handDTO
*** SUMMARY ***
Total pot 3300 | Rake 0 
Seat 6: adabrakadabra (button) (small blind) folded before Flop
Seat 7: jcarlos.vale (big blind) collected (3300)



PokerStars Hand #221594406837: Tournament #3079328305, $0.91+$0.09 USD Hold'em No Limit - Level XVI (1500/3000) - 2020/12/19 3:54:07 EET [2020/12/18 20:54:07 ET]
Table '3079328305 4' 9-max Seat #7 is the button
Seat 6: adabrakadabra (37300 in chips) 
Seat 7: jcarlos.vale (30200 in chips) 
adabrakadabra: posts the ante 150
jcarlos.vale: posts the ante 150
jcarlos.vale: posts small blind 1500
adabrakadabra: posts big blind 3000
*** HOLE CARDS ***
Dealt to jcarlos.vale [Ac 4h]
jcarlos.vale: raises 27050 to 30050 and is all-in
adabrakadabra: folds 
Uncalled bet (27050) returned to jcarlos.vale
jcarlos.vale collected 6300 from pot
jcarlos.vale: doesn't show handDTO
*** SUMMARY ***
Total pot 6300 | Rake 0 
Seat 6: adabrakadabra (big blind) folded before Flop
Seat 7: jcarlos.vale (button) (small blind) collected (6300)



PokerStars Hand #221594413289: Tournament #3079328305, $0.91+$0.09 USD Hold'em No Limit - Level XVI (1500/3000) - 2020/12/19 3:54:24 EET [2020/12/18 20:54:24 ET]
Table '3079328305 4' 9-max Seat #6 is the button
Seat 6: adabrakadabra (34150 in chips) 
Seat 7: jcarlos.vale (33350 in chips) 
adabrakadabra: posts the ante 150
jcarlos.vale: posts the ante 150
adabrakadabra: posts small blind 1500
jcarlos.vale: posts big blind 3000
*** HOLE CARDS ***
Dealt to jcarlos.vale [4h 7c]
adabrakadabra: raises 3000 to 6000
jcarlos.vale: folds 
Uncalled bet (3000) returned to adabrakadabra
adabrakadabra collected 6300 from pot
*** SUMMARY ***
Total pot 6300 | Rake 0 
Seat 6: adabrakadabra (button) (small blind) collected (6300)
Seat 7: jcarlos.vale (big blind) folded before Flop



PokerStars Hand #221594418698: Tournament #3079328305, $0.91+$0.09 USD Hold'em No Limit - Level XVI (1500/3000) - 2020/12/19 3:54:38 EET [2020/12/18 20:54:38 ET]
Table '3079328305 4' 9-max Seat #7 is the button
Seat 6: adabrakadabra (37300 in chips) 
Seat 7: jcarlos.vale (30200 in chips) 
adabrakadabra: posts the ante 150
jcarlos.vale: posts the ante 150
jcarlos.vale: posts small blind 1500
adabrakadabra: posts big blind 3000
*** HOLE CARDS ***
Dealt to jcarlos.vale [Kd Jh]
jcarlos.vale: raises 27050 to 30050 and is all-in
adabrakadabra: folds 
Uncalled bet (27050) returned to jcarlos.vale
jcarlos.vale collected 6300 from pot
jcarlos.vale: doesn't show handDTO
*** SUMMARY ***
Total pot 6300 | Rake 0 
Seat 6: adabrakadabra (big blind) folded before Flop
Seat 7: jcarlos.vale (button) (small blind) collected (6300)



PokerStars Hand #221594423496: Tournament #3079328305, $0.91+$0.09 USD Hold'em No Limit - Level XVI (1500/3000) - 2020/12/19 3:54:50 EET [2020/12/18 20:54:50 ET]
Table '3079328305 4' 9-max Seat #6 is the button
Seat 6: adabrakadabra (34150 in chips) 
Seat 7: jcarlos.vale (33350 in chips) 
adabrakadabra: posts the ante 150
jcarlos.vale: posts the ante 150
adabrakadabra: posts small blind 1500
jcarlos.vale: posts big blind 3000
*** HOLE CARDS ***
Dealt to jcarlos.vale [Kh 8s]
adabrakadabra: raises 3000 to 6000
jcarlos.vale: folds 
Uncalled bet (3000) returned to adabrakadabra
adabrakadabra collected 6300 from pot
*** SUMMARY ***
Total pot 6300 | Rake 0 
Seat 6: adabrakadabra (button) (small blind) collected (6300)
Seat 7: jcarlos.vale (big blind) folded before Flop



PokerStars Hand #221594429566: Tournament #3079328305, $0.91+$0.09 USD Hold'em No Limit - Level XVI (1500/3000) - 2020/12/19 3:55:06 EET [2020/12/18 20:55:06 ET]
Table '3079328305 4' 9-max Seat #7 is the button
Seat 6: adabrakadabra (37300 in chips) 
Seat 7: jcarlos.vale (30200 in chips) 
adabrakadabra: posts the ante 150
jcarlos.vale: posts the ante 150
jcarlos.vale: posts small blind 1500
adabrakadabra: posts big blind 3000
*** HOLE CARDS ***
Dealt to jcarlos.vale [2h Kh]
jcarlos.vale: folds 
Uncalled bet (1500) returned to adabrakadabra
adabrakadabra collected 3300 from pot
*** SUMMARY ***
Total pot 3300 | Rake 0 
Seat 6: adabrakadabra (big blind) collected (3300)
Seat 7: jcarlos.vale (button) (small blind) folded before Flop



PokerStars Hand #221594487181: Tournament #3079328305, $0.91+$0.09 USD Hold'em No Limit - Level XVI (1500/3000) - 2020/12/19 3:58:11 EET [2020/12/18 20:58:11 ET]
Table '3079328305 4' 9-max Seat #6 is the button
Seat 6: adabrakadabra (38950 in chips) 
Seat 7: jcarlos.vale (28550 in chips) 
adabrakadabra: posts the ante 150
jcarlos.vale: posts the ante 150
adabrakadabra: posts small blind 1500
jcarlos.vale: posts big blind 3000
*** HOLE CARDS ***
Dealt to jcarlos.vale [3c 5s]
adabrakadabra: raises 3300 to 6300
jcarlos.vale: folds 
Uncalled bet (3300) returned to adabrakadabra
adabrakadabra collected 6300 from pot
*** SUMMARY ***
Total pot 6300 | Rake 0 
Seat 6: adabrakadabra (button) (small blind) collected (6300)
Seat 7: jcarlos.vale (big blind) folded before Flop



PokerStars Hand #221594492045: Tournament #3079328305, $0.91+$0.09 USD Hold'em No Limit - Level XVI (1500/3000) - 2020/12/19 3:58:26 EET [2020/12/18 20:58:26 ET]
Table '3079328305 4' 9-max Seat #7 is the button
Seat 6: adabrakadabra (42100 in chips) 
Seat 7: jcarlos.vale (25400 in chips) 
adabrakadabra: posts the ante 150
jcarlos.vale: posts the ante 150
jcarlos.vale: posts small blind 1500
adabrakadabra: posts big blind 3000
*** HOLE CARDS ***
Dealt to jcarlos.vale [7h 2d]
jcarlos.vale: folds 
Uncalled bet (1500) returned to adabrakadabra
adabrakadabra collected 3300 from pot
*** SUMMARY ***
Total pot 3300 | Rake 0 
Seat 6: adabrakadabra (big blind) collected (3300)
Seat 7: jcarlos.vale (button) (small blind) folded before Flop



PokerStars Hand #221594495350: Tournament #3079328305, $0.91+$0.09 USD Hold'em No Limit - Level XVI (1500/3000) - 2020/12/19 3:58:37 EET [2020/12/18 20:58:37 ET]
Table '3079328305 4' 9-max Seat #6 is the button
Seat 6: adabrakadabra (43750 in chips) 
Seat 7: jcarlos.vale (23750 in chips) 
adabrakadabra: posts the ante 150
jcarlos.vale: posts the ante 150
adabrakadabra: posts small blind 1500
jcarlos.vale: posts big blind 3000
*** HOLE CARDS ***
Dealt to jcarlos.vale [Jd As]
adabrakadabra: raises 40600 to 43600 and is all-in
jcarlos.vale: calls 20600 and is all-in
Uncalled bet (20000) returned to adabrakadabra
*** FLOP *** [4s 8h 3c]
*** TURN *** [4s 8h 3c] [6h]
*** RIVER *** [4s 8h 3c 6h] [Td]
*** SHOW DOWN ***
jcarlos.vale: shows [Jd As] (high pairOfCards Ace)
adabrakadabra: shows [Jh Ad] (high pairOfCards Ace)
jcarlos.vale collected 23750 from pot
adabrakadabra collected 23750 from pot
*** SUMMARY ***
Total pot 47500 | Rake 0 
Board [4s 8h 3c 6h Td]
Seat 6: adabrakadabra (button) (small blind) showed [Jh Ad] and won (23750) with high pairOfCards Ace
Seat 7: jcarlos.vale (big blind) showed [Jd As] and won (23750) with high pairOfCards Ace



PokerStars Hand #221594505864: Tournament #3079328305, $0.91+$0.09 USD Hold'em No Limit - Level XVI (1500/3000) - 2020/12/19 3:59:11 EET [2020/12/18 20:59:11 ET]
Table '3079328305 4' 9-max Seat #7 is the button
Seat 6: adabrakadabra (43750 in chips) 
Seat 7: jcarlos.vale (23750 in chips) 
adabrakadabra: posts the ante 150
jcarlos.vale: posts the ante 150
jcarlos.vale: posts small blind 1500
adabrakadabra: posts big blind 3000
*** HOLE CARDS ***
Dealt to jcarlos.vale [Th Jh]
jcarlos.vale: raises 20600 to 23600 and is all-in
adabrakadabra: folds 
Uncalled bet (20600) returned to jcarlos.vale
jcarlos.vale collected 6300 from pot
jcarlos.vale: doesn't show handDTO
*** SUMMARY ***
Total pot 6300 | Rake 0 
Seat 6: adabrakadabra (big blind) folded before Flop
Seat 7: jcarlos.vale (button) (small blind) collected (6300)



PokerStars Hand #221594510274: Tournament #3079328305, $0.91+$0.09 USD Hold'em No Limit - Level XVI (1500/3000) - 2020/12/19 3:59:25 EET [2020/12/18 20:59:25 ET]
Table '3079328305 4' 9-max Seat #6 is the button
Seat 6: adabrakadabra (40600 in chips) 
Seat 7: jcarlos.vale (26900 in chips) 
adabrakadabra: posts the ante 150
jcarlos.vale: posts the ante 150
adabrakadabra: posts small blind 1500
jcarlos.vale: posts big blind 3000
*** HOLE CARDS ***
Dealt to jcarlos.vale [Ad 4h]
adabrakadabra: folds 
Uncalled bet (1500) returned to jcarlos.vale
jcarlos.vale collected 3300 from pot
jcarlos.vale: doesn't show handDTO
*** SUMMARY ***
Total pot 3300 | Rake 0 
Seat 6: adabrakadabra (button) (small blind) folded before Flop
Seat 7: jcarlos.vale (big blind) collected (3300)



PokerStars Hand #221594513414: Tournament #3079328305, $0.91+$0.09 USD Hold'em No Limit - Level XVI (1500/3000) - 2020/12/19 3:59:35 EET [2020/12/18 20:59:35 ET]
Table '3079328305 4' 9-max Seat #7 is the button
Seat 6: adabrakadabra (38950 in chips) 
Seat 7: jcarlos.vale (28550 in chips) 
adabrakadabra: posts the ante 150
jcarlos.vale: posts the ante 150
jcarlos.vale: posts small blind 1500
adabrakadabra: posts big blind 3000
*** HOLE CARDS ***
Dealt to jcarlos.vale [4s Qc]
jcarlos.vale: folds 
Uncalled bet (1500) returned to adabrakadabra
adabrakadabra collected 3300 from pot
*** SUMMARY ***
Total pot 3300 | Rake 0 
Seat 6: adabrakadabra (big blind) collected (3300)
Seat 7: jcarlos.vale (button) (small blind) folded before Flop



PokerStars Hand #221594516697: Tournament #3079328305, $0.91+$0.09 USD Hold'em No Limit - Level XVI (1500/3000) - 2020/12/19 3:59:45 EET [2020/12/18 20:59:45 ET]
Table '3079328305 4' 9-max Seat #6 is the button
Seat 6: adabrakadabra (40600 in chips) 
Seat 7: jcarlos.vale (26900 in chips) 
adabrakadabra: posts the ante 150
jcarlos.vale: posts the ante 150
adabrakadabra: posts small blind 1500
jcarlos.vale: posts big blind 3000
*** HOLE CARDS ***
Dealt to jcarlos.vale [Kd Qc]
adabrakadabra: raises 37450 to 40450 and is all-in
jcarlos.vale: calls 23750 and is all-in
Uncalled bet (13700) returned to adabrakadabra
*** FLOP *** [5d 4d Kh]
*** TURN *** [5d 4d Kh] [7s]
*** RIVER *** [5d 4d Kh 7s] [As]
*** SHOW DOWN ***
jcarlos.vale: shows [Kd Qc] (a pair of Kings)
adabrakadabra: shows [9h Ac] (a pair of Aces)
adabrakadabra collected 53800 from pot
*** SUMMARY ***
Total pot 53800 | Rake 0 
Board [5d 4d Kh 7s As]
Seat 6: adabrakadabra (button) (small blind) showed [9h Ac] and won (53800) with a pair of Aces
Seat 7: jcarlos.vale (big blind) showed [Kd Qc] and lost with a pair of Kings



